,TIME,SRC,PACKET_SIZE,CUMULATIVE_PACKET_SIZE,PAGE_NUMBER,TOTAL_PACKET_SIZE
0,0.0,74.125.130.0-255,153,153,8,340353
1,3.4e-05,172.31.36.0-255,66,219,8,340353
2,4.1e-05,74.125.130.0-255,1484,1703,8,340353
3,4.5e-05,172.31.36.0-255,66,1769,8,340353
4,5.7e-05,74.125.130.0-255,2902,4671,8,340353
5,6.1e-05,172.31.36.0-255,66,4737,8,340353
6,6.8e-05,74.125.130.0-255,7156,11893,8,340353
7,7e-05,172.31.36.0-255,66,11959,8,340353
8,7.4e-05,74.125.130.0-255,2027,13986,8,340353
9,7.7e-05,172.31.36.0-255,66,14052,8,340353
10,0.000112,74.125.130.0-255,2902,16954,8,340353
11,0.000115,172.31.36.0-255,66,17020,8,340353
12,0.000122,74.125.130.0-255,7156,24176,8,340353
13,0.000124,172.31.36.0-255,66,24242,8,340353
14,0.000129,74.125.130.0-255,5738,29980,8,340353
15,0.000131,172.31.36.0-255,66,30046,8,340353
16,0.000164,74.125.130.0-255,1125,31171,8,340353
17,0.000167,172.31.36.0-255,66,31237,8,340353
18,0.000258,74.125.130.0-255,1484,32721,8,340353
19,0.000263,172.31.36.0-255,66,32787,8,340353
20,0.000272,74.125.130.0-255,2902,35689,8,340353
21,0.000275,172.31.36.0-255,66,35755,8,340353
22,0.000285,74.125.130.0-255,4320,40075,8,340353
23,0.000288,172.31.36.0-255,66,40141,8,340353
24,0.00032,74.125.130.0-255,5738,45879,8,340353
25,0.000324,172.31.36.0-255,66,45945,8,340353
26,0.000352,74.125.130.0-255,3961,49906,8,340353
27,0.000357,74.125.130.0-255,4320,54226,8,340353
28,0.000358,172.31.36.0-255,66,54292,8,340353
29,0.000362,172.31.36.0-255,66,54358,8,340353
30,0.000441,172.31.36.0-255,66,54424,8,340353
31,0.000444,74.125.130.0-255,378,54802,8,340353
32,0.000644,74.125.130.0-255,1484,56286,8,340353
33,0.000649,74.125.130.0-255,2902,59188,8,340353
34,0.000651,172.31.36.0-255,66,59254,8,340353
35,0.000655,172.31.36.0-255,66,59320,8,340353
36,0.000681,74.125.130.0-255,5738,65058,8,340353
37,0.000689,172.31.36.0-255,66,65124,8,340353
38,0.000696,74.125.130.0-255,5738,70862,8,340353
39,0.000698,172.31.36.0-255,66,70928,8,340353
40,0.000739,74.125.130.0-255,7156,78084,8,340353
41,0.000742,172.31.36.0-255,66,78150,8,340353
42,0.00075,74.125.130.0-255,7156,85306,8,340353
43,0.000753,172.31.36.0-255,66,85372,8,340353
44,0.000777,74.125.130.0-255,3602,88974,8,340353
45,0.000781,172.31.36.0-255,66,89040,8,340353
46,0.000784,74.125.130.0-255,365,89405,8,340353
47,0.001085,172.31.36.0-255,66,89471,8,340353
48,0.001419,74.125.130.0-255,1484,90955,8,340353
49,0.001429,74.125.130.0-255,2902,93857,8,340353
50,0.001433,172.31.36.0-255,66,93923,8,340353
51,0.001464,74.125.130.0-255,4320,98243,8,340353
52,0.001467,172.31.36.0-255,66,98309,8,340353
53,0.001474,74.125.130.0-255,5738,104047,8,340353
54,0.001476,172.31.36.0-255,66,104113,8,340353
55,0.001514,172.31.36.0-255,66,104179,8,340353
56,0.001557,74.125.130.0-255,4320,108499,8,340353
57,0.001561,172.31.36.0-255,66,108565,8,340353
58,0.001587,74.125.130.0-255,3602,112167,8,340353
59,0.00159,172.31.36.0-255,66,112233,8,340353
60,0.001633,74.125.130.0-255,1484,113717,8,340353
61,0.001637,74.125.130.0-255,1484,115201,8,340353
62,0.001639,172.31.36.0-255,66,115267,8,340353
63,0.001659,74.125.130.0-255,1484,116751,8,340353
64,0.00168,74.125.130.0-255,5738,122489,8,340353
65,0.001683,172.31.36.0-255,66,122555,8,340353
66,0.001721,172.31.36.0-255,66,122621,8,340353
67,0.001768,172.31.36.0-255,66,122687,8,340353
68,0.001855,74.125.130.0-255,1484,124171,8,340353
69,0.00187,74.125.130.0-255,2902,127073,8,340353
70,0.001872,172.31.36.0-255,66,127139,8,340353
71,0.001886,74.125.130.0-255,2902,130041,8,340353
72,0.001887,172.31.36.0-255,66,130107,8,340353
73,0.001909,74.125.130.0-255,2902,133009,8,340353
74,0.001911,172.31.36.0-255,66,133075,8,340353
75,0.001915,74.125.130.0-255,2902,135977,8,340353
76,0.001917,172.31.36.0-255,66,136043,8,340353
77,0.00192,74.125.130.0-255,1484,137527,8,340353
78,0.001947,172.31.36.0-255,66,137593,8,340353
79,0.001952,74.125.130.0-255,4320,141913,8,340353
80,0.001955,172.31.36.0-255,66,141979,8,340353
81,0.001978,74.125.130.0-255,4320,146299,8,340353
82,0.001981,172.31.36.0-255,66,146365,8,340353
83,0.00201,74.125.130.0-255,2184,148549,8,340353
84,0.002012,172.31.36.0-255,66,148615,8,340353
85,0.002122,74.125.130.0-255,1484,150099,8,340353
86,0.002138,74.125.130.0-255,2902,153001,8,340353
87,0.00214,172.31.36.0-255,66,153067,8,340353
88,0.002165,74.125.130.0-255,2902,155969,8,340353
89,0.002168,172.31.36.0-255,66,156035,8,340353
90,0.004251,74.125.130.0-255,2902,158937,8,340353
91,0.004255,172.31.36.0-255,66,159003,8,340353
92,0.004279,74.125.130.0-255,2902,161905,8,340353
93,0.004283,172.31.36.0-255,66,161971,8,340353
94,0.006368,74.125.130.0-255,2902,164873,8,340353
95,0.006374,172.31.36.0-255,66,164939,8,340353
96,0.006408,74.125.130.0-255,2902,167841,8,340353
97,0.006411,172.31.36.0-255,66,167907,8,340353
98,0.00849,74.125.130.0-255,2902,170809,8,340353
99,0.008496,172.31.36.0-255,66,170875,8,340353
100,0.008531,74.125.130.0-255,2902,173777,8,340353
101,0.008535,172.31.36.0-255,66,173843,8,340353
102,0.010604,74.125.130.0-255,2902,176745,8,340353
103,0.010612,172.31.36.0-255,66,176811,8,340353
104,0.010646,74.125.130.0-255,2902,179713,8,340353
105,0.01065,172.31.36.0-255,66,179779,8,340353
106,0.012763,74.125.130.0-255,2902,182681,8,340353
107,0.01277,172.31.36.0-255,66,182747,8,340353
108,0.012806,74.125.130.0-255,2902,185649,8,340353
109,0.01281,172.31.36.0-255,66,185715,8,340353
110,0.014894,74.125.130.0-255,2902,188617,8,340353
111,0.014901,172.31.36.0-255,66,188683,8,340353
112,0.014936,74.125.130.0-255,2902,191585,8,340353
113,0.014938,172.31.36.0-255,66,191651,8,340353
114,0.017022,74.125.130.0-255,2902,194553,8,340353
115,0.017032,172.31.36.0-255,66,194619,8,340353
116,0.017072,74.125.130.0-255,2902,197521,8,340353
117,0.017076,172.31.36.0-255,66,197587,8,340353
118,0.019143,74.125.130.0-255,2902,200489,8,340353
119,0.019148,172.31.36.0-255,66,200555,8,340353
120,0.019174,74.125.130.0-255,1484,202039,8,340353
121,0.019192,74.125.130.0-255,1484,203523,8,340353
122,0.019195,172.31.36.0-255,66,203589,8,340353
123,0.021267,74.125.130.0-255,2902,206491,8,340353
124,0.021273,172.31.36.0-255,66,206557,8,340353
125,0.021306,74.125.130.0-255,2902,209459,8,340353
126,0.02131,172.31.36.0-255,66,209525,8,340353
127,0.023392,74.125.130.0-255,2902,212427,8,340353
128,0.023401,172.31.36.0-255,66,212493,8,340353
129,0.023435,74.125.130.0-255,2902,215395,8,340353
130,0.023439,172.31.36.0-255,66,215461,8,340353
131,0.025512,74.125.130.0-255,2902,218363,8,340353
132,0.02552,172.31.36.0-255,66,218429,8,340353
133,0.02555,74.125.130.0-255,2902,221331,8,340353
134,0.025553,172.31.36.0-255,66,221397,8,340353
135,0.027637,74.125.130.0-255,2902,224299,8,340353
136,0.027643,172.31.36.0-255,66,224365,8,340353
137,0.027674,74.125.130.0-255,2902,227267,8,340353
138,0.027678,172.31.36.0-255,66,227333,8,340353
139,0.029759,74.125.130.0-255,2902,230235,8,340353
140,0.029765,172.31.36.0-255,66,230301,8,340353
141,0.029797,74.125.130.0-255,2902,233203,8,340353
142,0.029802,172.31.36.0-255,66,233269,8,340353
143,0.03188,74.125.130.0-255,2902,236171,8,340353
144,0.031888,172.31.36.0-255,66,236237,8,340353
145,0.03192,74.125.130.0-255,2902,239139,8,340353
146,0.031924,172.31.36.0-255,66,239205,8,340353
147,0.033671,172.31.36.0-255,172,239377,8,340353
148,0.033715,172.31.36.0-255,1112,240489,8,340353
149,0.033786,172.31.36.0-255,1426,241915,8,340353
150,0.034012,74.125.130.0-255,2902,244817,8,340353
151,0.034019,172.31.36.0-255,66,244883,8,340353
152,0.034053,74.125.130.0-255,2902,247785,8,340353
153,0.034057,172.31.36.0-255,66,247851,8,340353
154,0.035235,104.244.42.0-255,66,247917,8,340353
155,0.035282,104.244.42.0-255,66,247983,8,340353
156,0.035338,104.244.42.0-255,66,248049,8,340353
157,0.03614,74.125.130.0-255,2902,250951,8,340353
158,0.036145,172.31.36.0-255,66,251017,8,340353
159,0.036185,74.125.130.0-255,2902,253919,8,340353
160,0.036188,172.31.36.0-255,66,253985,8,340353
161,0.038251,74.125.130.0-255,1484,255469,8,340353
162,0.038281,74.125.130.0-255,1484,256953,8,340353
163,0.038285,172.31.36.0-255,66,257019,8,340353
164,0.038308,74.125.130.0-255,2902,259921,8,340353
165,0.038311,172.31.36.0-255,66,259987,8,340353
166,0.040407,74.125.130.0-255,5738,265725,8,340353
167,0.040413,172.31.36.0-255,66,265791,8,340353
168,0.04253,74.125.130.0-255,5738,271529,8,340353
169,0.042536,172.31.36.0-255,66,271595,8,340353
170,0.044646,74.125.130.0-255,1484,273079,8,340353
171,0.044678,74.125.130.0-255,4320,277399,8,340353
172,0.044683,172.31.36.0-255,66,277465,8,340353
173,0.046785,74.125.130.0-255,1484,278949,8,340353
174,0.046818,74.125.130.0-255,4320,283269,8,340353
175,0.046822,172.31.36.0-255,66,283335,8,340353
176,0.048927,74.125.130.0-255,4320,287655,8,340353
177,0.048932,172.31.36.0-255,66,287721,8,340353
178,0.048962,74.125.130.0-255,1484,289205,8,340353
179,0.051039,74.125.130.0-255,4320,293525,8,340353
180,0.051044,172.31.36.0-255,66,293591,8,340353
181,0.053164,74.125.130.0-255,5738,299329,8,340353
182,0.053169,172.31.36.0-255,66,299395,8,340353
183,0.055293,74.125.130.0-255,5738,305133,8,340353
184,0.055299,172.31.36.0-255,66,305199,8,340353
185,0.057415,74.125.130.0-255,5738,310937,8,340353
186,0.057423,172.31.36.0-255,66,311003,8,340353
187,0.059549,74.125.130.0-255,5738,316741,8,340353
188,0.059569,172.31.36.0-255,66,316807,8,340353
189,0.061712,74.125.130.0-255,1484,318291,8,340353
190,0.061753,74.125.130.0-255,4320,322611,8,340353
191,0.061758,172.31.36.0-255,66,322677,8,340353
192,0.063864,74.125.130.0-255,5738,328415,8,340353
193,0.063869,172.31.36.0-255,66,328481,8,340353
194,0.065974,74.125.130.0-255,2902,331383,8,340353
195,0.06598,172.31.36.0-255,66,331449,8,340353
196,0.06601,74.125.130.0-255,2902,334351,8,340353
197,0.066013,172.31.36.0-255,66,334417,8,340353
198,0.068089,74.125.130.0-255,2902,337319,8,340353
199,0.068094,172.31.36.0-255,66,337385,8,340353
200,0.068133,74.125.130.0-255,2902,340287,8,340353
201,0.068136,172.31.36.0-255,66,340353,8,340353
202,0.0,74.125.24.0-255,167,167,8,162817
203,3.5e-05,172.31.36.0-255,66,233,8,162817
204,4.3e-05,74.125.24.0-255,1484,1717,8,162817
205,4.8e-05,172.31.36.0-255,66,1783,8,162817
206,5.4e-05,74.125.24.0-255,2902,4685,8,162817
207,5.7e-05,172.31.36.0-255,66,4751,8,162817
208,6.5e-05,74.125.24.0-255,7156,11907,8,162817
209,6.8e-05,172.31.36.0-255,66,11973,8,162817
210,7.2e-05,74.125.24.0-255,2053,14026,8,162817
211,7.4e-05,172.31.36.0-255,66,14092,8,162817
212,0.000146,74.125.24.0-255,1484,15576,8,162817
213,0.00015,172.31.36.0-255,66,15642,8,162817
214,0.000155,74.125.24.0-255,2902,18544,8,162817
215,0.000158,172.31.36.0-255,66,18610,8,162817
216,0.000175,74.125.24.0-255,1484,20094,8,162817
217,0.000177,172.31.36.0-255,66,20160,8,162817
218,0.000208,74.125.24.0-255,4320,24480,8,162817
219,0.000211,172.31.36.0-255,66,24546,8,162817
220,0.000225,172.31.36.0-255,66,24612,8,162817
221,0.000231,74.125.24.0-255,5738,30350,8,162817
222,0.000233,172.31.36.0-255,66,30416,8,162817
223,0.000258,74.125.24.0-255,2902,33318,8,162817
224,0.00026,172.31.36.0-255,66,33384,8,162817
225,0.0003,172.31.36.0-255,66,33450,8,162817
226,0.000303,74.125.24.0-255,115,33565,8,162817
227,0.000305,172.31.36.0-255,66,33631,8,162817
228,0.000308,74.125.24.0-255,330,33961,8,162817
229,0.00031,172.31.36.0-255,66,34027,8,162817
230,0.000566,74.125.24.0-255,1484,35511,8,162817
231,0.000571,74.125.24.0-255,2902,38413,8,162817
232,0.000572,172.31.36.0-255,66,38479,8,162817
233,0.000591,172.31.36.0-255,66,38545,8,162817
234,0.000599,74.125.24.0-255,5738,44283,8,162817
235,0.000608,172.31.36.0-255,66,44349,8,162817
236,0.000626,172.31.36.0-255,66,44415,8,162817
237,0.000635,74.125.24.0-255,2902,47317,8,162817
238,0.00064,172.31.36.0-255,66,47383,8,162817
239,0.000656,172.31.36.0-255,66,47449,8,162817
240,0.000734,74.125.24.0-255,1484,48933,8,162817
241,0.000739,74.125.24.0-255,2902,51835,8,162817
242,0.000743,172.31.36.0-255,66,51901,8,162817
243,0.000767,74.125.24.0-255,5738,57639,8,162817
244,0.000773,74.125.24.0-255,5738,63377,8,162817
245,0.000778,172.31.36.0-255,66,63443,8,162817
246,0.000794,74.125.24.0-255,2902,66345,8,162817
247,0.000806,172.31.36.0-255,66,66411,8,162817
248,0.000839,74.125.24.0-255,5020,71431,8,162817
249,0.000839,172.31.36.0-255,66,71497,8,162817
250,0.000843,172.31.36.0-255,66,71563,8,162817
251,0.000862,74.125.24.0-255,1484,73047,8,162817
252,0.000894,172.31.36.0-255,66,73113,8,162817
253,0.000925,74.125.24.0-255,2902,76015,8,162817
254,0.000929,172.31.36.0-255,66,76081,8,162817
255,0.000965,172.31.36.0-255,66,76147,8,162817
256,0.000996,74.125.24.0-255,1484,77631,8,162817
257,0.001013,74.125.24.0-255,2902,80533,8,162817
258,0.001022,172.31.36.0-255,66,80599,8,162817
259,0.001035,74.125.24.0-255,5738,86337,8,162817
260,0.00105,74.125.24.0-255,1484,87821,8,162817
261,0.001068,172.31.36.0-255,66,87887,8,162817
262,0.001086,172.31.36.0-255,66,87953,8,162817
263,0.001093,74.125.24.0-255,7156,95109,8,162817
264,0.001107,172.31.36.0-255,66,95175,8,162817
265,0.001124,74.125.24.0-255,3602,98777,8,162817
266,0.001135,172.31.36.0-255,66,98843,8,162817
267,0.001172,74.125.24.0-255,1484,100327,8,162817
268,0.001178,74.125.24.0-255,2902,103229,8,162817
269,0.001182,172.31.36.0-255,66,103295,8,162817
270,0.001185,74.125.24.0-255,1484,104779,8,162817
271,0.001204,74.125.24.0-255,4320,109099,8,162817
272,0.001209,74.125.24.0-255,4320,113419,8,162817
273,0.001209,172.31.36.0-255,66,113485,8,162817
274,0.001214,172.31.36.0-255,66,113551,8,162817
275,0.00125,172.31.36.0-255,66,113617,8,162817
276,0.001265,172.31.36.0-255,66,113683,8,162817
277,0.00129,74.125.24.0-255,5020,118703,8,162817
278,0.001297,74.125.24.0-255,5738,124441,8,162817
279,0.001302,172.31.36.0-255,66,124507,8,162817
280,0.00136,172.31.36.0-255,66,124573,8,162817
281,0.001376,74.125.24.0-255,1484,126057,8,162817
282,0.001407,172.31.36.0-255,66,126123,8,162817
283,0.00146,74.125.24.0-255,1484,127607,8,162817
284,0.001466,74.125.24.0-255,2902,130509,8,162817
285,0.001476,172.31.36.0-255,66,130575,8,162817
286,0.001487,74.125.24.0-255,5738,136313,8,162817
287,0.001491,172.31.36.0-255,66,136379,8,162817
288,0.001539,172.31.36.0-255,66,136445,8,162817
289,0.00157,172.31.36.0-255,66,136511,8,162817
290,0.001576,172.31.36.0-255,66,136577,8,162817
291,0.001607,74.125.24.0-255,1484,138061,8,162817
292,0.001632,172.31.36.0-255,66,138127,8,162817
293,0.001636,172.31.36.0-255,66,138193,8,162817
294,0.001648,172.31.36.0-255,66,138259,8,162817
295,0.001665,74.125.24.0-255,2902,141161,8,162817
296,0.001676,172.31.36.0-255,66,141227,8,162817
297,0.00168,74.125.24.0-255,3602,144829,8,162817
298,0.00169,172.31.36.0-255,66,144895,8,162817
299,0.001714,74.125.24.0-255,4320,149215,8,162817
300,0.001735,172.31.36.0-255,66,149281,8,162817
301,0.001741,172.31.36.0-255,66,149347,8,162817
302,0.001773,74.125.24.0-255,4320,153667,8,162817
303,0.001777,172.31.36.0-255,66,153733,8,162817
304,0.001799,74.125.24.0-255,4320,158053,8,162817
305,0.001803,172.31.36.0-255,66,158119,8,162817
306,0.001816,74.125.24.0-255,105,158224,8,162817
307,0.001818,172.31.36.0-255,66,158290,8,162817
308,0.003716,172.31.36.0-255,66,158356,8,162817
309,0.003742,172.31.36.0-255,105,158461,8,162817
310,0.005711,74.125.24.0-255,66,158527,8,162817
311,0.035176,172.31.36.0-255,172,158699,8,162817
312,0.035216,172.31.36.0-255,1112,159811,8,162817
313,0.03525,172.31.36.0-255,1514,161325,8,162817
314,0.035252,172.31.36.0-255,1294,162619,8,162817
315,0.036653,104.244.42.0-255,66,162685,8,162817
316,0.036849,104.244.42.0-255,66,162751,8,162817
317,0.036853,104.244.42.0-255,66,162817,8,162817
318,0.0,74.125.68.0-255,299,299,8,382853
319,2.7e-05,172.31.36.0-255,66,365,8,382853
320,3.3e-05,74.125.68.0-255,1484,1849,8,382853
321,3.7e-05,172.31.36.0-255,66,1915,8,382853
322,4.3e-05,74.125.68.0-255,2902,4817,8,382853
323,4.5e-05,172.31.36.0-255,66,4883,8,382853
324,7.2e-05,74.125.68.0-255,5738,10621,8,382853
325,7.5e-05,172.31.36.0-255,66,10687,8,382853
326,7.8e-05,74.125.68.0-255,1484,12171,8,382853
327,8.1e-05,172.31.36.0-255,66,12237,8,382853
328,0.000102,74.125.68.0-255,1787,14024,8,382853
329,0.000104,172.31.36.0-255,66,14090,8,382853
330,0.000111,74.125.68.0-255,4320,18410,8,382853
331,0.000113,172.31.36.0-255,66,18476,8,382853
332,0.000118,74.125.68.0-255,2902,21378,8,382853
333,0.00012,172.31.36.0-255,66,21444,8,382853
334,0.00015,74.125.68.0-255,7156,28600,8,382853
335,0.000154,172.31.36.0-255,66,28666,8,382853
336,0.000158,74.125.68.0-255,2543,31209,8,382853
337,0.000159,172.31.36.0-255,66,31275,8,382853
338,0.000406,74.125.68.0-255,1484,32759,8,382853
339,0.000411,172.31.36.0-255,66,32825,8,382853
340,0.000416,74.125.68.0-255,2902,35727,8,382853
341,0.00042,172.31.36.0-255,66,35793,8,382853
342,0.000423,74.125.68.0-255,1484,37277,8,382853
343,0.000425,172.31.36.0-255,66,37343,8,382853
344,0.000452,74.125.68.0-255,4320,41663,8,382853
345,0.000456,172.31.36.0-255,66,41729,8,382853
346,0.00046,74.125.68.0-255,2902,44631,8,382853
347,0.000465,74.125.68.0-255,4320,48951,8,382853
348,0.000466,172.31.36.0-255,66,49017,8,382853
349,0.000467,74.125.68.0-255,1484,50501,8,382853
350,0.000469,172.31.36.0-255,66,50567,8,382853
351,0.000501,74.125.68.0-255,7156,57723,8,382853
352,0.000505,172.31.36.0-255,66,57789,8,382853
353,0.000511,74.125.68.0-255,5738,63527,8,382853
354,0.000513,172.31.36.0-255,66,63593,8,382853
355,0.000535,74.125.68.0-255,2184,65777,8,382853
356,0.000538,172.31.36.0-255,66,65843,8,382853
357,0.00059,74.125.68.0-255,3232,69075,8,382853
358,0.000594,74.125.68.0-255,1484,70559,8,382853
359,0.000598,172.31.36.0-255,66,70625,8,382853
360,0.000607,74.125.68.0-255,2902,73527,8,382853
361,0.000619,172.31.36.0-255,66,73593,8,382853
362,0.000625,74.125.68.0-255,1484,75077,8,382853
363,0.00065,74.125.68.0-255,4320,79397,8,382853
364,0.000654,172.31.36.0-255,66,79463,8,382853
365,0.000682,74.125.68.0-255,1484,80947,8,382853
366,0.000697,74.125.68.0-255,4320,85267,8,382853
367,0.0007,172.31.36.0-255,66,85333,8,382853
368,0.000707,74.125.68.0-255,6438,91771,8,382853
369,0.000723,172.31.36.0-255,66,91837,8,382853
370,0.000758,74.125.68.0-255,1484,93321,8,382853
371,0.000762,74.125.68.0-255,1484,94805,8,382853
372,0.000766,172.31.36.0-255,66,94871,8,382853
373,0.000779,74.125.68.0-255,1484,96355,8,382853
374,0.000786,74.125.68.0-255,5738,102093,8,382853
375,0.000788,74.125.68.0-255,1484,103577,8,382853
376,0.000789,172.31.36.0-255,66,103643,8,382853
377,0.000813,74.125.68.0-255,1484,105127,8,382853
378,0.000818,74.125.68.0-255,4320,109447,8,382853
379,0.00082,74.125.68.0-255,1484,110931,8,382853
380,0.000821,172.31.36.0-255,66,110997,8,382853
381,0.000827,172.31.36.0-255,66,111063,8,382853
382,0.000847,74.125.68.0-255,7156,118219,8,382853
383,0.000853,74.125.68.0-255,7156,125375,8,382853
384,0.000853,172.31.36.0-255,66,125441,8,382853
385,0.000868,172.31.36.0-255,66,125507,8,382853
386,0.000883,74.125.68.0-255,766,126273,8,382853
387,0.000944,74.125.68.0-255,1484,127757,8,382853
388,0.000949,172.31.36.0-255,66,127823,8,382853
389,0.000963,74.125.68.0-255,2902,130725,8,382853
390,0.000971,172.31.36.0-255,66,130791,8,382853
391,0.000991,74.125.68.0-255,5738,136529,8,382853
392,0.000995,172.31.36.0-255,66,136595,8,382853
393,0.001002,74.125.68.0-255,1484,138079,8,382853
394,0.00102,74.125.68.0-255,7156,145235,8,382853
395,0.001024,172.31.36.0-255,66,145301,8,382853
396,0.001025,74.125.68.0-255,4320,149621,8,382853
397,0.001028,172.31.36.0-255,66,149687,8,382853
398,0.00104,74.125.68.0-255,5738,155425,8,382853
399,0.001051,172.31.36.0-255,66,155491,8,382853
400,0.001057,74.125.68.0-255,5020,160511,8,382853
401,0.001065,172.31.36.0-255,66,160577,8,382853
402,0.001083,74.125.68.0-255,5738,166315,8,382853
403,0.001087,172.31.36.0-255,66,166381,8,382853
404,0.001113,74.125.68.0-255,7156,173537,8,382853
405,0.001119,172.31.36.0-255,66,173603,8,382853
406,0.001127,74.125.68.0-255,4320,177923,8,382853
407,0.001133,172.31.36.0-255,66,177989,8,382853
408,0.001143,74.125.68.0-255,4320,182309,8,382853
409,0.001148,172.31.36.0-255,66,182375,8,382853
410,0.001149,74.125.68.0-255,4320,186695,8,382853
411,0.001161,172.31.36.0-255,66,186761,8,382853
412,0.001165,74.125.68.0-255,7156,193917,8,382853
413,0.001176,172.31.36.0-255,66,193983,8,382853
414,0.001194,74.125.68.0-255,1048,195031,8,382853
415,0.001225,74.125.68.0-255,1484,196515,8,382853
416,0.001234,172.31.36.0-255,66,196581,8,382853
417,0.001251,74.125.68.0-255,4320,200901,8,382853
418,0.001254,74.125.68.0-255,1484,202385,8,382853
419,0.001258,172.31.36.0-255,66,202451,8,382853
420,0.001258,74.125.68.0-255,2902,205353,8,382853
421,0.001261,172.31.36.0-255,66,205419,8,382853
422,0.00129,74.125.68.0-255,5738,211157,8,382853
423,0.001294,172.31.36.0-255,66,211223,8,382853
424,0.001298,74.125.68.0-255,2902,214125,8,382853
425,0.001308,172.31.36.0-255,66,214191,8,382853
426,0.001312,74.125.68.0-255,4320,218511,8,382853
427,0.001327,172.31.36.0-255,66,218577,8,382853
428,0.001333,74.125.68.0-255,2902,221479,8,382853
429,0.001341,172.31.36.0-255,66,221545,8,382853
430,0.001349,74.125.68.0-255,5738,227283,8,382853
431,0.001352,74.125.68.0-255,1484,228767,8,382853
432,0.001354,172.31.36.0-255,66,228833,8,382853
433,0.001392,74.125.68.0-255,766,229599,8,382853
434,0.001556,74.125.68.0-255,1484,231083,8,382853
435,0.001563,74.125.68.0-255,2902,233985,8,382853
436,0.001587,74.125.68.0-255,5738,239723,8,382853
437,0.001609,74.125.68.0-255,4320,244043,8,382853
438,0.001625,74.125.68.0-255,4320,248363,8,382853
439,0.001656,74.125.68.0-255,2902,251265,8,382853
440,0.001669,74.125.68.0-255,2184,253449,8,382853
441,0.001802,74.125.68.0-255,1484,254933,8,382853
442,0.001849,74.125.68.0-255,2902,257835,8,382853
443,0.001856,74.125.68.0-255,5738,263573,8,382853
444,0.001858,74.125.68.0-255,1484,265057,8,382853
445,0.001923,74.125.68.0-255,2184,267241,8,382853
446,0.002125,74.125.68.0-255,1484,268725,8,382853
447,0.002149,74.125.68.0-255,2902,271627,8,382853
448,0.00217,74.125.68.0-255,4320,275947,8,382853
449,0.002187,74.125.68.0-255,4320,280267,8,382853
450,0.002202,74.125.68.0-255,1484,281751,8,382853
451,0.002216,74.125.68.0-255,4320,286071,8,382853
452,0.002229,74.125.68.0-255,1484,287555,8,382853
453,0.002241,74.125.68.0-255,4320,291875,8,382853
454,0.002267,74.125.68.0-255,4320,296195,8,382853
455,0.002276,74.125.68.0-255,1484,297679,8,382853
456,0.002318,74.125.68.0-255,5020,302699,8,382853
457,0.002345,74.125.68.0-255,4320,307019,8,382853
458,0.002358,74.125.68.0-255,1484,308503,8,382853
459,0.002361,74.125.68.0-255,1484,309987,8,382853
460,0.002375,74.125.68.0-255,5738,315725,8,382853
461,0.0024,74.125.68.0-255,4320,320045,8,382853
462,0.002412,74.125.68.0-255,4320,324365,8,382853
463,0.002414,74.125.68.0-255,1484,325849,8,382853
464,0.00243,74.125.68.0-255,1484,327333,8,382853
465,0.002434,74.125.68.0-255,2902,330235,8,382853
466,0.002448,74.125.68.0-255,1484,331719,8,382853
467,0.002466,74.125.68.0-255,3602,335321,8,382853
468,0.002495,74.125.68.0-255,1484,336805,8,382853
469,0.002509,74.125.68.0-255,2902,339707,8,382853
470,0.002513,74.125.68.0-255,4320,344027,8,382853
471,0.002525,74.125.68.0-255,1484,345511,8,382853
472,0.00254,74.125.68.0-255,4320,349831,8,382853
473,0.002557,74.125.68.0-255,4320,354151,8,382853
474,0.002581,74.125.68.0-255,7156,361307,8,382853
475,0.002583,74.125.68.0-255,1484,362791,8,382853
476,0.005543,172.31.36.0-255,66,362857,8,382853
477,0.008109,74.125.68.0-255,4320,367177,8,382853
478,0.008116,172.31.36.0-255,66,367243,8,382853
479,0.008135,74.125.68.0-255,1484,368727,8,382853
480,0.010666,74.125.68.0-255,4320,373047,8,382853
481,0.010672,172.31.36.0-255,66,373113,8,382853
482,0.013236,74.125.68.0-255,5436,378549,8,382853
483,0.013244,172.31.36.0-255,66,378615,8,382853
484,0.016164,172.31.36.0-255,105,378720,8,382853
485,0.018677,74.125.68.0-255,66,378786,8,382853
486,0.032971,172.31.36.0-255,172,378958,8,382853
487,0.033004,172.31.36.0-255,1111,380069,8,382853
488,0.033042,172.31.36.0-255,1514,381583,8,382853
489,0.033044,172.31.36.0-255,1072,382655,8,382853
490,0.034537,104.244.42.0-255,66,382721,8,382853
491,0.034582,104.244.42.0-255,66,382787,8,382853
492,0.034626,104.244.42.0-255,66,382853,8,382853
493,0.0,74.125.24.0-255,153,153,8,309382
494,3.7e-05,172.31.36.0-255,66,219,8,309382
495,4.5e-05,74.125.24.0-255,1484,1703,8,309382
496,4.9e-05,172.31.36.0-255,66,1769,8,309382
497,6.4e-05,74.125.24.0-255,2902,4671,8,309382
498,6.7e-05,172.31.36.0-255,66,4737,8,309382
499,7.3e-05,74.125.24.0-255,5738,10475,8,309382
500,7.5e-05,172.31.36.0-255,66,10541,8,309382
501,9.1e-05,172.31.36.0-255,66,10607,8,309382
502,0.00014,74.125.24.0-255,2902,13509,8,309382
503,0.000144,172.31.36.0-255,66,13575,8,309382
504,0.000181,74.125.24.0-255,5738,19313,8,309382
505,0.000185,172.31.36.0-255,66,19379,8,309382
506,0.000193,74.125.24.0-255,5738,25117,8,309382
507,0.000196,172.31.36.0-255,66,25183,8,309382
508,0.000239,172.31.36.0-255,66,25249,8,309382
509,0.00028,74.125.24.0-255,1484,26733,8,309382
510,0.000283,172.31.36.0-255,66,26799,8,309382
511,0.00029,74.125.24.0-255,2902,29701,8,309382
512,0.000292,172.31.36.0-255,66,29767,8,309382
513,0.000308,74.125.24.0-255,5738,35505,8,309382
514,0.000317,172.31.36.0-255,66,35571,8,309382
515,0.000345,74.125.24.0-255,7091,42662,8,309382
516,0.000349,172.31.36.0-255,66,42728,8,309382
517,0.000439,74.125.24.0-255,129,42857,8,309382
518,0.000442,172.31.36.0-255,66,42923,8,309382
519,0.000589,74.125.24.0-255,1484,44407,8,309382
520,0.000592,172.31.36.0-255,66,44473,8,309382
521,0.000596,74.125.24.0-255,2902,47375,8,309382
522,0.000598,172.31.36.0-255,66,47441,8,309382
523,0.000626,74.125.24.0-255,5738,53179,8,309382
524,0.00063,74.125.24.0-255,1484,54663,8,309382
525,0.000639,172.31.36.0-255,66,54729,8,309382
526,0.000649,74.125.24.0-255,7156,61885,8,309382
527,0.000654,172.31.36.0-255,66,61951,8,309382
528,0.000723,74.125.24.0-255,1484,63435,8,309382
529,0.000753,172.31.36.0-255,66,63501,8,309382
530,0.000779,74.125.24.0-255,3307,66808,8,309382
531,0.000786,172.31.36.0-255,66,66874,8,309382
532,0.000817,74.125.24.0-255,1484,68358,8,309382
533,0.00082,74.125.24.0-255,1484,69842,8,309382
534,0.000827,172.31.36.0-255,66,69908,8,309382
535,0.00083,74.125.24.0-255,1484,71392,8,309382
536,0.000853,74.125.24.0-255,5738,77130,8,309382
537,0.000856,172.31.36.0-255,66,77196,8,309382
538,0.000869,172.31.36.0-255,66,77262,8,309382
539,0.000913,74.125.24.0-255,1484,78746,8,309382
540,0.000941,74.125.24.0-255,4320,83066,8,309382
541,0.00095,172.31.36.0-255,66,83132,8,309382
542,0.000965,74.125.24.0-255,5020,88152,8,309382
543,0.000971,172.31.36.0-255,66,88218,8,309382
544,0.001771,74.125.24.0-255,1484,89702,8,309382
545,0.001781,74.125.24.0-255,2902,92604,8,309382
546,0.001784,172.31.36.0-255,66,92670,8,309382
547,0.00179,74.125.24.0-255,2902,95572,8,309382
548,0.00181,74.125.24.0-255,2902,98474,8,309382
549,0.001833,74.125.24.0-255,7156,105630,8,309382
550,0.001867,74.125.24.0-255,2902,108532,8,309382
551,0.001946,74.125.24.0-255,2184,110716,8,309382
552,0.002186,74.125.24.0-255,1484,112200,8,309382
553,0.002201,74.125.24.0-255,2902,115102,8,309382
554,0.002215,74.125.24.0-255,1484,116586,8,309382
555,0.002228,74.125.24.0-255,4320,120906,8,309382
556,0.002247,74.125.24.0-255,5738,126644,8,309382
557,0.002261,74.125.24.0-255,7156,133800,8,309382
558,0.002313,74.125.24.0-255,2902,136702,8,309382
559,0.002389,74.125.24.0-255,4320,141022,8,309382
560,0.002403,74.125.24.0-255,4320,145342,8,309382
561,0.002433,74.125.24.0-255,1484,146826,8,309382
562,0.002443,74.125.24.0-255,2902,149728,8,309382
563,0.002463,74.125.24.0-255,5738,155466,8,309382
564,0.002494,74.125.24.0-255,2902,158368,8,309382
565,0.006924,172.31.36.0-255,66,158434,8,309382
566,0.009295,74.125.24.0-255,5738,164172,8,309382
567,0.009304,172.31.36.0-255,66,164238,8,309382
568,0.011678,74.125.24.0-255,5738,169976,8,309382
569,0.011886,172.31.36.0-255,66,170042,8,309382
570,0.01426,74.125.24.0-255,5738,175780,8,309382
571,0.014271,172.31.36.0-255,66,175846,8,309382
572,0.01662,74.125.24.0-255,5738,181584,8,309382
573,0.016628,172.31.36.0-255,66,181650,8,309382
574,0.018986,74.125.24.0-255,5738,187388,8,309382
575,0.018994,172.31.36.0-255,66,187454,8,309382
576,0.021368,74.125.24.0-255,5738,193192,8,309382
577,0.021375,172.31.36.0-255,66,193258,8,309382
578,0.02374,74.125.24.0-255,2902,196160,8,309382
579,0.023747,172.31.36.0-255,66,196226,8,309382
580,0.023782,74.125.24.0-255,2902,199128,8,309382
581,0.023796,172.31.36.0-255,66,199194,8,309382
582,0.026148,74.125.24.0-255,5738,204932,8,309382
583,0.026196,172.31.36.0-255,66,204998,8,309382
584,0.028554,74.125.24.0-255,5738,210736,8,309382
585,0.02856,172.31.36.0-255,66,210802,8,309382
586,0.029384,172.31.36.0-255,176,210978,8,309382
587,0.029437,172.31.36.0-255,1110,212088,8,309382
588,0.029469,172.31.36.0-255,1428,213516,8,309382
589,0.030893,74.125.24.0-255,2902,216418,8,309382
590,0.0309,172.31.36.0-255,66,216484,8,309382
591,0.030936,104.244.42.0-255,66,216550,8,309382
592,0.030942,74.125.24.0-255,2902,219452,8,309382
593,0.030949,172.31.36.0-255,66,219518,8,309382
594,0.030992,104.244.42.0-255,66,219584,8,309382
595,0.031091,104.244.42.0-255,66,219650,8,309382
596,0.033258,74.125.24.0-255,2902,222552,8,309382
597,0.033262,172.31.36.0-255,66,222618,8,309382
598,0.033295,74.125.24.0-255,2902,225520,8,309382
599,0.033303,172.31.36.0-255,66,225586,8,309382
600,0.035641,74.125.24.0-255,5738,231324,8,309382
601,0.035691,172.31.36.0-255,66,231390,8,309382
602,0.03804,74.125.24.0-255,5738,237128,8,309382
603,0.038046,172.31.36.0-255,66,237194,8,309382
604,0.040407,74.125.24.0-255,5738,242932,8,309382
605,0.040415,172.31.36.0-255,66,242998,8,309382
606,0.042777,74.125.24.0-255,4320,247318,8,309382
607,0.042782,172.31.36.0-255,66,247384,8,309382
608,0.04281,74.125.24.0-255,1484,248868,8,309382
609,0.045143,74.125.24.0-255,4320,253188,8,309382
610,0.045149,172.31.36.0-255,66,253254,8,309382
611,0.0475,74.125.24.0-255,4320,257574,8,309382
612,0.047505,172.31.36.0-255,66,257640,8,309382
613,0.04754,74.125.24.0-255,1484,259124,8,309382
614,0.049849,74.125.24.0-255,2902,262026,8,309382
615,0.049856,172.31.36.0-255,66,262092,8,309382
616,0.049885,74.125.24.0-255,1484,263576,8,309382
617,0.05223,74.125.24.0-255,4320,267896,8,309382
618,0.052281,172.31.36.0-255,66,267962,8,309382
619,0.054646,74.125.24.0-255,5738,273700,8,309382
620,0.055144,172.31.36.0-255,66,273766,8,309382
621,0.057517,74.125.24.0-255,2902,276668,8,309382
622,0.057523,172.31.36.0-255,66,276734,8,309382
623,0.05756,74.125.24.0-255,2902,279636,8,309382
624,0.057583,172.31.36.0-255,66,279702,8,309382
625,0.05987,74.125.24.0-255,2902,282604,8,309382
626,0.059876,172.31.36.0-255,66,282670,8,309382
627,0.059919,74.125.24.0-255,2902,285572,8,309382
628,0.059953,172.31.36.0-255,66,285638,8,309382
629,0.062229,74.125.24.0-255,2902,288540,8,309382
630,0.062235,172.31.36.0-255,66,288606,8,309382
631,0.062302,74.125.24.0-255,2902,291508,8,309382
632,0.062311,172.31.36.0-255,66,291574,8,309382
633,0.064576,74.125.24.0-255,2902,294476,8,309382
634,0.064582,172.31.36.0-255,66,294542,8,309382
635,0.064647,74.125.24.0-255,2902,297444,8,309382
636,0.064661,172.31.36.0-255,66,297510,8,309382
637,0.066928,74.125.24.0-255,2902,300412,8,309382
638,0.066934,172.31.36.0-255,66,300478,8,309382
639,0.066999,74.125.24.0-255,2902,303380,8,309382
640,0.067005,172.31.36.0-255,66,303446,8,309382
641,0.0693,74.125.24.0-255,2902,306348,8,309382
642,0.069305,172.31.36.0-255,66,306414,8,309382
643,0.06934,74.125.24.0-255,2902,309316,8,309382
644,0.069348,172.31.36.0-255,66,309382,8,309382
645,0.0,74.125.24.0-255,298,298,8,334315
646,2.5e-05,172.31.36.0-255,66,364,8,334315
647,3.1e-05,74.125.24.0-255,1484,1848,8,334315
648,3.6e-05,172.31.36.0-255,66,1914,8,334315
649,4.3e-05,74.125.24.0-255,4320,6234,8,334315
650,4.7e-05,172.31.36.0-255,66,6300,8,334315
651,5.4e-05,74.125.24.0-255,5738,12038,8,334315
652,5.7e-05,172.31.36.0-255,66,12104,8,334315
653,6.4e-05,74.125.24.0-255,7156,19260,8,334315
654,6.7e-05,172.31.36.0-255,66,19326,8,334315
655,9e-05,74.125.24.0-255,4709,24035,8,334315
656,9.3e-05,172.31.36.0-255,66,24101,8,334315
657,0.000101,74.125.24.0-255,6797,30898,8,334315
658,0.000104,172.31.36.0-255,66,30964,8,334315
659,0.000124,74.125.24.0-255,1484,32448,8,334315
660,0.000127,172.31.36.0-255,66,32514,8,334315
661,0.000132,74.125.24.0-255,2902,35416,8,334315
662,0.000135,172.31.36.0-255,66,35482,8,334315
663,0.000148,74.125.24.0-255,2902,38384,8,334315
664,0.000151,172.31.36.0-255,66,38450,8,334315
665,0.000163,74.125.24.0-255,2902,41352,8,334315
666,0.000165,172.31.36.0-255,66,41418,8,334315
667,0.000185,74.125.24.0-255,1484,42902,8,334315
668,0.000188,172.31.36.0-255,66,42968,8,334315
669,0.00021,74.125.24.0-255,5379,48347,8,334315
670,0.000213,172.31.36.0-255,66,48413,8,334315
671,0.000481,74.125.24.0-255,1484,49897,8,334315
672,0.000486,172.31.36.0-255,66,49963,8,334315
673,0.000492,74.125.24.0-255,2902,52865,8,334315
674,0.000495,172.31.36.0-255,66,52931,8,334315
675,0.000502,74.125.24.0-255,4320,57251,8,334315
676,0.000504,172.31.36.0-255,66,57317,8,334315
677,0.000529,74.125.24.0-255,1484,58801,8,334315
678,0.000541,172.31.36.0-255,66,58867,8,334315
679,0.000847,74.125.24.0-255,1484,60351,8,334315
680,0.000855,74.125.24.0-255,2902,63253,8,334315
681,0.000859,172.31.36.0-255,66,63319,8,334315
682,0.000863,74.125.24.0-255,1484,64803,8,334315
683,0.000884,74.125.24.0-255,4320,69123,8,334315
684,0.000886,172.31.36.0-255,66,69189,8,334315
685,0.000893,74.125.24.0-255,5738,74927,8,334315
686,0.000895,172.31.36.0-255,66,74993,8,334315
687,0.000929,74.125.24.0-255,2902,77895,8,334315
688,0.000932,172.31.36.0-255,66,77961,8,334315
689,0.00096,172.31.36.0-255,66,78027,8,334315
690,0.000966,74.125.24.0-255,5020,83047,8,334315
691,0.000968,172.31.36.0-255,66,83113,8,334315
692,0.001222,74.125.24.0-255,1484,84597,8,334315
693,0.001236,74.125.24.0-255,2902,87499,8,334315
694,0.001239,172.31.36.0-255,66,87565,8,334315
695,0.001246,74.125.24.0-255,4320,91885,8,334315
696,0.001248,172.31.36.0-255,66,91951,8,334315
697,0.001259,74.125.24.0-255,1484,93435,8,334315
698,0.001266,74.125.24.0-255,5738,99173,8,334315
699,0.001268,172.31.36.0-255,66,99239,8,334315
700,0.001295,74.125.24.0-255,7156,106395,8,334315
701,0.001298,172.31.36.0-255,66,106461,8,334315
702,0.001311,172.31.36.0-255,66,106527,8,334315
703,0.001929,74.125.24.0-255,1484,108011,8,334315
704,0.001939,74.125.24.0-255,2902,110913,8,334315
705,0.001944,172.31.36.0-255,66,110979,8,334315
706,0.00195,74.125.24.0-255,2902,113881,8,334315
707,0.001952,172.31.36.0-255,66,113947,8,334315
708,0.001957,74.125.24.0-255,2902,116849,8,334315
709,0.001959,172.31.36.0-255,66,116915,8,334315
710,0.00198,74.125.24.0-255,1484,118399,8,334315
711,0.001993,172.31.36.0-255,66,118465,8,334315
712,0.001997,74.125.24.0-255,1484,119949,8,334315
713,0.002025,172.31.36.0-255,66,120015,8,334315
714,0.002132,74.125.24.0-255,1484,121499,8,334315
715,0.002146,74.125.24.0-255,2902,124401,8,334315
716,0.00215,172.31.36.0-255,66,124467,8,334315
717,0.002155,74.125.24.0-255,2902,127369,8,334315
718,0.002157,172.31.36.0-255,66,127435,8,334315
719,0.002171,74.125.24.0-255,2902,130337,8,334315
720,0.002174,172.31.36.0-255,66,130403,8,334315
721,0.002182,74.125.24.0-255,7156,137559,8,334315
722,0.002184,172.31.36.0-255,66,137625,8,334315
723,0.002212,74.125.24.0-255,5738,143363,8,334315
724,0.002215,172.31.36.0-255,66,143429,8,334315
725,0.002222,74.125.24.0-255,5738,149167,8,334315
726,0.002224,172.31.36.0-255,66,149233,8,334315
727,0.002251,74.125.24.0-255,5020,154253,8,334315
728,0.002254,172.31.36.0-255,66,154319,8,334315
729,0.002334,74.125.24.0-255,1484,155803,8,334315
730,0.002351,74.125.24.0-255,2902,158705,8,334315
731,0.002354,172.31.36.0-255,66,158771,8,334315
732,0.002359,74.125.24.0-255,1484,160255,8,334315
733,0.004673,74.125.24.0-255,4320,164575,8,334315
734,0.004679,172.31.36.0-255,66,164641,8,334315
735,0.006975,74.125.24.0-255,5738,170379,8,334315
736,0.006985,172.31.36.0-255,66,170445,8,334315
737,0.009288,74.125.24.0-255,5738,176183,8,334315
738,0.009295,172.31.36.0-255,66,176249,8,334315
739,0.011587,74.125.24.0-255,5738,181987,8,334315
740,0.011594,172.31.36.0-255,66,182053,8,334315
741,0.013861,74.125.24.0-255,5738,187791,8,334315
742,0.013869,172.31.36.0-255,66,187857,8,334315
743,0.016141,74.125.24.0-255,5738,193595,8,334315
744,0.016149,172.31.36.0-255,66,193661,8,334315
745,0.018434,74.125.24.0-255,5738,199399,8,334315
746,0.018443,172.31.36.0-255,66,199465,8,334315
747,0.020767,74.125.24.0-255,5738,205203,8,334315
748,0.020776,172.31.36.0-255,66,205269,8,334315
749,0.023078,74.125.24.0-255,5738,211007,8,334315
750,0.023086,172.31.36.0-255,66,211073,8,334315
751,0.025356,74.125.24.0-255,5738,216811,8,334315
752,0.025365,172.31.36.0-255,66,216877,8,334315
753,0.027724,74.125.24.0-255,5738,222615,8,334315
754,0.027731,172.31.36.0-255,66,222681,8,334315
755,0.030007,74.125.24.0-255,5738,228419,8,334315
756,0.030015,172.31.36.0-255,66,228485,8,334315
757,0.032282,74.125.24.0-255,5738,234223,8,334315
758,0.032294,172.31.36.0-255,66,234289,8,334315
759,0.034602,74.125.24.0-255,5738,240027,8,334315
760,0.03461,172.31.36.0-255,66,240093,8,334315
761,0.03468,172.31.36.0-255,172,240265,8,334315
762,0.034713,172.31.36.0-255,1112,241377,8,334315
763,0.034773,172.31.36.0-255,1514,242891,8,334315
764,0.034775,172.31.36.0-255,1514,244405,8,334315
765,0.034781,172.31.36.0-255,1514,245919,8,334315
766,0.034782,172.31.36.0-255,1072,246991,8,334315
767,0.036255,104.244.42.0-255,66,247057,8,334315
768,0.036323,104.244.42.0-255,66,247123,8,334315
769,0.036344,104.244.42.0-255,66,247189,8,334315
770,0.036364,104.244.42.0-255,66,247255,8,334315
771,0.036881,74.125.24.0-255,5738,252993,8,334315
772,0.036887,172.31.36.0-255,66,253059,8,334315
773,0.039214,74.125.24.0-255,5738,258797,8,334315
774,0.03922,172.31.36.0-255,66,258863,8,334315
775,0.041533,74.125.24.0-255,5738,264601,8,334315
776,0.041541,172.31.36.0-255,66,264667,8,334315
777,0.043823,74.125.24.0-255,5738,270405,8,334315
778,0.04383,172.31.36.0-255,66,270471,8,334315
779,0.046123,74.125.24.0-255,5738,276209,8,334315
780,0.04613,172.31.36.0-255,66,276275,8,334315
781,0.048475,74.125.24.0-255,5738,282013,8,334315
782,0.048485,172.31.36.0-255,66,282079,8,334315
783,0.050845,74.125.24.0-255,5738,287817,8,334315
784,0.050852,172.31.36.0-255,66,287883,8,334315
785,0.053131,74.125.24.0-255,5738,293621,8,334315
786,0.053138,172.31.36.0-255,66,293687,8,334315
787,0.055476,74.125.24.0-255,5738,299425,8,334315
788,0.055484,172.31.36.0-255,66,299491,8,334315
789,0.057752,74.125.24.0-255,5738,305229,8,334315
790,0.057759,172.31.36.0-255,66,305295,8,334315
791,0.060072,74.125.24.0-255,5738,311033,8,334315
792,0.060079,172.31.36.0-255,66,311099,8,334315
793,0.062419,74.125.24.0-255,5738,316837,8,334315
794,0.062426,172.31.36.0-255,66,316903,8,334315
795,0.064745,74.125.24.0-255,5738,322641,8,334315
796,0.064755,172.31.36.0-255,66,322707,8,334315
797,0.067041,74.125.24.0-255,5738,328445,8,334315
798,0.067047,172.31.36.0-255,66,328511,8,334315
799,0.069341,74.125.24.0-255,5738,334249,8,334315
800,0.069347,172.31.36.0-255,66,334315,8,334315
801,0.0,74.125.200.0-255,66,66,8,66
802,0.0,172.217.194.0-255,153,153,8,303160
803,2.4e-05,172.31.36.0-255,66,219,8,303160
804,3.1e-05,172.217.194.0-255,1484,1703,8,303160
805,3.5e-05,172.31.36.0-255,66,1769,8,303160
806,4.1e-05,172.217.194.0-255,2902,4671,8,303160
807,5.4e-05,172.31.36.0-255,66,4737,8,303160
808,6.2e-05,172.217.194.0-255,7156,11893,8,303160
809,6.5e-05,172.31.36.0-255,66,11959,8,303160
810,6.9e-05,172.217.194.0-255,2015,13974,8,303160
811,7.2e-05,172.31.36.0-255,66,14040,8,303160
812,0.000374,172.217.194.0-255,1484,15524,8,303160
813,0.00038,172.31.36.0-255,66,15590,8,303160
814,0.000387,172.217.194.0-255,2902,18492,8,303160
815,0.00039,172.31.36.0-255,66,18558,8,303160
816,0.000402,172.217.194.0-255,5738,24296,8,303160
817,0.000404,172.31.36.0-255,66,24362,8,303160
818,0.000429,172.217.194.0-255,2902,27264,8,303160
819,0.000432,172.31.36.0-255,66,27330,8,303160
820,0.000474,172.31.36.0-255,66,27396,8,303160
821,0.00049,172.31.36.0-255,66,27462,8,303160
822,0.000531,172.217.194.0-255,1484,28946,8,303160
823,0.000534,172.31.36.0-255,66,29012,8,303160
824,0.000572,172.217.194.0-255,2902,31914,8,303160
825,0.000576,172.31.36.0-255,66,31980,8,303160
826,0.000582,172.217.194.0-255,5738,37718,8,303160
827,0.000585,172.31.36.0-255,66,37784,8,303160
828,0.000615,172.31.36.0-255,66,37850,8,303160
829,0.000769,172.217.194.0-255,1484,39334,8,303160
830,0.000773,172.31.36.0-255,66,39400,8,303160
831,0.000779,172.217.194.0-255,2902,42302,8,303160
832,0.000781,172.31.36.0-255,66,42368,8,303160
833,0.000786,172.217.194.0-255,4320,46688,8,303160
834,0.000793,172.31.36.0-255,66,46754,8,303160
835,0.000823,172.217.194.0-255,1484,48238,8,303160
836,0.00084,172.31.36.0-255,66,48304,8,303160
837,0.000866,172.217.194.0-255,4320,52624,8,303160
838,0.000868,172.31.36.0-255,66,52690,8,303160
839,0.000895,172.31.36.0-255,66,52756,8,303160
840,0.001473,172.217.194.0-255,1484,54240,8,303160
841,0.00148,172.217.194.0-255,2902,57142,8,303160
842,0.001483,172.31.36.0-255,66,57208,8,303160
843,0.00149,172.217.194.0-255,5738,62946,8,303160
844,0.001492,172.31.36.0-255,66,63012,8,303160
845,0.001536,172.217.194.0-255,6797,69809,8,303160
846,0.001539,172.31.36.0-255,66,69875,8,303160
847,0.001563,172.217.194.0-255,7156,77031,8,303160
848,0.001565,172.31.36.0-255,66,77097,8,303160
849,0.001569,172.217.194.0-255,1484,78581,8,303160
850,0.001599,172.217.194.0-255,7156,85737,8,303160
851,0.001602,172.31.36.0-255,66,85803,8,303160
852,0.001605,172.217.194.0-255,1125,86928,8,303160
853,0.001885,172.31.36.0-255,66,86994,8,303160
854,0.001932,172.217.194.0-255,1484,88478,8,303160
855,0.001938,172.217.194.0-255,2902,91380,8,303160
856,0.00194,172.31.36.0-255,66,91446,8,303160
857,0.001944,172.217.194.0-255,1484,92930,8,303160
858,0.001971,172.217.194.0-255,4320,97250,8,303160
859,0.001974,172.31.36.0-255,66,97316,8,303160
860,0.001982,172.217.194.0-255,7156,104472,8,303160
861,0.001984,172.31.36.0-255,66,104538,8,303160
862,0.002001,172.217.194.0-255,2902,107440,8,303160
863,0.002007,172.31.36.0-255,66,107506,8,303160
864,0.002039,172.31.36.0-255,66,107572,8,303160
865,0.002206,172.217.194.0-255,1484,109056,8,303160
866,0.002212,172.217.194.0-255,2902,111958,8,303160
867,0.002215,172.31.36.0-255,66,112024,8,303160
868,0.002222,172.217.194.0-255,5738,117762,8,303160
869,0.002224,172.31.36.0-255,66,117828,8,303160
870,0.002269,172.31.36.0-255,66,117894,8,303160
871,0.002276,172.217.194.0-255,5738,123632,8,303160
872,0.002278,172.31.36.0-255,66,123698,8,303160
873,0.002302,172.217.194.0-255,5020,128718,8,303160
874,0.002304,172.31.36.0-255,66,128784,8,303160
875,0.00232,172.31.36.0-255,66,128850,8,303160
876,0.002324,172.217.194.0-255,1484,130334,8,303160
877,0.00238,172.31.36.0-255,66,130400,8,303160
878,0.002388,172.31.36.0-255,66,130466,8,303160
879,0.004755,172.217.194.0-255,5738,136204,8,303160
880,0.004762,172.31.36.0-255,66,136270,8,303160
881,0.007101,172.217.194.0-255,5738,142008,8,303160
882,0.007105,172.31.36.0-255,66,142074,8,303160
883,0.009454,172.217.194.0-255,5738,147812,8,303160
884,0.009462,172.31.36.0-255,66,147878,8,303160
885,0.011827,172.217.194.0-255,5738,153616,8,303160
886,0.011835,172.31.36.0-255,66,153682,8,303160
887,0.014174,172.217.194.0-255,5738,159420,8,303160
888,0.014182,172.31.36.0-255,66,159486,8,303160
889,0.01651,172.217.194.0-255,5738,165224,8,303160
890,0.016517,172.31.36.0-255,66,165290,8,303160
891,0.018842,172.217.194.0-255,5738,171028,8,303160
892,0.018849,172.31.36.0-255,66,171094,8,303160
893,0.021184,172.217.194.0-255,5738,176832,8,303160
894,0.02119,172.31.36.0-255,66,176898,8,303160
895,0.023515,172.217.194.0-255,5738,182636,8,303160
896,0.023523,172.31.36.0-255,66,182702,8,303160
897,0.025849,172.217.194.0-255,5738,188440,8,303160
898,0.025856,172.31.36.0-255,66,188506,8,303160
899,0.028187,172.217.194.0-255,5738,194244,8,303160
900,0.028194,172.31.36.0-255,66,194310,8,303160
901,0.030525,172.217.194.0-255,5738,200048,8,303160
902,0.030533,172.31.36.0-255,66,200114,8,303160
903,0.032863,172.217.194.0-255,5738,205852,8,303160
904,0.032876,172.31.36.0-255,66,205918,8,303160
905,0.03529,172.217.194.0-255,5738,211656,8,303160
906,0.035297,172.31.36.0-255,66,211722,8,303160
907,0.035961,172.31.36.0-255,188,211910,8,303160
908,0.035994,172.31.36.0-255,955,212865,8,303160
909,0.03606,172.31.36.0-255,1514,214379,8,303160
910,0.036062,172.31.36.0-255,1514,215893,8,303160
911,0.036066,172.31.36.0-255,1514,217407,8,303160
912,0.036068,172.31.36.0-255,1514,218921,8,303160
913,0.036088,172.31.36.0-255,1514,220435,8,303160
914,0.036089,172.31.36.0-255,1031,221466,8,303160
915,0.037469,104.244.42.0-255,66,221532,8,303160
916,0.037498,104.244.42.0-255,66,221598,8,303160
917,0.037595,104.244.42.0-255,66,221664,8,303160
918,0.0376,104.244.42.0-255,66,221730,8,303160
919,0.037635,172.217.194.0-255,5738,227468,8,303160
920,0.03764,172.31.36.0-255,66,227534,8,303160
921,0.039972,172.217.194.0-255,5738,233272,8,303160
922,0.039982,172.31.36.0-255,66,233338,8,303160
923,0.042323,172.217.194.0-255,5738,239076,8,303160
924,0.04233,172.31.36.0-255,66,239142,8,303160
925,0.044678,172.217.194.0-255,5738,244880,8,303160
926,0.044684,172.31.36.0-255,66,244946,8,303160
927,0.04704,172.217.194.0-255,5738,250684,8,303160
928,0.04705,172.31.36.0-255,66,250750,8,303160
929,0.049394,172.217.194.0-255,5738,256488,8,303160
930,0.049404,172.31.36.0-255,66,256554,8,303160
931,0.051757,172.217.194.0-255,5738,262292,8,303160
932,0.051766,172.31.36.0-255,66,262358,8,303160
933,0.053903,172.31.36.0-255,108,262466,8,303160
934,0.054123,172.217.194.0-255,5738,268204,8,303160
935,0.05413,172.31.36.0-255,66,268270,8,303160
936,0.055382,104.244.42.0-255,66,268336,8,303160
937,0.05648,172.217.194.0-255,5738,274074,8,303160
938,0.056488,172.31.36.0-255,66,274140,8,303160
939,0.058832,172.217.194.0-255,5738,279878,8,303160
940,0.05884,172.31.36.0-255,66,279944,8,303160
941,0.061182,172.217.194.0-255,5738,285682,8,303160
942,0.061189,172.31.36.0-255,66,285748,8,303160
943,0.063524,172.217.194.0-255,5738,291486,8,303160
944,0.063531,172.31.36.0-255,66,291552,8,303160
945,0.065879,172.217.194.0-255,5738,297290,8,303160
946,0.065888,172.31.36.0-255,66,297356,8,303160
947,0.068208,172.217.194.0-255,5738,303094,8,303160
948,0.068217,172.31.36.0-255,66,303160,8,303160
949,0.0,172.217.194.0-255,152,152,8,201782
950,2.9e-05,172.31.36.0-255,66,218,8,201782
951,3.7e-05,172.217.194.0-255,1484,1702,8,201782
952,4.2e-05,172.31.36.0-255,66,1768,8,201782
953,4.6e-05,172.217.194.0-255,2902,4670,8,201782
954,4.8e-05,172.31.36.0-255,66,4736,8,201782
955,5.5e-05,172.217.194.0-255,7156,11892,8,201782
956,5.8e-05,172.31.36.0-255,66,11958,8,201782
957,9.7e-05,172.31.36.0-255,66,12024,8,201782
958,0.000119,172.217.194.0-255,3961,15985,8,201782
959,0.000122,172.31.36.0-255,66,16051,8,201782
960,0.000241,172.217.194.0-255,1484,17535,8,201782
961,0.000246,172.31.36.0-255,66,17601,8,201782
962,0.000251,172.217.194.0-255,2902,20503,8,201782
963,0.000254,172.31.36.0-255,66,20569,8,201782
964,0.000256,172.217.194.0-255,1484,22053,8,201782
965,0.000258,172.31.36.0-255,66,22119,8,201782
966,0.000287,172.217.194.0-255,2902,25021,8,201782
967,0.00029,172.31.36.0-255,66,25087,8,201782
968,0.000297,172.217.194.0-255,5738,30825,8,201782
969,0.0003,172.31.36.0-255,66,30891,8,201782
970,0.00032,172.217.194.0-255,4320,35211,8,201782
971,0.000324,172.31.36.0-255,66,35277,8,201782
972,0.000355,172.31.36.0-255,66,35343,8,201782
973,0.000361,172.217.194.0-255,5379,40722,8,201782
974,0.000363,172.31.36.0-255,66,40788,8,201782
975,0.00051,172.217.194.0-255,648,41436,8,201782
976,0.000516,172.31.36.0-255,66,41502,8,201782
977,0.000638,172.217.194.0-255,1484,42986,8,201782
978,0.000644,172.31.36.0-255,66,43052,8,201782
979,0.00065,172.217.194.0-255,2902,45954,8,201782
980,0.000652,172.31.36.0-255,66,46020,8,201782
981,0.000659,172.217.194.0-255,5738,51758,8,201782
982,0.000661,172.31.36.0-255,66,51824,8,201782
983,0.000692,172.31.36.0-255,66,51890,8,201782
984,0.000728,172.217.194.0-255,7156,59046,8,201782
985,0.000732,172.31.36.0-255,66,59112,8,201782
986,0.000754,172.31.36.0-255,66,59178,8,201782
987,0.000862,172.217.194.0-255,1484,60662,8,201782
988,0.000869,172.217.194.0-255,2902,63564,8,201782
989,0.000872,172.31.36.0-255,66,63630,8,201782
990,0.000877,172.217.194.0-255,2902,66532,8,201782
991,0.000879,172.31.36.0-255,66,66598,8,201782
992,0.000894,172.217.194.0-255,2902,69500,8,201782
993,0.000898,172.31.36.0-255,66,69566,8,201782
994,0.000905,172.217.194.0-255,5738,75304,8,201782
995,0.000907,172.31.36.0-255,66,75370,8,201782
996,0.000931,172.217.194.0-255,7156,82526,8,201782
997,0.000934,172.31.36.0-255,66,82592,8,201782
998,0.000946,172.31.36.0-255,66,82658,8,201782
999,0.000966,172.217.194.0-255,1484,84142,8,201782
1000,0.000999,172.31.36.0-255,66,84208,8,201782
1001,0.001048,172.31.36.0-255,66,84274,8,201782
1002,0.001061,172.217.194.0-255,2902,87176,8,201782
1003,0.001065,172.31.36.0-255,66,87242,8,201782
1004,0.001076,172.31.36.0-255,66,87308,8,201782
1005,0.001087,172.31.36.0-255,66,87374,8,201782
1006,0.001091,172.217.194.0-255,2902,90276,8,201782
1007,0.001094,172.31.36.0-255,66,90342,8,201782
1008,0.001123,172.31.36.0-255,66,90408,8,201782
1009,0.001126,172.217.194.0-255,1484,91892,8,201782
1010,0.001158,172.31.36.0-255,66,91958,8,201782
1011,0.001671,172.217.194.0-255,1484,93442,8,201782
1012,0.001675,172.217.194.0-255,2902,96344,8,201782
1013,0.001679,172.31.36.0-255,66,96410,8,201782
1014,0.001686,172.217.194.0-255,4320,100730,8,201782
1015,0.001688,172.31.36.0-255,66,100796,8,201782
1016,0.001701,172.217.194.0-255,1484,102280,8,201782
1017,0.001707,172.217.194.0-255,5738,108018,8,201782
1018,0.00171,172.31.36.0-255,66,108084,8,201782
1019,0.001738,172.217.194.0-255,7156,115240,8,201782
1020,0.001741,172.31.36.0-255,66,115306,8,201782
1021,0.001746,172.217.194.0-255,2902,118208,8,201782
1022,0.001748,172.31.36.0-255,66,118274,8,201782
1023,0.001773,172.31.36.0-255,66,118340,8,201782
1024,0.001801,172.217.194.0-255,1484,119824,8,201782
1025,0.001805,172.217.194.0-255,2902,122726,8,201782
1026,0.001808,172.31.36.0-255,66,122792,8,201782
1027,0.001827,172.217.194.0-255,5738,128530,8,201782
1028,0.00183,172.31.36.0-255,66,128596,8,201782
1029,0.001868,172.31.36.0-255,66,128662,8,201782
1030,0.001898,172.217.194.0-255,2902,131564,8,201782
1031,0.001902,172.31.36.0-255,66,131630,8,201782
1032,0.001933,172.31.36.0-255,66,131696,8,201782
1033,0.001956,172.217.194.0-255,1484,133180,8,201782
1034,0.001978,172.217.194.0-255,2902,136082,8,201782
1035,0.00198,172.31.36.0-255,66,136148,8,201782
1036,0.001985,172.217.194.0-255,2902,139050,8,201782
1037,0.001987,172.31.36.0-255,66,139116,8,201782
1038,0.002002,172.217.194.0-255,2902,142018,8,201782
1039,0.002005,172.31.36.0-255,66,142084,8,201782
1040,0.002008,172.217.194.0-255,1484,143568,8,201782
1041,0.002014,172.217.194.0-255,5738,149306,8,201782
1042,0.002016,172.31.36.0-255,66,149372,8,201782
1043,0.002034,172.217.194.0-255,2902,152274,8,201782
1044,0.002037,172.31.36.0-255,66,152340,8,201782
1045,0.002056,172.31.36.0-255,66,152406,8,201782
1046,0.002075,172.217.194.0-255,5020,157426,8,201782
1047,0.002078,172.31.36.0-255,66,157492,8,201782
1048,0.002097,172.217.194.0-255,4320,161812,8,201782
1049,0.002099,172.31.36.0-255,66,161878,8,201782
1050,0.002123,172.217.194.0-255,7156,169034,8,201782
1051,0.002126,172.31.36.0-255,66,169100,8,201782
1052,0.002132,172.217.194.0-255,5738,174838,8,201782
1053,0.002134,172.31.36.0-255,66,174904,8,201782
1054,0.002155,172.217.194.0-255,7156,182060,8,201782
1055,0.002158,172.31.36.0-255,66,182126,8,201782
1056,0.002171,172.31.36.0-255,66,182192,8,201782
1057,0.002212,172.217.194.0-255,5738,187930,8,201782
1058,0.002215,172.31.36.0-255,66,187996,8,201782
1059,0.002248,172.217.194.0-255,7156,195152,8,201782
1060,0.002252,172.31.36.0-255,66,195218,8,201782
1061,0.002259,172.31.36.0-255,66,195284,8,201782
1062,0.002272,172.31.36.0-255,66,195350,8,201782
1063,0.002284,172.31.36.0-255,66,195416,8,201782
1064,0.002302,172.217.194.0-255,2902,198318,8,201782
1065,0.002305,172.31.36.0-255,66,198384,8,201782
1066,0.002348,172.31.36.0-255,66,198450,8,201782
1067,0.002351,172.217.194.0-255,105,198555,8,201782
1068,0.003726,172.31.36.0-255,66,198621,8,201782
1069,0.003754,172.31.36.0-255,105,198726,8,201782
1070,0.006276,172.217.194.0-255,66,198792,8,201782
1071,0.033087,172.31.36.0-255,188,198980,8,201782
1072,0.033126,172.31.36.0-255,955,199935,8,201782
1073,0.033162,172.31.36.0-255,1514,201449,8,201782
1074,0.033164,172.31.36.0-255,135,201584,8,201782
1075,0.0346,104.244.42.0-255,66,201650,8,201782
1076,0.034639,104.244.42.0-255,66,201716,8,201782
1077,0.034687,104.244.42.0-255,66,201782,8,201782
1078,0.0,172.217.194.0-255,145,145,8,279604
1079,1.6e-05,172.31.36.0-255,66,211,8,279604
1080,2.3e-05,172.217.194.0-255,1484,1695,8,279604
1081,2.8e-05,172.31.36.0-255,66,1761,8,279604
1082,4.1e-05,172.217.194.0-255,2902,4663,8,279604
1083,4.5e-05,172.31.36.0-255,66,4729,8,279604
1084,5.1e-05,172.217.194.0-255,7156,11885,8,279604
1085,5.5e-05,172.31.36.0-255,66,11951,8,279604
1086,7.7e-05,172.217.194.0-255,2076,14027,8,279604
1087,8.3e-05,172.31.36.0-255,66,14093,8,279604
1088,9.8e-05,172.31.36.0-255,66,14159,8,279604
1089,0.000132,172.217.194.0-255,5379,19538,8,279604
1090,0.000135,172.31.36.0-255,66,19604,8,279604
1091,0.000277,172.217.194.0-255,1484,21088,8,279604
1092,0.000281,172.31.36.0-255,66,21154,8,279604
1093,0.000286,172.217.194.0-255,2902,24056,8,279604
1094,0.000288,172.31.36.0-255,66,24122,8,279604
1095,0.000299,172.217.194.0-255,5738,29860,8,279604
1096,0.000302,172.31.36.0-255,66,29926,8,279604
1097,0.000305,172.217.194.0-255,1484,31410,8,279604
1098,0.000308,172.31.36.0-255,66,31476,8,279604
1099,0.000339,172.217.194.0-255,4320,35796,8,279604
1100,0.000341,172.31.36.0-255,66,35862,8,279604
1101,0.000348,172.217.194.0-255,5738,41600,8,279604
1102,0.000351,172.31.36.0-255,66,41666,8,279604
1103,0.000396,172.31.36.0-255,66,41732,8,279604
1104,0.0004,172.217.194.0-255,114,41846,8,279604
1105,0.000402,172.31.36.0-255,66,41912,8,279604
1106,0.000483,172.217.194.0-255,386,42298,8,279604
1107,0.000486,172.31.36.0-255,66,42364,8,279604
1108,0.000629,172.217.194.0-255,1484,43848,8,279604
1109,0.000636,172.217.194.0-255,2902,46750,8,279604
1110,0.00064,172.31.36.0-255,66,46816,8,279604
1111,0.000675,172.217.194.0-255,5738,52554,8,279604
1112,0.000678,172.31.36.0-255,66,52620,8,279604
1113,0.000684,172.217.194.0-255,6248,58868,8,279604
1114,0.000687,172.31.36.0-255,66,58934,8,279604
1115,0.000889,172.217.194.0-255,1484,60418,8,279604
1116,0.000894,172.217.194.0-255,2902,63320,8,279604
1117,0.000898,172.31.36.0-255,66,63386,8,279604
1118,0.000935,172.217.194.0-255,5738,69124,8,279604
1119,0.000941,172.31.36.0-255,66,69190,8,279604
1120,0.000962,172.217.194.0-255,5738,74928,8,279604
1121,0.000964,172.31.36.0-255,66,74994,8,279604
1122,0.000969,172.217.194.0-255,4320,79314,8,279604
1123,0.000972,172.31.36.0-255,66,79380,8,279604
1124,0.00101,172.31.36.0-255,66,79446,8,279604
1125,0.001017,172.217.194.0-255,5020,84466,8,279604
1126,0.001019,172.31.36.0-255,66,84532,8,279604
1127,0.001092,172.217.194.0-255,1484,86016,8,279604
1128,0.001104,172.217.194.0-255,2902,88918,8,279604
1129,0.001108,172.31.36.0-255,66,88984,8,279604
1130,0.001138,172.217.194.0-255,5738,94722,8,279604
1131,0.001142,172.31.36.0-255,66,94788,8,279604
1132,0.001156,172.31.36.0-255,66,94854,8,279604
1133,0.001173,172.31.36.0-255,66,94920,8,279604
1134,0.001176,172.217.194.0-255,766,95686,8,279604
1135,0.001238,172.217.194.0-255,1484,97170,8,279604
1136,0.00124,172.31.36.0-255,66,97236,8,279604
1137,0.001246,172.217.194.0-255,4320,101556,8,279604
1138,0.001249,172.31.36.0-255,66,101622,8,279604
1139,0.001264,172.31.36.0-255,66,101688,8,279604
1140,0.001276,172.31.36.0-255,66,101754,8,279604
1141,0.001336,172.31.36.0-255,66,101820,8,279604
1142,0.001384,172.217.194.0-255,1484,103304,8,279604
1143,0.001397,172.217.194.0-255,2902,106206,8,279604
1144,0.001402,172.31.36.0-255,66,106272,8,279604
1145,0.001437,172.217.194.0-255,5738,112010,8,279604
1146,0.00144,172.31.36.0-255,66,112076,8,279604
1147,0.001477,172.31.36.0-255,66,112142,8,279604
1148,0.001489,172.31.36.0-255,66,112208,8,279604
1149,0.001522,172.217.194.0-255,2184,114392,8,279604
1150,0.001525,172.31.36.0-255,66,114458,8,279604
1151,0.001789,172.217.194.0-255,1484,115942,8,279604
1152,0.001805,172.217.194.0-255,2902,118844,8,279604
1153,0.001809,172.31.36.0-255,66,118910,8,279604
1154,0.001816,172.217.194.0-255,5738,124648,8,279604
1155,0.001818,172.31.36.0-255,66,124714,8,279604
1156,0.001857,172.31.36.0-255,66,124780,8,279604
1157,0.001892,172.31.36.0-255,66,124846,8,279604
1158,0.00191,172.217.194.0-255,2184,127030,8,279604
1159,0.001912,172.31.36.0-255,66,127096,8,279604
1160,0.004489,172.217.194.0-255,5738,132834,8,279604
1161,0.004497,172.31.36.0-255,66,132900,8,279604
1162,0.007035,172.217.194.0-255,4320,137220,8,279604
1163,0.007039,172.31.36.0-255,66,137286,8,279604
1164,0.007067,172.217.194.0-255,1484,138770,8,279604
1165,0.00959,172.217.194.0-255,4320,143090,8,279604
1166,0.009598,172.31.36.0-255,66,143156,8,279604
1167,0.01214,172.217.194.0-255,4320,147476,8,279604
1168,0.012148,172.31.36.0-255,66,147542,8,279604
1169,0.012198,172.217.194.0-255,1484,149026,8,279604
1170,0.0147,172.217.194.0-255,4320,153346,8,279604
1171,0.014708,172.31.36.0-255,66,153412,8,279604
1172,0.017252,172.217.194.0-255,5738,159150,8,279604
1173,0.017261,172.31.36.0-255,66,159216,8,279604
1174,0.0198,172.217.194.0-255,5738,164954,8,279604
1175,0.019809,172.31.36.0-255,66,165020,8,279604
1176,0.022345,172.217.194.0-255,5738,170758,8,279604
1177,0.022355,172.31.36.0-255,66,170824,8,279604
1178,0.024916,172.217.194.0-255,5738,176562,8,279604
1179,0.024925,172.31.36.0-255,66,176628,8,279604
1180,0.027468,172.217.194.0-255,5738,182366,8,279604
1181,0.027475,172.31.36.0-255,66,182432,8,279604
1182,0.030038,172.217.194.0-255,5738,188170,8,279604
1183,0.030045,172.31.36.0-255,66,188236,8,279604
1184,0.032574,172.217.194.0-255,5738,193974,8,279604
1185,0.032583,172.31.36.0-255,66,194040,8,279604
1186,0.035157,172.217.194.0-255,5738,199778,8,279604
1187,0.035165,172.31.36.0-255,66,199844,8,279604
1188,0.035912,172.31.36.0-255,192,200036,8,279604
1189,0.035945,172.31.36.0-255,1111,201147,8,279604
1190,0.03601,172.31.36.0-255,1514,202661,8,279604
1191,0.036012,172.31.36.0-255,1293,203954,8,279604
1192,0.037479,104.244.42.0-255,66,204020,8,279604
1193,0.037507,104.244.42.0-255,66,204086,8,279604
1194,0.03756,104.244.42.0-255,66,204152,8,279604
1195,0.037722,172.217.194.0-255,5738,209890,8,279604
1196,0.037728,172.31.36.0-255,66,209956,8,279604
1197,0.040294,172.217.194.0-255,5738,215694,8,279604
1198,0.040301,172.31.36.0-255,66,215760,8,279604
1199,0.042868,172.217.194.0-255,5738,221498,8,279604
1200,0.042875,172.31.36.0-255,66,221564,8,279604
1201,0.045444,172.217.194.0-255,5738,227302,8,279604
1202,0.04545,172.31.36.0-255,66,227368,8,279604
1203,0.048013,172.217.194.0-255,5738,233106,8,279604
1204,0.04802,172.31.36.0-255,66,233172,8,279604
1205,0.050576,172.217.194.0-255,5738,238910,8,279604
1206,0.05059,172.31.36.0-255,66,238976,8,279604
1207,0.053145,172.217.194.0-255,5738,244714,8,279604
1208,0.05316,172.31.36.0-255,66,244780,8,279604
1209,0.055697,172.217.194.0-255,5738,250518,8,279604
1210,0.055704,172.31.36.0-255,66,250584,8,279604
1211,0.058269,172.217.194.0-255,5738,256322,8,279604
1212,0.058275,172.31.36.0-255,66,256388,8,279604
1213,0.060805,172.217.194.0-255,5738,262126,8,279604
1214,0.060812,172.31.36.0-255,66,262192,8,279604
1215,0.063364,172.217.194.0-255,5738,267930,8,279604
1216,0.063371,172.31.36.0-255,66,267996,8,279604
1217,0.065928,172.217.194.0-255,5738,273734,8,279604
1218,0.065936,172.31.36.0-255,66,273800,8,279604
1219,0.068496,172.217.194.0-255,5738,279538,8,279604
1220,0.068504,172.31.36.0-255,66,279604,8,279604
1221,0.0,172.217.160.0-255,150,150,8,348228
1222,2.8e-05,172.31.36.0-255,66,216,8,348228
1223,3.5e-05,172.217.160.0-255,1484,1700,8,348228
1224,4e-05,172.31.36.0-255,66,1766,8,348228
1225,4.5e-05,172.217.160.0-255,2902,4668,8,348228
1226,4.7e-05,172.31.36.0-255,66,4734,8,348228
1227,6.1e-05,172.217.160.0-255,7156,11890,8,348228
1228,6.4e-05,172.31.36.0-255,66,11956,8,348228
1229,6.8e-05,172.217.160.0-255,2019,13975,8,348228
1230,6.9e-05,172.31.36.0-255,66,14041,8,348228
1231,0.000112,172.217.160.0-255,1484,15525,8,348228
1232,0.000115,172.31.36.0-255,66,15591,8,348228
1233,0.00012,172.217.160.0-255,2902,18493,8,348228
1234,0.000122,172.31.36.0-255,66,18559,8,348228
1235,0.000127,172.217.160.0-255,2902,21461,8,348228
1236,0.000129,172.31.36.0-255,66,21527,8,348228
1237,0.000147,172.217.160.0-255,2902,24429,8,348228
1238,0.00015,172.31.36.0-255,66,24495,8,348228
1239,0.000157,172.217.160.0-255,6797,31292,8,348228
1240,0.000163,172.31.36.0-255,66,31358,8,348228
1241,0.000213,172.217.160.0-255,7156,38514,8,348228
1242,0.000216,172.31.36.0-255,66,38580,8,348228
1243,0.000234,172.31.36.0-255,66,38646,8,348228
1244,0.000651,172.217.160.0-255,1484,40130,8,348228
1245,0.000656,172.31.36.0-255,66,40196,8,348228
1246,0.000662,172.217.160.0-255,2902,43098,8,348228
1247,0.000664,172.31.36.0-255,66,43164,8,348228
1248,0.000693,172.217.160.0-255,5738,48902,8,348228
1249,0.000696,172.31.36.0-255,66,48968,8,348228
1250,0.000725,172.217.160.0-255,5738,54706,8,348228
1251,0.000729,172.31.36.0-255,66,54772,8,348228
1252,0.000756,172.217.160.0-255,1735,56507,8,348228
1253,0.000759,172.31.36.0-255,66,56573,8,348228
1254,0.000792,172.217.160.0-255,1484,58057,8,348228
1255,0.000797,172.217.160.0-255,1484,59541,8,348228
1256,0.0008,172.31.36.0-255,66,59607,8,348228
1257,0.000829,172.217.160.0-255,1484,61091,8,348228
1258,0.000836,172.217.160.0-255,5738,66829,8,348228
1259,0.000839,172.31.36.0-255,66,66895,8,348228
1260,0.000877,172.31.36.0-255,66,66961,8,348228
1261,0.000895,172.217.160.0-255,2543,69504,8,348228
1262,0.000898,172.217.160.0-255,1484,70988,8,348228
1263,0.0009,172.31.36.0-255,66,71054,8,348228
1264,0.000911,172.217.160.0-255,4320,75374,8,348228
1265,0.000914,172.31.36.0-255,66,75440,8,348228
1266,0.00094,172.217.160.0-255,3961,79401,8,348228
1267,0.000944,172.31.36.0-255,66,79467,8,348228
1268,0.001364,172.217.160.0-255,1484,80951,8,348228
1269,0.001374,172.217.160.0-255,2902,83853,8,348228
1270,0.001378,172.31.36.0-255,66,83919,8,348228
1271,0.001386,172.217.160.0-255,5738,89657,8,348228
1272,0.001388,172.31.36.0-255,66,89723,8,348228
1273,0.001401,172.217.160.0-255,5738,95461,8,348228
1274,0.001404,172.31.36.0-255,66,95527,8,348228
1275,0.00143,172.217.160.0-255,1484,97011,8,348228
1276,0.001447,172.31.36.0-255,66,97077,8,348228
1277,0.001472,172.217.160.0-255,5738,102815,8,348228
1278,0.001475,172.31.36.0-255,66,102881,8,348228
1279,0.00148,172.217.160.0-255,2184,105065,8,348228
1280,0.001481,172.31.36.0-255,66,105131,8,348228
1281,0.003113,172.217.160.0-255,5738,110869,8,348228
1282,0.00312,172.31.36.0-255,66,110935,8,348228
1283,0.004742,172.217.160.0-255,5738,116673,8,348228
1284,0.004745,172.31.36.0-255,66,116739,8,348228
1285,0.006371,172.217.160.0-255,5738,122477,8,348228
1286,0.006374,172.31.36.0-255,66,122543,8,348228
1287,0.008013,172.217.160.0-255,5738,128281,8,348228
1288,0.008019,172.31.36.0-255,66,128347,8,348228
1289,0.009662,172.217.160.0-255,5738,134085,8,348228
1290,0.009669,172.31.36.0-255,66,134151,8,348228
1291,0.011466,172.217.160.0-255,5738,139889,8,348228
1292,0.011493,172.31.36.0-255,66,139955,8,348228
1293,0.01312,172.217.160.0-255,5738,145693,8,348228
1294,0.013126,172.31.36.0-255,66,145759,8,348228
1295,0.014751,172.217.160.0-255,5738,151497,8,348228
1296,0.014756,172.31.36.0-255,66,151563,8,348228
1297,0.016393,172.217.160.0-255,5738,157301,8,348228
1298,0.016402,172.31.36.0-255,66,157367,8,348228
1299,0.018034,172.217.160.0-255,5738,163105,8,348228
1300,0.018041,172.31.36.0-255,66,163171,8,348228
1301,0.019672,172.217.160.0-255,5738,168909,8,348228
1302,0.019679,172.31.36.0-255,66,168975,8,348228
1303,0.0213,172.217.160.0-255,5738,174713,8,348228
1304,0.021306,172.31.36.0-255,66,174779,8,348228
1305,0.022926,172.217.160.0-255,5738,180517,8,348228
1306,0.022933,172.31.36.0-255,66,180583,8,348228
1307,0.0246,172.217.160.0-255,5738,186321,8,348228
1308,0.024606,172.31.36.0-255,66,186387,8,348228
1309,0.026246,172.217.160.0-255,5738,192125,8,348228
1310,0.026252,172.31.36.0-255,66,192191,8,348228
1311,0.027888,172.217.160.0-255,5738,197929,8,348228
1312,0.027895,172.31.36.0-255,66,197995,8,348228
1313,0.029534,172.217.160.0-255,5738,203733,8,348228
1314,0.02954,172.31.36.0-255,66,203799,8,348228
1315,0.031164,172.217.160.0-255,5738,209537,8,348228
1316,0.031171,172.31.36.0-255,66,209603,8,348228
1317,0.032798,172.217.160.0-255,5738,215341,8,348228
1318,0.032805,172.31.36.0-255,66,215407,8,348228
1319,0.03444,172.217.160.0-255,5738,221145,8,348228
1320,0.034446,172.31.36.0-255,66,221211,8,348228
1321,0.035122,172.31.36.0-255,172,221383,8,348228
1322,0.035158,172.31.36.0-255,1112,222495,8,348228
1323,0.035204,172.31.36.0-255,1514,224009,8,348228
1324,0.035206,172.31.36.0-255,1514,225523,8,348228
1325,0.03521,172.31.36.0-255,1514,227037,8,348228
1326,0.035211,172.31.36.0-255,1514,228551,8,348228
1327,0.035234,172.31.36.0-255,167,228718,8,348228
1328,0.036082,172.217.160.0-255,5738,234456,8,348228
1329,0.036089,172.31.36.0-255,66,234522,8,348228
1330,0.036644,104.244.42.0-255,66,234588,8,348228
1331,0.036708,104.244.42.0-255,66,234654,8,348228
1332,0.036788,104.244.42.0-255,66,234720,8,348228
1333,0.036794,104.244.42.0-255,66,234786,8,348228
1334,0.036809,104.244.42.0-255,66,234852,8,348228
1335,0.037731,172.217.160.0-255,5738,240590,8,348228
1336,0.037737,172.31.36.0-255,66,240656,8,348228
1337,0.039367,172.217.160.0-255,5738,246394,8,348228
1338,0.039373,172.31.36.0-255,66,246460,8,348228
1339,0.040996,172.217.160.0-255,5738,252198,8,348228
1340,0.041016,172.31.36.0-255,66,252264,8,348228
1341,0.042643,172.217.160.0-255,4320,256584,8,348228
1342,0.042648,172.31.36.0-255,66,256650,8,348228
1343,0.042678,172.217.160.0-255,1484,258134,8,348228
1344,0.044263,172.217.160.0-255,4320,262454,8,348228
1345,0.044269,172.31.36.0-255,66,262520,8,348228
1346,0.0459,172.217.160.0-255,5738,268258,8,348228
1347,0.045905,172.31.36.0-255,66,268324,8,348228
1348,0.047525,172.217.160.0-255,5738,274062,8,348228
1349,0.04753,172.31.36.0-255,66,274128,8,348228
1350,0.049155,172.217.160.0-255,5738,279866,8,348228
1351,0.04916,172.31.36.0-255,66,279932,8,348228
1352,0.050785,172.217.160.0-255,5738,285670,8,348228
1353,0.05079,172.31.36.0-255,66,285736,8,348228
1354,0.052421,172.217.160.0-255,5738,291474,8,348228
1355,0.052428,172.31.36.0-255,66,291540,8,348228
1356,0.054051,172.217.160.0-255,5738,297278,8,348228
1357,0.054056,172.31.36.0-255,66,297344,8,348228
1358,0.055672,172.217.160.0-255,5738,303082,8,348228
1359,0.055677,172.31.36.0-255,66,303148,8,348228
1360,0.057308,172.217.160.0-255,5738,308886,8,348228
1361,0.057313,172.31.36.0-255,66,308952,8,348228
1362,0.058943,172.217.160.0-255,5738,314690,8,348228
1363,0.058948,172.31.36.0-255,66,314756,8,348228
1364,0.060576,172.217.160.0-255,5738,320494,8,348228
1365,0.060581,172.31.36.0-255,66,320560,8,348228
1366,0.062216,172.217.160.0-255,5738,326298,8,348228
1367,0.062221,172.31.36.0-255,66,326364,8,348228
1368,0.063843,172.217.160.0-255,5738,332102,8,348228
1369,0.063849,172.31.36.0-255,66,332168,8,348228
1370,0.065478,172.217.160.0-255,5738,337906,8,348228
1371,0.065483,172.31.36.0-255,66,337972,8,348228
1372,0.067118,172.217.160.0-255,4320,342292,8,348228
1373,0.067122,172.31.36.0-255,66,342358,8,348228
1374,0.067152,172.217.160.0-255,1484,343842,8,348228
1375,0.068743,172.217.160.0-255,4320,348162,8,348228
1376,0.068748,172.31.36.0-255,66,348228,8,348228
1377,0.0,172.217.194.0-255,146,146,8,245519
1378,4e-05,172.31.36.0-255,66,212,8,245519
1379,4.8e-05,172.217.194.0-255,1484,1696,8,245519
1380,5.2e-05,172.31.36.0-255,66,1762,8,245519
1381,5.7e-05,172.217.194.0-255,2902,4664,8,245519
1382,7e-05,172.31.36.0-255,66,4730,8,245519
1383,7.8e-05,172.217.194.0-255,7156,11886,8,245519
1384,8.1e-05,172.31.36.0-255,66,11952,8,245519
1385,0.000117,172.217.194.0-255,2104,14056,8,245519
1386,0.000121,172.31.36.0-255,66,14122,8,245519
1387,0.000412,172.217.194.0-255,1484,15606,8,245519
1388,0.000418,172.31.36.0-255,66,15672,8,245519
1389,0.000424,172.217.194.0-255,2902,18574,8,245519
1390,0.000427,172.31.36.0-255,66,18640,8,245519
1391,0.000441,172.217.194.0-255,5738,24378,8,245519
1392,0.000446,172.31.36.0-255,66,24444,8,245519
1393,0.000453,172.217.194.0-255,5738,30182,8,245519
1394,0.000455,172.31.36.0-255,66,30248,8,245519
1395,0.000482,172.217.194.0-255,1125,31373,8,245519
1396,0.000488,172.31.36.0-255,66,31439,8,245519
1397,0.000489,172.217.194.0-255,7156,38595,8,245519
1398,0.000493,172.31.36.0-255,66,38661,8,245519
1399,0.000513,172.217.194.0-255,7156,45817,8,245519
1400,0.000517,172.31.36.0-255,66,45883,8,245519
1401,0.000551,172.217.194.0-255,2543,48426,8,245519
1402,0.000555,172.31.36.0-255,66,48492,8,245519
1403,0.002015,172.217.194.0-255,1484,49976,8,245519
1404,0.002022,172.31.36.0-255,66,50042,8,245519
1405,0.002032,172.217.194.0-255,2902,52944,8,245519
1406,0.002034,172.31.36.0-255,66,53010,8,245519
1407,0.002046,172.217.194.0-255,5738,58748,8,245519
1408,0.002048,172.31.36.0-255,66,58814,8,245519
1409,0.002064,172.217.194.0-255,1484,60298,8,245519
1410,0.002093,172.217.194.0-255,6797,67095,8,245519
1411,0.002095,172.31.36.0-255,66,67161,8,245519
1412,0.002105,172.31.36.0-255,66,67227,8,245519
1413,0.002142,172.31.36.0-255,66,67293,8,245519
1414,0.002171,172.217.194.0-255,7156,74449,8,245519
1415,0.002173,172.31.36.0-255,66,74515,8,245519
1416,0.002178,172.217.194.0-255,5020,79535,8,245519
1417,0.00218,172.31.36.0-255,66,79601,8,245519
1418,0.002183,172.217.194.0-255,1484,81085,8,245519
1419,0.002217,172.217.194.0-255,2902,83987,8,245519
1420,0.00222,172.31.36.0-255,66,84053,8,245519
1421,0.002225,172.217.194.0-255,5738,89791,8,245519
1422,0.002227,172.31.36.0-255,66,89857,8,245519
1423,0.002259,172.217.194.0-255,6682,96539,8,245519
1424,0.002263,172.31.36.0-255,66,96605,8,245519
1425,0.002704,172.217.194.0-255,1484,98089,8,245519
1426,0.004903,172.217.194.0-255,4320,102409,8,245519
1427,0.004909,172.31.36.0-255,66,102475,8,245519
1428,0.007558,172.217.194.0-255,5738,108213,8,245519
1429,0.00757,172.31.36.0-255,66,108279,8,245519
1430,0.010211,172.217.194.0-255,5738,114017,8,245519
1431,0.010224,172.31.36.0-255,66,114083,8,245519
1432,0.012854,172.217.194.0-255,5738,119821,8,245519
1433,0.012871,172.31.36.0-255,66,119887,8,245519
1434,0.015505,172.217.194.0-255,5738,125625,8,245519
1435,0.015516,172.31.36.0-255,66,125691,8,245519
1436,0.018136,172.217.194.0-255,5738,131429,8,245519
1437,0.018146,172.31.36.0-255,66,131495,8,245519
1438,0.02079,172.217.194.0-255,5738,137233,8,245519
1439,0.020799,172.31.36.0-255,66,137299,8,245519
1440,0.023436,172.217.194.0-255,5738,143037,8,245519
1441,0.023445,172.31.36.0-255,66,143103,8,245519
1442,0.024067,172.31.36.0-255,171,143274,8,245519
1443,0.024099,172.31.36.0-255,1135,144409,8,245519
1444,0.024159,172.31.36.0-255,1514,145923,8,245519
1445,0.024161,172.31.36.0-255,730,146653,8,245519
1446,0.025653,104.244.42.0-255,66,146719,8,245519
1447,0.025721,104.244.42.0-255,66,146785,8,245519
1448,0.025741,104.244.42.0-255,66,146851,8,245519
1449,0.026095,172.217.194.0-255,5738,152589,8,245519
1450,0.026101,172.31.36.0-255,66,152655,8,245519
1451,0.02873,172.217.194.0-255,5738,158393,8,245519
1452,0.028737,172.31.36.0-255,66,158459,8,245519
1453,0.031374,172.217.194.0-255,5738,164197,8,245519
1454,0.031382,172.31.36.0-255,66,164263,8,245519
1455,0.034043,172.217.194.0-255,5738,170001,8,245519
1456,0.034059,172.31.36.0-255,66,170067,8,245519
1457,0.036696,172.217.194.0-255,5738,175805,8,245519
1458,0.036705,172.31.36.0-255,66,175871,8,245519
1459,0.039388,172.217.194.0-255,5738,181609,8,245519
1460,0.0394,172.31.36.0-255,66,181675,8,245519
1461,0.042035,172.217.194.0-255,5738,187413,8,245519
1462,0.042047,172.31.36.0-255,66,187479,8,245519
1463,0.044705,172.217.194.0-255,5738,193217,8,245519
1464,0.044716,172.31.36.0-255,66,193283,8,245519
1465,0.047371,172.217.194.0-255,5738,199021,8,245519
1466,0.047379,172.31.36.0-255,66,199087,8,245519
1467,0.05005,172.217.194.0-255,5738,204825,8,245519
1468,0.050058,172.31.36.0-255,66,204891,8,245519
1469,0.052686,172.217.194.0-255,5738,210629,8,245519
1470,0.052694,172.31.36.0-255,66,210695,8,245519
1471,0.055323,172.217.194.0-255,5738,216433,8,245519
1472,0.05533,172.31.36.0-255,66,216499,8,245519
1473,0.057955,172.217.194.0-255,5738,222237,8,245519
1474,0.057963,172.31.36.0-255,66,222303,8,245519
1475,0.060614,172.217.194.0-255,5738,228041,8,245519
1476,0.06062,172.31.36.0-255,66,228107,8,245519
1477,0.063239,172.217.194.0-255,5738,233845,8,245519
1478,0.063246,172.31.36.0-255,66,233911,8,245519
1479,0.065895,172.217.194.0-255,5738,239649,8,245519
1480,0.065909,172.31.36.0-255,66,239715,8,245519
1481,0.068568,172.217.194.0-255,5738,245453,8,245519
1482,0.068581,172.31.36.0-255,66,245519,8,245519
1483,0.0,172.217.194.0-255,150,150,8,300035
1484,2.4e-05,172.31.36.0-255,66,216,8,300035
1485,3.1e-05,172.217.194.0-255,1484,1700,8,300035
1486,3.4e-05,172.31.36.0-255,66,1766,8,300035
1487,3.8e-05,172.217.194.0-255,2902,4668,8,300035
1488,4.1e-05,172.31.36.0-255,66,4734,8,300035
1489,4.6e-05,172.217.194.0-255,7156,11890,8,300035
1490,4.9e-05,172.31.36.0-255,66,11956,8,300035
1491,5.3e-05,172.217.194.0-255,2016,13972,8,300035
1492,5.6e-05,172.31.36.0-255,66,14038,8,300035
1493,0.000111,172.31.36.0-255,66,14104,8,300035
1494,0.000131,172.217.194.0-255,2902,17006,8,300035
1495,0.000133,172.31.36.0-255,66,17072,8,300035
1496,0.000139,172.217.194.0-255,5379,22451,8,300035
1497,0.000141,172.31.36.0-255,66,22517,8,300035
1498,0.000167,172.217.194.0-255,5738,28255,8,300035
1499,0.00017,172.31.36.0-255,66,28321,8,300035
1500,0.000175,172.217.194.0-255,1484,29805,8,300035
1501,0.000176,172.31.36.0-255,66,29871,8,300035
1502,0.000194,172.217.194.0-255,5738,35609,8,300035
1503,0.000197,172.31.36.0-255,66,35675,8,300035
1504,0.00021,172.217.194.0-255,1484,37159,8,300035
1505,0.000212,172.31.36.0-255,66,37225,8,300035
1506,0.000238,172.217.194.0-255,2543,39768,8,300035
1507,0.00024,172.31.36.0-255,66,39834,8,300035
1508,0.000258,172.217.194.0-255,4320,44154,8,300035
1509,0.000261,172.31.36.0-255,66,44220,8,300035
1510,0.000266,172.217.194.0-255,5738,49958,8,300035
1511,0.000268,172.31.36.0-255,66,50024,8,300035
1512,0.000316,172.217.194.0-255,2902,52926,8,300035
1513,0.000318,172.31.36.0-255,66,52992,8,300035
1514,0.000332,172.217.194.0-255,4235,57227,8,300035
1515,0.000335,172.217.194.0-255,115,57342,8,300035
1516,0.000337,172.31.36.0-255,66,57408,8,300035
1517,0.000489,172.217.194.0-255,387,57795,8,300035
1518,0.000746,172.31.36.0-255,66,57861,8,300035
1519,0.00082,172.217.194.0-255,1484,59345,8,300035
1520,0.000835,172.217.194.0-255,2902,62247,8,300035
1521,0.000856,172.217.194.0-255,5738,67985,8,300035
1522,0.001143,172.217.194.0-255,1484,69469,8,300035
1523,0.001149,172.217.194.0-255,2902,72371,8,300035
1524,0.001152,172.217.194.0-255,1484,73855,8,300035
1525,0.001165,172.217.194.0-255,4320,78175,8,300035
1526,0.001179,172.217.194.0-255,1484,79659,8,300035
1527,0.001277,172.217.194.0-255,2184,81843,8,300035
1528,0.001768,172.217.194.0-255,1484,83327,8,300035
1529,0.001781,172.217.194.0-255,2902,86229,8,300035
1530,0.001787,172.217.194.0-255,5738,91967,8,300035
1531,0.001839,172.217.194.0-255,2902,94869,8,300035
1532,0.002039,172.217.194.0-255,1484,96353,8,300035
1533,0.002042,172.217.194.0-255,2902,99255,8,300035
1534,0.002058,172.217.194.0-255,4320,103575,8,300035
1535,0.002066,172.217.194.0-255,1484,105059,8,300035
1536,0.002078,172.217.194.0-255,4320,109379,8,300035
1537,0.002139,172.217.194.0-255,1484,110863,8,300035
1538,0.002208,172.217.194.0-255,5738,116601,8,300035
1539,0.002222,172.217.194.0-255,4320,120921,8,300035
1540,0.002232,172.217.194.0-255,2902,123823,8,300035
1541,0.002247,172.217.194.0-255,7156,130979,8,300035
1542,0.002263,172.217.194.0-255,7156,138135,8,300035
1543,0.002269,172.217.194.0-255,6438,144573,8,300035
1544,0.003396,172.31.36.0-255,66,144639,8,300035
1545,0.005665,172.217.194.0-255,5738,150377,8,300035
1546,0.00567,172.31.36.0-255,66,150443,8,300035
1547,0.007938,172.217.194.0-255,5738,156181,8,300035
1548,0.007943,172.31.36.0-255,66,156247,8,300035
1549,0.0102,172.217.194.0-255,5738,161985,8,300035
1550,0.010207,172.31.36.0-255,66,162051,8,300035
1551,0.012626,172.217.194.0-255,5738,167789,8,300035
1552,0.014637,172.31.36.0-255,66,167855,8,300035
1553,0.016938,172.217.194.0-255,5738,173593,8,300035
1554,0.016947,172.31.36.0-255,66,173659,8,300035
1555,0.019251,172.217.194.0-255,5738,179397,8,300035
1556,0.019257,172.31.36.0-255,66,179463,8,300035
1557,0.021539,172.217.194.0-255,5738,185201,8,300035
1558,0.021545,172.31.36.0-255,66,185267,8,300035
1559,0.023874,172.217.194.0-255,5738,191005,8,300035
1560,0.02388,172.31.36.0-255,66,191071,8,300035
1561,0.026154,172.217.194.0-255,5738,196809,8,300035
1562,0.026161,172.31.36.0-255,66,196875,8,300035
1563,0.028423,172.217.194.0-255,5738,202613,8,300035
1564,0.028432,172.31.36.0-255,66,202679,8,300035
1565,0.030714,172.217.194.0-255,5738,208417,8,300035
1566,0.030721,172.31.36.0-255,66,208483,8,300035
1567,0.033018,172.217.194.0-255,5738,214221,8,300035
1568,0.033025,172.31.36.0-255,66,214287,8,300035
1569,0.035297,172.217.194.0-255,5738,220025,8,300035
1570,0.035305,172.31.36.0-255,66,220091,8,300035
1571,0.037575,172.217.194.0-255,5738,225829,8,300035
1572,0.03758,172.31.36.0-255,66,225895,8,300035
1573,0.037983,172.31.36.0-255,188,226083,8,300035
1574,0.038011,172.31.36.0-255,955,227038,8,300035
1575,0.038046,172.31.36.0-255,1514,228552,8,300035
1576,0.038047,172.31.36.0-255,1514,230066,8,300035
1577,0.038053,172.31.36.0-255,1514,231580,8,300035
1578,0.038054,172.31.36.0-255,1514,233094,8,300035
1579,0.038083,172.31.36.0-255,1431,234525,8,300035
1580,0.039485,104.244.42.0-255,66,234591,8,300035
1581,0.039504,104.244.42.0-255,66,234657,8,300035
1582,0.039582,104.244.42.0-255,66,234723,8,300035
1583,0.039855,172.217.194.0-255,5738,240461,8,300035
1584,0.039858,172.31.36.0-255,66,240527,8,300035
1585,0.042115,172.217.194.0-255,5738,246265,8,300035
1586,0.04212,172.31.36.0-255,66,246331,8,300035
1587,0.044379,172.217.194.0-255,5738,252069,8,300035
1588,0.044385,172.31.36.0-255,66,252135,8,300035
1589,0.046656,172.217.194.0-255,2902,255037,8,300035
1590,0.046662,172.31.36.0-255,66,255103,8,300035
1591,0.04669,172.217.194.0-255,2902,258005,8,300035
1592,0.046711,172.31.36.0-255,66,258071,8,300035
1593,0.048909,172.217.194.0-255,2902,260973,8,300035
1594,0.048914,172.31.36.0-255,66,261039,8,300035
1595,0.048972,172.217.194.0-255,2902,263941,8,300035
1596,0.048994,172.31.36.0-255,66,264007,8,300035
1597,0.051158,172.217.194.0-255,2902,266909,8,300035
1598,0.051164,172.31.36.0-255,66,266975,8,300035
1599,0.051261,172.217.194.0-255,2902,269877,8,300035
1600,0.051384,172.31.36.0-255,66,269943,8,300035
1601,0.053428,172.217.194.0-255,2902,272845,8,300035
1602,0.053434,172.31.36.0-255,66,272911,8,300035
1603,0.053629,172.217.194.0-255,2902,275813,8,300035
1604,0.053635,172.31.36.0-255,66,275879,8,300035
1605,0.055702,172.217.194.0-255,2902,278781,8,300035
1606,0.055709,172.31.36.0-255,66,278847,8,300035
1607,0.055894,172.217.194.0-255,2902,281749,8,300035
1608,0.057174,172.31.36.0-255,66,281815,8,300035
1609,0.057978,172.217.194.0-255,2902,284717,8,300035
1610,0.057984,172.31.36.0-255,66,284783,8,300035
1611,0.059419,172.217.194.0-255,2902,287685,8,300035
1612,0.059425,172.31.36.0-255,66,287751,8,300035
1613,0.060236,172.217.194.0-255,2902,290653,8,300035
1614,0.060241,172.31.36.0-255,66,290719,8,300035
1615,0.061688,172.217.194.0-255,2902,293621,8,300035
1616,0.061693,172.31.36.0-255,66,293687,8,300035
1617,0.062517,172.217.194.0-255,2902,296589,8,300035
1618,0.062522,172.31.36.0-255,66,296655,8,300035
1619,0.063943,172.217.194.0-255,2902,299557,8,300035
1620,0.063948,172.31.36.0-255,66,299623,8,300035
1621,0.064738,172.217.194.0-255,175,299798,8,300035
1622,0.064887,172.31.36.0-255,66,299864,8,300035
1623,0.064917,172.31.36.0-255,105,299969,8,300035
1624,0.067137,172.217.194.0-255,66,300035,8,300035
1625,0.0,172.217.194.0-255,153,153,8,199343
1626,3.4e-05,172.31.36.0-255,66,219,8,199343
1627,4.1e-05,172.217.194.0-255,1484,1703,8,199343
1628,4.5e-05,172.31.36.0-255,66,1769,8,199343
1629,5e-05,172.217.194.0-255,2902,4671,8,199343
1630,6e-05,172.31.36.0-255,66,4737,8,199343
1631,6.8e-05,172.217.194.0-255,7156,11893,8,199343
1632,7e-05,172.31.36.0-255,66,11959,8,199343
1633,7.3e-05,172.217.194.0-255,1484,13443,8,199343
1634,7.5e-05,172.31.36.0-255,66,13509,8,199343
1635,7.8e-05,172.217.194.0-255,649,14158,8,199343
1636,8e-05,172.31.36.0-255,66,14224,8,199343
1637,0.000111,172.217.194.0-255,1484,15708,8,199343
1638,0.000114,172.31.36.0-255,66,15774,8,199343
1639,0.000119,172.217.194.0-255,4320,20094,8,199343
1640,0.000121,172.31.36.0-255,66,20160,8,199343
1641,0.000129,172.217.194.0-255,7156,27316,8,199343
1642,0.000132,172.31.36.0-255,66,27382,8,199343
1643,0.000158,172.217.194.0-255,2902,30284,8,199343
1644,0.00016,172.31.36.0-255,66,30350,8,199343
1645,0.000163,172.217.194.0-255,1125,31475,8,199343
1646,0.000165,172.31.36.0-255,66,31541,8,199343
1647,0.000178,172.31.36.0-255,66,31607,8,199343
1648,0.000205,172.217.194.0-255,2902,34509,8,199343
1649,0.000209,172.31.36.0-255,66,34575,8,199343
1650,0.000214,172.217.194.0-255,3961,38536,8,199343
1651,0.000216,172.31.36.0-255,66,38602,8,199343
1652,0.000222,172.217.194.0-255,4320,42922,8,199343
1653,0.000224,172.31.36.0-255,66,42988,8,199343
1654,0.000236,172.31.36.0-255,66,43054,8,199343
1655,0.000241,172.217.194.0-255,2543,45597,8,199343
1656,0.000243,172.31.36.0-255,66,45663,8,199343
1657,0.000291,172.217.194.0-255,711,46374,8,199343
1658,0.000472,172.217.194.0-255,1484,47858,8,199343
1659,0.000477,172.31.36.0-255,66,47924,8,199343
1660,0.000484,172.217.194.0-255,2902,50826,8,199343
1661,0.000486,172.31.36.0-255,66,50892,8,199343
1662,0.000498,172.217.194.0-255,5738,56630,8,199343
1663,0.0005,172.31.36.0-255,66,56696,8,199343
1664,0.000551,172.31.36.0-255,66,56762,8,199343
1665,0.000564,172.31.36.0-255,66,56828,8,199343
1666,0.000796,172.217.194.0-255,1484,58312,8,199343
1667,0.000802,172.217.194.0-255,2902,61214,8,199343
1668,0.000808,172.31.36.0-255,66,61280,8,199343
1669,0.000829,172.217.194.0-255,4320,65600,8,199343
1670,0.000832,172.31.36.0-255,66,65666,8,199343
1671,0.000859,172.217.194.0-255,1484,67150,8,199343
1672,0.000864,172.217.194.0-255,2902,70052,8,199343
1673,0.000867,172.31.36.0-255,66,70118,8,199343
1674,0.000901,172.31.36.0-255,66,70184,8,199343
1675,0.000912,172.217.194.0-255,1484,71668,8,199343
1676,0.000928,172.31.36.0-255,66,71734,8,199343
1677,0.000954,172.217.194.0-255,1632,73366,8,199343
1678,0.000957,172.31.36.0-255,66,73432,8,199343
1679,0.001045,172.217.194.0-255,1484,74916,8,199343
1680,0.001078,172.217.194.0-255,2902,77818,8,199343
1681,0.001083,172.31.36.0-255,66,77884,8,199343
1682,0.001109,172.217.194.0-255,5738,83622,8,199343
1683,0.001112,172.31.36.0-255,66,83688,8,199343
1684,0.001136,172.217.194.0-255,1484,85172,8,199343
1685,0.001165,172.31.36.0-255,66,85238,8,199343
1686,0.001169,172.217.194.0-255,1484,86722,8,199343
1687,0.00118,172.31.36.0-255,66,86788,8,199343
1688,0.001197,172.31.36.0-255,66,86854,8,199343
1689,0.001212,172.31.36.0-255,66,86920,8,199343
1690,0.001235,172.217.194.0-255,1484,88404,8,199343
1691,0.001242,172.217.194.0-255,6438,94842,8,199343
1692,0.001244,172.31.36.0-255,66,94908,8,199343
1693,0.001251,172.217.194.0-255,7156,102064,8,199343
1694,0.001254,172.31.36.0-255,66,102130,8,199343
1695,0.001269,172.31.36.0-255,66,102196,8,199343
1696,0.001279,172.31.36.0-255,66,102262,8,199343
1697,0.001306,172.217.194.0-255,3602,105864,8,199343
1698,0.001309,172.31.36.0-255,66,105930,8,199343
1699,0.001323,172.31.36.0-255,66,105996,8,199343
1700,0.001325,172.217.194.0-255,1484,107480,8,199343
1701,0.001406,172.31.36.0-255,66,107546,8,199343
1702,0.001412,172.217.194.0-255,3602,111148,8,199343
1703,0.001414,172.31.36.0-255,66,111214,8,199343
1704,0.001476,172.217.194.0-255,1484,112698,8,199343
1705,0.001499,172.217.194.0-255,2902,115600,8,199343
1706,0.001502,172.31.36.0-255,66,115666,8,199343
1707,0.001509,172.217.194.0-255,5738,121404,8,199343
1708,0.001512,172.31.36.0-255,66,121470,8,199343
1709,0.00153,172.31.36.0-255,66,121536,8,199343
1710,0.001573,172.217.194.0-255,5738,127274,8,199343
1711,0.001577,172.31.36.0-255,66,127340,8,199343
1712,0.001604,172.31.36.0-255,66,127406,8,199343
1713,0.001629,172.217.194.0-255,2902,130308,8,199343
1714,0.001633,172.31.36.0-255,66,130374,8,199343
1715,0.00166,172.217.194.0-255,4320,134694,8,199343
1716,0.001663,172.31.36.0-255,66,134760,8,199343
1717,0.001678,172.31.36.0-255,66,134826,8,199343
1718,0.001693,172.217.194.0-255,766,135592,8,199343
1719,0.001694,172.31.36.0-255,66,135658,8,199343
1720,0.001761,172.217.194.0-255,1484,137142,8,199343
1721,0.001765,172.31.36.0-255,66,137208,8,199343
1722,0.00177,172.217.194.0-255,2902,140110,8,199343
1723,0.001774,172.217.194.0-255,2902,143012,8,199343
1724,0.001779,172.31.36.0-255,66,143078,8,199343
1725,0.001807,172.217.194.0-255,2902,145980,8,199343
1726,0.001818,172.31.36.0-255,66,146046,8,199343
1727,0.001822,172.31.36.0-255,66,146112,8,199343
1728,0.001866,172.217.194.0-255,766,146878,8,199343
1729,0.00187,172.31.36.0-255,66,146944,8,199343
1730,0.004219,172.217.194.0-255,5738,152682,8,199343
1731,0.004226,172.31.36.0-255,66,152748,8,199343
1732,0.006511,172.217.194.0-255,5738,158486,8,199343
1733,0.006515,172.31.36.0-255,66,158552,8,199343
1734,0.008831,172.217.194.0-255,5738,164290,8,199343
1735,0.008837,172.31.36.0-255,66,164356,8,199343
1736,0.011132,172.217.194.0-255,5738,170094,8,199343
1737,0.01114,172.31.36.0-255,66,170160,8,199343
1738,0.013453,172.217.194.0-255,5738,175898,8,199343
1739,0.013461,172.31.36.0-255,66,175964,8,199343
1740,0.015773,172.217.194.0-255,5738,181702,8,199343
1741,0.015782,172.31.36.0-255,66,181768,8,199343
1742,0.018099,172.217.194.0-255,5738,187506,8,199343
1743,0.018114,172.31.36.0-255,66,187572,8,199343
1744,0.020438,172.217.194.0-255,2528,190100,8,199343
1745,0.020452,172.31.36.0-255,66,190166,8,199343
1746,0.020803,172.31.36.0-255,105,190271,8,199343
1747,0.023063,172.217.194.0-255,66,190337,8,199343
1748,0.036664,172.31.36.0-255,172,190509,8,199343
1749,0.036697,172.31.36.0-255,1112,191621,8,199343
1750,0.036746,172.31.36.0-255,1514,193135,8,199343
1751,0.036748,172.31.36.0-255,1514,194649,8,199343
1752,0.036752,172.31.36.0-255,1514,196163,8,199343
1753,0.036754,172.31.36.0-255,1514,197677,8,199343
1754,0.036781,172.31.36.0-255,1228,198905,8,199343
1755,0.038212,104.244.42.0-255,66,198971,8,199343
1756,0.038377,104.244.42.0-255,66,199037,8,199343
1757,0.038379,104.244.42.0-255,66,199103,8,199343
1758,0.038399,104.244.42.0-255,66,199169,8,199343
1759,0.038927,104.244.42.0-255,108,199277,8,199343
1760,0.038948,172.31.36.0-255,66,199343,8,199343
1761,0.0,172.217.194.0-255,153,153,8,235684
1762,1.4e-05,172.31.36.0-255,66,219,8,235684
1763,2.1e-05,172.217.194.0-255,1484,1703,8,235684
1764,2.6e-05,172.31.36.0-255,66,1769,8,235684
1765,3.1e-05,172.217.194.0-255,2902,4671,8,235684
1766,4.2e-05,172.31.36.0-255,66,4737,8,235684
1767,5.1e-05,172.217.194.0-255,7156,11893,8,235684
1768,5.4e-05,172.31.36.0-255,66,11959,8,235684
1769,9.7e-05,172.217.194.0-255,2112,14071,8,235684
1770,0.000101,172.31.36.0-255,66,14137,8,235684
1771,0.000128,172.217.194.0-255,2902,17039,8,235684
1772,0.000132,172.31.36.0-255,66,17105,8,235684
1773,0.000138,172.217.194.0-255,4320,21425,8,235684
1774,0.00014,172.31.36.0-255,66,21491,8,235684
1775,0.000179,172.31.36.0-255,66,21557,8,235684
1776,0.000183,172.217.194.0-255,1125,22682,8,235684
1777,0.000185,172.31.36.0-255,66,22748,8,235684
1778,0.000227,172.31.36.0-255,66,22814,8,235684
1779,0.000251,172.217.194.0-255,5379,28193,8,235684
1780,0.000253,172.31.36.0-255,66,28259,8,235684
1781,0.000278,172.217.194.0-255,5738,33997,8,235684
1782,0.000281,172.31.36.0-255,66,34063,8,235684
1783,0.000286,172.217.194.0-255,4320,38383,8,235684
1784,0.00029,172.31.36.0-255,66,38449,8,235684
1785,0.000346,172.217.194.0-255,7110,45559,8,235684
1786,0.00035,172.31.36.0-255,66,45625,8,235684
1787,0.0005,172.217.194.0-255,365,45990,8,235684
1788,0.000505,172.31.36.0-255,66,46056,8,235684
1789,0.000803,172.217.194.0-255,1484,47540,8,235684
1790,0.000809,172.31.36.0-255,66,47606,8,235684
1791,0.000815,172.217.194.0-255,2902,50508,8,235684
1792,0.000818,172.31.36.0-255,66,50574,8,235684
1793,0.000851,172.217.194.0-255,5738,56312,8,235684
1794,0.000854,172.31.36.0-255,66,56378,8,235684
1795,0.00086,172.217.194.0-255,5738,62116,8,235684
1796,0.000863,172.31.36.0-255,66,62182,8,235684
1797,0.000919,172.217.194.0-255,575,62757,8,235684
1798,0.000921,172.31.36.0-255,66,62823,8,235684
1799,0.001494,172.217.194.0-255,1484,64307,8,235684
1800,0.001501,172.31.36.0-255,66,64373,8,235684
1801,0.00151,172.217.194.0-255,2902,67275,8,235684
1802,0.001517,172.31.36.0-255,66,67341,8,235684
1803,0.001525,172.217.194.0-255,5738,73079,8,235684
1804,0.001527,172.31.36.0-255,66,73145,8,235684
1805,0.001535,172.217.194.0-255,5738,78883,8,235684
1806,0.001537,172.31.36.0-255,66,78949,8,235684
1807,0.001572,172.217.194.0-255,7156,86105,8,235684
1808,0.001575,172.31.36.0-255,66,86171,8,235684
1809,0.001587,172.31.36.0-255,66,86237,8,235684
1810,0.004223,172.217.194.0-255,5738,91975,8,235684
1811,0.00423,172.31.36.0-255,66,92041,8,235684
1812,0.00683,172.217.194.0-255,5738,97779,8,235684
1813,0.006835,172.31.36.0-255,66,97845,8,235684
1814,0.009477,172.217.194.0-255,5738,103583,8,235684
1815,0.009485,172.31.36.0-255,66,103649,8,235684
1816,0.012132,172.217.194.0-255,5738,109387,8,235684
1817,0.01214,172.31.36.0-255,66,109453,8,235684
1818,0.014775,172.217.194.0-255,5738,115191,8,235684
1819,0.014784,172.31.36.0-255,66,115257,8,235684
1820,0.017423,172.217.194.0-255,5738,120995,8,235684
1821,0.017433,172.31.36.0-255,66,121061,8,235684
1822,0.020043,172.217.194.0-255,4320,125381,8,235684
1823,0.020048,172.31.36.0-255,66,125447,8,235684
1824,0.020078,172.217.194.0-255,1484,126931,8,235684
1825,0.022685,172.217.194.0-255,4320,131251,8,235684
1826,0.022693,172.31.36.0-255,66,131317,8,235684
1827,0.02342,172.31.36.0-255,172,131489,8,235684
1828,0.023449,172.31.36.0-255,1111,132600,8,235684
1829,0.023511,172.31.36.0-255,1514,134114,8,235684
1830,0.023513,172.31.36.0-255,1514,135628,8,235684
1831,0.023514,172.31.36.0-255,1256,136884,8,235684
1832,0.025061,104.244.42.0-255,66,136950,8,235684
1833,0.025305,172.217.194.0-255,5738,142688,8,235684
1834,0.02531,172.31.36.0-255,66,142754,8,235684
1835,0.027932,172.217.194.0-255,5738,148492,8,235684
1836,0.027939,172.31.36.0-255,66,148558,8,235684
1837,0.030566,172.217.194.0-255,5738,154296,8,235684
1838,0.030573,172.31.36.0-255,66,154362,8,235684
1839,0.033207,172.217.194.0-255,5738,160100,8,235684
1840,0.033215,172.31.36.0-255,66,160166,8,235684
1841,0.035821,172.217.194.0-255,5738,165904,8,235684
1842,0.035828,172.31.36.0-255,66,165970,8,235684
1843,0.038464,172.217.194.0-255,5738,171708,8,235684
1844,0.03847,172.31.36.0-255,66,171774,8,235684
1845,0.041098,172.217.194.0-255,5738,177512,8,235684
1846,0.041106,172.31.36.0-255,66,177578,8,235684
1847,0.043751,172.217.194.0-255,5738,183316,8,235684
1848,0.043762,172.31.36.0-255,66,183382,8,235684
1849,0.046392,172.217.194.0-255,5738,189120,8,235684
1850,0.046401,172.31.36.0-255,66,189186,8,235684
1851,0.049028,172.217.194.0-255,5738,194924,8,235684
1852,0.049038,172.31.36.0-255,66,194990,8,235684
1853,0.05165,172.217.194.0-255,5738,200728,8,235684
1854,0.051658,172.31.36.0-255,66,200794,8,235684
1855,0.054277,172.217.194.0-255,5738,206532,8,235684
1856,0.054284,172.31.36.0-255,66,206598,8,235684
1857,0.056909,172.217.194.0-255,5738,212336,8,235684
1858,0.056916,172.31.36.0-255,66,212402,8,235684
1859,0.059532,172.217.194.0-255,5738,218140,8,235684
1860,0.059542,172.31.36.0-255,66,218206,8,235684
1861,0.062159,172.217.194.0-255,5738,223944,8,235684
1862,0.062166,172.31.36.0-255,66,224010,8,235684
1863,0.064803,172.217.194.0-255,5738,229748,8,235684
1864,0.06481,172.31.36.0-255,66,229814,8,235684
1865,0.065829,104.244.42.0-255,66,229880,8,235684
1866,0.067419,172.217.194.0-255,5738,235618,8,235684
1867,0.067425,172.31.36.0-255,66,235684,8,235684
1868,0.0,172.217.194.0-255,146,146,8,295334
1869,3.6e-05,172.31.36.0-255,66,212,8,295334
1870,4.3e-05,172.217.194.0-255,1484,1696,8,295334
1871,4.8e-05,172.31.36.0-255,66,1762,8,295334
1872,5.3e-05,172.217.194.0-255,2902,4664,8,295334
1873,5.5e-05,172.31.36.0-255,66,4730,8,295334
1874,6.2e-05,172.217.194.0-255,7156,11886,8,295334
1875,6.5e-05,172.31.36.0-255,66,11952,8,295334
1876,6.9e-05,172.217.194.0-255,2038,13990,8,295334
1877,7.1e-05,172.31.36.0-255,66,14056,8,295334
1878,0.000141,172.217.194.0-255,1484,15540,8,295334
1879,0.000145,172.31.36.0-255,66,15606,8,295334
1880,0.000151,172.217.194.0-255,2902,18508,8,295334
1881,0.000154,172.31.36.0-255,66,18574,8,295334
1882,0.000159,172.217.194.0-255,5738,24312,8,295334
1883,0.000161,172.31.36.0-255,66,24378,8,295334
1884,0.000203,172.217.194.0-255,2902,27280,8,295334
1885,0.000207,172.31.36.0-255,66,27346,8,295334
1886,0.000225,172.217.194.0-255,3961,31307,8,295334
1887,0.000228,172.31.36.0-255,66,31373,8,295334
1888,0.000252,172.217.194.0-255,2902,34275,8,295334
1889,0.000254,172.31.36.0-255,66,34341,8,295334
1890,0.000257,172.217.194.0-255,1484,35825,8,295334
1891,0.000259,172.31.36.0-255,66,35891,8,295334
1892,0.000278,172.217.194.0-255,2902,38793,8,295334
1893,0.000281,172.31.36.0-255,66,38859,8,295334
1894,0.000292,172.31.36.0-255,66,38925,8,295334
1895,0.000294,172.217.194.0-255,1125,40050,8,295334
1896,0.000296,172.31.36.0-255,66,40116,8,295334
1897,0.00076,172.217.194.0-255,1484,41600,8,295334
1898,0.000765,172.31.36.0-255,66,41666,8,295334
1899,0.000775,172.217.194.0-255,2902,44568,8,295334
1900,0.000777,172.31.36.0-255,66,44634,8,295334
1901,0.000781,172.217.194.0-255,1484,46118,8,295334
1902,0.000803,172.217.194.0-255,4320,50438,8,295334
1903,0.000807,172.31.36.0-255,66,50504,8,295334
1904,0.000812,172.217.194.0-255,2902,53406,8,295334
1905,0.000813,172.31.36.0-255,66,53472,8,295334
1906,0.000835,172.217.194.0-255,3961,57433,8,295334
1907,0.000838,172.31.36.0-255,66,57499,8,295334
1908,0.00086,172.217.194.0-255,645,58144,8,295334
1909,0.001053,172.31.36.0-255,66,58210,8,295334
1910,0.001398,172.217.194.0-255,1484,59694,8,295334
1911,0.001408,172.217.194.0-255,2902,62596,8,295334
1912,0.001412,172.31.36.0-255,66,62662,8,295334
1913,0.001418,172.217.194.0-255,4320,66982,8,295334
1914,0.00142,172.31.36.0-255,66,67048,8,295334
1915,0.001445,172.217.194.0-255,1484,68532,8,295334
1916,0.001451,172.217.194.0-255,5738,74270,8,295334
1917,0.001453,172.31.36.0-255,66,74336,8,295334
1918,0.001463,172.31.36.0-255,66,74402,8,295334
1919,0.001477,172.217.194.0-255,4320,78722,8,295334
1920,0.001479,172.31.36.0-255,66,78788,8,295334
1921,0.001484,172.217.194.0-255,5020,83808,8,295334
1922,0.001486,172.31.36.0-255,66,83874,8,295334
1923,0.001597,172.217.194.0-255,1484,85358,8,295334
1924,0.001603,172.217.194.0-255,2902,88260,8,295334
1925,0.001606,172.31.36.0-255,66,88326,8,295334
1926,0.00162,172.217.194.0-255,2902,91228,8,295334
1927,0.001622,172.31.36.0-255,66,91294,8,295334
1928,0.001639,172.217.194.0-255,2902,94196,8,295334
1929,0.001641,172.31.36.0-255,66,94262,8,295334
1930,0.001648,172.217.194.0-255,7156,101418,8,295334
1931,0.00165,172.31.36.0-255,66,101484,8,295334
1932,0.001667,172.217.194.0-255,5738,107222,8,295334
1933,0.00167,172.31.36.0-255,66,107288,8,295334
1934,0.001693,172.31.36.0-255,66,107354,8,295334
1935,0.001696,172.217.194.0-255,2184,109538,8,295334
1936,0.001698,172.31.36.0-255,66,109604,8,295334
1937,0.001844,172.217.194.0-255,1484,111088,8,295334
1938,0.001849,172.217.194.0-255,2902,113990,8,295334
1939,0.001853,172.31.36.0-255,66,114056,8,295334
1940,0.001859,172.217.194.0-255,4320,118376,8,295334
1941,0.001861,172.31.36.0-255,66,118442,8,295334
1942,0.001874,172.217.194.0-255,1484,119926,8,295334
1943,0.001878,172.217.194.0-255,2902,122828,8,295334
1944,0.00188,172.31.36.0-255,66,122894,8,295334
1945,0.001905,172.217.194.0-255,5738,128632,8,295334
1946,0.001908,172.31.36.0-255,66,128698,8,295334
1947,0.001978,172.31.36.0-255,66,128764,8,295334
1948,0.004264,172.217.194.0-255,5738,134502,8,295334
1949,0.004269,172.31.36.0-255,66,134568,8,295334
1950,0.00658,172.217.194.0-255,5738,140306,8,295334
1951,0.006587,172.31.36.0-255,66,140372,8,295334
1952,0.008919,172.217.194.0-255,5738,146110,8,295334
1953,0.008927,172.31.36.0-255,66,146176,8,295334
1954,0.011257,172.217.194.0-255,5738,151914,8,295334
1955,0.011266,172.31.36.0-255,66,151980,8,295334
1956,0.013617,172.217.194.0-255,5738,157718,8,295334
1957,0.013627,172.31.36.0-255,66,157784,8,295334
1958,0.015911,172.217.194.0-255,5738,163522,8,295334
1959,0.015919,172.31.36.0-255,66,163588,8,295334
1960,0.018215,172.217.194.0-255,5738,169326,8,295334
1961,0.018223,172.31.36.0-255,66,169392,8,295334
1962,0.020534,172.217.194.0-255,5738,175130,8,295334
1963,0.020541,172.31.36.0-255,66,175196,8,295334
1964,0.02288,172.217.194.0-255,5738,180934,8,295334
1965,0.02289,172.31.36.0-255,66,181000,8,295334
1966,0.025205,172.217.194.0-255,5738,186738,8,295334
1967,0.025213,172.31.36.0-255,66,186804,8,295334
1968,0.02753,172.217.194.0-255,5738,192542,8,295334
1969,0.027538,172.31.36.0-255,66,192608,8,295334
1970,0.029879,172.217.194.0-255,5738,198346,8,295334
1971,0.029889,172.31.36.0-255,66,198412,8,295334
1972,0.030091,172.31.36.0-255,172,198584,8,295334
1973,0.030132,172.31.36.0-255,1112,199696,8,295334
1974,0.030202,172.31.36.0-255,1514,201210,8,295334
1975,0.030204,172.31.36.0-255,1292,202502,8,295334
1976,0.031679,104.244.42.0-255,66,202568,8,295334
1977,0.031687,104.244.42.0-255,66,202634,8,295334
1978,0.031768,104.244.42.0-255,66,202700,8,295334
1979,0.032235,172.217.194.0-255,4320,207020,8,295334
1980,0.032242,172.31.36.0-255,66,207086,8,295334
1981,0.032262,172.217.194.0-255,1484,208570,8,295334
1982,0.034571,172.217.194.0-255,4320,212890,8,295334
1983,0.034579,172.31.36.0-255,66,212956,8,295334
1984,0.036913,172.217.194.0-255,4320,217276,8,295334
1985,0.036921,172.31.36.0-255,66,217342,8,295334
1986,0.036952,172.217.194.0-255,1484,218826,8,295334
1987,0.039248,172.217.194.0-255,4320,223146,8,295334
1988,0.039253,172.31.36.0-255,66,223212,8,295334
1989,0.0416,172.217.194.0-255,4320,227532,8,295334
1990,0.041606,172.31.36.0-255,66,227598,8,295334
1991,0.041636,172.217.194.0-255,1484,229082,8,295334
1992,0.043925,172.217.194.0-255,4320,233402,8,295334
1993,0.04393,172.31.36.0-255,66,233468,8,295334
1994,0.046246,172.217.194.0-255,4320,237788,8,295334
1995,0.046251,172.31.36.0-255,66,237854,8,295334
1996,0.046275,172.217.194.0-255,1484,239338,8,295334
1997,0.048594,172.217.194.0-255,4320,243658,8,295334
1998,0.048599,172.31.36.0-255,66,243724,8,295334
1999,0.050886,172.217.194.0-255,4320,248044,8,295334
2000,0.050891,172.31.36.0-255,66,248110,8,295334
2001,0.05092,172.217.194.0-255,1484,249594,8,295334
2002,0.05323,172.217.194.0-255,4320,253914,8,295334
2003,0.053236,172.31.36.0-255,66,253980,8,295334
2004,0.05557,172.217.194.0-255,5738,259718,8,295334
2005,0.055578,172.31.36.0-255,66,259784,8,295334
2006,0.057914,172.217.194.0-255,5738,265522,8,295334
2007,0.057922,172.31.36.0-255,66,265588,8,295334
2008,0.060269,172.217.194.0-255,2902,268490,8,295334
2009,0.060275,172.31.36.0-255,66,268556,8,295334
2010,0.060306,172.217.194.0-255,2902,271458,8,295334
2011,0.06031,172.31.36.0-255,66,271524,8,295334
2012,0.062568,172.217.194.0-255,2902,274426,8,295334
2013,0.062574,172.31.36.0-255,66,274492,8,295334
2014,0.06265,172.217.194.0-255,1484,275976,8,295334
2015,0.062663,172.217.194.0-255,1484,277460,8,295334
2016,0.062667,172.31.36.0-255,66,277526,8,295334
2017,0.064901,172.217.194.0-255,2902,280428,8,295334
2018,0.064907,172.31.36.0-255,66,280494,8,295334
2019,0.06506,172.217.194.0-255,2902,283396,8,295334
2020,0.065067,172.31.36.0-255,66,283462,8,295334
2021,0.067244,172.217.194.0-255,2902,286364,8,295334
2022,0.06725,172.31.36.0-255,66,286430,8,295334
2023,0.067354,172.217.194.0-255,2902,289332,8,295334
2024,0.067359,172.31.36.0-255,66,289398,8,295334
2025,0.069573,172.217.194.0-255,2902,292300,8,295334
2026,0.069579,172.31.36.0-255,66,292366,8,295334
2027,0.069655,172.217.194.0-255,2902,295268,8,295334
2028,0.06966,172.31.36.0-255,66,295334,8,295334
2029,0.0,172.217.194.0-255,153,153,8,236843
2030,2.7e-05,172.31.36.0-255,66,219,8,236843
2031,3.4e-05,172.217.194.0-255,1484,1703,8,236843
2032,3.8e-05,172.31.36.0-255,66,1769,8,236843
2033,4.3e-05,172.217.194.0-255,2902,4671,8,236843
2034,5.2e-05,172.31.36.0-255,66,4737,8,236843
2035,5.9e-05,172.217.194.0-255,7156,11893,8,236843
2036,6.2e-05,172.31.36.0-255,66,11959,8,236843
2037,9.4e-05,172.217.194.0-255,2039,13998,8,236843
2038,9.7e-05,172.31.36.0-255,66,14064,8,236843
2039,0.000158,172.217.194.0-255,1484,15548,8,236843
2040,0.000161,172.31.36.0-255,66,15614,8,236843
2041,0.000166,172.217.194.0-255,2902,18516,8,236843
2042,0.000168,172.31.36.0-255,66,18582,8,236843
2043,0.00018,172.217.194.0-255,5738,24320,8,236843
2044,0.000182,172.31.36.0-255,66,24386,8,236843
2045,0.000186,172.217.194.0-255,2902,27288,8,236843
2046,0.00019,172.31.36.0-255,66,27354,8,236843
2047,0.000217,172.217.194.0-255,2902,30256,8,236843
2048,0.000221,172.31.36.0-255,66,30322,8,236843
2049,0.000235,172.217.194.0-255,6797,37119,8,236843
2050,0.000237,172.31.36.0-255,66,37185,8,236843
2051,0.000251,172.31.36.0-255,66,37251,8,236843
2052,0.000263,172.31.36.0-255,66,37317,8,236843
2053,0.000294,172.217.194.0-255,2498,39815,8,236843
2054,0.000296,172.31.36.0-255,66,39881,8,236843
2055,0.000366,172.217.194.0-255,364,40245,8,236843
2056,0.00037,172.31.36.0-255,66,40311,8,236843
2057,0.000474,172.217.194.0-255,1484,41795,8,236843
2058,0.000478,172.31.36.0-255,66,41861,8,236843
2059,0.000483,172.217.194.0-255,2902,44763,8,236843
2060,0.000486,172.31.36.0-255,66,44829,8,236843
2061,0.000492,172.217.194.0-255,5738,50567,8,236843
2062,0.0005,172.31.36.0-255,66,50633,8,236843
2063,0.000507,172.217.194.0-255,5738,56371,8,236843
2064,0.000513,172.31.36.0-255,66,56437,8,236843
2065,0.000549,172.31.36.0-255,66,56503,8,236843
2066,0.000555,172.217.194.0-255,5020,61523,8,236843
2067,0.000558,172.31.36.0-255,66,61589,8,236843
2068,0.000887,172.217.194.0-255,1484,63073,8,236843
2069,0.000893,172.217.194.0-255,2902,65975,8,236843
2070,0.000896,172.31.36.0-255,66,66041,8,236843
2071,0.000903,172.217.194.0-255,4320,70361,8,236843
2072,0.000905,172.31.36.0-255,66,70427,8,236843
2073,0.000927,172.217.194.0-255,1484,71911,8,236843
2074,0.000933,172.217.194.0-255,4320,76231,8,236843
2075,0.000935,172.31.36.0-255,66,76297,8,236843
2076,0.000965,172.31.36.0-255,66,76363,8,236843
2077,0.001003,172.217.194.0-255,2902,79265,8,236843
2078,0.001005,172.31.36.0-255,66,79331,8,236843
2079,0.001035,172.31.36.0-255,66,79397,8,236843
2080,0.001903,172.217.194.0-255,1484,80881,8,236843
2081,0.001914,172.217.194.0-255,2902,83783,8,236843
2082,0.001917,172.31.36.0-255,66,83849,8,236843
2083,0.001943,172.217.194.0-255,5738,89587,8,236843
2084,0.001946,172.31.36.0-255,66,89653,8,236843
2085,0.00198,172.31.36.0-255,66,89719,8,236843
2086,0.001985,172.217.194.0-255,4320,94039,8,236843
2087,0.001986,172.31.36.0-255,66,94105,8,236843
2088,0.002015,172.217.194.0-255,6438,100543,8,236843
2089,0.002017,172.31.36.0-255,66,100609,8,236843
2090,0.00204,172.217.194.0-255,1484,102093,8,236843
2091,0.002051,172.217.194.0-255,2902,104995,8,236843
2092,0.002053,172.31.36.0-255,66,105061,8,236843
2093,0.002083,172.217.194.0-255,5738,110799,8,236843
2094,0.002085,172.31.36.0-255,66,110865,8,236843
2095,0.002094,172.31.36.0-255,66,110931,8,236843
2096,0.002131,172.31.36.0-255,66,110997,8,236843
2097,0.002189,172.31.36.0-255,66,111063,8,236843
2098,0.002201,172.31.36.0-255,66,111129,8,236843
2099,0.002223,172.31.36.0-255,66,111195,8,236843
2100,0.002256,172.31.36.0-255,66,111261,8,236843
2101,0.002282,172.217.194.0-255,1484,112745,8,236843
2102,0.002292,172.31.36.0-255,66,112811,8,236843
2103,0.002298,172.217.194.0-255,5738,118549,8,236843
2104,0.002301,172.31.36.0-255,66,118615,8,236843
2105,0.002347,172.31.36.0-255,66,118681,8,236843
2106,0.002365,172.31.36.0-255,66,118747,8,236843
2107,0.004698,172.217.194.0-255,5738,124485,8,236843
2108,0.004706,172.31.36.0-255,66,124551,8,236843
2109,0.006955,172.217.194.0-255,5738,130289,8,236843
2110,0.006962,172.31.36.0-255,66,130355,8,236843
2111,0.009254,172.217.194.0-255,2902,133257,8,236843
2112,0.00926,172.31.36.0-255,66,133323,8,236843
2113,0.009286,172.217.194.0-255,2902,136225,8,236843
2114,0.009288,172.31.36.0-255,66,136291,8,236843
2115,0.011551,172.217.194.0-255,5738,142029,8,236843
2116,0.011558,172.31.36.0-255,66,142095,8,236843
2117,0.013821,172.217.194.0-255,5738,147833,8,236843
2118,0.013832,172.31.36.0-255,66,147899,8,236843
2119,0.016105,172.217.194.0-255,5738,153637,8,236843
2120,0.016115,172.31.36.0-255,66,153703,8,236843
2121,0.018385,172.217.194.0-255,5738,159441,8,236843
2122,0.018393,172.31.36.0-255,66,159507,8,236843
2123,0.020704,172.217.194.0-255,5738,165245,8,236843
2124,0.02071,172.31.36.0-255,66,165311,8,236843
2125,0.023026,172.217.194.0-255,5738,171049,8,236843
2126,0.023044,172.31.36.0-255,66,171115,8,236843
2127,0.025305,172.217.194.0-255,5738,176853,8,236843
2128,0.025319,172.31.36.0-255,66,176919,8,236843
2129,0.027618,172.217.194.0-255,5738,182657,8,236843
2130,0.027633,172.31.36.0-255,66,182723,8,236843
2131,0.029546,172.31.36.0-255,172,182895,8,236843
2132,0.029577,172.31.36.0-255,1112,184007,8,236843
2133,0.029632,172.31.36.0-255,1514,185521,8,236843
2134,0.029634,172.31.36.0-255,1514,187035,8,236843
2135,0.029635,172.31.36.0-255,1514,188549,8,236843
2136,0.029636,172.31.36.0-255,1072,189621,8,236843
2137,0.029916,172.217.194.0-255,5738,195359,8,236843
2138,0.029923,172.31.36.0-255,66,195425,8,236843
2139,0.031071,104.244.42.0-255,66,195491,8,236843
2140,0.031116,104.244.42.0-255,66,195557,8,236843
2141,0.031214,104.244.42.0-255,66,195623,8,236843
2142,0.031218,104.244.42.0-255,66,195689,8,236843
2143,0.032196,172.217.194.0-255,4320,200009,8,236843
2144,0.032202,172.31.36.0-255,66,200075,8,236843
2145,0.032231,172.217.194.0-255,1484,201559,8,236843
2146,0.03449,172.217.194.0-255,4320,205879,8,236843
2147,0.034501,172.31.36.0-255,66,205945,8,236843
2148,0.036769,172.217.194.0-255,5738,211683,8,236843
2149,0.036781,172.31.36.0-255,66,211749,8,236843
2150,0.039082,172.217.194.0-255,5738,217487,8,236843
2151,0.039096,172.31.36.0-255,66,217553,8,236843
2152,0.041383,172.217.194.0-255,5738,223291,8,236843
2153,0.041391,172.31.36.0-255,66,223357,8,236843
2154,0.043669,172.217.194.0-255,5738,229095,8,236843
2155,0.04368,172.31.36.0-255,66,229161,8,236843
2156,0.045968,172.217.194.0-255,5738,234899,8,236843
2157,0.045974,172.31.36.0-255,66,234965,8,236843
2158,0.048272,172.217.194.0-255,1641,236606,8,236843
2159,0.048277,172.31.36.0-255,66,236672,8,236843
2160,0.048469,172.31.36.0-255,105,236777,8,236843
2161,0.0507,172.217.194.0-255,66,236843,8,236843
2162,0.0,172.217.194.0-255,153,153,8,301864
2163,1.7e-05,172.31.36.0-255,66,219,8,301864
2164,2.4e-05,172.217.194.0-255,1484,1703,8,301864
2165,3e-05,172.31.36.0-255,66,1769,8,301864
2166,4.4e-05,172.217.194.0-255,2902,4671,8,301864
2167,4.7e-05,172.31.36.0-255,66,4737,8,301864
2168,5.7e-05,172.217.194.0-255,7156,11893,8,301864
2169,6.2e-05,172.31.36.0-255,66,11959,8,301864
2170,6.6e-05,172.217.194.0-255,2099,14058,8,301864
2171,6.9e-05,172.31.36.0-255,66,14124,8,301864
2172,0.000102,172.217.194.0-255,2902,17026,8,301864
2173,0.000105,172.31.36.0-255,66,17092,8,301864
2174,0.000112,172.217.194.0-255,7156,24248,8,301864
2175,0.000116,172.31.36.0-255,66,24314,8,301864
2176,0.000136,172.217.194.0-255,1484,25798,8,301864
2177,0.000138,172.31.36.0-255,66,25864,8,301864
2178,0.000176,172.31.36.0-255,66,25930,8,301864
2179,0.000186,172.31.36.0-255,66,25996,8,301864
2180,0.000236,172.217.194.0-255,2543,28539,8,301864
2181,0.000239,172.31.36.0-255,66,28605,8,301864
2182,0.000364,172.217.194.0-255,1484,30089,8,301864
2183,0.000372,172.31.36.0-255,66,30155,8,301864
2184,0.000378,172.217.194.0-255,2902,33057,8,301864
2185,0.000381,172.31.36.0-255,66,33123,8,301864
2186,0.000387,172.217.194.0-255,5738,38861,8,301864
2187,0.000389,172.31.36.0-255,66,38927,8,301864
2188,0.000429,172.217.194.0-255,7112,46039,8,301864
2189,0.000433,172.31.36.0-255,66,46105,8,301864
2190,0.000943,172.217.194.0-255,363,46468,8,301864
2191,0.000949,172.31.36.0-255,66,46534,8,301864
2192,0.000983,172.217.194.0-255,1484,48018,8,301864
2193,0.000991,172.217.194.0-255,4320,52338,8,301864
2194,0.000993,172.31.36.0-255,66,52404,8,301864
2195,0.001015,172.217.194.0-255,4320,56724,8,301864
2196,0.00102,172.31.36.0-255,66,56790,8,301864
2197,0.001043,172.217.194.0-255,5738,62528,8,301864
2198,0.001047,172.31.36.0-255,66,62594,8,301864
2199,0.001059,172.31.36.0-255,66,62660,8,301864
2200,0.001098,172.31.36.0-255,66,62726,8,301864
2201,0.001457,172.217.194.0-255,1484,64210,8,301864
2202,0.001464,172.217.194.0-255,2902,67112,8,301864
2203,0.001467,172.31.36.0-255,66,67178,8,301864
2204,0.001496,172.217.194.0-255,5738,72916,8,301864
2205,0.001499,172.31.36.0-255,66,72982,8,301864
2206,0.001502,172.217.194.0-255,1484,74466,8,301864
2207,0.001539,172.31.36.0-255,66,74532,8,301864
2208,0.001552,172.31.36.0-255,66,74598,8,301864
2209,0.001696,172.217.194.0-255,1484,76082,8,301864
2210,0.001711,172.217.194.0-255,2902,78984,8,301864
2211,0.001714,172.31.36.0-255,66,79050,8,301864
2212,0.00172,172.217.194.0-255,2902,81952,8,301864
2213,0.001722,172.31.36.0-255,66,82018,8,301864
2214,0.001745,172.217.194.0-255,2902,84920,8,301864
2215,0.001749,172.31.36.0-255,66,84986,8,301864
2216,0.001756,172.217.194.0-255,7156,92142,8,301864
2217,0.001758,172.31.36.0-255,66,92208,8,301864
2218,0.001792,172.217.194.0-255,5738,97946,8,301864
2219,0.001796,172.31.36.0-255,66,98012,8,301864
2220,0.001808,172.31.36.0-255,66,98078,8,301864
2221,0.001811,172.217.194.0-255,766,98844,8,301864
2222,0.001841,172.217.194.0-255,1484,100328,8,301864
2223,0.001844,172.31.36.0-255,66,100394,8,301864
2224,0.001849,172.217.194.0-255,4320,104714,8,301864
2225,0.001852,172.31.36.0-255,66,104780,8,301864
2226,0.001863,172.217.194.0-255,1484,106264,8,301864
2227,0.001889,172.217.194.0-255,4320,110584,8,301864
2228,0.001892,172.31.36.0-255,66,110650,8,301864
2229,0.001899,172.217.194.0-255,7156,117806,8,301864
2230,0.001902,172.31.36.0-255,66,117872,8,301864
2231,0.001938,172.31.36.0-255,66,117938,8,301864
2232,0.001941,172.217.194.0-255,766,118704,8,301864
2233,0.002095,172.217.194.0-255,1484,120188,8,301864
2234,0.002099,172.31.36.0-255,66,120254,8,301864
2235,0.002105,172.217.194.0-255,2902,123156,8,301864
2236,0.002107,172.31.36.0-255,66,123222,8,301864
2237,0.00211,172.217.194.0-255,1484,124706,8,301864
2238,0.002139,172.217.194.0-255,4320,129026,8,301864
2239,0.002142,172.31.36.0-255,66,129092,8,301864
2240,0.002146,172.217.194.0-255,1484,130576,8,301864
2241,0.002181,172.31.36.0-255,66,130642,8,301864
2242,0.002258,172.31.36.0-255,66,130708,8,301864
2243,0.002284,172.217.194.0-255,2184,132892,8,301864
2244,0.002287,172.31.36.0-255,66,132958,8,301864
2245,0.004579,172.217.194.0-255,2902,135860,8,301864
2246,0.004586,172.31.36.0-255,66,135926,8,301864
2247,0.004629,172.217.194.0-255,2902,138828,8,301864
2248,0.004632,172.31.36.0-255,66,138894,8,301864
2249,0.006908,172.217.194.0-255,2902,141796,8,301864
2250,0.006911,172.31.36.0-255,66,141862,8,301864
2251,0.006961,172.217.194.0-255,2902,144764,8,301864
2252,0.006963,172.31.36.0-255,66,144830,8,301864
2253,0.00929,172.217.194.0-255,2902,147732,8,301864
2254,0.009298,172.31.36.0-255,66,147798,8,301864
2255,0.009334,172.217.194.0-255,2902,150700,8,301864
2256,0.009337,172.31.36.0-255,66,150766,8,301864
2257,0.011699,172.217.194.0-255,5738,156504,8,301864
2258,0.011706,172.31.36.0-255,66,156570,8,301864
2259,0.014064,172.217.194.0-255,5738,162308,8,301864
2260,0.014073,172.31.36.0-255,66,162374,8,301864
2261,0.016472,172.217.194.0-255,5738,168112,8,301864
2262,0.016482,172.31.36.0-255,66,168178,8,301864
2263,0.018855,172.217.194.0-255,5738,173916,8,301864
2264,0.018864,172.31.36.0-255,66,173982,8,301864
2265,0.021203,172.217.194.0-255,5738,179720,8,301864
2266,0.02121,172.31.36.0-255,66,179786,8,301864
2267,0.023575,172.217.194.0-255,5738,185524,8,301864
2268,0.023582,172.31.36.0-255,66,185590,8,301864
2269,0.025964,172.217.194.0-255,5738,191328,8,301864
2270,0.025972,172.31.36.0-255,66,191394,8,301864
2271,0.025981,172.31.36.0-255,172,191566,8,301864
2272,0.026029,172.31.36.0-255,1111,192677,8,301864
2273,0.026156,172.31.36.0-255,1514,194191,8,301864
2274,0.026159,172.31.36.0-255,1514,195705,8,301864
2275,0.02616,172.31.36.0-255,1256,196961,8,301864
2276,0.027538,104.244.42.0-255,66,197027,8,301864
2277,0.027573,104.244.42.0-255,66,197093,8,301864
2278,0.027723,104.244.42.0-255,66,197159,8,301864
2279,0.027744,104.244.42.0-255,66,197225,8,301864
2280,0.028316,172.217.194.0-255,5738,202963,8,301864
2281,0.028322,172.31.36.0-255,66,203029,8,301864
2282,0.030708,172.217.194.0-255,5738,208767,8,301864
2283,0.030715,172.31.36.0-255,66,208833,8,301864
2284,0.03312,172.217.194.0-255,5738,214571,8,301864
2285,0.033127,172.31.36.0-255,66,214637,8,301864
2286,0.035526,172.217.194.0-255,5738,220375,8,301864
2287,0.035533,172.31.36.0-255,66,220441,8,301864
2288,0.037938,172.217.194.0-255,5738,226179,8,301864
2289,0.037944,172.31.36.0-255,66,226245,8,301864
2290,0.04032,172.217.194.0-255,5738,231983,8,301864
2291,0.040329,172.31.36.0-255,66,232049,8,301864
2292,0.042746,172.217.194.0-255,5738,237787,8,301864
2293,0.042753,172.31.36.0-255,66,237853,8,301864
2294,0.0451,172.217.194.0-255,5738,243591,8,301864
2295,0.045107,172.31.36.0-255,66,243657,8,301864
2296,0.047482,172.217.194.0-255,5738,249395,8,301864
2297,0.047488,172.31.36.0-255,66,249461,8,301864
2298,0.049858,172.217.194.0-255,5738,255199,8,301864
2299,0.049865,172.31.36.0-255,66,255265,8,301864
2300,0.052228,172.217.194.0-255,5738,261003,8,301864
2301,0.052234,172.31.36.0-255,66,261069,8,301864
2302,0.054594,172.217.194.0-255,5738,266807,8,301864
2303,0.054601,172.31.36.0-255,66,266873,8,301864
2304,0.056991,172.217.194.0-255,5738,272611,8,301864
2305,0.056998,172.31.36.0-255,66,272677,8,301864
2306,0.059395,172.217.194.0-255,5738,278415,8,301864
2307,0.059403,172.31.36.0-255,66,278481,8,301864
2308,0.059524,172.31.36.0-255,101,278582,8,301864
2309,0.061817,172.217.194.0-255,5738,284320,8,301864
2310,0.061824,172.31.36.0-255,66,284386,8,301864
2311,0.061849,172.217.194.0-255,66,284452,8,301864
2312,0.064206,172.217.194.0-255,5738,290190,8,301864
2313,0.064213,172.31.36.0-255,66,290256,8,301864
2314,0.066579,172.217.194.0-255,5738,295994,8,301864
2315,0.066586,172.31.36.0-255,66,296060,8,301864
2316,0.068962,172.217.194.0-255,5738,301798,8,301864
2317,0.068968,172.31.36.0-255,66,301864,8,301864
2318,0.0,74.125.200.0-255,153,153,8,327590
2319,1.4e-05,172.31.36.0-255,66,219,8,327590
2320,2.1e-05,74.125.200.0-255,1484,1703,8,327590
2321,2.5e-05,172.31.36.0-255,66,1769,8,327590
2322,3.1e-05,74.125.200.0-255,2902,4671,8,327590
2323,4.3e-05,172.31.36.0-255,66,4737,8,327590
2324,4.8e-05,74.125.200.0-255,2902,7639,8,327590
2325,5e-05,172.31.36.0-255,66,7705,8,327590
2326,8.6e-05,74.125.200.0-255,2902,10607,8,327590
2327,8.9e-05,172.31.36.0-255,66,10673,8,327590
2328,9.7e-05,74.125.200.0-255,6336,17009,8,327590
2329,9.9e-05,172.31.36.0-255,66,17075,8,327590
2330,0.000104,74.125.200.0-255,2902,19977,8,327590
2331,0.000105,172.31.36.0-255,66,20043,8,327590
2332,0.000144,172.31.36.0-255,66,20109,8,327590
2333,0.00015,74.125.200.0-255,4320,24429,8,327590
2334,0.000152,172.31.36.0-255,66,24495,8,327590
2335,0.000181,74.125.200.0-255,5738,30233,8,327590
2336,0.000184,172.31.36.0-255,66,30299,8,327590
2337,0.00022,74.125.200.0-255,6438,36737,8,327590
2338,0.000223,172.31.36.0-255,66,36803,8,327590
2339,0.000473,74.125.200.0-255,1484,38287,8,327590
2340,0.000478,172.31.36.0-255,66,38353,8,327590
2341,0.000484,74.125.200.0-255,2902,41255,8,327590
2342,0.000486,172.31.36.0-255,66,41321,8,327590
2343,0.00049,74.125.200.0-255,1484,42805,8,327590
2344,0.000497,172.31.36.0-255,66,42871,8,327590
2345,0.000525,74.125.200.0-255,4320,47191,8,327590
2346,0.000528,172.31.36.0-255,66,47257,8,327590
2347,0.000535,74.125.200.0-255,6797,54054,8,327590
2348,0.000538,172.31.36.0-255,66,54120,8,327590
2349,0.000541,74.125.200.0-255,395,54515,8,327590
2350,0.000612,74.125.200.0-255,349,54864,8,327590
2351,0.000724,74.125.200.0-255,1484,56348,8,327590
2352,0.000729,172.31.36.0-255,66,56414,8,327590
2353,0.000755,74.125.200.0-255,2902,59316,8,327590
2354,0.000758,172.31.36.0-255,66,59382,8,327590
2355,0.00079,74.125.200.0-255,4320,63702,8,327590
2356,0.000792,172.31.36.0-255,66,63768,8,327590
2357,0.000835,74.125.200.0-255,2902,66670,8,327590
2358,0.000837,172.31.36.0-255,66,66736,8,327590
2359,0.000869,74.125.200.0-255,6797,73533,8,327590
2360,0.000872,172.31.36.0-255,66,73599,8,327590
2361,0.000889,172.31.36.0-255,66,73665,8,327590
2362,0.000895,74.125.200.0-255,5379,79044,8,327590
2363,0.000897,172.31.36.0-255,66,79110,8,327590
2364,0.001231,74.125.200.0-255,1484,80594,8,327590
2365,0.001235,74.125.200.0-255,1484,82078,8,327590
2366,0.001238,172.31.36.0-255,66,82144,8,327590
2367,0.001265,74.125.200.0-255,1484,83628,8,327590
2368,0.001268,74.125.200.0-255,1484,85112,8,327590
2369,0.00127,172.31.36.0-255,66,85178,8,327590
2370,0.001276,74.125.200.0-255,2902,88080,8,327590
2371,0.001278,172.31.36.0-255,66,88146,8,327590
2372,0.001284,74.125.200.0-255,5738,93884,8,327590
2373,0.001286,172.31.36.0-255,66,93950,8,327590
2374,0.001312,74.125.200.0-255,7156,101106,8,327590
2375,0.00133,172.31.36.0-255,66,101172,8,327590
2376,0.001356,74.125.200.0-255,5738,106910,8,327590
2377,0.001359,172.31.36.0-255,66,106976,8,327590
2378,0.001366,74.125.200.0-255,6438,113414,8,327590
2379,0.001369,172.31.36.0-255,66,113480,8,327590
2380,0.00191,74.125.200.0-255,1484,114964,8,327590
2381,0.001933,74.125.200.0-255,2902,117866,8,327590
2382,0.001938,172.31.36.0-255,66,117932,8,327590
2383,0.001946,74.125.200.0-255,4320,122252,8,327590
2384,0.001948,172.31.36.0-255,66,122318,8,327590
2385,0.001974,74.125.200.0-255,1484,123802,8,327590
2386,0.00198,74.125.200.0-255,5738,129540,8,327590
2387,0.001982,172.31.36.0-255,66,129606,8,327590
2388,0.00199,74.125.200.0-255,7156,136762,8,327590
2389,0.001992,172.31.36.0-255,66,136828,8,327590
2390,0.002022,74.125.200.0-255,5738,142566,8,327590
2391,0.002024,172.31.36.0-255,66,142632,8,327590
2392,0.002048,74.125.200.0-255,4320,146952,8,327590
2393,0.00205,172.31.36.0-255,66,147018,8,327590
2394,0.002053,74.125.200.0-255,766,147784,8,327590
2395,0.002283,74.125.200.0-255,1484,149268,8,327590
2396,0.002288,172.31.36.0-255,66,149334,8,327590
2397,0.002292,74.125.200.0-255,1484,150818,8,327590
2398,0.002314,74.125.200.0-255,1484,152302,8,327590
2399,0.002316,172.31.36.0-255,66,152368,8,327590
2400,0.00232,74.125.200.0-255,1484,153852,8,327590
2401,0.002355,74.125.200.0-255,1484,155336,8,327590
2402,0.002358,172.31.36.0-255,66,155402,8,327590
2403,0.002364,74.125.200.0-255,4320,159722,8,327590
2404,0.002371,172.31.36.0-255,66,159788,8,327590
2405,0.002382,172.31.36.0-255,66,159854,8,327590
2406,0.002388,74.125.200.0-255,4320,164174,8,327590
2407,0.00239,172.31.36.0-255,66,164240,8,327590
2408,0.002422,74.125.200.0-255,2902,167142,8,327590
2409,0.002425,172.31.36.0-255,66,167208,8,327590
2410,0.002452,74.125.200.0-255,6438,173646,8,327590
2411,0.002454,172.31.36.0-255,66,173712,8,327590
2412,0.005007,74.125.200.0-255,5738,179450,8,327590
2413,0.005014,172.31.36.0-255,66,179516,8,327590
2414,0.007598,74.125.200.0-255,5738,185254,8,327590
2415,0.007603,172.31.36.0-255,66,185320,8,327590
2416,0.01016,74.125.200.0-255,5738,191058,8,327590
2417,0.010167,172.31.36.0-255,66,191124,8,327590
2418,0.012728,74.125.200.0-255,5738,196862,8,327590
2419,0.012736,172.31.36.0-255,66,196928,8,327590
2420,0.01529,74.125.200.0-255,5738,202666,8,327590
2421,0.015298,172.31.36.0-255,66,202732,8,327590
2422,0.017867,74.125.200.0-255,5738,208470,8,327590
2423,0.017878,172.31.36.0-255,66,208536,8,327590
2424,0.020453,74.125.200.0-255,5738,214274,8,327590
2425,0.020462,172.31.36.0-255,66,214340,8,327590
2426,0.02302,74.125.200.0-255,5738,220078,8,327590
2427,0.023027,172.31.36.0-255,66,220144,8,327590
2428,0.025595,74.125.200.0-255,5738,225882,8,327590
2429,0.025604,172.31.36.0-255,66,225948,8,327590
2430,0.028165,74.125.200.0-255,5738,231686,8,327590
2431,0.028174,172.31.36.0-255,66,231752,8,327590
2432,0.030771,74.125.200.0-255,5738,237490,8,327590
2433,0.030777,172.31.36.0-255,66,237556,8,327590
2434,0.031612,172.31.36.0-255,172,237728,8,327590
2435,0.031642,172.31.36.0-255,1110,238838,8,327590
2436,0.031699,172.31.36.0-255,1428,240266,8,327590
2437,0.033175,104.244.42.0-255,66,240332,8,327590
2438,0.033183,104.244.42.0-255,66,240398,8,327590
2439,0.033278,104.244.42.0-255,66,240464,8,327590
2440,0.033334,74.125.200.0-255,5738,246202,8,327590
2441,0.033338,172.31.36.0-255,66,246268,8,327590
2442,0.035895,74.125.200.0-255,5738,252006,8,327590
2443,0.035901,172.31.36.0-255,66,252072,8,327590
2444,0.038452,74.125.200.0-255,5738,257810,8,327590
2445,0.038461,172.31.36.0-255,66,257876,8,327590
2446,0.041015,74.125.200.0-255,5738,263614,8,327590
2447,0.041022,172.31.36.0-255,66,263680,8,327590
2448,0.043578,74.125.200.0-255,5738,269418,8,327590
2449,0.043583,172.31.36.0-255,66,269484,8,327590
2450,0.04615,74.125.200.0-255,5738,275222,8,327590
2451,0.046156,172.31.36.0-255,66,275288,8,327590
2452,0.048727,74.125.200.0-255,5738,281026,8,327590
2453,0.048733,172.31.36.0-255,66,281092,8,327590
2454,0.051305,74.125.200.0-255,5738,286830,8,327590
2455,0.051311,172.31.36.0-255,66,286896,8,327590
2456,0.053884,74.125.200.0-255,5738,292634,8,327590
2457,0.05389,172.31.36.0-255,66,292700,8,327590
2458,0.056432,74.125.200.0-255,5738,298438,8,327590
2459,0.056439,172.31.36.0-255,66,298504,8,327590
2460,0.058989,74.125.200.0-255,5738,304242,8,327590
2461,0.058995,172.31.36.0-255,66,304308,8,327590
2462,0.061558,74.125.200.0-255,5738,310046,8,327590
2463,0.061564,172.31.36.0-255,66,310112,8,327590
2464,0.064114,74.125.200.0-255,1484,311596,8,327590
2465,0.064136,74.125.200.0-255,4320,315916,8,327590
2466,0.064141,172.31.36.0-255,66,315982,8,327590
2467,0.066708,74.125.200.0-255,5738,321720,8,327590
2468,0.066715,172.31.36.0-255,66,321786,8,327590
2469,0.06929,74.125.200.0-255,5738,327524,8,327590
2470,0.069295,172.31.36.0-255,66,327590,8,327590
2471,0.0,172.217.194.0-255,153,153,8,212668
2472,2e-05,172.31.36.0-255,66,219,8,212668
2473,5.2e-05,172.217.194.0-255,1484,1703,8,212668
2474,5.6e-05,172.31.36.0-255,66,1769,8,212668
2475,6.1e-05,172.217.194.0-255,2902,4671,8,212668
2476,6.4e-05,172.31.36.0-255,66,4737,8,212668
2477,7.2e-05,172.217.194.0-255,7156,11893,8,212668
2478,7.4e-05,172.31.36.0-255,66,11959,8,212668
2479,0.000104,172.217.194.0-255,3458,15417,8,212668
2480,0.000106,172.31.36.0-255,66,15483,8,212668
2481,0.000112,172.217.194.0-255,4320,19803,8,212668
2482,0.000114,172.31.36.0-255,66,19869,8,212668
2483,0.000118,172.217.194.0-255,2902,22771,8,212668
2484,0.000122,172.31.36.0-255,66,22837,8,212668
2485,0.000151,172.217.194.0-255,7156,29993,8,212668
2486,0.000155,172.31.36.0-255,66,30059,8,212668
2487,0.000159,172.217.194.0-255,1125,31184,8,212668
2488,0.000163,172.31.36.0-255,66,31250,8,212668
2489,0.000216,172.217.194.0-255,1484,32734,8,212668
2490,0.000219,172.31.36.0-255,66,32800,8,212668
2491,0.000223,172.217.194.0-255,1484,34284,8,212668
2492,0.000225,172.31.36.0-255,66,34350,8,212668
2493,0.000258,172.217.194.0-255,1484,35834,8,212668
2494,0.000262,172.31.36.0-255,66,35900,8,212668
2495,0.000269,172.217.194.0-255,5738,41638,8,212668
2496,0.000272,172.31.36.0-255,66,41704,8,212668
2497,0.000278,172.217.194.0-255,5738,47442,8,212668
2498,0.00028,172.31.36.0-255,66,47508,8,212668
2499,0.000314,172.217.194.0-255,6797,54305,8,212668
2500,0.000319,172.31.36.0-255,66,54371,8,212668
2501,0.00032,172.217.194.0-255,7156,61527,8,212668
2502,0.000324,172.31.36.0-255,66,61593,8,212668
2503,0.00036,172.217.194.0-255,3961,65554,8,212668
2504,0.000365,172.31.36.0-255,66,65620,8,212668
2505,0.000799,172.217.194.0-255,646,66266,8,212668
2506,0.000818,172.31.36.0-255,66,66332,8,212668
2507,0.000917,172.217.194.0-255,1484,67816,8,212668
2508,0.000926,172.217.194.0-255,2902,70718,8,212668
2509,0.00093,172.31.36.0-255,66,70784,8,212668
2510,0.000937,172.217.194.0-255,4320,75104,8,212668
2511,0.00094,172.31.36.0-255,66,75170,8,212668
2512,0.000968,172.217.194.0-255,1484,76654,8,212668
2513,0.000983,172.31.36.0-255,66,76720,8,212668
2514,0.000994,172.31.36.0-255,66,76786,8,212668
2515,0.001046,172.217.194.0-255,766,77552,8,212668
2516,0.001194,172.217.194.0-255,1484,79036,8,212668
2517,0.0012,172.31.36.0-255,66,79102,8,212668
2518,0.001206,172.217.194.0-255,2902,82004,8,212668
2519,0.001208,172.31.36.0-255,66,82070,8,212668
2520,0.001221,172.217.194.0-255,5738,87808,8,212668
2521,0.001223,172.31.36.0-255,66,87874,8,212668
2522,0.001229,172.217.194.0-255,5738,93612,8,212668
2523,0.001231,172.31.36.0-255,66,93678,8,212668
2524,0.001262,172.217.194.0-255,7156,100834,8,212668
2525,0.001265,172.31.36.0-255,66,100900,8,212668
2526,0.001268,172.217.194.0-255,1484,102384,8,212668
2527,0.00129,172.217.194.0-255,7156,109540,8,212668
2528,0.001292,172.31.36.0-255,66,109606,8,212668
2529,0.001321,172.217.194.0-255,3602,113208,8,212668
2530,0.001325,172.31.36.0-255,66,113274,8,212668
2531,0.001339,172.31.36.0-255,66,113340,8,212668
2532,0.001344,172.217.194.0-255,4320,117660,8,212668
2533,0.001346,172.31.36.0-255,66,117726,8,212668
2534,0.001388,172.31.36.0-255,66,117792,8,212668
2535,0.001391,172.217.194.0-255,1484,119276,8,212668
2536,0.001395,172.217.194.0-255,2902,122178,8,212668
2537,0.001398,172.31.36.0-255,66,122244,8,212668
2538,0.001402,172.217.194.0-255,2902,125146,8,212668
2539,0.001405,172.31.36.0-255,66,125212,8,212668
2540,0.001439,172.217.194.0-255,2902,128114,8,212668
2541,0.001442,172.31.36.0-255,66,128180,8,212668
2542,0.001456,172.31.36.0-255,66,128246,8,212668
2543,0.001467,172.31.36.0-255,66,128312,8,212668
2544,0.001489,172.217.194.0-255,2184,130496,8,212668
2545,0.001491,172.31.36.0-255,66,130562,8,212668
2546,0.001495,172.217.194.0-255,2902,133464,8,212668
2547,0.001497,172.31.36.0-255,66,133530,8,212668
2548,0.001501,172.217.194.0-255,2902,136432,8,212668
2549,0.001503,172.31.36.0-255,66,136498,8,212668
2550,0.001535,172.217.194.0-255,4320,140818,8,212668
2551,0.001538,172.31.36.0-255,66,140884,8,212668
2552,0.001552,172.31.36.0-255,66,140950,8,212668
2553,0.001558,172.217.194.0-255,6438,147388,8,212668
2554,0.001561,172.31.36.0-255,66,147454,8,212668
2555,0.001599,172.217.194.0-255,1484,148938,8,212668
2556,0.001604,172.217.194.0-255,2902,151840,8,212668
2557,0.001607,172.31.36.0-255,66,151906,8,212668
2558,0.001612,172.217.194.0-255,5738,157644,8,212668
2559,0.001615,172.31.36.0-255,66,157710,8,212668
2560,0.001651,172.31.36.0-255,66,157776,8,212668
2561,0.001662,172.31.36.0-255,66,157842,8,212668
2562,0.001679,172.217.194.0-255,766,158608,8,212668
2563,0.00174,172.217.194.0-255,1484,160092,8,212668
2564,0.001743,172.31.36.0-255,66,160158,8,212668
2565,0.001748,172.217.194.0-255,2902,163060,8,212668
2566,0.001751,172.31.36.0-255,66,163126,8,212668
2567,0.001783,172.217.194.0-255,5738,168864,8,212668
2568,0.001786,172.31.36.0-255,66,168930,8,212668
2569,0.001833,172.217.194.0-255,7156,176086,8,212668
2570,0.001835,172.31.36.0-255,66,176152,8,212668
2571,0.001861,172.217.194.0-255,5738,181890,8,212668
2572,0.001864,172.31.36.0-255,66,181956,8,212668
2573,0.001875,172.31.36.0-255,66,182022,8,212668
2574,0.001877,172.217.194.0-255,1484,183506,8,212668
2575,0.001881,172.217.194.0-255,2902,186408,8,212668
2576,0.001883,172.31.36.0-255,66,186474,8,212668
2577,0.001906,172.217.194.0-255,5738,192212,8,212668
2578,0.001909,172.31.36.0-255,66,192278,8,212668
2579,0.001913,172.217.194.0-255,2902,195180,8,212668
2580,0.001915,172.31.36.0-255,66,195246,8,212668
2581,0.001944,172.31.36.0-255,66,195312,8,212668
2582,0.001975,172.31.36.0-255,66,195378,8,212668
2583,0.00201,172.31.36.0-255,66,195444,8,212668
2584,0.002028,172.31.36.0-255,66,195510,8,212668
2585,0.002038,172.31.36.0-255,66,195576,8,212668
2586,0.002066,172.217.194.0-255,4320,199896,8,212668
2587,0.002069,172.31.36.0-255,66,199962,8,212668
2588,0.002115,172.31.36.0-255,66,200028,8,212668
2589,0.002118,172.217.194.0-255,1484,201512,8,212668
2590,0.002121,172.217.194.0-255,237,201749,8,212668
2591,0.002123,172.31.36.0-255,66,201815,8,212668
2592,0.004136,172.217.194.0-255,136,201951,8,212668
2593,0.005573,172.31.36.0-255,66,202017,8,212668
2594,0.0056,172.31.36.0-255,105,202122,8,212668
2595,0.007583,172.217.194.0-255,66,202188,8,212668
2596,0.038275,172.31.36.0-255,172,202360,8,212668
2597,0.038303,172.31.36.0-255,1111,203471,8,212668
2598,0.038351,172.31.36.0-255,1514,204985,8,212668
2599,0.038353,172.31.36.0-255,1514,206499,8,212668
2600,0.038357,172.31.36.0-255,1514,208013,8,212668
2601,0.038358,172.31.36.0-255,1514,209527,8,212668
2602,0.038376,172.31.36.0-255,1514,211041,8,212668
2603,0.038377,172.31.36.0-255,1123,212164,8,212668
2604,0.03979,104.244.42.0-255,66,212230,8,212668
2605,0.039857,104.244.42.0-255,66,212296,8,212668
2606,0.039871,104.244.42.0-255,66,212362,8,212668
2607,0.039875,104.244.42.0-255,66,212428,8,212668
2608,0.039908,104.244.42.0-255,66,212494,8,212668
2609,0.051138,172.31.36.0-255,108,212602,8,212668
2610,0.052647,104.244.42.0-255,66,212668,8,212668
2611,0.0,74.125.24.0-255,290,290,8,172701
2612,2.2e-05,172.31.36.0-255,66,356,8,172701
2613,2.8e-05,74.125.24.0-255,1484,1840,8,172701
2614,3.1e-05,172.31.36.0-255,66,1906,8,172701
2615,3.8e-05,74.125.24.0-255,4320,6226,8,172701
2616,4.8e-05,172.31.36.0-255,66,6292,8,172701
2617,5.3e-05,74.125.24.0-255,4320,10612,8,172701
2618,5.6e-05,172.31.36.0-255,66,10678,8,172701
2619,0.000108,172.31.36.0-255,66,10744,8,172701
2620,0.000133,74.125.24.0-255,1830,12574,8,172701
2621,0.000136,172.31.36.0-255,66,12640,8,172701
2622,0.000168,172.31.36.0-255,66,12706,8,172701
2623,0.000218,74.125.24.0-255,1484,14190,8,172701
2624,0.00022,172.31.36.0-255,66,14256,8,172701
2625,0.000224,74.125.24.0-255,2902,17158,8,172701
2626,0.000226,172.31.36.0-255,66,17224,8,172701
2627,0.000232,74.125.24.0-255,5738,22962,8,172701
2628,0.000234,172.31.36.0-255,66,23028,8,172701
2629,0.000268,172.31.36.0-255,66,23094,8,172701
2630,0.000307,74.125.24.0-255,4320,27414,8,172701
2631,0.000309,172.31.36.0-255,66,27480,8,172701
2632,0.000337,74.125.24.0-255,7156,34636,8,172701
2633,0.00034,172.31.36.0-255,66,34702,8,172701
2634,0.000367,74.125.24.0-255,2184,36886,8,172701
2635,0.000369,172.31.36.0-255,66,36952,8,172701
2636,0.000372,74.125.24.0-255,402,37354,8,172701
2637,0.000374,172.31.36.0-255,66,37420,8,172701
2638,0.000407,74.125.24.0-255,109,37529,8,172701
2639,0.000409,172.31.36.0-255,66,37595,8,172701
2640,0.000584,74.125.24.0-255,1484,39079,8,172701
2641,0.000593,74.125.24.0-255,2902,41981,8,172701
2642,0.000596,172.31.36.0-255,66,42047,8,172701
2643,0.000602,74.125.24.0-255,4320,46367,8,172701
2644,0.000604,172.31.36.0-255,66,46433,8,172701
2645,0.000628,74.125.24.0-255,1484,47917,8,172701
2646,0.000639,74.125.24.0-255,7156,55073,8,172701
2647,0.000642,172.31.36.0-255,66,55139,8,172701
2648,0.000685,172.31.36.0-255,66,55205,8,172701
2649,0.000737,74.125.24.0-255,2184,57389,8,172701
2650,0.00074,172.31.36.0-255,66,57455,8,172701
2651,0.000996,74.125.24.0-255,1484,58939,8,172701
2652,0.001003,74.125.24.0-255,2902,61841,8,172701
2653,0.001009,172.31.36.0-255,66,61907,8,172701
2654,0.001033,74.125.24.0-255,5738,67645,8,172701
2655,0.001038,172.31.36.0-255,66,67711,8,172701
2656,0.001085,172.31.36.0-255,66,67777,8,172701
2657,0.001118,74.125.24.0-255,5738,73515,8,172701
2658,0.001136,74.125.24.0-255,1484,74999,8,172701
2659,0.001142,74.125.24.0-255,3602,78601,8,172701
2660,0.001166,74.125.24.0-255,2902,81503,8,172701
2661,0.00118,74.125.24.0-255,1484,82987,8,172701
2662,0.001198,74.125.24.0-255,4320,87307,8,172701
2663,0.001208,172.31.36.0-255,66,87373,8,172701
2664,0.001226,74.125.24.0-255,5738,93111,8,172701
2665,0.001231,74.125.24.0-255,2902,96013,8,172701
2666,0.00126,74.125.24.0-255,2902,98915,8,172701
2667,0.001262,74.125.24.0-255,1484,100399,8,172701
2668,0.001266,172.31.36.0-255,66,100465,8,172701
2669,0.001279,74.125.24.0-255,5738,106203,8,172701
2670,0.001307,74.125.24.0-255,6438,112641,8,172701
2671,0.001322,172.31.36.0-255,66,112707,8,172701
2672,0.001402,74.125.24.0-255,1484,114191,8,172701
2673,0.001408,74.125.24.0-255,2902,117093,8,172701
2674,0.001411,74.125.24.0-255,1484,118577,8,172701
2675,0.00143,74.125.24.0-255,4320,122897,8,172701
2676,0.001436,172.31.36.0-255,66,122963,8,172701
2677,0.001465,172.31.36.0-255,66,123029,8,172701
2678,0.001474,74.125.24.0-255,1484,124513,8,172701
2679,0.001548,172.31.36.0-255,66,124579,8,172701
2680,0.001588,74.125.24.0-255,1484,126063,8,172701
2681,0.001595,74.125.24.0-255,2902,128965,8,172701
2682,0.001603,172.31.36.0-255,66,129031,8,172701
2683,0.001624,74.125.24.0-255,5738,134769,8,172701
2684,0.001681,74.125.24.0-255,4320,139089,8,172701
2685,0.001726,172.31.36.0-255,66,139155,8,172701
2686,0.001754,172.31.36.0-255,66,139221,8,172701
2687,0.001817,74.125.24.0-255,7156,146377,8,172701
2688,0.001824,172.31.36.0-255,66,146443,8,172701
2689,0.001863,74.125.24.0-255,5020,151463,8,172701
2690,0.001882,172.31.36.0-255,66,151529,8,172701
2691,0.001961,74.125.24.0-255,5738,157267,8,172701
2692,0.001967,172.31.36.0-255,66,157333,8,172701
2693,0.00201,172.31.36.0-255,66,157399,8,172701
2694,0.002103,74.125.24.0-255,2902,160301,8,172701
2695,0.002109,172.31.36.0-255,66,160367,8,172701
2696,0.002121,74.125.24.0-255,2902,163269,8,172701
2697,0.002141,172.31.36.0-255,66,163335,8,172701
2698,0.002196,74.125.24.0-255,2884,166219,8,172701
2699,0.00221,172.31.36.0-255,66,166285,8,172701
2700,0.002366,74.125.24.0-255,2902,169187,8,172701
2701,0.002373,172.31.36.0-255,66,169253,8,172701
2702,0.002422,172.31.36.0-255,66,169319,8,172701
2703,0.002507,172.31.36.0-255,66,169385,8,172701
2704,0.002529,172.31.36.0-255,66,169451,8,172701
2705,0.004542,74.125.24.0-255,105,169556,8,172701
2706,0.01354,172.31.36.0-255,66,169622,8,172701
2707,0.013605,172.31.36.0-255,105,169727,8,172701
2708,0.015616,74.125.24.0-255,66,169793,8,172701
2709,0.026636,172.31.36.0-255,172,169965,8,172701
2710,0.026692,172.31.36.0-255,1110,171075,8,172701
2711,0.026773,172.31.36.0-255,1428,172503,8,172701
2712,0.028173,104.244.42.0-255,66,172569,8,172701
2713,0.028217,104.244.42.0-255,66,172635,8,172701
2714,0.028367,104.244.42.0-255,66,172701,8,172701
2715,0.0,74.125.68.0-255,226,226,8,203112
2716,2.5e-05,172.31.36.0-255,66,292,8,203112
2717,3.2e-05,74.125.68.0-255,1484,1776,8,203112
2718,3.5e-05,172.31.36.0-255,66,1842,8,203112
2719,6.3e-05,74.125.68.0-255,2902,4744,8,203112
2720,7.1e-05,172.31.36.0-255,66,4810,8,203112
2721,0.000187,74.125.68.0-255,5738,10548,8,203112
2722,0.000193,172.31.36.0-255,66,10614,8,203112
2723,0.000416,74.125.68.0-255,3567,14181,8,203112
2724,0.000421,172.31.36.0-255,66,14247,8,203112
2725,0.000564,172.31.36.0-255,66,14313,8,203112
2726,0.000591,74.125.68.0-255,1484,15797,8,203112
2727,0.000595,172.31.36.0-255,66,15863,8,203112
2728,0.001021,172.31.36.0-255,66,15929,8,203112
2729,0.001334,74.125.68.0-255,2902,18831,8,203112
2730,0.001339,172.31.36.0-255,66,18897,8,203112
2731,0.002262,74.125.68.0-255,2902,21799,8,203112
2732,0.002267,172.31.36.0-255,66,21865,8,203112
2733,0.003552,74.125.68.0-255,2902,24767,8,203112
2734,0.003558,172.31.36.0-255,66,24833,8,203112
2735,0.004492,74.125.68.0-255,2902,27735,8,203112
2736,0.004497,172.31.36.0-255,66,27801,8,203112
2737,0.005781,74.125.68.0-255,2902,30703,8,203112
2738,0.005787,172.31.36.0-255,66,30769,8,203112
2739,0.006724,74.125.68.0-255,2902,33671,8,203112
2740,0.006731,172.31.36.0-255,66,33737,8,203112
2741,0.008011,74.125.68.0-255,2902,36639,8,203112
2742,0.008017,172.31.36.0-255,66,36705,8,203112
2743,0.008954,74.125.68.0-255,2902,39607,8,203112
2744,0.008961,172.31.36.0-255,66,39673,8,203112
2745,0.010231,74.125.68.0-255,2902,42575,8,203112
2746,0.010237,172.31.36.0-255,66,42641,8,203112
2747,0.011191,74.125.68.0-255,2902,45543,8,203112
2748,0.011197,172.31.36.0-255,66,45609,8,203112
2749,0.012459,74.125.68.0-255,2902,48511,8,203112
2750,0.012465,172.31.36.0-255,66,48577,8,203112
2751,0.013421,74.125.68.0-255,2902,51479,8,203112
2752,0.013428,172.31.36.0-255,66,51545,8,203112
2753,0.014681,74.125.68.0-255,2902,54447,8,203112
2754,0.014688,172.31.36.0-255,66,54513,8,203112
2755,0.015664,74.125.68.0-255,2902,57415,8,203112
2756,0.01567,172.31.36.0-255,66,57481,8,203112
2757,0.016282,172.31.36.0-255,172,57653,8,203112
2758,0.016322,172.31.36.0-255,1111,58764,8,203112
2759,0.016402,172.31.36.0-255,1512,60276,8,203112
2760,0.016918,74.125.68.0-255,2902,63178,8,203112
2761,0.016924,172.31.36.0-255,66,63244,8,203112
2762,0.01781,104.244.42.0-255,66,63310,8,203112
2763,0.017822,104.244.42.0-255,66,63376,8,203112
2764,0.017882,74.125.68.0-255,2902,66278,8,203112
2765,0.017886,172.31.36.0-255,66,66344,8,203112
2766,0.017922,104.244.42.0-255,66,66410,8,203112
2767,0.018475,104.244.42.0-255,108,66518,8,203112
2768,0.01848,172.31.36.0-255,66,66584,8,203112
2769,0.019147,74.125.68.0-255,2902,69486,8,203112
2770,0.019152,172.31.36.0-255,66,69552,8,203112
2771,0.020109,74.125.68.0-255,2902,72454,8,203112
2772,0.020113,172.31.36.0-255,66,72520,8,203112
2773,0.021372,74.125.68.0-255,2902,75422,8,203112
2774,0.021378,172.31.36.0-255,66,75488,8,203112
2775,0.022329,74.125.68.0-255,2902,78390,8,203112
2776,0.022335,172.31.36.0-255,66,78456,8,203112
2777,0.023601,74.125.68.0-255,2902,81358,8,203112
2778,0.023607,172.31.36.0-255,66,81424,8,203112
2779,0.024555,74.125.68.0-255,2902,84326,8,203112
2780,0.024561,172.31.36.0-255,66,84392,8,203112
2781,0.02584,74.125.68.0-255,2902,87294,8,203112
2782,0.025846,172.31.36.0-255,66,87360,8,203112
2783,0.026785,74.125.68.0-255,2902,90262,8,203112
2784,0.026791,172.31.36.0-255,66,90328,8,203112
2785,0.028069,74.125.68.0-255,2902,93230,8,203112
2786,0.028074,172.31.36.0-255,66,93296,8,203112
2787,0.02902,74.125.68.0-255,2902,96198,8,203112
2788,0.029027,172.31.36.0-255,66,96264,8,203112
2789,0.030281,74.125.68.0-255,2902,99166,8,203112
2790,0.030286,172.31.36.0-255,66,99232,8,203112
2791,0.031237,74.125.68.0-255,2902,102134,8,203112
2792,0.031241,172.31.36.0-255,66,102200,8,203112
2793,0.032502,74.125.68.0-255,2902,105102,8,203112
2794,0.032507,172.31.36.0-255,66,105168,8,203112
2795,0.03346,74.125.68.0-255,2902,108070,8,203112
2796,0.033465,172.31.36.0-255,66,108136,8,203112
2797,0.034722,74.125.68.0-255,2902,111038,8,203112
2798,0.034727,172.31.36.0-255,66,111104,8,203112
2799,0.035674,74.125.68.0-255,2902,114006,8,203112
2800,0.03568,172.31.36.0-255,66,114072,8,203112
2801,0.036937,74.125.68.0-255,2902,116974,8,203112
2802,0.036942,172.31.36.0-255,66,117040,8,203112
2803,0.0379,74.125.68.0-255,2902,119942,8,203112
2804,0.037905,172.31.36.0-255,66,120008,8,203112
2805,0.039167,74.125.68.0-255,2902,122910,8,203112
2806,0.039173,172.31.36.0-255,66,122976,8,203112
2807,0.040126,74.125.68.0-255,2902,125878,8,203112
2808,0.040132,172.31.36.0-255,66,125944,8,203112
2809,0.041393,74.125.68.0-255,2902,128846,8,203112
2810,0.041398,172.31.36.0-255,66,128912,8,203112
2811,0.042373,74.125.68.0-255,2902,131814,8,203112
2812,0.042378,172.31.36.0-255,66,131880,8,203112
2813,0.043626,74.125.68.0-255,2902,134782,8,203112
2814,0.043631,172.31.36.0-255,66,134848,8,203112
2815,0.044598,74.125.68.0-255,2902,137750,8,203112
2816,0.044603,172.31.36.0-255,66,137816,8,203112
2817,0.045845,74.125.68.0-255,2902,140718,8,203112
2818,0.045851,172.31.36.0-255,66,140784,8,203112
2819,0.046829,74.125.68.0-255,2902,143686,8,203112
2820,0.046835,172.31.36.0-255,66,143752,8,203112
2821,0.048063,74.125.68.0-255,2902,146654,8,203112
2822,0.048068,172.31.36.0-255,66,146720,8,203112
2823,0.049048,74.125.68.0-255,2902,149622,8,203112
2824,0.049053,172.31.36.0-255,66,149688,8,203112
2825,0.050282,74.125.68.0-255,2902,152590,8,203112
2826,0.050287,172.31.36.0-255,66,152656,8,203112
2827,0.051268,74.125.68.0-255,2902,155558,8,203112
2828,0.051274,172.31.36.0-255,66,155624,8,203112
2829,0.052506,74.125.68.0-255,2902,158526,8,203112
2830,0.052511,172.31.36.0-255,66,158592,8,203112
2831,0.053491,74.125.68.0-255,2902,161494,8,203112
2832,0.053496,172.31.36.0-255,66,161560,8,203112
2833,0.054732,74.125.68.0-255,2902,164462,8,203112
2834,0.05475,172.31.36.0-255,66,164528,8,203112
2835,0.05573,74.125.68.0-255,2902,167430,8,203112
2836,0.055736,172.31.36.0-255,66,167496,8,203112
2837,0.05697,74.125.68.0-255,2902,170398,8,203112
2838,0.056975,172.31.36.0-255,66,170464,8,203112
2839,0.057956,74.125.68.0-255,2902,173366,8,203112
2840,0.057962,172.31.36.0-255,66,173432,8,203112
2841,0.059199,74.125.68.0-255,2902,176334,8,203112
2842,0.059205,172.31.36.0-255,66,176400,8,203112
2843,0.060181,74.125.68.0-255,2902,179302,8,203112
2844,0.060186,172.31.36.0-255,66,179368,8,203112
2845,0.061414,74.125.68.0-255,2902,182270,8,203112
2846,0.06142,172.31.36.0-255,66,182336,8,203112
2847,0.062408,74.125.68.0-255,2902,185238,8,203112
2848,0.062414,172.31.36.0-255,66,185304,8,203112
2849,0.063641,74.125.68.0-255,2902,188206,8,203112
2850,0.063647,172.31.36.0-255,66,188272,8,203112
2851,0.064634,74.125.68.0-255,2902,191174,8,203112
2852,0.064639,172.31.36.0-255,66,191240,8,203112
2853,0.065884,74.125.68.0-255,2902,194142,8,203112
2854,0.065889,172.31.36.0-255,66,194208,8,203112
2855,0.066849,74.125.68.0-255,2902,197110,8,203112
2856,0.066853,172.31.36.0-255,66,197176,8,203112
2857,0.068116,74.125.68.0-255,2902,200078,8,203112
2858,0.068121,172.31.36.0-255,66,200144,8,203112
2859,0.069064,74.125.68.0-255,2902,203046,8,203112
2860,0.069068,172.31.36.0-255,66,203112,8,203112
2861,0.0,172.217.194.0-255,153,153,8,264890
2862,2.2e-05,172.31.36.0-255,66,219,8,264890
2863,2.9e-05,172.217.194.0-255,1484,1703,8,264890
2864,3.4e-05,172.31.36.0-255,66,1769,8,264890
2865,3.9e-05,172.217.194.0-255,2902,4671,8,264890
2866,4.3e-05,172.31.36.0-255,66,4737,8,264890
2867,5.1e-05,172.217.194.0-255,7156,11893,8,264890
2868,5.4e-05,172.31.36.0-255,66,11959,8,264890
2869,6.2e-05,172.217.194.0-255,7156,19115,8,264890
2870,6.5e-05,172.31.36.0-255,66,19181,8,264890
2871,0.000102,172.31.36.0-255,66,19247,8,264890
2872,0.000107,172.217.194.0-255,2543,21790,8,264890
2873,0.00011,172.31.36.0-255,66,21856,8,264890
2874,0.000113,172.217.194.0-255,1484,23340,8,264890
2875,0.000115,172.31.36.0-255,66,23406,8,264890
2876,0.000119,172.217.194.0-255,1484,24890,8,264890
2877,0.000121,172.31.36.0-255,66,24956,8,264890
2878,0.00014,172.217.194.0-255,1484,26440,8,264890
2879,0.000143,172.31.36.0-255,66,26506,8,264890
2880,0.00015,172.217.194.0-255,5738,32244,8,264890
2881,0.000152,172.31.36.0-255,66,32310,8,264890
2882,0.000173,172.217.194.0-255,1484,33794,8,264890
2883,0.000175,172.31.36.0-255,66,33860,8,264890
2884,0.000208,172.31.36.0-255,66,33926,8,264890
2885,0.000259,172.31.36.0-255,66,33992,8,264890
2886,0.000275,172.217.194.0-255,1431,35423,8,264890
2887,0.000277,172.31.36.0-255,66,35489,8,264890
2888,0.00028,172.217.194.0-255,381,35870,8,264890
2889,0.000281,172.31.36.0-255,66,35936,8,264890
2890,0.000668,172.217.194.0-255,1484,37420,8,264890
2891,0.000676,172.217.194.0-255,2902,40322,8,264890
2892,0.00068,172.31.36.0-255,66,40388,8,264890
2893,0.000688,172.217.194.0-255,5738,46126,8,264890
2894,0.00069,172.31.36.0-255,66,46192,8,264890
2895,0.000709,172.217.194.0-255,2902,49094,8,264890
2896,0.000711,172.31.36.0-255,66,49160,8,264890
2897,0.000748,172.31.36.0-255,66,49226,8,264890
2898,0.000761,172.31.36.0-255,66,49292,8,264890
2899,0.000784,172.217.194.0-255,766,50058,8,264890
2900,0.000984,172.217.194.0-255,1484,51542,8,264890
2901,0.000989,172.31.36.0-255,66,51608,8,264890
2902,0.000996,172.217.194.0-255,2902,54510,8,264890
2903,0.000998,172.31.36.0-255,66,54576,8,264890
2904,0.001004,172.217.194.0-255,5738,60314,8,264890
2905,0.001006,172.31.36.0-255,66,60380,8,264890
2906,0.001031,172.217.194.0-255,4320,64700,8,264890
2907,0.001034,172.31.36.0-255,66,64766,8,264890
2908,0.001064,172.31.36.0-255,66,64832,8,264890
2909,0.001076,172.31.36.0-255,66,64898,8,264890
2910,0.0011,172.217.194.0-255,2184,67082,8,264890
2911,0.001103,172.31.36.0-255,66,67148,8,264890
2912,0.003095,172.217.194.0-255,5738,72886,8,264890
2913,0.003101,172.31.36.0-255,66,72952,8,264890
2914,0.005081,172.217.194.0-255,4320,77272,8,264890
2915,0.005084,172.31.36.0-255,66,77338,8,264890
2916,0.005103,172.217.194.0-255,1484,78822,8,264890
2917,0.007098,172.217.194.0-255,4320,83142,8,264890
2918,0.007104,172.31.36.0-255,66,83208,8,264890
2919,0.009109,172.217.194.0-255,5738,88946,8,264890
2920,0.009116,172.31.36.0-255,66,89012,8,264890
2921,0.011119,172.217.194.0-255,5738,94750,8,264890
2922,0.011127,172.31.36.0-255,66,94816,8,264890
2923,0.013163,172.217.194.0-255,5738,100554,8,264890
2924,0.01317,172.31.36.0-255,66,100620,8,264890
2925,0.015197,172.217.194.0-255,5738,106358,8,264890
2926,0.015205,172.31.36.0-255,66,106424,8,264890
2927,0.017225,172.217.194.0-255,5738,112162,8,264890
2928,0.017233,172.31.36.0-255,66,112228,8,264890
2929,0.019231,172.217.194.0-255,5738,117966,8,264890
2930,0.019238,172.31.36.0-255,66,118032,8,264890
2931,0.021252,172.217.194.0-255,5738,123770,8,264890
2932,0.021261,172.31.36.0-255,66,123836,8,264890
2933,0.023277,172.217.194.0-255,5738,129574,8,264890
2934,0.023285,172.31.36.0-255,66,129640,8,264890
2935,0.025316,172.217.194.0-255,4320,133960,8,264890
2936,0.025322,172.31.36.0-255,66,134026,8,264890
2937,0.02534,172.217.194.0-255,1484,135510,8,264890
2938,0.027313,172.217.194.0-255,4320,139830,8,264890
2939,0.027321,172.31.36.0-255,66,139896,8,264890
2940,0.029312,172.217.194.0-255,5738,145634,8,264890
2941,0.029319,172.31.36.0-255,66,145700,8,264890
2942,0.031313,172.217.194.0-255,5738,151438,8,264890
2943,0.031321,172.31.36.0-255,66,151504,8,264890
2944,0.033339,172.217.194.0-255,5738,157242,8,264890
2945,0.033347,172.31.36.0-255,66,157308,8,264890
2946,0.035434,172.217.194.0-255,5738,163046,8,264890
2947,0.035442,172.31.36.0-255,66,163112,8,264890
2948,0.037089,172.31.36.0-255,208,163320,8,264890
2949,0.037131,172.31.36.0-255,955,164275,8,264890
2950,0.0372,172.31.36.0-255,1514,165789,8,264890
2951,0.037202,172.31.36.0-255,1514,167303,8,264890
2952,0.037207,172.31.36.0-255,1514,168817,8,264890
2953,0.037208,172.31.36.0-255,1514,170331,8,264890
2954,0.037226,172.31.36.0-255,1431,171762,8,264890
2955,0.037444,172.217.194.0-255,5738,177500,8,264890
2956,0.03745,172.31.36.0-255,66,177566,8,264890
2957,0.038668,104.244.42.0-255,66,177632,8,264890
2958,0.038708,104.244.42.0-255,66,177698,8,264890
2959,0.038783,104.244.42.0-255,66,177764,8,264890
2960,0.038849,104.244.42.0-255,66,177830,8,264890
2961,0.039442,172.217.194.0-255,5738,183568,8,264890
2962,0.039449,172.31.36.0-255,66,183634,8,264890
2963,0.041601,172.217.194.0-255,5738,189372,8,264890
2964,0.041608,172.31.36.0-255,66,189438,8,264890
2965,0.043635,172.217.194.0-255,5738,195176,8,264890
2966,0.043642,172.31.36.0-255,66,195242,8,264890
2967,0.045702,172.217.194.0-255,5738,200980,8,264890
2968,0.045709,172.31.36.0-255,66,201046,8,264890
2969,0.047722,172.217.194.0-255,5738,206784,8,264890
2970,0.04773,172.31.36.0-255,66,206850,8,264890
2971,0.04975,172.217.194.0-255,5738,212588,8,264890
2972,0.049757,172.31.36.0-255,66,212654,8,264890
2973,0.051782,172.217.194.0-255,5738,218392,8,264890
2974,0.051788,172.31.36.0-255,66,218458,8,264890
2975,0.053844,172.217.194.0-255,5738,224196,8,264890
2976,0.053852,172.31.36.0-255,66,224262,8,264890
2977,0.055858,172.217.194.0-255,5738,230000,8,264890
2978,0.055864,172.31.36.0-255,66,230066,8,264890
2979,0.057885,172.217.194.0-255,5738,235804,8,264890
2980,0.057891,172.31.36.0-255,66,235870,8,264890
2981,0.059947,172.217.194.0-255,5738,241608,8,264890
2982,0.059954,172.31.36.0-255,66,241674,8,264890
2983,0.061976,172.217.194.0-255,5738,247412,8,264890
2984,0.061982,172.31.36.0-255,66,247478,8,264890
2985,0.064029,172.217.194.0-255,5738,253216,8,264890
2986,0.064036,172.31.36.0-255,66,253282,8,264890
2987,0.066038,172.217.194.0-255,5738,259020,8,264890
2988,0.066048,172.31.36.0-255,66,259086,8,264890
2989,0.068086,172.217.194.0-255,5738,264824,8,264890
2990,0.068092,172.31.36.0-255,66,264890,8,264890
2991,0.0,172.217.194.0-255,153,153,8,294874
2992,2.9e-05,172.31.36.0-255,66,219,8,294874
2993,3.6e-05,172.217.194.0-255,1484,1703,8,294874
2994,4e-05,172.31.36.0-255,66,1769,8,294874
2995,4.5e-05,172.217.194.0-255,2902,4671,8,294874
2996,4.8e-05,172.31.36.0-255,66,4737,8,294874
2997,5.2e-05,172.217.194.0-255,2902,7639,8,294874
2998,5.4e-05,172.31.36.0-255,66,7705,8,294874
2999,0.000109,172.31.36.0-255,66,7771,8,294874
3000,0.00012,172.31.36.0-255,66,7837,8,294874
3001,0.00013,172.217.194.0-255,1484,9321,8,294874
3002,0.000133,172.31.36.0-255,66,9387,8,294874
3003,0.000182,172.31.36.0-255,66,9453,8,294874
3004,0.000186,172.217.194.0-255,2184,11637,8,294874
3005,0.000188,172.31.36.0-255,66,11703,8,294874
3006,0.000406,172.217.194.0-255,1484,13187,8,294874
3007,0.00041,172.31.36.0-255,66,13253,8,294874
3008,0.000416,172.217.194.0-255,2902,16155,8,294874
3009,0.000418,172.31.36.0-255,66,16221,8,294874
3010,0.000421,172.217.194.0-255,1484,17705,8,294874
3011,0.000423,172.31.36.0-255,66,17771,8,294874
3012,0.000447,172.217.194.0-255,4320,22091,8,294874
3013,0.000452,172.31.36.0-255,66,22157,8,294874
3014,0.000465,172.217.194.0-255,2902,25059,8,294874
3015,0.000469,172.31.36.0-255,66,25125,8,294874
3016,0.000498,172.217.194.0-255,3961,29086,8,294874
3017,0.000501,172.31.36.0-255,66,29152,8,294874
3018,0.00077,172.217.194.0-255,647,29799,8,294874
3019,0.000774,172.31.36.0-255,66,29865,8,294874
3020,0.000841,172.217.194.0-255,1484,31349,8,294874
3021,0.000846,172.217.194.0-255,2902,34251,8,294874
3022,0.000849,172.31.36.0-255,66,34317,8,294874
3023,0.000883,172.217.194.0-255,5738,40055,8,294874
3024,0.000887,172.31.36.0-255,66,40121,8,294874
3025,0.00089,172.217.194.0-255,1484,41605,8,294874
3026,0.000901,172.31.36.0-255,66,41671,8,294874
3027,0.000933,172.31.36.0-255,66,41737,8,294874
3028,0.000965,172.217.194.0-255,5020,46757,8,294874
3029,0.000969,172.31.36.0-255,66,46823,8,294874
3030,0.001673,172.217.194.0-255,1484,48307,8,294874
3031,0.001687,172.217.194.0-255,2902,51209,8,294874
3032,0.001692,172.31.36.0-255,66,51275,8,294874
3033,0.001698,172.217.194.0-255,4320,55595,8,294874
3034,0.0017,172.31.36.0-255,66,55661,8,294874
3035,0.001703,172.217.194.0-255,1484,57145,8,294874
3036,0.001736,172.217.194.0-255,7156,64301,8,294874
3037,0.001738,172.31.36.0-255,66,64367,8,294874
3038,0.001768,172.31.36.0-255,66,64433,8,294874
3039,0.001795,172.217.194.0-255,6438,70871,8,294874
3040,0.001797,172.31.36.0-255,66,70937,8,294874
3041,0.001801,172.217.194.0-255,1484,72421,8,294874
3042,0.001804,172.217.194.0-255,1484,73905,8,294874
3043,0.001805,172.31.36.0-255,66,73971,8,294874
3044,0.001814,172.217.194.0-255,1484,75455,8,294874
3045,0.001818,172.217.194.0-255,2902,78357,8,294874
3046,0.00182,172.31.36.0-255,66,78423,8,294874
3047,0.001842,172.217.194.0-255,2902,81325,8,294874
3048,0.001844,172.31.36.0-255,66,81391,8,294874
3049,0.001861,172.31.36.0-255,66,81457,8,294874
3050,0.001896,172.217.194.0-255,1484,82941,8,294874
3051,0.001912,172.217.194.0-255,7156,90097,8,294874
3052,0.001915,172.31.36.0-255,66,90163,8,294874
3053,0.001937,172.217.194.0-255,6438,96601,8,294874
3054,0.00194,172.31.36.0-255,66,96667,8,294874
3055,0.001952,172.31.36.0-255,66,96733,8,294874
3056,0.001974,172.217.194.0-255,1484,98217,8,294874
3057,0.001992,172.31.36.0-255,66,98283,8,294874
3058,0.001996,172.217.194.0-255,2184,100467,8,294874
3059,0.001998,172.31.36.0-255,66,100533,8,294874
3060,0.002108,172.217.194.0-255,1484,102017,8,294874
3061,0.004061,172.217.194.0-255,4320,106337,8,294874
3062,0.004067,172.31.36.0-255,66,106403,8,294874
3063,0.006135,172.217.194.0-255,5738,112141,8,294874
3064,0.00614,172.31.36.0-255,66,112207,8,294874
3065,0.008196,172.217.194.0-255,4320,116527,8,294874
3066,0.008201,172.31.36.0-255,66,116593,8,294874
3067,0.008242,172.217.194.0-255,1484,118077,8,294874
3068,0.010262,172.217.194.0-255,4320,122397,8,294874
3069,0.010269,172.31.36.0-255,66,122463,8,294874
3070,0.012348,172.217.194.0-255,5738,128201,8,294874
3071,0.012355,172.31.36.0-255,66,128267,8,294874
3072,0.014411,172.217.194.0-255,4320,132587,8,294874
3073,0.01442,172.31.36.0-255,66,132653,8,294874
3074,0.014427,172.217.194.0-255,1484,134137,8,294874
3075,0.016488,172.217.194.0-255,4320,138457,8,294874
3076,0.016495,172.31.36.0-255,66,138523,8,294874
3077,0.01857,172.217.194.0-255,5738,144261,8,294874
3078,0.01858,172.31.36.0-255,66,144327,8,294874
3079,0.020639,172.217.194.0-255,5738,150065,8,294874
3080,0.020646,172.31.36.0-255,66,150131,8,294874
3081,0.022741,172.217.194.0-255,5738,155869,8,294874
3082,0.022751,172.31.36.0-255,66,155935,8,294874
3083,0.024843,172.217.194.0-255,5738,161673,8,294874
3084,0.024851,172.31.36.0-255,66,161739,8,294874
3085,0.026925,172.217.194.0-255,5738,167477,8,294874
3086,0.026955,172.31.36.0-255,66,167543,8,294874
3087,0.029011,172.217.194.0-255,5738,173281,8,294874
3088,0.029019,172.31.36.0-255,66,173347,8,294874
3089,0.03108,172.217.194.0-255,2902,176249,8,294874
3090,0.031087,172.31.36.0-255,66,176315,8,294874
3091,0.03112,172.217.194.0-255,2902,179217,8,294874
3092,0.031123,172.31.36.0-255,66,179283,8,294874
3093,0.033171,172.217.194.0-255,2902,182185,8,294874
3094,0.033185,172.31.36.0-255,66,182251,8,294874
3095,0.033266,172.217.194.0-255,2902,185153,8,294874
3096,0.033271,172.31.36.0-255,66,185219,8,294874
3097,0.035252,172.217.194.0-255,2902,188121,8,294874
3098,0.035266,172.31.36.0-255,66,188187,8,294874
3099,0.035365,172.217.194.0-255,2902,191089,8,294874
3100,0.03537,172.31.36.0-255,66,191155,8,294874
3101,0.037352,172.217.194.0-255,2902,194057,8,294874
3102,0.037365,172.31.36.0-255,66,194123,8,294874
3103,0.037442,172.217.194.0-255,2902,197025,8,294874
3104,0.037448,172.31.36.0-255,66,197091,8,294874
3105,0.037603,172.31.36.0-255,172,197263,8,294874
3106,0.037634,172.31.36.0-255,1110,198373,8,294874
3107,0.037697,172.31.36.0-255,1514,199887,8,294874
3108,0.037699,172.31.36.0-255,1514,201401,8,294874
3109,0.037705,172.31.36.0-255,1514,202915,8,294874
3110,0.037706,172.31.36.0-255,1514,204429,8,294874
3111,0.037742,172.31.36.0-255,1231,205660,8,294874
3112,0.039149,104.244.42.0-255,66,205726,8,294874
3113,0.039178,104.244.42.0-255,66,205792,8,294874
3114,0.039255,104.244.42.0-255,66,205858,8,294874
3115,0.039299,104.244.42.0-255,66,205924,8,294874
3116,0.039401,172.217.194.0-255,2902,208826,8,294874
3117,0.039405,172.31.36.0-255,66,208892,8,294874
3118,0.039518,172.217.194.0-255,2902,211794,8,294874
3119,0.039523,172.31.36.0-255,66,211860,8,294874
3120,0.040021,104.244.42.0-255,108,211968,8,294874
3121,0.040043,172.31.36.0-255,66,212034,8,294874
3122,0.041473,172.217.194.0-255,2902,214936,8,294874
3123,0.041476,172.31.36.0-255,66,215002,8,294874
3124,0.041563,172.217.194.0-255,2902,217904,8,294874
3125,0.041568,172.31.36.0-255,66,217970,8,294874
3126,0.043552,172.217.194.0-255,2902,220872,8,294874
3127,0.043557,172.31.36.0-255,66,220938,8,294874
3128,0.043618,172.217.194.0-255,2902,223840,8,294874
3129,0.043622,172.31.36.0-255,66,223906,8,294874
3130,0.045626,172.217.194.0-255,2902,226808,8,294874
3131,0.045631,172.31.36.0-255,66,226874,8,294874
3132,0.045685,172.217.194.0-255,2902,229776,8,294874
3133,0.045688,172.31.36.0-255,66,229842,8,294874
3134,0.047689,172.217.194.0-255,2902,232744,8,294874
3135,0.047693,172.31.36.0-255,66,232810,8,294874
3136,0.047735,172.217.194.0-255,2902,235712,8,294874
3137,0.047738,172.31.36.0-255,66,235778,8,294874
3138,0.049761,172.217.194.0-255,2902,238680,8,294874
3139,0.049767,172.31.36.0-255,66,238746,8,294874
3140,0.049802,172.217.194.0-255,2902,241648,8,294874
3141,0.049805,172.31.36.0-255,66,241714,8,294874
3142,0.051822,172.217.194.0-255,2902,244616,8,294874
3143,0.051842,172.31.36.0-255,66,244682,8,294874
3144,0.051871,172.217.194.0-255,2902,247584,8,294874
3145,0.051876,172.31.36.0-255,66,247650,8,294874
3146,0.053925,172.217.194.0-255,2902,250552,8,294874
3147,0.053929,172.31.36.0-255,66,250618,8,294874
3148,0.053967,172.217.194.0-255,2902,253520,8,294874
3149,0.05397,172.31.36.0-255,66,253586,8,294874
3150,0.056023,172.217.194.0-255,5738,259324,8,294874
3151,0.056029,172.31.36.0-255,66,259390,8,294874
3152,0.058096,172.217.194.0-255,5738,265128,8,294874
3153,0.058101,172.31.36.0-255,66,265194,8,294874
3154,0.060159,172.217.194.0-255,2902,268096,8,294874
3155,0.060164,172.31.36.0-255,66,268162,8,294874
3156,0.060194,172.217.194.0-255,2902,271064,8,294874
3157,0.060198,172.31.36.0-255,66,271130,8,294874
3158,0.062209,172.217.194.0-255,2902,274032,8,294874
3159,0.062214,172.31.36.0-255,66,274098,8,294874
3160,0.062258,172.217.194.0-255,2902,277000,8,294874
3161,0.062262,172.31.36.0-255,66,277066,8,294874
3162,0.064268,172.217.194.0-255,2902,279968,8,294874
3163,0.064274,172.31.36.0-255,66,280034,8,294874
3164,0.06431,172.217.194.0-255,2902,282936,8,294874
3165,0.064313,172.31.36.0-255,66,283002,8,294874
3166,0.066345,172.217.194.0-255,2902,285904,8,294874
3167,0.066351,172.31.36.0-255,66,285970,8,294874
3168,0.066386,172.217.194.0-255,2902,288872,8,294874
3169,0.066389,172.31.36.0-255,66,288938,8,294874
3170,0.068427,172.217.194.0-255,2902,291840,8,294874
3171,0.068434,172.31.36.0-255,66,291906,8,294874
3172,0.068471,172.217.194.0-255,2902,294808,8,294874
3173,0.068474,172.31.36.0-255,66,294874,8,294874
3174,0.0,172.217.194.0-255,152,152,8,163833
3175,2e-05,172.31.36.0-255,66,218,8,163833
3176,2.7e-05,172.217.194.0-255,1484,1702,8,163833
3177,3.1e-05,172.31.36.0-255,66,1768,8,163833
3178,4.5e-05,172.217.194.0-255,2902,4670,8,163833
3179,4.9e-05,172.31.36.0-255,66,4736,8,163833
3180,5.7e-05,172.217.194.0-255,7156,11892,8,163833
3181,6e-05,172.31.36.0-255,66,11958,8,163833
3182,6.5e-05,172.217.194.0-255,2092,14050,8,163833
3183,6.8e-05,172.31.36.0-255,66,14116,8,163833
3184,7.5e-05,172.217.194.0-255,5738,19854,8,163833
3185,7.8e-05,172.31.36.0-255,66,19920,8,163833
3186,0.000108,172.217.194.0-255,5738,25658,8,163833
3187,0.000111,172.31.36.0-255,66,25724,8,163833
3188,0.000118,172.217.194.0-255,5379,31103,8,163833
3189,0.000122,172.31.36.0-255,66,31169,8,163833
3190,0.000191,172.217.194.0-255,1484,32653,8,163833
3191,0.000194,172.31.36.0-255,66,32719,8,163833
3192,0.000199,172.217.194.0-255,2902,35621,8,163833
3193,0.000201,172.31.36.0-255,66,35687,8,163833
3194,0.000234,172.217.194.0-255,5738,41425,8,163833
3195,0.000237,172.31.36.0-255,66,41491,8,163833
3196,0.000268,172.217.194.0-255,6797,48288,8,163833
3197,0.000271,172.31.36.0-255,66,48354,8,163833
3198,0.000296,172.217.194.0-255,1484,49838,8,163833
3199,0.000299,172.31.36.0-255,66,49904,8,163833
3200,0.000329,172.217.194.0-255,5738,55642,8,163833
3201,0.000331,172.31.36.0-255,66,55708,8,163833
3202,0.000347,172.31.36.0-255,66,55774,8,163833
3203,0.000375,172.217.194.0-255,1705,57479,8,163833
3204,0.000377,172.31.36.0-255,66,57545,8,163833
3205,0.000523,172.217.194.0-255,1484,59029,8,163833
3206,0.00053,172.217.194.0-255,2902,61931,8,163833
3207,0.000533,172.31.36.0-255,66,61997,8,163833
3208,0.000537,172.217.194.0-255,1484,63481,8,163833
3209,0.000566,172.217.194.0-255,4320,67801,8,163833
3210,0.000568,172.31.36.0-255,66,67867,8,163833
3211,0.00059,172.31.36.0-255,66,67933,8,163833
3212,0.000638,172.31.36.0-255,66,67999,8,163833
3213,0.000762,172.217.194.0-255,1484,69483,8,163833
3214,0.000768,172.217.194.0-255,2902,72385,8,163833
3215,0.000771,172.31.36.0-255,66,72451,8,163833
3216,0.000776,172.217.194.0-255,2902,75353,8,163833
3217,0.000778,172.31.36.0-255,66,75419,8,163833
3218,0.000803,172.217.194.0-255,2902,78321,8,163833
3219,0.000855,172.31.36.0-255,66,78387,8,163833
3220,0.000863,172.31.36.0-255,66,78453,8,163833
3221,0.00088,172.31.36.0-255,66,78519,8,163833
3222,0.001235,172.217.194.0-255,1484,80003,8,163833
3223,0.001241,172.217.194.0-255,2902,82905,8,163833
3224,0.001247,172.31.36.0-255,66,82971,8,163833
3225,0.001256,172.217.194.0-255,2902,85873,8,163833
3226,0.001259,172.31.36.0-255,66,85939,8,163833
3227,0.001292,172.217.194.0-255,2902,88841,8,163833
3228,0.001308,172.217.194.0-255,4320,93161,8,163833
3229,0.001312,172.31.36.0-255,66,93227,8,163833
3230,0.001315,172.31.36.0-255,66,93293,8,163833
3231,0.001318,172.31.36.0-255,66,93359,8,163833
3232,0.001336,172.217.194.0-255,1484,94843,8,163833
3233,0.001359,172.217.194.0-255,5020,99863,8,163833
3234,0.001361,172.31.36.0-255,66,99929,8,163833
3235,0.001445,172.217.194.0-255,1484,101413,8,163833
3236,0.00145,172.217.194.0-255,1484,102897,8,163833
3237,0.001453,172.31.36.0-255,66,102963,8,163833
3238,0.001485,172.217.194.0-255,1484,104447,8,163833
3239,0.001492,172.217.194.0-255,5738,110185,8,163833
3240,0.001494,172.31.36.0-255,66,110251,8,163833
3241,0.001513,172.31.36.0-255,66,110317,8,163833
3242,0.001519,172.217.194.0-255,4320,114637,8,163833
3243,0.001521,172.31.36.0-255,66,114703,8,163833
3244,0.001561,172.217.194.0-255,5738,120441,8,163833
3245,0.001564,172.31.36.0-255,66,120507,8,163833
3246,0.00159,172.217.194.0-255,766,121273,8,163833
3247,0.001598,172.217.194.0-255,7156,128429,8,163833
3248,0.001601,172.31.36.0-255,66,128495,8,163833
3249,0.001639,172.31.36.0-255,66,128561,8,163833
3250,0.001653,172.31.36.0-255,66,128627,8,163833
3251,0.001657,172.217.194.0-255,2184,130811,8,163833
3252,0.001659,172.31.36.0-255,66,130877,8,163833
3253,0.001797,172.217.194.0-255,1484,132361,8,163833
3254,0.001811,172.217.194.0-255,2902,135263,8,163833
3255,0.001814,172.31.36.0-255,66,135329,8,163833
3256,0.001849,172.217.194.0-255,5738,141067,8,163833
3257,0.001853,172.31.36.0-255,66,141133,8,163833
3258,0.001876,172.31.36.0-255,66,141199,8,163833
3259,0.001888,172.31.36.0-255,66,141265,8,163833
3260,0.001911,172.217.194.0-255,766,142031,8,163833
3261,0.001961,172.217.194.0-255,1484,143515,8,163833
3262,0.001964,172.31.36.0-255,66,143581,8,163833
3263,0.00197,172.217.194.0-255,2902,146483,8,163833
3264,0.001972,172.31.36.0-255,66,146549,8,163833
3265,0.001975,172.217.194.0-255,1484,148033,8,163833
3266,0.002003,172.217.194.0-255,4320,152353,8,163833
3267,0.002006,172.31.36.0-255,66,152419,8,163833
3268,0.00202,172.31.36.0-255,66,152485,8,163833
3269,0.002036,172.31.36.0-255,66,152551,8,163833
3270,0.002121,172.31.36.0-255,66,152617,8,163833
3271,0.002155,172.31.36.0-255,66,152683,8,163833
3272,0.002177,172.31.36.0-255,66,152749,8,163833
3273,0.002194,172.31.36.0-255,66,152815,8,163833
3274,0.002211,172.31.36.0-255,66,152881,8,163833
3275,0.002246,172.217.194.0-255,5020,157901,8,163833
3276,0.002249,172.31.36.0-255,66,157967,8,163833
3277,0.002272,172.31.36.0-255,66,158033,8,163833
3278,0.002275,172.217.194.0-255,985,159018,8,163833
3279,0.004545,172.217.194.0-255,105,159123,8,163833
3280,0.011214,172.31.36.0-255,66,159189,8,163833
3281,0.011253,172.31.36.0-255,105,159294,8,163833
3282,0.011346,172.217.194.0-255,105,159399,8,163833
3283,0.011353,172.31.36.0-255,78,159477,8,163833
3284,0.013539,172.217.194.0-255,66,159543,8,163833
3285,0.033139,172.31.36.0-255,172,159715,8,163833
3286,0.033175,172.31.36.0-255,1112,160827,8,163833
3287,0.03324,172.31.36.0-255,1514,162341,8,163833
3288,0.033242,172.31.36.0-255,1294,163635,8,163833
3289,0.034632,104.244.42.0-255,66,163701,8,163833
3290,0.03467,104.244.42.0-255,66,163767,8,163833
3291,0.034737,104.244.42.0-255,66,163833,8,163833
3292,0.0,172.217.194.0-255,297,297,8,175019
3293,1.3e-05,172.31.36.0-255,66,363,8,175019
3294,1.9e-05,172.217.194.0-255,1484,1847,8,175019
3295,2.3e-05,172.31.36.0-255,66,1913,8,175019
3296,2.9e-05,172.217.194.0-255,4320,6233,8,175019
3297,3.9e-05,172.31.36.0-255,66,6299,8,175019
3298,5e-05,172.31.36.0-255,66,6365,8,175019
3299,0.000135,172.31.36.0-255,66,6431,8,175019
3300,0.000149,172.31.36.0-255,66,6497,8,175019
3301,0.000152,172.217.194.0-255,1125,7622,8,175019
3302,0.000154,172.31.36.0-255,66,7688,8,175019
3303,0.000193,172.217.194.0-255,1484,9172,8,175019
3304,0.000195,172.31.36.0-255,66,9238,8,175019
3305,0.0002,172.217.194.0-255,2902,12140,8,175019
3306,0.000202,172.31.36.0-255,66,12206,8,175019
3307,0.000229,172.217.194.0-255,1484,13690,8,175019
3308,0.000231,172.31.36.0-255,66,13756,8,175019
3309,0.000238,172.217.194.0-255,7156,20912,8,175019
3310,0.00024,172.31.36.0-255,66,20978,8,175019
3311,0.000265,172.217.194.0-255,3961,24939,8,175019
3312,0.000267,172.31.36.0-255,66,25005,8,175019
3313,0.00053,172.217.194.0-255,649,25654,8,175019
3314,0.000534,172.31.36.0-255,66,25720,8,175019
3315,0.000728,172.217.194.0-255,1484,27204,8,175019
3316,0.000732,172.31.36.0-255,66,27270,8,175019
3317,0.000737,172.217.194.0-255,2902,30172,8,175019
3318,0.000739,172.31.36.0-255,66,30238,8,175019
3319,0.000742,172.217.194.0-255,1484,31722,8,175019
3320,0.000743,172.31.36.0-255,66,31788,8,175019
3321,0.000767,172.217.194.0-255,4320,36108,8,175019
3322,0.000769,172.31.36.0-255,66,36174,8,175019
3323,0.000783,172.31.36.0-255,66,36240,8,175019
3324,0.000827,172.217.194.0-255,4320,40560,8,175019
3325,0.000829,172.31.36.0-255,66,40626,8,175019
3326,0.00086,172.31.36.0-255,66,40692,8,175019
3327,0.000946,172.217.194.0-255,1484,42176,8,175019
3328,0.000949,172.217.194.0-255,1484,43660,8,175019
3329,0.000957,172.31.36.0-255,66,43726,8,175019
3330,0.000961,172.217.194.0-255,1484,45210,8,175019
3331,0.000967,172.217.194.0-255,5738,50948,8,175019
3332,0.000969,172.31.36.0-255,66,51014,8,175019
3333,0.001003,172.217.194.0-255,4320,55334,8,175019
3334,0.001005,172.31.36.0-255,66,55400,8,175019
3335,0.001031,172.31.36.0-255,66,55466,8,175019
3336,0.001043,172.31.36.0-255,66,55532,8,175019
3337,0.001116,172.31.36.0-255,66,55598,8,175019
3338,0.001128,172.31.36.0-255,66,55664,8,175019
3339,0.001142,172.31.36.0-255,66,55730,8,175019
3340,0.001409,172.217.194.0-255,1484,57214,8,175019
3341,0.001415,172.217.194.0-255,2902,60116,8,175019
3342,0.001417,172.31.36.0-255,66,60182,8,175019
3343,0.001442,172.217.194.0-255,5738,65920,8,175019
3344,0.001444,172.31.36.0-255,66,65986,8,175019
3345,0.001477,172.31.36.0-255,66,66052,8,175019
3346,0.001482,172.217.194.0-255,2902,68954,8,175019
3347,0.001484,172.31.36.0-255,66,69020,8,175019
3348,0.00152,172.31.36.0-255,66,69086,8,175019
3349,0.001705,172.217.194.0-255,1484,70570,8,175019
3350,0.00171,172.217.194.0-255,2902,73472,8,175019
3351,0.001712,172.31.36.0-255,66,73538,8,175019
3352,0.001716,172.217.194.0-255,1484,75022,8,175019
3353,0.001742,172.217.194.0-255,4320,79342,8,175019
3354,0.001744,172.31.36.0-255,66,79408,8,175019
3355,0.001749,172.217.194.0-255,5738,85146,8,175019
3356,0.00175,172.31.36.0-255,66,85212,8,175019
3357,0.001755,172.217.194.0-255,2902,88114,8,175019
3358,0.001756,172.31.36.0-255,66,88180,8,175019
3359,0.001791,172.217.194.0-255,4320,92500,8,175019
3360,0.001793,172.31.36.0-255,66,92566,8,175019
3361,0.001802,172.31.36.0-255,66,92632,8,175019
3362,0.001831,172.217.194.0-255,2184,94816,8,175019
3363,0.001833,172.31.36.0-255,66,94882,8,175019
3364,0.001838,172.217.194.0-255,4320,99202,8,175019
3365,0.00184,172.31.36.0-255,66,99268,8,175019
3366,0.001867,172.217.194.0-255,1484,100752,8,175019
3367,0.001874,172.217.194.0-255,7156,107908,8,175019
3368,0.001876,172.31.36.0-255,66,107974,8,175019
3369,0.001879,172.217.194.0-255,1484,109458,8,175019
3370,0.001917,172.31.36.0-255,66,109524,8,175019
3371,0.001922,172.217.194.0-255,6438,115962,8,175019
3372,0.001925,172.31.36.0-255,66,116028,8,175019
3373,0.001963,172.217.194.0-255,1484,117512,8,175019
3374,0.001977,172.217.194.0-255,2902,120414,8,175019
3375,0.001981,172.31.36.0-255,66,120480,8,175019
3376,0.001985,172.217.194.0-255,2902,123382,8,175019
3377,0.001987,172.31.36.0-255,66,123448,8,175019
3378,0.002024,172.217.194.0-255,2902,126350,8,175019
3379,0.002027,172.31.36.0-255,66,126416,8,175019
3380,0.002032,172.217.194.0-255,2902,129318,8,175019
3381,0.002034,172.31.36.0-255,66,129384,8,175019
3382,0.002038,172.217.194.0-255,4320,133704,8,175019
3383,0.00204,172.31.36.0-255,66,133770,8,175019
3384,0.002055,172.31.36.0-255,66,133836,8,175019
3385,0.002061,172.217.194.0-255,7156,140992,8,175019
3386,0.002063,172.31.36.0-255,66,141058,8,175019
3387,0.002085,172.217.194.0-255,766,141824,8,175019
3388,0.002117,172.217.194.0-255,1484,143308,8,175019
3389,0.00212,172.31.36.0-255,66,143374,8,175019
3390,0.002125,172.217.194.0-255,2902,146276,8,175019
3391,0.002127,172.31.36.0-255,66,146342,8,175019
3392,0.002131,172.217.194.0-255,2902,149244,8,175019
3393,0.002133,172.31.36.0-255,66,149310,8,175019
3394,0.002151,172.217.194.0-255,2902,152212,8,175019
3395,0.002153,172.31.36.0-255,66,152278,8,175019
3396,0.002194,172.217.194.0-255,7156,159434,8,175019
3397,0.002198,172.31.36.0-255,66,159500,8,175019
3398,0.002219,172.217.194.0-255,2902,162402,8,175019
3399,0.002221,172.31.36.0-255,66,162468,8,175019
3400,0.002238,172.31.36.0-255,66,162534,8,175019
3401,0.002251,172.31.36.0-255,66,162600,8,175019
3402,0.00231,172.217.194.0-255,2184,164784,8,175019
3403,0.002316,172.217.194.0-255,5738,170522,8,175019
3404,0.002325,172.31.36.0-255,66,170588,8,175019
3405,0.002382,172.31.36.0-255,66,170654,8,175019
3406,0.002402,172.217.194.0-255,105,170759,8,175019
3407,0.002423,172.31.36.0-255,66,170825,8,175019
3408,0.008755,172.31.36.0-255,105,170930,8,175019
3409,0.01131,172.217.194.0-255,66,170996,8,175019
3410,0.038282,172.31.36.0-255,172,171168,8,175019
3411,0.038317,172.31.36.0-255,1110,172278,8,175019
3412,0.038407,172.31.36.0-255,1514,173792,8,175019
3413,0.038409,172.31.36.0-255,1029,174821,8,175019
3414,0.039786,104.244.42.0-255,66,174887,8,175019
3415,0.039819,104.244.42.0-255,66,174953,8,175019
3416,0.039911,104.244.42.0-255,66,175019,8,175019
3417,0.0,172.217.194.0-255,297,297,8,302372
3418,3.1e-05,172.31.36.0-255,66,363,8,302372
3419,3.8e-05,172.217.194.0-255,1484,1847,8,302372
3420,4.2e-05,172.31.36.0-255,66,1913,8,302372
3421,4.8e-05,172.217.194.0-255,4320,6233,8,302372
3422,6e-05,172.31.36.0-255,66,6299,8,302372
3423,6.5e-05,172.217.194.0-255,4320,10619,8,302372
3424,6.8e-05,172.31.36.0-255,66,10685,8,302372
3425,9.7e-05,172.217.194.0-255,3257,13942,8,302372
3426,0.000101,172.31.36.0-255,66,14008,8,302372
3427,0.000517,172.217.194.0-255,1484,15492,8,302372
3428,0.000523,172.31.36.0-255,66,15558,8,302372
3429,0.000532,172.217.194.0-255,2902,18460,8,302372
3430,0.00054,172.31.36.0-255,66,18526,8,302372
3431,0.000547,172.217.194.0-255,5738,24264,8,302372
3432,0.00055,172.31.36.0-255,66,24330,8,302372
3433,0.000558,172.217.194.0-255,6797,31127,8,302372
3434,0.000561,172.31.36.0-255,66,31193,8,302372
3435,0.000954,172.217.194.0-255,1484,32677,8,302372
3436,0.000961,172.31.36.0-255,66,32743,8,302372
3437,0.000968,172.217.194.0-255,2902,35645,8,302372
3438,0.00097,172.31.36.0-255,66,35711,8,302372
3439,0.000983,172.217.194.0-255,5738,41449,8,302372
3440,0.000986,172.31.36.0-255,66,41515,8,302372
3441,0.000992,172.217.194.0-255,6797,48312,8,302372
3442,0.000995,172.31.36.0-255,66,48378,8,302372
3443,0.001042,172.31.36.0-255,66,48444,8,302372
3444,0.001067,172.217.194.0-255,2902,51346,8,302372
3445,0.001071,172.31.36.0-255,66,51412,8,302372
3446,0.001098,172.217.194.0-255,2543,53955,8,302372
3447,0.001101,172.31.36.0-255,66,54021,8,302372
3448,0.001275,172.217.194.0-255,646,54667,8,302372
3449,0.001402,172.31.36.0-255,66,54733,8,302372
3450,0.001895,172.217.194.0-255,1484,56217,8,302372
3451,0.001906,172.217.194.0-255,2902,59119,8,302372
3452,0.00191,172.31.36.0-255,66,59185,8,302372
3453,0.001915,172.217.194.0-255,1484,60669,8,302372
3454,0.001938,172.217.194.0-255,4320,64989,8,302372
3455,0.00194,172.31.36.0-255,66,65055,8,302372
3456,0.001946,172.217.194.0-255,5738,70793,8,302372
3457,0.001948,172.31.36.0-255,66,70859,8,302372
3458,0.001952,172.217.194.0-255,4320,75179,8,302372
3459,0.00196,172.31.36.0-255,66,75245,8,302372
3460,0.001996,172.31.36.0-255,66,75311,8,302372
3461,0.002002,172.217.194.0-255,5020,80331,8,302372
3462,0.002004,172.31.36.0-255,66,80397,8,302372
3463,0.002174,172.217.194.0-255,1484,81881,8,302372
3464,0.002191,172.217.194.0-255,2902,84783,8,302372
3465,0.002193,172.31.36.0-255,66,84849,8,302372
3466,0.002198,172.217.194.0-255,2902,87751,8,302372
3467,0.0022,172.31.36.0-255,66,87817,8,302372
3468,0.002218,172.217.194.0-255,2902,90719,8,302372
3469,0.00222,172.31.36.0-255,66,90785,8,302372
3470,0.002265,172.31.36.0-255,66,90851,8,302372
3471,0.002293,172.217.194.0-255,4320,95171,8,302372
3472,0.002296,172.31.36.0-255,66,95237,8,302372
3473,0.002306,172.31.36.0-255,66,95303,8,302372
3474,0.002314,172.217.194.0-255,766,96069,8,302372
3475,0.002317,172.217.194.0-255,1484,97553,8,302372
3476,0.002319,172.31.36.0-255,66,97619,8,302372
3477,0.002346,172.217.194.0-255,4320,101939,8,302372
3478,0.002348,172.31.36.0-255,66,102005,8,302372
3479,0.002358,172.217.194.0-255,5738,107743,8,302372
3480,0.002361,172.31.36.0-255,66,107809,8,302372
3481,0.002386,172.217.194.0-255,4320,112129,8,302372
3482,0.002388,172.31.36.0-255,66,112195,8,302372
3483,0.002395,172.217.194.0-255,1484,113679,8,302372
3484,0.002436,172.31.36.0-255,66,113745,8,302372
3485,0.002492,172.217.194.0-255,1484,115229,8,302372
3486,0.002505,172.217.194.0-255,2902,118131,8,302372
3487,0.002508,172.31.36.0-255,66,118197,8,302372
3488,0.00251,172.217.194.0-255,1484,119681,8,302372
3489,0.002534,172.217.194.0-255,4320,124001,8,302372
3490,0.002536,172.31.36.0-255,66,124067,8,302372
3491,0.002543,172.217.194.0-255,7156,131223,8,302372
3492,0.002546,172.31.36.0-255,66,131289,8,302372
3493,0.002566,172.217.194.0-255,4320,135609,8,302372
3494,0.002568,172.31.36.0-255,66,135675,8,302372
3495,0.0026,172.217.194.0-255,1484,137159,8,302372
3496,0.002612,172.31.36.0-255,66,137225,8,302372
3497,0.002654,172.217.194.0-255,1484,138709,8,302372
3498,0.002657,172.217.194.0-255,1484,140193,8,302372
3499,0.002659,172.31.36.0-255,66,140259,8,302372
3500,0.002686,172.217.194.0-255,1484,141743,8,302372
3501,0.002693,172.217.194.0-255,5738,147481,8,302372
3502,0.002695,172.31.36.0-255,66,147547,8,302372
3503,0.002705,172.31.36.0-255,66,147613,8,302372
3504,0.002722,172.31.36.0-255,66,147679,8,302372
3505,0.002727,172.217.194.0-255,4320,151999,8,302372
3506,0.002729,172.31.36.0-255,66,152065,8,302372
3507,0.005325,172.217.194.0-255,1484,153549,8,302372
3508,0.005387,172.217.194.0-255,4320,157869,8,302372
3509,0.005392,172.31.36.0-255,66,157935,8,302372
3510,0.008065,172.217.194.0-255,5738,163673,8,302372
3511,0.008076,172.31.36.0-255,66,163739,8,302372
3512,0.010707,172.217.194.0-255,5738,169477,8,302372
3513,0.010723,172.31.36.0-255,66,169543,8,302372
3514,0.013395,172.217.194.0-255,5738,175281,8,302372
3515,0.013408,172.31.36.0-255,66,175347,8,302372
3516,0.016032,172.217.194.0-255,5738,181085,8,302372
3517,0.016045,172.31.36.0-255,66,181151,8,302372
3518,0.018698,172.217.194.0-255,5738,186889,8,302372
3519,0.01871,172.31.36.0-255,66,186955,8,302372
3520,0.021361,172.217.194.0-255,5738,192693,8,302372
3521,0.021369,172.31.36.0-255,66,192759,8,302372
3522,0.024037,172.217.194.0-255,5738,198497,8,302372
3523,0.024045,172.31.36.0-255,66,198563,8,302372
3524,0.026677,172.217.194.0-255,5738,204301,8,302372
3525,0.026684,172.31.36.0-255,66,204367,8,302372
3526,0.029333,172.217.194.0-255,5738,210105,8,302372
3527,0.02934,172.31.36.0-255,66,210171,8,302372
3528,0.030812,172.31.36.0-255,167,210338,8,302372
3529,0.03084,172.31.36.0-255,1111,211449,8,302372
3530,0.030883,172.31.36.0-255,1514,212963,8,302372
3531,0.030885,172.31.36.0-255,1293,214256,8,302372
3532,0.031995,172.217.194.0-255,5738,219994,8,302372
3533,0.032001,172.31.36.0-255,66,220060,8,302372
3534,0.032346,104.244.42.0-255,66,220126,8,302372
3535,0.032524,104.244.42.0-255,66,220192,8,302372
3536,0.032528,104.244.42.0-255,66,220258,8,302372
3537,0.034633,172.217.194.0-255,2902,223160,8,302372
3538,0.034638,172.31.36.0-255,66,223226,8,302372
3539,0.034675,172.217.194.0-255,2902,226128,8,302372
3540,0.034679,172.31.36.0-255,66,226194,8,302372
3541,0.03725,172.217.194.0-255,2902,229096,8,302372
3542,0.037255,172.31.36.0-255,66,229162,8,302372
3543,0.037341,172.217.194.0-255,2902,232064,8,302372
3544,0.037346,172.31.36.0-255,66,232130,8,302372
3545,0.039923,172.217.194.0-255,2902,235032,8,302372
3546,0.039928,172.31.36.0-255,66,235098,8,302372
3547,0.039962,172.217.194.0-255,2902,238000,8,302372
3548,0.039965,172.31.36.0-255,66,238066,8,302372
3549,0.042533,172.217.194.0-255,2902,240968,8,302372
3550,0.042539,172.31.36.0-255,66,241034,8,302372
3551,0.042585,172.217.194.0-255,2902,243936,8,302372
3552,0.042589,172.31.36.0-255,66,244002,8,302372
3553,0.04514,172.217.194.0-255,2902,246904,8,302372
3554,0.04515,172.31.36.0-255,66,246970,8,302372
3555,0.045195,172.217.194.0-255,2902,249872,8,302372
3556,0.0452,172.31.36.0-255,66,249938,8,302372
3557,0.047808,172.217.194.0-255,2902,252840,8,302372
3558,0.047814,172.31.36.0-255,66,252906,8,302372
3559,0.047839,172.217.194.0-255,1484,254390,8,302372
3560,0.047854,172.217.194.0-255,1484,255874,8,302372
3561,0.047857,172.31.36.0-255,66,255940,8,302372
3562,0.050471,172.217.194.0-255,5738,261678,8,302372
3563,0.050478,172.31.36.0-255,66,261744,8,302372
3564,0.053106,172.217.194.0-255,5738,267482,8,302372
3565,0.053112,172.31.36.0-255,66,267548,8,302372
3566,0.055725,172.217.194.0-255,5738,273286,8,302372
3567,0.05573,172.31.36.0-255,66,273352,8,302372
3568,0.058376,172.217.194.0-255,5738,279090,8,302372
3569,0.058382,172.31.36.0-255,66,279156,8,302372
3570,0.060993,172.217.194.0-255,5738,284894,8,302372
3571,0.061,172.31.36.0-255,66,284960,8,302372
3572,0.063673,172.217.194.0-255,5738,290698,8,302372
3573,0.063678,172.31.36.0-255,66,290764,8,302372
3574,0.066298,172.217.194.0-255,5738,296502,8,302372
3575,0.066307,172.31.36.0-255,66,296568,8,302372
3576,0.068968,172.217.194.0-255,5738,302306,8,302372
3577,0.068978,172.31.36.0-255,66,302372,8,302372
3578,0.0,74.125.130.0-255,153,153,8,374563
3579,2.2e-05,172.31.36.0-255,66,219,8,374563
3580,2.9e-05,74.125.130.0-255,1484,1703,8,374563
3581,3.3e-05,172.31.36.0-255,66,1769,8,374563
3582,3.8e-05,74.125.130.0-255,2902,4671,8,374563
3583,4.1e-05,172.31.36.0-255,66,4737,8,374563
3584,4.5e-05,74.125.130.0-255,1484,6221,8,374563
3585,5.7e-05,172.31.36.0-255,66,6287,8,374563
3586,8.8e-05,74.125.130.0-255,5738,12025,8,374563
3587,9.4e-05,172.31.36.0-255,66,12091,8,374563
3588,9.8e-05,74.125.130.0-255,2116,14207,8,374563
3589,0.0001,172.31.36.0-255,66,14273,8,374563
3590,0.000104,74.125.130.0-255,2902,17175,8,374563
3591,0.000106,172.31.36.0-255,66,17241,8,374563
3592,0.000109,74.125.130.0-255,1484,18725,8,374563
3593,0.000111,172.31.36.0-255,66,18791,8,374563
3594,0.000139,74.125.130.0-255,5738,24529,8,374563
3595,0.000142,172.31.36.0-255,66,24595,8,374563
3596,0.000146,74.125.130.0-255,2902,27497,8,374563
3597,0.000148,172.31.36.0-255,66,27563,8,374563
3598,0.000183,172.31.36.0-255,66,27629,8,374563
3599,0.000206,74.125.130.0-255,2902,30531,8,374563
3600,0.000208,172.31.36.0-255,66,30597,8,374563
3601,0.000215,74.125.130.0-255,5738,36335,8,374563
3602,0.000217,172.31.36.0-255,66,36401,8,374563
3603,0.000238,74.125.130.0-255,3602,40003,8,374563
3604,0.000241,172.31.36.0-255,66,40069,8,374563
3605,0.000272,74.125.130.0-255,1484,41553,8,374563
3606,0.000274,172.31.36.0-255,66,41619,8,374563
3607,0.000277,74.125.130.0-255,1484,43103,8,374563
3608,0.000279,172.31.36.0-255,66,43169,8,374563
3609,0.000298,74.125.130.0-255,1484,44653,8,374563
3610,0.000305,74.125.130.0-255,5738,50391,8,374563
3611,0.00031,74.125.130.0-255,4320,54711,8,374563
3612,0.000343,74.125.130.0-255,2819,57530,8,374563
3613,0.000385,74.125.130.0-255,1484,59014,8,374563
3614,0.000388,74.125.130.0-255,1484,60498,8,374563
3615,0.000405,74.125.130.0-255,1484,61982,8,374563
3616,0.000411,74.125.130.0-255,5738,67720,8,374563
3617,0.000414,74.125.130.0-255,1484,69204,8,374563
3618,0.000428,74.125.130.0-255,2902,72106,8,374563
3619,0.000445,74.125.130.0-255,2902,75008,8,374563
3620,0.000456,74.125.130.0-255,2856,77864,8,374563
3621,0.000471,74.125.130.0-255,2902,80766,8,374563
3622,0.000495,74.125.130.0-255,7156,87922,8,374563
3623,0.000523,74.125.130.0-255,3961,91883,8,374563
3624,0.00057,74.125.130.0-255,1484,93367,8,374563
3625,0.000573,74.125.130.0-255,1484,94851,8,374563
3626,0.000588,74.125.130.0-255,1484,96335,8,374563
3627,0.0006,172.31.36.0-255,66,96401,8,374563
3628,0.000612,74.125.130.0-255,5738,102139,8,374563
3629,0.000647,172.31.36.0-255,66,102205,8,374563
3630,0.000679,74.125.130.0-255,1635,103840,8,374563
3631,0.000706,172.31.36.0-255,66,103906,8,374563
3632,0.000738,74.125.130.0-255,1484,105390,8,374563
3633,0.000753,74.125.130.0-255,1484,106874,8,374563
3634,0.000765,172.31.36.0-255,66,106940,8,374563
3635,0.000773,74.125.130.0-255,1484,108424,8,374563
3636,0.000783,74.125.130.0-255,5738,114162,8,374563
3637,0.000785,74.125.130.0-255,1484,115646,8,374563
3638,0.000791,172.31.36.0-255,66,115712,8,374563
3639,0.00081,74.125.130.0-255,5738,121450,8,374563
3640,0.00082,172.31.36.0-255,66,121516,8,374563
3641,0.000834,74.125.130.0-255,4320,125836,8,374563
3642,0.000864,172.31.36.0-255,66,125902,8,374563
3643,0.000874,74.125.130.0-255,3602,129504,8,374563
3644,0.000893,172.31.36.0-255,66,129570,8,374563
3645,0.001538,74.125.130.0-255,1484,131054,8,374563
3646,0.001554,74.125.130.0-255,2902,133956,8,374563
3647,0.001558,172.31.36.0-255,66,134022,8,374563
3648,0.001564,74.125.130.0-255,5738,139760,8,374563
3649,0.001583,74.125.130.0-255,4320,144080,8,374563
3650,0.001592,172.31.36.0-255,66,144146,8,374563
3651,0.001607,74.125.130.0-255,5738,149884,8,374563
3652,0.001611,172.31.36.0-255,66,149950,8,374563
3653,0.001649,74.125.130.0-255,2184,152134,8,374563
3654,0.001653,172.31.36.0-255,66,152200,8,374563
3655,0.001715,74.125.130.0-255,1484,153684,8,374563
3656,0.00172,74.125.130.0-255,2902,156586,8,374563
3657,0.001723,172.31.36.0-255,66,156652,8,374563
3658,0.001729,74.125.130.0-255,5738,162390,8,374563
3659,0.00175,74.125.130.0-255,5738,168128,8,374563
3660,0.001768,74.125.130.0-255,1484,169612,8,374563
3661,0.001771,74.125.130.0-255,1484,171096,8,374563
3662,0.001786,74.125.130.0-255,7156,178252,8,374563
3663,0.001788,172.31.36.0-255,66,178318,8,374563
3664,0.001792,172.31.36.0-255,66,178384,8,374563
3665,0.001813,74.125.130.0-255,5738,184122,8,374563
3666,0.001816,74.125.130.0-255,2184,186306,8,374563
3667,0.001825,172.31.36.0-255,66,186372,8,374563
3668,0.003792,74.125.130.0-255,5738,192110,8,374563
3669,0.003807,172.31.36.0-255,66,192176,8,374563
3670,0.005755,74.125.130.0-255,5738,197914,8,374563
3671,0.008747,172.31.36.0-255,66,197980,8,374563
3672,0.010712,74.125.130.0-255,5738,203718,8,374563
3673,0.010722,172.31.36.0-255,66,203784,8,374563
3674,0.012667,74.125.130.0-255,5738,209522,8,374563
3675,0.012675,172.31.36.0-255,66,209588,8,374563
3676,0.014622,74.125.130.0-255,5738,215326,8,374563
3677,0.01463,172.31.36.0-255,66,215392,8,374563
3678,0.016587,74.125.130.0-255,5738,221130,8,374563
3679,0.016595,172.31.36.0-255,66,221196,8,374563
3680,0.01854,74.125.130.0-255,5738,226934,8,374563
3681,0.018546,172.31.36.0-255,66,227000,8,374563
3682,0.020497,74.125.130.0-255,5738,232738,8,374563
3683,0.020503,172.31.36.0-255,66,232804,8,374563
3684,0.022455,74.125.130.0-255,5738,238542,8,374563
3685,0.022462,172.31.36.0-255,66,238608,8,374563
3686,0.023391,172.31.36.0-255,164,238772,8,374563
3687,0.023421,172.31.36.0-255,1119,239891,8,374563
3688,0.023469,172.31.36.0-255,1514,241405,8,374563
3689,0.02347,172.31.36.0-255,1514,242919,8,374563
3690,0.023471,172.31.36.0-255,1514,244433,8,374563
3691,0.023472,172.31.36.0-255,1514,245947,8,374563
3692,0.023496,172.31.36.0-255,1350,247297,8,374563
3693,0.024444,74.125.130.0-255,5738,253035,8,374563
3694,0.024453,172.31.36.0-255,66,253101,8,374563
3695,0.025048,104.244.42.0-255,66,253167,8,374563
3696,0.026408,74.125.130.0-255,4320,257487,8,374563
3697,0.026412,172.31.36.0-255,66,257553,8,374563
3698,0.026447,74.125.130.0-255,1484,259037,8,374563
3699,0.028348,74.125.130.0-255,4320,263357,8,374563
3700,0.028353,172.31.36.0-255,66,263423,8,374563
3701,0.0303,74.125.130.0-255,4320,267743,8,374563
3702,0.030306,172.31.36.0-255,66,267809,8,374563
3703,0.03033,74.125.130.0-255,1484,269293,8,374563
3704,0.032246,74.125.130.0-255,4320,273613,8,374563
3705,0.032252,172.31.36.0-255,66,273679,8,374563
3706,0.034185,74.125.130.0-255,2902,276581,8,374563
3707,0.03419,172.31.36.0-255,66,276647,8,374563
3708,0.034221,74.125.130.0-255,2902,279549,8,374563
3709,0.034232,172.31.36.0-255,66,279615,8,374563
3710,0.036123,74.125.130.0-255,2902,282517,8,374563
3711,0.036129,172.31.36.0-255,66,282583,8,374563
3712,0.036176,74.125.130.0-255,2902,285485,8,374563
3713,0.036209,172.31.36.0-255,66,285551,8,374563
3714,0.038064,74.125.130.0-255,2902,288453,8,374563
3715,0.038069,172.31.36.0-255,66,288519,8,374563
3716,0.038134,74.125.130.0-255,2902,291421,8,374563
3717,0.038137,172.31.36.0-255,66,291487,8,374563
3718,0.040004,74.125.130.0-255,2902,294389,8,374563
3719,0.040012,172.31.36.0-255,66,294455,8,374563
3720,0.040066,74.125.130.0-255,2902,297357,8,374563
3721,0.040085,172.31.36.0-255,66,297423,8,374563
3722,0.041948,74.125.130.0-255,2902,300325,8,374563
3723,0.041954,172.31.36.0-255,66,300391,8,374563
3724,0.042018,74.125.130.0-255,2902,303293,8,374563
3725,0.042037,172.31.36.0-255,66,303359,8,374563
3726,0.043884,74.125.130.0-255,2902,306261,8,374563
3727,0.043889,172.31.36.0-255,66,306327,8,374563
3728,0.043975,74.125.130.0-255,2902,309229,8,374563
3729,0.043979,172.31.36.0-255,66,309295,8,374563
3730,0.045824,74.125.130.0-255,2902,312197,8,374563
3731,0.045829,172.31.36.0-255,66,312263,8,374563
3732,0.045907,74.125.130.0-255,2902,315165,8,374563
3733,0.04591,172.31.36.0-255,66,315231,8,374563
3734,0.04778,74.125.130.0-255,2902,318133,8,374563
3735,0.04779,172.31.36.0-255,66,318199,8,374563
3736,0.047841,74.125.130.0-255,2902,321101,8,374563
3737,0.047851,172.31.36.0-255,66,321167,8,374563
3738,0.04973,74.125.130.0-255,2902,324069,8,374563
3739,0.049737,172.31.36.0-255,66,324135,8,374563
3740,0.049781,74.125.130.0-255,2902,327037,8,374563
3741,0.049792,172.31.36.0-255,66,327103,8,374563
3742,0.051683,74.125.130.0-255,2902,330005,8,374563
3743,0.051688,172.31.36.0-255,66,330071,8,374563
3744,0.051739,74.125.130.0-255,2902,332973,8,374563
3745,0.051748,172.31.36.0-255,66,333039,8,374563
3746,0.053639,74.125.130.0-255,2902,335941,8,374563
3747,0.053645,172.31.36.0-255,66,336007,8,374563
3748,0.053682,74.125.130.0-255,2902,338909,8,374563
3749,0.05402,172.31.36.0-255,66,338975,8,374563
3750,0.055582,74.125.130.0-255,2902,341877,8,374563
3751,0.055588,172.31.36.0-255,66,341943,8,374563
3752,0.055956,74.125.130.0-255,2902,344845,8,374563
3753,0.055962,172.31.36.0-255,66,344911,8,374563
3754,0.057533,74.125.130.0-255,2902,347813,8,374563
3755,0.057541,172.31.36.0-255,66,347879,8,374563
3756,0.057902,74.125.130.0-255,2902,350781,8,374563
3757,0.057907,172.31.36.0-255,66,350847,8,374563
3758,0.059479,74.125.130.0-255,2902,353749,8,374563
3759,0.059484,172.31.36.0-255,66,353815,8,374563
3760,0.059855,74.125.130.0-255,2902,356717,8,374563
3761,0.05986,172.31.36.0-255,66,356783,8,374563
3762,0.061425,74.125.130.0-255,2902,359685,8,374563
3763,0.06143,172.31.36.0-255,66,359751,8,374563
3764,0.061791,74.125.130.0-255,2902,362653,8,374563
3765,0.061796,172.31.36.0-255,66,362719,8,374563
3766,0.063377,74.125.130.0-255,2902,365621,8,374563
3767,0.063384,172.31.36.0-255,66,365687,8,374563
3768,0.063737,74.125.130.0-255,2902,368589,8,374563
3769,0.063943,172.31.36.0-255,66,368655,8,374563
3770,0.065327,74.125.130.0-255,2902,371557,8,374563
3771,0.065333,172.31.36.0-255,66,371623,8,374563
3772,0.065729,104.244.42.0-255,66,371689,8,374563
3773,0.06588,74.125.130.0-255,2637,374326,8,374563
3774,0.065884,172.31.36.0-255,66,374392,8,374563
3775,0.066045,172.31.36.0-255,105,374497,8,374563
3776,0.06796,74.125.130.0-255,66,374563,8,374563
3777,0.0,172.217.160.0-255,153,153,8,356974
3778,2.5e-05,172.31.36.0-255,66,219,8,356974
3779,3.1e-05,172.217.160.0-255,1484,1703,8,356974
3780,3.5e-05,172.31.36.0-255,66,1769,8,356974
3781,4.9e-05,172.217.160.0-255,2902,4671,8,356974
3782,5.2e-05,172.31.36.0-255,66,4737,8,356974
3783,5.9e-05,172.217.160.0-255,7156,11893,8,356974
3784,6.2e-05,172.31.36.0-255,66,11959,8,356974
3785,6.7e-05,172.217.160.0-255,2902,14861,8,356974
3786,7e-05,172.31.36.0-255,66,14927,8,356974
3787,0.000101,172.217.160.0-255,4814,19741,8,356974
3788,0.000105,172.31.36.0-255,66,19807,8,356974
3789,0.000112,172.217.160.0-255,7156,26963,8,356974
3790,0.000115,172.31.36.0-255,66,27029,8,356974
3791,0.000141,172.217.160.0-255,3961,30990,8,356974
3792,0.000144,172.31.36.0-255,66,31056,8,356974
3793,0.000154,172.217.160.0-255,4320,35376,8,356974
3794,0.000157,172.31.36.0-255,66,35442,8,356974
3795,0.000162,172.217.160.0-255,4320,39762,8,356974
3796,0.000164,172.31.36.0-255,66,39828,8,356974
3797,0.000202,172.217.160.0-255,5738,45566,8,356974
3798,0.000205,172.31.36.0-255,66,45632,8,356974
3799,0.000209,172.217.160.0-255,2543,48175,8,356974
3800,0.000211,172.31.36.0-255,66,48241,8,356974
3801,0.000354,172.217.160.0-255,1484,49725,8,356974
3802,0.000359,172.31.36.0-255,66,49791,8,356974
3803,0.000379,172.217.160.0-255,1484,51275,8,356974
3804,0.000382,172.31.36.0-255,66,51341,8,356974
3805,0.000387,172.217.160.0-255,2902,54243,8,356974
3806,0.000389,172.31.36.0-255,66,54309,8,356974
3807,0.000392,172.217.160.0-255,1484,55793,8,356974
3808,0.000394,172.31.36.0-255,66,55859,8,356974
3809,0.000428,172.217.160.0-255,4320,60179,8,356974
3810,0.000431,172.31.36.0-255,66,60245,8,356974
3811,0.000466,172.217.160.0-255,2902,63147,8,356974
3812,0.000469,172.31.36.0-255,66,63213,8,356974
3813,0.000492,172.217.160.0-255,2543,65756,8,356974
3814,0.000507,172.31.36.0-255,66,65822,8,356974
3815,0.00051,172.217.160.0-255,333,66155,8,356974
3816,0.001212,172.217.160.0-255,124,66279,8,356974
3817,0.001263,172.217.160.0-255,1484,67763,8,356974
3818,0.001268,172.31.36.0-255,66,67829,8,356974
3819,0.001274,172.217.160.0-255,2902,70731,8,356974
3820,0.001276,172.31.36.0-255,66,70797,8,356974
3821,0.001279,172.217.160.0-255,1484,72281,8,356974
3822,0.001302,172.217.160.0-255,4320,76601,8,356974
3823,0.001309,172.31.36.0-255,66,76667,8,356974
3824,0.001315,172.217.160.0-255,5738,82405,8,356974
3825,0.001317,172.31.36.0-255,66,82471,8,356974
3826,0.001357,172.31.36.0-255,66,82537,8,356974
3827,0.00139,172.217.160.0-255,3961,86498,8,356974
3828,0.001394,172.31.36.0-255,66,86564,8,356974
3829,0.001399,172.217.160.0-255,3961,90525,8,356974
3830,0.001401,172.31.36.0-255,66,90591,8,356974
3831,0.001464,172.217.160.0-255,1484,92075,8,356974
3832,0.001469,172.217.160.0-255,2902,94977,8,356974
3833,0.001471,172.31.36.0-255,66,95043,8,356974
3834,0.001475,172.217.160.0-255,1484,96527,8,356974
3835,0.001503,172.217.160.0-255,4320,100847,8,356974
3836,0.001505,172.31.36.0-255,66,100913,8,356974
3837,0.001515,172.31.36.0-255,66,100979,8,356974
3838,0.001545,172.217.160.0-255,4320,105299,8,356974
3839,0.001547,172.31.36.0-255,66,105365,8,356974
3840,0.001554,172.217.160.0-255,5738,111103,8,356974
3841,0.001556,172.31.36.0-255,66,111169,8,356974
3842,0.001559,172.217.160.0-255,1484,112653,8,356974
3843,0.001589,172.217.160.0-255,3602,116255,8,356974
3844,0.001593,172.31.36.0-255,66,116321,8,356974
3845,0.001662,172.217.160.0-255,1484,117805,8,356974
3846,0.001676,172.217.160.0-255,2902,120707,8,356974
3847,0.001679,172.31.36.0-255,66,120773,8,356974
3848,0.001685,172.217.160.0-255,4320,125093,8,356974
3849,0.001687,172.31.36.0-255,66,125159,8,356974
3850,0.001716,172.217.160.0-255,1484,126643,8,356974
3851,0.001731,172.31.36.0-255,66,126709,8,356974
3852,0.001744,172.31.36.0-255,66,126775,8,356974
3853,0.001747,172.217.160.0-255,383,127158,8,356974
3854,0.001874,172.217.160.0-255,1484,128642,8,356974
3855,0.001879,172.31.36.0-255,66,128708,8,356974
3856,0.001885,172.217.160.0-255,2902,131610,8,356974
3857,0.001887,172.31.36.0-255,66,131676,8,356974
3858,0.001898,172.217.160.0-255,5738,137414,8,356974
3859,0.0019,172.31.36.0-255,66,137480,8,356974
3860,0.001908,172.217.160.0-255,5738,143218,8,356974
3861,0.00191,172.31.36.0-255,66,143284,8,356974
3862,0.001936,172.217.160.0-255,7156,150440,8,356974
3863,0.001943,172.31.36.0-255,66,150506,8,356974
3864,0.001956,172.31.36.0-255,66,150572,8,356974
3865,0.00389,172.217.160.0-255,5738,156310,8,356974
3866,0.003898,172.31.36.0-255,66,156376,8,356974
3867,0.005838,172.217.160.0-255,4320,160696,8,356974
3868,0.005842,172.31.36.0-255,66,160762,8,356974
3869,0.005865,172.217.160.0-255,1484,162246,8,356974
3870,0.00777,172.217.160.0-255,4320,166566,8,356974
3871,0.007773,172.31.36.0-255,66,166632,8,356974
3872,0.00972,172.217.160.0-255,5738,172370,8,356974
3873,0.00973,172.31.36.0-255,66,172436,8,356974
3874,0.011699,172.217.160.0-255,5738,178174,8,356974
3875,0.011707,172.31.36.0-255,66,178240,8,356974
3876,0.013642,172.217.160.0-255,5738,183978,8,356974
3877,0.01365,172.31.36.0-255,66,184044,8,356974
3878,0.015616,172.217.160.0-255,5738,189782,8,356974
3879,0.015624,172.31.36.0-255,66,189848,8,356974
3880,0.017571,172.217.160.0-255,5738,195586,8,356974
3881,0.017581,172.31.36.0-255,66,195652,8,356974
3882,0.019552,172.217.160.0-255,5738,201390,8,356974
3883,0.019561,172.31.36.0-255,66,201456,8,356974
3884,0.021512,172.217.160.0-255,5738,207194,8,356974
3885,0.021528,172.31.36.0-255,66,207260,8,356974
3886,0.023493,172.217.160.0-255,5738,212998,8,356974
3887,0.023508,172.31.36.0-255,66,213064,8,356974
3888,0.025467,172.217.160.0-255,5738,218802,8,356974
3889,0.025481,172.31.36.0-255,66,218868,8,356974
3890,0.027436,172.217.160.0-255,5738,224606,8,356974
3891,0.027452,172.31.36.0-255,66,224672,8,356974
3892,0.029401,172.217.160.0-255,5738,230410,8,356974
3893,0.029411,172.31.36.0-255,66,230476,8,356974
3894,0.031384,172.217.160.0-255,5738,236214,8,356974
3895,0.031391,172.31.36.0-255,66,236280,8,356974
3896,0.033333,172.217.160.0-255,5738,242018,8,356974
3897,0.033342,172.31.36.0-255,66,242084,8,356974
3898,0.035309,172.217.160.0-255,5738,247822,8,356974
3899,0.035317,172.31.36.0-255,66,247888,8,356974
3900,0.037271,172.217.160.0-255,5738,253626,8,356974
3901,0.037282,172.31.36.0-255,66,253692,8,356974
3902,0.03923,172.217.160.0-255,5738,259430,8,356974
3903,0.039237,172.31.36.0-255,66,259496,8,356974
3904,0.041178,172.217.160.0-255,5738,265234,8,356974
3905,0.041185,172.31.36.0-255,66,265300,8,356974
3906,0.04313,172.217.160.0-255,5738,271038,8,356974
3907,0.043138,172.31.36.0-255,66,271104,8,356974
3908,0.044116,172.31.36.0-255,172,271276,8,356974
3909,0.044149,172.31.36.0-255,1111,272387,8,356974
3910,0.04422,172.31.36.0-255,1514,273901,8,356974
3911,0.044222,172.31.36.0-255,1514,275415,8,356974
3912,0.044228,172.31.36.0-255,1514,276929,8,356974
3913,0.044229,172.31.36.0-255,1514,278443,8,356974
3914,0.044252,172.31.36.0-255,1514,279957,8,356974
3915,0.044254,172.31.36.0-255,995,280952,8,356974
3916,0.045088,172.217.160.0-255,1484,282436,8,356974
3917,0.045111,172.217.160.0-255,4320,286756,8,356974
3918,0.045117,172.31.36.0-255,66,286822,8,356974
3919,0.045663,104.244.42.0-255,66,286888,8,356974
3920,0.045763,104.244.42.0-255,66,286954,8,356974
3921,0.045803,104.244.42.0-255,66,287020,8,356974
3922,0.0459,104.244.42.0-255,66,287086,8,356974
3923,0.045906,104.244.42.0-255,66,287152,8,356974
3924,0.047063,172.217.160.0-255,5738,292890,8,356974
3925,0.047071,172.31.36.0-255,66,292956,8,356974
3926,0.049005,172.217.160.0-255,5738,298694,8,356974
3927,0.049014,172.31.36.0-255,66,298760,8,356974
3928,0.051004,172.217.160.0-255,5738,304498,8,356974
3929,0.051014,172.31.36.0-255,66,304564,8,356974
3930,0.05296,172.217.160.0-255,5738,310302,8,356974
3931,0.052967,172.31.36.0-255,66,310368,8,356974
3932,0.054923,172.217.160.0-255,5738,316106,8,356974
3933,0.054942,172.31.36.0-255,66,316172,8,356974
3934,0.056921,172.217.160.0-255,5738,321910,8,356974
3935,0.056932,172.31.36.0-255,66,321976,8,356974
3936,0.058886,172.217.160.0-255,5738,327714,8,356974
3937,0.058899,172.31.36.0-255,66,327780,8,356974
3938,0.060581,172.31.36.0-255,108,327888,8,356974
3939,0.060837,172.217.160.0-255,5738,333626,8,356974
3940,0.060846,172.31.36.0-255,66,333692,8,356974
3941,0.062148,104.244.42.0-255,66,333758,8,356974
3942,0.062796,172.217.160.0-255,5738,339496,8,356974
3943,0.062803,172.31.36.0-255,66,339562,8,356974
3944,0.064747,172.217.160.0-255,5738,345300,8,356974
3945,0.064759,172.31.36.0-255,66,345366,8,356974
3946,0.066707,172.217.160.0-255,5738,351104,8,356974
3947,0.066718,172.31.36.0-255,66,351170,8,356974
3948,0.068676,172.217.160.0-255,5738,356908,8,356974
3949,0.068692,172.31.36.0-255,66,356974,8,356974
3950,0.0,74.125.24.0-255,153,153,8,326771
3951,2.9e-05,172.31.36.0-255,66,219,8,326771
3952,3.6e-05,74.125.24.0-255,1484,1703,8,326771
3953,4.1e-05,172.31.36.0-255,66,1769,8,326771
3954,4.6e-05,74.125.24.0-255,2902,4671,8,326771
3955,4.8e-05,172.31.36.0-255,66,4737,8,326771
3956,5.4e-05,74.125.24.0-255,7156,11893,8,326771
3957,5.7e-05,172.31.36.0-255,66,11959,8,326771
3958,6e-05,74.125.24.0-255,1982,13941,8,326771
3959,6.2e-05,172.31.36.0-255,66,14007,8,326771
3960,9.5e-05,74.125.24.0-255,1484,15491,8,326771
3961,9.7e-05,172.31.36.0-255,66,15557,8,326771
3962,0.000118,74.125.24.0-255,7156,22713,8,326771
3963,0.00012,172.31.36.0-255,66,22779,8,326771
3964,0.000154,74.125.24.0-255,4320,27099,8,326771
3965,0.000157,172.31.36.0-255,66,27165,8,326771
3966,0.000176,74.125.24.0-255,3961,31126,8,326771
3967,0.000179,172.31.36.0-255,66,31192,8,326771
3968,0.000212,74.125.24.0-255,1484,32676,8,326771
3969,0.000214,172.31.36.0-255,66,32742,8,326771
3970,0.00023,74.125.24.0-255,2902,35644,8,326771
3971,0.000232,172.31.36.0-255,66,35710,8,326771
3972,0.000236,74.125.24.0-255,1484,37194,8,326771
3973,0.000238,172.31.36.0-255,66,37260,8,326771
3974,0.000261,74.125.24.0-255,4320,41580,8,326771
3975,0.000264,172.31.36.0-255,66,41646,8,326771
3976,0.000269,74.125.24.0-255,4320,45966,8,326771
3977,0.000272,172.31.36.0-255,66,46032,8,326771
3978,0.000275,74.125.24.0-255,1484,47516,8,326771
3979,0.000276,172.31.36.0-255,66,47582,8,326771
3980,0.000307,172.31.36.0-255,66,47648,8,326771
3981,0.000315,74.125.24.0-255,7071,54719,8,326771
3982,0.000317,172.31.36.0-255,66,54785,8,326771
3983,0.000353,74.125.24.0-255,131,54916,8,326771
3984,0.000428,74.125.24.0-255,1484,56400,8,326771
3985,0.000431,172.31.36.0-255,66,56466,8,326771
3986,0.000436,74.125.24.0-255,2902,59368,8,326771
3987,0.000439,172.31.36.0-255,66,59434,8,326771
3988,0.000443,74.125.24.0-255,2902,62336,8,326771
3989,0.000445,172.31.36.0-255,66,62402,8,326771
3990,0.000474,74.125.24.0-255,2902,65304,8,326771
3991,0.000477,172.31.36.0-255,66,65370,8,326771
3992,0.000483,74.125.24.0-255,6797,72167,8,326771
3993,0.000485,172.31.36.0-255,66,72233,8,326771
3994,0.000548,74.125.24.0-255,1484,73717,8,326771
3995,0.000569,74.125.24.0-255,2902,76619,8,326771
3996,0.000573,172.31.36.0-255,66,76685,8,326771
3997,0.000579,74.125.24.0-255,4320,81005,8,326771
3998,0.000581,172.31.36.0-255,66,81071,8,326771
3999,0.000592,74.125.24.0-255,1484,82555,8,326771
4000,0.00062,74.125.24.0-255,2902,85457,8,326771
4001,0.000623,172.31.36.0-255,66,85523,8,326771
4002,0.000644,74.125.24.0-255,4242,89765,8,326771
4003,0.000647,172.31.36.0-255,66,89831,8,326771
4004,0.001042,74.125.24.0-255,1484,91315,8,326771
4005,0.001051,74.125.24.0-255,2902,94217,8,326771
4006,0.001054,172.31.36.0-255,66,94283,8,326771
4007,0.001076,74.125.24.0-255,5738,100021,8,326771
4008,0.001078,172.31.36.0-255,66,100087,8,326771
4009,0.00108,74.125.24.0-255,1484,101571,8,326771
4010,0.001112,172.31.36.0-255,66,101637,8,326771
4011,0.001119,74.125.24.0-255,4320,105957,8,326771
4012,0.001121,172.31.36.0-255,66,106023,8,326771
4013,0.001137,74.125.24.0-255,6438,112461,8,326771
4014,0.00114,172.31.36.0-255,66,112527,8,326771
4015,0.001191,74.125.24.0-255,1484,114011,8,326771
4016,0.001196,74.125.24.0-255,2902,116913,8,326771
4017,0.001198,172.31.36.0-255,66,116979,8,326771
4018,0.001203,74.125.24.0-255,4320,121299,8,326771
4019,0.001205,172.31.36.0-255,66,121365,8,326771
4020,0.001217,74.125.24.0-255,1484,122849,8,326771
4021,0.00122,74.125.24.0-255,1484,124333,8,326771
4022,0.001222,172.31.36.0-255,66,124399,8,326771
4023,0.001256,172.31.36.0-255,66,124465,8,326771
4024,0.001259,74.125.24.0-255,1484,125949,8,326771
4025,0.001283,172.31.36.0-255,66,126015,8,326771
4026,0.001867,74.125.24.0-255,1484,127499,8,326771
4027,0.001875,74.125.24.0-255,2902,130401,8,326771
4028,0.001879,172.31.36.0-255,66,130467,8,326771
4029,0.001883,74.125.24.0-255,1484,131951,8,326771
4030,0.0019,74.125.24.0-255,4320,136271,8,326771
4031,0.001902,172.31.36.0-255,66,136337,8,326771
4032,0.001928,172.31.36.0-255,66,136403,8,326771
4033,0.001946,74.125.24.0-255,2902,139305,8,326771
4034,0.001948,172.31.36.0-255,66,139371,8,326771
4035,0.001954,74.125.24.0-255,5738,145109,8,326771
4036,0.001956,172.31.36.0-255,66,145175,8,326771
4037,0.001993,74.125.24.0-255,5020,150195,8,326771
4038,0.001995,172.31.36.0-255,66,150261,8,326771
4039,0.002352,74.125.24.0-255,1484,151745,8,326771
4040,0.002398,74.125.24.0-255,2902,154647,8,326771
4041,0.002401,172.31.36.0-255,66,154713,8,326771
4042,0.002419,74.125.24.0-255,4320,159033,8,326771
4043,0.002421,172.31.36.0-255,66,159099,8,326771
4044,0.002434,74.125.24.0-255,4320,163419,8,326771
4045,0.002436,172.31.36.0-255,66,163485,8,326771
4046,0.002458,74.125.24.0-255,4320,167805,8,326771
4047,0.002461,172.31.36.0-255,66,167871,8,326771
4048,0.002499,172.31.36.0-255,66,167937,8,326771
4049,0.002504,74.125.24.0-255,4320,172257,8,326771
4050,0.002506,172.31.36.0-255,66,172323,8,326771
4051,0.002518,74.125.24.0-255,2184,174507,8,326771
4052,0.00252,172.31.36.0-255,66,174573,8,326771
4053,0.002581,74.125.24.0-255,1484,176057,8,326771
4054,0.002592,74.125.24.0-255,1484,177541,8,326771
4055,0.002594,172.31.36.0-255,66,177607,8,326771
4056,0.005069,74.125.24.0-255,2902,180509,8,326771
4057,0.005072,172.31.36.0-255,66,180575,8,326771
4058,0.005134,74.125.24.0-255,2902,183477,8,326771
4059,0.005136,172.31.36.0-255,66,183543,8,326771
4060,0.007684,74.125.24.0-255,2902,186445,8,326771
4061,0.00769,172.31.36.0-255,66,186511,8,326771
4062,0.007713,74.125.24.0-255,2902,189413,8,326771
4063,0.007716,172.31.36.0-255,66,189479,8,326771
4064,0.010282,74.125.24.0-255,5738,195217,8,326771
4065,0.010303,172.31.36.0-255,66,195283,8,326771
4066,0.012864,74.125.24.0-255,5738,201021,8,326771
4067,0.012873,172.31.36.0-255,66,201087,8,326771
4068,0.015468,74.125.24.0-255,5738,206825,8,326771
4069,0.015476,172.31.36.0-255,66,206891,8,326771
4070,0.018033,74.125.24.0-255,5738,212629,8,326771
4071,0.018041,172.31.36.0-255,66,212695,8,326771
4072,0.020607,74.125.24.0-255,5738,218433,8,326771
4073,0.020614,172.31.36.0-255,66,218499,8,326771
4074,0.023167,74.125.24.0-255,5738,224237,8,326771
4075,0.023174,172.31.36.0-255,66,224303,8,326771
4076,0.025765,74.125.24.0-255,5738,230041,8,326771
4077,0.025774,172.31.36.0-255,66,230107,8,326771
4078,0.028362,74.125.24.0-255,5738,235845,8,326771
4079,0.02837,172.31.36.0-255,66,235911,8,326771
4080,0.03092,74.125.24.0-255,5738,241649,8,326771
4081,0.030927,172.31.36.0-255,66,241715,8,326771
4082,0.031981,172.31.36.0-255,172,241887,8,326771
4083,0.032015,172.31.36.0-255,1111,242998,8,326771
4084,0.032045,172.31.36.0-255,571,243569,8,326771
4085,0.033516,104.244.42.0-255,66,243635,8,326771
4086,0.033531,74.125.24.0-255,5738,249373,8,326771
4087,0.033535,172.31.36.0-255,66,249439,8,326771
4088,0.033565,104.244.42.0-255,66,249505,8,326771
4089,0.03357,104.244.42.0-255,66,249571,8,326771
4090,0.036096,74.125.24.0-255,4320,253891,8,326771
4091,0.036102,172.31.36.0-255,66,253957,8,326771
4092,0.036132,74.125.24.0-255,1484,255441,8,326771
4093,0.038703,74.125.24.0-255,4320,259761,8,326771
4094,0.038709,172.31.36.0-255,66,259827,8,326771
4095,0.041306,74.125.24.0-255,4320,264147,8,326771
4096,0.041312,172.31.36.0-255,66,264213,8,326771
4097,0.041342,74.125.24.0-255,1484,265697,8,326771
4098,0.043868,74.125.24.0-255,4320,270017,8,326771
4099,0.043873,172.31.36.0-255,66,270083,8,326771
4100,0.046434,74.125.24.0-255,4320,274403,8,326771
4101,0.046439,172.31.36.0-255,66,274469,8,326771
4102,0.046486,74.125.24.0-255,1484,275953,8,326771
4103,0.049017,74.125.24.0-255,4320,280273,8,326771
4104,0.049021,172.31.36.0-255,66,280339,8,326771
4105,0.051578,74.125.24.0-255,5738,286077,8,326771
4106,0.051582,172.31.36.0-255,66,286143,8,326771
4107,0.054121,74.125.24.0-255,5738,291881,8,326771
4108,0.054126,172.31.36.0-255,66,291947,8,326771
4109,0.05668,74.125.24.0-255,5738,297685,8,326771
4110,0.056687,172.31.36.0-255,66,297751,8,326771
4111,0.059224,74.125.24.0-255,5738,303489,8,326771
4112,0.05923,172.31.36.0-255,66,303555,8,326771
4113,0.061794,74.125.24.0-255,5738,309293,8,326771
4114,0.061799,172.31.36.0-255,66,309359,8,326771
4115,0.064349,74.125.24.0-255,5738,315097,8,326771
4116,0.064354,172.31.36.0-255,66,315163,8,326771
4117,0.066904,74.125.24.0-255,5738,320901,8,326771
4118,0.066909,172.31.36.0-255,66,320967,8,326771
4119,0.069453,74.125.24.0-255,5738,326705,8,326771
4120,0.069458,172.31.36.0-255,66,326771,8,326771
4121,0.0,74.125.200.0-255,146,146,8,306798
4122,3.4e-05,172.31.36.0-255,66,212,8,306798
4123,4.1e-05,74.125.200.0-255,1484,1696,8,306798
4124,4.6e-05,172.31.36.0-255,66,1762,8,306798
4125,5.1e-05,74.125.200.0-255,2902,4664,8,306798
4126,6.5e-05,172.31.36.0-255,66,4730,8,306798
4127,7.2e-05,74.125.200.0-255,7156,11886,8,306798
4128,7.5e-05,172.31.36.0-255,66,11952,8,306798
4129,7.9e-05,74.125.200.0-255,2039,13991,8,306798
4130,8.1e-05,172.31.36.0-255,66,14057,8,306798
4131,0.000127,74.125.200.0-255,1484,15541,8,306798
4132,0.00013,172.31.36.0-255,66,15607,8,306798
4133,0.000164,74.125.200.0-255,2902,18509,8,306798
4134,0.000169,172.31.36.0-255,66,18575,8,306798
4135,0.000175,74.125.200.0-255,5738,24313,8,306798
4136,0.000177,172.31.36.0-255,66,24379,8,306798
4137,0.000181,74.125.200.0-255,2902,27281,8,306798
4138,0.000189,172.31.36.0-255,66,27347,8,306798
4139,0.000196,74.125.200.0-255,3961,31308,8,306798
4140,0.000199,172.31.36.0-255,66,31374,8,306798
4141,0.000293,74.125.200.0-255,1484,32858,8,306798
4142,0.000298,172.31.36.0-255,66,32924,8,306798
4143,0.000304,74.125.200.0-255,2902,35826,8,306798
4144,0.000307,172.31.36.0-255,66,35892,8,306798
4145,0.000344,74.125.200.0-255,4320,40212,8,306798
4146,0.000349,172.31.36.0-255,66,40278,8,306798
4147,0.000355,74.125.200.0-255,5738,46016,8,306798
4148,0.000358,172.31.36.0-255,66,46082,8,306798
4149,0.000401,172.31.36.0-255,66,46148,8,306798
4150,0.000407,74.125.200.0-255,4320,50468,8,306798
4151,0.00041,172.31.36.0-255,66,50534,8,306798
4152,0.000441,74.125.200.0-255,5691,56225,8,306798
4153,0.000445,172.31.36.0-255,66,56291,8,306798
4154,0.00055,74.125.200.0-255,111,56402,8,306798
4155,0.000556,172.31.36.0-255,66,56468,8,306798
4156,0.000686,74.125.200.0-255,1484,57952,8,306798
4157,0.000693,172.31.36.0-255,66,58018,8,306798
4158,0.000698,74.125.200.0-255,2902,60920,8,306798
4159,0.000701,172.31.36.0-255,66,60986,8,306798
4160,0.000734,74.125.200.0-255,5738,66724,8,306798
4161,0.000738,172.31.36.0-255,66,66790,8,306798
4162,0.000741,74.125.200.0-255,1484,68274,8,306798
4163,0.000744,172.31.36.0-255,66,68340,8,306798
4164,0.00075,74.125.200.0-255,2902,71242,8,306798
4165,0.000752,172.31.36.0-255,66,71308,8,306798
4166,0.000795,74.125.200.0-255,5738,77046,8,306798
4167,0.000799,172.31.36.0-255,66,77112,8,306798
4168,0.000804,74.125.200.0-255,2902,80014,8,306798
4169,0.000806,172.31.36.0-255,66,80080,8,306798
4170,0.000817,74.125.200.0-255,4320,84400,8,306798
4171,0.00082,74.125.200.0-255,1484,85884,8,306798
4172,0.000823,172.31.36.0-255,66,85950,8,306798
4173,0.000858,74.125.200.0-255,5285,91235,8,306798
4174,0.000869,172.31.36.0-255,66,91301,8,306798
4175,0.000974,74.125.200.0-255,1484,92785,8,306798
4176,0.00098,74.125.200.0-255,2902,95687,8,306798
4177,0.000999,74.125.200.0-255,2902,98589,8,306798
4178,0.000999,172.31.36.0-255,66,98655,8,306798
4179,0.001005,172.31.36.0-255,66,98721,8,306798
4180,0.001029,74.125.200.0-255,2902,101623,8,306798
4181,0.001035,74.125.200.0-255,5738,107361,8,306798
4182,0.001047,74.125.200.0-255,7156,114517,8,306798
4183,0.001054,172.31.36.0-255,66,114583,8,306798
4184,0.001079,74.125.200.0-255,5738,120321,8,306798
4185,0.001083,172.31.36.0-255,66,120387,8,306798
4186,0.001116,74.125.200.0-255,5020,125407,8,306798
4187,0.001122,172.31.36.0-255,66,125473,8,306798
4188,0.001231,74.125.200.0-255,1484,126957,8,306798
4189,0.00125,74.125.200.0-255,2902,129859,8,306798
4190,0.001254,74.125.200.0-255,1484,131343,8,306798
4191,0.001257,172.31.36.0-255,66,131409,8,306798
4192,0.001279,74.125.200.0-255,4320,135729,8,306798
4193,0.001284,74.125.200.0-255,2902,138631,8,306798
4194,0.001287,74.125.200.0-255,1484,140115,8,306798
4195,0.001289,172.31.36.0-255,66,140181,8,306798
4196,0.001328,172.31.36.0-255,66,140247,8,306798
4197,0.001343,172.31.36.0-255,66,140313,8,306798
4198,0.001372,74.125.200.0-255,1484,141797,8,306798
4199,0.001382,74.125.200.0-255,2902,144699,8,306798
4200,0.001392,172.31.36.0-255,66,144765,8,306798
4201,0.001397,74.125.200.0-255,1484,146249,8,306798
4202,0.001424,74.125.200.0-255,4320,150569,8,306798
4203,0.001437,172.31.36.0-255,66,150635,8,306798
4204,0.001442,172.31.36.0-255,66,150701,8,306798
4205,0.001489,74.125.200.0-255,5020,155721,8,306798
4206,0.001493,172.31.36.0-255,66,155787,8,306798
4207,0.001551,74.125.200.0-255,1484,157271,8,306798
4208,0.001557,74.125.200.0-255,2902,160173,8,306798
4209,0.00156,172.31.36.0-255,66,160239,8,306798
4210,0.001601,74.125.200.0-255,4320,164559,8,306798
4211,0.001607,74.125.200.0-255,5738,170297,8,306798
4212,0.001613,74.125.200.0-255,5738,176035,8,306798
4213,0.001615,172.31.36.0-255,66,176101,8,306798
4214,0.00162,172.31.36.0-255,66,176167,8,306798
4215,0.001631,74.125.200.0-255,5738,181905,8,306798
4216,0.001642,74.125.200.0-255,5738,187643,8,306798
4217,0.001648,172.31.36.0-255,66,187709,8,306798
4218,0.001677,74.125.200.0-255,6438,194147,8,306798
4219,0.001687,74.125.200.0-255,1484,195631,8,306798
4220,0.001688,172.31.36.0-255,66,195697,8,306798
4221,0.001721,74.125.200.0-255,5738,201435,8,306798
4222,0.001726,172.31.36.0-255,66,201501,8,306798
4223,0.001773,74.125.200.0-255,5738,207239,8,306798
4224,0.001777,172.31.36.0-255,66,207305,8,306798
4225,0.001812,172.31.36.0-255,66,207371,8,306798
4226,0.001815,74.125.200.0-255,6438,213809,8,306798
4227,0.001821,74.125.200.0-255,7156,220965,8,306798
4228,0.001825,172.31.36.0-255,66,221031,8,306798
4229,0.001827,74.125.200.0-255,4320,225351,8,306798
4230,0.00183,172.31.36.0-255,66,225417,8,306798
4231,0.001844,74.125.200.0-255,5738,231155,8,306798
4232,0.001855,172.31.36.0-255,66,231221,8,306798
4233,0.001885,74.125.200.0-255,4320,235541,8,306798
4234,0.001891,172.31.36.0-255,66,235607,8,306798
4235,0.001918,74.125.200.0-255,766,236373,8,306798
4236,0.001941,74.125.200.0-255,1484,237857,8,306798
4237,0.001953,172.31.36.0-255,66,237923,8,306798
4238,0.001961,74.125.200.0-255,4320,242243,8,306798
4239,0.001969,172.31.36.0-255,66,242309,8,306798
4240,0.001985,74.125.200.0-255,5738,248047,8,306798
4241,0.00199,172.31.36.0-255,66,248113,8,306798
4242,0.002016,74.125.200.0-255,4320,252433,8,306798
4243,0.002027,172.31.36.0-255,66,252499,8,306798
4244,0.002039,74.125.200.0-255,6438,258937,8,306798
4245,0.002045,172.31.36.0-255,66,259003,8,306798
4246,0.0021,74.125.200.0-255,1484,260487,8,306798
4247,0.002118,74.125.200.0-255,2902,263389,8,306798
4248,0.002126,172.31.36.0-255,66,263455,8,306798
4249,0.002134,74.125.200.0-255,1484,264939,8,306798
4250,0.002153,74.125.200.0-255,2902,267841,8,306798
4251,0.002159,74.125.200.0-255,5738,273579,8,306798
4252,0.002163,172.31.36.0-255,66,273645,8,306798
4253,0.002204,74.125.200.0-255,4320,277965,8,306798
4254,0.002205,172.31.36.0-255,66,278031,8,306798
4255,0.00221,172.31.36.0-255,66,278097,8,306798
4256,0.002249,74.125.200.0-255,3602,281699,8,306798
4257,0.002253,74.125.200.0-255,1484,283183,8,306798
4258,0.002261,172.31.36.0-255,66,283249,8,306798
4259,0.002269,74.125.200.0-255,2902,286151,8,306798
4260,0.002278,172.31.36.0-255,66,286217,8,306798
4261,0.002305,172.31.36.0-255,66,286283,8,306798
4262,0.002306,74.125.200.0-255,4320,290603,8,306798
4263,0.002309,172.31.36.0-255,66,290669,8,306798
4264,0.00235,74.125.200.0-255,7156,297825,8,306798
4265,0.002369,172.31.36.0-255,66,297891,8,306798
4266,0.002391,74.125.200.0-255,1484,299375,8,306798
4267,0.002395,74.125.200.0-255,4320,303695,8,306798
4268,0.002395,172.31.36.0-255,66,303761,8,306798
4269,0.002397,74.125.200.0-255,480,304241,8,306798
4270,0.0024,74.125.200.0-255,97,304338,8,306798
4271,0.0024,172.31.36.0-255,66,304404,8,306798
4272,0.002434,74.125.200.0-255,105,304509,8,306798
4273,0.004122,172.31.36.0-255,66,304575,8,306798
4274,0.004163,172.31.36.0-255,105,304680,8,306798
4275,0.006428,74.125.200.0-255,66,304746,8,306798
4276,0.035138,172.31.36.0-255,172,304918,8,306798
4277,0.035172,172.31.36.0-255,1110,306028,8,306798
4278,0.035249,172.31.36.0-255,572,306600,8,306798
4279,0.036625,104.244.42.0-255,66,306666,8,306798
4280,0.036702,104.244.42.0-255,66,306732,8,306798
4281,0.036726,104.244.42.0-255,66,306798,8,306798
4282,0.0,74.125.24.0-255,152,152,8,307841
4283,2.5e-05,172.31.36.0-255,66,218,8,307841
4284,3.2e-05,74.125.24.0-255,1484,1702,8,307841
4285,3.7e-05,172.31.36.0-255,66,1768,8,307841
4286,4.3e-05,74.125.24.0-255,2902,4670,8,307841
4287,4.7e-05,172.31.36.0-255,66,4736,8,307841
4288,5.6e-05,74.125.24.0-255,7156,11892,8,307841
4289,5.8e-05,172.31.36.0-255,66,11958,8,307841
4290,6.3e-05,74.125.24.0-255,1993,13951,8,307841
4291,6.6e-05,172.31.36.0-255,66,14017,8,307841
4292,0.00034,74.125.24.0-255,1484,15501,8,307841
4293,0.000346,172.31.36.0-255,66,15567,8,307841
4294,0.000401,74.125.24.0-255,2902,18469,8,307841
4295,0.000405,172.31.36.0-255,66,18535,8,307841
4296,0.000424,74.125.24.0-255,1484,20019,8,307841
4297,0.000428,172.31.36.0-255,66,20085,8,307841
4298,0.000465,74.125.24.0-255,5738,25823,8,307841
4299,0.000468,172.31.36.0-255,66,25889,8,307841
4300,0.000472,74.125.24.0-255,1484,27373,8,307841
4301,0.000474,172.31.36.0-255,66,27439,8,307841
4302,0.000494,74.125.24.0-255,3961,31400,8,307841
4303,0.000497,172.31.36.0-255,66,31466,8,307841
4304,0.000685,74.125.24.0-255,1484,32950,8,307841
4305,0.000689,172.31.36.0-255,66,33016,8,307841
4306,0.000708,74.125.24.0-255,2902,35918,8,307841
4307,0.00071,172.31.36.0-255,66,35984,8,307841
4308,0.000717,74.125.24.0-255,5738,41722,8,307841
4309,0.000718,172.31.36.0-255,66,41788,8,307841
4310,0.000747,74.125.24.0-255,6797,48585,8,307841
4311,0.000749,172.31.36.0-255,66,48651,8,307841
4312,0.000753,74.125.24.0-255,1484,50135,8,307841
4313,0.000755,172.31.36.0-255,66,50201,8,307841
4314,0.000772,74.125.24.0-255,5738,55939,8,307841
4315,0.000775,172.31.36.0-255,66,56005,8,307841
4316,0.00078,74.125.24.0-255,4320,60325,8,307841
4317,0.000783,172.31.36.0-255,66,60391,8,307841
4318,0.000803,74.125.24.0-255,1484,61875,8,307841
4319,0.000825,74.125.24.0-255,4273,66148,8,307841
4320,0.000828,172.31.36.0-255,66,66214,8,307841
4321,0.00087,74.125.24.0-255,111,66325,8,307841
4322,0.001103,74.125.24.0-255,330,66655,8,307841
4323,0.001141,74.125.24.0-255,1484,68139,8,307841
4324,0.001145,172.31.36.0-255,66,68205,8,307841
4325,0.001167,74.125.24.0-255,2902,71107,8,307841
4326,0.001169,172.31.36.0-255,66,71173,8,307841
4327,0.001176,74.125.24.0-255,5738,76911,8,307841
4328,0.001178,172.31.36.0-255,66,76977,8,307841
4329,0.001221,172.31.36.0-255,66,77043,8,307841
4330,0.001239,74.125.24.0-255,2902,79945,8,307841
4331,0.001242,172.31.36.0-255,66,80011,8,307841
4332,0.001266,74.125.24.0-255,2902,82913,8,307841
4333,0.001269,172.31.36.0-255,66,82979,8,307841
4334,0.001288,172.31.36.0-255,66,83045,8,307841
4335,0.001545,74.125.24.0-255,1484,84529,8,307841
4336,0.001567,74.125.24.0-255,2902,87431,8,307841
4337,0.00157,172.31.36.0-255,66,87497,8,307841
4338,0.001575,74.125.24.0-255,1484,88981,8,307841
4339,0.001595,74.125.24.0-255,4320,93301,8,307841
4340,0.001597,172.31.36.0-255,66,93367,8,307841
4341,0.001615,74.125.24.0-255,7156,100523,8,307841
4342,0.001617,172.31.36.0-255,66,100589,8,307841
4343,0.001643,74.125.24.0-255,5738,106327,8,307841
4344,0.001645,172.31.36.0-255,66,106393,8,307841
4345,0.001662,74.125.24.0-255,1484,107877,8,307841
4346,0.00168,74.125.24.0-255,7156,115033,8,307841
4347,0.001683,172.31.36.0-255,66,115099,8,307841
4348,0.001701,74.125.24.0-255,2184,117283,8,307841
4349,0.001703,172.31.36.0-255,66,117349,8,307841
4350,0.001776,74.125.24.0-255,1484,118833,8,307841
4351,0.001796,74.125.24.0-255,2902,121735,8,307841
4352,0.0018,172.31.36.0-255,66,121801,8,307841
4353,0.001805,74.125.24.0-255,2902,124703,8,307841
4354,0.001806,172.31.36.0-255,66,124769,8,307841
4355,0.00182,74.125.24.0-255,2902,127671,8,307841
4356,0.001823,172.31.36.0-255,66,127737,8,307841
4357,0.001854,74.125.24.0-255,7156,134893,8,307841
4358,0.001857,172.31.36.0-255,66,134959,8,307841
4359,0.001909,172.31.36.0-255,66,135025,8,307841
4360,0.001931,74.125.24.0-255,4320,139345,8,307841
4361,0.001933,172.31.36.0-255,66,139411,8,307841
4362,0.001938,74.125.24.0-255,2184,141595,8,307841
4363,0.00194,172.31.36.0-255,66,141661,8,307841
4364,0.002566,74.125.24.0-255,1484,143145,8,307841
4365,0.002576,74.125.24.0-255,2902,146047,8,307841
4366,0.002579,172.31.36.0-255,66,146113,8,307841
4367,0.002587,74.125.24.0-255,5738,151851,8,307841
4368,0.002589,172.31.36.0-255,66,151917,8,307841
4369,0.002594,74.125.24.0-255,2902,154819,8,307841
4370,0.002595,172.31.36.0-255,66,154885,8,307841
4371,0.005134,74.125.24.0-255,5738,160623,8,307841
4372,0.005141,172.31.36.0-255,66,160689,8,307841
4373,0.007698,74.125.24.0-255,5738,166427,8,307841
4374,0.007704,172.31.36.0-255,66,166493,8,307841
4375,0.010259,74.125.24.0-255,5738,172231,8,307841
4376,0.010267,172.31.36.0-255,66,172297,8,307841
4377,0.012858,74.125.24.0-255,5738,178035,8,307841
4378,0.012867,172.31.36.0-255,66,178101,8,307841
4379,0.015471,74.125.24.0-255,5738,183839,8,307841
4380,0.01548,172.31.36.0-255,66,183905,8,307841
4381,0.018065,74.125.24.0-255,5738,189643,8,307841
4382,0.018074,172.31.36.0-255,66,189709,8,307841
4383,0.020668,74.125.24.0-255,5738,195447,8,307841
4384,0.020676,172.31.36.0-255,66,195513,8,307841
4385,0.023277,74.125.24.0-255,5738,201251,8,307841
4386,0.023286,172.31.36.0-255,66,201317,8,307841
4387,0.025918,74.125.24.0-255,5738,207055,8,307841
4388,0.025927,172.31.36.0-255,66,207121,8,307841
4389,0.02854,74.125.24.0-255,5738,212859,8,307841
4390,0.028549,172.31.36.0-255,66,212925,8,307841
4391,0.031092,74.125.24.0-255,5738,218663,8,307841
4392,0.0311,172.31.36.0-255,66,218729,8,307841
4393,0.033699,74.125.24.0-255,5738,224467,8,307841
4394,0.033707,172.31.36.0-255,66,224533,8,307841
4395,0.036284,74.125.24.0-255,5738,230271,8,307841
4396,0.036292,172.31.36.0-255,66,230337,8,307841
4397,0.038843,74.125.24.0-255,5738,236075,8,307841
4398,0.038854,172.31.36.0-255,66,236141,8,307841
4399,0.041009,172.31.36.0-255,172,236313,8,307841
4400,0.041043,172.31.36.0-255,1110,237423,8,307841
4401,0.041097,172.31.36.0-255,572,237995,8,307841
4402,0.04145,74.125.24.0-255,5738,243733,8,307841
4403,0.041457,172.31.36.0-255,66,243799,8,307841
4404,0.042568,104.244.42.0-255,66,243865,8,307841
4405,0.042646,104.244.42.0-255,66,243931,8,307841
4406,0.04265,104.244.42.0-255,66,243997,8,307841
4407,0.043997,74.125.24.0-255,5738,249735,8,307841
4408,0.044004,172.31.36.0-255,66,249801,8,307841
4409,0.046565,74.125.24.0-255,5738,255539,8,307841
4410,0.046573,172.31.36.0-255,66,255605,8,307841
4411,0.049151,74.125.24.0-255,5738,261343,8,307841
4412,0.049164,172.31.36.0-255,66,261409,8,307841
4413,0.051726,74.125.24.0-255,5738,267147,8,307841
4414,0.051735,172.31.36.0-255,66,267213,8,307841
4415,0.054309,74.125.24.0-255,5738,272951,8,307841
4416,0.054316,172.31.36.0-255,66,273017,8,307841
4417,0.056854,74.125.24.0-255,5738,278755,8,307841
4418,0.056861,172.31.36.0-255,66,278821,8,307841
4419,0.059414,74.125.24.0-255,5738,284559,8,307841
4420,0.059422,172.31.36.0-255,66,284625,8,307841
4421,0.061994,74.125.24.0-255,5738,290363,8,307841
4422,0.062,172.31.36.0-255,66,290429,8,307841
4423,0.064613,74.125.24.0-255,5738,296167,8,307841
4424,0.064624,172.31.36.0-255,66,296233,8,307841
4425,0.067206,74.125.24.0-255,5738,301971,8,307841
4426,0.067212,172.31.36.0-255,66,302037,8,307841
4427,0.069805,74.125.24.0-255,5738,307775,8,307841
4428,0.069812,172.31.36.0-255,66,307841,8,307841
4429,0.0,74.125.24.0-255,153,153,8,265791
4430,3.4e-05,172.31.36.0-255,66,219,8,265791
4431,4.1e-05,74.125.24.0-255,1484,1703,8,265791
4432,4.6e-05,172.31.36.0-255,66,1769,8,265791
4433,5e-05,74.125.24.0-255,2902,4671,8,265791
4434,6.5e-05,172.31.36.0-255,66,4737,8,265791
4435,7.2e-05,74.125.24.0-255,7156,11893,8,265791
4436,7.4e-05,172.31.36.0-255,66,11959,8,265791
4437,0.000103,74.125.24.0-255,2066,14025,8,265791
4438,0.000106,172.31.36.0-255,66,14091,8,265791
4439,0.000111,74.125.24.0-255,2902,16993,8,265791
4440,0.000113,172.31.36.0-255,66,17059,8,265791
4441,0.000116,74.125.24.0-255,1484,18543,8,265791
4442,0.000118,172.31.36.0-255,66,18609,8,265791
4443,0.000135,74.125.24.0-255,5738,24347,8,265791
4444,0.00014,172.31.36.0-255,66,24413,8,265791
4445,0.000152,74.125.24.0-255,6797,31210,8,265791
4446,0.000155,172.31.36.0-255,66,31276,8,265791
4447,0.000336,74.125.24.0-255,1484,32760,8,265791
4448,0.000341,172.31.36.0-255,66,32826,8,265791
4449,0.000347,74.125.24.0-255,2902,35728,8,265791
4450,0.000349,172.31.36.0-255,66,35794,8,265791
4451,0.000354,74.125.24.0-255,2902,38696,8,265791
4452,0.000362,172.31.36.0-255,66,38762,8,265791
4453,0.000395,74.125.24.0-255,2902,41664,8,265791
4454,0.000398,172.31.36.0-255,66,41730,8,265791
4455,0.000406,74.125.24.0-255,6797,48527,8,265791
4456,0.000409,172.31.36.0-255,66,48593,8,265791
4457,0.000432,74.125.24.0-255,1484,50077,8,265791
4458,0.000435,172.31.36.0-255,66,50143,8,265791
4459,0.000441,74.125.24.0-255,2902,53045,8,265791
4460,0.000444,172.31.36.0-255,66,53111,8,265791
4461,0.00045,74.125.24.0-255,5738,58849,8,265791
4462,0.000455,172.31.36.0-255,66,58915,8,265791
4463,0.000478,74.125.24.0-255,4320,63235,8,265791
4464,0.000483,172.31.36.0-255,66,63301,8,265791
4465,0.000502,74.125.24.0-255,2840,66141,8,265791
4466,0.000506,172.31.36.0-255,66,66207,8,265791
4467,0.00087,74.125.24.0-255,131,66338,8,265791
4468,0.000876,74.125.24.0-255,347,66685,8,265791
4469,0.000933,172.31.36.0-255,66,66751,8,265791
4470,0.001089,74.125.24.0-255,1484,68235,8,265791
4471,0.001111,74.125.24.0-255,2902,71137,8,265791
4472,0.001115,172.31.36.0-255,66,71203,8,265791
4473,0.001145,74.125.24.0-255,5738,76941,8,265791
4474,0.001148,172.31.36.0-255,66,77007,8,265791
4475,0.001175,74.125.24.0-255,5738,82745,8,265791
4476,0.001186,172.31.36.0-255,66,82811,8,265791
4477,0.001192,74.125.24.0-255,4320,87131,8,265791
4478,0.001194,172.31.36.0-255,66,87197,8,265791
4479,0.001227,74.125.24.0-255,2902,90099,8,265791
4480,0.001229,172.31.36.0-255,66,90165,8,265791
4481,0.00124,172.31.36.0-255,66,90231,8,265791
4482,0.00127,74.125.24.0-255,766,90997,8,265791
4483,0.001504,172.31.36.0-255,66,91063,8,265791
4484,0.003572,74.125.24.0-255,4320,95383,8,265791
4485,0.003578,172.31.36.0-255,66,95449,8,265791
4486,0.003797,74.125.24.0-255,1484,96933,8,265791
4487,0.005886,74.125.24.0-255,4320,101253,8,265791
4488,0.005891,172.31.36.0-255,66,101319,8,265791
4489,0.008228,74.125.24.0-255,5738,107057,8,265791
4490,0.008236,172.31.36.0-255,66,107123,8,265791
4491,0.010621,74.125.24.0-255,5738,112861,8,265791
4492,0.010628,172.31.36.0-255,66,112927,8,265791
4493,0.012951,74.125.24.0-255,5738,118665,8,265791
4494,0.012961,172.31.36.0-255,66,118731,8,265791
4495,0.01529,74.125.24.0-255,5738,124469,8,265791
4496,0.015298,172.31.36.0-255,66,124535,8,265791
4497,0.017668,74.125.24.0-255,5738,130273,8,265791
4498,0.017675,172.31.36.0-255,66,130339,8,265791
4499,0.020081,74.125.24.0-255,5738,136077,8,265791
4500,0.020088,172.31.36.0-255,66,136143,8,265791
4501,0.022404,74.125.24.0-255,5738,141881,8,265791
4502,0.022411,172.31.36.0-255,66,141947,8,265791
4503,0.024716,74.125.24.0-255,4320,146267,8,265791
4504,0.024723,172.31.36.0-255,66,146333,8,265791
4505,0.024754,74.125.24.0-255,1484,147817,8,265791
4506,0.027021,74.125.24.0-255,4320,152137,8,265791
4507,0.027027,172.31.36.0-255,66,152203,8,265791
4508,0.029323,74.125.24.0-255,5738,157941,8,265791
4509,0.029332,172.31.36.0-255,66,158007,8,265791
4510,0.031674,74.125.24.0-255,5738,163745,8,265791
4511,0.031683,172.31.36.0-255,66,163811,8,265791
4512,0.034006,74.125.24.0-255,5738,169549,8,265791
4513,0.034014,172.31.36.0-255,66,169615,8,265791
4514,0.03465,172.31.36.0-255,645,170260,8,265791
4515,0.034694,172.31.36.0-255,1112,171372,8,265791
4516,0.03479,172.31.36.0-255,1514,172886,8,265791
4517,0.034791,172.31.36.0-255,1514,174400,8,265791
4518,0.034793,172.31.36.0-255,1514,175914,8,265791
4519,0.034794,172.31.36.0-255,771,176685,8,265791
4520,0.036197,104.244.42.0-255,66,176751,8,265791
4521,0.036235,104.244.42.0-255,66,176817,8,265791
4522,0.036341,74.125.24.0-255,1484,178301,8,265791
4523,0.036373,104.244.42.0-255,66,178367,8,265791
4524,0.036379,104.244.42.0-255,66,178433,8,265791
4525,0.036382,74.125.24.0-255,4320,182753,8,265791
4526,0.036387,172.31.36.0-255,66,182819,8,265791
4527,0.038727,74.125.24.0-255,5738,188557,8,265791
4528,0.038735,172.31.36.0-255,66,188623,8,265791
4529,0.041255,74.125.24.0-255,2902,191525,8,265791
4530,0.041262,172.31.36.0-255,66,191591,8,265791
4531,0.041292,74.125.24.0-255,2902,194493,8,265791
4532,0.041296,172.31.36.0-255,66,194559,8,265791
4533,0.043548,74.125.24.0-255,2902,197461,8,265791
4534,0.043555,172.31.36.0-255,66,197527,8,265791
4535,0.043627,74.125.24.0-255,2902,200429,8,265791
4536,0.04363,172.31.36.0-255,66,200495,8,265791
4537,0.045892,74.125.24.0-255,2902,203397,8,265791
4538,0.045898,172.31.36.0-255,66,203463,8,265791
4539,0.045935,74.125.24.0-255,1484,204947,8,265791
4540,0.045946,74.125.24.0-255,1484,206431,8,265791
4541,0.045949,172.31.36.0-255,66,206497,8,265791
4542,0.048188,74.125.24.0-255,2902,209399,8,265791
4543,0.048194,172.31.36.0-255,66,209465,8,265791
4544,0.048239,74.125.24.0-255,2902,212367,8,265791
4545,0.048243,172.31.36.0-255,66,212433,8,265791
4546,0.050486,74.125.24.0-255,2902,215335,8,265791
4547,0.050491,172.31.36.0-255,66,215401,8,265791
4548,0.050529,74.125.24.0-255,1484,216885,8,265791
4549,0.050544,74.125.24.0-255,1484,218369,8,265791
4550,0.05055,172.31.36.0-255,66,218435,8,265791
4551,0.05281,74.125.24.0-255,2902,221337,8,265791
4552,0.052816,172.31.36.0-255,66,221403,8,265791
4553,0.052878,74.125.24.0-255,2902,224305,8,265791
4554,0.052882,172.31.36.0-255,66,224371,8,265791
4555,0.055161,74.125.24.0-255,2902,227273,8,265791
4556,0.055167,172.31.36.0-255,66,227339,8,265791
4557,0.055206,74.125.24.0-255,1484,228823,8,265791
4558,0.055218,74.125.24.0-255,1484,230307,8,265791
4559,0.055221,172.31.36.0-255,66,230373,8,265791
4560,0.057461,74.125.24.0-255,2902,233275,8,265791
4561,0.057468,172.31.36.0-255,66,233341,8,265791
4562,0.057505,74.125.24.0-255,2902,236243,8,265791
4563,0.057508,172.31.36.0-255,66,236309,8,265791
4564,0.059806,74.125.24.0-255,2902,239211,8,265791
4565,0.059811,172.31.36.0-255,66,239277,8,265791
4566,0.05984,74.125.24.0-255,2902,242179,8,265791
4567,0.059843,172.31.36.0-255,66,242245,8,265791
4568,0.062143,74.125.24.0-255,5738,247983,8,265791
4569,0.062151,172.31.36.0-255,66,248049,8,265791
4570,0.064477,74.125.24.0-255,5738,253787,8,265791
4571,0.064484,172.31.36.0-255,66,253853,8,265791
4572,0.066835,74.125.24.0-255,2902,256755,8,265791
4573,0.06684,172.31.36.0-255,66,256821,8,265791
4574,0.066877,74.125.24.0-255,2902,259723,8,265791
4575,0.066881,172.31.36.0-255,66,259789,8,265791
4576,0.069131,74.125.24.0-255,1484,261273,8,265791
4577,0.069157,74.125.24.0-255,1484,262757,8,265791
4578,0.069162,172.31.36.0-255,66,262823,8,265791
4579,0.069211,74.125.24.0-255,2902,265725,8,265791
4580,0.069215,172.31.36.0-255,66,265791,8,265791
4581,0.0,74.125.24.0-255,289,289,8,279269
4582,1.3e-05,172.31.36.0-255,66,355,8,279269
4583,1.9e-05,74.125.24.0-255,1484,1839,8,279269
4584,2.4e-05,172.31.36.0-255,66,1905,8,279269
4585,3e-05,74.125.24.0-255,4320,6225,8,279269
4586,3.3e-05,172.31.36.0-255,66,6291,8,279269
4587,3.9e-05,74.125.24.0-255,4320,10611,8,279269
4588,4.2e-05,172.31.36.0-255,66,10677,8,279269
4589,4.9e-05,74.125.24.0-255,4687,15364,8,279269
4590,5.1e-05,172.31.36.0-255,66,15430,8,279269
4591,9.5e-05,172.31.36.0-255,66,15496,8,279269
4592,0.000101,74.125.24.0-255,3961,19457,8,279269
4593,0.000103,172.31.36.0-255,66,19523,8,279269
4594,0.000166,74.125.24.0-255,1484,21007,8,279269
4595,0.00017,172.31.36.0-255,66,21073,8,279269
4596,0.000176,74.125.24.0-255,2902,23975,8,279269
4597,0.000179,172.31.36.0-255,66,24041,8,279269
4598,0.000185,74.125.24.0-255,5738,29779,8,279269
4599,0.000188,172.31.36.0-255,66,29845,8,279269
4600,0.000195,74.125.24.0-255,6797,36642,8,279269
4601,0.000197,172.31.36.0-255,66,36708,8,279269
4602,0.000205,74.125.24.0-255,7156,43864,8,279269
4603,0.000208,172.31.36.0-255,66,43930,8,279269
4604,0.00024,74.125.24.0-255,2902,46832,8,279269
4605,0.000243,172.31.36.0-255,66,46898,8,279269
4606,0.000268,74.125.24.0-255,7066,53964,8,279269
4607,0.000271,172.31.36.0-255,66,54030,8,279269
4608,0.00032,74.125.24.0-255,387,54417,8,279269
4609,0.000323,172.31.36.0-255,66,54483,8,279269
4610,0.000348,74.125.24.0-255,1484,55967,8,279269
4611,0.000351,172.31.36.0-255,66,56033,8,279269
4612,0.000356,74.125.24.0-255,2902,58935,8,279269
4613,0.000359,172.31.36.0-255,66,59001,8,279269
4614,0.00038,74.125.24.0-255,1484,60485,8,279269
4615,0.0004,74.125.24.0-255,5738,66223,8,279269
4616,0.000403,172.31.36.0-255,66,66289,8,279269
4617,0.000419,74.125.24.0-255,1484,67773,8,279269
4618,0.000427,74.125.24.0-255,7156,74929,8,279269
4619,0.00043,172.31.36.0-255,66,74995,8,279269
4620,0.000448,74.125.24.0-255,1484,76479,8,279269
4621,0.000453,74.125.24.0-255,2902,79381,8,279269
4622,0.000457,172.31.36.0-255,66,79447,8,279269
4623,0.000475,74.125.24.0-255,5738,85185,8,279269
4624,0.000477,172.31.36.0-255,66,85251,8,279269
4625,0.000501,74.125.24.0-255,3052,88303,8,279269
4626,0.000503,172.31.36.0-255,66,88369,8,279269
4627,0.000521,74.125.24.0-255,1484,89853,8,279269
4628,0.000524,74.125.24.0-255,1484,91337,8,279269
4629,0.000526,172.31.36.0-255,66,91403,8,279269
4630,0.000547,74.125.24.0-255,1484,92887,8,279269
4631,0.000554,74.125.24.0-255,5738,98625,8,279269
4632,0.000557,172.31.36.0-255,66,98691,8,279269
4633,0.000564,74.125.24.0-255,6797,105488,8,279269
4634,0.000567,172.31.36.0-255,66,105554,8,279269
4635,0.000679,74.125.24.0-255,1484,107038,8,279269
4636,0.000684,74.125.24.0-255,1484,108522,8,279269
4637,0.000686,172.31.36.0-255,66,108588,8,279269
4638,0.000705,74.125.24.0-255,1484,110072,8,279269
4639,0.000714,74.125.24.0-255,5738,115810,8,279269
4640,0.000716,172.31.36.0-255,66,115876,8,279269
4641,0.000723,74.125.24.0-255,5738,121614,8,279269
4642,0.000726,172.31.36.0-255,66,121680,8,279269
4643,0.000749,74.125.24.0-255,7156,128836,8,279269
4644,0.000751,172.31.36.0-255,66,128902,8,279269
4645,0.000765,172.31.36.0-255,66,128968,8,279269
4646,0.000818,74.125.24.0-255,4320,133288,8,279269
4647,0.000821,172.31.36.0-255,66,133354,8,279269
4648,0.000827,74.125.24.0-255,5738,139092,8,279269
4649,0.00083,172.31.36.0-255,66,139158,8,279269
4650,0.000851,74.125.24.0-255,1484,140642,8,279269
4651,0.000877,74.125.24.0-255,5379,146021,8,279269
4652,0.000881,172.31.36.0-255,66,146087,8,279269
4653,0.001009,74.125.24.0-255,1484,147571,8,279269
4654,0.001016,74.125.24.0-255,2902,150473,8,279269
4655,0.001018,172.31.36.0-255,66,150539,8,279269
4656,0.001025,74.125.24.0-255,4320,154859,8,279269
4657,0.001027,172.31.36.0-255,66,154925,8,279269
4658,0.001052,74.125.24.0-255,1484,156409,8,279269
4659,0.001057,74.125.24.0-255,4320,160729,8,279269
4660,0.001063,74.125.24.0-255,5738,166467,8,279269
4661,0.001068,172.31.36.0-255,66,166533,8,279269
4662,0.001072,172.31.36.0-255,66,166599,8,279269
4663,0.001116,74.125.24.0-255,1484,168083,8,279269
4664,0.00112,172.31.36.0-255,66,168149,8,279269
4665,0.001129,74.125.24.0-255,766,168915,8,279269
4666,0.001132,172.31.36.0-255,66,168981,8,279269
4667,0.001181,74.125.24.0-255,1484,170465,8,279269
4668,0.001209,74.125.24.0-255,2902,173367,8,279269
4669,0.001213,172.31.36.0-255,66,173433,8,279269
4670,0.001232,74.125.24.0-255,4320,177753,8,279269
4671,0.001236,172.31.36.0-255,66,177819,8,279269
4672,0.001252,74.125.24.0-255,4320,182139,8,279269
4673,0.001256,172.31.36.0-255,66,182205,8,279269
4674,0.001269,74.125.24.0-255,2902,185107,8,279269
4675,0.001272,172.31.36.0-255,66,185173,8,279269
4676,0.001295,172.31.36.0-255,66,185239,8,279269
4677,0.001298,74.125.24.0-255,1484,186723,8,279269
4678,0.001332,172.31.36.0-255,66,186789,8,279269
4679,0.001525,74.125.24.0-255,1484,188273,8,279269
4680,0.001545,74.125.24.0-255,2902,191175,8,279269
4681,0.001549,172.31.36.0-255,66,191241,8,279269
4682,0.001556,74.125.24.0-255,5738,196979,8,279269
4683,0.001558,172.31.36.0-255,66,197045,8,279269
4684,0.001561,74.125.24.0-255,1484,198529,8,279269
4685,0.001603,172.31.36.0-255,66,198595,8,279269
4686,0.00161,74.125.24.0-255,5738,204333,8,279269
4687,0.001612,172.31.36.0-255,66,204399,8,279269
4688,0.001639,172.31.36.0-255,66,204465,8,279269
4689,0.00179,74.125.24.0-255,1484,205949,8,279269
4690,0.001812,74.125.24.0-255,2902,208851,8,279269
4691,0.001816,172.31.36.0-255,66,208917,8,279269
4692,0.001822,74.125.24.0-255,4320,213237,8,279269
4693,0.001824,172.31.36.0-255,66,213303,8,279269
4694,0.001835,172.31.36.0-255,66,213369,8,279269
4695,0.001862,74.125.24.0-255,4320,217689,8,279269
4696,0.001864,172.31.36.0-255,66,217755,8,279269
4697,0.0019,172.31.36.0-255,66,217821,8,279269
4698,0.001912,74.125.24.0-255,1484,219305,8,279269
4699,0.001917,74.125.24.0-255,2902,222207,8,279269
4700,0.001919,172.31.36.0-255,66,222273,8,279269
4701,0.001923,74.125.24.0-255,2902,225175,8,279269
4702,0.001925,172.31.36.0-255,66,225241,8,279269
4703,0.001947,74.125.24.0-255,2902,228143,8,279269
4704,0.00195,172.31.36.0-255,66,228209,8,279269
4705,0.001962,172.31.36.0-255,66,228275,8,279269
4706,0.001987,74.125.24.0-255,4320,232595,8,279269
4707,0.00199,172.31.36.0-255,66,232661,8,279269
4708,0.001997,74.125.24.0-255,7156,239817,8,279269
4709,0.001999,172.31.36.0-255,66,239883,8,279269
4710,0.002035,74.125.24.0-255,4320,244203,8,279269
4711,0.002038,172.31.36.0-255,66,244269,8,279269
4712,0.002085,172.31.36.0-255,66,244335,8,279269
4713,0.002099,172.31.36.0-255,66,244401,8,279269
4714,0.002116,172.31.36.0-255,66,244467,8,279269
4715,0.002121,74.125.24.0-255,2902,247369,8,279269
4716,0.002123,172.31.36.0-255,66,247435,8,279269
4717,0.004165,74.125.24.0-255,5738,253173,8,279269
4718,0.00417,172.31.36.0-255,66,253239,8,279269
4719,0.006215,74.125.24.0-255,5738,258977,8,279269
4720,0.006223,172.31.36.0-255,66,259043,8,279269
4721,0.008236,74.125.24.0-255,5738,264781,8,279269
4722,0.00824,172.31.36.0-255,66,264847,8,279269
4723,0.010271,74.125.24.0-255,3791,268638,8,279269
4724,0.010278,172.31.36.0-255,66,268704,8,279269
4725,0.011853,172.31.36.0-255,105,268809,8,279269
4726,0.013887,74.125.24.0-255,66,268875,8,279269
4727,0.035674,172.31.36.0-255,172,269047,8,279269
4728,0.035707,172.31.36.0-255,1110,270157,8,279269
4729,0.035767,172.31.36.0-255,1514,271671,8,279269
4730,0.035769,172.31.36.0-255,1514,273185,8,279269
4731,0.035774,172.31.36.0-255,1514,274699,8,279269
4732,0.035775,172.31.36.0-255,1514,276213,8,279269
4733,0.035793,172.31.36.0-255,1514,277727,8,279269
4734,0.035795,172.31.36.0-255,996,278723,8,279269
4735,0.037207,104.244.42.0-255,66,278789,8,279269
4736,0.037251,104.244.42.0-255,66,278855,8,279269
4737,0.037343,104.244.42.0-255,66,278921,8,279269
4738,0.03735,104.244.42.0-255,66,278987,8,279269
4739,0.038013,104.244.42.0-255,108,279095,8,279269
4740,0.038023,172.31.36.0-255,66,279161,8,279269
4741,0.046074,172.31.36.0-255,108,279269,8,279269
4742,0.0,172.217.194.0-255,159,159,8,211281
4743,2.3e-05,172.31.36.0-255,66,225,8,211281
4744,2.9e-05,172.217.194.0-255,1484,1709,8,211281
4745,3.3e-05,172.31.36.0-255,66,1775,8,211281
4746,3.9e-05,172.217.194.0-255,2902,4677,8,211281
4747,5e-05,172.31.36.0-255,66,4743,8,211281
4748,5.6e-05,172.217.194.0-255,4320,9063,8,211281
4749,6e-05,172.31.36.0-255,66,9129,8,211281
4750,6.6e-05,172.217.194.0-255,4766,13895,8,211281
4751,6.9e-05,172.31.36.0-255,66,13961,8,211281
4752,7.5e-05,172.217.194.0-255,4320,18281,8,211281
4753,7.8e-05,172.31.36.0-255,66,18347,8,211281
4754,0.000117,172.217.194.0-255,7156,25503,8,211281
4755,0.000121,172.31.36.0-255,66,25569,8,211281
4756,0.000128,172.217.194.0-255,5379,30948,8,211281
4757,0.000131,172.31.36.0-255,66,31014,8,211281
4758,0.000185,172.217.194.0-255,1484,32498,8,211281
4759,0.000187,172.31.36.0-255,66,32564,8,211281
4760,0.000213,172.217.194.0-255,2902,35466,8,211281
4761,0.000215,172.31.36.0-255,66,35532,8,211281
4762,0.000222,172.217.194.0-255,5738,41270,8,211281
4763,0.000225,172.31.36.0-255,66,41336,8,211281
4764,0.000287,172.31.36.0-255,66,41402,8,211281
4765,0.000323,172.31.36.0-255,66,41468,8,211281
4766,0.000486,172.217.194.0-255,1484,42952,8,211281
4767,0.00049,172.31.36.0-255,66,43018,8,211281
4768,0.000497,172.217.194.0-255,2902,45920,8,211281
4769,0.0005,172.31.36.0-255,66,45986,8,211281
4770,0.000524,172.217.194.0-255,2902,48888,8,211281
4771,0.000526,172.31.36.0-255,66,48954,8,211281
4772,0.000554,172.217.194.0-255,2902,51856,8,211281
4773,0.000557,172.31.36.0-255,66,51922,8,211281
4774,0.000564,172.217.194.0-255,6248,58170,8,211281
4775,0.000566,172.31.36.0-255,66,58236,8,211281
4776,0.000634,172.217.194.0-255,1484,59720,8,211281
4777,0.000641,172.217.194.0-255,2902,62622,8,211281
4778,0.000644,172.31.36.0-255,66,62688,8,211281
4779,0.000648,172.217.194.0-255,2902,65590,8,211281
4780,0.00065,172.31.36.0-255,66,65656,8,211281
4781,0.000675,172.217.194.0-255,2902,68558,8,211281
4782,0.000678,172.31.36.0-255,66,68624,8,211281
4783,0.000681,172.217.194.0-255,1484,70108,8,211281
4784,0.000722,172.31.36.0-255,66,70174,8,211281
4785,0.000758,172.217.194.0-255,7156,77330,8,211281
4786,0.000761,172.31.36.0-255,66,77396,8,211281
4787,0.000782,172.217.194.0-255,2902,80298,8,211281
4788,0.000784,172.31.36.0-255,66,80364,8,211281
4789,0.000787,172.217.194.0-255,766,81130,8,211281
4790,0.001616,172.31.36.0-255,66,81196,8,211281
4791,0.001912,172.217.194.0-255,1484,82680,8,211281
4792,0.001923,172.217.194.0-255,2902,85582,8,211281
4793,0.001927,172.31.36.0-255,66,85648,8,211281
4794,0.001934,172.217.194.0-255,4320,89968,8,211281
4795,0.001936,172.31.36.0-255,66,90034,8,211281
4796,0.001974,172.217.194.0-255,1484,91518,8,211281
4797,0.001987,172.31.36.0-255,66,91584,8,211281
4798,0.002,172.31.36.0-255,66,91650,8,211281
4799,0.002109,172.217.194.0-255,1484,93134,8,211281
4800,0.002115,172.217.194.0-255,2902,96036,8,211281
4801,0.002118,172.31.36.0-255,66,96102,8,211281
4802,0.002125,172.217.194.0-255,5738,101840,8,211281
4803,0.002127,172.31.36.0-255,66,101906,8,211281
4804,0.002138,172.217.194.0-255,5738,107644,8,211281
4805,0.00214,172.31.36.0-255,66,107710,8,211281
4806,0.002164,172.217.194.0-255,1484,109194,8,211281
4807,0.002193,172.217.194.0-255,5738,114932,8,211281
4808,0.002195,172.31.36.0-255,66,114998,8,211281
4809,0.002234,172.31.36.0-255,66,115064,8,211281
4810,0.002377,172.217.194.0-255,1484,116548,8,211281
4811,0.002384,172.217.194.0-255,2902,119450,8,211281
4812,0.002387,172.31.36.0-255,66,119516,8,211281
4813,0.002394,172.217.194.0-255,4320,123836,8,211281
4814,0.002396,172.31.36.0-255,66,123902,8,211281
4815,0.00242,172.217.194.0-255,1484,125386,8,211281
4816,0.002429,172.217.194.0-255,2902,128288,8,211281
4817,0.00243,172.31.36.0-255,66,128354,8,211281
4818,0.002438,172.217.194.0-255,5738,134092,8,211281
4819,0.002439,172.31.36.0-255,66,134158,8,211281
4820,0.002479,172.31.36.0-255,66,134224,8,211281
4821,0.002485,172.217.194.0-255,3602,137826,8,211281
4822,0.002488,172.31.36.0-255,66,137892,8,211281
4823,0.002491,172.217.194.0-255,1484,139376,8,211281
4824,0.002516,172.217.194.0-255,2902,142278,8,211281
4825,0.002519,172.31.36.0-255,66,142344,8,211281
4826,0.002565,172.31.36.0-255,66,142410,8,211281
4827,0.00257,172.217.194.0-255,3602,146012,8,211281
4828,0.002573,172.31.36.0-255,78,146090,8,211281
4829,0.002582,172.217.194.0-255,2902,148992,8,211281
4830,0.002585,172.31.36.0-255,66,149058,8,211281
4831,0.002668,172.217.194.0-255,1484,150542,8,211281
4832,0.002674,172.217.194.0-255,2902,153444,8,211281
4833,0.002677,172.31.36.0-255,66,153510,8,211281
4834,0.00268,172.217.194.0-255,1484,154994,8,211281
4835,0.002705,172.217.194.0-255,4320,159314,8,211281
4836,0.002708,172.31.36.0-255,66,159380,8,211281
4837,0.002711,172.217.194.0-255,1484,160864,8,211281
4838,0.002741,172.31.36.0-255,66,160930,8,211281
4839,0.002751,172.31.36.0-255,66,160996,8,211281
4840,0.002784,172.217.194.0-255,3602,164598,8,211281
4841,0.002787,172.31.36.0-255,66,164664,8,211281
4842,0.002792,172.217.194.0-255,4320,168984,8,211281
4843,0.002795,172.31.36.0-255,66,169050,8,211281
4844,0.002827,172.217.194.0-255,4320,173370,8,211281
4845,0.00283,172.31.36.0-255,66,173436,8,211281
4846,0.002867,172.217.194.0-255,5738,179174,8,211281
4847,0.00287,172.31.36.0-255,66,179240,8,211281
4848,0.002902,172.217.194.0-255,1484,180724,8,211281
4849,0.00292,172.31.36.0-255,66,180790,8,211281
4850,0.002938,172.31.36.0-255,66,180856,8,211281
4851,0.002953,172.31.36.0-255,66,180922,8,211281
4852,0.002979,172.217.194.0-255,2184,183106,8,211281
4853,0.002982,172.31.36.0-255,78,183184,8,211281
4854,0.00299,172.217.194.0-255,7156,190340,8,211281
4855,0.002992,172.31.36.0-255,78,190418,8,211281
4856,0.003037,172.31.36.0-255,78,190496,8,211281
4857,0.003062,172.31.36.0-255,66,190562,8,211281
4858,0.003077,172.31.36.0-255,66,190628,8,211281
4859,0.003102,172.217.194.0-255,7156,197784,8,211281
4860,0.003105,172.31.36.0-255,66,197850,8,211281
4861,0.003109,172.217.194.0-255,2737,200587,8,211281
4862,0.003112,172.31.36.0-255,66,200653,8,211281
4863,0.003115,172.217.194.0-255,105,200758,8,211281
4864,0.013614,172.31.36.0-255,66,200824,8,211281
4865,0.013672,172.31.36.0-255,105,200929,8,211281
4866,0.01592,172.217.194.0-255,66,200995,8,211281
4867,0.056287,172.31.36.0-255,172,201167,8,211281
4868,0.056324,172.31.36.0-255,1111,202278,8,211281
4869,0.056396,172.31.36.0-255,1514,203792,8,211281
4870,0.056397,172.31.36.0-255,1514,205306,8,211281
4871,0.056403,172.31.36.0-255,1514,206820,8,211281
4872,0.056404,172.31.36.0-255,1514,208334,8,211281
4873,0.056423,172.31.36.0-255,1514,209848,8,211281
4874,0.056424,172.31.36.0-255,995,210843,8,211281
4875,0.057846,104.244.42.0-255,66,210909,8,211281
4876,0.057884,104.244.42.0-255,66,210975,8,211281
4877,0.057992,104.244.42.0-255,66,211041,8,211281
4878,0.057997,104.244.42.0-255,66,211107,8,211281
4879,0.062049,172.31.36.0-255,108,211215,8,211281
4880,0.063606,104.244.42.0-255,66,211281,8,211281
4881,0.0,74.125.24.0-255,153,153,8,295661
4882,3.1e-05,172.31.36.0-255,66,219,8,295661
4883,3.9e-05,74.125.24.0-255,1484,1703,8,295661
4884,4.4e-05,172.31.36.0-255,66,1769,8,295661
4885,4.9e-05,74.125.24.0-255,2902,4671,8,295661
4886,5.3e-05,172.31.36.0-255,66,4737,8,295661
4887,5.9e-05,74.125.24.0-255,5738,10475,8,295661
4888,6.3e-05,172.31.36.0-255,66,10541,8,295661
4889,7.8e-05,74.125.24.0-255,1484,12025,8,295661
4890,8e-05,172.31.36.0-255,66,12091,8,295661
4891,8.5e-05,74.125.24.0-255,4320,16411,8,295661
4892,8.7e-05,172.31.36.0-255,66,16477,8,295661
4893,0.000112,74.125.24.0-255,2099,18576,8,295661
4894,0.000115,172.31.36.0-255,66,18642,8,295661
4895,0.000121,74.125.24.0-255,7156,25798,8,295661
4896,0.000123,172.31.36.0-255,66,25864,8,295661
4897,0.000128,74.125.24.0-255,2902,28766,8,295661
4898,0.00013,172.31.36.0-255,66,28832,8,295661
4899,0.000152,74.125.24.0-255,2543,31375,8,295661
4900,0.000155,172.31.36.0-255,66,31441,8,295661
4901,0.000242,74.125.24.0-255,1484,32925,8,295661
4902,0.000246,172.31.36.0-255,66,32991,8,295661
4903,0.000251,74.125.24.0-255,2902,35893,8,295661
4904,0.000254,172.31.36.0-255,66,35959,8,295661
4905,0.000281,74.125.24.0-255,5738,41697,8,295661
4906,0.000285,172.31.36.0-255,66,41763,8,295661
4907,0.000292,74.125.24.0-255,6797,48560,8,295661
4908,0.000294,172.31.36.0-255,66,48626,8,295661
4909,0.000334,74.125.24.0-255,5738,54364,8,295661
4910,0.000341,172.31.36.0-255,66,54430,8,295661
4911,0.000371,172.31.36.0-255,66,54496,8,295661
4912,0.000376,74.125.24.0-255,2823,57319,8,295661
4913,0.000378,172.31.36.0-255,66,57385,8,295661
4914,0.000381,74.125.24.0-255,129,57514,8,295661
4915,0.000503,74.125.24.0-255,1484,58998,8,295661
4916,0.000507,172.31.36.0-255,66,59064,8,295661
4917,0.000525,74.125.24.0-255,1484,60548,8,295661
4918,0.000538,74.125.24.0-255,1484,62032,8,295661
4919,0.000541,172.31.36.0-255,66,62098,8,295661
4920,0.00056,74.125.24.0-255,4320,66418,8,295661
4921,0.000563,172.31.36.0-255,66,66484,8,295661
4922,0.000585,74.125.24.0-255,1484,67968,8,295661
4923,0.000608,74.125.24.0-255,4320,72288,8,295661
4924,0.000612,172.31.36.0-255,66,72354,8,295661
4925,0.000618,74.125.24.0-255,4320,76674,8,295661
4926,0.000621,172.31.36.0-255,66,76740,8,295661
4927,0.000645,172.31.36.0-255,66,76806,8,295661
4928,0.000653,74.125.24.0-255,6797,83603,8,295661
4929,0.000655,172.31.36.0-255,66,83669,8,295661
4930,0.001175,74.125.24.0-255,1484,85153,8,295661
4931,0.001192,74.125.24.0-255,2902,88055,8,295661
4932,0.001195,172.31.36.0-255,66,88121,8,295661
4933,0.00122,74.125.24.0-255,5738,93859,8,295661
4934,0.001223,172.31.36.0-255,66,93925,8,295661
4935,0.00123,74.125.24.0-255,7156,101081,8,295661
4936,0.001232,172.31.36.0-255,66,101147,8,295661
4937,0.001256,74.125.24.0-255,5738,106885,8,295661
4938,0.001258,172.31.36.0-255,66,106951,8,295661
4939,0.001264,74.125.24.0-255,4320,111271,8,295661
4940,0.001266,172.31.36.0-255,66,111337,8,295661
4941,0.001284,74.125.24.0-255,5738,117075,8,295661
4942,0.001287,172.31.36.0-255,66,117141,8,295661
4943,0.001312,74.125.24.0-255,4320,121461,8,295661
4944,0.001314,172.31.36.0-255,66,121527,8,295661
4945,0.001353,172.31.36.0-255,66,121593,8,295661
4946,0.001365,172.31.36.0-255,66,121659,8,295661
4947,0.001437,74.125.24.0-255,1484,123143,8,295661
4948,0.001443,74.125.24.0-255,2902,126045,8,295661
4949,0.001446,172.31.36.0-255,66,126111,8,295661
4950,0.001469,74.125.24.0-255,5738,131849,8,295661
4951,0.001473,172.31.36.0-255,66,131915,8,295661
4952,0.001478,74.125.24.0-255,4320,136235,8,295661
4953,0.00148,172.31.36.0-255,66,136301,8,295661
4954,0.001522,172.31.36.0-255,66,136367,8,295661
4955,0.001528,74.125.24.0-255,7156,143523,8,295661
4956,0.001531,172.31.36.0-255,66,143589,8,295661
4957,0.001557,74.125.24.0-255,7156,150745,8,295661
4958,0.00156,172.31.36.0-255,66,150811,8,295661
4959,0.001578,74.125.24.0-255,6438,157249,8,295661
4960,0.001581,172.31.36.0-255,66,157315,8,295661
4961,0.001594,172.31.36.0-255,66,157381,8,295661
4962,0.001622,74.125.24.0-255,2902,160283,8,295661
4963,0.001625,172.31.36.0-255,66,160349,8,295661
4964,0.001635,172.31.36.0-255,66,160415,8,295661
4965,0.001739,74.125.24.0-255,1484,161899,8,295661
4966,0.001745,74.125.24.0-255,2902,164801,8,295661
4967,0.001749,172.31.36.0-255,66,164867,8,295661
4968,0.001755,74.125.24.0-255,4320,169187,8,295661
4969,0.001757,172.31.36.0-255,66,169253,8,295661
4970,0.001772,74.125.24.0-255,1484,170737,8,295661
4971,0.001775,74.125.24.0-255,1484,172221,8,295661
4972,0.001777,172.31.36.0-255,66,172287,8,295661
4973,0.001816,172.31.36.0-255,66,172353,8,295661
4974,0.00183,172.31.36.0-255,66,172419,8,295661
4975,0.002048,74.125.24.0-255,1484,173903,8,295661
4976,0.002069,74.125.24.0-255,1484,175387,8,295661
4977,0.002072,172.31.36.0-255,66,175453,8,295661
4978,0.002089,74.125.24.0-255,1484,176937,8,295661
4979,0.002095,74.125.24.0-255,5738,182675,8,295661
4980,0.002098,172.31.36.0-255,66,182741,8,295661
4981,0.002117,74.125.24.0-255,4320,187061,8,295661
4982,0.00212,172.31.36.0-255,66,187127,8,295661
4983,0.002134,74.125.24.0-255,5738,192865,8,295661
4984,0.002136,172.31.36.0-255,66,192931,8,295661
4985,0.002159,74.125.24.0-255,5738,198669,8,295661
4986,0.002162,74.125.24.0-255,1484,200153,8,295661
4987,0.00218,74.125.24.0-255,5738,205891,8,295661
4988,0.002213,74.125.24.0-255,5738,211629,8,295661
4989,0.002229,74.125.24.0-255,2184,213813,8,295661
4990,0.002283,74.125.24.0-255,5738,219551,8,295661
4991,0.002303,74.125.24.0-255,7156,226707,8,295661
4992,0.002324,74.125.24.0-255,1484,228191,8,295661
4993,0.00234,74.125.24.0-255,2184,230375,8,295661
4994,0.002394,74.125.24.0-255,1484,231859,8,295661
4995,0.002406,74.125.24.0-255,2902,234761,8,295661
4996,0.002429,74.125.24.0-255,5738,240499,8,295661
4997,0.002432,74.125.24.0-255,1484,241983,8,295661
4998,0.002445,74.125.24.0-255,2902,244885,8,295661
4999,0.002448,74.125.24.0-255,1484,246369,8,295661
5000,0.002487,74.125.24.0-255,5738,252107,8,295661
5001,0.0025,74.125.24.0-255,2184,254291,8,295661
5002,0.002503,74.125.24.0-255,1484,255775,8,295661
5003,0.002525,74.125.24.0-255,7156,262931,8,295661
5004,0.002564,74.125.24.0-255,7156,270087,8,295661
5005,0.002575,74.125.24.0-255,2902,272989,8,295661
5006,0.00259,74.125.24.0-255,7156,280145,8,295661
5007,0.002611,74.125.24.0-255,6549,286694,8,295661
5008,0.007631,172.31.36.0-255,66,286760,8,295661
5009,0.01019,74.125.24.0-255,105,286865,8,295661
5010,0.010261,172.31.36.0-255,66,286931,8,295661
5011,0.010293,172.31.36.0-255,105,287036,8,295661
5012,0.012869,74.125.24.0-255,66,287102,8,295661
5013,0.038431,172.31.36.0-255,172,287274,8,295661
5014,0.038458,172.31.36.0-255,1111,288385,8,295661
5015,0.038513,172.31.36.0-255,1514,289899,8,295661
5016,0.038515,172.31.36.0-255,1514,291413,8,295661
5017,0.038516,172.31.36.0-255,1514,292927,8,295661
5018,0.038517,172.31.36.0-255,1514,294441,8,295661
5019,0.038518,172.31.36.0-255,956,295397,8,295661
5020,0.040011,104.244.42.0-255,66,295463,8,295661
5021,0.040021,104.244.42.0-255,66,295529,8,295661
5022,0.040099,104.244.42.0-255,66,295595,8,295661
5023,0.040105,104.244.42.0-255,66,295661,8,295661
5024,0.0,172.217.194.0-255,153,153,8,198286
5025,1.8e-05,172.31.36.0-255,66,219,8,198286
5026,2.5e-05,172.217.194.0-255,1484,1703,8,198286
5027,3e-05,172.31.36.0-255,66,1769,8,198286
5028,3.6e-05,172.217.194.0-255,2902,4671,8,198286
5029,3.9e-05,172.31.36.0-255,66,4737,8,198286
5030,4.4e-05,172.217.194.0-255,2902,7639,8,198286
5031,4.7e-05,172.31.36.0-255,66,7705,8,198286
5032,6.6e-05,172.217.194.0-255,4320,12025,8,198286
5033,6.9e-05,172.31.36.0-255,66,12091,8,198286
5034,7.5e-05,172.217.194.0-255,4320,16411,8,198286
5035,7.7e-05,172.31.36.0-255,66,16477,8,198286
5036,0.000107,172.217.194.0-255,4882,21359,8,198286
5037,0.000111,172.31.36.0-255,66,21425,8,198286
5038,0.000118,172.217.194.0-255,5738,27163,8,198286
5039,0.00012,172.31.36.0-255,66,27229,8,198286
5040,0.000147,172.217.194.0-255,3961,31190,8,198286
5041,0.000149,172.31.36.0-255,66,31256,8,198286
5042,0.000244,172.217.194.0-255,1484,32740,8,198286
5043,0.000248,172.31.36.0-255,66,32806,8,198286
5044,0.000253,172.217.194.0-255,2902,35708,8,198286
5045,0.000255,172.31.36.0-255,66,35774,8,198286
5046,0.000258,172.217.194.0-255,1484,37258,8,198286
5047,0.000261,172.31.36.0-255,66,37324,8,198286
5048,0.000286,172.217.194.0-255,4320,41644,8,198286
5049,0.000289,172.31.36.0-255,66,41710,8,198286
5050,0.000295,172.217.194.0-255,4320,46030,8,198286
5051,0.000297,172.31.36.0-255,66,46096,8,198286
5052,0.000316,172.217.194.0-255,6797,52893,8,198286
5053,0.000319,172.31.36.0-255,66,52959,8,198286
5054,0.000332,172.31.36.0-255,66,53025,8,198286
5055,0.000335,172.217.194.0-255,1447,54472,8,198286
5056,0.000419,172.217.194.0-255,1484,55956,8,198286
5057,0.000423,172.31.36.0-255,66,56022,8,198286
5058,0.000427,172.217.194.0-255,1484,57506,8,198286
5059,0.000446,172.217.194.0-255,1484,58990,8,198286
5060,0.000448,172.31.36.0-255,66,59056,8,198286
5061,0.000455,172.217.194.0-255,5738,64794,8,198286
5062,0.000457,172.31.36.0-255,66,64860,8,198286
5063,0.000464,172.217.194.0-255,5738,70598,8,198286
5064,0.000466,172.31.36.0-255,66,70664,8,198286
5065,0.000499,172.31.36.0-255,66,70730,8,198286
5066,0.000504,172.217.194.0-255,3961,74691,8,198286
5067,0.000506,172.31.36.0-255,66,74757,8,198286
5068,0.000523,172.217.194.0-255,363,75120,8,198286
5069,0.000682,172.217.194.0-255,1484,76604,8,198286
5070,0.000687,172.31.36.0-255,66,76670,8,198286
5071,0.000693,172.217.194.0-255,2902,79572,8,198286
5072,0.000695,172.31.36.0-255,66,79638,8,198286
5073,0.000728,172.217.194.0-255,5738,85376,8,198286
5074,0.000731,172.31.36.0-255,66,85442,8,198286
5075,0.000767,172.31.36.0-255,66,85508,8,198286
5076,0.00078,172.31.36.0-255,66,85574,8,198286
5077,0.000832,172.217.194.0-255,1484,87058,8,198286
5078,0.000837,172.217.194.0-255,2902,89960,8,198286
5079,0.00084,172.31.36.0-255,66,90026,8,198286
5080,0.000847,172.217.194.0-255,5738,95764,8,198286
5081,0.000849,172.31.36.0-255,66,95830,8,198286
5082,0.000875,172.31.36.0-255,66,95896,8,198286
5083,0.000905,172.217.194.0-255,4320,100216,8,198286
5084,0.000908,172.31.36.0-255,66,100282,8,198286
5085,0.00092,172.217.194.0-255,766,101048,8,198286
5086,0.000923,172.31.36.0-255,66,101114,8,198286
5087,0.000944,172.217.194.0-255,1484,102598,8,198286
5088,0.000947,172.217.194.0-255,1484,104082,8,198286
5089,0.000957,172.217.194.0-255,1484,105566,8,198286
5090,0.000963,172.217.194.0-255,5738,111304,8,198286
5091,0.000978,172.31.36.0-255,66,111370,8,198286
5092,0.000989,172.217.194.0-255,5738,117108,8,198286
5093,0.000993,172.31.36.0-255,66,117174,8,198286
5094,0.001013,172.217.194.0-255,7156,124330,8,198286
5095,0.001017,172.217.194.0-255,2902,127232,8,198286
5096,0.001027,172.31.36.0-255,66,127298,8,198286
5097,0.001045,172.31.36.0-255,66,127364,8,198286
5098,0.001056,172.217.194.0-255,1484,128848,8,198286
5099,0.001072,172.217.194.0-255,2902,131750,8,198286
5100,0.001077,172.217.194.0-255,2902,134652,8,198286
5101,0.001092,172.217.194.0-255,2902,137554,8,198286
5102,0.001095,172.31.36.0-255,66,137620,8,198286
5103,0.0011,172.31.36.0-255,66,137686,8,198286
5104,0.001133,172.217.194.0-255,7156,144842,8,198286
5105,0.00114,172.31.36.0-255,66,144908,8,198286
5106,0.001157,172.217.194.0-255,2902,147810,8,198286
5107,0.00116,172.217.194.0-255,766,148576,8,198286
5108,0.001175,172.31.36.0-255,66,148642,8,198286
5109,0.001192,172.217.194.0-255,1484,150126,8,198286
5110,0.001196,172.217.194.0-255,1484,151610,8,198286
5111,0.00121,172.31.36.0-255,66,151676,8,198286
5112,0.001215,172.217.194.0-255,2902,154578,8,198286
5113,0.001222,172.217.194.0-255,7156,161734,8,198286
5114,0.001227,172.31.36.0-255,66,161800,8,198286
5115,0.001241,172.217.194.0-255,2902,164702,8,198286
5116,0.001273,172.217.194.0-255,7156,171858,8,198286
5117,0.001279,172.217.194.0-255,4320,176178,8,198286
5118,0.00129,172.31.36.0-255,66,176244,8,198286
5119,0.001329,172.217.194.0-255,5738,181982,8,198286
5120,0.001338,172.31.36.0-255,66,182048,8,198286
5121,0.001356,172.217.194.0-255,4320,186368,8,198286
5122,0.001363,172.31.36.0-255,66,186434,8,198286
5123,0.001493,172.31.36.0-255,66,186500,8,198286
5124,0.001496,172.217.194.0-255,1484,187984,8,198286
5125,0.001512,172.31.36.0-255,66,188050,8,198286
5126,0.001569,172.31.36.0-255,66,188116,8,198286
5127,0.001602,172.217.194.0-255,5548,193664,8,198286
5128,0.001605,172.217.194.0-255,105,193769,8,198286
5129,0.001621,172.31.36.0-255,66,193835,8,198286
5130,0.004318,172.31.36.0-255,105,193940,8,198286
5131,0.006642,172.217.194.0-255,66,194006,8,198286
5132,0.031238,172.31.36.0-255,164,194170,8,198286
5133,0.031271,172.31.36.0-255,1121,195291,8,198286
5134,0.031333,172.31.36.0-255,1514,196805,8,198286
5135,0.031335,172.31.36.0-255,1283,198088,8,198286
5136,0.032787,104.244.42.0-255,66,198154,8,198286
5137,0.032851,104.244.42.0-255,66,198220,8,198286
5138,0.032902,104.244.42.0-255,66,198286,8,198286
5139,0.0,74.125.24.0-255,153,153,8,290973
5140,2.9e-05,172.31.36.0-255,66,219,8,290973
5141,3.5e-05,74.125.24.0-255,1484,1703,8,290973
5142,4e-05,172.31.36.0-255,66,1769,8,290973
5143,7e-05,74.125.24.0-255,2902,4671,8,290973
5144,7.3e-05,172.31.36.0-255,66,4737,8,290973
5145,7.6e-05,74.125.24.0-255,1484,6221,8,290973
5146,8e-05,172.31.36.0-255,66,6287,8,290973
5147,8.3e-05,74.125.24.0-255,5738,12025,8,290973
5148,8.6e-05,172.31.36.0-255,66,12091,8,290973
5149,0.000122,74.125.24.0-255,1987,14078,8,290973
5150,0.000125,172.31.36.0-255,66,14144,8,290973
5151,0.000231,74.125.24.0-255,1484,15628,8,290973
5152,0.000236,172.31.36.0-255,66,15694,8,290973
5153,0.000242,74.125.24.0-255,2902,18596,8,290973
5154,0.000245,172.31.36.0-255,66,18662,8,290973
5155,0.000261,74.125.24.0-255,1484,20146,8,290973
5156,0.000264,172.31.36.0-255,66,20212,8,290973
5157,0.000288,74.125.24.0-255,1484,21696,8,290973
5158,0.000291,172.31.36.0-255,66,21762,8,290973
5159,0.000298,74.125.24.0-255,4320,26082,8,290973
5160,0.000301,172.31.36.0-255,66,26148,8,290973
5161,0.000306,74.125.24.0-255,4320,30468,8,290973
5162,0.00031,172.31.36.0-255,66,30534,8,290973
5163,0.000342,74.125.24.0-255,5379,35913,8,290973
5164,0.000347,172.31.36.0-255,66,35979,8,290973
5165,0.000354,172.31.36.0-255,66,36045,8,290973
5166,0.000377,74.125.24.0-255,2902,38947,8,290973
5167,0.000383,172.31.36.0-255,66,39013,8,290973
5168,0.000415,172.31.36.0-255,66,39079,8,290973
5169,0.000418,74.125.24.0-255,425,39504,8,290973
5170,0.000826,172.31.36.0-255,66,39570,8,290973
5171,0.001307,74.125.24.0-255,1484,41054,8,290973
5172,0.001317,74.125.24.0-255,2902,43956,8,290973
5173,0.001322,172.31.36.0-255,66,44022,8,290973
5174,0.001329,74.125.24.0-255,4320,48342,8,290973
5175,0.001331,172.31.36.0-255,66,48408,8,290973
5176,0.001355,74.125.24.0-255,1484,49892,8,290973
5177,0.00136,74.125.24.0-255,4320,54212,8,290973
5178,0.001363,172.31.36.0-255,66,54278,8,290973
5179,0.001411,172.31.36.0-255,66,54344,8,290973
5180,0.001416,74.125.24.0-255,2902,57246,8,290973
5181,0.001418,172.31.36.0-255,66,57312,8,290973
5182,0.001444,74.125.24.0-255,2902,60214,8,290973
5183,0.001446,172.31.36.0-255,66,60280,8,290973
5184,0.001463,74.125.24.0-255,2184,62464,8,290973
5185,0.001465,172.31.36.0-255,66,62530,8,290973
5186,0.001674,74.125.24.0-255,349,62879,8,290973
5187,0.001704,74.125.24.0-255,1484,64363,8,290973
5188,0.001706,172.31.36.0-255,66,64429,8,290973
5189,0.001722,74.125.24.0-255,4320,68749,8,290973
5190,0.001725,172.31.36.0-255,66,68815,8,290973
5191,0.001753,172.31.36.0-255,66,68881,8,290973
5192,0.001775,74.125.24.0-255,1484,70365,8,290973
5193,0.001797,172.31.36.0-255,66,70431,8,290973
5194,0.001802,74.125.24.0-255,2902,73333,8,290973
5195,0.001804,172.31.36.0-255,66,73399,8,290973
5196,0.001819,74.125.24.0-255,3602,77001,8,290973
5197,0.001821,172.31.36.0-255,66,77067,8,290973
5198,0.001976,74.125.24.0-255,1484,78551,8,290973
5199,0.001991,74.125.24.0-255,2902,81453,8,290973
5200,0.001993,172.31.36.0-255,66,81519,8,290973
5201,0.001999,74.125.24.0-255,4320,85839,8,290973
5202,0.002001,172.31.36.0-255,66,85905,8,290973
5203,0.002013,74.125.24.0-255,1484,87389,8,290973
5204,0.002018,74.125.24.0-255,4320,91709,8,290973
5205,0.00202,172.31.36.0-255,66,91775,8,290973
5206,0.002037,74.125.24.0-255,2902,94677,8,290973
5207,0.00204,172.31.36.0-255,66,94743,8,290973
5208,0.002054,172.31.36.0-255,66,94809,8,290973
5209,0.002057,74.125.24.0-255,2184,96993,8,290973
5210,0.00206,172.31.36.0-255,66,97059,8,290973
5211,0.002201,74.125.24.0-255,1484,98543,8,290973
5212,0.002219,74.125.24.0-255,2902,101445,8,290973
5213,0.002221,172.31.36.0-255,66,101511,8,290973
5214,0.002224,74.125.24.0-255,1484,102995,8,290973
5215,0.002242,74.125.24.0-255,4320,107315,8,290973
5216,0.002244,172.31.36.0-255,66,107381,8,290973
5217,0.002267,74.125.24.0-255,5738,113119,8,290973
5218,0.002269,172.31.36.0-255,66,113185,8,290973
5219,0.002294,74.125.24.0-255,7156,120341,8,290973
5220,0.002296,172.31.36.0-255,66,120407,8,290973
5221,0.002334,172.31.36.0-255,66,120473,8,290973
5222,0.004654,74.125.24.0-255,5738,126211,8,290973
5223,0.004658,172.31.36.0-255,66,126277,8,290973
5224,0.006982,74.125.24.0-255,5738,132015,8,290973
5225,0.006989,172.31.36.0-255,66,132081,8,290973
5226,0.009278,74.125.24.0-255,5738,137819,8,290973
5227,0.009285,172.31.36.0-255,66,137885,8,290973
5228,0.01161,74.125.24.0-255,5738,143623,8,290973
5229,0.011618,172.31.36.0-255,66,143689,8,290973
5230,0.013896,74.125.24.0-255,5738,149427,8,290973
5231,0.013904,172.31.36.0-255,66,149493,8,290973
5232,0.016246,74.125.24.0-255,5738,155231,8,290973
5233,0.016255,172.31.36.0-255,66,155297,8,290973
5234,0.018628,74.125.24.0-255,5738,161035,8,290973
5235,0.018635,172.31.36.0-255,66,161101,8,290973
5236,0.020955,74.125.24.0-255,5738,166839,8,290973
5237,0.020965,172.31.36.0-255,66,166905,8,290973
5238,0.023276,74.125.24.0-255,5738,172643,8,290973
5239,0.023282,172.31.36.0-255,66,172709,8,290973
5240,0.025588,74.125.24.0-255,5738,178447,8,290973
5241,0.025594,172.31.36.0-255,66,178513,8,290973
5242,0.027879,74.125.24.0-255,5738,184251,8,290973
5243,0.027886,172.31.36.0-255,66,184317,8,290973
5244,0.03018,74.125.24.0-255,4320,188637,8,290973
5245,0.030186,172.31.36.0-255,66,188703,8,290973
5246,0.030208,74.125.24.0-255,1484,190187,8,290973
5247,0.032518,74.125.24.0-255,4320,194507,8,290973
5248,0.032527,172.31.36.0-255,66,194573,8,290973
5249,0.034109,172.31.36.0-255,172,194745,8,290973
5250,0.03414,172.31.36.0-255,1111,195856,8,290973
5251,0.034195,172.31.36.0-255,1514,197370,8,290973
5252,0.034197,172.31.36.0-255,1514,198884,8,290973
5253,0.034202,172.31.36.0-255,1514,200398,8,290973
5254,0.034203,172.31.36.0-255,1514,201912,8,290973
5255,0.034222,172.31.36.0-255,1275,203187,8,290973
5256,0.034845,74.125.24.0-255,5738,208925,8,290973
5257,0.034852,172.31.36.0-255,66,208991,8,290973
5258,0.035656,104.244.42.0-255,66,209057,8,290973
5259,0.035717,104.244.42.0-255,66,209123,8,290973
5260,0.035742,104.244.42.0-255,66,209189,8,290973
5261,0.035764,104.244.42.0-255,66,209255,8,290973
5262,0.035768,104.244.42.0-255,66,209321,8,290973
5263,0.037147,74.125.24.0-255,5738,215059,8,290973
5264,0.037153,172.31.36.0-255,66,215125,8,290973
5265,0.039458,74.125.24.0-255,4320,219445,8,290973
5266,0.039464,172.31.36.0-255,66,219511,8,290973
5267,0.039488,74.125.24.0-255,1484,220995,8,290973
5268,0.041734,74.125.24.0-255,4320,225315,8,290973
5269,0.04174,172.31.36.0-255,66,225381,8,290973
5270,0.044012,74.125.24.0-255,5738,231119,8,290973
5271,0.044018,172.31.36.0-255,66,231185,8,290973
5272,0.046342,74.125.24.0-255,5738,236923,8,290973
5273,0.046347,172.31.36.0-255,66,236989,8,290973
5274,0.048612,74.125.24.0-255,5738,242727,8,290973
5275,0.048617,172.31.36.0-255,66,242793,8,290973
5276,0.050956,74.125.24.0-255,5738,248531,8,290973
5277,0.050963,172.31.36.0-255,66,248597,8,290973
5278,0.053301,74.125.24.0-255,5738,254335,8,290973
5279,0.053305,172.31.36.0-255,66,254401,8,290973
5280,0.055588,74.125.24.0-255,4320,258721,8,290973
5281,0.055594,172.31.36.0-255,66,258787,8,290973
5282,0.055611,74.125.24.0-255,1484,260271,8,290973
5283,0.057902,74.125.24.0-255,2902,263173,8,290973
5284,0.057907,172.31.36.0-255,66,263239,8,290973
5285,0.060211,74.125.24.0-255,5738,268977,8,290973
5286,0.060217,172.31.36.0-255,66,269043,8,290973
5287,0.062517,74.125.24.0-255,5738,274781,8,290973
5288,0.062525,172.31.36.0-255,66,274847,8,290973
5289,0.064833,74.125.24.0-255,4320,279167,8,290973
5290,0.064839,172.31.36.0-255,66,279233,8,290973
5291,0.064866,74.125.24.0-255,1484,280717,8,290973
5292,0.067192,74.125.24.0-255,4320,285037,8,290973
5293,0.067197,172.31.36.0-255,66,285103,8,290973
5294,0.069454,74.125.24.0-255,4320,289423,8,290973
5295,0.069461,172.31.36.0-255,66,289489,8,290973
5296,0.069489,74.125.24.0-255,1484,290973,8,290973
5297,0.0,74.125.24.0-255,297,297,8,269355
5298,2.4e-05,172.31.36.0-255,66,363,8,269355
5299,3.1e-05,74.125.24.0-255,1484,1847,8,269355
5300,3.5e-05,172.31.36.0-255,66,1913,8,269355
5301,4.2e-05,74.125.24.0-255,4320,6233,8,269355
5302,4.7e-05,172.31.36.0-255,66,6299,8,269355
5303,6e-05,172.31.36.0-255,66,6365,8,269355
5304,9.4e-05,172.31.36.0-255,66,6431,8,269355
5305,0.000119,74.125.24.0-255,5379,11810,8,269355
5306,0.000121,172.31.36.0-255,66,11876,8,269355
5307,0.000215,74.125.24.0-255,1484,13360,8,269355
5308,0.000219,172.31.36.0-255,66,13426,8,269355
5309,0.000224,74.125.24.0-255,2902,16328,8,269355
5310,0.000226,172.31.36.0-255,66,16394,8,269355
5311,0.000233,74.125.24.0-255,5738,22132,8,269355
5312,0.000236,172.31.36.0-255,66,22198,8,269355
5313,0.000271,74.125.24.0-255,5738,27936,8,269355
5314,0.000275,172.31.36.0-255,66,28002,8,269355
5315,0.000301,172.31.36.0-255,66,28068,8,269355
5316,0.000304,74.125.24.0-255,1484,29552,8,269355
5317,0.000306,172.31.36.0-255,66,29618,8,269355
5318,0.00033,172.31.36.0-255,66,29684,8,269355
5319,0.000343,74.125.24.0-255,395,30079,8,269355
5320,0.000345,172.31.36.0-255,66,30145,8,269355
5321,0.000732,74.125.24.0-255,1484,31629,8,269355
5322,0.000737,172.31.36.0-255,66,31695,8,269355
5323,0.000743,74.125.24.0-255,2902,34597,8,269355
5324,0.000745,172.31.36.0-255,66,34663,8,269355
5325,0.000751,74.125.24.0-255,2902,37565,8,269355
5326,0.000754,172.31.36.0-255,66,37631,8,269355
5327,0.00078,74.125.24.0-255,2902,40533,8,269355
5328,0.000782,172.31.36.0-255,66,40599,8,269355
5329,0.000797,172.31.36.0-255,66,40665,8,269355
5330,0.000809,172.31.36.0-255,66,40731,8,269355
5331,0.000826,74.125.24.0-255,1125,41856,8,269355
5332,0.000877,74.125.24.0-255,1484,43340,8,269355
5333,0.000881,172.31.36.0-255,66,43406,8,269355
5334,0.000897,74.125.24.0-255,2902,46308,8,269355
5335,0.000899,172.31.36.0-255,66,46374,8,269355
5336,0.000906,74.125.24.0-255,5738,52112,8,269355
5337,0.000908,172.31.36.0-255,66,52178,8,269355
5338,0.00093,74.125.24.0-255,7156,59334,8,269355
5339,0.000933,172.31.36.0-255,66,59400,8,269355
5340,0.000953,74.125.24.0-255,5738,65138,8,269355
5341,0.000956,172.31.36.0-255,66,65204,8,269355
5342,0.000969,172.31.36.0-255,66,65270,8,269355
5343,0.000971,74.125.24.0-255,766,66036,8,269355
5344,0.001017,74.125.24.0-255,1484,67520,8,269355
5345,0.001054,74.125.24.0-255,2902,70422,8,269355
5346,0.001058,172.31.36.0-255,66,70488,8,269355
5347,0.001062,172.31.36.0-255,66,70554,8,269355
5348,0.001071,74.125.24.0-255,1484,72038,8,269355
5349,0.001077,74.125.24.0-255,5738,77776,8,269355
5350,0.001084,74.125.24.0-255,7156,84932,8,269355
5351,0.001087,74.125.24.0-255,2902,87834,8,269355
5352,0.001092,172.31.36.0-255,66,87900,8,269355
5353,0.001095,172.31.36.0-255,66,87966,8,269355
5354,0.001104,172.31.36.0-255,66,88032,8,269355
5355,0.001118,172.31.36.0-255,66,88098,8,269355
5356,0.001143,74.125.24.0-255,2184,90282,8,269355
5357,0.001147,172.31.36.0-255,66,90348,8,269355
5358,0.00135,74.125.24.0-255,1484,91832,8,269355
5359,0.001356,74.125.24.0-255,2902,94734,8,269355
5360,0.001359,172.31.36.0-255,66,94800,8,269355
5361,0.001377,74.125.24.0-255,5738,100538,8,269355
5362,0.001379,172.31.36.0-255,66,100604,8,269355
5363,0.001397,74.125.24.0-255,1484,102088,8,269355
5364,0.001413,74.125.24.0-255,7156,109244,8,269355
5365,0.001416,172.31.36.0-255,66,109310,8,269355
5366,0.001421,74.125.24.0-255,2902,112212,8,269355
5367,0.001423,172.31.36.0-255,66,112278,8,269355
5368,0.001441,74.125.24.0-255,7156,119434,8,269355
5369,0.001444,172.31.36.0-255,66,119500,8,269355
5370,0.00145,74.125.24.0-255,5020,124520,8,269355
5371,0.001453,172.31.36.0-255,66,124586,8,269355
5372,0.001759,74.125.24.0-255,1484,126070,8,269355
5373,0.001765,74.125.24.0-255,2902,128972,8,269355
5374,0.001768,172.31.36.0-255,66,129038,8,269355
5375,0.001786,74.125.24.0-255,4320,133358,8,269355
5376,0.001789,172.31.36.0-255,66,133424,8,269355
5377,0.001813,74.125.24.0-255,1484,134908,8,269355
5378,0.001819,74.125.24.0-255,4320,139228,8,269355
5379,0.001821,172.31.36.0-255,66,139294,8,269355
5380,0.001828,74.125.24.0-255,5738,145032,8,269355
5381,0.001831,172.31.36.0-255,66,145098,8,269355
5382,0.001846,74.125.24.0-255,5738,150836,8,269355
5383,0.001848,172.31.36.0-255,66,150902,8,269355
5384,0.00186,172.31.36.0-255,66,150968,8,269355
5385,0.001888,74.125.24.0-255,4320,155288,8,269355
5386,0.001891,172.31.36.0-255,66,155354,8,269355
5387,0.001912,74.125.24.0-255,4320,159674,8,269355
5388,0.001915,172.31.36.0-255,66,159740,8,269355
5389,0.001919,74.125.24.0-255,2902,162642,8,269355
5390,0.001921,172.31.36.0-255,66,162708,8,269355
5391,0.001934,74.125.24.0-255,1484,164192,8,269355
5392,0.001959,74.125.24.0-255,2902,167094,8,269355
5393,0.001962,172.31.36.0-255,66,167160,8,269355
5394,0.001991,172.31.36.0-255,66,167226,8,269355
5395,0.002013,74.125.24.0-255,6438,173664,8,269355
5396,0.002016,172.31.36.0-255,66,173730,8,269355
5397,0.002037,74.125.24.0-255,7156,180886,8,269355
5398,0.00204,172.31.36.0-255,66,180952,8,269355
5399,0.002073,74.125.24.0-255,7156,188108,8,269355
5400,0.002077,172.31.36.0-255,66,188174,8,269355
5401,0.002105,74.125.24.0-255,4320,192494,8,269355
5402,0.002108,172.31.36.0-255,66,192560,8,269355
5403,0.002137,172.31.36.0-255,66,192626,8,269355
5404,0.00214,74.125.24.0-255,1484,194110,8,269355
5405,0.002155,74.125.24.0-255,1484,195594,8,269355
5406,0.002157,172.31.36.0-255,66,195660,8,269355
5407,0.002183,74.125.24.0-255,3602,199262,8,269355
5408,0.002185,172.31.36.0-255,66,199328,8,269355
5409,0.002215,74.125.24.0-255,4320,203648,8,269355
5410,0.002218,172.31.36.0-255,66,203714,8,269355
5411,0.002223,74.125.24.0-255,2902,206616,8,269355
5412,0.002225,172.31.36.0-255,66,206682,8,269355
5413,0.002235,172.31.36.0-255,66,206748,8,269355
5414,0.00226,74.125.24.0-255,1484,208232,8,269355
5415,0.002265,74.125.24.0-255,2902,211134,8,269355
5416,0.002267,172.31.36.0-255,66,211200,8,269355
5417,0.002332,74.125.24.0-255,1484,212684,8,269355
5418,0.002336,74.125.24.0-255,2902,215586,8,269355
5419,0.002339,172.31.36.0-255,66,215652,8,269355
5420,0.002346,74.125.24.0-255,5738,221390,8,269355
5421,0.002348,172.31.36.0-255,66,221456,8,269355
5422,0.002354,74.125.24.0-255,3602,225058,8,269355
5423,0.002356,172.31.36.0-255,66,225124,8,269355
5424,0.00236,74.125.24.0-255,4320,229444,8,269355
5425,0.002363,172.31.36.0-255,66,229510,8,269355
5426,0.002394,172.31.36.0-255,66,229576,8,269355
5427,0.002423,172.31.36.0-255,66,229642,8,269355
5428,0.002429,74.125.24.0-255,5738,235380,8,269355
5429,0.002432,172.31.36.0-255,66,235446,8,269355
5430,0.002451,74.125.24.0-255,4320,239766,8,269355
5431,0.002454,172.31.36.0-255,66,239832,8,269355
5432,0.002456,74.125.24.0-255,766,240598,8,269355
5433,0.002459,74.125.24.0-255,1484,242082,8,269355
5434,0.002461,172.31.36.0-255,66,242148,8,269355
5435,0.002467,74.125.24.0-255,4320,246468,8,269355
5436,0.00247,172.31.36.0-255,66,246534,8,269355
5437,0.002492,74.125.24.0-255,7156,253690,8,269355
5438,0.002495,172.31.36.0-255,66,253756,8,269355
5439,0.002521,74.125.24.0-255,2902,256658,8,269355
5440,0.002523,172.31.36.0-255,66,256724,8,269355
5441,0.002535,172.31.36.0-255,66,256790,8,269355
5442,0.00256,74.125.24.0-255,4320,261110,8,269355
5443,0.002563,172.31.36.0-255,66,261176,8,269355
5444,0.002594,172.31.36.0-255,66,261242,8,269355
5445,0.002618,74.125.24.0-255,105,261347,8,269355
5446,0.009015,172.31.36.0-255,66,261413,8,269355
5447,0.009064,172.31.36.0-255,105,261518,8,269355
5448,0.011101,74.125.24.0-255,66,261584,8,269355
5449,0.038783,172.31.36.0-255,172,261756,8,269355
5450,0.038817,172.31.36.0-255,1112,262868,8,269355
5451,0.038886,172.31.36.0-255,1514,264382,8,269355
5452,0.038888,172.31.36.0-255,1514,265896,8,269355
5453,0.038894,172.31.36.0-255,1514,267410,8,269355
5454,0.038895,172.31.36.0-255,1514,268924,8,269355
5455,0.038913,172.31.36.0-255,167,269091,8,269355
5456,0.040328,104.244.42.0-255,66,269157,8,269355
5457,0.040374,104.244.42.0-255,66,269223,8,269355
5458,0.040474,104.244.42.0-255,66,269289,8,269355
5459,0.040481,104.244.42.0-255,66,269355,8,269355
5460,0.0,172.217.194.0-255,146,146,8,192272
5461,2.3e-05,172.31.36.0-255,66,212,8,192272
5462,3.1e-05,172.217.194.0-255,1484,1696,8,192272
5463,3.5e-05,172.31.36.0-255,66,1762,8,192272
5464,4e-05,172.217.194.0-255,2902,4664,8,192272
5465,5.1e-05,172.31.36.0-255,66,4730,8,192272
5466,5.9e-05,172.217.194.0-255,7156,11886,8,192272
5467,6.2e-05,172.31.36.0-255,66,11952,8,192272
5468,6.7e-05,172.217.194.0-255,2040,13992,8,192272
5469,7e-05,172.31.36.0-255,66,14058,8,192272
5470,0.000338,172.217.194.0-255,1484,15542,8,192272
5471,0.000344,172.31.36.0-255,66,15608,8,192272
5472,0.000351,172.217.194.0-255,2902,18510,8,192272
5473,0.000354,172.31.36.0-255,66,18576,8,192272
5474,0.000366,172.217.194.0-255,5738,24314,8,192272
5475,0.000369,172.31.36.0-255,66,24380,8,192272
5476,0.000409,172.217.194.0-255,6797,31177,8,192272
5477,0.000412,172.31.36.0-255,66,31243,8,192272
5478,0.000498,172.217.194.0-255,1484,32727,8,192272
5479,0.000502,172.31.36.0-255,66,32793,8,192272
5480,0.000508,172.217.194.0-255,2902,35695,8,192272
5481,0.00051,172.31.36.0-255,66,35761,8,192272
5482,0.000513,172.217.194.0-255,1484,37245,8,192272
5483,0.00052,172.31.36.0-255,66,37311,8,192272
5484,0.000547,172.217.194.0-255,4320,41631,8,192272
5485,0.00055,172.31.36.0-255,66,41697,8,192272
5486,0.000577,172.31.36.0-255,66,41763,8,192272
5487,0.000615,172.217.194.0-255,5379,47142,8,192272
5488,0.000618,172.31.36.0-255,66,47208,8,192272
5489,0.00063,172.31.36.0-255,66,47274,8,192272
5490,0.000634,172.217.194.0-255,393,47667,8,192272
5491,0.000637,172.217.194.0-255,381,48048,8,192272
5492,0.000983,172.217.194.0-255,1484,49532,8,192272
5493,0.000987,172.31.36.0-255,66,49598,8,192272
5494,0.000993,172.217.194.0-255,2902,52500,8,192272
5495,0.000995,172.31.36.0-255,66,52566,8,192272
5496,0.001006,172.217.194.0-255,5738,58304,8,192272
5497,0.001009,172.31.36.0-255,66,58370,8,192272
5498,0.001012,172.217.194.0-255,1484,59854,8,192272
5499,0.001052,172.31.36.0-255,66,59920,8,192272
5500,0.001071,172.217.194.0-255,2902,62822,8,192272
5501,0.001074,172.31.36.0-255,66,62888,8,192272
5502,0.001108,172.31.36.0-255,66,62954,8,192272
5503,0.001334,172.217.194.0-255,1484,64438,8,192272
5504,0.00134,172.217.194.0-255,2902,67340,8,192272
5505,0.001343,172.31.36.0-255,66,67406,8,192272
5506,0.001351,172.217.194.0-255,5738,73144,8,192272
5507,0.001353,172.31.36.0-255,66,73210,8,192272
5508,0.001376,172.217.194.0-255,1484,74694,8,192272
5509,0.001406,172.31.36.0-255,66,74760,8,192272
5510,0.00143,172.217.194.0-255,2902,77662,8,192272
5511,0.001433,172.31.36.0-255,66,77728,8,192272
5512,0.001468,172.31.36.0-255,66,77794,8,192272
5513,0.002067,172.217.194.0-255,1484,79278,8,192272
5514,0.002077,172.217.194.0-255,2902,82180,8,192272
5515,0.002081,172.31.36.0-255,66,82246,8,192272
5516,0.002103,172.217.194.0-255,4320,86566,8,192272
5517,0.002105,172.31.36.0-255,66,86632,8,192272
5518,0.00211,172.217.194.0-255,2902,89534,8,192272
5519,0.002112,172.31.36.0-255,66,89600,8,192272
5520,0.002135,172.217.194.0-255,2902,92502,8,192272
5521,0.002138,172.31.36.0-255,66,92568,8,192272
5522,0.002151,172.31.36.0-255,66,92634,8,192272
5523,0.002158,172.217.194.0-255,5738,98372,8,192272
5524,0.00216,172.31.36.0-255,66,98438,8,192272
5525,0.002191,172.217.194.0-255,2184,100622,8,192272
5526,0.002194,172.31.36.0-255,66,100688,8,192272
5527,0.002601,172.217.194.0-255,1484,102172,8,192272
5528,0.00261,172.217.194.0-255,2902,105074,8,192272
5529,0.002614,172.31.36.0-255,66,105140,8,192272
5530,0.002618,172.217.194.0-255,1484,106624,8,192272
5531,0.002645,172.31.36.0-255,66,106690,8,192272
5532,0.002671,172.217.194.0-255,4320,111010,8,192272
5533,0.002673,172.31.36.0-255,66,111076,8,192272
5534,0.002714,172.31.36.0-255,66,111142,8,192272
5535,0.00272,172.217.194.0-255,3602,114744,8,192272
5536,0.002722,172.31.36.0-255,66,114810,8,192272
5537,0.002731,172.217.194.0-255,2902,117712,8,192272
5538,0.002734,172.31.36.0-255,66,117778,8,192272
5539,0.002758,172.217.194.0-255,1484,119262,8,192272
5540,0.002766,172.217.194.0-255,4320,123582,8,192272
5541,0.002769,172.31.36.0-255,66,123648,8,192272
5542,0.002795,172.217.194.0-255,4320,127968,8,192272
5543,0.002798,172.31.36.0-255,66,128034,8,192272
5544,0.002809,172.31.36.0-255,66,128100,8,192272
5545,0.002822,172.31.36.0-255,66,128166,8,192272
5546,0.002854,172.217.194.0-255,2184,130350,8,192272
5547,0.002856,172.31.36.0-255,66,130416,8,192272
5548,0.003091,172.217.194.0-255,1484,131900,8,192272
5549,0.003108,172.217.194.0-255,2902,134802,8,192272
5550,0.003112,172.31.36.0-255,66,134868,8,192272
5551,0.003119,172.217.194.0-255,5738,140606,8,192272
5552,0.003123,172.31.36.0-255,66,140672,8,192272
5553,0.003148,172.31.36.0-255,66,140738,8,192272
5554,0.003155,172.217.194.0-255,5738,146476,8,192272
5555,0.003158,172.31.36.0-255,66,146542,8,192272
5556,0.003163,172.217.194.0-255,2902,149444,8,192272
5557,0.003165,172.31.36.0-255,66,149510,8,192272
5558,0.003196,172.217.194.0-255,2184,151694,8,192272
5559,0.0032,172.31.36.0-255,66,151760,8,192272
5560,0.003226,172.217.194.0-255,5738,157498,8,192272
5561,0.003229,172.31.36.0-255,66,157564,8,192272
5562,0.003232,172.217.194.0-255,1484,159048,8,192272
5563,0.00327,172.217.194.0-255,5738,164786,8,192272
5564,0.003273,172.31.36.0-255,66,164852,8,192272
5565,0.0033,172.217.194.0-255,2902,167754,8,192272
5566,0.003303,172.31.36.0-255,66,167820,8,192272
5567,0.003321,172.31.36.0-255,66,167886,8,192272
5568,0.003333,172.31.36.0-255,66,167952,8,192272
5569,0.003362,172.31.36.0-255,66,168018,8,192272
5570,0.003405,172.31.36.0-255,66,168084,8,192272
5571,0.003423,172.31.36.0-255,66,168150,8,192272
5572,0.003437,172.31.36.0-255,66,168216,8,192272
5573,0.003474,172.217.194.0-255,2184,170400,8,192272
5574,0.003477,172.31.36.0-255,66,170466,8,192272
5575,0.003483,172.217.194.0-255,5738,176204,8,192272
5576,0.003486,172.31.36.0-255,66,176270,8,192272
5577,0.003499,172.31.36.0-255,66,176336,8,192272
5578,0.003502,172.217.194.0-255,1484,177820,8,192272
5579,0.003505,172.31.36.0-255,78,177898,8,192272
5580,0.003522,172.31.36.0-255,66,177964,8,192272
5581,0.003527,172.217.194.0-255,3602,181566,8,192272
5582,0.003529,172.31.36.0-255,66,181632,8,192272
5583,0.003542,172.31.36.0-255,66,181698,8,192272
5584,0.003545,172.217.194.0-255,105,181803,8,192272
5585,0.011443,172.31.36.0-255,66,181869,8,192272
5586,0.011484,172.31.36.0-255,105,181974,8,192272
5587,0.013518,172.217.194.0-255,66,182040,8,192272
5588,0.038158,172.31.36.0-255,172,182212,8,192272
5589,0.03819,172.31.36.0-255,1110,183322,8,192272
5590,0.038245,172.31.36.0-255,1514,184836,8,192272
5591,0.038247,172.31.36.0-255,1514,186350,8,192272
5592,0.038252,172.31.36.0-255,1514,187864,8,192272
5593,0.038254,172.31.36.0-255,1514,189378,8,192272
5594,0.038277,172.31.36.0-255,1514,190892,8,192272
5595,0.038278,172.31.36.0-255,876,191768,8,192272
5596,0.039717,104.244.42.0-255,66,191834,8,192272
5597,0.039962,104.244.42.0-255,66,191900,8,192272
5598,0.040007,104.244.42.0-255,66,191966,8,192272
5599,0.040013,104.244.42.0-255,66,192032,8,192272
5600,0.040062,104.244.42.0-255,66,192098,8,192272
5601,0.050455,172.31.36.0-255,108,192206,8,192272
5602,0.051988,104.244.42.0-255,66,192272,8,192272
5603,0.0,172.217.194.0-255,155,155,8,286120
5604,2.2e-05,172.31.36.0-255,66,221,8,286120
5605,2.9e-05,172.217.194.0-255,1484,1705,8,286120
5606,3.3e-05,172.31.36.0-255,66,1771,8,286120
5607,3.9e-05,172.217.194.0-255,2902,4673,8,286120
5608,5e-05,172.31.36.0-255,66,4739,8,286120
5609,5.8e-05,172.217.194.0-255,7156,11895,8,286120
5610,6.1e-05,172.31.36.0-255,66,11961,8,286120
5611,8.3e-05,172.217.194.0-255,2103,14064,8,286120
5612,9.1e-05,172.31.36.0-255,66,14130,8,286120
5613,0.000131,172.31.36.0-255,66,14196,8,286120
5614,0.000193,172.217.194.0-255,5379,19575,8,286120
5615,0.000197,172.31.36.0-255,66,19641,8,286120
5616,0.000243,172.217.194.0-255,5738,25379,8,286120
5617,0.000246,172.31.36.0-255,66,25445,8,286120
5618,0.000282,172.217.194.0-255,7156,32601,8,286120
5619,0.000285,172.31.36.0-255,66,32667,8,286120
5620,0.000313,172.217.194.0-255,3961,36628,8,286120
5621,0.000315,172.31.36.0-255,66,36694,8,286120
5622,0.000374,172.217.194.0-255,7156,43850,8,286120
5623,0.000378,172.31.36.0-255,66,43916,8,286120
5624,0.000405,172.31.36.0-255,66,43982,8,286120
5625,0.00048,172.217.194.0-255,120,44102,8,286120
5626,0.000484,172.31.36.0-255,66,44168,8,286120
5627,0.000487,172.217.194.0-255,379,44547,8,286120
5628,0.000489,172.31.36.0-255,66,44613,8,286120
5629,0.000604,172.217.194.0-255,1484,46097,8,286120
5630,0.000609,172.31.36.0-255,66,46163,8,286120
5631,0.000627,172.217.194.0-255,2902,49065,8,286120
5632,0.00063,172.31.36.0-255,66,49131,8,286120
5633,0.000633,172.217.194.0-255,1484,50615,8,286120
5634,0.000666,172.217.194.0-255,4320,54935,8,286120
5635,0.000669,172.31.36.0-255,66,55001,8,286120
5636,0.000675,172.217.194.0-255,4320,59321,8,286120
5637,0.000678,172.31.36.0-255,66,59387,8,286120
5638,0.000717,172.217.194.0-255,7156,66543,8,286120
5639,0.00072,172.31.36.0-255,66,66609,8,286120
5640,0.000748,172.217.194.0-255,4320,70929,8,286120
5641,0.000751,172.31.36.0-255,66,70995,8,286120
5642,0.000814,172.31.36.0-255,66,71061,8,286120
5643,0.001527,172.217.194.0-255,1484,72545,8,286120
5644,0.001534,172.217.194.0-255,2902,75447,8,286120
5645,0.001538,172.31.36.0-255,66,75513,8,286120
5646,0.001569,172.217.194.0-255,5738,81251,8,286120
5647,0.001572,172.31.36.0-255,66,81317,8,286120
5648,0.001576,172.217.194.0-255,1484,82801,8,286120
5649,0.001601,172.217.194.0-255,1484,84285,8,286120
5650,0.001603,172.217.194.0-255,1484,85769,8,286120
5651,0.00161,172.31.36.0-255,66,85835,8,286120
5652,0.001644,172.31.36.0-255,66,85901,8,286120
5653,0.001697,172.217.194.0-255,5738,91639,8,286120
5654,0.001701,172.31.36.0-255,66,91705,8,286120
5655,0.001732,172.217.194.0-255,5020,96725,8,286120
5656,0.001735,172.31.36.0-255,66,96791,8,286120
5657,0.001929,172.217.194.0-255,1484,98275,8,286120
5658,0.001935,172.217.194.0-255,2902,101177,8,286120
5659,0.001939,172.31.36.0-255,66,101243,8,286120
5660,0.001944,172.217.194.0-255,2902,104145,8,286120
5661,0.001946,172.31.36.0-255,66,104211,8,286120
5662,0.001966,172.217.194.0-255,2902,107113,8,286120
5663,0.001973,172.31.36.0-255,66,107179,8,286120
5664,0.00201,172.31.36.0-255,66,107245,8,286120
5665,0.002088,172.217.194.0-255,1484,108729,8,286120
5666,0.002116,172.31.36.0-255,66,108795,8,286120
5667,0.00442,172.217.194.0-255,5738,114533,8,286120
5668,0.004428,172.31.36.0-255,66,114599,8,286120
5669,0.00671,172.217.194.0-255,1484,116083,8,286120
5670,0.006728,172.217.194.0-255,4320,120403,8,286120
5671,0.006732,172.31.36.0-255,66,120469,8,286120
5672,0.00902,172.217.194.0-255,2902,123371,8,286120
5673,0.009027,172.31.36.0-255,66,123437,8,286120
5674,0.009057,172.217.194.0-255,2902,126339,8,286120
5675,0.00906,172.31.36.0-255,66,126405,8,286120
5676,0.011305,172.217.194.0-255,2902,129307,8,286120
5677,0.011316,172.31.36.0-255,66,129373,8,286120
5678,0.011344,172.217.194.0-255,2902,132275,8,286120
5679,0.011347,172.31.36.0-255,66,132341,8,286120
5680,0.013597,172.217.194.0-255,2902,135243,8,286120
5681,0.013605,172.31.36.0-255,66,135309,8,286120
5682,0.013651,172.217.194.0-255,1484,136793,8,286120
5683,0.013668,172.217.194.0-255,1484,138277,8,286120
5684,0.013672,172.31.36.0-255,66,138343,8,286120
5685,0.015889,172.217.194.0-255,2902,141245,8,286120
5686,0.0159,172.31.36.0-255,66,141311,8,286120
5687,0.01597,172.217.194.0-255,1484,142795,8,286120
5688,0.015984,172.217.194.0-255,1484,144279,8,286120
5689,0.015987,172.31.36.0-255,66,144345,8,286120
5690,0.018213,172.217.194.0-255,2902,147247,8,286120
5691,0.018224,172.31.36.0-255,66,147313,8,286120
5692,0.018266,172.217.194.0-255,2902,150215,8,286120
5693,0.018269,172.31.36.0-255,66,150281,8,286120
5694,0.020506,172.217.194.0-255,2902,153183,8,286120
5695,0.020513,172.31.36.0-255,66,153249,8,286120
5696,0.020543,172.217.194.0-255,2902,156151,8,286120
5697,0.020546,172.31.36.0-255,66,156217,8,286120
5698,0.022781,172.217.194.0-255,2902,159119,8,286120
5699,0.022789,172.31.36.0-255,66,159185,8,286120
5700,0.022852,172.217.194.0-255,1484,160669,8,286120
5701,0.022864,172.217.194.0-255,1484,162153,8,286120
5702,0.022867,172.31.36.0-255,66,162219,8,286120
5703,0.025086,172.217.194.0-255,2902,165121,8,286120
5704,0.025095,172.31.36.0-255,66,165187,8,286120
5705,0.025143,172.217.194.0-255,2902,168089,8,286120
5706,0.025146,172.31.36.0-255,66,168155,8,286120
5707,0.02737,172.217.194.0-255,2902,171057,8,286120
5708,0.027377,172.31.36.0-255,66,171123,8,286120
5709,0.027421,172.217.194.0-255,2902,174025,8,286120
5710,0.027424,172.31.36.0-255,66,174091,8,286120
5711,0.028715,172.31.36.0-255,171,174262,8,286120
5712,0.028749,172.31.36.0-255,1135,175397,8,286120
5713,0.028816,172.31.36.0-255,1514,176911,8,286120
5714,0.028818,172.31.36.0-255,1514,178425,8,286120
5715,0.028823,172.31.36.0-255,1514,179939,8,286120
5716,0.028824,172.31.36.0-255,1049,180988,8,286120
5717,0.029669,172.217.194.0-255,2902,183890,8,286120
5718,0.02968,172.31.36.0-255,66,183956,8,286120
5719,0.029716,172.217.194.0-255,2902,186858,8,286120
5720,0.029719,172.31.36.0-255,66,186924,8,286120
5721,0.030259,104.244.42.0-255,66,186990,8,286120
5722,0.030308,104.244.42.0-255,66,187056,8,286120
5723,0.030365,104.244.42.0-255,66,187122,8,286120
5724,0.030411,104.244.42.0-255,66,187188,8,286120
5725,0.031991,172.217.194.0-255,2902,190090,8,286120
5726,0.031999,172.31.36.0-255,66,190156,8,286120
5727,0.032031,172.217.194.0-255,2902,193058,8,286120
5728,0.032034,172.31.36.0-255,66,193124,8,286120
5729,0.034278,172.217.194.0-255,2902,196026,8,286120
5730,0.034285,172.31.36.0-255,66,196092,8,286120
5731,0.034311,172.217.194.0-255,2902,198994,8,286120
5732,0.034315,172.31.36.0-255,66,199060,8,286120
5733,0.036585,172.217.194.0-255,5738,204798,8,286120
5734,0.036592,172.31.36.0-255,66,204864,8,286120
5735,0.038903,172.217.194.0-255,5738,210602,8,286120
5736,0.03891,172.31.36.0-255,66,210668,8,286120
5737,0.041221,172.217.194.0-255,5738,216406,8,286120
5738,0.041228,172.31.36.0-255,66,216472,8,286120
5739,0.0435,172.217.194.0-255,5738,222210,8,286120
5740,0.043507,172.31.36.0-255,66,222276,8,286120
5741,0.045816,172.217.194.0-255,5738,228014,8,286120
5742,0.045823,172.31.36.0-255,66,228080,8,286120
5743,0.048108,172.217.194.0-255,5738,233818,8,286120
5744,0.048117,172.31.36.0-255,66,233884,8,286120
5745,0.050405,172.217.194.0-255,5738,239622,8,286120
5746,0.050412,172.31.36.0-255,66,239688,8,286120
5747,0.052708,172.217.194.0-255,5738,245426,8,286120
5748,0.052716,172.31.36.0-255,66,245492,8,286120
5749,0.055017,172.217.194.0-255,5738,251230,8,286120
5750,0.055026,172.31.36.0-255,66,251296,8,286120
5751,0.057327,172.217.194.0-255,5738,257034,8,286120
5752,0.057335,172.31.36.0-255,66,257100,8,286120
5753,0.059667,172.217.194.0-255,5738,262838,8,286120
5754,0.059675,172.31.36.0-255,66,262904,8,286120
5755,0.062017,172.217.194.0-255,5738,268642,8,286120
5756,0.062026,172.31.36.0-255,66,268708,8,286120
5757,0.064321,172.217.194.0-255,5738,274446,8,286120
5758,0.064329,172.31.36.0-255,66,274512,8,286120
5759,0.066651,172.217.194.0-255,5738,280250,8,286120
5760,0.066656,172.31.36.0-255,66,280316,8,286120
5761,0.069005,172.217.194.0-255,5738,286054,8,286120
5762,0.069012,172.31.36.0-255,66,286120,8,286120
5763,0.0,74.125.24.0-255,146,146,8,124205
5764,1.7e-05,172.31.36.0-255,66,212,8,124205
5765,2.4e-05,74.125.24.0-255,1484,1696,8,124205
5766,2.8e-05,172.31.36.0-255,66,1762,8,124205
5767,3.4e-05,74.125.24.0-255,2902,4664,8,124205
5768,4.5e-05,172.31.36.0-255,66,4730,8,124205
5769,5.3e-05,74.125.24.0-255,7156,11886,8,124205
5770,5.7e-05,172.31.36.0-255,66,11952,8,124205
5771,6.1e-05,74.125.24.0-255,2042,13994,8,124205
5772,6.3e-05,172.31.36.0-255,66,14060,8,124205
5773,8.3e-05,74.125.24.0-255,4320,18380,8,124205
5774,8.6e-05,172.31.36.0-255,66,18446,8,124205
5775,0.00012,74.125.24.0-255,7156,25602,8,124205
5776,0.000123,172.31.36.0-255,66,25668,8,124205
5777,0.000156,74.125.24.0-255,5379,31047,8,124205
5778,0.000159,172.31.36.0-255,66,31113,8,124205
5779,0.00022,74.125.24.0-255,1484,32597,8,124205
5780,0.000223,172.31.36.0-255,66,32663,8,124205
5781,0.000228,74.125.24.0-255,2902,35565,8,124205
5782,0.00023,172.31.36.0-255,66,35631,8,124205
5783,0.000234,74.125.24.0-255,1484,37115,8,124205
5784,0.00024,172.31.36.0-255,66,37181,8,124205
5785,0.000273,74.125.24.0-255,4320,41501,8,124205
5786,0.000276,172.31.36.0-255,66,41567,8,124205
5787,0.000292,172.31.36.0-255,66,41633,8,124205
5788,0.000323,172.31.36.0-255,66,41699,8,124205
5789,0.000356,74.125.24.0-255,130,41829,8,124205
5790,0.000358,172.31.36.0-255,66,41895,8,124205
5791,0.000362,74.125.24.0-255,351,42246,8,124205
5792,0.000364,172.31.36.0-255,66,42312,8,124205
5793,0.000701,74.125.24.0-255,1484,43796,8,124205
5794,0.000707,172.31.36.0-255,66,43862,8,124205
5795,0.000713,74.125.24.0-255,2902,46764,8,124205
5796,0.000715,172.31.36.0-255,66,46830,8,124205
5797,0.000722,74.125.24.0-255,5738,52568,8,124205
5798,0.000729,172.31.36.0-255,66,52634,8,124205
5799,0.000774,172.31.36.0-255,66,52700,8,124205
5800,0.000782,74.125.24.0-255,7156,59856,8,124205
5801,0.000784,172.31.36.0-255,66,59922,8,124205
5802,0.000794,74.125.24.0-255,3602,63524,8,124205
5803,0.000796,172.31.36.0-255,66,63590,8,124205
5804,0.000935,74.125.24.0-255,1484,65074,8,124205
5805,0.00094,172.31.36.0-255,66,65140,8,124205
5806,0.000946,74.125.24.0-255,2902,68042,8,124205
5807,0.000948,172.31.36.0-255,66,68108,8,124205
5808,0.000959,74.125.24.0-255,5738,73846,8,124205
5809,0.000962,172.31.36.0-255,66,73912,8,124205
5810,0.001003,172.31.36.0-255,66,73978,8,124205
5811,0.001015,172.31.36.0-255,66,74044,8,124205
5812,0.001127,74.125.24.0-255,1484,75528,8,124205
5813,0.001131,172.31.36.0-255,66,75594,8,124205
5814,0.001137,74.125.24.0-255,2902,78496,8,124205
5815,0.001139,172.31.36.0-255,66,78562,8,124205
5816,0.00115,74.125.24.0-255,5738,84300,8,124205
5817,0.001152,172.31.36.0-255,66,84366,8,124205
5818,0.001158,74.125.24.0-255,4320,88686,8,124205
5819,0.001173,172.31.36.0-255,66,88752,8,124205
5820,0.00125,172.31.36.0-255,66,88818,8,124205
5821,0.001263,74.125.24.0-255,7156,95974,8,124205
5822,0.001311,172.31.36.0-255,66,96040,8,124205
5823,0.001334,74.125.24.0-255,766,96806,8,124205
5824,0.001353,172.31.36.0-255,66,96872,8,124205
5825,0.001395,74.125.24.0-255,5738,102610,8,124205
5826,0.001399,172.31.36.0-255,66,102676,8,124205
5827,0.001425,172.31.36.0-255,66,102742,8,124205
5828,0.001769,74.125.24.0-255,7156,109898,8,124205
5829,0.001774,172.31.36.0-255,66,109964,8,124205
5830,0.001856,172.31.36.0-255,66,110030,8,124205
5831,0.001938,172.31.36.0-255,66,110096,8,124205
5832,0.002001,74.125.24.0-255,3602,113698,8,124205
5833,0.002092,74.125.24.0-255,105,113803,8,124205
5834,0.002099,172.31.36.0-255,66,113869,8,124205
5835,0.008635,172.31.36.0-255,105,113974,8,124205
5836,0.010855,74.125.24.0-255,66,114040,8,124205
5837,0.023393,172.31.36.0-255,172,114212,8,124205
5838,0.023473,172.31.36.0-255,1110,115322,8,124205
5839,0.023566,172.31.36.0-255,1514,116836,8,124205
5840,0.023569,172.31.36.0-255,1514,118350,8,124205
5841,0.023575,172.31.36.0-255,1514,119864,8,124205
5842,0.023576,172.31.36.0-255,1514,121378,8,124205
5843,0.023605,172.31.36.0-255,1514,122892,8,124205
5844,0.023607,172.31.36.0-255,875,123767,8,124205
5845,0.024956,104.244.42.0-255,66,123833,8,124205
5846,0.025,104.244.42.0-255,66,123899,8,124205
5847,0.025109,104.244.42.0-255,66,123965,8,124205
5848,0.025157,104.244.42.0-255,66,124031,8,124205
5849,0.034241,172.31.36.0-255,108,124139,8,124205
5850,0.035763,104.244.42.0-255,66,124205,8,124205
5851,0.0,172.217.194.0-255,153,153,8,221361
5852,5e-05,172.31.36.0-255,66,219,8,221361
5853,5.7e-05,172.217.194.0-255,1484,1703,8,221361
5854,6.1e-05,172.31.36.0-255,66,1769,8,221361
5855,6.7e-05,172.217.194.0-255,2902,4671,8,221361
5856,7e-05,172.31.36.0-255,66,4737,8,221361
5857,7.8e-05,172.217.194.0-255,7156,11893,8,221361
5858,8.1e-05,172.31.36.0-255,66,11959,8,221361
5859,8.4e-05,172.217.194.0-255,1975,13934,8,221361
5860,8.7e-05,172.31.36.0-255,66,14000,8,221361
5861,0.000205,172.217.194.0-255,1484,15484,8,221361
5862,0.000209,172.31.36.0-255,66,15550,8,221361
5863,0.000215,172.217.194.0-255,2902,18452,8,221361
5864,0.000218,172.31.36.0-255,66,18518,8,221361
5865,0.000225,172.217.194.0-255,5738,24256,8,221361
5866,0.000228,172.31.36.0-255,66,24322,8,221361
5867,0.000268,172.217.194.0-255,5738,30060,8,221361
5868,0.000271,172.31.36.0-255,66,30126,8,221361
5869,0.000301,172.31.36.0-255,66,30192,8,221361
5870,0.000336,172.31.36.0-255,66,30258,8,221361
5871,0.000354,172.217.194.0-255,2902,33160,8,221361
5872,0.000357,172.31.36.0-255,66,33226,8,221361
5873,0.00037,172.31.36.0-255,66,33292,8,221361
5874,0.000375,172.217.194.0-255,2795,36087,8,221361
5875,0.000377,172.31.36.0-255,66,36153,8,221361
5876,0.00044,172.217.194.0-255,1484,37637,8,221361
5877,0.000444,172.31.36.0-255,66,37703,8,221361
5878,0.000459,172.217.194.0-255,2902,40605,8,221361
5879,0.000462,172.31.36.0-255,66,40671,8,221361
5880,0.000465,172.217.194.0-255,1484,42155,8,221361
5881,0.00049,172.217.194.0-255,4320,46475,8,221361
5882,0.000494,172.31.36.0-255,66,46541,8,221361
5883,0.000497,172.217.194.0-255,1484,48025,8,221361
5884,0.000517,172.217.194.0-255,2902,50927,8,221361
5885,0.000521,172.31.36.0-255,66,50993,8,221361
5886,0.000528,172.217.194.0-255,5738,56731,8,221361
5887,0.000531,172.31.36.0-255,66,56797,8,221361
5888,0.000535,172.217.194.0-255,2902,59699,8,221361
5889,0.000538,172.31.36.0-255,66,59765,8,221361
5890,0.000562,172.217.194.0-255,4320,64085,8,221361
5891,0.000566,172.31.36.0-255,66,64151,8,221361
5892,0.000598,172.217.194.0-255,6438,70589,8,221361
5893,0.000601,172.31.36.0-255,66,70655,8,221361
5894,0.000627,172.217.194.0-255,7156,77811,8,221361
5895,0.000632,172.31.36.0-255,66,77877,8,221361
5896,0.000664,172.31.36.0-255,66,77943,8,221361
5897,0.000703,172.217.194.0-255,5738,83681,8,221361
5898,0.000708,172.31.36.0-255,66,83747,8,221361
5899,0.000731,172.217.194.0-255,6438,90185,8,221361
5900,0.000735,172.31.36.0-255,66,90251,8,221361
5901,0.00089,172.217.194.0-255,1484,91735,8,221361
5902,0.000894,172.217.194.0-255,1484,93219,8,221361
5903,0.000898,172.31.36.0-255,66,93285,8,221361
5904,0.000917,172.217.194.0-255,1484,94769,8,221361
5905,0.000925,172.217.194.0-255,5738,100507,8,221361
5906,0.000927,172.31.36.0-255,66,100573,8,221361
5907,0.000942,172.31.36.0-255,66,100639,8,221361
5908,0.000977,172.31.36.0-255,66,100705,8,221361
5909,0.001025,172.217.194.0-255,1484,102189,8,221361
5910,0.00103,172.217.194.0-255,2902,105091,8,221361
5911,0.001033,172.31.36.0-255,66,105157,8,221361
5912,0.001039,172.217.194.0-255,5738,110895,8,221361
5913,0.001043,172.31.36.0-255,66,110961,8,221361
5914,0.001061,172.217.194.0-255,2902,113863,8,221361
5915,0.001064,172.31.36.0-255,66,113929,8,221361
5916,0.00109,172.31.36.0-255,66,113995,8,221361
5917,0.001103,172.31.36.0-255,66,114061,8,221361
5918,0.001212,172.217.194.0-255,1484,115545,8,221361
5919,0.001218,172.217.194.0-255,2902,118447,8,221361
5920,0.001221,172.31.36.0-255,66,118513,8,221361
5921,0.001225,172.217.194.0-255,1484,119997,8,221361
5922,0.001243,172.217.194.0-255,4320,124317,8,221361
5923,0.001246,172.31.36.0-255,66,124383,8,221361
5924,0.001276,172.31.36.0-255,66,124449,8,221361
5925,0.00128,172.217.194.0-255,2902,127351,8,221361
5926,0.001283,172.31.36.0-255,66,127417,8,221361
5927,0.001315,172.31.36.0-255,66,127483,8,221361
5928,0.001403,172.217.194.0-255,1484,128967,8,221361
5929,0.001415,172.217.194.0-255,2902,131869,8,221361
5930,0.001419,172.31.36.0-255,66,131935,8,221361
5931,0.001425,172.217.194.0-255,2902,134837,8,221361
5932,0.001427,172.31.36.0-255,66,134903,8,221361
5933,0.00144,172.217.194.0-255,2902,137805,8,221361
5934,0.001443,172.31.36.0-255,66,137871,8,221361
5935,0.001446,172.217.194.0-255,1484,139355,8,221361
5936,0.001449,172.217.194.0-255,1484,140839,8,221361
5937,0.001451,172.31.36.0-255,66,140905,8,221361
5938,0.001487,172.217.194.0-255,7156,148061,8,221361
5939,0.001491,172.31.36.0-255,66,148127,8,221361
5940,0.001496,172.217.194.0-255,4320,152447,8,221361
5941,0.001499,172.31.36.0-255,66,152513,8,221361
5942,0.00152,172.31.36.0-255,66,152579,8,221361
5943,0.001573,172.217.194.0-255,1484,154063,8,221361
5944,0.001579,172.217.194.0-255,2902,156965,8,221361
5945,0.001582,172.31.36.0-255,66,157031,8,221361
5946,0.001593,172.217.194.0-255,1484,158515,8,221361
5947,0.00161,172.217.194.0-255,4320,162835,8,221361
5948,0.001614,172.31.36.0-255,66,162901,8,221361
5949,0.00162,172.217.194.0-255,5738,168639,8,221361
5950,0.001623,172.31.36.0-255,66,168705,8,221361
5951,0.001651,172.217.194.0-255,7156,175861,8,221361
5952,0.001655,172.31.36.0-255,66,175927,8,221361
5953,0.001662,172.217.194.0-255,7156,183083,8,221361
5954,0.001665,172.31.36.0-255,66,183149,8,221361
5955,0.001697,172.217.194.0-255,5020,188169,8,221361
5956,0.0017,172.31.36.0-255,66,188235,8,221361
5957,0.001715,172.31.36.0-255,66,188301,8,221361
5958,0.001734,172.31.36.0-255,66,188367,8,221361
5959,0.001741,172.217.194.0-255,7156,195523,8,221361
5960,0.001744,172.31.36.0-255,66,195589,8,221361
5961,0.001781,172.31.36.0-255,66,195655,8,221361
5962,0.001795,172.31.36.0-255,66,195721,8,221361
5963,0.001819,172.217.194.0-255,5738,201459,8,221361
5964,0.001823,172.31.36.0-255,66,201525,8,221361
5965,0.00184,172.217.194.0-255,7156,208681,8,221361
5966,0.001843,172.31.36.0-255,66,208747,8,221361
5967,0.001876,172.31.36.0-255,66,208813,8,221361
5968,0.001881,172.217.194.0-255,2902,211715,8,221361
5969,0.001883,172.31.36.0-255,66,211781,8,221361
5970,0.001909,172.217.194.0-255,3065,214846,8,221361
5971,0.001912,172.31.36.0-255,66,214912,8,221361
5972,0.001915,172.217.194.0-255,105,215017,8,221361
5973,0.003646,172.31.36.0-255,66,215083,8,221361
5974,0.003675,172.31.36.0-255,105,215188,8,221361
5975,0.005848,172.217.194.0-255,66,215254,8,221361
5976,0.037593,172.31.36.0-255,188,215442,8,221361
5977,0.037628,172.31.36.0-255,955,216397,8,221361
5978,0.037693,172.31.36.0-255,1514,217911,8,221361
5979,0.037695,172.31.36.0-255,1514,219425,8,221361
5980,0.037696,172.31.36.0-255,1514,220939,8,221361
5981,0.037697,172.31.36.0-255,158,221097,8,221361
5982,0.039126,104.244.42.0-255,66,221163,8,221361
5983,0.039182,104.244.42.0-255,66,221229,8,221361
5984,0.039285,104.244.42.0-255,66,221295,8,221361
5985,0.039288,104.244.42.0-255,66,221361,8,221361
5986,0.0,172.217.160.0-255,146,146,8,264125
5987,3.5e-05,172.31.36.0-255,66,212,8,264125
5988,4.2e-05,172.217.160.0-255,1484,1696,8,264125
5989,4.6e-05,172.31.36.0-255,66,1762,8,264125
5990,6.7e-05,172.217.160.0-255,2902,4664,8,264125
5991,7e-05,172.31.36.0-255,66,4730,8,264125
5992,0.000151,172.217.160.0-255,7156,11886,8,264125
5993,0.000155,172.31.36.0-255,66,11952,8,264125
5994,0.000401,172.217.160.0-255,1484,13436,8,264125
5995,0.000407,172.31.36.0-255,66,13502,8,264125
5996,0.000452,172.217.160.0-255,7156,20658,8,264125
5997,0.000456,172.31.36.0-255,66,20724,8,264125
5998,0.000483,172.31.36.0-255,66,20790,8,264125
5999,0.000979,172.217.160.0-255,2543,23333,8,264125
6000,0.000985,172.31.36.0-255,66,23399,8,264125
6001,0.001066,172.217.160.0-255,7156,30555,8,264125
6002,0.001071,172.31.36.0-255,66,30621,8,264125
6003,0.001104,172.31.36.0-255,66,30687,8,264125
6004,0.001886,172.31.36.0-255,66,30753,8,264125
6005,0.001922,172.31.36.0-255,66,30819,8,264125
6006,0.002828,172.31.36.0-255,66,30885,8,264125
6007,0.002847,172.31.36.0-255,66,30951,8,264125
6008,0.004464,172.217.160.0-255,5738,36689,8,264125
6009,0.004468,172.31.36.0-255,66,36755,8,264125
6010,0.006091,172.217.160.0-255,5738,42493,8,264125
6011,0.006097,172.31.36.0-255,66,42559,8,264125
6012,0.007724,172.217.160.0-255,5738,48297,8,264125
6013,0.00773,172.31.36.0-255,66,48363,8,264125
6014,0.009367,172.217.160.0-255,5738,54101,8,264125
6015,0.011609,172.31.36.0-255,66,54167,8,264125
6016,0.013237,172.217.160.0-255,5738,59905,8,264125
6017,0.013245,172.31.36.0-255,66,59971,8,264125
6018,0.014872,172.217.160.0-255,5738,65709,8,264125
6019,0.014879,172.31.36.0-255,66,65775,8,264125
6020,0.016519,172.217.160.0-255,5738,71513,8,264125
6021,0.016525,172.31.36.0-255,66,71579,8,264125
6022,0.018202,172.217.160.0-255,5738,77317,8,264125
6023,0.01821,172.31.36.0-255,66,77383,8,264125
6024,0.019857,172.217.160.0-255,5738,83121,8,264125
6025,0.019864,172.31.36.0-255,66,83187,8,264125
6026,0.021495,172.217.160.0-255,5738,88925,8,264125
6027,0.021501,172.31.36.0-255,66,88991,8,264125
6028,0.023129,172.217.160.0-255,5738,94729,8,264125
6029,0.023135,172.31.36.0-255,66,94795,8,264125
6030,0.024763,172.217.160.0-255,2902,97697,8,264125
6031,0.024769,172.31.36.0-255,66,97763,8,264125
6032,0.024801,172.217.160.0-255,2902,100665,8,264125
6033,0.024817,172.31.36.0-255,66,100731,8,264125
6034,0.025976,172.31.36.0-255,188,100919,8,264125
6035,0.02601,172.31.36.0-255,955,101874,8,264125
6036,0.026046,172.31.36.0-255,1514,103388,8,264125
6037,0.026048,172.31.36.0-255,135,103523,8,264125
6038,0.026393,172.217.160.0-255,2902,106425,8,264125
6039,0.0264,172.31.36.0-255,66,106491,8,264125
6040,0.026437,172.217.160.0-255,2902,109393,8,264125
6041,0.026447,172.31.36.0-255,66,109459,8,264125
6042,0.02754,104.244.42.0-255,66,109525,8,264125
6043,0.027548,104.244.42.0-255,66,109591,8,264125
6044,0.027598,104.244.42.0-255,66,109657,8,264125
6045,0.028065,172.217.160.0-255,2902,112559,8,264125
6046,0.028071,172.31.36.0-255,66,112625,8,264125
6047,0.0281,172.217.160.0-255,2902,115527,8,264125
6048,0.028155,172.31.36.0-255,66,115593,8,264125
6049,0.029698,172.217.160.0-255,2902,118495,8,264125
6050,0.029703,172.31.36.0-255,66,118561,8,264125
6051,0.029772,172.217.160.0-255,2902,121463,8,264125
6052,0.029788,172.31.36.0-255,66,121529,8,264125
6053,0.031326,172.217.160.0-255,2902,124431,8,264125
6054,0.031332,172.31.36.0-255,66,124497,8,264125
6055,0.0314,172.217.160.0-255,2902,127399,8,264125
6056,0.031408,172.31.36.0-255,66,127465,8,264125
6057,0.032952,172.217.160.0-255,2902,130367,8,264125
6058,0.032958,172.31.36.0-255,66,130433,8,264125
6059,0.033025,172.217.160.0-255,2902,133335,8,264125
6060,0.03304,172.31.36.0-255,66,133401,8,264125
6061,0.034572,172.217.160.0-255,2902,136303,8,264125
6062,0.034578,172.31.36.0-255,66,136369,8,264125
6063,0.034653,172.217.160.0-255,2902,139271,8,264125
6064,0.03467,172.31.36.0-255,66,139337,8,264125
6065,0.036203,172.217.160.0-255,2902,142239,8,264125
6066,0.036209,172.31.36.0-255,66,142305,8,264125
6067,0.036289,172.217.160.0-255,2902,145207,8,264125
6068,0.036312,172.31.36.0-255,66,145273,8,264125
6069,0.037883,172.217.160.0-255,2902,148175,8,264125
6070,0.037888,172.31.36.0-255,66,148241,8,264125
6071,0.03794,172.217.160.0-255,1484,149725,8,264125
6072,0.037953,172.217.160.0-255,1484,151209,8,264125
6073,0.037966,172.31.36.0-255,66,151275,8,264125
6074,0.039503,172.217.160.0-255,2902,154177,8,264125
6075,0.039509,172.31.36.0-255,66,154243,8,264125
6076,0.039579,172.217.160.0-255,2902,157145,8,264125
6077,0.039586,172.31.36.0-255,66,157211,8,264125
6078,0.041128,172.217.160.0-255,2902,160113,8,264125
6079,0.041134,172.31.36.0-255,66,160179,8,264125
6080,0.041199,172.217.160.0-255,2902,163081,8,264125
6081,0.041212,172.31.36.0-255,66,163147,8,264125
6082,0.042749,172.217.160.0-255,2902,166049,8,264125
6083,0.042754,172.31.36.0-255,66,166115,8,264125
6084,0.042828,172.217.160.0-255,2902,169017,8,264125
6085,0.042835,172.31.36.0-255,66,169083,8,264125
6086,0.044365,172.217.160.0-255,2902,171985,8,264125
6087,0.04437,172.31.36.0-255,66,172051,8,264125
6088,0.044446,172.217.160.0-255,2902,174953,8,264125
6089,0.04446,172.31.36.0-255,66,175019,8,264125
6090,0.045997,172.217.160.0-255,2902,177921,8,264125
6091,0.046002,172.31.36.0-255,66,177987,8,264125
6092,0.046074,172.217.160.0-255,2902,180889,8,264125
6093,0.046081,172.31.36.0-255,66,180955,8,264125
6094,0.047639,172.217.160.0-255,2902,183857,8,264125
6095,0.047648,172.31.36.0-255,66,183923,8,264125
6096,0.047698,172.217.160.0-255,2902,186825,8,264125
6097,0.048546,172.31.36.0-255,66,186891,8,264125
6098,0.049288,172.217.160.0-255,2902,189793,8,264125
6099,0.049297,172.31.36.0-255,66,189859,8,264125
6100,0.05017,172.217.160.0-255,2902,192761,8,264125
6101,0.050178,172.31.36.0-255,66,192827,8,264125
6102,0.050921,172.217.160.0-255,2902,195729,8,264125
6103,0.050927,172.31.36.0-255,66,195795,8,264125
6104,0.051803,172.217.160.0-255,2902,198697,8,264125
6105,0.05181,172.31.36.0-255,66,198763,8,264125
6106,0.052552,172.217.160.0-255,2902,201665,8,264125
6107,0.052557,172.31.36.0-255,66,201731,8,264125
6108,0.05343,172.217.160.0-255,2902,204633,8,264125
6109,0.053435,172.31.36.0-255,66,204699,8,264125
6110,0.054176,172.217.160.0-255,2902,207601,8,264125
6111,0.054181,172.31.36.0-255,66,207667,8,264125
6112,0.055059,172.217.160.0-255,2902,210569,8,264125
6113,0.055065,172.31.36.0-255,66,210635,8,264125
6114,0.055801,172.217.160.0-255,2902,213537,8,264125
6115,0.055806,172.31.36.0-255,66,213603,8,264125
6116,0.056682,172.217.160.0-255,2902,216505,8,264125
6117,0.056687,172.31.36.0-255,66,216571,8,264125
6118,0.057432,172.217.160.0-255,2902,219473,8,264125
6119,0.057437,172.31.36.0-255,66,219539,8,264125
6120,0.058322,172.217.160.0-255,2902,222441,8,264125
6121,0.058328,172.31.36.0-255,66,222507,8,264125
6122,0.059055,172.217.160.0-255,2902,225409,8,264125
6123,0.059061,172.31.36.0-255,66,225475,8,264125
6124,0.05995,172.217.160.0-255,2902,228377,8,264125
6125,0.059955,172.31.36.0-255,66,228443,8,264125
6126,0.060684,172.217.160.0-255,2902,231345,8,264125
6127,0.060689,172.31.36.0-255,66,231411,8,264125
6128,0.061577,172.217.160.0-255,2902,234313,8,264125
6129,0.061582,172.31.36.0-255,66,234379,8,264125
6130,0.062313,172.217.160.0-255,2902,237281,8,264125
6131,0.062318,172.31.36.0-255,66,237347,8,264125
6132,0.063215,172.217.160.0-255,2902,240249,8,264125
6133,0.06322,172.31.36.0-255,66,240315,8,264125
6134,0.063941,172.217.160.0-255,2902,243217,8,264125
6135,0.063947,172.31.36.0-255,66,243283,8,264125
6136,0.06484,172.217.160.0-255,2902,246185,8,264125
6137,0.064847,172.31.36.0-255,66,246251,8,264125
6138,0.065593,172.217.160.0-255,2902,249153,8,264125
6139,0.065599,172.31.36.0-255,66,249219,8,264125
6140,0.066466,172.217.160.0-255,1484,250703,8,264125
6141,0.066497,172.217.160.0-255,1484,252187,8,264125
6142,0.066502,172.31.36.0-255,66,252253,8,264125
6143,0.067221,172.217.160.0-255,2902,255155,8,264125
6144,0.067226,172.31.36.0-255,66,255221,8,264125
6145,0.068121,172.217.160.0-255,2902,258123,8,264125
6146,0.068127,172.31.36.0-255,66,258189,8,264125
6147,0.068856,172.217.160.0-255,2902,261091,8,264125
6148,0.068862,172.31.36.0-255,66,261157,8,264125
6149,0.069768,172.217.160.0-255,2902,264059,8,264125
6150,0.069773,172.31.36.0-255,66,264125,8,264125
6151,0.0,172.217.194.0-255,153,153,8,330764
6152,2.7e-05,172.31.36.0-255,66,219,8,330764
6153,3.3e-05,172.217.194.0-255,1484,1703,8,330764
6154,3.7e-05,172.31.36.0-255,66,1769,8,330764
6155,4.2e-05,172.217.194.0-255,2902,4671,8,330764
6156,4.4e-05,172.31.36.0-255,66,4737,8,330764
6157,5.3e-05,172.217.194.0-255,7156,11893,8,330764
6158,5.6e-05,172.31.36.0-255,66,11959,8,330764
6159,0.0001,172.217.194.0-255,2040,13999,8,330764
6160,0.000103,172.31.36.0-255,66,14065,8,330764
6161,0.00014,172.217.194.0-255,2902,16967,8,330764
6162,0.000144,172.31.36.0-255,66,17033,8,330764
6163,0.000151,172.217.194.0-255,7156,24189,8,330764
6164,0.000154,172.31.36.0-255,66,24255,8,330764
6165,0.000157,172.217.194.0-255,1484,25739,8,330764
6166,0.000158,172.31.36.0-255,66,25805,8,330764
6167,0.000204,172.217.194.0-255,5379,31184,8,330764
6168,0.00021,172.31.36.0-255,66,31250,8,330764
6169,0.000359,172.217.194.0-255,1484,32734,8,330764
6170,0.000364,172.31.36.0-255,66,32800,8,330764
6171,0.000369,172.217.194.0-255,2902,35702,8,330764
6172,0.000372,172.31.36.0-255,66,35768,8,330764
6173,0.000378,172.217.194.0-255,5738,41506,8,330764
6174,0.00038,172.31.36.0-255,66,41572,8,330764
6175,0.000397,172.217.194.0-255,1484,43056,8,330764
6176,0.0004,172.31.36.0-255,66,43122,8,330764
6177,0.000426,172.217.194.0-255,5379,48501,8,330764
6178,0.000429,172.31.36.0-255,66,48567,8,330764
6179,0.000448,172.217.194.0-255,7156,55723,8,330764
6180,0.000451,172.31.36.0-255,66,55789,8,330764
6181,0.000457,172.217.194.0-255,5738,61527,8,330764
6182,0.000461,172.31.36.0-255,66,61593,8,330764
6183,0.000476,172.217.194.0-255,1484,63077,8,330764
6184,0.000506,172.217.194.0-255,2543,65620,8,330764
6185,0.00051,172.31.36.0-255,66,65686,8,330764
6186,0.000954,172.217.194.0-255,647,66333,8,330764
6187,0.001099,172.217.194.0-255,1484,67817,8,330764
6188,0.001104,172.31.36.0-255,66,67883,8,330764
6189,0.00111,172.217.194.0-255,2902,70785,8,330764
6190,0.001113,172.31.36.0-255,66,70851,8,330764
6191,0.001119,172.217.194.0-255,5738,76589,8,330764
6192,0.001121,172.31.36.0-255,66,76655,8,330764
6193,0.001155,172.31.36.0-255,66,76721,8,330764
6194,0.001177,172.217.194.0-255,1484,78205,8,330764
6195,0.001188,172.217.194.0-255,766,78971,8,330764
6196,0.001637,172.217.194.0-255,1484,80455,8,330764
6197,0.001646,172.217.194.0-255,2902,83357,8,330764
6198,0.001651,172.217.194.0-255,5738,89095,8,330764
6199,0.00167,172.217.194.0-255,7156,96251,8,330764
6200,0.001683,172.217.194.0-255,5738,101989,8,330764
6201,0.00169,172.217.194.0-255,2902,104891,8,330764
6202,0.001791,172.217.194.0-255,1484,106375,8,330764
6203,0.001809,172.217.194.0-255,2902,109277,8,330764
6204,0.001815,172.217.194.0-255,5738,115015,8,330764
6205,0.001839,172.217.194.0-255,1484,116499,8,330764
6206,0.001885,172.217.194.0-255,2184,118683,8,330764
6207,0.001922,172.217.194.0-255,1484,120167,8,330764
6208,0.001927,172.217.194.0-255,2902,123069,8,330764
6209,0.001932,172.217.194.0-255,2902,125971,8,330764
6210,0.001958,172.217.194.0-255,2902,128873,8,330764
6211,0.001965,172.217.194.0-255,7156,136029,8,330764
6212,0.001981,172.217.194.0-255,5738,141767,8,330764
6213,0.00201,172.217.194.0-255,2184,143951,8,330764
6214,0.002085,172.217.194.0-255,1484,145435,8,330764
6215,0.00209,172.217.194.0-255,2902,148337,8,330764
6216,0.002105,172.217.194.0-255,2902,151239,8,330764
6217,0.00212,172.217.194.0-255,2902,154141,8,330764
6218,0.002126,172.217.194.0-255,2902,157043,8,330764
6219,0.002154,172.217.194.0-255,4320,161363,8,330764
6220,0.002175,172.217.194.0-255,6438,167801,8,330764
6221,0.00223,172.217.194.0-255,4320,172121,8,330764
6222,0.002265,172.217.194.0-255,4320,176441,8,330764
6223,0.002272,172.217.194.0-255,6438,182879,8,330764
6224,0.005364,172.31.36.0-255,66,182945,8,330764
6225,0.007665,172.217.194.0-255,5738,188683,8,330764
6226,0.007671,172.31.36.0-255,66,188749,8,330764
6227,0.010011,172.217.194.0-255,5738,194487,8,330764
6228,0.010017,172.31.36.0-255,66,194553,8,330764
6229,0.012352,172.217.194.0-255,5738,200291,8,330764
6230,0.012429,172.31.36.0-255,66,200357,8,330764
6231,0.014707,172.217.194.0-255,5738,206095,8,330764
6232,0.014715,172.31.36.0-255,66,206161,8,330764
6233,0.016994,172.217.194.0-255,5738,211899,8,330764
6234,0.017003,172.31.36.0-255,66,211965,8,330764
6235,0.019289,172.217.194.0-255,5738,217703,8,330764
6236,0.019298,172.31.36.0-255,66,217769,8,330764
6237,0.02158,172.217.194.0-255,5738,223507,8,330764
6238,0.021589,172.31.36.0-255,66,223573,8,330764
6239,0.023887,172.217.194.0-255,5738,229311,8,330764
6240,0.023896,172.31.36.0-255,66,229377,8,330764
6241,0.026199,172.217.194.0-255,5738,235115,8,330764
6242,0.026209,172.31.36.0-255,66,235181,8,330764
6243,0.028511,172.217.194.0-255,5738,240919,8,330764
6244,0.028518,172.31.36.0-255,66,240985,8,330764
6245,0.030808,172.217.194.0-255,5738,246723,8,330764
6246,0.030817,172.31.36.0-255,66,246789,8,330764
6247,0.033137,172.217.194.0-255,4320,251109,8,330764
6248,0.033144,172.31.36.0-255,66,251175,8,330764
6249,0.033181,172.217.194.0-255,1484,252659,8,330764
6250,0.035441,172.217.194.0-255,4320,256979,8,330764
6251,0.035449,172.31.36.0-255,66,257045,8,330764
6252,0.037737,172.217.194.0-255,5738,262783,8,330764
6253,0.037745,172.31.36.0-255,66,262849,8,330764
6254,0.040033,172.217.194.0-255,5738,268587,8,330764
6255,0.040042,172.31.36.0-255,66,268653,8,330764
6256,0.042295,172.217.194.0-255,5738,274391,8,330764
6257,0.042303,172.31.36.0-255,66,274457,8,330764
6258,0.044574,172.217.194.0-255,5738,280195,8,330764
6259,0.044583,172.31.36.0-255,66,280261,8,330764
6260,0.046892,172.217.194.0-255,5738,285999,8,330764
6261,0.0469,172.31.36.0-255,66,286065,8,330764
6262,0.047111,172.31.36.0-255,192,286257,8,330764
6263,0.047138,172.31.36.0-255,955,287212,8,330764
6264,0.047187,172.31.36.0-255,1514,288726,8,330764
6265,0.047189,172.31.36.0-255,1514,290240,8,330764
6266,0.047234,172.31.36.0-255,77,290317,8,330764
6267,0.048674,104.244.42.0-255,66,290383,8,330764
6268,0.048698,104.244.42.0-255,66,290449,8,330764
6269,0.048787,104.244.42.0-255,66,290515,8,330764
6270,0.048793,104.244.42.0-255,66,290581,8,330764
6271,0.049145,172.217.194.0-255,5738,296319,8,330764
6272,0.049152,172.31.36.0-255,66,296385,8,330764
6273,0.051445,172.217.194.0-255,5738,302123,8,330764
6274,0.05145,172.31.36.0-255,66,302189,8,330764
6275,0.053727,172.217.194.0-255,5738,307927,8,330764
6276,0.053733,172.31.36.0-255,66,307993,8,330764
6277,0.056018,172.217.194.0-255,5738,313731,8,330764
6278,0.056023,172.31.36.0-255,66,313797,8,330764
6279,0.058288,172.217.194.0-255,5738,319535,8,330764
6280,0.058294,172.31.36.0-255,66,319601,8,330764
6281,0.060584,172.217.194.0-255,5738,325339,8,330764
6282,0.060588,172.31.36.0-255,66,325405,8,330764
6283,0.062866,172.217.194.0-255,4531,329936,8,330764
6284,0.062871,172.31.36.0-255,66,330002,8,330764
6285,0.063068,172.31.36.0-255,105,330107,8,330764
6286,0.063093,172.31.36.0-255,105,330212,8,330764
6287,0.063333,172.31.36.0-255,90,330302,8,330764
6288,0.06334,172.31.36.0-255,66,330368,8,330764
6289,0.065315,172.217.194.0-255,66,330434,8,330764
6290,0.065322,172.217.194.0-255,66,330500,8,330764
6291,0.065538,172.217.194.0-255,66,330566,8,330764
6292,0.065559,172.217.194.0-255,66,330632,8,330764
6293,0.065564,172.31.36.0-255,66,330698,8,330764
6294,0.065575,172.217.194.0-255,66,330764,8,330764
6295,0.0,172.217.27.0-255,153,153,8,281309
6296,1.6e-05,172.31.36.0-255,66,219,8,281309
6297,2.4e-05,172.217.27.0-255,1484,1703,8,281309
6298,2.9e-05,172.31.36.0-255,66,1769,8,281309
6299,3.6e-05,172.217.27.0-255,2902,4671,8,281309
6300,4.8e-05,172.31.36.0-255,66,4737,8,281309
6301,5.5e-05,172.217.27.0-255,5738,10475,8,281309
6302,5.9e-05,172.31.36.0-255,66,10541,8,281309
6303,0.000128,172.31.36.0-255,66,10607,8,281309
6304,0.000135,172.217.27.0-255,6797,17404,8,281309
6305,0.000138,172.31.36.0-255,66,17470,8,281309
6306,0.000254,172.217.27.0-255,1484,18954,8,281309
6307,0.000256,172.31.36.0-255,66,19020,8,281309
6308,0.000285,172.217.27.0-255,2902,21922,8,281309
6309,0.000287,172.31.36.0-255,66,21988,8,281309
6310,0.000291,172.217.27.0-255,1484,23472,8,281309
6311,0.000293,172.31.36.0-255,66,23538,8,281309
6312,0.000297,172.217.27.0-255,2902,26440,8,281309
6313,0.0003,172.31.36.0-255,66,26506,8,281309
6314,0.000337,172.217.27.0-255,1484,27990,8,281309
6315,0.000339,172.31.36.0-255,66,28056,8,281309
6316,0.000342,172.217.27.0-255,1484,29540,8,281309
6317,0.000344,172.31.36.0-255,66,29606,8,281309
6318,0.000364,172.217.27.0-255,2902,32508,8,281309
6319,0.000371,172.31.36.0-255,66,32574,8,281309
6320,0.000374,172.217.27.0-255,1484,34058,8,281309
6321,0.000376,172.31.36.0-255,66,34124,8,281309
6322,0.00038,172.217.27.0-255,1125,35249,8,281309
6323,0.000382,172.31.36.0-255,66,35315,8,281309
6324,0.000422,172.217.27.0-255,1484,36799,8,281309
6325,0.000424,172.31.36.0-255,66,36865,8,281309
6326,0.00043,172.217.27.0-255,2902,39767,8,281309
6327,0.000433,172.31.36.0-255,66,39833,8,281309
6328,0.000456,172.217.27.0-255,1484,41317,8,281309
6329,0.000468,172.217.27.0-255,5738,47055,8,281309
6330,0.000471,172.31.36.0-255,66,47121,8,281309
6331,0.000497,172.217.27.0-255,5668,52789,8,281309
6332,0.0005,172.31.36.0-255,66,52855,8,281309
6333,0.001204,172.217.27.0-255,131,52986,8,281309
6334,0.001345,172.217.27.0-255,1484,54470,8,281309
6335,0.001351,172.31.36.0-255,66,54536,8,281309
6336,0.001358,172.217.27.0-255,2902,57438,8,281309
6337,0.00136,172.31.36.0-255,66,57504,8,281309
6338,0.001365,172.217.27.0-255,2902,60406,8,281309
6339,0.001372,172.31.36.0-255,66,60472,8,281309
6340,0.001385,172.217.27.0-255,2902,63374,8,281309
6341,0.001388,172.31.36.0-255,66,63440,8,281309
6342,0.001421,172.31.36.0-255,66,63506,8,281309
6343,0.001451,172.217.27.0-255,3961,67467,8,281309
6344,0.001454,172.31.36.0-255,66,67533,8,281309
6345,0.001462,172.217.27.0-255,7156,74689,8,281309
6346,0.001465,172.31.36.0-255,66,74755,8,281309
6347,0.001473,172.217.27.0-255,2543,77298,8,281309
6348,0.001475,172.31.36.0-255,66,77364,8,281309
6349,0.001679,172.217.27.0-255,1484,78848,8,281309
6350,0.001685,172.217.27.0-255,2902,81750,8,281309
6351,0.001689,172.31.36.0-255,66,81816,8,281309
6352,0.001733,172.217.27.0-255,5738,87554,8,281309
6353,0.001737,172.31.36.0-255,66,87620,8,281309
6354,0.001745,172.217.27.0-255,7156,94776,8,281309
6355,0.001747,172.31.36.0-255,66,94842,8,281309
6356,0.001763,172.31.36.0-255,66,94908,8,281309
6357,0.001766,172.217.27.0-255,1484,96392,8,281309
6358,0.001768,172.217.27.0-255,1484,97876,8,281309
6359,0.001771,172.31.36.0-255,66,97942,8,281309
6360,0.001774,172.217.27.0-255,1484,99426,8,281309
6361,0.001814,172.217.27.0-255,3602,103028,8,281309
6362,0.001818,172.31.36.0-255,66,103094,8,281309
6363,0.001873,172.217.27.0-255,1484,104578,8,281309
6364,0.001887,172.217.27.0-255,2902,107480,8,281309
6365,0.001891,172.31.36.0-255,66,107546,8,281309
6366,0.001898,172.217.27.0-255,5738,113284,8,281309
6367,0.001901,172.31.36.0-255,66,113350,8,281309
6368,0.001909,172.217.27.0-255,1484,114834,8,281309
6369,0.001935,172.217.27.0-255,2902,117736,8,281309
6370,0.001938,172.31.36.0-255,66,117802,8,281309
6371,0.001941,172.217.27.0-255,1484,119286,8,281309
6372,0.001943,172.31.36.0-255,78,119364,8,281309
6373,0.001949,172.217.27.0-255,4320,123684,8,281309
6374,0.001951,172.31.36.0-255,66,123750,8,281309
6375,0.001959,172.217.27.0-255,1484,125234,8,281309
6376,0.001964,172.217.27.0-255,2902,128136,8,281309
6377,0.001966,172.31.36.0-255,66,128202,8,281309
6378,0.00197,172.217.27.0-255,2902,131104,8,281309
6379,0.001972,172.31.36.0-255,66,131170,8,281309
6380,0.001978,172.217.27.0-255,4320,135490,8,281309
6381,0.001981,172.31.36.0-255,66,135556,8,281309
6382,0.002015,172.217.27.0-255,2184,137740,8,281309
6383,0.002018,172.31.36.0-255,66,137806,8,281309
6384,0.002165,172.217.27.0-255,1484,139290,8,281309
6385,0.002171,172.217.27.0-255,2902,142192,8,281309
6386,0.002174,172.31.36.0-255,66,142258,8,281309
6387,0.002179,172.217.27.0-255,2902,145160,8,281309
6388,0.00218,172.31.36.0-255,66,145226,8,281309
6389,0.002208,172.217.27.0-255,2902,148128,8,281309
6390,0.00221,172.31.36.0-255,66,148194,8,281309
6391,0.002223,172.31.36.0-255,66,148260,8,281309
6392,0.00224,172.31.36.0-255,66,148326,8,281309
6393,0.002314,172.31.36.0-255,66,148392,8,281309
6394,0.00232,172.217.27.0-255,5738,154130,8,281309
6395,0.002323,172.31.36.0-255,66,154196,8,281309
6396,0.002335,172.217.27.0-255,7156,161352,8,281309
6397,0.002337,172.31.36.0-255,66,161418,8,281309
6398,0.002349,172.31.36.0-255,66,161484,8,281309
6399,0.002379,172.217.27.0-255,2902,164386,8,281309
6400,0.002381,172.31.36.0-255,66,164452,8,281309
6401,0.002415,172.217.27.0-255,2902,167354,8,281309
6402,0.002418,172.31.36.0-255,66,167420,8,281309
6403,0.002426,172.217.27.0-255,7156,174576,8,281309
6404,0.002428,172.31.36.0-255,66,174642,8,281309
6405,0.002452,172.31.36.0-255,66,174708,8,281309
6406,0.002459,172.217.27.0-255,6438,181146,8,281309
6407,0.002462,172.31.36.0-255,66,181212,8,281309
6408,0.002509,172.217.27.0-255,1484,182696,8,281309
6409,0.002514,172.217.27.0-255,2902,185598,8,281309
6410,0.002517,172.31.36.0-255,66,185664,8,281309
6411,0.002522,172.217.27.0-255,2902,188566,8,281309
6412,0.002525,172.31.36.0-255,66,188632,8,281309
6413,0.002547,172.217.27.0-255,2902,191534,8,281309
6414,0.002549,172.31.36.0-255,66,191600,8,281309
6415,0.002565,172.31.36.0-255,66,191666,8,281309
6416,0.002578,172.31.36.0-255,66,191732,8,281309
6417,0.002582,172.217.27.0-255,2184,193916,8,281309
6418,0.002584,172.31.36.0-255,66,193982,8,281309
6419,0.003026,172.217.27.0-255,1484,195466,8,281309
6420,0.00303,172.217.27.0-255,1484,196950,8,281309
6421,0.003033,172.31.36.0-255,66,197016,8,281309
6422,0.003046,172.217.27.0-255,1484,198500,8,281309
6423,0.003055,172.217.27.0-255,4320,202820,8,281309
6424,0.003057,172.31.36.0-255,66,202886,8,281309
6425,0.00306,172.217.27.0-255,1484,204370,8,281309
6426,0.003092,172.217.27.0-255,7156,211526,8,281309
6427,0.003095,172.31.36.0-255,66,211592,8,281309
6428,0.003101,172.217.27.0-255,5738,217330,8,281309
6429,0.003102,172.31.36.0-255,66,217396,8,281309
6430,0.003112,172.217.27.0-255,5738,223134,8,281309
6431,0.003113,172.31.36.0-255,66,223200,8,281309
6432,0.003118,172.217.27.0-255,2902,226102,8,281309
6433,0.003119,172.31.36.0-255,66,226168,8,281309
6434,0.003155,172.217.27.0-255,2184,228352,8,281309
6435,0.003157,172.31.36.0-255,66,228418,8,281309
6436,0.003161,172.217.27.0-255,2902,231320,8,281309
6437,0.003163,172.31.36.0-255,66,231386,8,281309
6438,0.003166,172.217.27.0-255,1484,232870,8,281309
6439,0.003192,172.217.27.0-255,5738,238608,8,281309
6440,0.003208,172.31.36.0-255,66,238674,8,281309
6441,0.00322,172.31.36.0-255,66,238740,8,281309
6442,0.003237,172.31.36.0-255,66,238806,8,281309
6443,0.003537,172.217.27.0-255,1484,240290,8,281309
6444,0.003544,172.217.27.0-255,2902,243192,8,281309
6445,0.003548,172.31.36.0-255,66,243258,8,281309
6446,0.003555,172.217.27.0-255,5738,248996,8,281309
6447,0.003556,172.31.36.0-255,66,249062,8,281309
6448,0.003593,172.31.36.0-255,66,249128,8,281309
6449,0.003631,172.217.27.0-255,4320,253448,8,281309
6450,0.003633,172.31.36.0-255,66,253514,8,281309
6451,0.003658,172.217.27.0-255,4320,257834,8,281309
6452,0.00366,172.31.36.0-255,66,257900,8,281309
6453,0.003663,172.217.27.0-255,1484,259384,8,281309
6454,0.003667,172.217.27.0-255,3602,262986,8,281309
6455,0.003669,172.31.36.0-255,66,263052,8,281309
6456,0.003676,172.217.27.0-255,1484,264536,8,281309
6457,0.003679,172.217.27.0-255,2902,267438,8,281309
6458,0.003681,172.31.36.0-255,66,267504,8,281309
6459,0.003717,172.217.27.0-255,2902,270406,8,281309
6460,0.00372,172.31.36.0-255,66,270472,8,281309
6461,0.003744,172.217.27.0-255,2494,272966,8,281309
6462,0.003746,172.31.36.0-255,66,273032,8,281309
6463,0.003749,172.217.27.0-255,97,273129,8,281309
6464,0.003773,172.217.27.0-255,105,273234,8,281309
6465,0.009651,172.31.36.0-255,66,273300,8,281309
6466,0.00969,172.31.36.0-255,105,273405,8,281309
6467,0.011293,172.217.27.0-255,66,273471,8,281309
6468,0.038703,172.31.36.0-255,172,273643,8,281309
6469,0.038734,172.31.36.0-255,1112,274755,8,281309
6470,0.038798,172.31.36.0-255,1514,276269,8,281309
6471,0.0388,172.31.36.0-255,1514,277783,8,281309
6472,0.038806,172.31.36.0-255,1514,279297,8,281309
6473,0.038807,172.31.36.0-255,1514,280811,8,281309
6474,0.038825,172.31.36.0-255,168,280979,8,281309
6475,0.040253,104.244.42.0-255,66,281045,8,281309
6476,0.040402,104.244.42.0-255,66,281111,8,281309
6477,0.040408,104.244.42.0-255,66,281177,8,281309
6478,0.040412,104.244.42.0-255,66,281243,8,281309
6479,0.040415,104.244.42.0-255,66,281309,8,281309
6480,0.0,74.125.24.0-255,152,152,8,314639
6481,2.5e-05,172.31.36.0-255,66,218,8,314639
6482,3.3e-05,74.125.24.0-255,1484,1702,8,314639
6483,3.7e-05,172.31.36.0-255,66,1768,8,314639
6484,4.3e-05,74.125.24.0-255,2902,4670,8,314639
6485,4.7e-05,172.31.36.0-255,66,4736,8,314639
6486,6.4e-05,74.125.24.0-255,7156,11892,8,314639
6487,6.9e-05,172.31.36.0-255,66,11958,8,314639
6488,7.4e-05,74.125.24.0-255,2051,14009,8,314639
6489,7.6e-05,172.31.36.0-255,66,14075,8,314639
6490,0.000529,74.125.24.0-255,1484,15559,8,314639
6491,0.000535,172.31.36.0-255,66,15625,8,314639
6492,0.000542,74.125.24.0-255,2902,18527,8,314639
6493,0.000544,172.31.36.0-255,66,18593,8,314639
6494,0.000554,74.125.24.0-255,2902,21495,8,314639
6495,0.000556,172.31.36.0-255,66,21561,8,314639
6496,0.000564,74.125.24.0-255,7156,28717,8,314639
6497,0.000567,172.31.36.0-255,66,28783,8,314639
6498,0.000607,74.125.24.0-255,1484,30267,8,314639
6499,0.00061,172.31.36.0-255,66,30333,8,314639
6500,0.000651,172.31.36.0-255,66,30399,8,314639
6501,0.000667,172.31.36.0-255,66,30465,8,314639
6502,0.000678,74.125.24.0-255,5321,35786,8,314639
6503,0.00068,172.31.36.0-255,66,35852,8,314639
6504,0.000684,74.125.24.0-255,131,35983,8,314639
6505,0.000686,172.31.36.0-255,66,36049,8,314639
6506,0.000923,74.125.24.0-255,342,36391,8,314639
6507,0.000928,172.31.36.0-255,66,36457,8,314639
6508,0.001616,74.125.24.0-255,1484,37941,8,314639
6509,0.001623,172.31.36.0-255,66,38007,8,314639
6510,0.001633,74.125.24.0-255,2902,40909,8,314639
6511,0.001635,172.31.36.0-255,66,40975,8,314639
6512,0.001646,74.125.24.0-255,2902,43877,8,314639
6513,0.001649,172.31.36.0-255,66,43943,8,314639
6514,0.001689,74.125.24.0-255,7156,51099,8,314639
6515,0.001692,172.31.36.0-255,66,51165,8,314639
6516,0.001718,74.125.24.0-255,4320,55485,8,314639
6517,0.00172,172.31.36.0-255,66,55551,8,314639
6518,0.001758,172.31.36.0-255,66,55617,8,314639
6519,0.001766,74.125.24.0-255,6438,62055,8,314639
6520,0.001768,172.31.36.0-255,66,62121,8,314639
6521,0.001833,74.125.24.0-255,1484,63605,8,314639
6522,0.00184,74.125.24.0-255,2902,66507,8,314639
6523,0.001843,172.31.36.0-255,66,66573,8,314639
6524,0.001872,74.125.24.0-255,5738,72311,8,314639
6525,0.001875,172.31.36.0-255,66,72377,8,314639
6526,0.00191,172.31.36.0-255,66,72443,8,314639
6527,0.001943,74.125.24.0-255,4320,76763,8,314639
6528,0.001963,172.31.36.0-255,66,76829,8,314639
6529,0.001971,74.125.24.0-255,5738,82567,8,314639
6530,0.001974,172.31.36.0-255,66,82633,8,314639
6531,0.00198,74.125.24.0-255,5020,87653,8,314639
6532,0.001983,172.31.36.0-255,66,87719,8,314639
6533,0.002024,74.125.24.0-255,1484,89203,8,314639
6534,0.002028,74.125.24.0-255,1484,90687,8,314639
6535,0.00203,172.31.36.0-255,66,90753,8,314639
6536,0.002056,74.125.24.0-255,1484,92237,8,314639
6537,0.002063,74.125.24.0-255,5738,97975,8,314639
6538,0.002066,172.31.36.0-255,66,98041,8,314639
6539,0.002072,74.125.24.0-255,4320,102361,8,314639
6540,0.002075,172.31.36.0-255,66,102427,8,314639
6541,0.002082,74.125.24.0-255,7156,109583,8,314639
6542,0.002084,172.31.36.0-255,66,109649,8,314639
6543,0.002112,74.125.24.0-255,4320,113969,8,314639
6544,0.002114,172.31.36.0-255,66,114035,8,314639
6545,0.00212,74.125.24.0-255,2902,116937,8,314639
6546,0.002123,172.31.36.0-255,66,117003,8,314639
6547,0.002157,74.125.24.0-255,5020,122023,8,314639
6548,0.002159,172.31.36.0-255,66,122089,8,314639
6549,0.002183,74.125.24.0-255,1484,123573,8,314639
6550,0.002186,74.125.24.0-255,1484,125057,8,314639
6551,0.002188,172.31.36.0-255,66,125123,8,314639
6552,0.0022,74.125.24.0-255,1484,126607,8,314639
6553,0.002211,74.125.24.0-255,5738,132345,8,314639
6554,0.002214,172.31.36.0-255,66,132411,8,314639
6555,0.002218,74.125.24.0-255,2902,135313,8,314639
6556,0.00222,172.31.36.0-255,66,135379,8,314639
6557,0.002254,74.125.24.0-255,7156,142535,8,314639
6558,0.002262,172.31.36.0-255,66,142601,8,314639
6559,0.002265,74.125.24.0-255,1484,144085,8,314639
6560,0.002307,172.31.36.0-255,66,144151,8,314639
6561,0.002336,74.125.24.0-255,1484,145635,8,314639
6562,0.002341,74.125.24.0-255,2902,148537,8,314639
6563,0.002344,172.31.36.0-255,66,148603,8,314639
6564,0.002374,74.125.24.0-255,5738,154341,8,314639
6565,0.002378,172.31.36.0-255,66,154407,8,314639
6566,0.002383,74.125.24.0-255,2902,157309,8,314639
6567,0.002385,172.31.36.0-255,66,157375,8,314639
6568,0.002428,172.31.36.0-255,66,157441,8,314639
6569,0.002441,172.31.36.0-255,66,157507,8,314639
6570,0.005008,74.125.24.0-255,5738,163245,8,314639
6571,0.005015,172.31.36.0-255,66,163311,8,314639
6572,0.007589,74.125.24.0-255,4320,167631,8,314639
6573,0.007596,172.31.36.0-255,66,167697,8,314639
6574,0.007621,74.125.24.0-255,1484,169181,8,314639
6575,0.010168,74.125.24.0-255,4320,173501,8,314639
6576,0.010178,172.31.36.0-255,66,173567,8,314639
6577,0.012769,74.125.24.0-255,5738,179305,8,314639
6578,0.012776,172.31.36.0-255,66,179371,8,314639
6579,0.01536,74.125.24.0-255,5738,185109,8,314639
6580,0.015368,172.31.36.0-255,66,185175,8,314639
6581,0.018034,74.125.24.0-255,5738,190913,8,314639
6582,0.018044,172.31.36.0-255,66,190979,8,314639
6583,0.020621,74.125.24.0-255,5738,196717,8,314639
6584,0.020633,172.31.36.0-255,66,196783,8,314639
6585,0.023213,74.125.24.0-255,5738,202521,8,314639
6586,0.023222,172.31.36.0-255,66,202587,8,314639
6587,0.025813,74.125.24.0-255,5738,208325,8,314639
6588,0.025825,172.31.36.0-255,66,208391,8,314639
6589,0.028406,74.125.24.0-255,5738,214129,8,314639
6590,0.028414,172.31.36.0-255,66,214195,8,314639
6591,0.031001,74.125.24.0-255,5738,219933,8,314639
6592,0.031011,172.31.36.0-255,66,219999,8,314639
6593,0.033615,74.125.24.0-255,5738,225737,8,314639
6594,0.033625,172.31.36.0-255,66,225803,8,314639
6595,0.036216,74.125.24.0-255,5738,231541,8,314639
6596,0.036222,172.31.36.0-255,66,231607,8,314639
6597,0.038779,74.125.24.0-255,5738,237345,8,314639
6598,0.038787,172.31.36.0-255,66,237411,8,314639
6599,0.0414,74.125.24.0-255,5738,243149,8,314639
6600,0.041413,172.31.36.0-255,66,243215,8,314639
6601,0.044003,74.125.24.0-255,5738,248953,8,314639
6602,0.044018,172.31.36.0-255,66,249019,8,314639
6603,0.046615,74.125.24.0-255,5738,254757,8,314639
6604,0.046624,172.31.36.0-255,66,254823,8,314639
6605,0.047037,172.31.36.0-255,172,254995,8,314639
6606,0.047066,172.31.36.0-255,1112,256107,8,314639
6607,0.047136,172.31.36.0-255,1514,257621,8,314639
6608,0.047157,172.31.36.0-255,1514,259135,8,314639
6609,0.047161,172.31.36.0-255,1514,260649,8,314639
6610,0.047176,172.31.36.0-255,1514,262163,8,314639
6611,0.047184,172.31.36.0-255,1514,263677,8,314639
6612,0.047185,172.31.36.0-255,794,264471,8,314639
6613,0.048663,104.244.42.0-255,66,264537,8,314639
6614,0.048704,104.244.42.0-255,66,264603,8,314639
6615,0.048858,104.244.42.0-255,66,264669,8,314639
6616,0.048884,104.244.42.0-255,66,264735,8,314639
6617,0.048943,104.244.42.0-255,66,264801,8,314639
6618,0.04923,74.125.24.0-255,5738,270539,8,314639
6619,0.049238,172.31.36.0-255,66,270605,8,314639
6620,0.049661,104.244.42.0-255,108,270713,8,314639
6621,0.04967,172.31.36.0-255,66,270779,8,314639
6622,0.051817,74.125.24.0-255,1484,272263,8,314639
6623,0.051842,74.125.24.0-255,4320,276583,8,314639
6624,0.051846,172.31.36.0-255,66,276649,8,314639
6625,0.054466,74.125.24.0-255,5738,282387,8,314639
6626,0.054477,172.31.36.0-255,66,282453,8,314639
6627,0.057066,74.125.24.0-255,5738,288191,8,314639
6628,0.057072,172.31.36.0-255,66,288257,8,314639
6629,0.059667,74.125.24.0-255,5738,293995,8,314639
6630,0.059674,172.31.36.0-255,66,294061,8,314639
6631,0.062247,74.125.24.0-255,5738,299799,8,314639
6632,0.062255,172.31.36.0-255,66,299865,8,314639
6633,0.064828,74.125.24.0-255,2902,302767,8,314639
6634,0.064834,172.31.36.0-255,66,302833,8,314639
6635,0.064864,74.125.24.0-255,2902,305735,8,314639
6636,0.064867,172.31.36.0-255,66,305801,8,314639
6637,0.067415,74.125.24.0-255,2902,308703,8,314639
6638,0.067425,172.31.36.0-255,66,308769,8,314639
6639,0.067457,74.125.24.0-255,2902,311671,8,314639
6640,0.06746,172.31.36.0-255,66,311737,8,314639
6641,0.069992,74.125.24.0-255,2902,314639,8,314639
6642,0.0,74.125.24.0-255,153,153,8,281431
6643,4.2e-05,172.31.36.0-255,66,219,8,281431
6644,4.9e-05,74.125.24.0-255,1484,1703,8,281431
6645,5.3e-05,172.31.36.0-255,66,1769,8,281431
6646,5.7e-05,74.125.24.0-255,2902,4671,8,281431
6647,6e-05,172.31.36.0-255,66,4737,8,281431
6648,7.5e-05,74.125.24.0-255,7156,11893,8,281431
6649,7.8e-05,172.31.36.0-255,66,11959,8,281431
6650,8.1e-05,74.125.24.0-255,2076,14035,8,281431
6651,8.4e-05,172.31.36.0-255,66,14101,8,281431
6652,0.000116,172.31.36.0-255,66,14167,8,281431
6653,0.000151,74.125.24.0-255,2902,17069,8,281431
6654,0.000155,172.31.36.0-255,66,17135,8,281431
6655,0.000163,74.125.24.0-255,5379,22514,8,281431
6656,0.000165,172.31.36.0-255,66,22580,8,281431
6657,0.000295,74.125.24.0-255,1484,24064,8,281431
6658,0.000301,172.31.36.0-255,66,24130,8,281431
6659,0.000307,74.125.24.0-255,2902,27032,8,281431
6660,0.00031,172.31.36.0-255,66,27098,8,281431
6661,0.000349,74.125.24.0-255,5738,32836,8,281431
6662,0.000353,172.31.36.0-255,66,32902,8,281431
6663,0.000364,172.31.36.0-255,66,32968,8,281431
6664,0.000374,172.31.36.0-255,66,33034,8,281431
6665,0.000412,74.125.24.0-255,6797,39831,8,281431
6666,0.000416,172.31.36.0-255,66,39897,8,281431
6667,0.000419,74.125.24.0-255,364,40261,8,281431
6668,0.000421,172.31.36.0-255,66,40327,8,281431
6669,0.000424,74.125.24.0-255,414,40741,8,281431
6670,0.000427,172.31.36.0-255,66,40807,8,281431
6671,0.000691,74.125.24.0-255,1484,42291,8,281431
6672,0.00071,74.125.24.0-255,2902,45193,8,281431
6673,0.000714,172.31.36.0-255,66,45259,8,281431
6674,0.000717,74.125.24.0-255,1484,46743,8,281431
6675,0.000743,74.125.24.0-255,4320,51063,8,281431
6676,0.000746,172.31.36.0-255,66,51129,8,281431
6677,0.000754,74.125.24.0-255,7156,58285,8,281431
6678,0.000756,172.31.36.0-255,66,58351,8,281431
6679,0.000797,172.31.36.0-255,66,58417,8,281431
6680,0.000825,74.125.24.0-255,2902,61319,8,281431
6681,0.000828,172.31.36.0-255,66,61385,8,281431
6682,0.000833,74.125.24.0-255,2184,63569,8,281431
6683,0.000835,172.31.36.0-255,66,63635,8,281431
6684,0.000966,74.125.24.0-255,1484,65119,8,281431
6685,0.00098,74.125.24.0-255,2902,68021,8,281431
6686,0.000983,172.31.36.0-255,66,68087,8,281431
6687,0.000997,74.125.24.0-255,2902,70989,8,281431
6688,0.001,172.31.36.0-255,66,71055,8,281431
6689,0.001033,74.125.24.0-255,2902,73957,8,281431
6690,0.001036,172.31.36.0-255,66,74023,8,281431
6691,0.001053,172.31.36.0-255,66,74089,8,281431
6692,0.001092,172.31.36.0-255,66,74155,8,281431
6693,0.001146,74.125.24.0-255,1484,75639,8,281431
6694,0.001152,74.125.24.0-255,2902,78541,8,281431
6695,0.001155,172.31.36.0-255,66,78607,8,281431
6696,0.00116,74.125.24.0-255,4320,82927,8,281431
6697,0.001162,172.31.36.0-255,66,82993,8,281431
6698,0.001186,74.125.24.0-255,1484,84477,8,281431
6699,0.001192,74.125.24.0-255,4320,88797,8,281431
6700,0.001194,172.31.36.0-255,66,88863,8,281431
6701,0.001231,172.31.36.0-255,66,88929,8,281431
6702,0.001238,74.125.24.0-255,5738,94667,8,281431
6703,0.00124,172.31.36.0-255,66,94733,8,281431
6704,0.001278,74.125.24.0-255,5020,99753,8,281431
6705,0.001281,172.31.36.0-255,66,99819,8,281431
6706,0.001559,74.125.24.0-255,1484,101303,8,281431
6707,0.001565,74.125.24.0-255,2902,104205,8,281431
6708,0.001569,172.31.36.0-255,66,104271,8,281431
6709,0.001601,74.125.24.0-255,1484,105755,8,281431
6710,0.001619,74.125.24.0-255,4320,110075,8,281431
6711,0.001622,172.31.36.0-255,66,110141,8,281431
6712,0.001626,74.125.24.0-255,1484,111625,8,281431
6713,0.001666,172.31.36.0-255,66,111691,8,281431
6714,0.001672,74.125.24.0-255,5738,117429,8,281431
6715,0.001674,172.31.36.0-255,66,117495,8,281431
6716,0.001678,74.125.24.0-255,2902,120397,8,281431
6717,0.00168,172.31.36.0-255,66,120463,8,281431
6718,0.00172,74.125.24.0-255,4320,124783,8,281431
6719,0.001723,172.31.36.0-255,66,124849,8,281431
6720,0.001726,74.125.24.0-255,766,125615,8,281431
6721,0.001935,172.31.36.0-255,66,125681,8,281431
6722,0.002083,74.125.24.0-255,1484,127165,8,281431
6723,0.002105,74.125.24.0-255,2902,130067,8,281431
6724,0.00211,172.31.36.0-255,66,130133,8,281431
6725,0.002117,74.125.24.0-255,5738,135871,8,281431
6726,0.002119,172.31.36.0-255,66,135937,8,281431
6727,0.002125,74.125.24.0-255,5738,141675,8,281431
6728,0.002127,172.31.36.0-255,66,141741,8,281431
6729,0.002181,172.31.36.0-255,66,141807,8,281431
6730,0.002181,74.125.24.0-255,5020,146827,8,281431
6731,0.002184,172.31.36.0-255,66,146893,8,281431
6732,0.002187,74.125.24.0-255,4320,151213,8,281431
6733,0.002189,172.31.36.0-255,66,151279,8,281431
6734,0.002215,74.125.24.0-255,1484,152763,8,281431
6735,0.002239,172.31.36.0-255,66,152829,8,281431
6736,0.002246,74.125.24.0-255,5738,158567,8,281431
6737,0.002248,172.31.36.0-255,66,158633,8,281431
6738,0.002302,172.31.36.0-255,66,158699,8,281431
6739,0.002306,74.125.24.0-255,1484,160183,8,281431
6740,0.002345,172.31.36.0-255,66,160249,8,281431
6741,0.002359,172.31.36.0-255,66,160315,8,281431
6742,0.002383,74.125.24.0-255,1484,161799,8,281431
6743,0.002389,74.125.24.0-255,3602,165401,8,281431
6744,0.002391,172.31.36.0-255,66,165467,8,281431
6745,0.004734,74.125.24.0-255,5738,171205,8,281431
6746,0.004756,172.31.36.0-255,66,171271,8,281431
6747,0.007131,74.125.24.0-255,5738,177009,8,281431
6748,0.007145,172.31.36.0-255,66,177075,8,281431
6749,0.009473,74.125.24.0-255,5738,182813,8,281431
6750,0.009493,172.31.36.0-255,66,182879,8,281431
6751,0.011823,74.125.24.0-255,5738,188617,8,281431
6752,0.01183,172.31.36.0-255,66,188683,8,281431
6753,0.014156,74.125.24.0-255,5738,194421,8,281431
6754,0.01416,172.31.36.0-255,66,194487,8,281431
6755,0.016512,74.125.24.0-255,5738,200225,8,281431
6756,0.016518,172.31.36.0-255,66,200291,8,281431
6757,0.018882,74.125.24.0-255,5738,206029,8,281431
6758,0.018891,172.31.36.0-255,66,206095,8,281431
6759,0.021237,74.125.24.0-255,5738,211833,8,281431
6760,0.021246,172.31.36.0-255,66,211899,8,281431
6761,0.023574,74.125.24.0-255,5738,217637,8,281431
6762,0.023581,172.31.36.0-255,66,217703,8,281431
6763,0.025904,74.125.24.0-255,5738,223441,8,281431
6764,0.025909,172.31.36.0-255,66,223507,8,281431
6765,0.028215,74.125.24.0-255,5738,229245,8,281431
6766,0.028222,172.31.36.0-255,66,229311,8,281431
6767,0.030548,74.125.24.0-255,5738,235049,8,281431
6768,0.030555,172.31.36.0-255,66,235115,8,281431
6769,0.031597,172.31.36.0-255,172,235287,8,281431
6770,0.031629,172.31.36.0-255,1111,236398,8,281431
6771,0.031671,172.31.36.0-255,1514,237912,8,281431
6772,0.031692,172.31.36.0-255,1514,239426,8,281431
6773,0.031695,172.31.36.0-255,1514,240940,8,281431
6774,0.03171,172.31.36.0-255,1514,242454,8,281431
6775,0.031718,172.31.36.0-255,1514,243968,8,281431
6776,0.03172,172.31.36.0-255,875,244843,8,281431
6777,0.032855,74.125.24.0-255,5738,250581,8,281431
6778,0.032862,172.31.36.0-255,66,250647,8,281431
6779,0.033145,104.244.42.0-255,66,250713,8,281431
6780,0.033201,104.244.42.0-255,66,250779,8,281431
6781,0.033245,104.244.42.0-255,66,250845,8,281431
6782,0.03325,104.244.42.0-255,66,250911,8,281431
6783,0.034623,104.244.42.0-255,108,251019,8,281431
6784,0.034654,172.31.36.0-255,66,251085,8,281431
6785,0.035158,74.125.24.0-255,5738,256823,8,281431
6786,0.035164,172.31.36.0-255,66,256889,8,281431
6787,0.037481,74.125.24.0-255,5738,262627,8,281431
6788,0.03749,172.31.36.0-255,66,262693,8,281431
6789,0.039792,74.125.24.0-255,5738,268431,8,281431
6790,0.039838,172.31.36.0-255,66,268497,8,281431
6791,0.042146,74.125.24.0-255,5738,274235,8,281431
6792,0.042154,172.31.36.0-255,66,274301,8,281431
6793,0.044498,74.125.24.0-255,5738,280039,8,281431
6794,0.044508,172.31.36.0-255,66,280105,8,281431
6795,0.046801,74.125.24.0-255,981,281086,8,281431
6796,0.046958,172.31.36.0-255,66,281152,8,281431
6797,0.046988,172.31.36.0-255,105,281257,8,281431
6798,0.049257,74.125.24.0-255,66,281323,8,281431
6799,0.054558,172.31.36.0-255,108,281431,8,281431
6800,0.0,74.125.200.0-255,348,348,8,319495
6801,2.2e-05,172.31.36.0-255,66,414,8,319495
6802,2.9e-05,74.125.200.0-255,1484,1898,8,319495
6803,3.3e-05,172.31.36.0-255,66,1964,8,319495
6804,3.9e-05,74.125.200.0-255,4320,6284,8,319495
6805,4.3e-05,172.31.36.0-255,66,6350,8,319495
6806,5.5e-05,172.31.36.0-255,66,6416,8,319495
6807,6.1e-05,74.125.200.0-255,4320,10736,8,319495
6808,6.4e-05,172.31.36.0-255,66,10802,8,319495
6809,8.3e-05,74.125.200.0-255,4320,15122,8,319495
6810,8.6e-05,172.31.36.0-255,66,15188,8,319495
6811,9.2e-05,74.125.200.0-255,5738,20926,8,319495
6812,9.5e-05,172.31.36.0-255,66,20992,8,319495
6813,0.000136,74.125.200.0-255,2543,23535,8,319495
6814,0.000138,172.31.36.0-255,66,23601,8,319495
6815,0.000247,74.125.200.0-255,1484,25085,8,319495
6816,0.000252,172.31.36.0-255,66,25151,8,319495
6817,0.000289,74.125.200.0-255,2902,28053,8,319495
6818,0.000293,172.31.36.0-255,66,28119,8,319495
6819,0.000296,74.125.200.0-255,1484,29603,8,319495
6820,0.000298,172.31.36.0-255,66,29669,8,319495
6821,0.000303,74.125.200.0-255,2902,32571,8,319495
6822,0.000305,172.31.36.0-255,66,32637,8,319495
6823,0.000334,74.125.200.0-255,5738,38375,8,319495
6824,0.000337,172.31.36.0-255,66,38441,8,319495
6825,0.000341,74.125.200.0-255,2543,40984,8,319495
6826,0.000343,172.31.36.0-255,66,41050,8,319495
6827,0.00037,74.125.200.0-255,2902,43952,8,319495
6828,0.000373,172.31.36.0-255,66,44018,8,319495
6829,0.000391,74.125.200.0-255,4320,48338,8,319495
6830,0.000394,172.31.36.0-255,66,48404,8,319495
6831,0.000416,74.125.200.0-255,5738,54142,8,319495
6832,0.000418,172.31.36.0-255,66,54208,8,319495
6833,0.000434,74.125.200.0-255,1484,55692,8,319495
6834,0.000452,74.125.200.0-255,2817,58509,8,319495
6835,0.000454,172.31.36.0-255,66,58575,8,319495
6836,0.000465,74.125.200.0-255,381,58956,8,319495
6837,0.000585,74.125.200.0-255,1484,60440,8,319495
6838,0.000589,172.31.36.0-255,66,60506,8,319495
6839,0.000605,74.125.200.0-255,2902,63408,8,319495
6840,0.000609,172.31.36.0-255,66,63474,8,319495
6841,0.000636,74.125.200.0-255,5738,69212,8,319495
6842,0.000638,172.31.36.0-255,66,69278,8,319495
6843,0.000641,74.125.200.0-255,1484,70762,8,319495
6844,0.000644,74.125.200.0-255,1484,72246,8,319495
6845,0.000646,172.31.36.0-255,66,72312,8,319495
6846,0.000661,74.125.200.0-255,1484,73796,8,319495
6847,0.000696,74.125.200.0-255,2902,76698,8,319495
6848,0.000699,172.31.36.0-255,66,76764,8,319495
6849,0.000721,74.125.200.0-255,2543,79307,8,319495
6850,0.000723,172.31.36.0-255,66,79373,8,319495
6851,0.00073,74.125.200.0-255,5738,85111,8,319495
6852,0.000732,172.31.36.0-255,66,85177,8,319495
6853,0.000746,74.125.200.0-255,2902,88079,8,319495
6854,0.000749,172.31.36.0-255,66,88145,8,319495
6855,0.000769,74.125.200.0-255,5379,93524,8,319495
6856,0.000771,172.31.36.0-255,66,93590,8,319495
6857,0.000792,74.125.200.0-255,1484,95074,8,319495
6858,0.000812,74.125.200.0-255,2902,97976,8,319495
6859,0.000815,172.31.36.0-255,66,98042,8,319495
6860,0.000837,74.125.200.0-255,5738,103780,8,319495
6861,0.00084,172.31.36.0-255,66,103846,8,319495
6862,0.000845,74.125.200.0-255,4320,108166,8,319495
6863,0.000847,172.31.36.0-255,66,108232,8,319495
6864,0.000852,74.125.200.0-255,4320,112552,8,319495
6865,0.000855,172.31.36.0-255,66,112618,8,319495
6866,0.000876,74.125.200.0-255,1484,114102,8,319495
6867,0.000892,172.31.36.0-255,66,114168,8,319495
6868,0.000897,74.125.200.0-255,2184,116352,8,319495
6869,0.000899,172.31.36.0-255,66,116418,8,319495
6870,0.000984,74.125.200.0-255,1484,117902,8,319495
6871,0.000988,74.125.200.0-255,1484,119386,8,319495
6872,0.00099,172.31.36.0-255,66,119452,8,319495
6873,0.001009,74.125.200.0-255,1484,120936,8,319495
6874,0.001015,74.125.200.0-255,5738,126674,8,319495
6875,0.001018,172.31.36.0-255,66,126740,8,319495
6876,0.001041,74.125.200.0-255,2902,129642,8,319495
6877,0.001044,172.31.36.0-255,66,129708,8,319495
6878,0.001077,172.31.36.0-255,66,129774,8,319495
6879,0.001084,74.125.200.0-255,5738,135512,8,319495
6880,0.001086,172.31.36.0-255,66,135578,8,319495
6881,0.001109,74.125.200.0-255,5020,140598,8,319495
6882,0.001111,172.31.36.0-255,66,140664,8,319495
6883,0.001141,74.125.200.0-255,5738,146402,8,319495
6884,0.001157,172.31.36.0-255,66,146468,8,319495
6885,0.001162,74.125.200.0-255,1484,147952,8,319495
6886,0.00118,74.125.200.0-255,2902,150854,8,319495
6887,0.001183,172.31.36.0-255,66,150920,8,319495
6888,0.00119,74.125.200.0-255,5738,156658,8,319495
6889,0.001192,172.31.36.0-255,66,156724,8,319495
6890,0.001221,172.31.36.0-255,66,156790,8,319495
6891,0.001257,74.125.200.0-255,2902,159692,8,319495
6892,0.00126,172.31.36.0-255,66,159758,8,319495
6893,0.001277,74.125.200.0-255,3602,163360,8,319495
6894,0.001279,172.31.36.0-255,66,163426,8,319495
6895,0.001361,74.125.200.0-255,1484,164910,8,319495
6896,0.001367,74.125.200.0-255,2902,167812,8,319495
6897,0.00137,172.31.36.0-255,66,167878,8,319495
6898,0.001391,74.125.200.0-255,5738,173616,8,319495
6899,0.00141,74.125.200.0-255,4320,177936,8,319495
6900,0.001428,74.125.200.0-255,1994,179930,8,319495
6901,0.001435,74.125.200.0-255,7156,187086,8,319495
6902,0.001439,172.31.36.0-255,66,187152,8,319495
6903,0.00145,172.31.36.0-255,66,187218,8,319495
6904,0.001458,74.125.200.0-255,1484,188702,8,319495
6905,0.001496,74.125.200.0-255,4320,193022,8,319495
6906,0.0015,172.31.36.0-255,66,193088,8,319495
6907,0.001544,172.31.36.0-255,66,193154,8,319495
6908,0.001589,74.125.200.0-255,1484,194638,8,319495
6909,0.001593,74.125.200.0-255,1484,196122,8,319495
6910,0.001603,74.125.200.0-255,1484,197606,8,319495
6911,0.001605,74.125.200.0-255,1484,199090,8,319495
6912,0.001615,172.31.36.0-255,66,199156,8,319495
6913,0.001626,74.125.200.0-255,4320,203476,8,319495
6914,0.001641,172.31.36.0-255,66,203542,8,319495
6915,0.001649,74.125.200.0-255,7156,210698,8,319495
6916,0.001651,74.125.200.0-255,1484,212182,8,319495
6917,0.001664,74.125.200.0-255,2902,215084,8,319495
6918,0.001685,74.125.200.0-255,5738,220822,8,319495
6919,0.001688,172.31.36.0-255,66,220888,8,319495
6920,0.001702,172.31.36.0-255,66,220954,8,319495
6921,0.001729,74.125.200.0-255,6438,227392,8,319495
6922,0.00174,172.31.36.0-255,66,227458,8,319495
6923,0.001806,74.125.200.0-255,1484,228942,8,319495
6924,0.001824,74.125.200.0-255,2902,231844,8,319495
6925,0.001831,74.125.200.0-255,5738,237582,8,319495
6926,0.001847,172.31.36.0-255,66,237648,8,319495
6927,0.001864,74.125.200.0-255,5738,243386,8,319495
6928,0.001874,172.31.36.0-255,66,243452,8,319495
6929,0.001886,74.125.200.0-255,7156,250608,8,319495
6930,0.001892,172.31.36.0-255,66,250674,8,319495
6931,0.001922,74.125.200.0-255,4320,254994,8,319495
6932,0.001927,172.31.36.0-255,66,255060,8,319495
6933,0.001939,74.125.200.0-255,6438,261498,8,319495
6934,0.001986,74.125.200.0-255,1484,262982,8,319495
6935,0.001992,74.125.200.0-255,2902,265884,8,319495
6936,0.001995,74.125.200.0-255,1484,267368,8,319495
6937,0.002007,74.125.200.0-255,4320,271688,8,319495
6938,0.002017,172.31.36.0-255,66,271754,8,319495
6939,0.002032,74.125.200.0-255,5738,277492,8,319495
6940,0.00204,74.125.200.0-255,7156,284648,8,319495
6941,0.002065,74.125.200.0-255,4320,288968,8,319495
6942,0.002069,172.31.36.0-255,66,289034,8,319495
6943,0.002074,172.31.36.0-255,66,289100,8,319495
6944,0.002092,74.125.200.0-255,6438,295538,8,319495
6945,0.002108,74.125.200.0-255,2902,298440,8,319495
6946,0.002124,74.125.200.0-255,7156,305596,8,319495
6947,0.002134,172.31.36.0-255,66,305662,8,319495
6948,0.002137,74.125.200.0-255,1484,307146,8,319495
6949,0.002142,74.125.200.0-255,4320,311466,8,319495
6950,0.002147,172.31.36.0-255,66,311532,8,319495
6951,0.002202,172.31.36.0-255,66,311598,8,319495
6952,0.002218,172.31.36.0-255,66,311664,8,319495
6953,0.002222,74.125.200.0-255,1484,313148,8,319495
6954,0.002233,74.125.200.0-255,1484,314632,8,319495
6955,0.002271,172.31.36.0-255,66,314698,8,319495
6956,0.002303,74.125.200.0-255,105,314803,8,319495
6957,0.002321,172.31.36.0-255,66,314869,8,319495
6958,0.010409,172.31.36.0-255,101,314970,8,319495
6959,0.010749,172.31.36.0-255,105,315075,8,319495
6960,0.012708,74.125.200.0-255,66,315141,8,319495
6961,0.013024,74.125.200.0-255,66,315207,8,319495
6962,0.035595,172.31.36.0-255,172,315379,8,319495
6963,0.035631,172.31.36.0-255,1112,316491,8,319495
6964,0.035696,172.31.36.0-255,1514,318005,8,319495
6965,0.035698,172.31.36.0-255,1292,319297,8,319495
6966,0.037166,104.244.42.0-255,66,319363,8,319495
6967,0.037205,104.244.42.0-255,66,319429,8,319495
6968,0.037249,104.244.42.0-255,66,319495,8,319495
6969,0.0,74.125.24.0-255,152,152,8,324342
6970,2.2e-05,172.31.36.0-255,66,218,8,324342
6971,3e-05,74.125.24.0-255,1484,1702,8,324342
6972,3.5e-05,172.31.36.0-255,66,1768,8,324342
6973,4.2e-05,74.125.24.0-255,2902,4670,8,324342
6974,4.5e-05,172.31.36.0-255,66,4736,8,324342
6975,5.3e-05,74.125.24.0-255,5738,10474,8,324342
6976,5.6e-05,172.31.36.0-255,66,10540,8,324342
6977,6.1e-05,74.125.24.0-255,2902,13442,8,324342
6978,6.4e-05,172.31.36.0-255,66,13508,8,324342
6979,0.000101,172.31.36.0-255,66,13574,8,324342
6980,0.00018,74.125.24.0-255,6797,20371,8,324342
6981,0.000183,172.31.36.0-255,66,20437,8,324342
6982,0.000277,74.125.24.0-255,1484,21921,8,324342
6983,0.000282,172.31.36.0-255,66,21987,8,324342
6984,0.000288,74.125.24.0-255,2902,24889,8,324342
6985,0.00029,172.31.36.0-255,66,24955,8,324342
6986,0.00032,74.125.24.0-255,5738,30693,8,324342
6987,0.000323,172.31.36.0-255,66,30759,8,324342
6988,0.000328,74.125.24.0-255,2902,33661,8,324342
6989,0.00033,172.31.36.0-255,66,33727,8,324342
6990,0.00035,74.125.24.0-255,3961,37688,8,324342
6991,0.000352,172.31.36.0-255,66,37754,8,324342
6992,0.000416,74.125.24.0-255,2902,40656,8,324342
6993,0.000419,172.31.36.0-255,66,40722,8,324342
6994,0.00044,74.125.24.0-255,4320,45042,8,324342
6995,0.000443,172.31.36.0-255,66,45108,8,324342
6996,0.000479,74.125.24.0-255,2902,48010,8,324342
6997,0.000482,172.31.36.0-255,66,48076,8,324342
6998,0.000503,74.125.24.0-255,6797,54873,8,324342
6999,0.000506,172.31.36.0-255,66,54939,8,324342
7000,0.000905,74.125.24.0-255,647,55586,8,324342
7001,0.001082,74.125.24.0-255,1484,57070,8,324342
7002,0.001087,172.31.36.0-255,66,57136,8,324342
7003,0.001093,74.125.24.0-255,2902,60038,8,324342
7004,0.001105,74.125.24.0-255,1484,61522,8,324342
7005,0.001109,172.31.36.0-255,66,61588,8,324342
7006,0.001127,74.125.24.0-255,4320,65908,8,324342
7007,0.001153,74.125.24.0-255,4320,70228,8,324342
7008,0.001156,172.31.36.0-255,66,70294,8,324342
7009,0.001181,172.31.36.0-255,66,70360,8,324342
7010,0.00122,74.125.24.0-255,7156,77516,8,324342
7011,0.001234,74.125.24.0-255,1484,79000,8,324342
7012,0.001248,172.31.36.0-255,66,79066,8,324342
7013,0.001281,74.125.24.0-255,2184,81250,8,324342
7014,0.001285,172.31.36.0-255,66,81316,8,324342
7015,0.001301,74.125.24.0-255,1484,82800,8,324342
7016,0.001321,74.125.24.0-255,5738,88538,8,324342
7017,0.001338,74.125.24.0-255,5738,94276,8,324342
7018,0.001342,172.31.36.0-255,66,94342,8,324342
7019,0.001346,172.31.36.0-255,66,94408,8,324342
7020,0.00138,74.125.24.0-255,5738,100146,8,324342
7021,0.001389,172.31.36.0-255,66,100212,8,324342
7022,0.001423,172.31.36.0-255,66,100278,8,324342
7023,0.001524,74.125.24.0-255,4320,104598,8,324342
7024,0.001536,172.31.36.0-255,66,104664,8,324342
7025,0.00157,172.31.36.0-255,66,104730,8,324342
7026,0.00158,74.125.24.0-255,4320,109050,8,324342
7027,0.001584,172.31.36.0-255,66,109116,8,324342
7028,0.001704,74.125.24.0-255,5020,114136,8,324342
7029,0.001716,172.31.36.0-255,66,114202,8,324342
7030,0.001731,74.125.24.0-255,2902,117104,8,324342
7031,0.001739,172.31.36.0-255,66,117170,8,324342
7032,0.001752,74.125.24.0-255,2902,120072,8,324342
7033,0.001759,172.31.36.0-255,66,120138,8,324342
7034,0.001772,74.125.24.0-255,4320,124458,8,324342
7035,0.001786,172.31.36.0-255,66,124524,8,324342
7036,0.0018,172.31.36.0-255,66,124590,8,324342
7037,0.001885,172.31.36.0-255,66,124656,8,324342
7038,0.00189,74.125.24.0-255,3602,128258,8,324342
7039,0.001903,172.31.36.0-255,66,128324,8,324342
7040,0.001985,74.125.24.0-255,1484,129808,8,324342
7041,0.001989,74.125.24.0-255,1484,131292,8,324342
7042,0.002001,74.125.24.0-255,1484,132776,8,324342
7043,0.002004,74.125.24.0-255,1484,134260,8,324342
7044,0.002009,172.31.36.0-255,66,134326,8,324342
7045,0.002028,74.125.24.0-255,4320,138646,8,324342
7046,0.002043,74.125.24.0-255,4320,142966,8,324342
7047,0.002052,172.31.36.0-255,66,143032,8,324342
7048,0.002084,172.31.36.0-255,66,143098,8,324342
7049,0.002122,74.125.24.0-255,1484,144582,8,324342
7050,0.002148,74.125.24.0-255,5738,150320,8,324342
7051,0.002163,172.31.36.0-255,66,150386,8,324342
7052,0.002182,74.125.24.0-255,3602,153988,8,324342
7053,0.002199,172.31.36.0-255,66,154054,8,324342
7054,0.004489,74.125.24.0-255,5738,159792,8,324342
7055,0.004495,172.31.36.0-255,66,159858,8,324342
7056,0.006748,74.125.24.0-255,5738,165596,8,324342
7057,0.008047,172.31.36.0-255,66,165662,8,324342
7058,0.010347,74.125.24.0-255,5738,171400,8,324342
7059,0.010354,172.31.36.0-255,66,171466,8,324342
7060,0.012627,74.125.24.0-255,5738,177204,8,324342
7061,0.012879,172.31.36.0-255,66,177270,8,324342
7062,0.015139,74.125.24.0-255,5738,183008,8,324342
7063,0.015147,172.31.36.0-255,66,183074,8,324342
7064,0.017434,74.125.24.0-255,5738,188812,8,324342
7065,0.017442,172.31.36.0-255,66,188878,8,324342
7066,0.019701,74.125.24.0-255,5738,194616,8,324342
7067,0.019709,172.31.36.0-255,66,194682,8,324342
7068,0.021982,74.125.24.0-255,5738,200420,8,324342
7069,0.02199,172.31.36.0-255,66,200486,8,324342
7070,0.02427,74.125.24.0-255,5738,206224,8,324342
7071,0.024277,172.31.36.0-255,66,206290,8,324342
7072,0.026519,74.125.24.0-255,5738,212028,8,324342
7073,0.026526,172.31.36.0-255,66,212094,8,324342
7074,0.028781,74.125.24.0-255,5738,217832,8,324342
7075,0.028787,172.31.36.0-255,66,217898,8,324342
7076,0.028848,172.31.36.0-255,172,218070,8,324342
7077,0.028873,172.31.36.0-255,1111,219181,8,324342
7078,0.028975,172.31.36.0-255,1514,220695,8,324342
7079,0.028977,172.31.36.0-255,1514,222209,8,324342
7080,0.028978,172.31.36.0-255,1514,223723,8,324342
7081,0.028979,172.31.36.0-255,1514,225237,8,324342
7082,0.02898,172.31.36.0-255,1358,226595,8,324342
7083,0.030406,104.244.42.0-255,66,226661,8,324342
7084,0.030444,104.244.42.0-255,66,226727,8,324342
7085,0.030553,104.244.42.0-255,66,226793,8,324342
7086,0.030557,104.244.42.0-255,66,226859,8,324342
7087,0.031087,74.125.24.0-255,5738,232597,8,324342
7088,0.031095,172.31.36.0-255,66,232663,8,324342
7089,0.031251,172.31.36.0-255,101,232764,8,324342
7090,0.033387,74.125.24.0-255,5738,238502,8,324342
7091,0.033393,172.31.36.0-255,66,238568,8,324342
7092,0.033511,74.125.24.0-255,66,238634,8,324342
7093,0.035721,74.125.24.0-255,5738,244372,8,324342
7094,0.035726,172.31.36.0-255,66,244438,8,324342
7095,0.038038,74.125.24.0-255,5738,250176,8,324342
7096,0.038043,172.31.36.0-255,66,250242,8,324342
7097,0.040349,74.125.24.0-255,5738,255980,8,324342
7098,0.040355,172.31.36.0-255,66,256046,8,324342
7099,0.042641,74.125.24.0-255,5738,261784,8,324342
7100,0.042647,172.31.36.0-255,66,261850,8,324342
7101,0.044926,74.125.24.0-255,5738,267588,8,324342
7102,0.044932,172.31.36.0-255,66,267654,8,324342
7103,0.047236,74.125.24.0-255,5738,273392,8,324342
7104,0.047245,172.31.36.0-255,66,273458,8,324342
7105,0.049538,74.125.24.0-255,5738,279196,8,324342
7106,0.049545,172.31.36.0-255,66,279262,8,324342
7107,0.051841,74.125.24.0-255,5738,285000,8,324342
7108,0.051847,172.31.36.0-255,66,285066,8,324342
7109,0.054131,74.125.24.0-255,5738,290804,8,324342
7110,0.05414,172.31.36.0-255,66,290870,8,324342
7111,0.056423,74.125.24.0-255,4320,295190,8,324342
7112,0.05643,172.31.36.0-255,66,295256,8,324342
7113,0.05645,74.125.24.0-255,1484,296740,8,324342
7114,0.058724,74.125.24.0-255,4320,301060,8,324342
7115,0.058731,172.31.36.0-255,66,301126,8,324342
7116,0.061027,74.125.24.0-255,5738,306864,8,324342
7117,0.061409,172.31.36.0-255,66,306930,8,324342
7118,0.063681,74.125.24.0-255,5738,312668,8,324342
7119,0.063687,172.31.36.0-255,66,312734,8,324342
7120,0.065956,74.125.24.0-255,5738,318472,8,324342
7121,0.065963,172.31.36.0-255,66,318538,8,324342
7122,0.068283,74.125.24.0-255,5738,324276,8,324342
7123,0.068289,172.31.36.0-255,66,324342,8,324342
7124,0.0,74.125.24.0-255,66,66,8,66
7125,0.0,172.217.194.0-255,146,146,8,157894
7126,2.3e-05,172.31.36.0-255,66,212,8,157894
7127,3.1e-05,172.217.194.0-255,1484,1696,8,157894
7128,3.6e-05,172.31.36.0-255,66,1762,8,157894
7129,5.1e-05,172.217.194.0-255,2902,4664,8,157894
7130,5.5e-05,172.31.36.0-255,66,4730,8,157894
7131,6.2e-05,172.217.194.0-255,5738,10468,8,157894
7132,6.5e-05,172.31.36.0-255,66,10534,8,157894
7133,7.9e-05,172.31.36.0-255,66,10600,8,157894
7134,8.5e-05,172.217.194.0-255,6797,17397,8,157894
7135,8.9e-05,172.31.36.0-255,66,17463,8,157894
7136,0.000139,172.217.194.0-255,1484,18947,8,157894
7137,0.000142,172.31.36.0-255,66,19013,8,157894
7138,0.000148,172.217.194.0-255,2902,21915,8,157894
7139,0.00015,172.31.36.0-255,66,21981,8,157894
7140,0.000153,172.217.194.0-255,1484,23465,8,157894
7141,0.000155,172.31.36.0-255,66,23531,8,157894
7142,0.000184,172.217.194.0-255,4320,27851,8,157894
7143,0.000192,172.31.36.0-255,66,27917,8,157894
7144,0.000205,172.31.36.0-255,66,27983,8,157894
7145,0.000265,172.31.36.0-255,66,28049,8,157894
7146,0.000268,172.217.194.0-255,366,28415,8,157894
7147,0.000269,172.31.36.0-255,66,28481,8,157894
7148,0.000354,172.217.194.0-255,1484,29965,8,157894
7149,0.000358,172.31.36.0-255,66,30031,8,157894
7150,0.000364,172.217.194.0-255,2902,32933,8,157894
7151,0.000366,172.31.36.0-255,66,32999,8,157894
7152,0.000369,172.217.194.0-255,1484,34483,8,157894
7153,0.000375,172.31.36.0-255,66,34549,8,157894
7154,0.00039,172.217.194.0-255,4320,38869,8,157894
7155,0.000396,172.217.194.0-255,4320,43189,8,157894
7156,0.000481,172.217.194.0-255,1484,44673,8,157894
7157,0.000494,172.217.194.0-255,2902,47575,8,157894
7158,0.000514,172.217.194.0-255,5738,53313,8,157894
7159,0.000579,172.217.194.0-255,2902,56215,8,157894
7160,0.000665,172.31.36.0-255,66,56281,8,157894
7161,0.000843,172.217.194.0-255,1484,57765,8,157894
7162,0.00085,172.217.194.0-255,2902,60667,8,157894
7163,0.000855,172.217.194.0-255,4320,64987,8,157894
7164,0.000872,172.31.36.0-255,66,65053,8,157894
7165,0.000876,172.217.194.0-255,1484,66537,8,157894
7166,0.000883,172.217.194.0-255,7156,73693,8,157894
7167,0.000889,172.31.36.0-255,66,73759,8,157894
7168,0.000917,172.217.194.0-255,5738,79497,8,157894
7169,0.000933,172.31.36.0-255,66,79563,8,157894
7170,0.000969,172.31.36.0-255,66,79629,8,157894
7171,0.001693,172.217.194.0-255,1484,81113,8,157894
7172,0.001709,172.217.194.0-255,2902,84015,8,157894
7173,0.001713,172.31.36.0-255,66,84081,8,157894
7174,0.001718,172.217.194.0-255,2902,86983,8,157894
7175,0.001743,172.217.194.0-255,2902,89885,8,157894
7176,0.00175,172.217.194.0-255,5738,95623,8,157894
7177,0.001763,172.217.194.0-255,2902,98525,8,157894
7178,0.001767,172.31.36.0-255,66,98591,8,157894
7179,0.001775,172.31.36.0-255,66,98657,8,157894
7180,0.001795,172.217.194.0-255,5020,103677,8,157894
7181,0.001837,172.31.36.0-255,66,103743,8,157894
7182,0.001845,172.217.194.0-255,7156,110899,8,157894
7183,0.00185,172.31.36.0-255,66,110965,8,157894
7184,0.001892,172.217.194.0-255,5738,116703,8,157894
7185,0.001899,172.31.36.0-255,66,116769,8,157894
7186,0.001973,172.31.36.0-255,66,116835,8,157894
7187,0.002075,172.217.194.0-255,1484,118319,8,157894
7188,0.00208,172.217.194.0-255,2902,121221,8,157894
7189,0.002083,172.217.194.0-255,1484,122705,8,157894
7190,0.002093,172.31.36.0-255,66,122771,8,157894
7191,0.002108,172.217.194.0-255,4320,127091,8,157894
7192,0.002144,172.217.194.0-255,2902,129993,8,157894
7193,0.002173,172.217.194.0-255,4320,134313,8,157894
7194,0.00219,172.217.194.0-255,7156,141469,8,157894
7195,0.002192,172.217.194.0-255,1484,142953,8,157894
7196,0.002241,172.217.194.0-255,1484,144437,8,157894
7197,0.002399,172.217.194.0-255,3602,148039,8,157894
7198,0.002482,172.217.194.0-255,5595,153634,8,157894
7199,0.007618,172.31.36.0-255,66,153700,8,157894
7200,0.00979,172.31.36.0-255,105,153805,8,157894
7201,0.012398,172.217.194.0-255,66,153871,8,157894
7202,0.042537,172.31.36.0-255,172,154043,8,157894
7203,0.042571,172.31.36.0-255,1109,155152,8,157894
7204,0.042678,172.31.36.0-255,1514,156666,8,157894
7205,0.042681,172.31.36.0-255,1030,157696,8,157894
7206,0.044093,104.244.42.0-255,66,157762,8,157894
7207,0.044147,104.244.42.0-255,66,157828,8,157894
7208,0.044224,104.244.42.0-255,66,157894,8,157894
7209,0.0,74.125.24.0-255,153,153,8,209955
7210,2.4e-05,172.31.36.0-255,66,219,8,209955
7211,3.2e-05,74.125.24.0-255,1484,1703,8,209955
7212,3.6e-05,172.31.36.0-255,66,1769,8,209955
7213,4.2e-05,74.125.24.0-255,2902,4671,8,209955
7214,5.5e-05,172.31.36.0-255,66,4737,8,209955
7215,6.1e-05,74.125.24.0-255,4320,9057,8,209955
7216,6.4e-05,172.31.36.0-255,66,9123,8,209955
7217,7.2e-05,74.125.24.0-255,4863,13986,8,209955
7218,7.5e-05,172.31.36.0-255,66,14052,8,209955
7219,0.00019,74.125.24.0-255,1484,15536,8,209955
7220,0.000194,172.31.36.0-255,66,15602,8,209955
7221,0.000201,74.125.24.0-255,2902,18504,8,209955
7222,0.000203,172.31.36.0-255,66,18570,8,209955
7223,0.000237,74.125.24.0-255,4320,22890,8,209955
7224,0.00024,172.31.36.0-255,66,22956,8,209955
7225,0.000246,74.125.24.0-255,4320,27276,8,209955
7226,0.000248,172.31.36.0-255,66,27342,8,209955
7227,0.00027,74.125.24.0-255,1484,28826,8,209955
7228,0.000272,172.31.36.0-255,66,28892,8,209955
7229,0.000277,74.125.24.0-255,2543,31435,8,209955
7230,0.00028,172.31.36.0-255,66,31501,8,209955
7231,0.000571,74.125.24.0-255,1484,32985,8,209955
7232,0.000578,172.31.36.0-255,66,33051,8,209955
7233,0.000584,74.125.24.0-255,2902,35953,8,209955
7234,0.000587,172.31.36.0-255,66,36019,8,209955
7235,0.000599,74.125.24.0-255,5738,41757,8,209955
7236,0.000601,172.31.36.0-255,66,41823,8,209955
7237,0.000647,172.31.36.0-255,66,41889,8,209955
7238,0.000659,172.31.36.0-255,66,41955,8,209955
7239,0.0011,74.125.24.0-255,646,42601,8,209955
7240,0.001171,172.31.36.0-255,66,42667,8,209955
7241,0.001307,74.125.24.0-255,1484,44151,8,209955
7242,0.001345,74.125.24.0-255,2902,47053,8,209955
7243,0.001349,172.31.36.0-255,66,47119,8,209955
7244,0.001357,74.125.24.0-255,5738,52857,8,209955
7245,0.001359,172.31.36.0-255,66,52923,8,209955
7246,0.001406,74.125.24.0-255,2902,55825,8,209955
7247,0.00764,172.31.36.0-255,66,55891,8,209955
7248,0.010065,74.125.24.0-255,5738,61629,8,209955
7249,0.01008,172.31.36.0-255,66,61695,8,209955
7250,0.01245,74.125.24.0-255,5738,67433,8,209955
7251,0.01246,172.31.36.0-255,66,67499,8,209955
7252,0.014802,74.125.24.0-255,5738,73237,8,209955
7253,0.015148,172.31.36.0-255,66,73303,8,209955
7254,0.017514,74.125.24.0-255,5738,79041,8,209955
7255,0.017528,172.31.36.0-255,66,79107,8,209955
7256,0.019905,74.125.24.0-255,5738,84845,8,209955
7257,0.019916,172.31.36.0-255,66,84911,8,209955
7258,0.02226,74.125.24.0-255,5738,90649,8,209955
7259,0.022274,172.31.36.0-255,66,90715,8,209955
7260,0.024619,74.125.24.0-255,5738,96453,8,209955
7261,0.02463,172.31.36.0-255,66,96519,8,209955
7262,0.027002,74.125.24.0-255,5738,102257,8,209955
7263,0.027011,172.31.36.0-255,66,102323,8,209955
7264,0.029332,74.125.24.0-255,5738,108061,8,209955
7265,0.02934,172.31.36.0-255,66,108127,8,209955
7266,0.031697,74.125.24.0-255,5738,113865,8,209955
7267,0.031706,172.31.36.0-255,66,113931,8,209955
7268,0.03405,74.125.24.0-255,5738,119669,8,209955
7269,0.034059,172.31.36.0-255,66,119735,8,209955
7270,0.036435,74.125.24.0-255,5738,125473,8,209955
7271,0.036444,172.31.36.0-255,66,125539,8,209955
7272,0.038776,74.125.24.0-255,5738,131277,8,209955
7273,0.038788,172.31.36.0-255,66,131343,8,209955
7274,0.041155,74.125.24.0-255,5738,137081,8,209955
7275,0.041168,172.31.36.0-255,66,137147,8,209955
7276,0.043544,74.125.24.0-255,5738,142885,8,209955
7277,0.043555,172.31.36.0-255,66,142951,8,209955
7278,0.04593,74.125.24.0-255,4320,147271,8,209955
7279,0.045938,172.31.36.0-255,66,147337,8,209955
7280,0.045967,74.125.24.0-255,1484,148821,8,209955
7281,0.046624,172.31.36.0-255,188,149009,8,209955
7282,0.046655,172.31.36.0-255,955,149964,8,209955
7283,0.046727,172.31.36.0-255,1514,151478,8,209955
7284,0.046729,172.31.36.0-255,1514,152992,8,209955
7285,0.046752,172.31.36.0-255,77,153069,8,209955
7286,0.048164,104.244.42.0-255,66,153135,8,209955
7287,0.048206,104.244.42.0-255,66,153201,8,209955
7288,0.048269,74.125.24.0-255,4320,157521,8,209955
7289,0.048275,172.31.36.0-255,66,157587,8,209955
7290,0.048304,104.244.42.0-255,66,157653,8,209955
7291,0.04831,104.244.42.0-255,66,157719,8,209955
7292,0.050672,74.125.24.0-255,5738,163457,8,209955
7293,0.050679,172.31.36.0-255,66,163523,8,209955
7294,0.053043,74.125.24.0-255,5738,169261,8,209955
7295,0.05305,172.31.36.0-255,66,169327,8,209955
7296,0.055396,74.125.24.0-255,5738,175065,8,209955
7297,0.055409,172.31.36.0-255,66,175131,8,209955
7298,0.057753,74.125.24.0-255,5738,180869,8,209955
7299,0.057761,172.31.36.0-255,66,180935,8,209955
7300,0.060279,74.125.24.0-255,5738,186673,8,209955
7301,0.060286,172.31.36.0-255,66,186739,8,209955
7302,0.06282,74.125.24.0-255,5738,192477,8,209955
7303,0.062827,172.31.36.0-255,66,192543,8,209955
7304,0.065156,74.125.24.0-255,5738,198281,8,209955
7305,0.065163,172.31.36.0-255,66,198347,8,209955
7306,0.067541,74.125.24.0-255,5738,204085,8,209955
7307,0.067549,172.31.36.0-255,66,204151,8,209955
7308,0.069942,74.125.24.0-255,5738,209889,8,209955
7309,0.069949,172.31.36.0-255,66,209955,8,209955
7310,0.0,74.125.24.0-255,146,146,8,346846
7311,2.1e-05,172.31.36.0-255,66,212,8,346846
7312,2.8e-05,74.125.24.0-255,1484,1696,8,346846
7313,3.2e-05,172.31.36.0-255,66,1762,8,346846
7314,3.7e-05,74.125.24.0-255,2902,4664,8,346846
7315,4.1e-05,172.31.36.0-255,66,4730,8,346846
7316,4.7e-05,74.125.24.0-255,7156,11886,8,346846
7317,5e-05,172.31.36.0-255,66,11952,8,346846
7318,6.7e-05,74.125.24.0-255,1974,13926,8,346846
7319,7e-05,172.31.36.0-255,66,13992,8,346846
7320,0.000187,74.125.24.0-255,1484,15476,8,346846
7321,0.000191,172.31.36.0-255,66,15542,8,346846
7322,0.000196,74.125.24.0-255,2902,18444,8,346846
7323,0.000198,172.31.36.0-255,66,18510,8,346846
7324,0.000202,74.125.24.0-255,2902,21412,8,346846
7325,0.000204,172.31.36.0-255,66,21478,8,346846
7326,0.000219,74.125.24.0-255,2902,24380,8,346846
7327,0.000221,172.31.36.0-255,66,24446,8,346846
7328,0.000227,74.125.24.0-255,6797,31243,8,346846
7329,0.000229,172.31.36.0-255,66,31309,8,346846
7330,0.00037,74.125.24.0-255,1484,32793,8,346846
7331,0.000374,172.31.36.0-255,66,32859,8,346846
7332,0.000379,74.125.24.0-255,2902,35761,8,346846
7333,0.000381,172.31.36.0-255,66,35827,8,346846
7334,0.000387,74.125.24.0-255,5738,41565,8,346846
7335,0.000389,172.31.36.0-255,66,41631,8,346846
7336,0.000423,74.125.24.0-255,2902,44533,8,346846
7337,0.000425,172.31.36.0-255,66,44599,8,346846
7338,0.000444,74.125.24.0-255,3961,48560,8,346846
7339,0.000446,172.31.36.0-255,66,48626,8,346846
7340,0.000643,74.125.24.0-255,1484,50110,8,346846
7341,0.000648,74.125.24.0-255,2902,53012,8,346846
7342,0.000653,74.125.24.0-255,5738,58750,8,346846
7343,0.000667,172.31.36.0-255,66,58816,8,346846
7344,0.00067,172.31.36.0-255,66,58882,8,346846
7345,0.000672,172.31.36.0-255,66,58948,8,346846
7346,0.000685,74.125.24.0-255,6797,65745,8,346846
7347,0.000687,172.31.36.0-255,66,65811,8,346846
7348,0.000721,74.125.24.0-255,7156,72967,8,346846
7349,0.000724,172.31.36.0-255,66,73033,8,346846
7350,0.000759,172.31.36.0-255,66,73099,8,346846
7351,0.000781,74.125.24.0-255,1706,74805,8,346846
7352,0.000783,172.31.36.0-255,66,74871,8,346846
7353,0.000801,74.125.24.0-255,2902,77773,8,346846
7354,0.000803,172.31.36.0-255,66,77839,8,346846
7355,0.000834,74.125.24.0-255,7156,84995,8,346846
7356,0.000837,172.31.36.0-255,66,85061,8,346846
7357,0.000843,74.125.24.0-255,6797,91858,8,346846
7358,0.000845,172.31.36.0-255,66,91924,8,346846
7359,0.001254,74.125.24.0-255,1484,93408,8,346846
7360,0.00126,172.31.36.0-255,66,93474,8,346846
7361,0.001267,74.125.24.0-255,2902,96376,8,346846
7362,0.001269,172.31.36.0-255,66,96442,8,346846
7363,0.001276,74.125.24.0-255,5738,102180,8,346846
7364,0.001278,172.31.36.0-255,66,102246,8,346846
7365,0.001285,74.125.24.0-255,5738,107984,8,346846
7366,0.001286,172.31.36.0-255,66,108050,8,346846
7367,0.001312,74.125.24.0-255,7156,115206,8,346846
7368,0.001315,172.31.36.0-255,66,115272,8,346846
7369,0.001348,172.31.36.0-255,66,115338,8,346846
7370,0.001368,74.125.24.0-255,2184,117522,8,346846
7371,0.00137,172.31.36.0-255,66,117588,8,346846
7372,0.001846,74.125.24.0-255,1484,119072,8,346846
7373,0.001856,74.125.24.0-255,2902,121974,8,346846
7374,0.00186,172.31.36.0-255,66,122040,8,346846
7375,0.001867,74.125.24.0-255,4320,126360,8,346846
7376,0.001869,172.31.36.0-255,66,126426,8,346846
7377,0.001874,74.125.24.0-255,2902,129328,8,346846
7378,0.001876,172.31.36.0-255,66,129394,8,346846
7379,0.001902,74.125.24.0-255,5738,135132,8,346846
7380,0.001905,172.31.36.0-255,66,135198,8,346846
7381,0.001909,74.125.24.0-255,2902,138100,8,346846
7382,0.001912,172.31.36.0-255,66,138166,8,346846
7383,0.001948,172.31.36.0-255,66,138232,8,346846
7384,0.002044,74.125.24.0-255,1484,139716,8,346846
7385,0.002049,74.125.24.0-255,1484,141200,8,346846
7386,0.002052,172.31.36.0-255,66,141266,8,346846
7387,0.002074,74.125.24.0-255,1484,142750,8,346846
7388,0.002081,74.125.24.0-255,5738,148488,8,346846
7389,0.002084,172.31.36.0-255,66,148554,8,346846
7390,0.002126,172.31.36.0-255,66,148620,8,346846
7391,0.002134,74.125.24.0-255,5738,154358,8,346846
7392,0.002136,172.31.36.0-255,66,154424,8,346846
7393,0.002158,74.125.24.0-255,2902,157326,8,346846
7394,0.002161,172.31.36.0-255,66,157392,8,346846
7395,0.00218,74.125.24.0-255,2184,159576,8,346846
7396,0.002183,172.31.36.0-255,66,159642,8,346846
7397,0.002204,74.125.24.0-255,5738,165380,8,346846
7398,0.002207,172.31.36.0-255,66,165446,8,346846
7399,0.00221,74.125.24.0-255,1484,166930,8,346846
7400,0.002227,74.125.24.0-255,4320,171250,8,346846
7401,0.002229,172.31.36.0-255,66,171316,8,346846
7402,0.002254,74.125.24.0-255,4320,175636,8,346846
7403,0.002258,172.31.36.0-255,66,175702,8,346846
7404,0.002261,74.125.24.0-255,1484,177186,8,346846
7405,0.002314,74.125.24.0-255,5738,182924,8,346846
7406,0.00232,172.31.36.0-255,66,182990,8,346846
7407,0.002384,74.125.24.0-255,5738,188728,8,346846
7408,0.002398,74.125.24.0-255,2902,191630,8,346846
7409,0.002415,74.125.24.0-255,4320,195950,8,346846
7410,0.002432,74.125.24.0-255,2184,198134,8,346846
7411,0.002713,172.31.36.0-255,66,198200,8,346846
7412,0.005096,74.125.24.0-255,4320,202520,8,346846
7413,0.005101,172.31.36.0-255,66,202586,8,346846
7414,0.00512,74.125.24.0-255,1484,204070,8,346846
7415,0.007469,74.125.24.0-255,4320,208390,8,346846
7416,0.007478,172.31.36.0-255,66,208456,8,346846
7417,0.009856,74.125.24.0-255,5738,214194,8,346846
7418,0.00987,172.31.36.0-255,66,214260,8,346846
7419,0.012212,74.125.24.0-255,5738,219998,8,346846
7420,0.012224,172.31.36.0-255,66,220064,8,346846
7421,0.014581,74.125.24.0-255,5738,225802,8,346846
7422,0.014589,172.31.36.0-255,66,225868,8,346846
7423,0.01693,74.125.24.0-255,5738,231606,8,346846
7424,0.016938,172.31.36.0-255,66,231672,8,346846
7425,0.019266,74.125.24.0-255,5738,237410,8,346846
7426,0.019272,172.31.36.0-255,66,237476,8,346846
7427,0.021649,74.125.24.0-255,5738,243214,8,346846
7428,0.021658,172.31.36.0-255,66,243280,8,346846
7429,0.023987,74.125.24.0-255,5738,249018,8,346846
7430,0.023995,172.31.36.0-255,66,249084,8,346846
7431,0.026347,74.125.24.0-255,5738,254822,8,346846
7432,0.026354,172.31.36.0-255,66,254888,8,346846
7433,0.028716,74.125.24.0-255,5738,260626,8,346846
7434,0.028725,172.31.36.0-255,66,260692,8,346846
7435,0.031069,74.125.24.0-255,4320,265012,8,346846
7436,0.031078,172.31.36.0-255,66,265078,8,346846
7437,0.031102,74.125.24.0-255,1484,266562,8,346846
7438,0.033448,74.125.24.0-255,4320,270882,8,346846
7439,0.033463,172.31.36.0-255,66,270948,8,346846
7440,0.035787,74.125.24.0-255,5738,276686,8,346846
7441,0.035797,172.31.36.0-255,66,276752,8,346846
7442,0.036992,172.31.36.0-255,172,276924,8,346846
7443,0.037026,172.31.36.0-255,1113,278037,8,346846
7444,0.037067,172.31.36.0-255,1514,279551,8,346846
7445,0.037069,172.31.36.0-255,1514,281065,8,346846
7446,0.037075,172.31.36.0-255,1514,282579,8,346846
7447,0.037076,172.31.36.0-255,771,283350,8,346846
7448,0.038206,74.125.24.0-255,5738,289088,8,346846
7449,0.038219,172.31.36.0-255,66,289154,8,346846
7450,0.038544,104.244.42.0-255,66,289220,8,346846
7451,0.03862,104.244.42.0-255,66,289286,8,346846
7452,0.038626,104.244.42.0-255,66,289352,8,346846
7453,0.038629,104.244.42.0-255,66,289418,8,346846
7454,0.040557,74.125.24.0-255,5738,295156,8,346846
7455,0.040564,172.31.36.0-255,66,295222,8,346846
7456,0.042932,74.125.24.0-255,5738,300960,8,346846
7457,0.042937,172.31.36.0-255,66,301026,8,346846
7458,0.045301,74.125.24.0-255,5738,306764,8,346846
7459,0.045308,172.31.36.0-255,66,306830,8,346846
7460,0.047666,74.125.24.0-255,4320,311150,8,346846
7461,0.047674,172.31.36.0-255,66,311216,8,346846
7462,0.047706,74.125.24.0-255,1484,312700,8,346846
7463,0.050029,74.125.24.0-255,4320,317020,8,346846
7464,0.050035,172.31.36.0-255,66,317086,8,346846
7465,0.052425,74.125.24.0-255,5738,322824,8,346846
7466,0.052431,172.31.36.0-255,66,322890,8,346846
7467,0.05478,74.125.24.0-255,5738,328628,8,346846
7468,0.054786,172.31.36.0-255,66,328694,8,346846
7469,0.057142,74.125.24.0-255,5738,334432,8,346846
7470,0.057148,172.31.36.0-255,66,334498,8,346846
7471,0.059504,74.125.24.0-255,5738,340236,8,346846
7472,0.059511,172.31.36.0-255,66,340302,8,346846
7473,0.061875,74.125.24.0-255,5738,346040,8,346846
7474,0.061881,172.31.36.0-255,66,346106,8,346846
7475,0.064213,74.125.24.0-255,503,346609,8,346846
7476,0.064403,172.31.36.0-255,66,346675,8,346846
7477,0.064434,172.31.36.0-255,105,346780,8,346846
7478,0.066756,74.125.24.0-255,66,346846,8,346846
7479,0.0,74.125.24.0-255,153,153,8,301710
7480,2.8e-05,172.31.36.0-255,66,219,8,301710
7481,3.8e-05,74.125.24.0-255,1484,1703,8,301710
7482,4.3e-05,172.31.36.0-255,66,1769,8,301710
7483,5.6e-05,74.125.24.0-255,2902,4671,8,301710
7484,6.1e-05,172.31.36.0-255,66,4737,8,301710
7485,6.9e-05,74.125.24.0-255,7156,11893,8,301710
7486,7.3e-05,172.31.36.0-255,66,11959,8,301710
7487,7.8e-05,74.125.24.0-255,2051,14010,8,301710
7488,8.1e-05,172.31.36.0-255,66,14076,8,301710
7489,0.000143,74.125.24.0-255,1484,15560,8,301710
7490,0.000145,172.31.36.0-255,66,15626,8,301710
7491,0.000152,74.125.24.0-255,2902,18528,8,301710
7492,0.000154,172.31.36.0-255,66,18594,8,301710
7493,0.000167,74.125.24.0-255,5738,24332,8,301710
7494,0.00017,172.31.36.0-255,66,24398,8,301710
7495,0.000201,74.125.24.0-255,6797,31195,8,301710
7496,0.000209,172.31.36.0-255,66,31261,8,301710
7497,0.000219,74.125.24.0-255,7156,38417,8,301710
7498,0.000222,172.31.36.0-255,66,38483,8,301710
7499,0.000248,74.125.24.0-255,2902,41385,8,301710
7500,0.00025,172.31.36.0-255,66,41451,8,301710
7501,0.000286,74.125.24.0-255,6797,48248,8,301710
7502,0.000289,172.31.36.0-255,66,48314,8,301710
7503,0.000332,172.31.36.0-255,66,48380,8,301710
7504,0.000355,74.125.24.0-255,1484,49864,8,301710
7505,0.000357,172.31.36.0-255,66,49930,8,301710
7506,0.000365,74.125.24.0-255,5738,55668,8,301710
7507,0.000367,172.31.36.0-255,66,55734,8,301710
7508,0.000371,74.125.24.0-255,1461,57195,8,301710
7509,0.000373,172.31.36.0-255,66,57261,8,301710
7510,0.00048,74.125.24.0-255,1484,58745,8,301710
7511,0.000487,74.125.24.0-255,2902,61647,8,301710
7512,0.000512,74.125.24.0-255,5738,67385,8,301710
7513,0.000561,74.125.24.0-255,6797,74182,8,301710
7514,0.000657,74.125.24.0-255,1484,75666,8,301710
7515,0.000662,74.125.24.0-255,2902,78568,8,301710
7516,0.000684,74.125.24.0-255,5738,84306,8,301710
7517,0.000704,74.125.24.0-255,6797,91103,8,301710
7518,0.000796,172.31.36.0-255,66,91169,8,301710
7519,0.000806,74.125.24.0-255,1484,92653,8,301710
7520,0.000809,74.125.24.0-255,1484,94137,8,301710
7521,0.000824,172.31.36.0-255,66,94203,8,301710
7522,0.000828,74.125.24.0-255,1484,95687,8,301710
7523,0.00084,74.125.24.0-255,5738,101425,8,301710
7524,0.000878,74.125.24.0-255,4320,105745,8,301710
7525,0.000899,172.31.36.0-255,66,105811,8,301710
7526,0.00094,74.125.24.0-255,2184,107995,8,301710
7527,0.000948,74.125.24.0-255,5738,113733,8,301710
7528,0.000967,74.125.24.0-255,5738,119471,8,301710
7529,0.000977,172.31.36.0-255,66,119537,8,301710
7530,0.000984,74.125.24.0-255,4320,123857,8,301710
7531,0.000989,172.31.36.0-255,66,123923,8,301710
7532,0.001003,74.125.24.0-255,7156,131079,8,301710
7533,0.001062,172.31.36.0-255,66,131145,8,301710
7534,0.001203,74.125.24.0-255,1484,132629,8,301710
7535,0.001208,74.125.24.0-255,2902,135531,8,301710
7536,0.001223,74.125.24.0-255,2902,138433,8,301710
7537,0.001231,172.31.36.0-255,66,138499,8,301710
7538,0.001243,74.125.24.0-255,2902,141401,8,301710
7539,0.001251,74.125.24.0-255,1484,142885,8,301710
7540,0.001286,74.125.24.0-255,5738,148623,8,301710
7541,0.001293,172.31.36.0-255,66,148689,8,301710
7542,0.001336,74.125.24.0-255,5020,153709,8,301710
7543,0.001359,172.31.36.0-255,66,153775,8,301710
7544,0.001503,74.125.24.0-255,1484,155259,8,301710
7545,0.001508,74.125.24.0-255,1484,156743,8,301710
7546,0.001515,172.31.36.0-255,66,156809,8,301710
7547,0.001524,74.125.24.0-255,1484,158293,8,301710
7548,0.001528,74.125.24.0-255,2902,161195,8,301710
7549,0.00155,74.125.24.0-255,2902,164097,8,301710
7550,0.001569,74.125.24.0-255,5738,169835,8,301710
7551,0.001574,172.31.36.0-255,66,169901,8,301710
7552,0.001584,74.125.24.0-255,4320,174221,8,301710
7553,0.001604,74.125.24.0-255,766,174987,8,301710
7554,0.001624,172.31.36.0-255,66,175053,8,301710
7555,0.001768,74.125.24.0-255,1484,176537,8,301710
7556,0.001775,74.125.24.0-255,2902,179439,8,301710
7557,0.001817,74.125.24.0-255,1484,180923,8,301710
7558,0.00183,172.31.36.0-255,66,180989,8,301710
7559,0.001835,74.125.24.0-255,4320,185309,8,301710
7560,0.001883,172.31.36.0-255,66,185375,8,301710
7561,0.002031,74.125.24.0-255,1484,186859,8,301710
7562,0.002047,74.125.24.0-255,2902,189761,8,301710
7563,0.002066,172.31.36.0-255,66,189827,8,301710
7564,0.002073,74.125.24.0-255,2902,192729,8,301710
7565,0.002078,172.31.36.0-255,66,192795,8,301710
7566,0.0021,74.125.24.0-255,2902,195697,8,301710
7567,0.002127,74.125.24.0-255,7156,202853,8,301710
7568,0.002136,172.31.36.0-255,66,202919,8,301710
7569,0.002148,74.125.24.0-255,5738,208657,8,301710
7570,0.002153,74.125.24.0-255,2902,211559,8,301710
7571,0.002164,172.31.36.0-255,66,211625,8,301710
7572,0.002173,74.125.24.0-255,4320,215945,8,301710
7573,0.002176,74.125.24.0-255,1484,217429,8,301710
7574,0.002219,172.31.36.0-255,66,217495,8,301710
7575,0.002231,74.125.24.0-255,5020,222515,8,301710
7576,0.00224,74.125.24.0-255,2902,225417,8,301710
7577,0.002272,172.31.36.0-255,66,225483,8,301710
7578,0.004591,74.125.24.0-255,5738,231221,8,301710
7579,0.004604,172.31.36.0-255,66,231287,8,301710
7580,0.006941,74.125.24.0-255,5738,237025,8,301710
7581,0.006953,172.31.36.0-255,66,237091,8,301710
7582,0.009243,74.125.24.0-255,5738,242829,8,301710
7583,0.009252,172.31.36.0-255,66,242895,8,301710
7584,0.011565,74.125.24.0-255,5738,248633,8,301710
7585,0.011575,172.31.36.0-255,66,248699,8,301710
7586,0.013906,74.125.24.0-255,5738,254437,8,301710
7587,0.013922,172.31.36.0-255,66,254503,8,301710
7588,0.016251,74.125.24.0-255,5738,260241,8,301710
7589,0.016265,172.31.36.0-255,66,260307,8,301710
7590,0.018602,74.125.24.0-255,5738,266045,8,301710
7591,0.018619,172.31.36.0-255,66,266111,8,301710
7592,0.020932,74.125.24.0-255,5738,271849,8,301710
7593,0.020942,172.31.36.0-255,66,271915,8,301710
7594,0.023263,74.125.24.0-255,5738,277653,8,301710
7595,0.02328,172.31.36.0-255,66,277719,8,301710
7596,0.025635,74.125.24.0-255,5738,283457,8,301710
7597,0.025651,172.31.36.0-255,66,283523,8,301710
7598,0.027996,74.125.24.0-255,5738,289261,8,301710
7599,0.028012,172.31.36.0-255,66,289327,8,301710
7600,0.030361,74.125.24.0-255,5738,295065,8,301710
7601,0.030378,172.31.36.0-255,66,295131,8,301710
7602,0.032712,74.125.24.0-255,4290,299421,8,301710
7603,0.032729,172.31.36.0-255,66,299487,8,301710
7604,0.033012,172.31.36.0-255,105,299592,8,301710
7605,0.03533,74.125.24.0-255,66,299658,8,301710
7606,0.052639,172.31.36.0-255,172,299830,8,301710
7607,0.052675,172.31.36.0-255,1113,300943,8,301710
7608,0.05276,172.31.36.0-255,569,301512,8,301710
7609,0.054197,104.244.42.0-255,66,301578,8,301710
7610,0.054257,104.244.42.0-255,66,301644,8,301710
7611,0.0543,104.244.42.0-255,66,301710,8,301710
7612,0.0,172.31.36.0-255,66,66,8,66
7613,0.0,74.125.68.0-255,153,153,8,362983
7614,1.4e-05,172.31.36.0-255,66,219,8,362983
7615,2e-05,74.125.68.0-255,1484,1703,8,362983
7616,2.5e-05,172.31.36.0-255,66,1769,8,362983
7617,3.1e-05,74.125.68.0-255,2902,4671,8,362983
7618,4.2e-05,172.31.36.0-255,66,4737,8,362983
7619,5e-05,74.125.68.0-255,5738,10475,8,362983
7620,5.3e-05,172.31.36.0-255,66,10541,8,362983
7621,9.4e-05,74.125.68.0-255,3445,13986,8,362983
7622,9.7e-05,172.31.36.0-255,66,14052,8,362983
7623,0.000104,74.125.68.0-255,4320,18372,8,362983
7624,0.000106,172.31.36.0-255,66,18438,8,362983
7625,0.000118,172.31.36.0-255,66,18504,8,362983
7626,0.000122,74.125.68.0-255,2543,21047,8,362983
7627,0.000125,172.31.36.0-255,66,21113,8,362983
7628,0.000215,74.125.68.0-255,1484,22597,8,362983
7629,0.00022,172.31.36.0-255,66,22663,8,362983
7630,0.000224,74.125.68.0-255,1484,24147,8,362983
7631,0.000227,172.31.36.0-255,66,24213,8,362983
7632,0.000248,74.125.68.0-255,1484,25697,8,362983
7633,0.000251,172.31.36.0-255,66,25763,8,362983
7634,0.000258,74.125.68.0-255,5738,31501,8,362983
7635,0.000261,172.31.36.0-255,66,31567,8,362983
7636,0.000267,74.125.68.0-255,5738,37305,8,362983
7637,0.000269,172.31.36.0-255,66,37371,8,362983
7638,0.000299,74.125.68.0-255,7156,44527,8,362983
7639,0.000302,172.31.36.0-255,66,44593,8,362983
7640,0.000338,172.31.36.0-255,66,44659,8,362983
7641,0.000468,74.125.68.0-255,413,45072,8,362983
7642,0.000472,172.31.36.0-255,66,45138,8,362983
7643,0.000718,74.125.68.0-255,331,45469,8,362983
7644,0.000924,74.125.68.0-255,1484,46953,8,362983
7645,0.000929,172.31.36.0-255,66,47019,8,362983
7646,0.000936,74.125.68.0-255,2902,49921,8,362983
7647,0.000938,172.31.36.0-255,66,49987,8,362983
7648,0.000947,74.125.68.0-255,2902,52889,8,362983
7649,0.000949,172.31.36.0-255,66,52955,8,362983
7650,0.000978,74.125.68.0-255,2902,55857,8,362983
7651,0.000981,172.31.36.0-255,66,55923,8,362983
7652,0.000989,74.125.68.0-255,6797,62720,8,362983
7653,0.000991,172.31.36.0-255,66,62786,8,362983
7654,0.000998,74.125.68.0-255,5738,68524,8,362983
7655,0.001,172.31.36.0-255,66,68590,8,362983
7656,0.001027,74.125.68.0-255,1484,70074,8,362983
7657,0.001035,74.125.68.0-255,7156,77230,8,362983
7658,0.001038,172.31.36.0-255,66,77296,8,362983
7659,0.001073,74.125.68.0-255,2543,79839,8,362983
7660,0.001076,172.31.36.0-255,66,79905,8,362983
7661,0.001497,74.125.68.0-255,1484,81389,8,362983
7662,0.001506,74.125.68.0-255,2902,84291,8,362983
7663,0.001509,172.31.36.0-255,66,84357,8,362983
7664,0.001539,74.125.68.0-255,1484,85841,8,362983
7665,0.001542,74.125.68.0-255,1484,87325,8,362983
7666,0.001545,172.31.36.0-255,66,87391,8,362983
7667,0.00157,74.125.68.0-255,1484,88875,8,362983
7668,0.001577,74.125.68.0-255,5738,94613,8,362983
7669,0.001579,172.31.36.0-255,66,94679,8,362983
7670,0.001584,74.125.68.0-255,2902,97581,8,362983
7671,0.001585,172.31.36.0-255,66,97647,8,362983
7672,0.001592,74.125.68.0-255,4320,101967,8,362983
7673,0.001594,172.31.36.0-255,66,102033,8,362983
7674,0.001627,172.31.36.0-255,66,102099,8,362983
7675,0.001632,74.125.68.0-255,3602,105701,8,362983
7676,0.001634,172.31.36.0-255,66,105767,8,362983
7677,0.001688,74.125.68.0-255,1484,107251,8,362983
7678,0.001709,74.125.68.0-255,2902,110153,8,362983
7679,0.001712,172.31.36.0-255,66,110219,8,362983
7680,0.001718,74.125.68.0-255,5738,115957,8,362983
7681,0.001721,172.31.36.0-255,66,116023,8,362983
7682,0.001731,74.125.68.0-255,4320,120343,8,362983
7683,0.001733,172.31.36.0-255,66,120409,8,362983
7684,0.001736,74.125.68.0-255,1484,121893,8,362983
7685,0.001764,74.125.68.0-255,4320,126213,8,362983
7686,0.001767,172.31.36.0-255,66,126279,8,362983
7687,0.001793,74.125.68.0-255,7156,133435,8,362983
7688,0.001796,172.31.36.0-255,66,133501,8,362983
7689,0.001822,74.125.68.0-255,1484,134985,8,362983
7690,0.001847,74.125.68.0-255,5020,140005,8,362983
7691,0.00185,172.31.36.0-255,66,140071,8,362983
7692,0.001857,74.125.68.0-255,5738,145809,8,362983
7693,0.00186,172.31.36.0-255,66,145875,8,362983
7694,0.001896,74.125.68.0-255,5738,151613,8,362983
7695,0.001899,172.31.36.0-255,66,151679,8,362983
7696,0.001929,74.125.68.0-255,7156,158835,8,362983
7697,0.001933,172.31.36.0-255,66,158901,8,362983
7698,0.001949,172.31.36.0-255,66,158967,8,362983
7699,0.001951,74.125.68.0-255,766,159733,8,362983
7700,0.002023,74.125.68.0-255,1484,161217,8,362983
7701,0.002028,172.31.36.0-255,66,161283,8,362983
7702,0.002034,74.125.68.0-255,2902,164185,8,362983
7703,0.002036,172.31.36.0-255,66,164251,8,362983
7704,0.00208,74.125.68.0-255,2902,167153,8,362983
7705,0.002083,172.31.36.0-255,66,167219,8,362983
7706,0.002112,74.125.68.0-255,1484,168703,8,362983
7707,0.002119,74.125.68.0-255,5738,174441,8,362983
7708,0.002123,172.31.36.0-255,66,174507,8,362983
7709,0.002127,74.125.68.0-255,2902,177409,8,362983
7710,0.00213,172.31.36.0-255,66,177475,8,362983
7711,0.002167,172.31.36.0-255,66,177541,8,362983
7712,0.002173,74.125.68.0-255,4320,181861,8,362983
7713,0.002175,172.31.36.0-255,66,181927,8,362983
7714,0.002202,74.125.68.0-255,3602,185529,8,362983
7715,0.002205,172.31.36.0-255,66,185595,8,362983
7716,0.004453,74.125.68.0-255,1484,187079,8,362983
7717,0.004486,74.125.68.0-255,4320,191399,8,362983
7718,0.004491,172.31.36.0-255,66,191465,8,362983
7719,0.006777,74.125.68.0-255,5738,197203,8,362983
7720,0.006782,172.31.36.0-255,66,197269,8,362983
7721,0.009087,74.125.68.0-255,5738,203007,8,362983
7722,0.009094,172.31.36.0-255,66,203073,8,362983
7723,0.011394,74.125.68.0-255,5738,208811,8,362983
7724,0.011402,172.31.36.0-255,66,208877,8,362983
7725,0.013685,74.125.68.0-255,5738,214615,8,362983
7726,0.013693,172.31.36.0-255,66,214681,8,362983
7727,0.015999,74.125.68.0-255,5738,220419,8,362983
7728,0.016007,172.31.36.0-255,66,220485,8,362983
7729,0.018297,74.125.68.0-255,5738,226223,8,362983
7730,0.018304,172.31.36.0-255,66,226289,8,362983
7731,0.020593,74.125.68.0-255,5738,232027,8,362983
7732,0.020601,172.31.36.0-255,66,232093,8,362983
7733,0.022892,74.125.68.0-255,5738,237831,8,362983
7734,0.0229,172.31.36.0-255,66,237897,8,362983
7735,0.025193,74.125.68.0-255,5738,243635,8,362983
7736,0.025203,172.31.36.0-255,66,243701,8,362983
7737,0.027479,74.125.68.0-255,5738,249439,8,362983
7738,0.027487,172.31.36.0-255,66,249505,8,362983
7739,0.029772,74.125.68.0-255,5738,255243,8,362983
7740,0.029779,172.31.36.0-255,66,255309,8,362983
7741,0.032067,74.125.68.0-255,5738,261047,8,362983
7742,0.032075,172.31.36.0-255,66,261113,8,362983
7743,0.034352,74.125.68.0-255,5738,266851,8,362983
7744,0.034358,172.31.36.0-255,66,266917,8,362983
7745,0.036685,74.125.68.0-255,5738,272655,8,362983
7746,0.036693,172.31.36.0-255,66,272721,8,362983
7747,0.037298,172.31.36.0-255,172,272893,8,362983
7748,0.037324,172.31.36.0-255,1112,274005,8,362983
7749,0.037389,172.31.36.0-255,1514,275519,8,362983
7750,0.037392,172.31.36.0-255,1514,277033,8,362983
7751,0.037398,172.31.36.0-255,1514,278547,8,362983
7752,0.037399,172.31.36.0-255,1514,280061,8,362983
7753,0.037427,172.31.36.0-255,1228,281289,8,362983
7754,0.038809,104.244.42.0-255,66,281355,8,362983
7755,0.038818,104.244.42.0-255,66,281421,8,362983
7756,0.038942,104.244.42.0-255,66,281487,8,362983
7757,0.038948,104.244.42.0-255,66,281553,8,362983
7758,0.038973,74.125.68.0-255,5738,287291,8,362983
7759,0.038979,172.31.36.0-255,66,287357,8,362983
7760,0.039594,104.244.42.0-255,108,287465,8,362983
7761,0.039601,172.31.36.0-255,66,287531,8,362983
7762,0.041268,74.125.68.0-255,5738,293269,8,362983
7763,0.041273,172.31.36.0-255,66,293335,8,362983
7764,0.04355,74.125.68.0-255,5738,299073,8,362983
7765,0.043557,172.31.36.0-255,66,299139,8,362983
7766,0.045848,74.125.68.0-255,5738,304877,8,362983
7767,0.045855,172.31.36.0-255,66,304943,8,362983
7768,0.048167,74.125.68.0-255,5738,310681,8,362983
7769,0.048174,172.31.36.0-255,66,310747,8,362983
7770,0.050463,74.125.68.0-255,5738,316485,8,362983
7771,0.05047,172.31.36.0-255,66,316551,8,362983
7772,0.052765,74.125.68.0-255,5738,322289,8,362983
7773,0.052772,172.31.36.0-255,66,322355,8,362983
7774,0.055067,74.125.68.0-255,5738,328093,8,362983
7775,0.055074,172.31.36.0-255,66,328159,8,362983
7776,0.057384,74.125.68.0-255,5738,333897,8,362983
7777,0.057391,172.31.36.0-255,66,333963,8,362983
7778,0.059737,74.125.68.0-255,5738,339701,8,362983
7779,0.059745,172.31.36.0-255,66,339767,8,362983
7780,0.062034,74.125.68.0-255,5738,345505,8,362983
7781,0.062041,172.31.36.0-255,66,345571,8,362983
7782,0.064337,74.125.68.0-255,5738,351309,8,362983
7783,0.064344,172.31.36.0-255,66,351375,8,362983
7784,0.066632,74.125.68.0-255,5738,357113,8,362983
7785,0.066639,172.31.36.0-255,66,357179,8,362983
7786,0.068927,74.125.68.0-255,5738,362917,8,362983
7787,0.068934,172.31.36.0-255,66,362983,8,362983
7788,0.0,172.253.118.0-255,146,146,8,264656
7789,2.5e-05,172.31.36.0-255,66,212,8,264656
7790,3.2e-05,172.253.118.0-255,1484,1696,8,264656
7791,3.6e-05,172.31.36.0-255,66,1762,8,264656
7792,4.2e-05,172.253.118.0-255,2902,4664,8,264656
7793,5.3e-05,172.31.36.0-255,66,4730,8,264656
7794,5.9e-05,172.253.118.0-255,5738,10468,8,264656
7795,6.2e-05,172.31.36.0-255,66,10534,8,264656
7796,9.1e-05,172.253.118.0-255,2902,13436,8,264656
7797,9.5e-05,172.31.36.0-255,66,13502,8,264656
7798,0.00012,172.253.118.0-255,3483,16985,8,264656
7799,0.000124,172.31.36.0-255,66,17051,8,264656
7800,0.000129,172.253.118.0-255,2902,19953,8,264656
7801,0.000131,172.31.36.0-255,66,20019,8,264656
7802,0.000154,172.253.118.0-255,5738,25757,8,264656
7803,0.000156,172.31.36.0-255,66,25823,8,264656
7804,0.000169,172.253.118.0-255,5379,31202,8,264656
7805,0.000172,172.31.36.0-255,66,31268,8,264656
7806,0.000254,172.253.118.0-255,1484,32752,8,264656
7807,0.000258,172.31.36.0-255,66,32818,8,264656
7808,0.000283,172.253.118.0-255,2902,35720,8,264656
7809,0.000286,172.31.36.0-255,66,35786,8,264656
7810,0.000315,172.253.118.0-255,5738,41524,8,264656
7811,0.000318,172.31.36.0-255,66,41590,8,264656
7812,0.000353,172.31.36.0-255,66,41656,8,264656
7813,0.000361,172.253.118.0-255,7156,48812,8,264656
7814,0.000363,172.31.36.0-255,66,48878,8,264656
7815,0.000403,172.253.118.0-255,2902,51780,8,264656
7816,0.000407,172.31.36.0-255,66,51846,8,264656
7817,0.000435,172.253.118.0-255,2900,54746,8,264656
7818,0.000438,172.31.36.0-255,66,54812,8,264656
7819,0.000469,172.253.118.0-255,1484,56296,8,264656
7820,0.000473,172.31.36.0-255,66,56362,8,264656
7821,0.000492,172.253.118.0-255,2902,59264,8,264656
7822,0.000495,172.31.36.0-255,66,59330,8,264656
7823,0.000521,172.253.118.0-255,5738,65068,8,264656
7824,0.000524,172.31.36.0-255,66,65134,8,264656
7825,0.000532,172.253.118.0-255,7156,72290,8,264656
7826,0.000535,172.31.36.0-255,66,72356,8,264656
7827,0.000565,172.253.118.0-255,4320,76676,8,264656
7828,0.000567,172.31.36.0-255,66,76742,8,264656
7829,0.000611,172.31.36.0-255,66,76808,8,264656
7830,0.000616,172.253.118.0-255,2184,78992,8,264656
7831,0.000618,172.31.36.0-255,66,79058,8,264656
7832,0.000646,172.253.118.0-255,1484,80542,8,264656
7833,0.00065,172.31.36.0-255,66,80608,8,264656
7834,0.000655,172.253.118.0-255,2902,83510,8,264656
7835,0.000656,172.31.36.0-255,66,83576,8,264656
7836,0.000678,172.253.118.0-255,5738,89314,8,264656
7837,0.000686,172.31.36.0-255,66,89380,8,264656
7838,0.000689,172.253.118.0-255,1484,90864,8,264656
7839,0.000726,172.31.36.0-255,66,90930,8,264656
7840,0.000755,172.253.118.0-255,2902,93832,8,264656
7841,0.000763,172.31.36.0-255,66,93898,8,264656
7842,0.000768,172.31.36.0-255,66,93964,8,264656
7843,0.000873,172.253.118.0-255,1484,95448,8,264656
7844,0.000879,172.253.118.0-255,2902,98350,8,264656
7845,0.000882,172.253.118.0-255,2902,101252,8,264656
7846,0.000883,172.31.36.0-255,66,101318,8,264656
7847,0.000888,172.31.36.0-255,66,101384,8,264656
7848,0.000893,172.253.118.0-255,2902,104286,8,264656
7849,0.000904,172.31.36.0-255,66,104352,8,264656
7850,0.000932,172.31.36.0-255,66,104418,8,264656
7851,0.000933,172.253.118.0-255,5738,110156,8,264656
7852,0.000936,172.31.36.0-255,66,110222,8,264656
7853,0.000966,172.253.118.0-255,4320,114542,8,264656
7854,0.000979,172.253.118.0-255,5020,119562,8,264656
7855,0.000983,172.31.36.0-255,66,119628,8,264656
7856,0.000984,172.253.118.0-255,5738,125366,8,264656
7857,0.000988,172.31.36.0-255,66,125432,8,264656
7858,0.001043,172.31.36.0-255,66,125498,8,264656
7859,0.001083,172.31.36.0-255,66,125564,8,264656
7860,0.001088,172.31.36.0-255,66,125630,8,264656
7861,0.001123,172.31.36.0-255,66,125696,8,264656
7862,0.001129,172.253.118.0-255,5379,131075,8,264656
7863,0.001137,172.31.36.0-255,66,131141,8,264656
7864,0.001175,172.253.118.0-255,4320,135461,8,264656
7865,0.001184,172.31.36.0-255,66,135527,8,264656
7866,0.001196,172.253.118.0-255,5738,141265,8,264656
7867,0.001219,172.31.36.0-255,66,141331,8,264656
7868,0.001226,172.253.118.0-255,5738,147069,8,264656
7869,0.001238,172.31.36.0-255,66,147135,8,264656
7870,0.001246,172.253.118.0-255,5738,152873,8,264656
7871,0.001252,172.31.36.0-255,66,152939,8,264656
7872,0.001258,172.253.118.0-255,7156,160095,8,264656
7873,0.001276,172.31.36.0-255,66,160161,8,264656
7874,0.001279,172.253.118.0-255,5020,165181,8,264656
7875,0.001289,172.31.36.0-255,66,165247,8,264656
7876,0.001353,172.253.118.0-255,1484,166731,8,264656
7877,0.001358,172.253.118.0-255,1484,168215,8,264656
7878,0.001361,172.31.36.0-255,66,168281,8,264656
7879,0.00139,172.253.118.0-255,1484,169765,8,264656
7880,0.001397,172.253.118.0-255,5738,175503,8,264656
7881,0.001409,172.31.36.0-255,66,175569,8,264656
7882,0.001446,172.31.36.0-255,66,175635,8,264656
7883,0.001447,172.253.118.0-255,4320,179955,8,264656
7884,0.001451,172.31.36.0-255,66,180021,8,264656
7885,0.001513,172.253.118.0-255,6438,186459,8,264656
7886,0.001519,172.31.36.0-255,66,186525,8,264656
7887,0.001597,172.253.118.0-255,1484,188009,8,264656
7888,0.001602,172.253.118.0-255,2902,190911,8,264656
7889,0.001607,172.31.36.0-255,66,190977,8,264656
7890,0.001613,172.253.118.0-255,4320,195297,8,264656
7891,0.001625,172.31.36.0-255,66,195363,8,264656
7892,0.001639,172.253.118.0-255,1484,196847,8,264656
7893,0.001645,172.253.118.0-255,4320,201167,8,264656
7894,0.001649,172.31.36.0-255,66,201233,8,264656
7895,0.001676,172.253.118.0-255,1484,202717,8,264656
7896,0.001676,172.31.36.0-255,66,202783,8,264656
7897,0.00168,172.253.118.0-255,4320,207103,8,264656
7898,0.001693,172.31.36.0-255,66,207169,8,264656
7899,0.001712,172.253.118.0-255,3602,210771,8,264656
7900,0.001719,172.31.36.0-255,66,210837,8,264656
7901,0.001854,172.253.118.0-255,1484,212321,8,264656
7902,0.001861,172.253.118.0-255,2902,215223,8,264656
7903,0.001865,172.31.36.0-255,66,215289,8,264656
7904,0.001896,172.253.118.0-255,5738,221027,8,264656
7905,0.0019,172.253.118.0-255,1484,222511,8,264656
7906,0.001902,172.31.36.0-255,66,222577,8,264656
7907,0.001913,172.253.118.0-255,2902,225479,8,264656
7908,0.001919,172.31.36.0-255,66,225545,8,264656
7909,0.001931,172.253.118.0-255,5738,231283,8,264656
7910,0.001948,172.31.36.0-255,66,231349,8,264656
7911,0.001981,172.31.36.0-255,66,231415,8,264656
7912,0.001984,172.253.118.0-255,3602,235017,8,264656
7913,0.001998,172.31.36.0-255,66,235083,8,264656
7914,0.002009,172.253.118.0-255,5738,240821,8,264656
7915,0.002011,172.31.36.0-255,66,240887,8,264656
7916,0.002016,172.31.36.0-255,66,240953,8,264656
7917,0.002065,172.253.118.0-255,7156,248109,8,264656
7918,0.002074,172.31.36.0-255,66,248175,8,264656
7919,0.002086,172.253.118.0-255,6438,254613,8,264656
7920,0.002094,172.253.118.0-255,1484,256097,8,264656
7921,0.002095,172.31.36.0-255,66,256163,8,264656
7922,0.002123,172.253.118.0-255,1484,257647,8,264656
7923,0.002129,172.253.118.0-255,4320,261967,8,264656
7924,0.002134,172.31.36.0-255,66,262033,8,264656
7925,0.002171,172.31.36.0-255,66,262099,8,264656
7926,0.002215,172.31.36.0-255,66,262165,8,264656
7927,0.002243,172.253.118.0-255,97,262262,8,264656
7928,0.002275,172.253.118.0-255,105,262367,8,264656
7929,0.007831,172.31.36.0-255,66,262433,8,264656
7930,0.007857,172.31.36.0-255,105,262538,8,264656
7931,0.010153,172.253.118.0-255,66,262604,8,264656
7932,0.040527,172.31.36.0-255,172,262776,8,264656
7933,0.040566,172.31.36.0-255,1111,263887,8,264656
7934,0.040609,172.31.36.0-255,571,264458,8,264656
7935,0.042083,104.244.42.0-255,66,264524,8,264656
7936,0.042124,104.244.42.0-255,66,264590,8,264656
7937,0.042168,104.244.42.0-255,66,264656,8,264656
7938,0.0,216.58.221.0-255,144,144,8,310483
7939,2.8e-05,172.31.36.0-255,66,210,8,310483
7940,3.5e-05,216.58.221.0-255,1484,1694,8,310483
7941,3.9e-05,172.31.36.0-255,66,1760,8,310483
7942,5.2e-05,216.58.221.0-255,2902,4662,8,310483
7943,5.5e-05,172.31.36.0-255,66,4728,8,310483
7944,6.2e-05,216.58.221.0-255,7156,11884,8,310483
7945,6.5e-05,172.31.36.0-255,66,11950,8,310483
7946,6.9e-05,216.58.221.0-255,2102,14052,8,310483
7947,7.1e-05,172.31.36.0-255,66,14118,8,310483
7948,0.000153,216.58.221.0-255,1484,15602,8,310483
7949,0.000157,172.31.36.0-255,66,15668,8,310483
7950,0.000162,216.58.221.0-255,2902,18570,8,310483
7951,0.000165,172.31.36.0-255,66,18636,8,310483
7952,0.000195,216.58.221.0-255,5738,24374,8,310483
7953,0.000198,172.31.36.0-255,66,24440,8,310483
7954,0.000226,216.58.221.0-255,6797,31237,8,310483
7955,0.000229,172.31.36.0-255,66,31303,8,310483
7956,0.000481,216.58.221.0-255,1484,32787,8,310483
7957,0.000485,172.31.36.0-255,66,32853,8,310483
7958,0.00049,216.58.221.0-255,1484,34337,8,310483
7959,0.000492,172.31.36.0-255,66,34403,8,310483
7960,0.000511,216.58.221.0-255,1484,35887,8,310483
7961,0.000513,172.31.36.0-255,66,35953,8,310483
7962,0.00052,216.58.221.0-255,5738,41691,8,310483
7963,0.000529,172.31.36.0-255,66,41757,8,310483
7964,0.000535,216.58.221.0-255,4320,46077,8,310483
7965,0.000537,172.31.36.0-255,66,46143,8,310483
7966,0.000569,216.58.221.0-255,2543,48686,8,310483
7967,0.000573,172.31.36.0-255,66,48752,8,310483
7968,0.00058,216.58.221.0-255,7156,55908,8,310483
7969,0.000583,172.31.36.0-255,66,55974,8,310483
7970,0.0006,172.31.36.0-255,66,56040,8,310483
7971,0.000655,216.58.221.0-255,1393,57433,8,310483
7972,0.000767,172.31.36.0-255,66,57499,8,310483
7973,0.001055,216.58.221.0-255,386,57885,8,310483
7974,0.001253,216.58.221.0-255,1484,59369,8,310483
7975,0.00126,172.31.36.0-255,66,59435,8,310483
7976,0.001269,216.58.221.0-255,2902,62337,8,310483
7977,0.001271,172.31.36.0-255,66,62403,8,310483
7978,0.001284,216.58.221.0-255,5738,68141,8,310483
7979,0.001286,172.31.36.0-255,66,68207,8,310483
7980,0.001293,216.58.221.0-255,4320,72527,8,310483
7981,0.001296,172.31.36.0-255,66,72593,8,310483
7982,0.001325,216.58.221.0-255,3961,76554,8,310483
7983,0.001329,172.31.36.0-255,66,76620,8,310483
7984,0.001344,172.31.36.0-255,66,76686,8,310483
7985,0.001376,216.58.221.0-255,1484,78170,8,310483
7986,0.001404,216.58.221.0-255,5379,83549,8,310483
7987,0.001406,172.31.36.0-255,66,83615,8,310483
7988,0.001799,216.58.221.0-255,1484,85099,8,310483
7989,0.001804,216.58.221.0-255,2902,88001,8,310483
7990,0.001806,172.31.36.0-255,66,88067,8,310483
7991,0.00183,216.58.221.0-255,5738,93805,8,310483
7992,0.001833,172.31.36.0-255,66,93871,8,310483
7993,0.001848,216.58.221.0-255,1484,95355,8,310483
7994,0.001859,216.58.221.0-255,2902,98257,8,310483
7995,0.001862,172.31.36.0-255,66,98323,8,310483
7996,0.001879,216.58.221.0-255,1484,99807,8,310483
7997,0.001883,216.58.221.0-255,2902,102709,8,310483
7998,0.001885,172.31.36.0-255,66,102775,8,310483
7999,0.00189,216.58.221.0-255,2902,105677,8,310483
8000,0.001901,172.31.36.0-255,66,105743,8,310483
8001,0.001926,216.58.221.0-255,2902,108645,8,310483
8002,0.001933,172.31.36.0-255,66,108711,8,310483
8003,0.001937,216.58.221.0-255,2902,111613,8,310483
8004,0.001939,172.31.36.0-255,66,111679,8,310483
8005,0.001941,216.58.221.0-255,1484,113163,8,310483
8006,0.001965,216.58.221.0-255,2902,116065,8,310483
8007,0.001971,172.31.36.0-255,66,116131,8,310483
8008,0.001989,216.58.221.0-255,2184,118315,8,310483
8009,0.001992,172.31.36.0-255,66,118381,8,310483
8010,0.003909,216.58.221.0-255,2902,121283,8,310483
8011,0.003916,172.31.36.0-255,66,121349,8,310483
8012,0.003944,216.58.221.0-255,2902,124251,8,310483
8013,0.003946,172.31.36.0-255,66,124317,8,310483
8014,0.005852,216.58.221.0-255,2902,127219,8,310483
8015,0.005855,172.31.36.0-255,66,127285,8,310483
8016,0.005882,216.58.221.0-255,2902,130187,8,310483
8017,0.005884,172.31.36.0-255,66,130253,8,310483
8018,0.007807,216.58.221.0-255,2902,133155,8,310483
8019,0.007813,172.31.36.0-255,66,133221,8,310483
8020,0.007841,216.58.221.0-255,2902,136123,8,310483
8021,0.007844,172.31.36.0-255,66,136189,8,310483
8022,0.009753,216.58.221.0-255,2902,139091,8,310483
8023,0.00976,172.31.36.0-255,66,139157,8,310483
8024,0.009792,216.58.221.0-255,2902,142059,8,310483
8025,0.009796,172.31.36.0-255,66,142125,8,310483
8026,0.011706,216.58.221.0-255,2902,145027,8,310483
8027,0.011713,172.31.36.0-255,66,145093,8,310483
8028,0.01174,216.58.221.0-255,2902,147995,8,310483
8029,0.011742,172.31.36.0-255,66,148061,8,310483
8030,0.013675,216.58.221.0-255,5738,153799,8,310483
8031,0.013683,172.31.36.0-255,66,153865,8,310483
8032,0.015649,216.58.221.0-255,5738,159603,8,310483
8033,0.015658,172.31.36.0-255,66,159669,8,310483
8034,0.017599,216.58.221.0-255,5738,165407,8,310483
8035,0.017605,172.31.36.0-255,66,165473,8,310483
8036,0.01956,216.58.221.0-255,5738,171211,8,310483
8037,0.019567,172.31.36.0-255,66,171277,8,310483
8038,0.021517,216.58.221.0-255,5738,177015,8,310483
8039,0.021523,172.31.36.0-255,66,177081,8,310483
8040,0.023469,216.58.221.0-255,4320,181401,8,310483
8041,0.023475,172.31.36.0-255,66,181467,8,310483
8042,0.023493,216.58.221.0-255,1484,182951,8,310483
8043,0.025425,216.58.221.0-255,4320,187271,8,310483
8044,0.025433,172.31.36.0-255,66,187337,8,310483
8045,0.027384,216.58.221.0-255,4320,191657,8,310483
8046,0.027392,172.31.36.0-255,66,191723,8,310483
8047,0.027433,216.58.221.0-255,1484,193207,8,310483
8048,0.02934,216.58.221.0-255,4320,197527,8,310483
8049,0.029346,172.31.36.0-255,66,197593,8,310483
8050,0.031289,216.58.221.0-255,5738,203331,8,310483
8051,0.031295,172.31.36.0-255,66,203397,8,310483
8052,0.033249,216.58.221.0-255,5738,209135,8,310483
8053,0.033261,172.31.36.0-255,66,209201,8,310483
8054,0.03521,216.58.221.0-255,5738,214939,8,310483
8055,0.035219,172.31.36.0-255,66,215005,8,310483
8056,0.037166,216.58.221.0-255,5738,220743,8,310483
8057,0.037174,172.31.36.0-255,66,220809,8,310483
8058,0.038179,172.31.36.0-255,172,220981,8,310483
8059,0.03821,172.31.36.0-255,562,221543,8,310483
8060,0.039117,216.58.221.0-255,5738,227281,8,310483
8061,0.039124,172.31.36.0-255,66,227347,8,310483
8062,0.039748,104.244.42.0-255,66,227413,8,310483
8063,0.039828,104.244.42.0-255,66,227479,8,310483
8064,0.041068,216.58.221.0-255,5738,233217,8,310483
8065,0.041078,172.31.36.0-255,66,233283,8,310483
8066,0.043034,216.58.221.0-255,5738,239021,8,310483
8067,0.043043,172.31.36.0-255,66,239087,8,310483
8068,0.044995,216.58.221.0-255,5738,244825,8,310483
8069,0.045005,172.31.36.0-255,66,244891,8,310483
8070,0.046948,216.58.221.0-255,4320,249211,8,310483
8071,0.046956,172.31.36.0-255,66,249277,8,310483
8072,0.04699,216.58.221.0-255,1484,250761,8,310483
8073,0.048897,216.58.221.0-255,4320,255081,8,310483
8074,0.048905,172.31.36.0-255,66,255147,8,310483
8075,0.050842,216.58.221.0-255,5738,260885,8,310483
8076,0.050848,172.31.36.0-255,66,260951,8,310483
8077,0.052845,216.58.221.0-255,5738,266689,8,310483
8078,0.052855,172.31.36.0-255,66,266755,8,310483
8079,0.054798,216.58.221.0-255,5738,272493,8,310483
8080,0.054826,172.31.36.0-255,66,272559,8,310483
8081,0.05677,216.58.221.0-255,4320,276879,8,310483
8082,0.056775,172.31.36.0-255,66,276945,8,310483
8083,0.056812,216.58.221.0-255,1484,278429,8,310483
8084,0.058711,216.58.221.0-255,4320,282749,8,310483
8085,0.058719,172.31.36.0-255,66,282815,8,310483
8086,0.060652,216.58.221.0-255,5738,288553,8,310483
8087,0.060657,172.31.36.0-255,66,288619,8,310483
8088,0.062598,216.58.221.0-255,5738,294357,8,310483
8089,0.062604,172.31.36.0-255,66,294423,8,310483
8090,0.064539,216.58.221.0-255,4320,298743,8,310483
8091,0.064545,172.31.36.0-255,66,298809,8,310483
8092,0.064578,216.58.221.0-255,1484,300293,8,310483
8093,0.066503,216.58.221.0-255,4320,304613,8,310483
8094,0.066509,172.31.36.0-255,66,304679,8,310483
8095,0.068445,216.58.221.0-255,5738,310417,8,310483
8096,0.068451,172.31.36.0-255,66,310483,8,310483
8097,0.0,172.217.194.0-255,146,146,8,176923
8098,3.3e-05,172.31.36.0-255,66,212,8,176923
8099,4e-05,172.217.194.0-255,1484,1696,8,176923
8100,4.5e-05,172.31.36.0-255,66,1762,8,176923
8101,5e-05,172.217.194.0-255,2902,4664,8,176923
8102,6.1e-05,172.31.36.0-255,66,4730,8,176923
8103,6.8e-05,172.217.194.0-255,7156,11886,8,176923
8104,7.1e-05,172.31.36.0-255,66,11952,8,176923
8105,7.4e-05,172.217.194.0-255,2037,13989,8,176923
8106,7.8e-05,172.31.36.0-255,66,14055,8,176923
8107,9e-05,172.31.36.0-255,66,14121,8,176923
8108,0.000122,172.217.194.0-255,5379,19500,8,176923
8109,0.000125,172.31.36.0-255,66,19566,8,176923
8110,0.000152,172.217.194.0-255,1484,21050,8,176923
8111,0.000155,172.31.36.0-255,66,21116,8,176923
8112,0.000191,172.217.194.0-255,1484,22600,8,176923
8113,0.000194,172.31.36.0-255,66,22666,8,176923
8114,0.0002,172.217.194.0-255,4320,26986,8,176923
8115,0.000202,172.31.36.0-255,66,27052,8,176923
8116,0.00022,172.31.36.0-255,66,27118,8,176923
8117,0.000233,172.31.36.0-255,66,27184,8,176923
8118,0.00026,172.217.194.0-255,2902,30086,8,176923
8119,0.000262,172.31.36.0-255,66,30152,8,176923
8120,0.000286,172.217.194.0-255,3947,34099,8,176923
8121,0.00029,172.31.36.0-255,66,34165,8,176923
8122,0.000342,172.217.194.0-255,7156,41321,8,176923
8123,0.000346,172.31.36.0-255,66,41387,8,176923
8124,0.000353,172.217.194.0-255,5738,47125,8,176923
8125,0.000355,172.31.36.0-255,66,47191,8,176923
8126,0.000358,172.217.194.0-255,1484,48675,8,176923
8127,0.000388,172.217.194.0-255,2818,51493,8,176923
8128,0.000391,172.31.36.0-255,66,51559,8,176923
8129,0.000397,172.217.194.0-255,4320,55879,8,176923
8130,0.000399,172.31.36.0-255,66,55945,8,176923
8131,0.000411,172.31.36.0-255,66,56011,8,176923
8132,0.000415,172.217.194.0-255,2543,58554,8,176923
8133,0.000417,172.31.36.0-255,66,58620,8,176923
8134,0.000766,172.217.194.0-255,1484,60104,8,176923
8135,0.000779,172.217.194.0-255,2902,63006,8,176923
8136,0.000783,172.31.36.0-255,66,63072,8,176923
8137,0.00079,172.217.194.0-255,5738,68810,8,176923
8138,0.000792,172.31.36.0-255,66,68876,8,176923
8139,0.000831,172.31.36.0-255,66,68942,8,176923
8140,0.000844,172.31.36.0-255,66,69008,8,176923
8141,0.000872,172.217.194.0-255,1484,70492,8,176923
8142,0.000884,172.217.194.0-255,2902,73394,8,176923
8143,0.000887,172.31.36.0-255,66,73460,8,176923
8144,0.000893,172.217.194.0-255,2902,76362,8,176923
8145,0.000895,172.31.36.0-255,66,76428,8,176923
8146,0.000914,172.217.194.0-255,2902,79330,8,176923
8147,0.000918,172.31.36.0-255,66,79396,8,176923
8148,0.000935,172.31.36.0-255,66,79462,8,176923
8149,0.000972,172.217.194.0-255,1484,80946,8,176923
8150,0.000985,172.31.36.0-255,66,81012,8,176923
8151,0.00101,172.217.194.0-255,1484,82496,8,176923
8152,0.001022,172.217.194.0-255,1484,83980,8,176923
8153,0.001025,172.31.36.0-255,66,84046,8,176923
8154,0.001037,172.217.194.0-255,1484,85530,8,176923
8155,0.001048,172.217.194.0-255,5738,91268,8,176923
8156,0.001052,172.31.36.0-255,66,91334,8,176923
8157,0.001063,172.31.36.0-255,66,91400,8,176923
8158,0.001087,172.217.194.0-255,4320,95720,8,176923
8159,0.00109,172.31.36.0-255,66,95786,8,176923
8160,0.001096,172.217.194.0-255,4320,100106,8,176923
8161,0.001098,172.31.36.0-255,66,100172,8,176923
8162,0.001125,172.217.194.0-255,6438,106610,8,176923
8163,0.001129,172.31.36.0-255,66,106676,8,176923
8164,0.001133,172.217.194.0-255,1484,108160,8,176923
8165,0.001169,172.217.194.0-255,1484,109644,8,176923
8166,0.001172,172.31.36.0-255,66,109710,8,176923
8167,0.001184,172.31.36.0-255,66,109776,8,176923
8168,0.001189,172.217.194.0-255,4320,114096,8,176923
8169,0.001192,172.31.36.0-255,66,114162,8,176923
8170,0.001223,172.217.194.0-255,2184,116346,8,176923
8171,0.001226,172.31.36.0-255,66,116412,8,176923
8172,0.001276,172.217.194.0-255,1484,117896,8,176923
8173,0.001282,172.217.194.0-255,2902,120798,8,176923
8174,0.001285,172.31.36.0-255,66,120864,8,176923
8175,0.001316,172.217.194.0-255,5738,126602,8,176923
8176,0.001322,172.31.36.0-255,66,126668,8,176923
8177,0.001371,172.31.36.0-255,66,126734,8,176923
8178,0.0014,172.217.194.0-255,1484,128218,8,176923
8179,0.001415,172.31.36.0-255,66,128284,8,176923
8180,0.001444,172.217.194.0-255,1484,129768,8,176923
8181,0.00145,172.217.194.0-255,2902,132670,8,176923
8182,0.001453,172.31.36.0-255,66,132736,8,176923
8183,0.001458,172.217.194.0-255,2902,135638,8,176923
8184,0.00146,172.31.36.0-255,66,135704,8,176923
8185,0.001495,172.217.194.0-255,2902,138606,8,176923
8186,0.001498,172.31.36.0-255,66,138672,8,176923
8187,0.001511,172.31.36.0-255,66,138738,8,176923
8188,0.001516,172.217.194.0-255,2902,141640,8,176923
8189,0.001518,172.31.36.0-255,66,141706,8,176923
8190,0.001558,172.217.194.0-255,5738,147444,8,176923
8191,0.001562,172.217.194.0-255,2184,149628,8,176923
8192,0.001563,172.31.36.0-255,66,149694,8,176923
8193,0.001567,172.31.36.0-255,66,149760,8,176923
8194,0.0016,172.217.194.0-255,2902,152662,8,176923
8195,0.001609,172.31.36.0-255,66,152728,8,176923
8196,0.001616,172.217.194.0-255,7156,159884,8,176923
8197,0.001618,172.31.36.0-255,66,159950,8,176923
8198,0.00163,172.31.36.0-255,66,160016,8,176923
8199,0.001633,172.217.194.0-255,1484,161500,8,176923
8200,0.001671,172.31.36.0-255,66,161566,8,176923
8201,0.001687,172.31.36.0-255,66,161632,8,176923
8202,0.001713,172.217.194.0-255,4320,165952,8,176923
8203,0.001716,172.31.36.0-255,66,166018,8,176923
8204,0.001759,172.31.36.0-255,66,166084,8,176923
8205,0.001787,172.217.194.0-255,5020,171104,8,176923
8206,0.001791,172.31.36.0-255,66,171170,8,176923
8207,0.001805,172.31.36.0-255,66,171236,8,176923
8208,0.001841,172.31.36.0-255,66,171302,8,176923
8209,0.001845,172.217.194.0-255,105,171407,8,176923
8210,0.003578,172.31.36.0-255,66,171473,8,176923
8211,0.003605,172.31.36.0-255,105,171578,8,176923
8212,0.005576,172.217.194.0-255,66,171644,8,176923
8213,0.031304,172.31.36.0-255,172,171816,8,176923
8214,0.031334,172.31.36.0-255,1112,172928,8,176923
8215,0.031378,172.31.36.0-255,1514,174442,8,176923
8216,0.03138,172.31.36.0-255,1514,175956,8,176923
8217,0.031403,172.31.36.0-255,703,176659,8,176923
8218,0.032794,104.244.42.0-255,66,176725,8,176923
8219,0.032822,104.244.42.0-255,66,176791,8,176923
8220,0.032878,104.244.42.0-255,66,176857,8,176923
8221,0.032881,104.244.42.0-255,66,176923,8,176923
8222,0.0,74.125.24.0-255,146,146,8,280747
8223,1.5e-05,172.31.36.0-255,66,212,8,280747
8224,2.2e-05,74.125.24.0-255,1484,1696,8,280747
8225,2.7e-05,172.31.36.0-255,66,1762,8,280747
8226,3.3e-05,74.125.24.0-255,2902,4664,8,280747
8227,3.6e-05,172.31.36.0-255,66,4730,8,280747
8228,4.5e-05,74.125.24.0-255,7156,11886,8,280747
8229,4.8e-05,172.31.36.0-255,66,11952,8,280747
8230,5.2e-05,74.125.24.0-255,2013,13965,8,280747
8231,5.5e-05,172.31.36.0-255,66,14031,8,280747
8232,0.000115,74.125.24.0-255,1484,15515,8,280747
8233,0.000119,172.31.36.0-255,66,15581,8,280747
8234,0.000124,74.125.24.0-255,2902,18483,8,280747
8235,0.000126,172.31.36.0-255,66,18549,8,280747
8236,0.000151,74.125.24.0-255,5738,24287,8,280747
8237,0.000156,74.125.24.0-255,4320,28607,8,280747
8238,0.000159,172.31.36.0-255,66,28673,8,280747
8239,0.000162,172.31.36.0-255,66,28739,8,280747
8240,0.000198,74.125.24.0-255,2543,31282,8,280747
8241,0.0002,172.31.36.0-255,66,31348,8,280747
8242,0.000433,74.125.24.0-255,1484,32832,8,280747
8243,0.000438,172.31.36.0-255,66,32898,8,280747
8244,0.000444,74.125.24.0-255,2902,35800,8,280747
8245,0.000448,172.31.36.0-255,66,35866,8,280747
8246,0.000454,74.125.24.0-255,5738,41604,8,280747
8247,0.000457,172.31.36.0-255,66,41670,8,280747
8248,0.000462,74.125.24.0-255,4320,45990,8,280747
8249,0.000464,172.31.36.0-255,66,46056,8,280747
8250,0.000485,74.125.24.0-255,4320,50376,8,280747
8251,0.000488,172.31.36.0-255,66,50442,8,280747
8252,0.000525,172.31.36.0-255,66,50508,8,280747
8253,0.000532,74.125.24.0-255,6797,57305,8,280747
8254,0.000551,172.31.36.0-255,66,57371,8,280747
8255,0.000972,74.125.24.0-255,646,58017,8,280747
8256,0.001043,172.31.36.0-255,66,58083,8,280747
8257,0.001206,74.125.24.0-255,1484,59567,8,280747
8258,0.001215,74.125.24.0-255,2902,62469,8,280747
8259,0.001221,74.125.24.0-255,2902,65371,8,280747
8260,0.001237,74.125.24.0-255,2902,68273,8,280747
8261,0.001253,74.125.24.0-255,5738,74011,8,280747
8262,0.001274,74.125.24.0-255,7156,81167,8,280747
8263,0.001279,74.125.24.0-255,2902,84069,8,280747
8264,0.001294,74.125.24.0-255,4320,88389,8,280747
8265,0.001315,74.125.24.0-255,3602,91991,8,280747
8266,0.002233,74.125.24.0-255,1484,93475,8,280747
8267,0.002242,74.125.24.0-255,2902,96377,8,280747
8268,0.002248,74.125.24.0-255,5738,102115,8,280747
8269,0.002266,74.125.24.0-255,2902,105017,8,280747
8270,0.002346,74.125.24.0-255,1484,106501,8,280747
8271,0.002351,74.125.24.0-255,2902,109403,8,280747
8272,0.002362,74.125.24.0-255,1484,110887,8,280747
8273,0.002384,74.125.24.0-255,4320,115207,8,280747
8274,0.002391,74.125.24.0-255,5738,120945,8,280747
8275,0.005854,172.31.36.0-255,66,121011,8,280747
8276,0.008269,74.125.24.0-255,5738,126749,8,280747
8277,0.008275,172.31.36.0-255,66,126815,8,280747
8278,0.010637,74.125.24.0-255,5738,132553,8,280747
8279,0.010645,172.31.36.0-255,66,132619,8,280747
8280,0.01302,74.125.24.0-255,5738,138357,8,280747
8281,0.013416,172.31.36.0-255,66,138423,8,280747
8282,0.015769,74.125.24.0-255,5738,144161,8,280747
8283,0.015779,172.31.36.0-255,66,144227,8,280747
8284,0.018135,74.125.24.0-255,5738,149965,8,280747
8285,0.018144,172.31.36.0-255,66,150031,8,280747
8286,0.020488,74.125.24.0-255,5738,155769,8,280747
8287,0.020495,172.31.36.0-255,66,155835,8,280747
8288,0.022847,74.125.24.0-255,5738,161573,8,280747
8289,0.022855,172.31.36.0-255,66,161639,8,280747
8290,0.025211,74.125.24.0-255,5738,167377,8,280747
8291,0.025219,172.31.36.0-255,66,167443,8,280747
8292,0.027561,74.125.24.0-255,5738,173181,8,280747
8293,0.027569,172.31.36.0-255,66,173247,8,280747
8294,0.029914,74.125.24.0-255,5738,178985,8,280747
8295,0.029921,172.31.36.0-255,66,179051,8,280747
8296,0.03224,172.31.36.0-255,172,179223,8,280747
8297,0.032281,74.125.24.0-255,5738,184961,8,280747
8298,0.032286,172.31.36.0-255,66,185027,8,280747
8299,0.032291,172.31.36.0-255,1113,186140,8,280747
8300,0.032434,172.31.36.0-255,1514,187654,8,280747
8301,0.032437,172.31.36.0-255,1514,189168,8,280747
8302,0.032443,172.31.36.0-255,1514,190682,8,280747
8303,0.032444,172.31.36.0-255,1514,192196,8,280747
8304,0.032467,172.31.36.0-255,1227,193423,8,280747
8305,0.03377,104.244.42.0-255,66,193489,8,280747
8306,0.033845,104.244.42.0-255,66,193555,8,280747
8307,0.034007,104.244.42.0-255,66,193621,8,280747
8308,0.034013,104.244.42.0-255,66,193687,8,280747
8309,0.034629,74.125.24.0-255,5738,199425,8,280747
8310,0.034636,172.31.36.0-255,66,199491,8,280747
8311,0.036996,74.125.24.0-255,5738,205229,8,280747
8312,0.037004,172.31.36.0-255,66,205295,8,280747
8313,0.039368,74.125.24.0-255,5738,211033,8,280747
8314,0.039374,172.31.36.0-255,66,211099,8,280747
8315,0.041749,74.125.24.0-255,5738,216837,8,280747
8316,0.041755,172.31.36.0-255,66,216903,8,280747
8317,0.044113,74.125.24.0-255,5738,222641,8,280747
8318,0.044119,172.31.36.0-255,66,222707,8,280747
8319,0.046481,74.125.24.0-255,5738,228445,8,280747
8320,0.046489,172.31.36.0-255,66,228511,8,280747
8321,0.048864,74.125.24.0-255,5738,234249,8,280747
8322,0.048871,172.31.36.0-255,66,234315,8,280747
8323,0.051247,74.125.24.0-255,5738,240053,8,280747
8324,0.051257,172.31.36.0-255,66,240119,8,280747
8325,0.053641,74.125.24.0-255,5738,245857,8,280747
8326,0.053647,172.31.36.0-255,66,245923,8,280747
8327,0.055996,74.125.24.0-255,5738,251661,8,280747
8328,0.056002,172.31.36.0-255,66,251727,8,280747
8329,0.058371,74.125.24.0-255,5738,257465,8,280747
8330,0.058378,172.31.36.0-255,66,257531,8,280747
8331,0.060727,74.125.24.0-255,5738,263269,8,280747
8332,0.060734,172.31.36.0-255,66,263335,8,280747
8333,0.063118,74.125.24.0-255,5738,269073,8,280747
8334,0.063124,172.31.36.0-255,66,269139,8,280747
8335,0.065494,74.125.24.0-255,5738,274877,8,280747
8336,0.0655,172.31.36.0-255,66,274943,8,280747
8337,0.0679,74.125.24.0-255,5738,280681,8,280747
8338,0.067907,172.31.36.0-255,66,280747,8,280747
8339,0.0,74.125.24.0-255,153,153,8,222271
8340,1.4e-05,172.31.36.0-255,66,219,8,222271
8341,2.1e-05,74.125.24.0-255,1484,1703,8,222271
8342,2.5e-05,172.31.36.0-255,66,1769,8,222271
8343,3.1e-05,74.125.24.0-255,2902,4671,8,222271
8344,3.4e-05,172.31.36.0-255,66,4737,8,222271
8345,4.1e-05,74.125.24.0-255,7156,11893,8,222271
8346,4.4e-05,172.31.36.0-255,66,11959,8,222271
8347,5.1e-05,74.125.24.0-255,4320,16279,8,222271
8348,5.4e-05,172.31.36.0-255,66,16345,8,222271
8349,8.4e-05,172.31.36.0-255,66,16411,8,222271
8350,9.9e-05,74.125.24.0-255,5379,21790,8,222271
8351,0.000102,172.31.36.0-255,66,21856,8,222271
8352,0.000145,74.125.24.0-255,1484,23340,8,222271
8353,0.000147,172.31.36.0-255,66,23406,8,222271
8354,0.000152,74.125.24.0-255,2902,26308,8,222271
8355,0.000155,172.31.36.0-255,66,26374,8,222271
8356,0.000158,74.125.24.0-255,1484,27858,8,222271
8357,0.00016,172.31.36.0-255,66,27924,8,222271
8358,0.000187,74.125.24.0-255,4320,32244,8,222271
8359,0.00019,172.31.36.0-255,66,32310,8,222271
8360,0.000196,74.125.24.0-255,5738,38048,8,222271
8361,0.000198,172.31.36.0-255,66,38114,8,222271
8362,0.000219,172.31.36.0-255,66,38180,8,222271
8363,0.00023,172.31.36.0-255,66,38246,8,222271
8364,0.000245,74.125.24.0-255,1397,39643,8,222271
8365,0.000247,172.31.36.0-255,66,39709,8,222271
8366,0.000273,74.125.24.0-255,127,39836,8,222271
8367,0.000276,172.31.36.0-255,66,39902,8,222271
8368,0.000387,74.125.24.0-255,1484,41386,8,222271
8369,0.000401,74.125.24.0-255,2902,44288,8,222271
8370,0.000405,172.31.36.0-255,66,44354,8,222271
8371,0.000424,74.125.24.0-255,5738,50092,8,222271
8372,0.000427,172.31.36.0-255,66,50158,8,222271
8373,0.000463,74.125.24.0-255,4320,54478,8,222271
8374,0.000466,172.31.36.0-255,66,54544,8,222271
8375,0.000489,74.125.24.0-255,5379,59923,8,222271
8376,0.000492,172.31.36.0-255,66,59989,8,222271
8377,0.000503,172.31.36.0-255,66,60055,8,222271
8378,0.000509,74.125.24.0-255,3961,64016,8,222271
8379,0.000512,172.31.36.0-255,66,64082,8,222271
8380,0.000611,74.125.24.0-255,1484,65566,8,222271
8381,0.000617,74.125.24.0-255,2902,68468,8,222271
8382,0.00062,172.31.36.0-255,66,68534,8,222271
8383,0.000626,74.125.24.0-255,2902,71436,8,222271
8384,0.000628,172.31.36.0-255,66,71502,8,222271
8385,0.000643,74.125.24.0-255,2902,74404,8,222271
8386,0.000645,172.31.36.0-255,66,74470,8,222271
8387,0.000648,74.125.24.0-255,1484,75954,8,222271
8388,0.000684,172.31.36.0-255,66,76020,8,222271
8389,0.000696,172.31.36.0-255,66,76086,8,222271
8390,0.000763,74.125.24.0-255,766,76852,8,222271
8391,0.000767,74.125.24.0-255,1484,78336,8,222271
8392,0.00077,172.31.36.0-255,66,78402,8,222271
8393,0.000776,74.125.24.0-255,4320,82722,8,222271
8394,0.000779,172.31.36.0-255,66,82788,8,222271
8395,0.000791,172.31.36.0-255,66,82854,8,222271
8396,0.000793,74.125.24.0-255,1484,84338,8,222271
8397,0.000802,74.125.24.0-255,7156,91494,8,222271
8398,0.000804,172.31.36.0-255,66,91560,8,222271
8399,0.000824,74.125.24.0-255,5738,97298,8,222271
8400,0.000827,172.31.36.0-255,66,97364,8,222271
8401,0.000831,74.125.24.0-255,3602,100966,8,222271
8402,0.000833,172.31.36.0-255,66,101032,8,222271
8403,0.000868,74.125.24.0-255,4320,105352,8,222271
8404,0.000871,172.31.36.0-255,66,105418,8,222271
8405,0.000902,172.31.36.0-255,66,105484,8,222271
8406,0.000935,172.31.36.0-255,66,105550,8,222271
8407,0.000957,74.125.24.0-255,2902,108452,8,222271
8408,0.00096,172.31.36.0-255,66,108518,8,222271
8409,0.000966,74.125.24.0-255,5738,114256,8,222271
8410,0.000969,172.31.36.0-255,66,114322,8,222271
8411,0.000971,74.125.24.0-255,766,115088,8,222271
8412,0.001011,74.125.24.0-255,1484,116572,8,222271
8413,0.001014,172.31.36.0-255,66,116638,8,222271
8414,0.00102,74.125.24.0-255,4320,120958,8,222271
8415,0.001023,172.31.36.0-255,66,121024,8,222271
8416,0.00105,74.125.24.0-255,4320,125344,8,222271
8417,0.001054,172.31.36.0-255,66,125410,8,222271
8418,0.00106,74.125.24.0-255,5738,131148,8,222271
8419,0.001063,172.31.36.0-255,66,131214,8,222271
8420,0.00107,74.125.24.0-255,7156,138370,8,222271
8421,0.001072,172.31.36.0-255,66,138436,8,222271
8422,0.001098,74.125.24.0-255,4320,142756,8,222271
8423,0.001101,172.31.36.0-255,66,142822,8,222271
8424,0.001109,74.125.24.0-255,6438,149260,8,222271
8425,0.001111,172.31.36.0-255,66,149326,8,222271
8426,0.00114,74.125.24.0-255,7156,156482,8,222271
8427,0.001143,172.31.36.0-255,66,156548,8,222271
8428,0.001165,74.125.24.0-255,1484,158032,8,222271
8429,0.001183,172.31.36.0-255,66,158098,8,222271
8430,0.001201,74.125.24.0-255,5738,163836,8,222271
8431,0.001267,74.125.24.0-255,2902,166738,8,222271
8432,0.001274,74.125.24.0-255,6438,173176,8,222271
8433,0.001434,74.125.24.0-255,1484,174660,8,222271
8434,0.00144,74.125.24.0-255,2902,177562,8,222271
8435,0.001463,74.125.24.0-255,4320,181882,8,222271
8436,0.001504,74.125.24.0-255,4320,186202,8,222271
8437,0.00153,74.125.24.0-255,4320,190522,8,222271
8438,0.001646,74.125.24.0-255,1484,192006,8,222271
8439,0.00165,74.125.24.0-255,1484,193490,8,222271
8440,0.001669,74.125.24.0-255,1484,194974,8,222271
8441,0.001676,74.125.24.0-255,5738,200712,8,222271
8442,0.001711,74.125.24.0-255,5738,206450,8,222271
8443,0.00173,74.125.24.0-255,5020,211470,8,222271
8444,0.00181,74.125.24.0-255,1484,212954,8,222271
8445,0.00183,74.125.24.0-255,4520,217474,8,222271
8446,0.001843,74.125.24.0-255,105,217579,8,222271
8447,0.001955,172.31.36.0-255,66,217645,8,222271
8448,0.004267,172.31.36.0-255,101,217746,8,222271
8449,0.006182,74.125.24.0-255,66,217812,8,222271
8450,0.009107,172.31.36.0-255,105,217917,8,222271
8451,0.011027,74.125.24.0-255,66,217983,8,222271
8452,0.03246,172.31.36.0-255,172,218155,8,222271
8453,0.032493,172.31.36.0-255,1112,219267,8,222271
8454,0.032578,172.31.36.0-255,1514,220781,8,222271
8455,0.03258,172.31.36.0-255,1292,222073,8,222271
8456,0.034028,104.244.42.0-255,66,222139,8,222271
8457,0.034065,104.244.42.0-255,66,222205,8,222271
8458,0.034172,104.244.42.0-255,66,222271,8,222271
8459,0.0,74.125.68.0-255,299,299,8,163768
8460,2.7e-05,172.31.36.0-255,66,365,8,163768
8461,3.2e-05,74.125.68.0-255,1484,1849,8,163768
8462,3.6e-05,172.31.36.0-255,66,1915,8,163768
8463,5.7e-05,74.125.68.0-255,2902,4817,8,163768
8464,6.3e-05,172.31.36.0-255,66,4883,8,163768
8465,6.6e-05,74.125.68.0-255,1484,6367,8,163768
8466,6.7e-05,172.31.36.0-255,66,6433,8,163768
8467,9.1e-05,74.125.68.0-255,2902,9335,8,163768
8468,9.3e-05,172.31.36.0-255,66,9401,8,163768
8469,9.7e-05,74.125.68.0-255,2902,12303,8,163768
8470,9.9e-05,172.31.36.0-255,66,12369,8,163768
8471,0.00013,74.125.68.0-255,1853,14222,8,163768
8472,0.000133,172.31.36.0-255,66,14288,8,163768
8473,0.000163,74.125.68.0-255,7156,21444,8,163768
8474,0.000165,172.31.36.0-255,66,21510,8,163768
8475,0.000225,172.31.36.0-255,66,21576,8,163768
8476,0.000293,74.125.68.0-255,1125,22701,8,163768
8477,0.000298,172.31.36.0-255,66,22767,8,163768
8478,0.000303,74.125.68.0-255,2902,25669,8,163768
8479,0.000304,172.31.36.0-255,66,25735,8,163768
8480,0.000337,172.31.36.0-255,66,25801,8,163768
8481,0.000418,74.125.68.0-255,2902,28703,8,163768
8482,0.000422,172.31.36.0-255,66,28769,8,163768
8483,0.00048,172.31.36.0-255,66,28835,8,163768
8484,0.000611,74.125.68.0-255,2543,31378,8,163768
8485,0.000616,172.31.36.0-255,66,31444,8,163768
8486,0.000639,74.125.68.0-255,2902,34346,8,163768
8487,0.000642,172.31.36.0-255,66,34412,8,163768
8488,0.000664,74.125.68.0-255,4320,38732,8,163768
8489,0.000673,172.31.36.0-255,66,38798,8,163768
8490,0.000675,74.125.68.0-255,2902,41700,8,163768
8491,0.000685,172.31.36.0-255,66,41766,8,163768
8492,0.000732,74.125.68.0-255,2902,44668,8,163768
8493,0.000735,172.31.36.0-255,66,44734,8,163768
8494,0.00076,74.125.68.0-255,5738,50472,8,163768
8495,0.000769,172.31.36.0-255,66,50538,8,163768
8496,0.000783,172.31.36.0-255,66,50604,8,163768
8497,0.000916,74.125.68.0-255,5020,55624,8,163768
8498,0.00092,172.31.36.0-255,66,55690,8,163768
8499,0.000964,74.125.68.0-255,7156,62846,8,163768
8500,0.000972,172.31.36.0-255,66,62912,8,163768
8501,0.000978,74.125.68.0-255,2902,65814,8,163768
8502,0.00099,172.31.36.0-255,66,65880,8,163768
8503,0.001068,74.125.68.0-255,4320,70200,8,163768
8504,0.001076,172.31.36.0-255,66,70266,8,163768
8505,0.001099,172.31.36.0-255,66,70332,8,163768
8506,0.00123,74.125.68.0-255,5738,76070,8,163768
8507,0.001235,172.31.36.0-255,66,76136,8,163768
8508,0.001263,74.125.68.0-255,4723,80859,8,163768
8509,0.001269,172.31.36.0-255,66,80925,8,163768
8510,0.001318,74.125.68.0-255,1484,82409,8,163768
8511,0.001348,172.31.36.0-255,66,82475,8,163768
8512,0.001399,172.31.36.0-255,66,82541,8,163768
8513,0.00159,74.125.68.0-255,766,83307,8,163768
8514,0.001622,172.31.36.0-255,66,83373,8,163768
8515,0.001656,74.125.68.0-255,2902,86275,8,163768
8516,0.001689,172.31.36.0-255,66,86341,8,163768
8517,0.001731,74.125.68.0-255,7156,93497,8,163768
8518,0.001755,74.125.68.0-255,7156,100653,8,163768
8519,0.001768,172.31.36.0-255,66,100719,8,163768
8520,0.001879,74.125.68.0-255,7156,107875,8,163768
8521,0.001887,172.31.36.0-255,66,107941,8,163768
8522,0.001922,172.31.36.0-255,66,108007,8,163768
8523,0.002167,172.31.36.0-255,66,108073,8,163768
8524,0.002266,74.125.68.0-255,4320,112393,8,163768
8525,0.0023,172.31.36.0-255,66,112459,8,163768
8526,0.002401,172.31.36.0-255,66,112525,8,163768
8527,0.002803,172.31.36.0-255,66,112591,8,163768
8528,0.002962,172.31.36.0-255,66,112657,8,163768
8529,0.003019,172.31.36.0-255,66,112723,8,163768
8530,0.003752,172.31.36.0-255,101,112824,8,163768
8531,0.005287,74.125.68.0-255,5738,118562,8,163768
8532,0.005291,172.31.36.0-255,66,118628,8,163768
8533,0.005975,74.125.68.0-255,66,118694,8,163768
8534,0.007554,74.125.68.0-255,5738,124432,8,163768
8535,0.00756,172.31.36.0-255,66,124498,8,163768
8536,0.009817,74.125.68.0-255,5738,130236,8,163768
8537,0.009822,172.31.36.0-255,66,130302,8,163768
8538,0.012077,74.125.68.0-255,5738,136040,8,163768
8539,0.012085,172.31.36.0-255,66,136106,8,163768
8540,0.014343,74.125.68.0-255,5738,141844,8,163768
8541,0.014351,172.31.36.0-255,66,141910,8,163768
8542,0.01661,74.125.68.0-255,5738,147648,8,163768
8543,0.016617,172.31.36.0-255,66,147714,8,163768
8544,0.018877,74.125.68.0-255,5738,153452,8,163768
8545,0.018883,172.31.36.0-255,66,153518,8,163768
8546,0.02114,74.125.68.0-255,5738,159256,8,163768
8547,0.021145,172.31.36.0-255,66,159322,8,163768
8548,0.023372,74.125.68.0-255,248,159570,8,163768
8549,0.023524,172.31.36.0-255,105,159675,8,163768
8550,0.030963,74.125.68.0-255,66,159741,8,163768
8551,0.039554,172.31.36.0-255,176,159917,8,163768
8552,0.039613,172.31.36.0-255,1113,161030,8,163768
8553,0.039716,172.31.36.0-255,1514,162544,8,163768
8554,0.039718,172.31.36.0-255,1026,163570,8,163768
8555,0.041099,104.244.42.0-255,66,163636,8,163768
8556,0.041134,104.244.42.0-255,66,163702,8,163768
8557,0.041273,104.244.42.0-255,66,163768,8,163768
8558,0.0,172.217.160.0-255,153,153,8,302356
8559,1.7e-05,172.31.36.0-255,66,219,8,302356
8560,2.5e-05,172.217.160.0-255,1484,1703,8,302356
8561,2.9e-05,172.31.36.0-255,66,1769,8,302356
8562,3.5e-05,172.217.160.0-255,2902,4671,8,302356
8563,3.9e-05,172.31.36.0-255,66,4737,8,302356
8564,6.7e-05,172.217.160.0-255,4320,9057,8,302356
8565,7e-05,172.31.36.0-255,66,9123,8,302356
8566,0.000105,172.217.160.0-255,4846,13969,8,302356
8567,0.000108,172.31.36.0-255,66,14035,8,302356
8568,0.000165,172.217.160.0-255,1484,15519,8,302356
8569,0.000168,172.31.36.0-255,66,15585,8,302356
8570,0.000183,172.217.160.0-255,2902,18487,8,302356
8571,0.000185,172.31.36.0-255,66,18553,8,302356
8572,0.00019,172.217.160.0-255,2902,21455,8,302356
8573,0.000193,172.31.36.0-255,66,21521,8,302356
8574,0.000214,172.217.160.0-255,2902,24423,8,302356
8575,0.000217,172.31.36.0-255,66,24489,8,302356
8576,0.000221,172.217.160.0-255,2902,27391,8,302356
8577,0.000223,172.31.36.0-255,66,27457,8,302356
8578,0.000251,172.31.36.0-255,66,27523,8,302356
8579,0.000255,172.217.160.0-255,1484,29007,8,302356
8580,0.000258,172.31.36.0-255,66,29073,8,302356
8581,0.000289,172.31.36.0-255,66,29139,8,302356
8582,0.000304,172.217.160.0-255,2902,32041,8,302356
8583,0.000306,172.31.36.0-255,66,32107,8,302356
8584,0.000332,172.31.36.0-255,66,32173,8,302356
8585,0.000352,172.217.160.0-255,4320,36493,8,302356
8586,0.000355,172.31.36.0-255,66,36559,8,302356
8587,0.000358,172.217.160.0-255,1397,37956,8,302356
8588,0.001034,172.31.36.0-255,66,38022,8,302356
8589,0.00122,172.217.160.0-255,124,38146,8,302356
8590,0.001314,172.217.160.0-255,1484,39630,8,302356
8591,0.001318,172.31.36.0-255,66,39696,8,302356
8592,0.001324,172.217.160.0-255,2902,42598,8,302356
8593,0.001326,172.31.36.0-255,66,42664,8,302356
8594,0.001333,172.217.160.0-255,4320,46984,8,302356
8595,0.001335,172.31.36.0-255,66,47050,8,302356
8596,0.001351,172.217.160.0-255,1484,48534,8,302356
8597,0.001388,172.31.36.0-255,66,48600,8,302356
8598,0.001393,172.217.160.0-255,2902,51502,8,302356
8599,0.001395,172.31.36.0-255,66,51568,8,302356
8600,0.001411,172.217.160.0-255,4320,55888,8,302356
8601,0.001414,172.31.36.0-255,66,55954,8,302356
8602,0.00145,172.217.160.0-255,5379,61333,8,302356
8603,0.001453,172.31.36.0-255,66,61399,8,302356
8604,0.001538,172.217.160.0-255,1484,62883,8,302356
8605,0.001554,172.217.160.0-255,2902,65785,8,302356
8606,0.001556,172.31.36.0-255,66,65851,8,302356
8607,0.001561,172.217.160.0-255,2902,68753,8,302356
8608,0.001563,172.31.36.0-255,66,68819,8,302356
8609,0.001577,172.217.160.0-255,2902,71721,8,302356
8610,0.001579,172.31.36.0-255,66,71787,8,302356
8611,0.001588,172.217.160.0-255,7156,78943,8,302356
8612,0.00159,172.31.36.0-255,66,79009,8,302356
8613,0.001617,172.217.160.0-255,5738,84747,8,302356
8614,0.001619,172.31.36.0-255,66,84813,8,302356
8615,0.001633,172.31.36.0-255,66,84879,8,302356
8616,0.001637,172.217.160.0-255,2496,87375,8,302356
8617,0.00164,172.31.36.0-255,66,87441,8,302356
8618,0.001682,172.217.160.0-255,2902,90343,8,302356
8619,0.001685,172.31.36.0-255,66,90409,8,302356
8620,0.001688,172.217.160.0-255,1484,91893,8,302356
8621,0.001706,172.217.160.0-255,2902,94795,8,302356
8622,0.001708,172.31.36.0-255,66,94861,8,302356
8623,0.00172,172.31.36.0-255,66,94927,8,302356
8624,0.001763,172.31.36.0-255,66,94993,8,302356
8625,0.001787,172.31.36.0-255,66,95059,8,302356
8626,0.003681,172.217.160.0-255,5738,100797,8,302356
8627,0.003687,172.31.36.0-255,66,100863,8,302356
8628,0.005575,172.217.160.0-255,5738,106601,8,302356
8629,0.005583,172.31.36.0-255,66,106667,8,302356
8630,0.007463,172.217.160.0-255,4320,110987,8,302356
8631,0.007467,172.31.36.0-255,66,111053,8,302356
8632,0.007479,172.217.160.0-255,1484,112537,8,302356
8633,0.009352,172.217.160.0-255,4320,116857,8,302356
8634,0.009359,172.31.36.0-255,66,116923,8,302356
8635,0.011238,172.217.160.0-255,5738,122661,8,302356
8636,0.011245,172.31.36.0-255,66,122727,8,302356
8637,0.013126,172.217.160.0-255,5738,128465,8,302356
8638,0.013134,172.31.36.0-255,66,128531,8,302356
8639,0.015034,172.217.160.0-255,5738,134269,8,302356
8640,0.015043,172.31.36.0-255,66,134335,8,302356
8641,0.016946,172.217.160.0-255,5738,140073,8,302356
8642,0.016953,172.31.36.0-255,66,140139,8,302356
8643,0.018875,172.217.160.0-255,5738,145877,8,302356
8644,0.018886,172.31.36.0-255,66,145943,8,302356
8645,0.020779,172.217.160.0-255,5738,151681,8,302356
8646,0.020787,172.31.36.0-255,66,151747,8,302356
8647,0.022675,172.217.160.0-255,5738,157485,8,302356
8648,0.022683,172.31.36.0-255,66,157551,8,302356
8649,0.024561,172.217.160.0-255,5738,163289,8,302356
8650,0.02457,172.31.36.0-255,66,163355,8,302356
8651,0.026475,172.217.160.0-255,5738,169093,8,302356
8652,0.026484,172.31.36.0-255,66,169159,8,302356
8653,0.028371,172.217.160.0-255,5738,174897,8,302356
8654,0.028378,172.31.36.0-255,66,174963,8,302356
8655,0.030266,172.217.160.0-255,5738,180701,8,302356
8656,0.030273,172.31.36.0-255,66,180767,8,302356
8657,0.032149,172.217.160.0-255,5738,186505,8,302356
8658,0.032158,172.31.36.0-255,66,186571,8,302356
8659,0.034039,172.217.160.0-255,5738,192309,8,302356
8660,0.034046,172.31.36.0-255,66,192375,8,302356
8661,0.035943,172.217.160.0-255,5738,198113,8,302356
8662,0.03595,172.31.36.0-255,66,198179,8,302356
8663,0.037835,172.217.160.0-255,5738,203917,8,302356
8664,0.037843,172.31.36.0-255,66,203983,8,302356
8665,0.039768,172.217.160.0-255,5738,209721,8,302356
8666,0.039776,172.31.36.0-255,66,209787,8,302356
8667,0.041651,172.217.160.0-255,5738,215525,8,302356
8668,0.041658,172.31.36.0-255,66,215591,8,302356
8669,0.042337,172.31.36.0-255,172,215763,8,302356
8670,0.042369,172.31.36.0-255,1113,216876,8,302356
8671,0.04243,172.31.36.0-255,1514,218390,8,302356
8672,0.042432,172.31.36.0-255,1514,219904,8,302356
8673,0.042437,172.31.36.0-255,1514,221418,8,302356
8674,0.042438,172.31.36.0-255,770,222188,8,302356
8675,0.043567,172.217.160.0-255,5738,227926,8,302356
8676,0.043578,172.31.36.0-255,66,227992,8,302356
8677,0.043915,104.244.42.0-255,66,228058,8,302356
8678,0.043954,104.244.42.0-255,66,228124,8,302356
8679,0.044003,104.244.42.0-255,66,228190,8,302356
8680,0.044009,104.244.42.0-255,66,228256,8,302356
8681,0.045453,172.217.160.0-255,5738,233994,8,302356
8682,0.04546,172.31.36.0-255,66,234060,8,302356
8683,0.047332,172.217.160.0-255,4320,238380,8,302356
8684,0.047339,172.31.36.0-255,66,238446,8,302356
8685,0.047359,172.217.160.0-255,1484,239930,8,302356
8686,0.049234,172.217.160.0-255,4320,244250,8,302356
8687,0.049242,172.31.36.0-255,66,244316,8,302356
8688,0.051131,172.217.160.0-255,5738,250054,8,302356
8689,0.051138,172.31.36.0-255,66,250120,8,302356
8690,0.053046,172.217.160.0-255,5738,255858,8,302356
8691,0.053053,172.31.36.0-255,66,255924,8,302356
8692,0.054936,172.217.160.0-255,5738,261662,8,302356
8693,0.054942,172.31.36.0-255,66,261728,8,302356
8694,0.056828,172.217.160.0-255,5738,267466,8,302356
8695,0.056835,172.31.36.0-255,66,267532,8,302356
8696,0.058709,172.217.160.0-255,5738,273270,8,302356
8697,0.058715,172.31.36.0-255,66,273336,8,302356
8698,0.060594,172.217.160.0-255,5738,279074,8,302356
8699,0.060602,172.31.36.0-255,66,279140,8,302356
8700,0.062499,172.217.160.0-255,5738,284878,8,302356
8701,0.062506,172.31.36.0-255,66,284944,8,302356
8702,0.064382,172.217.160.0-255,5738,290682,8,302356
8703,0.064389,172.31.36.0-255,66,290748,8,302356
8704,0.066313,172.217.160.0-255,5738,296486,8,302356
8705,0.066324,172.31.36.0-255,66,296552,8,302356
8706,0.068219,172.217.160.0-255,5738,302290,8,302356
8707,0.068226,172.31.36.0-255,66,302356,8,302356
8708,0.0,172.217.27.0-255,146,146,8,332198
8709,3.6e-05,172.31.36.0-255,66,212,8,332198
8710,4.4e-05,172.217.27.0-255,1484,1696,8,332198
8711,4.8e-05,172.31.36.0-255,66,1762,8,332198
8712,6e-05,172.217.27.0-255,2902,4664,8,332198
8713,6.4e-05,172.31.36.0-255,66,4730,8,332198
8714,7.1e-05,172.217.27.0-255,7156,11886,8,332198
8715,7.4e-05,172.31.36.0-255,66,11952,8,332198
8716,0.000121,172.217.27.0-255,2092,14044,8,332198
8717,0.000124,172.31.36.0-255,66,14110,8,332198
8718,0.00013,172.217.27.0-255,2902,17012,8,332198
8719,0.000133,172.31.36.0-255,66,17078,8,332198
8720,0.000148,172.217.27.0-255,7156,24234,8,332198
8721,0.00015,172.31.36.0-255,66,24300,8,332198
8722,0.000157,172.217.27.0-255,5738,30038,8,332198
8723,0.000159,172.31.36.0-255,66,30104,8,332198
8724,0.000161,172.217.27.0-255,1125,31229,8,332198
8725,0.000164,172.31.36.0-255,66,31295,8,332198
8726,0.000234,172.217.27.0-255,1484,32779,8,332198
8727,0.000238,172.31.36.0-255,66,32845,8,332198
8728,0.000243,172.217.27.0-255,2902,35747,8,332198
8729,0.000245,172.31.36.0-255,66,35813,8,332198
8730,0.000278,172.217.27.0-255,5738,41551,8,332198
8731,0.000282,172.31.36.0-255,66,41617,8,332198
8732,0.000285,172.217.27.0-255,1484,43101,8,332198
8733,0.000287,172.31.36.0-255,66,43167,8,332198
8734,0.000318,172.217.27.0-255,5379,48546,8,332198
8735,0.000321,172.31.36.0-255,66,48612,8,332198
8736,0.000421,172.217.27.0-255,1484,50096,8,332198
8737,0.000425,172.31.36.0-255,66,50162,8,332198
8738,0.000445,172.217.27.0-255,2902,53064,8,332198
8739,0.00045,172.31.36.0-255,66,53130,8,332198
8740,0.000455,172.217.27.0-255,4320,57450,8,332198
8741,0.000459,172.31.36.0-255,66,57516,8,332198
8742,0.000499,172.31.36.0-255,66,57582,8,332198
8743,0.00097,172.217.27.0-255,132,57714,8,332198
8744,0.000975,172.31.36.0-255,66,57780,8,332198
8745,0.001173,172.217.27.0-255,1484,59264,8,332198
8746,0.001179,172.31.36.0-255,66,59330,8,332198
8747,0.001185,172.217.27.0-255,2902,62232,8,332198
8748,0.001186,172.31.36.0-255,66,62298,8,332198
8749,0.001217,172.217.27.0-255,5738,68036,8,332198
8750,0.001219,172.31.36.0-255,66,68102,8,332198
8751,0.001223,172.217.27.0-255,2902,71004,8,332198
8752,0.001225,172.31.36.0-255,66,71070,8,332198
8753,0.00123,172.217.27.0-255,3961,75031,8,332198
8754,0.001237,172.31.36.0-255,66,75097,8,332198
8755,0.001273,172.217.27.0-255,2902,77999,8,332198
8756,0.001276,172.31.36.0-255,66,78065,8,332198
8757,0.001282,172.217.27.0-255,4320,82385,8,332198
8758,0.001284,172.31.36.0-255,66,82451,8,332198
8759,0.001306,172.217.27.0-255,4320,86771,8,332198
8760,0.001314,172.31.36.0-255,66,86837,8,332198
8761,0.001325,172.217.27.0-255,4320,91157,8,332198
8762,0.001331,172.31.36.0-255,66,91223,8,332198
8763,0.001362,172.217.27.0-255,1125,92348,8,332198
8764,0.001366,172.31.36.0-255,66,92414,8,332198
8765,0.002993,172.217.27.0-255,4320,96734,8,332198
8766,0.002997,172.31.36.0-255,66,96800,8,332198
8767,0.003023,172.217.27.0-255,1484,98284,8,332198
8768,0.003025,172.31.36.0-255,66,98350,8,332198
8769,0.004651,172.217.27.0-255,4320,102670,8,332198
8770,0.004654,172.31.36.0-255,66,102736,8,332198
8771,0.004681,172.217.27.0-255,1484,104220,8,332198
8772,0.004683,172.31.36.0-255,66,104286,8,332198
8773,0.006317,172.217.27.0-255,4320,108606,8,332198
8774,0.006323,172.31.36.0-255,66,108672,8,332198
8775,0.006353,172.217.27.0-255,1484,110156,8,332198
8776,0.006356,172.31.36.0-255,66,110222,8,332198
8777,0.008001,172.217.27.0-255,5738,115960,8,332198
8778,0.00801,172.31.36.0-255,66,116026,8,332198
8779,0.009683,172.217.27.0-255,5738,121764,8,332198
8780,0.009691,172.31.36.0-255,66,121830,8,332198
8781,0.011368,172.217.27.0-255,5738,127568,8,332198
8782,0.011377,172.31.36.0-255,66,127634,8,332198
8783,0.01306,172.217.27.0-255,5738,133372,8,332198
8784,0.01307,172.31.36.0-255,66,133438,8,332198
8785,0.01474,172.217.27.0-255,5738,139176,8,332198
8786,0.014747,172.31.36.0-255,66,139242,8,332198
8787,0.016424,172.217.27.0-255,5738,144980,8,332198
8788,0.016429,172.31.36.0-255,66,145046,8,332198
8789,0.018087,172.217.27.0-255,5738,150784,8,332198
8790,0.018093,172.31.36.0-255,66,150850,8,332198
8791,0.019795,172.217.27.0-255,5738,156588,8,332198
8792,0.019804,172.31.36.0-255,66,156654,8,332198
8793,0.021471,172.217.27.0-255,5738,162392,8,332198
8794,0.021478,172.31.36.0-255,66,162458,8,332198
8795,0.023147,172.217.27.0-255,5738,168196,8,332198
8796,0.023155,172.31.36.0-255,66,168262,8,332198
8797,0.024831,172.217.27.0-255,5738,174000,8,332198
8798,0.024839,172.31.36.0-255,66,174066,8,332198
8799,0.026525,172.217.27.0-255,5738,179804,8,332198
8800,0.026532,172.31.36.0-255,66,179870,8,332198
8801,0.028186,172.217.27.0-255,1484,181354,8,332198
8802,0.028205,172.217.27.0-255,4320,185674,8,332198
8803,0.02821,172.31.36.0-255,66,185740,8,332198
8804,0.028366,172.31.36.0-255,172,185912,8,332198
8805,0.028393,172.31.36.0-255,1112,187024,8,332198
8806,0.028447,172.31.36.0-255,1514,188538,8,332198
8807,0.028449,172.31.36.0-255,1514,190052,8,332198
8808,0.02845,172.31.36.0-255,1514,191566,8,332198
8809,0.028451,172.31.36.0-255,1072,192638,8,332198
8810,0.029878,172.217.27.0-255,5738,198376,8,332198
8811,0.029884,172.31.36.0-255,66,198442,8,332198
8812,0.029917,104.244.42.0-255,66,198508,8,332198
8813,0.029953,104.244.42.0-255,66,198574,8,332198
8814,0.030002,104.244.42.0-255,66,198640,8,332198
8815,0.030006,104.244.42.0-255,66,198706,8,332198
8816,0.031556,172.217.27.0-255,5738,204444,8,332198
8817,0.031562,172.31.36.0-255,66,204510,8,332198
8818,0.033222,172.217.27.0-255,5738,210248,8,332198
8819,0.033229,172.31.36.0-255,66,210314,8,332198
8820,0.034901,172.217.27.0-255,5738,216052,8,332198
8821,0.034909,172.31.36.0-255,66,216118,8,332198
8822,0.036591,172.217.27.0-255,5738,221856,8,332198
8823,0.036599,172.31.36.0-255,66,221922,8,332198
8824,0.038269,172.217.27.0-255,5738,227660,8,332198
8825,0.038276,172.31.36.0-255,66,227726,8,332198
8826,0.039954,172.217.27.0-255,5738,233464,8,332198
8827,0.039968,172.31.36.0-255,66,233530,8,332198
8828,0.041635,172.217.27.0-255,5738,239268,8,332198
8829,0.041643,172.31.36.0-255,66,239334,8,332198
8830,0.043331,172.217.27.0-255,5738,245072,8,332198
8831,0.043337,172.31.36.0-255,66,245138,8,332198
8832,0.045043,172.217.27.0-255,5738,250876,8,332198
8833,0.04505,172.31.36.0-255,66,250942,8,332198
8834,0.046715,172.217.27.0-255,5738,256680,8,332198
8835,0.04672,172.31.36.0-255,66,256746,8,332198
8836,0.048416,172.217.27.0-255,5738,262484,8,332198
8837,0.048422,172.31.36.0-255,66,262550,8,332198
8838,0.05009,172.217.27.0-255,5738,268288,8,332198
8839,0.050096,172.31.36.0-255,66,268354,8,332198
8840,0.051767,172.217.27.0-255,5738,274092,8,332198
8841,0.051773,172.31.36.0-255,66,274158,8,332198
8842,0.053431,172.217.27.0-255,5738,279896,8,332198
8843,0.053437,172.31.36.0-255,66,279962,8,332198
8844,0.055108,172.217.27.0-255,5738,285700,8,332198
8845,0.055115,172.31.36.0-255,66,285766,8,332198
8846,0.056781,172.217.27.0-255,5738,291504,8,332198
8847,0.056787,172.31.36.0-255,66,291570,8,332198
8848,0.058457,172.217.27.0-255,5738,297308,8,332198
8849,0.058462,172.31.36.0-255,66,297374,8,332198
8850,0.060131,172.217.27.0-255,5738,303112,8,332198
8851,0.060139,172.31.36.0-255,66,303178,8,332198
8852,0.061807,172.217.27.0-255,5738,308916,8,332198
8853,0.061812,172.31.36.0-255,66,308982,8,332198
8854,0.063478,172.217.27.0-255,5738,314720,8,332198
8855,0.063485,172.31.36.0-255,66,314786,8,332198
8856,0.065154,172.217.27.0-255,5738,320524,8,332198
8857,0.065174,172.31.36.0-255,66,320590,8,332198
8858,0.066835,172.217.27.0-255,5738,326328,8,332198
8859,0.066841,172.31.36.0-255,66,326394,8,332198
8860,0.068503,172.217.27.0-255,5738,332132,8,332198
8861,0.068508,172.31.36.0-255,66,332198,8,332198
8862,0.0,74.125.68.0-255,146,146,8,343773
8863,3.7e-05,172.31.36.0-255,66,212,8,343773
8864,4.4e-05,74.125.68.0-255,1484,1696,8,343773
8865,4.8e-05,172.31.36.0-255,66,1762,8,343773
8866,5.4e-05,74.125.68.0-255,2902,4664,8,343773
8867,5.7e-05,172.31.36.0-255,66,4730,8,343773
8868,6.3e-05,74.125.68.0-255,5738,10468,8,343773
8869,6.5e-05,172.31.36.0-255,66,10534,8,343773
8870,9e-05,74.125.68.0-255,2902,13436,8,343773
8871,9.3e-05,172.31.36.0-255,66,13502,8,343773
8872,0.0001,74.125.68.0-255,3467,16969,8,343773
8873,0.000102,172.31.36.0-255,66,17035,8,343773
8874,0.000119,74.125.68.0-255,1484,18519,8,343773
8875,0.000122,172.31.36.0-255,66,18585,8,343773
8876,0.000143,74.125.68.0-255,7156,25741,8,343773
8877,0.000146,172.31.36.0-255,66,25807,8,343773
8878,0.000151,74.125.68.0-255,4320,30127,8,343773
8879,0.000154,172.31.36.0-255,66,30193,8,343773
8880,0.000179,74.125.68.0-255,1125,31318,8,343773
8881,0.000182,172.31.36.0-255,66,31384,8,343773
8882,0.000232,74.125.68.0-255,1484,32868,8,343773
8883,0.000235,172.31.36.0-255,66,32934,8,343773
8884,0.000241,74.125.68.0-255,2902,35836,8,343773
8885,0.000244,172.31.36.0-255,66,35902,8,343773
8886,0.000274,74.125.68.0-255,5738,41640,8,343773
8887,0.000278,172.31.36.0-255,66,41706,8,343773
8888,0.000324,172.31.36.0-255,66,41772,8,343773
8889,0.000332,74.125.68.0-255,7156,48928,8,343773
8890,0.000335,172.31.36.0-255,66,48994,8,343773
8891,0.000352,74.125.68.0-255,2902,51896,8,343773
8892,0.000355,172.31.36.0-255,66,51962,8,343773
8893,0.000361,74.125.68.0-255,4320,56282,8,343773
8894,0.000363,172.31.36.0-255,66,56348,8,343773
8895,0.00039,74.125.68.0-255,1143,57491,8,343773
8896,0.000394,172.31.36.0-255,66,57557,8,343773
8897,0.000429,74.125.68.0-255,331,57888,8,343773
8898,0.000432,172.31.36.0-255,66,57954,8,343773
8899,0.000593,74.125.68.0-255,1484,59438,8,343773
8900,0.000597,172.31.36.0-255,66,59504,8,343773
8901,0.000601,74.125.68.0-255,1484,60988,8,343773
8902,0.000603,172.31.36.0-255,66,61054,8,343773
8903,0.000617,74.125.68.0-255,1484,62538,8,343773
8904,0.00062,172.31.36.0-255,66,62604,8,343773
8905,0.000625,74.125.68.0-255,4320,66924,8,343773
8906,0.000628,172.31.36.0-255,66,66990,8,343773
8907,0.000642,74.125.68.0-255,1484,68474,8,343773
8908,0.000645,172.31.36.0-255,66,68540,8,343773
8909,0.000653,74.125.68.0-255,6797,75337,8,343773
8910,0.000656,172.31.36.0-255,66,75403,8,343773
8911,0.00068,74.125.68.0-255,1484,76887,8,343773
8912,0.000683,172.31.36.0-255,66,76953,8,343773
8913,0.000699,74.125.68.0-255,7156,84109,8,343773
8914,0.000701,172.31.36.0-255,66,84175,8,343773
8915,0.000743,172.31.36.0-255,66,84241,8,343773
8916,0.001564,74.125.68.0-255,1484,85725,8,343773
8917,0.00157,172.31.36.0-255,66,85791,8,343773
8918,0.00158,74.125.68.0-255,2902,88693,8,343773
8919,0.001582,172.31.36.0-255,66,88759,8,343773
8920,0.001587,74.125.68.0-255,2902,91661,8,343773
8921,0.001589,172.31.36.0-255,66,91727,8,343773
8922,0.001613,74.125.68.0-255,1484,93211,8,343773
8923,0.001616,172.31.36.0-255,66,93277,8,343773
8924,0.001622,74.125.68.0-255,5738,99015,8,343773
8925,0.001624,172.31.36.0-255,66,99081,8,343773
8926,0.001692,74.125.68.0-255,2902,101983,8,343773
8927,0.001715,74.125.68.0-255,5020,107003,8,343773
8928,0.001742,74.125.68.0-255,4320,111323,8,343773
8929,0.001763,74.125.68.0-255,4320,115643,8,343773
8930,0.001768,74.125.68.0-255,4320,119963,8,343773
8931,0.001791,74.125.68.0-255,5738,125701,8,343773
8932,0.001798,74.125.68.0-255,7156,132857,8,343773
8933,0.001814,74.125.68.0-255,2902,135759,8,343773
8934,0.001851,74.125.68.0-255,5020,140779,8,343773
8935,0.001929,74.125.68.0-255,1484,142263,8,343773
8936,0.001946,74.125.68.0-255,2902,145165,8,343773
8937,0.001962,74.125.68.0-255,4320,149485,8,343773
8938,0.001971,74.125.68.0-255,1484,150969,8,343773
8939,0.001997,74.125.68.0-255,4320,155289,8,343773
8940,0.002052,74.125.68.0-255,2902,158191,8,343773
8941,0.002068,74.125.68.0-255,5738,163929,8,343773
8942,0.00208,74.125.68.0-255,2184,166113,8,343773
8943,0.002121,74.125.68.0-255,1484,167597,8,343773
8944,0.002132,74.125.68.0-255,2902,170499,8,343773
8945,0.002157,74.125.68.0-255,4320,174819,8,343773
8946,0.002161,74.125.68.0-255,2902,177721,8,343773
8947,0.002176,74.125.68.0-255,2902,180623,8,343773
8948,0.002194,74.125.68.0-255,2902,183525,8,343773
8949,0.002223,74.125.68.0-255,4320,187845,8,343773
8950,0.002306,74.125.68.0-255,4320,192165,8,343773
8951,0.002343,74.125.68.0-255,5738,197903,8,343773
8952,0.00236,74.125.68.0-255,6438,204341,8,343773
8953,0.002381,74.125.68.0-255,7156,211497,8,343773
8954,0.002419,74.125.68.0-255,2902,214399,8,343773
8955,0.002476,74.125.68.0-255,7156,221555,8,343773
8956,0.002491,74.125.68.0-255,5020,226575,8,343773
8957,0.002969,172.31.36.0-255,66,226641,8,343773
8958,0.005567,74.125.68.0-255,5738,232379,8,343773
8959,0.005574,172.31.36.0-255,66,232445,8,343773
8960,0.008156,74.125.68.0-255,4320,236765,8,343773
8961,0.008161,172.31.36.0-255,66,236831,8,343773
8962,0.00818,74.125.68.0-255,1484,238315,8,343773
8963,0.008182,172.31.36.0-255,66,238381,8,343773
8964,0.010731,74.125.68.0-255,5738,244119,8,343773
8965,0.010738,172.31.36.0-255,66,244185,8,343773
8966,0.013326,74.125.68.0-255,5738,249923,8,343773
8967,0.013335,172.31.36.0-255,66,249989,8,343773
8968,0.015922,74.125.68.0-255,5738,255727,8,343773
8969,0.015931,172.31.36.0-255,66,255793,8,343773
8970,0.018549,74.125.68.0-255,5738,261531,8,343773
8971,0.018559,172.31.36.0-255,66,261597,8,343773
8972,0.021127,74.125.68.0-255,5738,267335,8,343773
8973,0.021134,172.31.36.0-255,66,267401,8,343773
8974,0.023734,74.125.68.0-255,5738,273139,8,343773
8975,0.023744,172.31.36.0-255,66,273205,8,343773
8976,0.026323,74.125.68.0-255,4320,277525,8,343773
8977,0.02633,172.31.36.0-255,66,277591,8,343773
8978,0.026361,74.125.68.0-255,1484,279075,8,343773
8979,0.028915,74.125.68.0-255,4320,283395,8,343773
8980,0.028923,172.31.36.0-255,66,283461,8,343773
8981,0.0315,74.125.68.0-255,5738,289199,8,343773
8982,0.031558,172.31.36.0-255,66,289265,8,343773
8983,0.034142,74.125.68.0-255,5738,295003,8,343773
8984,0.03415,172.31.36.0-255,66,295069,8,343773
8985,0.036739,74.125.68.0-255,5738,300807,8,343773
8986,0.036748,172.31.36.0-255,66,300873,8,343773
8987,0.039325,74.125.68.0-255,5738,306611,8,343773
8988,0.039333,172.31.36.0-255,66,306677,8,343773
8989,0.041919,74.125.68.0-255,5738,312415,8,343773
8990,0.041927,172.31.36.0-255,66,312481,8,343773
8991,0.044538,74.125.68.0-255,5738,318219,8,343773
8992,0.044546,172.31.36.0-255,66,318285,8,343773
8993,0.047116,74.125.68.0-255,4320,322605,8,343773
8994,0.047124,172.31.36.0-255,66,322671,8,343773
8995,0.047143,74.125.68.0-255,1484,324155,8,343773
8996,0.048627,172.31.36.0-255,176,324331,8,343773
8997,0.048659,172.31.36.0-255,1111,325442,8,343773
8998,0.048709,172.31.36.0-255,1514,326956,8,343773
8999,0.048711,172.31.36.0-255,1514,328470,8,343773
9000,0.048712,172.31.36.0-255,1514,329984,8,343773
9001,0.048736,172.31.36.0-255,773,330757,8,343773
9002,0.049699,74.125.68.0-255,4320,335077,8,343773
9003,0.049706,172.31.36.0-255,66,335143,8,343773
9004,0.050195,104.244.42.0-255,66,335209,8,343773
9005,0.050203,104.244.42.0-255,66,335275,8,343773
9006,0.050289,104.244.42.0-255,66,335341,8,343773
9007,0.050294,104.244.42.0-255,66,335407,8,343773
9008,0.051665,104.244.42.0-255,108,335515,8,343773
9009,0.051688,172.31.36.0-255,66,335581,8,343773
9010,0.052304,74.125.68.0-255,4320,339901,8,343773
9011,0.052309,172.31.36.0-255,66,339967,8,343773
9012,0.052346,74.125.68.0-255,1484,341451,8,343773
9013,0.054891,74.125.68.0-255,2085,343536,8,343773
9014,0.054897,172.31.36.0-255,66,343602,8,343773
9015,0.05506,172.31.36.0-255,105,343707,8,343773
9016,0.057602,74.125.68.0-255,66,343773,8,343773
9017,0.0,172.217.194.0-255,153,153,8,245403
9018,3.6e-05,172.31.36.0-255,66,219,8,245403
9019,4.3e-05,172.217.194.0-255,1484,1703,8,245403
9020,4.9e-05,172.31.36.0-255,66,1769,8,245403
9021,5.5e-05,172.217.194.0-255,2902,4671,8,245403
9022,5.8e-05,172.31.36.0-255,66,4737,8,245403
9023,6.2e-05,172.217.194.0-255,1484,6221,8,245403
9024,6.4e-05,172.31.36.0-255,66,6287,8,245403
9025,6.9e-05,172.217.194.0-255,2902,9189,8,245403
9026,7.2e-05,172.31.36.0-255,66,9255,8,245403
9027,7.9e-05,172.217.194.0-255,4903,14158,8,245403
9028,8.2e-05,172.31.36.0-255,66,14224,8,245403
9029,0.000237,172.217.194.0-255,1484,15708,8,245403
9030,0.000241,172.31.36.0-255,66,15774,8,245403
9031,0.000248,172.217.194.0-255,2902,18676,8,245403
9032,0.00025,172.31.36.0-255,66,18742,8,245403
9033,0.000255,172.217.194.0-255,2902,21644,8,245403
9034,0.000257,172.31.36.0-255,66,21710,8,245403
9035,0.000283,172.217.194.0-255,2902,24612,8,245403
9036,0.000286,172.31.36.0-255,66,24678,8,245403
9037,0.000289,172.217.194.0-255,1484,26162,8,245403
9038,0.000291,172.31.36.0-255,66,26228,8,245403
9039,0.000308,172.217.194.0-255,4320,30548,8,245403
9040,0.000311,172.31.36.0-255,66,30614,8,245403
9041,0.000339,172.31.36.0-255,66,30680,8,245403
9042,0.000345,172.217.194.0-255,4320,35000,8,245403
9043,0.000347,172.31.36.0-255,66,35066,8,245403
9044,0.00037,172.31.36.0-255,66,35132,8,245403
9045,0.000375,172.217.194.0-255,2902,38034,8,245403
9046,0.000377,172.31.36.0-255,66,38100,8,245403
9047,0.000407,172.31.36.0-255,66,38166,8,245403
9048,0.000409,172.217.194.0-255,339,38505,8,245403
9049,0.001014,172.217.194.0-255,121,38626,8,245403
9050,0.001061,172.217.194.0-255,1484,40110,8,245403
9051,0.001065,172.31.36.0-255,66,40176,8,245403
9052,0.001071,172.217.194.0-255,2902,43078,8,245403
9053,0.001074,172.31.36.0-255,66,43144,8,245403
9054,0.001081,172.217.194.0-255,5738,48882,8,245403
9055,0.001083,172.31.36.0-255,66,48948,8,245403
9056,0.001115,172.31.36.0-255,66,49014,8,245403
9057,0.001157,172.217.194.0-255,7156,56170,8,245403
9058,0.001159,172.31.36.0-255,66,56236,8,245403
9059,0.001178,172.217.194.0-255,2902,59138,8,245403
9060,0.001181,172.31.36.0-255,66,59204,8,245403
9061,0.001201,172.217.194.0-255,3602,62806,8,245403
9062,0.001203,172.31.36.0-255,66,62872,8,245403
9063,0.001399,172.217.194.0-255,1484,64356,8,245403
9064,0.001404,172.217.194.0-255,2902,67258,8,245403
9065,0.001406,172.31.36.0-255,66,67324,8,245403
9066,0.001428,172.217.194.0-255,5738,73062,8,245403
9067,0.00143,172.31.36.0-255,66,73128,8,245403
9068,0.001436,172.217.194.0-255,5738,78866,8,245403
9069,0.001438,172.31.36.0-255,66,78932,8,245403
9070,0.001471,172.217.194.0-255,7156,86088,8,245403
9071,0.001474,172.31.36.0-255,66,86154,8,245403
9072,0.001497,172.217.194.0-255,5738,91892,8,245403
9073,0.001499,172.31.36.0-255,66,91958,8,245403
9074,0.001505,172.217.194.0-255,5020,96978,8,245403
9075,0.001507,172.31.36.0-255,66,97044,8,245403
9076,0.001536,172.217.194.0-255,2902,99946,8,245403
9077,0.001539,172.31.36.0-255,66,100012,8,245403
9078,0.001559,172.217.194.0-255,4320,104332,8,245403
9079,0.001561,172.31.36.0-255,66,104398,8,245403
9080,0.001571,172.31.36.0-255,66,104464,8,245403
9081,0.001597,172.217.194.0-255,4320,108784,8,245403
9082,0.001599,172.31.36.0-255,66,108850,8,245403
9083,0.001602,172.217.194.0-255,1484,110334,8,245403
9084,0.001618,172.217.194.0-255,2902,113236,8,245403
9085,0.001621,172.31.36.0-255,66,113302,8,245403
9086,0.001631,172.217.194.0-255,1484,114786,8,245403
9087,0.001645,172.217.194.0-255,4320,119106,8,245403
9088,0.001648,172.31.36.0-255,66,119172,8,245403
9089,0.00166,172.217.194.0-255,3602,122774,8,245403
9090,0.001663,172.31.36.0-255,66,122840,8,245403
9091,0.001768,172.217.194.0-255,1484,124324,8,245403
9092,0.001773,172.217.194.0-255,2902,127226,8,245403
9093,0.001775,172.31.36.0-255,66,127292,8,245403
9094,0.00178,172.217.194.0-255,2902,130194,8,245403
9095,0.001782,172.31.36.0-255,66,130260,8,245403
9096,0.001796,172.217.194.0-255,2902,133162,8,245403
9097,0.001798,172.31.36.0-255,66,133228,8,245403
9098,0.001801,172.217.194.0-255,1484,134712,8,245403
9099,0.001827,172.217.194.0-255,5738,140450,8,245403
9100,0.001829,172.31.36.0-255,66,140516,8,245403
9101,0.001841,172.31.36.0-255,66,140582,8,245403
9102,0.001858,172.217.194.0-255,2902,143484,8,245403
9103,0.001861,172.217.194.0-255,2184,145668,8,245403
9104,0.001865,172.31.36.0-255,66,145734,8,245403
9105,0.001871,172.31.36.0-255,66,145800,8,245403
9106,0.001983,172.217.194.0-255,1484,147284,8,245403
9107,0.00199,172.217.194.0-255,2902,150186,8,245403
9108,0.001993,172.31.36.0-255,66,150252,8,245403
9109,0.002014,172.217.194.0-255,5738,155990,8,245403
9110,0.002017,172.31.36.0-255,66,156056,8,245403
9111,0.002022,172.217.194.0-255,4320,160376,8,245403
9112,0.002024,172.31.36.0-255,66,160442,8,245403
9113,0.002057,172.31.36.0-255,66,160508,8,245403
9114,0.002062,172.217.194.0-255,4320,164828,8,245403
9115,0.002064,172.31.36.0-255,66,164894,8,245403
9116,0.002081,172.217.194.0-255,6438,171332,8,245403
9117,0.002084,172.31.36.0-255,66,171398,8,245403
9118,0.002088,172.217.194.0-255,2902,174300,8,245403
9119,0.00209,172.31.36.0-255,66,174366,8,245403
9120,0.002116,172.31.36.0-255,66,174432,8,245403
9121,0.002133,172.31.36.0-255,66,174498,8,245403
9122,0.002157,172.217.194.0-255,2902,177400,8,245403
9123,0.002159,172.31.36.0-255,66,177466,8,245403
9124,0.002194,172.31.36.0-255,66,177532,8,245403
9125,0.002256,172.31.36.0-255,66,177598,8,245403
9126,0.002281,172.217.194.0-255,6438,184036,8,245403
9127,0.002285,172.31.36.0-255,66,184102,8,245403
9128,0.002291,172.217.194.0-255,7156,191258,8,245403
9129,0.002294,172.31.36.0-255,66,191324,8,245403
9130,0.0023,172.217.194.0-255,5738,197062,8,245403
9131,0.002302,172.31.36.0-255,66,197128,8,245403
9132,0.002323,172.31.36.0-255,66,197194,8,245403
9133,0.002328,172.217.194.0-255,5020,202214,8,245403
9134,0.00233,172.31.36.0-255,66,202280,8,245403
9135,0.002353,172.217.194.0-255,1484,203764,8,245403
9136,0.002369,172.217.194.0-255,7156,210920,8,245403
9137,0.002372,172.31.36.0-255,66,210986,8,245403
9138,0.002402,172.31.36.0-255,66,211052,8,245403
9139,0.002405,172.217.194.0-255,1484,212536,8,245403
9140,0.002408,172.217.194.0-255,1484,214020,8,245403
9141,0.002409,172.31.36.0-255,66,214086,8,245403
9142,0.002434,172.31.36.0-255,66,214152,8,245403
9143,0.002437,172.217.194.0-255,1484,215636,8,245403
9144,0.002439,172.217.194.0-255,1484,217120,8,245403
9145,0.002441,172.31.36.0-255,66,217186,8,245403
9146,0.002444,172.217.194.0-255,1484,218670,8,245403
9147,0.002471,172.31.36.0-255,66,218736,8,245403
9148,0.002483,172.31.36.0-255,66,218802,8,245403
9149,0.002488,172.217.194.0-255,5738,224540,8,245403
9150,0.002491,172.31.36.0-255,66,224606,8,245403
9151,0.002513,172.217.194.0-255,2184,226790,8,245403
9152,0.002515,172.31.36.0-255,66,226856,8,245403
9153,0.002519,172.217.194.0-255,2902,229758,8,245403
9154,0.002521,172.31.36.0-255,66,229824,8,245403
9155,0.002536,172.217.194.0-255,5081,234905,8,245403
9156,0.002539,172.31.36.0-255,66,234971,8,245403
9157,0.002541,172.217.194.0-255,105,235076,8,245403
9158,0.004512,172.31.36.0-255,66,235142,8,245403
9159,0.004549,172.31.36.0-255,105,235247,8,245403
9160,0.006823,172.217.194.0-255,66,235313,8,245403
9161,0.034344,172.31.36.0-255,176,235489,8,245403
9162,0.034383,172.31.36.0-255,1112,236601,8,245403
9163,0.034479,172.31.36.0-255,1514,238115,8,245403
9164,0.034481,172.31.36.0-255,1514,239629,8,245403
9165,0.034482,172.31.36.0-255,1514,241143,8,245403
9166,0.034483,172.31.36.0-255,1514,242657,8,245403
9167,0.034524,172.31.36.0-255,1514,244171,8,245403
9168,0.034526,172.31.36.0-255,794,244965,8,245403
9169,0.035904,104.244.42.0-255,66,245031,8,245403
9170,0.035953,104.244.42.0-255,66,245097,8,245403
9171,0.036051,104.244.42.0-255,66,245163,8,245403
9172,0.036069,104.244.42.0-255,66,245229,8,245403
9173,0.036722,104.244.42.0-255,108,245337,8,245403
9174,0.036735,172.31.36.0-255,66,245403,8,245403
9175,0.0,74.125.24.0-255,298,298,8,210178
9176,1.7e-05,172.31.36.0-255,66,364,8,210178
9177,4.4e-05,74.125.24.0-255,1484,1848,8,210178
9178,4.9e-05,172.31.36.0-255,66,1914,8,210178
9179,5.7e-05,74.125.24.0-255,4320,6234,8,210178
9180,6.1e-05,172.31.36.0-255,66,6300,8,210178
9181,9.2e-05,74.125.24.0-255,5738,12038,8,210178
9182,9.6e-05,172.31.36.0-255,66,12104,8,210178
9183,0.000113,74.125.24.0-255,1778,13882,8,210178
9184,0.000116,172.31.36.0-255,66,13948,8,210178
9185,0.000128,172.31.36.0-255,66,14014,8,210178
9186,0.000132,74.125.24.0-255,2902,16916,8,210178
9187,0.000135,172.31.36.0-255,66,16982,8,210178
9188,0.000161,74.125.24.0-255,5379,22361,8,210178
9189,0.000165,172.31.36.0-255,66,22427,8,210178
9190,0.001441,74.125.24.0-255,1484,23911,8,210178
9191,0.001449,172.31.36.0-255,66,23977,8,210178
9192,0.001457,74.125.24.0-255,2902,26879,8,210178
9193,0.001461,172.31.36.0-255,66,26945,8,210178
9194,0.001468,74.125.24.0-255,5738,32683,8,210178
9195,0.00147,172.31.36.0-255,66,32749,8,210178
9196,0.001484,172.31.36.0-255,66,32815,8,210178
9197,0.001508,74.125.24.0-255,2543,35358,8,210178
9198,0.001512,172.31.36.0-255,66,35424,8,210178
9199,0.001515,74.125.24.0-255,1484,36908,8,210178
9200,0.001517,172.31.36.0-255,66,36974,8,210178
9201,0.001525,74.125.24.0-255,5738,42712,8,210178
9202,0.001527,172.31.36.0-255,66,42778,8,210178
9203,0.001544,74.125.24.0-255,2877,45655,8,210178
9204,0.001547,172.31.36.0-255,66,45721,8,210178
9205,0.001654,74.125.24.0-255,110,45831,8,210178
9206,0.001782,74.125.24.0-255,1484,47315,8,210178
9207,0.001787,172.31.36.0-255,66,47381,8,210178
9208,0.001794,74.125.24.0-255,2902,50283,8,210178
9209,0.001797,172.31.36.0-255,66,50349,8,210178
9210,0.001804,74.125.24.0-255,5738,56087,8,210178
9211,0.001807,172.31.36.0-255,66,56153,8,210178
9212,0.001854,74.125.24.0-255,6797,62950,8,210178
9213,0.001858,172.31.36.0-255,66,63016,8,210178
9214,0.001865,74.125.24.0-255,7156,70172,8,210178
9215,0.001868,172.31.36.0-255,66,70238,8,210178
9216,0.0019,172.31.36.0-255,66,70304,8,210178
9217,0.003428,74.125.24.0-255,1484,71788,8,210178
9218,0.003436,74.125.24.0-255,2902,74690,8,210178
9219,0.003441,172.31.36.0-255,66,74756,8,210178
9220,0.003446,74.125.24.0-255,2902,77658,8,210178
9221,0.003448,172.31.36.0-255,66,77724,8,210178
9222,0.003469,74.125.24.0-255,2902,80626,8,210178
9223,0.003474,74.125.24.0-255,4320,84946,8,210178
9224,0.003478,74.125.24.0-255,2902,87848,8,210178
9225,0.003482,172.31.36.0-255,66,87914,8,210178
9226,0.003485,172.31.36.0-255,66,87980,8,210178
9227,0.003488,172.31.36.0-255,66,88046,8,210178
9228,0.003504,172.31.36.0-255,66,88112,8,210178
9229,0.003511,74.125.24.0-255,4320,92432,8,210178
9230,0.003513,172.31.36.0-255,66,92498,8,210178
9231,0.003537,74.125.24.0-255,3602,96100,8,210178
9232,0.00354,172.31.36.0-255,66,96166,8,210178
9233,0.003635,74.125.24.0-255,1484,97650,8,210178
9234,0.003648,74.125.24.0-255,2902,100552,8,210178
9235,0.003652,172.31.36.0-255,66,100618,8,210178
9236,0.003659,74.125.24.0-255,5738,106356,8,210178
9237,0.003661,172.31.36.0-255,66,106422,8,210178
9238,0.003664,74.125.24.0-255,1484,107906,8,210178
9239,0.003713,172.31.36.0-255,66,107972,8,210178
9240,0.003716,74.125.24.0-255,1484,109456,8,210178
9241,0.003746,172.31.36.0-255,66,109522,8,210178
9242,0.00387,74.125.24.0-255,1484,111006,8,210178
9243,0.003886,74.125.24.0-255,2902,113908,8,210178
9244,0.00389,172.31.36.0-255,66,113974,8,210178
9245,0.003897,74.125.24.0-255,5738,119712,8,210178
9246,0.0039,172.31.36.0-255,66,119778,8,210178
9247,0.004004,74.125.24.0-255,4320,124098,8,210178
9248,0.004022,74.125.24.0-255,6438,130536,8,210178
9249,0.004058,74.125.24.0-255,1484,132020,8,210178
9250,0.004061,74.125.24.0-255,1484,133504,8,210178
9251,0.004079,74.125.24.0-255,4320,137824,8,210178
9252,0.0041,74.125.24.0-255,7156,144980,8,210178
9253,0.004113,74.125.24.0-255,2902,147882,8,210178
9254,0.004116,74.125.24.0-255,1484,149366,8,210178
9255,0.004122,74.125.24.0-255,5738,155104,8,210178
9256,0.004139,74.125.24.0-255,7156,162260,8,210178
9257,0.004157,74.125.24.0-255,5738,167998,8,210178
9258,0.004176,74.125.24.0-255,1484,169482,8,210178
9259,0.004192,74.125.24.0-255,1484,170966,8,210178
9260,0.004285,74.125.24.0-255,7156,178122,8,210178
9261,0.004334,74.125.24.0-255,5738,183860,8,210178
9262,0.004388,74.125.24.0-255,5020,188880,8,210178
9263,0.004418,74.125.24.0-255,5738,194618,8,210178
9264,0.004504,74.125.24.0-255,5738,200356,8,210178
9265,0.004525,74.125.24.0-255,6491,206847,8,210178
9266,0.004528,74.125.24.0-255,105,206952,8,210178
9267,0.009785,172.31.36.0-255,66,207018,8,210178
9268,0.016275,172.31.36.0-255,105,207123,8,210178
9269,0.018538,74.125.24.0-255,66,207189,8,210178
9270,0.048798,172.31.36.0-255,187,207376,8,210178
9271,0.048842,172.31.36.0-255,979,208355,8,210178
9272,0.048911,172.31.36.0-255,1514,209869,8,210178
9273,0.048913,172.31.36.0-255,111,209980,8,210178
9274,0.050401,104.244.42.0-255,66,210046,8,210178
9275,0.050435,104.244.42.0-255,66,210112,8,210178
9276,0.050472,104.244.42.0-255,66,210178,8,210178
9277,0.0,74.125.130.0-255,153,153,8,226420
9278,1.7e-05,172.31.36.0-255,66,219,8,226420
9279,2.4e-05,74.125.130.0-255,1484,1703,8,226420
9280,2.9e-05,172.31.36.0-255,66,1769,8,226420
9281,3.6e-05,74.125.130.0-255,2902,4671,8,226420
9282,4.8e-05,172.31.36.0-255,66,4737,8,226420
9283,5.5e-05,74.125.130.0-255,4320,9057,8,226420
9284,5.8e-05,172.31.36.0-255,66,9123,8,226420
9285,9e-05,74.125.130.0-255,1484,10607,8,226420
9286,9.3e-05,172.31.36.0-255,66,10673,8,226420
9287,0.000103,74.125.130.0-255,6343,17016,8,226420
9288,0.000111,172.31.36.0-255,66,17082,8,226420
9289,0.000117,74.125.130.0-255,5738,22820,8,226420
9290,0.00012,172.31.36.0-255,66,22886,8,226420
9291,0.000127,74.125.130.0-255,7156,30042,8,226420
9292,0.000129,172.31.36.0-255,66,30108,8,226420
9293,0.000132,74.125.130.0-255,1125,31233,8,226420
9294,0.000135,172.31.36.0-255,66,31299,8,226420
9295,0.000234,74.125.130.0-255,1484,32783,8,226420
9296,0.000237,172.31.36.0-255,66,32849,8,226420
9297,0.000268,74.125.130.0-255,2902,35751,8,226420
9298,0.000271,172.31.36.0-255,66,35817,8,226420
9299,0.000278,74.125.130.0-255,5738,41555,8,226420
9300,0.00028,172.31.36.0-255,66,41621,8,226420
9301,0.000319,172.31.36.0-255,66,41687,8,226420
9302,0.00037,172.31.36.0-255,66,41753,8,226420
9303,0.000432,74.125.130.0-255,647,42400,8,226420
9304,0.000435,172.31.36.0-255,66,42466,8,226420
9305,0.000821,74.125.130.0-255,1484,43950,8,226420
9306,0.000827,172.31.36.0-255,66,44016,8,226420
9307,0.000833,74.125.130.0-255,2902,46918,8,226420
9308,0.000836,172.31.36.0-255,66,46984,8,226420
9309,0.000847,74.125.130.0-255,5738,52722,8,226420
9310,0.000849,172.31.36.0-255,66,52788,8,226420
9311,0.000855,74.125.130.0-255,5738,58526,8,226420
9312,0.000858,172.31.36.0-255,66,58592,8,226420
9313,0.000893,74.125.130.0-255,7156,65748,8,226420
9314,0.000899,172.31.36.0-255,66,65814,8,226420
9315,0.000926,74.125.130.0-255,1484,67298,8,226420
9316,0.000956,172.31.36.0-255,66,67364,8,226420
9317,0.001612,74.125.130.0-255,1484,68848,8,226420
9318,0.001622,74.125.130.0-255,2902,71750,8,226420
9319,0.001627,172.31.36.0-255,66,71816,8,226420
9320,0.001635,74.125.130.0-255,5738,77554,8,226420
9321,0.001637,172.31.36.0-255,66,77620,8,226420
9322,0.001674,74.125.130.0-255,4320,81940,8,226420
9323,0.001677,172.31.36.0-255,66,82006,8,226420
9324,0.001684,74.125.130.0-255,5738,87744,8,226420
9325,0.001686,172.31.36.0-255,66,87810,8,226420
9326,0.00172,172.31.36.0-255,66,87876,8,226420
9327,0.001725,74.125.130.0-255,2184,90060,8,226420
9328,0.001728,172.31.36.0-255,66,90126,8,226420
9329,0.001892,74.125.130.0-255,1484,91610,8,226420
9330,0.001921,74.125.130.0-255,1484,93094,8,226420
9331,0.001925,172.31.36.0-255,66,93160,8,226420
9332,0.001967,74.125.130.0-255,2902,96062,8,226420
9333,0.001971,172.31.36.0-255,66,96128,8,226420
9334,0.002015,74.125.130.0-255,4320,100448,8,226420
9335,0.002018,172.31.36.0-255,66,100514,8,226420
9336,0.002047,74.125.130.0-255,5738,106252,8,226420
9337,0.00205,172.31.36.0-255,66,106318,8,226420
9338,0.002054,74.125.130.0-255,1484,107802,8,226420
9339,0.002082,74.125.130.0-255,2902,110704,8,226420
9340,0.002085,172.31.36.0-255,66,110770,8,226420
9341,0.002089,74.125.130.0-255,1484,112254,8,226420
9342,0.002092,74.125.130.0-255,1484,113738,8,226420
9343,0.002094,172.31.36.0-255,66,113804,8,226420
9344,0.002131,74.125.130.0-255,4320,118124,8,226420
9345,0.002134,172.31.36.0-255,66,118190,8,226420
9346,0.002168,74.125.130.0-255,1484,119674,8,226420
9347,0.002172,74.125.130.0-255,1484,121158,8,226420
9348,0.002174,172.31.36.0-255,66,121224,8,226420
9349,0.002185,74.125.130.0-255,1484,122708,8,226420
9350,0.002193,74.125.130.0-255,2184,124892,8,226420
9351,0.002196,172.31.36.0-255,66,124958,8,226420
9352,0.002408,74.125.130.0-255,1484,126442,8,226420
9353,0.002414,74.125.130.0-255,1484,127926,8,226420
9354,0.002418,172.31.36.0-255,66,127992,8,226420
9355,0.002449,74.125.130.0-255,1484,129476,8,226420
9356,0.002455,74.125.130.0-255,4320,133796,8,226420
9357,0.002458,172.31.36.0-255,66,133862,8,226420
9358,0.002475,172.31.36.0-255,66,133928,8,226420
9359,0.002478,74.125.130.0-255,1484,135412,8,226420
9360,0.002518,172.31.36.0-255,66,135478,8,226420
9361,0.002684,74.125.130.0-255,1484,136962,8,226420
9362,0.002693,74.125.130.0-255,2902,139864,8,226420
9363,0.002697,172.31.36.0-255,66,139930,8,226420
9364,0.002704,74.125.130.0-255,5738,145668,8,226420
9365,0.002707,172.31.36.0-255,66,145734,8,226420
9366,0.002746,172.31.36.0-255,66,145800,8,226420
9367,0.002787,172.31.36.0-255,66,145866,8,226420
9368,0.00279,74.125.130.0-255,1484,147350,8,226420
9369,0.002812,74.125.130.0-255,1484,148834,8,226420
9370,0.002814,172.31.36.0-255,66,148900,8,226420
9371,0.002819,74.125.130.0-255,2902,151802,8,226420
9372,0.002822,172.31.36.0-255,66,151868,8,226420
9373,0.002826,74.125.130.0-255,1484,153352,8,226420
9374,0.002864,74.125.130.0-255,5738,159090,8,226420
9375,0.002867,172.31.36.0-255,66,159156,8,226420
9376,0.002875,74.125.130.0-255,2902,162058,8,226420
9377,0.002878,172.31.36.0-255,66,162124,8,226420
9378,0.002888,74.125.130.0-255,4320,166444,8,226420
9379,0.002891,172.31.36.0-255,66,166510,8,226420
9380,0.002897,74.125.130.0-255,5738,172248,8,226420
9381,0.002901,172.31.36.0-255,66,172314,8,226420
9382,0.002932,172.31.36.0-255,66,172380,8,226420
9383,0.002994,74.125.130.0-255,2902,175282,8,226420
9384,0.002997,172.31.36.0-255,66,175348,8,226420
9385,0.003023,74.125.130.0-255,5738,181086,8,226420
9386,0.003026,172.31.36.0-255,66,181152,8,226420
9387,0.003034,74.125.130.0-255,7156,188308,8,226420
9388,0.003037,172.31.36.0-255,66,188374,8,226420
9389,0.003057,172.31.36.0-255,66,188440,8,226420
9390,0.003082,74.125.130.0-255,3602,192042,8,226420
9391,0.003085,172.31.36.0-255,66,192108,8,226420
9392,0.003121,74.125.130.0-255,4320,196428,8,226420
9393,0.003123,172.31.36.0-255,66,196494,8,226420
9394,0.003127,74.125.130.0-255,1484,197978,8,226420
9395,0.003148,74.125.130.0-255,2902,200880,8,226420
9396,0.003151,172.31.36.0-255,66,200946,8,226420
9397,0.003157,74.125.130.0-255,4320,205266,8,226420
9398,0.003159,172.31.36.0-255,66,205332,8,226420
9399,0.003188,74.125.130.0-255,1484,206816,8,226420
9400,0.00321,74.125.130.0-255,2902,209718,8,226420
9401,0.003212,172.31.36.0-255,66,209784,8,226420
9402,0.00324,74.125.130.0-255,5738,215522,8,226420
9403,0.003244,172.31.36.0-255,66,215588,8,226420
9404,0.003255,172.31.36.0-255,66,215654,8,226420
9405,0.003288,172.31.36.0-255,66,215720,8,226420
9406,0.003301,172.31.36.0-255,66,215786,8,226420
9407,0.003305,74.125.130.0-255,2902,218688,8,226420
9408,0.003307,172.31.36.0-255,66,218754,8,226420
9409,0.003346,172.31.36.0-255,66,218820,8,226420
9410,0.003361,172.31.36.0-255,66,218886,8,226420
9411,0.003394,74.125.130.0-255,2902,221788,8,226420
9412,0.003465,74.125.130.0-255,105,221893,8,226420
9413,0.004281,172.31.36.0-255,66,221959,8,226420
9414,0.006578,172.31.36.0-255,105,222064,8,226420
9415,0.008508,74.125.130.0-255,66,222130,8,226420
9416,0.040203,172.31.36.0-255,172,222302,8,226420
9417,0.040238,172.31.36.0-255,1112,223414,8,226420
9418,0.0403,172.31.36.0-255,1514,224928,8,226420
9419,0.040302,172.31.36.0-255,1294,226222,8,226420
9420,0.041714,104.244.42.0-255,66,226288,8,226420
9421,0.041758,104.244.42.0-255,66,226354,8,226420
9422,0.041853,104.244.42.0-255,66,226420,8,226420
9423,0.0,172.217.194.0-255,226,226,8,190575
9424,3.3e-05,172.31.36.0-255,66,292,8,190575
9425,3.9e-05,172.217.194.0-255,1484,1776,8,190575
9426,4.4e-05,172.31.36.0-255,66,1842,8,190575
9427,5.1e-05,172.217.194.0-255,4320,6162,8,190575
9428,6.2e-05,172.31.36.0-255,66,6228,8,190575
9429,0.000257,172.217.194.0-255,5738,11966,8,190575
9430,0.000263,172.31.36.0-255,66,12032,8,190575
9431,0.000517,172.217.194.0-255,7156,19188,8,190575
9432,0.000523,172.31.36.0-255,66,19254,8,190575
9433,0.000553,172.217.194.0-255,4904,24158,8,190575
9434,0.000556,172.31.36.0-255,66,24224,8,190575
9435,0.001071,172.217.194.0-255,6797,31021,8,190575
9436,0.001077,172.31.36.0-255,66,31087,8,190575
9437,0.001374,172.31.36.0-255,66,31153,8,190575
9438,0.001413,172.31.36.0-255,66,31219,8,190575
9439,0.002636,172.217.194.0-255,2902,34121,8,190575
9440,0.00264,172.31.36.0-255,66,34187,8,190575
9441,0.003962,172.217.194.0-255,2902,37089,8,190575
9442,0.003967,172.31.36.0-255,66,37155,8,190575
9443,0.005179,172.217.194.0-255,2902,40057,8,190575
9444,0.005186,172.31.36.0-255,66,40123,8,190575
9445,0.006504,172.217.194.0-255,2902,43025,8,190575
9446,0.00651,172.31.36.0-255,66,43091,8,190575
9447,0.00773,172.217.194.0-255,2902,45993,8,190575
9448,0.007736,172.31.36.0-255,66,46059,8,190575
9449,0.00908,172.217.194.0-255,2902,48961,8,190575
9450,0.009087,172.31.36.0-255,66,49027,8,190575
9451,0.010281,172.217.194.0-255,2902,51929,8,190575
9452,0.010287,172.31.36.0-255,66,51995,8,190575
9453,0.011629,172.217.194.0-255,2902,54897,8,190575
9454,0.011635,172.31.36.0-255,66,54963,8,190575
9455,0.012834,172.217.194.0-255,2902,57865,8,190575
9456,0.012841,172.31.36.0-255,66,57931,8,190575
9457,0.014172,172.217.194.0-255,2902,60833,8,190575
9458,0.014179,172.31.36.0-255,66,60899,8,190575
9459,0.01539,172.217.194.0-255,2902,63801,8,190575
9460,0.015397,172.31.36.0-255,66,63867,8,190575
9461,0.016726,172.217.194.0-255,2902,66769,8,190575
9462,0.016733,172.31.36.0-255,66,66835,8,190575
9463,0.017967,172.217.194.0-255,2902,69737,8,190575
9464,0.017977,172.31.36.0-255,66,69803,8,190575
9465,0.019284,172.217.194.0-255,2902,72705,8,190575
9466,0.019292,172.31.36.0-255,66,72771,8,190575
9467,0.020524,172.217.194.0-255,2902,75673,8,190575
9468,0.02053,172.31.36.0-255,66,75739,8,190575
9469,0.021831,172.217.194.0-255,2902,78641,8,190575
9470,0.021837,172.31.36.0-255,66,78707,8,190575
9471,0.023089,172.217.194.0-255,2902,81609,8,190575
9472,0.023095,172.31.36.0-255,66,81675,8,190575
9473,0.024373,172.217.194.0-255,2902,84577,8,190575
9474,0.02438,172.31.36.0-255,66,84643,8,190575
9475,0.025665,172.217.194.0-255,2902,87545,8,190575
9476,0.025672,172.31.36.0-255,66,87611,8,190575
9477,0.026922,172.217.194.0-255,2902,90513,8,190575
9478,0.026929,172.31.36.0-255,66,90579,8,190575
9479,0.028219,172.217.194.0-255,2902,93481,8,190575
9480,0.028226,172.31.36.0-255,66,93547,8,190575
9481,0.02949,172.217.194.0-255,2902,96449,8,190575
9482,0.029497,172.31.36.0-255,66,96515,8,190575
9483,0.030771,172.217.194.0-255,2902,99417,8,190575
9484,0.030778,172.31.36.0-255,66,99483,8,190575
9485,0.032032,172.217.194.0-255,2902,102385,8,190575
9486,0.032039,172.31.36.0-255,66,102451,8,190575
9487,0.033334,172.217.194.0-255,2902,105353,8,190575
9488,0.033341,172.31.36.0-255,66,105419,8,190575
9489,0.034598,172.217.194.0-255,2902,108321,8,190575
9490,0.034606,172.31.36.0-255,66,108387,8,190575
9491,0.035892,172.217.194.0-255,2902,111289,8,190575
9492,0.035899,172.31.36.0-255,66,111355,8,190575
9493,0.037166,172.217.194.0-255,2902,114257,8,190575
9494,0.037172,172.31.36.0-255,66,114323,8,190575
9495,0.037344,172.31.36.0-255,172,114495,8,190575
9496,0.037387,172.31.36.0-255,1110,115605,8,190575
9497,0.037496,172.31.36.0-255,572,116177,8,190575
9498,0.038438,172.217.194.0-255,2902,119079,8,190575
9499,0.038446,172.31.36.0-255,66,119145,8,190575
9500,0.038836,104.244.42.0-255,66,119211,8,190575
9501,0.038875,104.244.42.0-255,66,119277,8,190575
9502,0.03897,104.244.42.0-255,66,119343,8,190575
9503,0.039729,172.217.194.0-255,2902,122245,8,190575
9504,0.039735,172.31.36.0-255,66,122311,8,190575
9505,0.041001,172.217.194.0-255,2902,125213,8,190575
9506,0.041007,172.31.36.0-255,66,125279,8,190575
9507,0.042267,172.217.194.0-255,2902,128181,8,190575
9508,0.042272,172.31.36.0-255,66,128247,8,190575
9509,0.043559,172.217.194.0-255,2902,131149,8,190575
9510,0.043565,172.31.36.0-255,66,131215,8,190575
9511,0.044816,172.217.194.0-255,2902,134117,8,190575
9512,0.044821,172.31.36.0-255,66,134183,8,190575
9513,0.046109,172.217.194.0-255,2902,137085,8,190575
9514,0.046114,172.31.36.0-255,66,137151,8,190575
9515,0.047369,172.217.194.0-255,2902,140053,8,190575
9516,0.047374,172.31.36.0-255,66,140119,8,190575
9517,0.048682,172.217.194.0-255,2902,143021,8,190575
9518,0.048687,172.31.36.0-255,66,143087,8,190575
9519,0.049902,172.217.194.0-255,2902,145989,8,190575
9520,0.049907,172.31.36.0-255,66,146055,8,190575
9521,0.051225,172.217.194.0-255,2902,148957,8,190575
9522,0.051232,172.31.36.0-255,66,149023,8,190575
9523,0.052449,172.217.194.0-255,2902,151925,8,190575
9524,0.052453,172.31.36.0-255,66,151991,8,190575
9525,0.053792,172.217.194.0-255,2902,154893,8,190575
9526,0.053797,172.31.36.0-255,66,154959,8,190575
9527,0.054995,172.217.194.0-255,2902,157861,8,190575
9528,0.055,172.31.36.0-255,66,157927,8,190575
9529,0.056354,172.217.194.0-255,2902,160829,8,190575
9530,0.05636,172.31.36.0-255,66,160895,8,190575
9531,0.057544,172.217.194.0-255,2902,163797,8,190575
9532,0.05755,172.31.36.0-255,66,163863,8,190575
9533,0.058914,172.217.194.0-255,2902,166765,8,190575
9534,0.05892,172.31.36.0-255,66,166831,8,190575
9535,0.060092,172.217.194.0-255,2902,169733,8,190575
9536,0.060097,172.31.36.0-255,66,169799,8,190575
9537,0.06147,172.217.194.0-255,2902,172701,8,190575
9538,0.061475,172.31.36.0-255,66,172767,8,190575
9539,0.062643,172.217.194.0-255,2902,175669,8,190575
9540,0.062648,172.31.36.0-255,66,175735,8,190575
9541,0.064013,172.217.194.0-255,2902,178637,8,190575
9542,0.064018,172.31.36.0-255,66,178703,8,190575
9543,0.065203,172.217.194.0-255,2902,181605,8,190575
9544,0.065208,172.31.36.0-255,66,181671,8,190575
9545,0.06658,172.217.194.0-255,2902,184573,8,190575
9546,0.066585,172.31.36.0-255,66,184639,8,190575
9547,0.067757,172.217.194.0-255,2902,187541,8,190575
9548,0.067762,172.31.36.0-255,66,187607,8,190575
9549,0.069139,172.217.194.0-255,2902,190509,8,190575
9550,0.069144,172.31.36.0-255,66,190575,8,190575
9551,0.0,172.217.194.0-255,152,152,8,139166
9552,3.2e-05,172.31.36.0-255,66,218,8,139166
9553,3.9e-05,172.217.194.0-255,1484,1702,8,139166
9554,4.3e-05,172.31.36.0-255,66,1768,8,139166
9555,4.8e-05,172.217.194.0-255,2902,4670,8,139166
9556,5.9e-05,172.31.36.0-255,66,4736,8,139166
9557,6.7e-05,172.217.194.0-255,7156,11892,8,139166
9558,7e-05,172.31.36.0-255,66,11958,8,139166
9559,7.3e-05,172.217.194.0-255,2049,14007,8,139166
9560,7.8e-05,172.31.36.0-255,66,14073,8,139166
9561,9e-05,172.31.36.0-255,66,14139,8,139166
9562,9.8e-05,172.217.194.0-255,5379,19518,8,139166
9563,0.000101,172.31.36.0-255,66,19584,8,139166
9564,0.000147,172.217.194.0-255,1484,21068,8,139166
9565,0.00015,172.31.36.0-255,66,21134,8,139166
9566,0.000156,172.217.194.0-255,2902,24036,8,139166
9567,0.000159,172.31.36.0-255,66,24102,8,139166
9568,0.000162,172.217.194.0-255,1484,25586,8,139166
9569,0.000171,172.31.36.0-255,66,25652,8,139166
9570,0.0002,172.217.194.0-255,4320,29972,8,139166
9571,0.000207,172.31.36.0-255,66,30038,8,139166
9572,0.000222,172.31.36.0-255,66,30104,8,139166
9573,0.000268,172.217.194.0-255,7156,37260,8,139166
9574,0.000272,172.31.36.0-255,66,37326,8,139166
9575,0.000303,172.217.194.0-255,4250,41576,8,139166
9576,0.000306,172.31.36.0-255,66,41642,8,139166
9577,0.00031,172.217.194.0-255,99,41741,8,139166
9578,0.000312,172.31.36.0-255,66,41807,8,139166
9579,0.000384,172.217.194.0-255,1484,43291,8,139166
9580,0.000389,172.31.36.0-255,66,43357,8,139166
9581,0.000394,172.217.194.0-255,2902,46259,8,139166
9582,0.000397,172.31.36.0-255,66,46325,8,139166
9583,0.000414,172.217.194.0-255,4320,50645,8,139166
9584,0.00042,172.31.36.0-255,66,50711,8,139166
9585,0.000433,172.217.194.0-255,1484,52195,8,139166
9586,0.000439,172.217.194.0-255,2902,55097,8,139166
9587,0.000442,172.31.36.0-255,66,55163,8,139166
9588,0.000489,172.31.36.0-255,66,55229,8,139166
9589,0.000501,172.31.36.0-255,66,55295,8,139166
9590,0.001044,172.217.194.0-255,1484,56779,8,139166
9591,0.00105,172.217.194.0-255,1484,58263,8,139166
9592,0.001054,172.31.36.0-255,66,58329,8,139166
9593,0.001074,172.217.194.0-255,1484,59813,8,139166
9594,0.001081,172.217.194.0-255,5738,65551,8,139166
9595,0.001084,172.31.36.0-255,66,65617,8,139166
9596,0.001098,172.31.36.0-255,66,65683,8,139166
9597,0.001104,172.217.194.0-255,7156,72839,8,139166
9598,0.001106,172.31.36.0-255,66,72905,8,139166
9599,0.00114,172.217.194.0-255,3602,76507,8,139166
9600,0.001144,172.31.36.0-255,66,76573,8,139166
9601,0.001147,172.217.194.0-255,1484,78057,8,139166
9602,0.001151,172.217.194.0-255,2902,80959,8,139166
9603,0.001153,172.31.36.0-255,66,81025,8,139166
9604,0.001186,172.217.194.0-255,5738,86763,8,139166
9605,0.001189,172.31.36.0-255,66,86829,8,139166
9606,0.001195,172.217.194.0-255,4320,91149,8,139166
9607,0.001198,172.31.36.0-255,66,91215,8,139166
9608,0.001232,172.31.36.0-255,66,91281,8,139166
9609,0.001245,172.31.36.0-255,66,91347,8,139166
9610,0.001248,172.217.194.0-255,766,92113,8,139166
9611,0.001313,172.217.194.0-255,1484,93597,8,139166
9612,0.001317,172.31.36.0-255,66,93663,8,139166
9613,0.001321,172.217.194.0-255,2902,96565,8,139166
9614,0.001323,172.31.36.0-255,66,96631,8,139166
9615,0.00133,172.217.194.0-255,5738,102369,8,139166
9616,0.00134,172.31.36.0-255,66,102435,8,139166
9617,0.001353,172.31.36.0-255,66,102501,8,139166
9618,0.001388,172.217.194.0-255,1484,103985,8,139166
9619,0.001402,172.31.36.0-255,66,104051,8,139166
9620,0.001462,172.217.194.0-255,1484,105535,8,139166
9621,0.001466,172.217.194.0-255,1484,107019,8,139166
9622,0.001469,172.31.36.0-255,66,107085,8,139166
9623,0.001502,172.217.194.0-255,1484,108569,8,139166
9624,0.001509,172.217.194.0-255,5738,114307,8,139166
9625,0.001512,172.31.36.0-255,66,114373,8,139166
9626,0.00153,172.31.36.0-255,66,114439,8,139166
9627,0.001555,172.217.194.0-255,2902,117341,8,139166
9628,0.001558,172.31.36.0-255,66,117407,8,139166
9629,0.001595,172.31.36.0-255,66,117473,8,139166
9630,0.001636,172.217.194.0-255,1484,118957,8,139166
9631,0.00164,172.217.194.0-255,1484,120441,8,139166
9632,0.001642,172.31.36.0-255,66,120507,8,139166
9633,0.001671,172.217.194.0-255,1484,121991,8,139166
9634,0.001678,172.217.194.0-255,5738,127729,8,139166
9635,0.001681,172.31.36.0-255,66,127795,8,139166
9636,0.001699,172.31.36.0-255,66,127861,8,139166
9637,0.001748,172.31.36.0-255,66,127927,8,139166
9638,0.001763,172.31.36.0-255,66,127993,8,139166
9639,0.00178,172.31.36.0-255,66,128059,8,139166
9640,0.001816,172.31.36.0-255,66,128125,8,139166
9641,0.001838,172.31.36.0-255,66,128191,8,139166
9642,0.001849,172.31.36.0-255,66,128257,8,139166
9643,0.001935,172.31.36.0-255,66,128323,8,139166
9644,0.001957,172.217.194.0-255,5020,133343,8,139166
9645,0.001965,172.31.36.0-255,66,133409,8,139166
9646,0.00199,172.31.36.0-255,66,133475,8,139166
9647,0.002011,172.31.36.0-255,66,133541,8,139166
9648,0.002015,172.217.194.0-255,105,133646,8,139166
9649,0.011123,172.31.36.0-255,66,133712,8,139166
9650,0.011152,172.31.36.0-255,105,133817,8,139166
9651,0.013626,172.217.194.0-255,66,133883,8,139166
9652,0.041806,172.31.36.0-255,172,134055,8,139166
9653,0.041837,172.31.36.0-255,1111,135166,8,139166
9654,0.041945,172.31.36.0-255,1514,136680,8,139166
9655,0.041948,172.31.36.0-255,1514,138194,8,139166
9656,0.041949,172.31.36.0-255,708,138902,8,139166
9657,0.043352,104.244.42.0-255,66,138968,8,139166
9658,0.043362,104.244.42.0-255,66,139034,8,139166
9659,0.043475,104.244.42.0-255,66,139100,8,139166
9660,0.043478,104.244.42.0-255,66,139166,8,139166
9661,0.0,172.217.194.0-255,146,146,8,235913
9662,2.1e-05,172.31.36.0-255,66,212,8,235913
9663,2.9e-05,172.217.194.0-255,1484,1696,8,235913
9664,3.3e-05,172.31.36.0-255,66,1762,8,235913
9665,3.8e-05,172.217.194.0-255,2902,4664,8,235913
9666,4.1e-05,172.31.36.0-255,66,4730,8,235913
9667,4.4e-05,172.217.194.0-255,1484,6214,8,235913
9668,4.7e-05,172.31.36.0-255,66,6280,8,235913
9669,9.1e-05,172.31.36.0-255,66,6346,8,235913
9670,0.000133,172.217.194.0-255,7156,13502,8,235913
9671,0.000135,172.31.36.0-255,66,13568,8,235913
9672,0.00016,172.217.194.0-255,4320,17888,8,235913
9673,0.000163,172.31.36.0-255,66,17954,8,235913
9674,0.000168,172.217.194.0-255,3961,21915,8,235913
9675,0.000171,172.31.36.0-255,66,21981,8,235913
9676,0.000186,172.217.194.0-255,1484,23465,8,235913
9677,0.000188,172.31.36.0-255,66,23531,8,235913
9678,0.000193,172.217.194.0-255,2902,26433,8,235913
9679,0.000195,172.31.36.0-255,66,26499,8,235913
9680,0.000212,172.217.194.0-255,4320,30819,8,235913
9681,0.000214,172.31.36.0-255,66,30885,8,235913
9682,0.000234,172.217.194.0-255,1484,32369,8,235913
9683,0.000236,172.31.36.0-255,66,32435,8,235913
9684,0.000242,172.217.194.0-255,4320,36755,8,235913
9685,0.000244,172.31.36.0-255,66,36821,8,235913
9686,0.000263,172.217.194.0-255,5379,42200,8,235913
9687,0.000276,172.31.36.0-255,66,42266,8,235913
9688,0.00028,172.31.36.0-255,66,42332,8,235913
9689,0.000315,172.217.194.0-255,4251,46583,8,235913
9690,0.000317,172.31.36.0-255,66,46649,8,235913
9691,0.000331,172.217.194.0-255,365,47014,8,235913
9692,0.000333,172.31.36.0-255,66,47080,8,235913
9693,0.000408,172.217.194.0-255,1484,48564,8,235913
9694,0.000412,172.31.36.0-255,66,48630,8,235913
9695,0.000417,172.217.194.0-255,2902,51532,8,235913
9696,0.000419,172.31.36.0-255,66,51598,8,235913
9697,0.000448,172.217.194.0-255,5738,57336,8,235913
9698,0.000451,172.31.36.0-255,66,57402,8,235913
9699,0.000459,172.217.194.0-255,6248,63650,8,235913
9700,0.000461,172.31.36.0-255,66,63716,8,235913
9701,0.000617,172.217.194.0-255,1484,65200,8,235913
9702,0.000633,172.217.194.0-255,2902,68102,8,235913
9703,0.000652,172.31.36.0-255,66,68168,8,235913
9704,0.00066,172.217.194.0-255,5738,73906,8,235913
9705,0.000666,172.31.36.0-255,66,73972,8,235913
9706,0.000677,172.217.194.0-255,4320,78292,8,235913
9707,0.000696,172.217.194.0-255,5738,84030,8,235913
9708,0.000724,172.31.36.0-255,66,84096,8,235913
9709,0.000736,172.217.194.0-255,5020,89116,8,235913
9710,0.000742,172.31.36.0-255,66,89182,8,235913
9711,0.000941,172.217.194.0-255,1484,90666,8,235913
9712,0.000959,172.217.194.0-255,2902,93568,8,235913
9713,0.000965,172.31.36.0-255,66,93634,8,235913
9714,0.000976,172.217.194.0-255,5738,99372,8,235913
9715,0.000984,172.31.36.0-255,66,99438,8,235913
9716,0.001005,172.217.194.0-255,5738,105176,8,235913
9717,0.001016,172.31.36.0-255,66,105242,8,235913
9718,0.00103,172.217.194.0-255,7156,112398,8,235913
9719,0.001037,172.217.194.0-255,5738,118136,8,235913
9720,0.001064,172.217.194.0-255,2902,121038,8,235913
9721,0.001072,172.31.36.0-255,66,121104,8,235913
9722,0.001081,172.217.194.0-255,2184,123288,8,235913
9723,0.001085,172.31.36.0-255,66,123354,8,235913
9724,0.001153,172.217.194.0-255,1484,124838,8,235913
9725,0.001171,172.217.194.0-255,2902,127740,8,235913
9726,0.00119,172.217.194.0-255,5738,133478,8,235913
9727,0.001223,172.31.36.0-255,66,133544,8,235913
9728,0.001233,172.217.194.0-255,2902,136446,8,235913
9729,0.001239,172.217.194.0-255,5738,142184,8,235913
9730,0.001246,172.31.36.0-255,66,142250,8,235913
9731,0.001278,172.217.194.0-255,5020,147270,8,235913
9732,0.001285,172.31.36.0-255,66,147336,8,235913
9733,0.001464,172.217.194.0-255,1484,148820,8,235913
9734,0.001483,172.217.194.0-255,2902,151722,8,235913
9735,0.001501,172.31.36.0-255,66,151788,8,235913
9736,0.001508,172.217.194.0-255,5738,157526,8,235913
9737,0.001517,172.31.36.0-255,66,157592,8,235913
9738,0.001523,172.217.194.0-255,4320,161912,8,235913
9739,0.001551,172.217.194.0-255,7156,169068,8,235913
9740,0.001605,172.217.194.0-255,3602,172670,8,235913
9741,0.001613,172.31.36.0-255,66,172736,8,235913
9742,0.001639,172.217.194.0-255,1484,174220,8,235913
9743,0.001642,172.217.194.0-255,1484,175704,8,235913
9744,0.001653,172.217.194.0-255,1484,177188,8,235913
9745,0.001663,172.31.36.0-255,66,177254,8,235913
9746,0.001675,172.217.194.0-255,5738,182992,8,235913
9747,0.00168,172.31.36.0-255,66,183058,8,235913
9748,0.001721,172.217.194.0-255,2902,185960,8,235913
9749,0.001733,172.31.36.0-255,66,186026,8,235913
9750,0.001737,172.217.194.0-255,1484,187510,8,235913
9751,0.001778,172.31.36.0-255,66,187576,8,235913
9752,0.001792,172.217.194.0-255,1484,189060,8,235913
9753,0.001797,172.217.194.0-255,2902,191962,8,235913
9754,0.0018,172.217.194.0-255,1484,193446,8,235913
9755,0.001819,172.217.194.0-255,4320,197766,8,235913
9756,0.001853,172.217.194.0-255,1484,199250,8,235913
9757,0.001866,172.31.36.0-255,66,199316,8,235913
9758,0.00191,172.217.194.0-255,7156,206472,8,235913
9759,0.001922,172.31.36.0-255,66,206538,8,235913
9760,0.001959,172.31.36.0-255,66,206604,8,235913
9761,0.001969,172.217.194.0-255,2902,209506,8,235913
9762,0.001988,172.217.194.0-255,5738,215244,8,235913
9763,0.001999,172.31.36.0-255,66,215310,8,235913
9764,0.002019,172.31.36.0-255,66,215376,8,235913
9765,0.002042,172.217.194.0-255,5020,220396,8,235913
9766,0.002062,172.31.36.0-255,66,220462,8,235913
9767,0.002089,172.217.194.0-255,7156,227618,8,235913
9768,0.002095,172.217.194.0-255,3602,231220,8,235913
9769,0.002148,172.31.36.0-255,66,231286,8,235913
9770,0.002154,172.31.36.0-255,66,231352,8,235913
9771,0.002233,172.217.194.0-255,2101,233453,8,235913
9772,0.002236,172.217.194.0-255,105,233558,8,235913
9773,0.00224,172.31.36.0-255,66,233624,8,235913
9774,0.002246,172.31.36.0-255,66,233690,8,235913
9775,0.00976,172.31.36.0-255,105,233795,8,235913
9776,0.012061,172.217.194.0-255,66,233861,8,235913
9777,0.037707,172.31.36.0-255,172,234033,8,235913
9778,0.03774,172.31.36.0-255,1110,235143,8,235913
9779,0.037799,172.31.36.0-255,572,235715,8,235913
9780,0.03924,104.244.42.0-255,66,235781,8,235913
9781,0.039279,104.244.42.0-255,66,235847,8,235913
9782,0.039324,104.244.42.0-255,66,235913,8,235913
9783,0.0,172.217.194.0-255,153,153,8,314848
9784,1.7e-05,172.31.36.0-255,66,219,8,314848
9785,2.4e-05,172.217.194.0-255,1484,1703,8,314848
9786,2.8e-05,172.31.36.0-255,66,1769,8,314848
9787,4.2e-05,172.217.194.0-255,2902,4671,8,314848
9788,4.5e-05,172.31.36.0-255,66,4737,8,314848
9789,5e-05,172.217.194.0-255,2902,7639,8,314848
9790,5.3e-05,172.31.36.0-255,66,7705,8,314848
9791,8.5e-05,172.217.194.0-255,1484,9189,8,314848
9792,8.9e-05,172.31.36.0-255,66,9255,8,314848
9793,9.6e-05,172.217.194.0-255,4864,14119,8,314848
9794,9.8e-05,172.31.36.0-255,66,14185,8,314848
9795,0.000144,172.31.36.0-255,66,14251,8,314848
9796,0.000177,172.217.194.0-255,2902,17153,8,314848
9797,0.00018,172.31.36.0-255,66,17219,8,314848
9798,0.000209,172.217.194.0-255,3961,21180,8,314848
9799,0.000212,172.31.36.0-255,66,21246,8,314848
9800,0.000315,172.217.194.0-255,1484,22730,8,314848
9801,0.000319,172.31.36.0-255,66,22796,8,314848
9802,0.000351,172.217.194.0-255,2902,25698,8,314848
9803,0.000353,172.31.36.0-255,66,25764,8,314848
9804,0.00036,172.217.194.0-255,5738,31502,8,314848
9805,0.000363,172.31.36.0-255,66,31568,8,314848
9806,0.000368,172.217.194.0-255,4320,35888,8,314848
9807,0.00037,172.31.36.0-255,66,35954,8,314848
9808,0.0004,172.217.194.0-255,2543,38497,8,314848
9809,0.000403,172.31.36.0-255,66,38563,8,314848
9810,0.00042,172.217.194.0-255,5738,44301,8,314848
9811,0.000426,172.31.36.0-255,66,44367,8,314848
9812,0.000455,172.31.36.0-255,66,44433,8,314848
9813,0.000459,172.217.194.0-255,2833,47266,8,314848
9814,0.000462,172.31.36.0-255,66,47332,8,314848
9815,0.000465,172.217.194.0-255,365,47697,8,314848
9816,0.000558,172.217.194.0-255,1484,49181,8,314848
9817,0.000563,172.31.36.0-255,66,49247,8,314848
9818,0.000577,172.217.194.0-255,2902,52149,8,314848
9819,0.000584,172.31.36.0-255,66,52215,8,314848
9820,0.000592,172.217.194.0-255,5738,57953,8,314848
9821,0.000595,172.31.36.0-255,66,58019,8,314848
9822,0.000637,172.217.194.0-255,5738,63757,8,314848
9823,0.00064,172.31.36.0-255,66,63823,8,314848
9824,0.000679,172.31.36.0-255,66,63889,8,314848
9825,0.000695,172.31.36.0-255,66,63955,8,314848
9826,0.001102,172.217.194.0-255,1484,65439,8,314848
9827,0.001119,172.217.194.0-255,2902,68341,8,314848
9828,0.001123,172.31.36.0-255,66,68407,8,314848
9829,0.001145,172.217.194.0-255,5738,74145,8,314848
9830,0.001147,172.31.36.0-255,66,74211,8,314848
9831,0.001178,172.217.194.0-255,4320,78531,8,314848
9832,0.00118,172.31.36.0-255,66,78597,8,314848
9833,0.001222,172.217.194.0-255,2902,81499,8,314848
9834,0.001226,172.31.36.0-255,66,81565,8,314848
9835,0.00124,172.31.36.0-255,66,81631,8,314848
9836,0.001244,172.217.194.0-255,2184,83815,8,314848
9837,0.001246,172.31.36.0-255,66,83881,8,314848
9838,0.001353,172.217.194.0-255,1484,85365,8,314848
9839,0.001371,172.217.194.0-255,2902,88267,8,314848
9840,0.001374,172.31.36.0-255,66,88333,8,314848
9841,0.001409,172.217.194.0-255,5738,94071,8,314848
9842,0.001412,172.31.36.0-255,66,94137,8,314848
9843,0.001419,172.217.194.0-255,7156,101293,8,314848
9844,0.001421,172.31.36.0-255,66,101359,8,314848
9845,0.001464,172.31.36.0-255,66,101425,8,314848
9846,0.001469,172.217.194.0-255,2184,103609,8,314848
9847,0.001471,172.31.36.0-255,66,103675,8,314848
9848,0.001556,172.217.194.0-255,1484,105159,8,314848
9849,0.001574,172.217.194.0-255,2902,108061,8,314848
9850,0.001577,172.31.36.0-255,66,108127,8,314848
9851,0.001609,172.217.194.0-255,5738,113865,8,314848
9852,0.001612,172.31.36.0-255,66,113931,8,314848
9853,0.001618,172.217.194.0-255,4320,118251,8,314848
9854,0.00162,172.31.36.0-255,66,118317,8,314848
9855,0.001668,172.31.36.0-255,66,118383,8,314848
9856,0.001675,172.217.194.0-255,5738,124121,8,314848
9857,0.001677,172.31.36.0-255,66,124187,8,314848
9858,0.001701,172.217.194.0-255,2184,126371,8,314848
9859,0.001708,172.31.36.0-255,66,126437,8,314848
9860,0.001841,172.217.194.0-255,1484,127921,8,314848
9861,0.001859,172.217.194.0-255,2902,130823,8,314848
9862,0.001866,172.31.36.0-255,66,130889,8,314848
9863,0.001876,172.217.194.0-255,2902,133791,8,314848
9864,0.001879,172.31.36.0-255,66,133857,8,314848
9865,0.001901,172.217.194.0-255,2902,136759,8,314848
9866,0.001903,172.31.36.0-255,66,136825,8,314848
9867,0.001911,172.217.194.0-255,7156,143981,8,314848
9868,0.001918,172.31.36.0-255,66,144047,8,314848
9869,0.001939,172.217.194.0-255,5738,149785,8,314848
9870,0.001946,172.31.36.0-255,66,149851,8,314848
9871,0.001952,172.217.194.0-255,5738,155589,8,314848
9872,0.001955,172.31.36.0-255,66,155655,8,314848
9873,0.002002,172.31.36.0-255,66,155721,8,314848
9874,0.002007,172.217.194.0-255,2184,157905,8,314848
9875,0.00201,172.31.36.0-255,66,157971,8,314848
9876,0.002033,172.31.36.0-255,66,158037,8,314848
9877,0.002059,172.217.194.0-255,2902,160939,8,314848
9878,0.002061,172.31.36.0-255,66,161005,8,314848
9879,0.002067,172.217.194.0-255,5738,166743,8,314848
9880,0.00207,172.31.36.0-255,66,166809,8,314848
9881,0.002074,172.217.194.0-255,2902,169711,8,314848
9882,0.002076,172.31.36.0-255,66,169777,8,314848
9883,0.002101,172.217.194.0-255,2184,171961,8,314848
9884,0.002109,172.31.36.0-255,66,172027,8,314848
9885,0.002165,172.217.194.0-255,1484,173511,8,314848
9886,0.002169,172.217.194.0-255,1484,174995,8,314848
9887,0.002172,172.31.36.0-255,66,175061,8,314848
9888,0.002197,172.217.194.0-255,1484,176545,8,314848
9889,0.002204,172.217.194.0-255,5738,182283,8,314848
9890,0.002207,172.31.36.0-255,66,182349,8,314848
9891,0.002243,172.217.194.0-255,4320,186669,8,314848
9892,0.002247,172.31.36.0-255,66,186735,8,314848
9893,0.002296,172.31.36.0-255,66,186801,8,314848
9894,0.002349,172.217.194.0-255,5738,192539,8,314848
9895,0.002356,172.31.36.0-255,66,192605,8,314848
9896,0.002366,172.217.194.0-255,5020,197625,8,314848
9897,0.00239,172.31.36.0-255,66,197691,8,314848
9898,0.004704,172.217.194.0-255,5738,203429,8,314848
9899,0.004711,172.31.36.0-255,66,203495,8,314848
9900,0.006986,172.217.194.0-255,5738,209233,8,314848
9901,0.006989,172.31.36.0-255,66,209299,8,314848
9902,0.009264,172.217.194.0-255,4320,213619,8,314848
9903,0.00927,172.31.36.0-255,66,213685,8,314848
9904,0.009299,172.217.194.0-255,1484,215169,8,314848
9905,0.01155,172.217.194.0-255,4320,219489,8,314848
9906,0.011558,172.31.36.0-255,66,219555,8,314848
9907,0.013833,172.217.194.0-255,5738,225293,8,314848
9908,0.013842,172.31.36.0-255,66,225359,8,314848
9909,0.016153,172.217.194.0-255,5738,231097,8,314848
9910,0.016162,172.31.36.0-255,66,231163,8,314848
9911,0.01847,172.217.194.0-255,5738,236901,8,314848
9912,0.018479,172.31.36.0-255,66,236967,8,314848
9913,0.020803,172.217.194.0-255,5738,242705,8,314848
9914,0.020812,172.31.36.0-255,66,242771,8,314848
9915,0.023135,172.217.194.0-255,5738,248509,8,314848
9916,0.023144,172.31.36.0-255,66,248575,8,314848
9917,0.02547,172.217.194.0-255,5738,254313,8,314848
9918,0.025478,172.31.36.0-255,66,254379,8,314848
9919,0.027773,172.217.194.0-255,5738,260117,8,314848
9920,0.027782,172.31.36.0-255,66,260183,8,314848
9921,0.030065,172.217.194.0-255,5738,265921,8,314848
9922,0.03007,172.31.36.0-255,66,265987,8,314848
9923,0.03241,172.217.194.0-255,5738,271725,8,314848
9924,0.032417,172.31.36.0-255,66,271791,8,314848
9925,0.034708,172.217.194.0-255,5738,277529,8,314848
9926,0.034716,172.31.36.0-255,66,277595,8,314848
9927,0.036993,172.217.194.0-255,5738,283333,8,314848
9928,0.037002,172.31.36.0-255,66,283399,8,314848
9929,0.039316,172.217.194.0-255,5738,289137,8,314848
9930,0.039324,172.31.36.0-255,66,289203,8,314848
9931,0.040485,172.31.36.0-255,172,289375,8,314848
9932,0.040518,172.31.36.0-255,1112,290487,8,314848
9933,0.040597,172.31.36.0-255,1514,292001,8,314848
9934,0.040599,172.31.36.0-255,1514,293515,8,314848
9935,0.040604,172.31.36.0-255,1514,295029,8,314848
9936,0.040605,172.31.36.0-255,771,295800,8,314848
9937,0.041621,172.217.194.0-255,5738,301538,8,314848
9938,0.041628,172.31.36.0-255,66,301604,8,314848
9939,0.042022,104.244.42.0-255,66,301670,8,314848
9940,0.042076,104.244.42.0-255,66,301736,8,314848
9941,0.042168,104.244.42.0-255,66,301802,8,314848
9942,0.043923,172.217.194.0-255,5738,307540,8,314848
9943,0.043931,172.31.36.0-255,66,307606,8,314848
9944,0.046225,172.217.194.0-255,5738,313344,8,314848
9945,0.046232,172.31.36.0-255,66,313410,8,314848
9946,0.048503,172.217.194.0-255,1201,314611,8,314848
9947,0.048637,172.31.36.0-255,66,314677,8,314848
9948,0.048673,172.31.36.0-255,105,314782,8,314848
9949,0.050899,172.217.194.0-255,66,314848,8,314848
9950,0.0,74.125.24.0-255,148,148,8,282753
9951,1.6e-05,172.31.36.0-255,66,214,8,282753
9952,2.4e-05,74.125.24.0-255,1484,1698,8,282753
9953,2.9e-05,172.31.36.0-255,66,1764,8,282753
9954,4.3e-05,74.125.24.0-255,2902,4666,8,282753
9955,4.6e-05,172.31.36.0-255,66,4732,8,282753
9956,5.5e-05,74.125.24.0-255,7156,11888,8,282753
9957,5.8e-05,172.31.36.0-255,66,11954,8,282753
9958,9.2e-05,74.125.24.0-255,4320,16274,8,282753
9959,9.5e-05,172.31.36.0-255,66,16340,8,282753
9960,0.000117,74.125.24.0-255,4875,21215,8,282753
9961,0.00012,172.31.36.0-255,66,21281,8,282753
9962,0.000137,172.31.36.0-255,66,21347,8,282753
9963,0.000296,74.125.24.0-255,1484,22831,8,282753
9964,0.000301,172.31.36.0-255,66,22897,8,282753
9965,0.000307,74.125.24.0-255,2902,25799,8,282753
9966,0.00031,172.31.36.0-255,66,25865,8,282753
9967,0.000341,74.125.24.0-255,5738,31603,8,282753
9968,0.000344,172.31.36.0-255,66,31669,8,282753
9969,0.000363,74.125.24.0-255,1484,33153,8,282753
9970,0.000365,172.31.36.0-255,66,33219,8,282753
9971,0.000394,74.125.24.0-255,5379,38598,8,282753
9972,0.000397,172.31.36.0-255,66,38664,8,282753
9973,0.000403,74.125.24.0-255,4320,42984,8,282753
9974,0.000405,172.31.36.0-255,66,43050,8,282753
9975,0.000437,74.125.24.0-255,2902,45952,8,282753
9976,0.00044,172.31.36.0-255,66,46018,8,282753
9977,0.000472,172.31.36.0-255,66,46084,8,282753
9978,0.000554,74.125.24.0-255,135,46219,8,282753
9979,0.000557,172.31.36.0-255,66,46285,8,282753
9980,0.000736,74.125.24.0-255,1484,47769,8,282753
9981,0.000744,74.125.24.0-255,2902,50671,8,282753
9982,0.000764,74.125.24.0-255,5738,56409,8,282753
9983,0.000773,172.31.36.0-255,66,56475,8,282753
9984,0.000783,74.125.24.0-255,5738,62213,8,282753
9985,0.000805,172.31.36.0-255,66,62279,8,282753
9986,0.000831,74.125.24.0-255,4320,66599,8,282753
9987,0.000842,172.31.36.0-255,66,66665,8,282753
9988,0.000881,74.125.24.0-255,5020,71685,8,282753
9989,0.000883,74.125.24.0-255,347,72032,8,282753
9990,0.00089,172.31.36.0-255,66,72098,8,282753
9991,0.00126,74.125.24.0-255,1484,73582,8,282753
9992,0.001266,74.125.24.0-255,2902,76484,8,282753
9993,0.001269,172.31.36.0-255,66,76550,8,282753
9994,0.001277,74.125.24.0-255,5738,82288,8,282753
9995,0.00128,74.125.24.0-255,1484,83772,8,282753
9996,0.001301,74.125.24.0-255,4320,88092,8,282753
9997,0.001306,74.125.24.0-255,2902,90994,8,282753
9998,0.001324,74.125.24.0-255,7156,98150,8,282753
9999,0.001332,172.31.36.0-255,66,98216,8,282753
10000,0.00134,74.125.24.0-255,2902,101118,8,282753
10001,0.001347,172.31.36.0-255,66,101184,8,282753
10002,0.00136,74.125.24.0-255,2902,104086,8,282753
10003,0.001382,74.125.24.0-255,2184,106270,8,282753
10004,0.001397,172.31.36.0-255,66,106336,8,282753
10005,0.001792,74.125.24.0-255,1484,107820,8,282753
10006,0.001798,74.125.24.0-255,2902,110722,8,282753
10007,0.001801,172.31.36.0-255,66,110788,8,282753
10008,0.001805,74.125.24.0-255,1484,112272,8,282753
10009,0.001835,74.125.24.0-255,4320,116592,8,282753
10010,0.001837,172.31.36.0-255,66,116658,8,282753
10011,0.001864,74.125.24.0-255,5738,122396,8,282753
10012,0.001869,172.31.36.0-255,66,122462,8,282753
10013,0.001902,74.125.24.0-255,7156,129618,8,282753
10014,0.001905,172.31.36.0-255,66,129684,8,282753
10015,0.001912,74.125.24.0-255,5738,135422,8,282753
10016,0.001914,172.31.36.0-255,66,135488,8,282753
10017,0.001918,74.125.24.0-255,2902,138390,8,282753
10018,0.00192,172.31.36.0-255,66,138456,8,282753
10019,0.001933,74.125.24.0-255,2184,140640,8,282753
10020,0.001935,172.31.36.0-255,66,140706,8,282753
10021,0.001962,74.125.24.0-255,5738,146444,8,282753
10022,0.001967,74.125.24.0-255,2902,149346,8,282753
10023,0.001971,172.31.36.0-255,66,149412,8,282753
10024,0.001978,74.125.24.0-255,1484,150896,8,282753
10025,0.002019,74.125.24.0-255,1484,152380,8,282753
10026,0.002025,172.31.36.0-255,66,152446,8,282753
10027,0.002078,172.31.36.0-255,66,152512,8,282753
10028,0.002096,74.125.24.0-255,3602,156114,8,282753
10029,0.002099,74.125.24.0-255,1484,157598,8,282753
10030,0.002103,74.125.24.0-255,2902,160500,8,282753
10031,0.002106,74.125.24.0-255,1484,161984,8,282753
10032,0.002135,74.125.24.0-255,4320,166304,8,282753
10033,0.002141,74.125.24.0-255,5738,172042,8,282753
10034,0.002146,172.31.36.0-255,66,172108,8,282753
10035,0.00219,74.125.24.0-255,5020,177128,8,282753
10036,0.002206,172.31.36.0-255,66,177194,8,282753
10037,0.002311,74.125.24.0-255,1484,178678,8,282753
10038,0.002317,74.125.24.0-255,2902,181580,8,282753
10039,0.002335,74.125.24.0-255,5738,187318,8,282753
10040,0.002373,74.125.24.0-255,2902,190220,8,282753
10041,0.002424,74.125.24.0-255,1484,191704,8,282753
10042,0.002427,74.125.24.0-255,1484,193188,8,282753
10043,0.002477,74.125.24.0-255,1484,194672,8,282753
10044,0.002501,74.125.24.0-255,4320,198992,8,282753
10045,0.002533,74.125.24.0-255,7156,206148,8,282753
10046,0.002547,74.125.24.0-255,3602,209750,8,282753
10047,0.002554,74.125.24.0-255,7156,216906,8,282753
10048,0.002572,74.125.24.0-255,4320,221226,8,282753
10049,0.002575,74.125.24.0-255,1484,222710,8,282753
10050,0.002579,172.31.36.0-255,78,222788,8,282753
10051,0.002614,172.31.36.0-255,78,222866,8,282753
10052,0.002648,74.125.24.0-255,7156,230022,8,282753
10053,0.007774,172.31.36.0-255,66,230088,8,282753
10054,0.009821,74.125.24.0-255,4320,234408,8,282753
10055,0.009827,172.31.36.0-255,78,234486,8,282753
10056,0.009856,74.125.24.0-255,1484,235970,8,282753
10057,0.009858,172.31.36.0-255,78,236048,8,282753
10058,0.010378,74.125.24.0-255,5738,241786,8,282753
10059,0.010384,172.31.36.0-255,66,241852,8,282753
10060,0.012959,74.125.24.0-255,5738,247590,8,282753
10061,0.012966,172.31.36.0-255,66,247656,8,282753
10062,0.015538,74.125.24.0-255,5738,253394,8,282753
10063,0.015546,172.31.36.0-255,66,253460,8,282753
10064,0.018128,74.125.24.0-255,5738,259198,8,282753
10065,0.018137,172.31.36.0-255,66,259264,8,282753
10066,0.020719,74.125.24.0-255,5738,265002,8,282753
10067,0.020728,172.31.36.0-255,66,265068,8,282753
10068,0.023286,74.125.24.0-255,5738,270806,8,282753
10069,0.023294,172.31.36.0-255,66,270872,8,282753
10070,0.025887,74.125.24.0-255,5738,276610,8,282753
10071,0.025895,172.31.36.0-255,66,276676,8,282753
10072,0.028465,74.125.24.0-255,3788,280464,8,282753
10073,0.028473,172.31.36.0-255,66,280530,8,282753
10074,0.028668,172.31.36.0-255,105,280635,8,282753
10075,0.031184,74.125.24.0-255,66,280701,8,282753
10076,0.037501,172.31.36.0-255,172,280873,8,282753
10077,0.037536,172.31.36.0-255,1110,281983,8,282753
10078,0.037593,172.31.36.0-255,572,282555,8,282753
10079,0.039037,104.244.42.0-255,66,282621,8,282753
10080,0.039069,104.244.42.0-255,66,282687,8,282753
10081,0.039122,104.244.42.0-255,66,282753,8,282753
10082,0.0,74.125.24.0-255,146,146,8,252163
10083,2.6e-05,172.31.36.0-255,66,212,8,252163
10084,3.3e-05,74.125.24.0-255,1484,1696,8,252163
10085,3.9e-05,172.31.36.0-255,66,1762,8,252163
10086,4.6e-05,74.125.24.0-255,2902,4664,8,252163
10087,4.9e-05,172.31.36.0-255,66,4730,8,252163
10088,5.8e-05,74.125.24.0-255,7156,11886,8,252163
10089,6.1e-05,172.31.36.0-255,66,11952,8,252163
10090,8.8e-05,74.125.24.0-255,2012,13964,8,252163
10091,9.1e-05,172.31.36.0-255,66,14030,8,252163
10092,0.000151,74.125.24.0-255,1484,15514,8,252163
10093,0.000154,172.31.36.0-255,66,15580,8,252163
10094,0.000159,74.125.24.0-255,2902,18482,8,252163
10095,0.000161,172.31.36.0-255,66,18548,8,252163
10096,0.000187,74.125.24.0-255,5738,24286,8,252163
10097,0.000189,172.31.36.0-255,66,24352,8,252163
10098,0.000203,74.125.24.0-255,1484,25836,8,252163
10099,0.000205,172.31.36.0-255,66,25902,8,252163
10100,0.000209,74.125.24.0-255,1484,27386,8,252163
10101,0.000211,172.31.36.0-255,66,27452,8,252163
10102,0.000235,74.125.24.0-255,1484,28936,8,252163
10103,0.000238,172.31.36.0-255,66,29002,8,252163
10104,0.000242,74.125.24.0-255,2543,31545,8,252163
10105,0.000245,172.31.36.0-255,66,31611,8,252163
10106,0.000413,74.125.24.0-255,1484,33095,8,252163
10107,0.000418,172.31.36.0-255,66,33161,8,252163
10108,0.000424,74.125.24.0-255,2902,36063,8,252163
10109,0.000427,172.31.36.0-255,66,36129,8,252163
10110,0.000447,74.125.24.0-255,4320,40449,8,252163
10111,0.000449,172.31.36.0-255,66,40515,8,252163
10112,0.000467,74.125.24.0-255,1484,41999,8,252163
10113,0.000469,172.31.36.0-255,66,42065,8,252163
10114,0.000501,74.125.24.0-255,5738,47803,8,252163
10115,0.000503,172.31.36.0-255,66,47869,8,252163
10116,0.000528,172.31.36.0-255,66,47935,8,252163
10117,0.000559,74.125.24.0-255,1484,49419,8,252163
10118,0.000572,74.125.24.0-255,1484,50903,8,252163
10119,0.000574,172.31.36.0-255,66,50969,8,252163
10120,0.00058,74.125.24.0-255,2902,53871,8,252163
10121,0.000582,172.31.36.0-255,66,53937,8,252163
10122,0.000599,74.125.24.0-255,4235,58172,8,252163
10123,0.000602,172.31.36.0-255,66,58238,8,252163
10124,0.000613,74.125.24.0-255,135,58373,8,252163
10125,0.000738,74.125.24.0-255,1484,59857,8,252163
10126,0.000743,172.31.36.0-255,66,59923,8,252163
10127,0.000748,74.125.24.0-255,2902,62825,8,252163
10128,0.000751,172.31.36.0-255,66,62891,8,252163
10129,0.00078,74.125.24.0-255,5738,68629,8,252163
10130,0.000783,172.31.36.0-255,66,68695,8,252163
10131,0.000788,74.125.24.0-255,2902,71597,8,252163
10132,0.00079,172.31.36.0-255,66,71663,8,252163
10133,0.000819,172.31.36.0-255,66,71729,8,252163
10134,0.000874,74.125.24.0-255,4320,76049,8,252163
10135,0.000878,172.31.36.0-255,66,76115,8,252163
10136,0.000895,74.125.24.0-255,5738,81853,8,252163
10137,0.000898,172.31.36.0-255,66,81919,8,252163
10138,0.000921,74.125.24.0-255,463,82382,8,252163
10139,0.001047,74.125.24.0-255,1484,83866,8,252163
10140,0.001051,172.31.36.0-255,66,83932,8,252163
10141,0.001056,74.125.24.0-255,2902,86834,8,252163
10142,0.001058,172.31.36.0-255,66,86900,8,252163
10143,0.001064,74.125.24.0-255,5738,92638,8,252163
10144,0.001066,172.31.36.0-255,66,92704,8,252163
10145,0.001115,172.31.36.0-255,66,92770,8,252163
10146,0.001135,74.125.24.0-255,2902,95672,8,252163
10147,0.001138,172.31.36.0-255,66,95738,8,252163
10148,0.001184,74.125.24.0-255,5738,101476,8,252163
10149,0.001187,172.31.36.0-255,66,101542,8,252163
10150,0.001227,74.125.24.0-255,5020,106562,8,252163
10151,0.001231,172.31.36.0-255,66,106628,8,252163
10152,0.001321,74.125.24.0-255,1484,108112,8,252163
10153,0.001359,74.125.24.0-255,2902,111014,8,252163
10154,0.001363,172.31.36.0-255,66,111080,8,252163
10155,0.001367,74.125.24.0-255,1484,112564,8,252163
10156,0.001372,74.125.24.0-255,2902,115466,8,252163
10157,0.001374,172.31.36.0-255,66,115532,8,252163
10158,0.00138,74.125.24.0-255,5738,121270,8,252163
10159,0.001382,172.31.36.0-255,66,121336,8,252163
10160,0.001402,74.125.24.0-255,2902,124238,8,252163
10161,0.001405,172.31.36.0-255,66,124304,8,252163
10162,0.00144,172.31.36.0-255,66,124370,8,252163
10163,0.001485,74.125.24.0-255,5738,130108,8,252163
10164,0.001488,172.31.36.0-255,66,130174,8,252163
10165,0.001518,74.125.24.0-255,766,130940,8,252163
10166,0.001554,74.125.24.0-255,4320,135260,8,252163
10167,0.001557,172.31.36.0-255,66,135326,8,252163
10168,0.001582,74.125.24.0-255,4320,139646,8,252163
10169,0.001585,172.31.36.0-255,66,139712,8,252163
10170,0.001598,172.31.36.0-255,66,139778,8,252163
10171,0.00163,74.125.24.0-255,7156,146934,8,252163
10172,0.001634,172.31.36.0-255,66,147000,8,252163
10173,0.001724,74.125.24.0-255,6438,153438,8,252163
10174,0.001728,172.31.36.0-255,66,153504,8,252163
10175,0.001756,74.125.24.0-255,2902,156406,8,252163
10176,0.001759,172.31.36.0-255,66,156472,8,252163
10177,0.00178,74.125.24.0-255,4320,160792,8,252163
10178,0.001784,172.31.36.0-255,66,160858,8,252163
10179,0.001796,74.125.24.0-255,4320,165178,8,252163
10180,0.001798,172.31.36.0-255,66,165244,8,252163
10181,0.00183,172.31.36.0-255,66,165310,8,252163
10182,0.001937,74.125.24.0-255,5738,171048,8,252163
10183,0.00194,172.31.36.0-255,66,171114,8,252163
10184,0.001963,74.125.24.0-255,5020,176134,8,252163
10185,0.001966,172.31.36.0-255,66,176200,8,252163
10186,0.001987,172.31.36.0-255,66,176266,8,252163
10187,0.002005,74.125.24.0-255,2902,179168,8,252163
10188,0.002007,172.31.36.0-255,66,179234,8,252163
10189,0.002075,74.125.24.0-255,5738,184972,8,252163
10190,0.002079,172.31.36.0-255,66,185038,8,252163
10191,0.002096,74.125.24.0-255,2902,187940,8,252163
10192,0.002099,172.31.36.0-255,66,188006,8,252163
10193,0.002102,74.125.24.0-255,1484,189490,8,252163
10194,0.002139,74.125.24.0-255,5020,194510,8,252163
10195,0.002226,74.125.24.0-255,7156,201666,8,252163
10196,0.002268,74.125.24.0-255,1484,203150,8,252163
10197,0.002404,74.125.24.0-255,766,203916,8,252163
10198,0.002422,74.125.24.0-255,1484,205400,8,252163
10199,0.002428,74.125.24.0-255,4320,209720,8,252163
10200,0.002461,74.125.24.0-255,4320,214040,8,252163
10201,0.002481,74.125.24.0-255,5738,219778,8,252163
10202,0.002535,74.125.24.0-255,7156,226934,8,252163
10203,0.002825,74.125.24.0-255,5020,231954,8,252163
10204,0.003026,74.125.24.0-255,5738,237692,8,252163
10205,0.003043,74.125.24.0-255,4320,242012,8,252163
10206,0.006908,172.31.36.0-255,66,242078,8,252163
10207,0.007747,172.31.36.0-255,101,242179,8,252163
10208,0.0095,74.125.24.0-255,5738,247917,8,252163
10209,0.009512,172.31.36.0-255,66,247983,8,252163
10210,0.010313,74.125.24.0-255,66,248049,8,252163
10211,0.012118,74.125.24.0-255,953,249002,8,252163
10212,0.012652,172.31.36.0-255,105,249107,8,252163
10213,0.019322,74.125.24.0-255,66,249173,8,252163
10214,0.035985,172.31.36.0-255,188,249361,8,252163
10215,0.036023,172.31.36.0-255,955,250316,8,252163
10216,0.03609,172.31.36.0-255,1514,251830,8,252163
10217,0.036092,172.31.36.0-255,135,251965,8,252163
10218,0.037527,104.244.42.0-255,66,252031,8,252163
10219,0.037571,104.244.42.0-255,66,252097,8,252163
10220,0.037658,104.244.42.0-255,66,252163,8,252163
10221,0.0,74.125.24.0-255,150,150,8,272678
10222,2.5e-05,172.31.36.0-255,66,216,8,272678
10223,3.2e-05,74.125.24.0-255,1484,1700,8,272678
10224,3.6e-05,172.31.36.0-255,66,1766,8,272678
10225,4.1e-05,74.125.24.0-255,2902,4668,8,272678
10226,4.5e-05,172.31.36.0-255,66,4734,8,272678
10227,5.9e-05,74.125.24.0-255,7156,11890,8,272678
10228,6.2e-05,172.31.36.0-255,66,11956,8,272678
10229,0.0001,74.125.24.0-255,2056,14012,8,272678
10230,0.000103,172.31.36.0-255,66,14078,8,272678
10231,0.000188,74.125.24.0-255,1484,15562,8,272678
10232,0.000192,172.31.36.0-255,66,15628,8,272678
10233,0.000198,74.125.24.0-255,2902,18530,8,272678
10234,0.000201,172.31.36.0-255,66,18596,8,272678
10235,0.000204,74.125.24.0-255,1484,20080,8,272678
10236,0.000206,172.31.36.0-255,66,20146,8,272678
10237,0.000232,74.125.24.0-255,4320,24466,8,272678
10238,0.000235,172.31.36.0-255,66,24532,8,272678
10239,0.000265,74.125.24.0-255,4320,28852,8,272678
10240,0.000269,172.31.36.0-255,66,28918,8,272678
10241,0.000295,74.125.24.0-255,2543,31461,8,272678
10242,0.000299,172.31.36.0-255,66,31527,8,272678
10243,0.000467,74.125.24.0-255,1484,33011,8,272678
10244,0.000472,172.31.36.0-255,66,33077,8,272678
10245,0.000486,74.125.24.0-255,2902,35979,8,272678
10246,0.000494,172.31.36.0-255,66,36045,8,272678
10247,0.000501,74.125.24.0-255,5738,41783,8,272678
10248,0.000503,172.31.36.0-255,66,41849,8,272678
10249,0.000545,74.125.24.0-255,5738,47587,8,272678
10250,0.000549,172.31.36.0-255,66,47653,8,272678
10251,0.000583,172.31.36.0-255,66,47719,8,272678
10252,0.000658,74.125.24.0-255,7156,54875,8,272678
10253,0.000663,172.31.36.0-255,66,54941,8,272678
10254,0.00071,74.125.24.0-255,2543,57484,8,272678
10255,0.000713,172.31.36.0-255,66,57550,8,272678
10256,0.001132,74.125.24.0-255,647,58197,8,272678
10257,0.001306,74.125.24.0-255,1484,59681,8,272678
10258,0.001311,172.31.36.0-255,66,59747,8,272678
10259,0.001318,74.125.24.0-255,2902,62649,8,272678
10260,0.00132,172.31.36.0-255,66,62715,8,272678
10261,0.001325,74.125.24.0-255,2902,65617,8,272678
10262,0.001334,172.31.36.0-255,66,65683,8,272678
10263,0.001359,74.125.24.0-255,2902,68585,8,272678
10264,0.001362,172.31.36.0-255,66,68651,8,272678
10265,0.001396,172.31.36.0-255,66,68717,8,272678
10266,0.001449,74.125.24.0-255,5738,74455,8,272678
10267,0.001452,172.31.36.0-255,66,74521,8,272678
10268,0.001485,172.31.36.0-255,66,74587,8,272678
10269,0.001938,74.125.24.0-255,1484,76071,8,272678
10270,0.001945,74.125.24.0-255,2902,78973,8,272678
10271,0.001947,172.31.36.0-255,66,79039,8,272678
10272,0.001951,74.125.24.0-255,1484,80523,8,272678
10273,0.001975,74.125.24.0-255,4320,84843,8,272678
10274,0.001978,172.31.36.0-255,66,84909,8,272678
10275,0.002005,74.125.24.0-255,7156,92065,8,272678
10276,0.002007,172.31.36.0-255,66,92131,8,272678
10277,0.002057,74.125.24.0-255,2902,95033,8,272678
10278,0.002059,172.31.36.0-255,66,95099,8,272678
10279,0.002096,172.31.36.0-255,66,95165,8,272678
10280,0.002173,74.125.24.0-255,2184,97349,8,272678
10281,0.002176,172.31.36.0-255,66,97415,8,272678
10282,0.004353,74.125.24.0-255,2902,100317,8,272678
10283,0.004358,172.31.36.0-255,66,100383,8,272678
10284,0.004431,74.125.24.0-255,2902,103285,8,272678
10285,0.004433,172.31.36.0-255,66,103351,8,272678
10286,0.006609,74.125.24.0-255,2902,106253,8,272678
10287,0.006614,172.31.36.0-255,66,106319,8,272678
10288,0.006658,74.125.24.0-255,2902,109221,8,272678
10289,0.006661,172.31.36.0-255,66,109287,8,272678
10290,0.008871,74.125.24.0-255,2902,112189,8,272678
10291,0.008878,172.31.36.0-255,66,112255,8,272678
10292,0.008915,74.125.24.0-255,2902,115157,8,272678
10293,0.008919,172.31.36.0-255,66,115223,8,272678
10294,0.01115,74.125.24.0-255,2902,118125,8,272678
10295,0.011158,172.31.36.0-255,66,118191,8,272678
10296,0.011178,74.125.24.0-255,2902,121093,8,272678
10297,0.011181,172.31.36.0-255,66,121159,8,272678
10298,0.013435,74.125.24.0-255,5738,126897,8,272678
10299,0.013443,172.31.36.0-255,66,126963,8,272678
10300,0.015691,74.125.24.0-255,5738,132701,8,272678
10301,0.015699,172.31.36.0-255,66,132767,8,272678
10302,0.017932,74.125.24.0-255,5738,138505,8,272678
10303,0.017939,172.31.36.0-255,66,138571,8,272678
10304,0.020177,74.125.24.0-255,5738,144309,8,272678
10305,0.020185,172.31.36.0-255,66,144375,8,272678
10306,0.022421,74.125.24.0-255,5738,150113,8,272678
10307,0.022428,172.31.36.0-255,66,150179,8,272678
10308,0.024684,74.125.24.0-255,5738,155917,8,272678
10309,0.024691,172.31.36.0-255,66,155983,8,272678
10310,0.026958,74.125.24.0-255,5738,161721,8,272678
10311,0.026966,172.31.36.0-255,66,161787,8,272678
10312,0.029238,74.125.24.0-255,5738,167525,8,272678
10313,0.029247,172.31.36.0-255,66,167591,8,272678
10314,0.029829,172.31.36.0-255,172,167763,8,272678
10315,0.029876,172.31.36.0-255,1112,168875,8,272678
10316,0.029956,172.31.36.0-255,1514,170389,8,272678
10317,0.029958,172.31.36.0-255,1514,171903,8,272678
10318,0.029965,172.31.36.0-255,1514,173417,8,272678
10319,0.029966,172.31.36.0-255,1514,174931,8,272678
10320,0.029986,172.31.36.0-255,167,175098,8,272678
10321,0.031389,104.244.42.0-255,66,175164,8,272678
10322,0.0314,104.244.42.0-255,66,175230,8,272678
10323,0.031464,104.244.42.0-255,66,175296,8,272678
10324,0.03147,104.244.42.0-255,66,175362,8,272678
10325,0.031507,74.125.24.0-255,4320,179682,8,272678
10326,0.031515,172.31.36.0-255,66,179748,8,272678
10327,0.03155,74.125.24.0-255,1484,181232,8,272678
10328,0.033801,74.125.24.0-255,4320,185552,8,272678
10329,0.033812,172.31.36.0-255,66,185618,8,272678
10330,0.036067,74.125.24.0-255,5738,191356,8,272678
10331,0.036074,172.31.36.0-255,66,191422,8,272678
10332,0.038358,74.125.24.0-255,5738,197160,8,272678
10333,0.038368,172.31.36.0-255,66,197226,8,272678
10334,0.040622,74.125.24.0-255,5738,202964,8,272678
10335,0.040632,172.31.36.0-255,66,203030,8,272678
10336,0.042871,74.125.24.0-255,5738,208768,8,272678
10337,0.042884,172.31.36.0-255,66,208834,8,272678
10338,0.04516,74.125.24.0-255,5738,214572,8,272678
10339,0.045172,172.31.36.0-255,66,214638,8,272678
10340,0.047431,74.125.24.0-255,5738,220376,8,272678
10341,0.047437,172.31.36.0-255,66,220442,8,272678
10342,0.049699,74.125.24.0-255,5738,226180,8,272678
10343,0.049704,172.31.36.0-255,66,226246,8,272678
10344,0.051948,74.125.24.0-255,5738,231984,8,272678
10345,0.051954,172.31.36.0-255,66,232050,8,272678
10346,0.05423,74.125.24.0-255,5738,237788,8,272678
10347,0.054235,172.31.36.0-255,66,237854,8,272678
10348,0.056495,74.125.24.0-255,5738,243592,8,272678
10349,0.056501,172.31.36.0-255,66,243658,8,272678
10350,0.058753,74.125.24.0-255,5738,249396,8,272678
10351,0.058759,172.31.36.0-255,66,249462,8,272678
10352,0.061049,74.125.24.0-255,5738,255200,8,272678
10353,0.061055,172.31.36.0-255,66,255266,8,272678
10354,0.063302,74.125.24.0-255,5738,261004,8,272678
10355,0.06331,172.31.36.0-255,66,261070,8,272678
10356,0.065578,74.125.24.0-255,5738,266808,8,272678
10357,0.065589,172.31.36.0-255,66,266874,8,272678
10358,0.067854,74.125.24.0-255,5738,272612,8,272678
10359,0.06786,172.31.36.0-255,66,272678,8,272678
10360,0.0,74.125.24.0-255,291,291,8,358750
10361,3.9e-05,172.31.36.0-255,66,357,8,358750
10362,4.6e-05,74.125.24.0-255,1484,1841,8,358750
10363,5.1e-05,172.31.36.0-255,66,1907,8,358750
10364,5.8e-05,74.125.24.0-255,4320,6227,8,358750
10365,6e-05,172.31.36.0-255,66,6293,8,358750
10366,6.3e-05,74.125.24.0-255,1484,7777,8,358750
10367,6.5e-05,172.31.36.0-255,66,7843,8,358750
10368,8e-05,172.31.36.0-255,66,7909,8,358750
10369,8.7e-05,74.125.24.0-255,7156,15065,8,358750
10370,9e-05,172.31.36.0-255,66,15131,8,358750
10371,0.000112,74.125.24.0-255,5379,20510,8,358750
10372,0.000115,172.31.36.0-255,66,20576,8,358750
10373,0.000201,74.125.24.0-255,1484,22060,8,358750
10374,0.000205,172.31.36.0-255,66,22126,8,358750
10375,0.000209,74.125.24.0-255,1484,23610,8,358750
10376,0.000211,172.31.36.0-255,66,23676,8,358750
10377,0.000226,74.125.24.0-255,1484,25160,8,358750
10378,0.000228,172.31.36.0-255,66,25226,8,358750
10379,0.000231,74.125.24.0-255,1484,26710,8,358750
10380,0.000233,172.31.36.0-255,66,26776,8,358750
10381,0.000257,74.125.24.0-255,2902,29678,8,358750
10382,0.00026,172.31.36.0-255,66,29744,8,358750
10383,0.000265,74.125.24.0-255,2902,32646,8,358750
10384,0.000267,172.31.36.0-255,66,32712,8,358750
10385,0.000284,74.125.24.0-255,6797,39509,8,358750
10386,0.000287,172.31.36.0-255,66,39575,8,358750
10387,0.000293,74.125.24.0-255,4320,43895,8,358750
10388,0.000295,172.31.36.0-255,66,43961,8,358750
10389,0.000313,74.125.24.0-255,4320,48281,8,358750
10390,0.000316,172.31.36.0-255,66,48347,8,358750
10391,0.000365,74.125.24.0-255,5738,54085,8,358750
10392,0.000369,172.31.36.0-255,66,54151,8,358750
10393,0.000388,74.125.24.0-255,1713,55864,8,358750
10394,0.00039,172.31.36.0-255,66,55930,8,358750
10395,0.000409,74.125.24.0-255,1484,57414,8,358750
10396,0.000437,74.125.24.0-255,7156,64570,8,358750
10397,0.000441,172.31.36.0-255,66,64636,8,358750
10398,0.000446,74.125.24.0-255,4320,68956,8,358750
10399,0.000448,172.31.36.0-255,66,69022,8,358750
10400,0.000468,74.125.24.0-255,1484,70506,8,358750
10401,0.000482,74.125.24.0-255,1995,72501,8,358750
10402,0.000486,172.31.36.0-255,66,72567,8,358750
10403,0.000977,74.125.24.0-255,1484,74051,8,358750
10404,0.001005,74.125.24.0-255,2902,76953,8,358750
10405,0.001009,172.31.36.0-255,66,77019,8,358750
10406,0.001035,74.125.24.0-255,5738,82757,8,358750
10407,0.001038,172.31.36.0-255,66,82823,8,358750
10408,0.001069,172.31.36.0-255,66,82889,8,358750
10409,0.001074,74.125.24.0-255,4320,87209,8,358750
10410,0.001076,172.31.36.0-255,66,87275,8,358750
10411,0.001102,74.125.24.0-255,7156,94431,8,358750
10412,0.001105,172.31.36.0-255,66,94497,8,358750
10413,0.001136,74.125.24.0-255,4320,98817,8,358750
10414,0.001142,172.31.36.0-255,66,98883,8,358750
10415,0.001152,74.125.24.0-255,7156,106039,8,358750
10416,0.001154,172.31.36.0-255,66,106105,8,358750
10417,0.00116,74.125.24.0-255,4320,110425,8,358750
10418,0.001162,172.31.36.0-255,66,110491,8,358750
10419,0.001185,74.125.24.0-255,2184,112675,8,358750
10420,0.001188,172.31.36.0-255,66,112741,8,358750
10421,0.001222,74.125.24.0-255,1484,114225,8,358750
10422,0.001274,74.125.24.0-255,2902,117127,8,358750
10423,0.001277,172.31.36.0-255,66,117193,8,358750
10424,0.001283,74.125.24.0-255,2902,120095,8,358750
10425,0.001285,172.31.36.0-255,66,120161,8,358750
10426,0.001298,74.125.24.0-255,1484,121645,8,358750
10427,0.001305,74.125.24.0-255,5738,127383,8,358750
10428,0.001308,172.31.36.0-255,66,127449,8,358750
10429,0.001327,74.125.24.0-255,2902,130351,8,358750
10430,0.00133,172.31.36.0-255,66,130417,8,358750
10431,0.001379,74.125.24.0-255,4320,134737,8,358750
10432,0.001382,172.31.36.0-255,66,134803,8,358750
10433,0.001403,172.31.36.0-255,66,134869,8,358750
10434,0.001415,74.125.24.0-255,1484,136353,8,358750
10435,0.001434,74.125.24.0-255,2184,138537,8,358750
10436,0.001437,172.31.36.0-255,66,138603,8,358750
10437,0.001442,74.125.24.0-255,4320,142923,8,358750
10438,0.001445,172.31.36.0-255,66,142989,8,358750
10439,0.001449,74.125.24.0-255,2902,145891,8,358750
10440,0.001451,172.31.36.0-255,66,145957,8,358750
10441,0.001481,74.125.24.0-255,7156,153113,8,358750
10442,0.001484,172.31.36.0-255,66,153179,8,358750
10443,0.001494,172.31.36.0-255,66,153245,8,358750
10444,0.001519,74.125.24.0-255,5738,158983,8,358750
10445,0.001522,172.31.36.0-255,66,159049,8,358750
10446,0.001537,74.125.24.0-255,5020,164069,8,358750
10447,0.00154,172.31.36.0-255,66,164135,8,358750
10448,0.001693,74.125.24.0-255,1484,165619,8,358750
10449,0.001699,74.125.24.0-255,2902,168521,8,358750
10450,0.001702,172.31.36.0-255,66,168587,8,358750
10451,0.001724,74.125.24.0-255,5738,174325,8,358750
10452,0.001728,172.31.36.0-255,66,174391,8,358750
10453,0.001766,74.125.24.0-255,4320,178711,8,358750
10454,0.001769,172.31.36.0-255,66,178777,8,358750
10455,0.001791,74.125.24.0-255,2902,181679,8,358750
10456,0.001794,172.31.36.0-255,66,181745,8,358750
10457,0.001809,172.31.36.0-255,66,181811,8,358750
10458,0.001813,74.125.24.0-255,2184,183995,8,358750
10459,0.001815,172.31.36.0-255,66,184061,8,358750
10460,0.00203,74.125.24.0-255,1484,185545,8,358750
10461,0.002036,74.125.24.0-255,2902,188447,8,358750
10462,0.002039,172.31.36.0-255,66,188513,8,358750
10463,0.002043,74.125.24.0-255,1484,189997,8,358750
10464,0.00206,74.125.24.0-255,4320,194317,8,358750
10465,0.002062,172.31.36.0-255,66,194383,8,358750
10466,0.002089,74.125.24.0-255,5738,200121,8,358750
10467,0.002094,172.31.36.0-255,66,200187,8,358750
10468,0.002114,74.125.24.0-255,7156,207343,8,358750
10469,0.002118,172.31.36.0-255,66,207409,8,358750
10470,0.002123,172.31.36.0-255,66,207475,8,358750
10471,0.002149,74.125.24.0-255,2184,209659,8,358750
10472,0.002153,172.31.36.0-255,66,209725,8,358750
10473,0.004487,74.125.24.0-255,5738,215463,8,358750
10474,0.004495,172.31.36.0-255,66,215529,8,358750
10475,0.006853,74.125.24.0-255,5738,221267,8,358750
10476,0.006859,172.31.36.0-255,66,221333,8,358750
10477,0.009209,74.125.24.0-255,5738,227071,8,358750
10478,0.009215,172.31.36.0-255,66,227137,8,358750
10479,0.011572,74.125.24.0-255,5738,232875,8,358750
10480,0.011579,172.31.36.0-255,66,232941,8,358750
10481,0.013936,74.125.24.0-255,5738,238679,8,358750
10482,0.013947,172.31.36.0-255,66,238745,8,358750
10483,0.016315,74.125.24.0-255,5738,244483,8,358750
10484,0.016324,172.31.36.0-255,66,244549,8,358750
10485,0.018652,74.125.24.0-255,5738,250287,8,358750
10486,0.018667,172.31.36.0-255,66,250353,8,358750
10487,0.021013,74.125.24.0-255,5738,256091,8,358750
10488,0.021022,172.31.36.0-255,66,256157,8,358750
10489,0.02336,74.125.24.0-255,5738,261895,8,358750
10490,0.023368,172.31.36.0-255,66,261961,8,358750
10491,0.025125,172.31.36.0-255,172,262133,8,358750
10492,0.025158,172.31.36.0-255,1112,263245,8,358750
10493,0.025206,172.31.36.0-255,1514,264759,8,358750
10494,0.025208,172.31.36.0-255,1292,266051,8,358750
10495,0.025723,74.125.24.0-255,5738,271789,8,358750
10496,0.025729,172.31.36.0-255,66,271855,8,358750
10497,0.026697,104.244.42.0-255,66,271921,8,358750
10498,0.026706,104.244.42.0-255,66,271987,8,358750
10499,0.026788,104.244.42.0-255,66,272053,8,358750
10500,0.028078,74.125.24.0-255,5738,277791,8,358750
10501,0.028084,172.31.36.0-255,66,277857,8,358750
10502,0.030456,74.125.24.0-255,5738,283595,8,358750
10503,0.030462,172.31.36.0-255,66,283661,8,358750
10504,0.032812,74.125.24.0-255,5738,289399,8,358750
10505,0.032817,172.31.36.0-255,66,289465,8,358750
10506,0.035154,74.125.24.0-255,5738,295203,8,358750
10507,0.035159,172.31.36.0-255,66,295269,8,358750
10508,0.037482,74.125.24.0-255,5738,301007,8,358750
10509,0.037487,172.31.36.0-255,66,301073,8,358750
10510,0.039839,74.125.24.0-255,5738,306811,8,358750
10511,0.039844,172.31.36.0-255,66,306877,8,358750
10512,0.04219,74.125.24.0-255,5738,312615,8,358750
10513,0.042211,172.31.36.0-255,66,312681,8,358750
10514,0.044537,74.125.24.0-255,1484,314165,8,358750
10515,0.044569,74.125.24.0-255,4320,318485,8,358750
10516,0.044574,172.31.36.0-255,66,318551,8,358750
10517,0.046925,74.125.24.0-255,4320,322871,8,358750
10518,0.04693,172.31.36.0-255,66,322937,8,358750
10519,0.046974,74.125.24.0-255,1484,324421,8,358750
10520,0.049275,74.125.24.0-255,4320,328741,8,358750
10521,0.049279,172.31.36.0-255,66,328807,8,358750
10522,0.051653,74.125.24.0-255,4320,333127,8,358750
10523,0.051658,172.31.36.0-255,66,333193,8,358750
10524,0.05169,74.125.24.0-255,1484,334677,8,358750
10525,0.053982,74.125.24.0-255,2902,337579,8,358750
10526,0.053988,172.31.36.0-255,66,337645,8,358750
10527,0.05402,74.125.24.0-255,1484,339129,8,358750
10528,0.056337,74.125.24.0-255,4320,343449,8,358750
10529,0.056343,172.31.36.0-255,66,343515,8,358750
10530,0.058682,74.125.24.0-255,4320,347835,8,358750
10531,0.058688,172.31.36.0-255,66,347901,8,358750
10532,0.058721,74.125.24.0-255,1484,349385,8,358750
10533,0.061041,74.125.24.0-255,4320,353705,8,358750
10534,0.061045,172.31.36.0-255,66,353771,8,358750
10535,0.063402,74.125.24.0-255,4742,358513,8,358750
10536,0.063407,172.31.36.0-255,66,358579,8,358750
10537,0.063596,172.31.36.0-255,105,358684,8,358750
10538,0.065948,74.125.24.0-255,66,358750,8,358750
10539,0.0,74.125.200.0-255,298,298,8,372279
10540,2.8e-05,172.31.36.0-255,66,364,8,372279
10541,3.4e-05,74.125.200.0-255,1484,1848,8,372279
10542,3.8e-05,172.31.36.0-255,66,1914,8,372279
10543,4.3e-05,74.125.200.0-255,2902,4816,8,372279
10544,4.6e-05,172.31.36.0-255,66,4882,8,372279
10545,5.2e-05,74.125.200.0-255,5738,10620,8,372279
10546,5.5e-05,172.31.36.0-255,66,10686,8,372279
10547,8.5e-05,74.125.200.0-255,3259,13945,8,372279
10548,8.7e-05,172.31.36.0-255,66,14011,8,372279
10549,0.00014,74.125.200.0-255,1484,15495,8,372279
10550,0.000143,172.31.36.0-255,66,15561,8,372279
10551,0.000147,74.125.200.0-255,1484,17045,8,372279
10552,0.000149,172.31.36.0-255,66,17111,8,372279
10553,0.000163,74.125.200.0-255,1484,18595,8,372279
10554,0.000165,172.31.36.0-255,66,18661,8,372279
10555,0.00017,74.125.200.0-255,2902,21563,8,372279
10556,0.000173,172.31.36.0-255,66,21629,8,372279
10557,0.000193,74.125.200.0-255,2902,24531,8,372279
10558,0.000195,172.31.36.0-255,66,24597,8,372279
10559,0.000202,74.125.200.0-255,6797,31394,8,372279
10560,0.000205,172.31.36.0-255,66,31460,8,372279
10561,0.000231,74.125.200.0-255,4320,35780,8,372279
10562,0.000234,172.31.36.0-255,66,35846,8,372279
10563,0.000239,74.125.200.0-255,4320,40166,8,372279
10564,0.000242,172.31.36.0-255,66,40232,8,372279
10565,0.000262,74.125.200.0-255,1484,41716,8,372279
10566,0.000264,172.31.36.0-255,66,41782,8,372279
10567,0.00027,74.125.200.0-255,4320,46102,8,372279
10568,0.000273,172.31.36.0-255,66,46168,8,372279
10569,0.000285,74.125.200.0-255,2543,48711,8,372279
10570,0.000287,172.31.36.0-255,66,48777,8,372279
10571,0.000326,74.125.200.0-255,1484,50261,8,372279
10572,0.000332,74.125.200.0-255,2902,53163,8,372279
10573,0.000335,172.31.36.0-255,66,53229,8,372279
10574,0.000357,74.125.200.0-255,4320,57549,8,372279
10575,0.00036,172.31.36.0-255,66,57615,8,372279
10576,0.000376,74.125.200.0-255,1484,59099,8,372279
10577,0.000384,74.125.200.0-255,5738,64837,8,372279
10578,0.000387,172.31.36.0-255,66,64903,8,372279
10579,0.000405,74.125.200.0-255,1125,66028,8,372279
10580,0.000848,74.125.200.0-255,646,66674,8,372279
10581,0.000854,172.31.36.0-255,66,66740,8,372279
10582,0.001924,74.125.200.0-255,1484,68224,8,372279
10583,0.001934,74.125.200.0-255,2902,71126,8,372279
10584,0.001939,172.31.36.0-255,66,71192,8,372279
10585,0.001958,74.125.200.0-255,5738,76930,8,372279
10586,0.00196,172.31.36.0-255,66,76996,8,372279
10587,0.001964,74.125.200.0-255,2902,79898,8,372279
10588,0.001966,172.31.36.0-255,66,79964,8,372279
10589,0.001984,74.125.200.0-255,1484,81448,8,372279
10590,0.001994,74.125.200.0-255,2902,84350,8,372279
10591,0.001996,172.31.36.0-255,66,84416,8,372279
10592,0.00203,74.125.200.0-255,2902,87318,8,372279
10593,0.002032,172.31.36.0-255,66,87384,8,372279
10594,0.002054,74.125.200.0-255,2902,90286,8,372279
10595,0.002056,172.31.36.0-255,66,90352,8,372279
10596,0.002063,74.125.200.0-255,7156,97508,8,372279
10597,0.002065,172.31.36.0-255,66,97574,8,372279
10598,0.002079,74.125.200.0-255,3602,101176,8,372279
10599,0.002081,172.31.36.0-255,66,101242,8,372279
10600,0.003051,74.125.200.0-255,1484,102726,8,372279
10601,0.003073,74.125.200.0-255,2902,105628,8,372279
10602,0.003076,172.31.36.0-255,66,105694,8,372279
10603,0.003079,74.125.200.0-255,1484,107178,8,372279
10604,0.003094,74.125.200.0-255,2902,110080,8,372279
10605,0.003096,172.31.36.0-255,66,110146,8,372279
10606,0.003108,74.125.200.0-255,1484,111630,8,372279
10607,0.003142,74.125.200.0-255,7156,118786,8,372279
10608,0.003144,172.31.36.0-255,66,118852,8,372279
10609,0.003154,172.31.36.0-255,66,118918,8,372279
10610,0.003175,74.125.200.0-255,1484,120402,8,372279
10611,0.003193,74.125.200.0-255,6438,126840,8,372279
10612,0.003195,172.31.36.0-255,66,126906,8,372279
10613,0.003254,74.125.200.0-255,1484,128390,8,372279
10614,0.003273,74.125.200.0-255,2902,131292,8,372279
10615,0.003276,172.31.36.0-255,66,131358,8,372279
10616,0.003278,74.125.200.0-255,1484,132842,8,372279
10617,0.003282,74.125.200.0-255,2902,135744,8,372279
10618,0.003284,172.31.36.0-255,66,135810,8,372279
10619,0.003294,74.125.200.0-255,1484,137294,8,372279
10620,0.003312,74.125.200.0-255,4320,141614,8,372279
10621,0.003314,172.31.36.0-255,66,141680,8,372279
10622,0.003363,74.125.200.0-255,7156,148836,8,372279
10623,0.003365,172.31.36.0-255,66,148902,8,372279
10624,0.003369,74.125.200.0-255,2902,151804,8,372279
10625,0.003371,172.31.36.0-255,66,151870,8,372279
10626,0.003391,74.125.200.0-255,5738,157608,8,372279
10627,0.003393,172.31.36.0-255,66,157674,8,372279
10628,0.003395,74.125.200.0-255,1484,159158,8,372279
10629,0.003426,74.125.200.0-255,2184,161342,8,372279
10630,0.003429,172.31.36.0-255,66,161408,8,372279
10631,0.004249,74.125.200.0-255,1484,162892,8,372279
10632,0.004257,74.125.200.0-255,2902,165794,8,372279
10633,0.004261,172.31.36.0-255,66,165860,8,372279
10634,0.004281,74.125.200.0-255,1484,167344,8,372279
10635,0.004295,74.125.200.0-255,4320,171664,8,372279
10636,0.004299,172.31.36.0-255,66,171730,8,372279
10637,0.004302,74.125.200.0-255,1484,173214,8,372279
10638,0.004318,74.125.200.0-255,4320,177534,8,372279
10639,0.004322,172.31.36.0-255,66,177600,8,372279
10640,0.004345,74.125.200.0-255,5738,183338,8,372279
10641,0.004348,172.31.36.0-255,66,183404,8,372279
10642,0.004354,74.125.200.0-255,4320,187724,8,372279
10643,0.004357,172.31.36.0-255,66,187790,8,372279
10644,0.004393,172.31.36.0-255,66,187856,8,372279
10645,0.004655,74.125.200.0-255,1484,189340,8,372279
10646,0.004674,74.125.200.0-255,2902,192242,8,372279
10647,0.004678,172.31.36.0-255,66,192308,8,372279
10648,0.004695,74.125.200.0-255,5738,198046,8,372279
10649,0.004699,172.31.36.0-255,66,198112,8,372279
10650,0.004702,74.125.200.0-255,1484,199596,8,372279
10651,0.004726,74.125.200.0-255,5738,205334,8,372279
10652,0.00473,172.31.36.0-255,66,205400,8,372279
10653,0.004737,74.125.200.0-255,7156,212556,8,372279
10654,0.00474,172.31.36.0-255,66,212622,8,372279
10655,0.004755,74.125.200.0-255,1484,214106,8,372279
10656,0.004782,172.31.36.0-255,66,214172,8,372279
10657,0.005091,74.125.200.0-255,1484,215656,8,372279
10658,0.005099,74.125.200.0-255,2902,218558,8,372279
10659,0.005103,172.31.36.0-255,66,218624,8,372279
10660,0.005107,74.125.200.0-255,1484,220108,8,372279
10661,0.005124,74.125.200.0-255,2902,223010,8,372279
10662,0.005127,172.31.36.0-255,66,223076,8,372279
10663,0.005146,74.125.200.0-255,4320,227396,8,372279
10664,0.00515,172.31.36.0-255,66,227462,8,372279
10665,0.005176,74.125.200.0-255,1484,228946,8,372279
10666,0.005182,74.125.200.0-255,5738,234684,8,372279
10667,0.005185,172.31.36.0-255,66,234750,8,372279
10668,0.005192,74.125.200.0-255,7156,241906,8,372279
10669,0.005194,172.31.36.0-255,66,241972,8,372279
10670,0.005215,74.125.200.0-255,5738,247710,8,372279
10671,0.005217,172.31.36.0-255,66,247776,8,372279
10672,0.005235,74.125.200.0-255,766,248542,8,372279
10673,0.005258,74.125.200.0-255,7156,255698,8,372279
10674,0.005262,172.31.36.0-255,66,255764,8,372279
10675,0.005267,74.125.200.0-255,4320,260084,8,372279
10676,0.005269,172.31.36.0-255,66,260150,8,372279
10677,0.005284,74.125.200.0-255,4320,264470,8,372279
10678,0.005287,172.31.36.0-255,66,264536,8,372279
10679,0.005304,74.125.200.0-255,1484,266020,8,372279
10680,0.005318,74.125.200.0-255,1484,267504,8,372279
10681,0.005321,172.31.36.0-255,66,267570,8,372279
10682,0.005346,74.125.200.0-255,7156,274726,8,372279
10683,0.00535,172.31.36.0-255,66,274792,8,372279
10684,0.00537,74.125.200.0-255,5738,280530,8,372279
10685,0.005374,172.31.36.0-255,66,280596,8,372279
10686,0.005393,74.125.200.0-255,2184,282780,8,372279
10687,0.005395,172.31.36.0-255,66,282846,8,372279
10688,0.005413,74.125.200.0-255,2902,285748,8,372279
10689,0.005416,172.31.36.0-255,66,285814,8,372279
10690,0.005438,74.125.200.0-255,2902,288716,8,372279
10691,0.005441,172.31.36.0-255,66,288782,8,372279
10692,0.005444,74.125.200.0-255,1484,290266,8,372279
10693,0.005462,74.125.200.0-255,5738,296004,8,372279
10694,0.005465,172.31.36.0-255,66,296070,8,372279
10695,0.005468,74.125.200.0-255,1484,297554,8,372279
10696,0.005503,172.31.36.0-255,66,297620,8,372279
10697,0.005526,172.31.36.0-255,66,297686,8,372279
10698,0.005572,74.125.200.0-255,1484,299170,8,372279
10699,0.005587,74.125.200.0-255,7156,306326,8,372279
10700,0.005591,172.31.36.0-255,66,306392,8,372279
10701,0.005609,74.125.200.0-255,7156,313548,8,372279
10702,0.005612,172.31.36.0-255,66,313614,8,372279
10703,0.005636,74.125.200.0-255,2902,316516,8,372279
10704,0.005638,172.31.36.0-255,66,316582,8,372279
10705,0.005641,74.125.200.0-255,1484,318066,8,372279
10706,0.005643,74.125.200.0-255,1484,319550,8,372279
10707,0.005645,172.31.36.0-255,66,319616,8,372279
10708,0.005648,74.125.200.0-255,1484,321100,8,372279
10709,0.005651,74.125.200.0-255,1484,322584,8,372279
10710,0.005653,172.31.36.0-255,66,322650,8,372279
10711,0.005658,74.125.200.0-255,4320,326970,8,372279
10712,0.005661,172.31.36.0-255,66,327036,8,372279
10713,0.005678,74.125.200.0-255,2902,329938,8,372279
10714,0.005682,172.31.36.0-255,66,330004,8,372279
10715,0.005686,74.125.200.0-255,1484,331488,8,372279
10716,0.005688,74.125.200.0-255,766,332254,8,372279
10717,0.00569,172.31.36.0-255,66,332320,8,372279
10718,0.005722,74.125.200.0-255,4320,336640,8,372279
10719,0.005725,172.31.36.0-255,66,336706,8,372279
10720,0.005728,74.125.200.0-255,1484,338190,8,372279
10721,0.005741,74.125.200.0-255,1484,339674,8,372279
10722,0.005743,172.31.36.0-255,66,339740,8,372279
10723,0.005749,74.125.200.0-255,4320,344060,8,372279
10724,0.005751,172.31.36.0-255,66,344126,8,372279
10725,0.005768,74.125.200.0-255,1484,345610,8,372279
10726,0.005795,74.125.200.0-255,7156,352766,8,372279
10727,0.005799,172.31.36.0-255,66,352832,8,372279
10728,0.005809,172.31.36.0-255,66,352898,8,372279
10729,0.005815,74.125.200.0-255,5020,357918,8,372279
10730,0.005818,172.31.36.0-255,66,357984,8,372279
10731,0.005839,74.125.200.0-255,5738,363722,8,372279
10732,0.005842,172.31.36.0-255,66,363788,8,372279
10733,0.005879,74.125.200.0-255,1616,365404,8,372279
10734,0.005883,172.31.36.0-255,66,365470,8,372279
10735,0.005938,74.125.200.0-255,105,365575,8,372279
10736,0.008239,172.31.36.0-255,66,365641,8,372279
10737,0.008266,172.31.36.0-255,105,365746,8,372279
10738,0.010763,74.125.200.0-255,66,365812,8,372279
10739,0.043195,172.31.36.0-255,172,365984,8,372279
10740,0.043223,172.31.36.0-255,1111,367095,8,372279
10741,0.043287,172.31.36.0-255,1514,368609,8,372279
10742,0.043289,172.31.36.0-255,1514,370123,8,372279
10743,0.043294,172.31.36.0-255,1514,371637,8,372279
10744,0.043295,172.31.36.0-255,378,372015,8,372279
10745,0.044795,104.244.42.0-255,66,372081,8,372279
10746,0.044806,104.244.42.0-255,66,372147,8,372279
10747,0.044863,104.244.42.0-255,66,372213,8,372279
10748,0.044869,104.244.42.0-255,66,372279,8,372279
10749,0.0,172.217.27.0-255,152,152,8,330666
10750,1.9e-05,172.31.36.0-255,66,218,8,330666
10751,2.6e-05,172.217.27.0-255,1484,1702,8,330666
10752,3e-05,172.31.36.0-255,66,1768,8,330666
10753,3.3e-05,172.217.27.0-255,1484,3252,8,330666
10754,4.6e-05,172.31.36.0-255,66,3318,8,330666
10755,6.8e-05,172.217.27.0-255,1484,4802,8,330666
10756,7.1e-05,172.31.36.0-255,66,4868,8,330666
10757,8.2e-05,172.217.27.0-255,5738,10606,8,330666
10758,8.5e-05,172.31.36.0-255,66,10672,8,330666
10759,0.000125,172.217.27.0-255,3384,14056,8,330666
10760,0.000129,172.31.36.0-255,66,14122,8,330666
10761,0.000156,172.217.27.0-255,1484,15606,8,330666
10762,0.000159,172.31.36.0-255,66,15672,8,330666
10763,0.000164,172.217.27.0-255,2902,18574,8,330666
10764,0.000166,172.31.36.0-255,66,18640,8,330666
10765,0.000196,172.217.27.0-255,5738,24378,8,330666
10766,0.000199,172.31.36.0-255,66,24444,8,330666
10767,0.000204,172.217.27.0-255,4320,28764,8,330666
10768,0.000206,172.31.36.0-255,66,28830,8,330666
10769,0.000264,172.217.27.0-255,5379,34209,8,330666
10770,0.000269,172.31.36.0-255,66,34275,8,330666
10771,0.000273,172.217.27.0-255,1484,35759,8,330666
10772,0.000275,172.31.36.0-255,66,35825,8,330666
10773,0.00031,172.217.27.0-255,4320,40145,8,330666
10774,0.000313,172.31.36.0-255,66,40211,8,330666
10775,0.000318,172.217.27.0-255,2902,43113,8,330666
10776,0.00032,172.31.36.0-255,66,43179,8,330666
10777,0.000331,172.217.27.0-255,4320,47499,8,330666
10778,0.000334,172.31.36.0-255,66,47565,8,330666
10779,0.000336,172.217.27.0-255,1125,48690,8,330666
10780,0.000338,172.31.36.0-255,66,48756,8,330666
10781,0.000364,172.217.27.0-255,1484,50240,8,330666
10782,0.00037,172.217.27.0-255,4320,54560,8,330666
10783,0.000377,172.31.36.0-255,66,54626,8,330666
10784,0.00041,172.31.36.0-255,66,54692,8,330666
10785,0.000438,172.217.27.0-255,1458,56150,8,330666
10786,0.000712,172.217.27.0-255,114,56264,8,330666
10787,0.000717,172.31.36.0-255,66,56330,8,330666
10788,0.000745,172.217.27.0-255,329,56659,8,330666
10789,0.001134,172.217.27.0-255,1484,58143,8,330666
10790,0.00114,172.31.36.0-255,66,58209,8,330666
10791,0.001146,172.217.27.0-255,2902,61111,8,330666
10792,0.001148,172.31.36.0-255,66,61177,8,330666
10793,0.001152,172.217.27.0-255,1484,62661,8,330666
10794,0.001162,172.217.27.0-255,2902,65563,8,330666
10795,0.001165,172.31.36.0-255,66,65629,8,330666
10796,0.00117,172.217.27.0-255,2902,68531,8,330666
10797,0.001172,172.31.36.0-255,66,68597,8,330666
10798,0.001208,172.217.27.0-255,2902,71499,8,330666
10799,0.001212,172.31.36.0-255,66,71565,8,330666
10800,0.001222,172.31.36.0-255,66,71631,8,330666
10801,0.001242,172.31.36.0-255,66,71697,8,330666
10802,0.001244,172.217.27.0-255,766,72463,8,330666
10803,0.001578,172.217.27.0-255,1484,73947,8,330666
10804,0.001583,172.31.36.0-255,66,74013,8,330666
10805,0.001589,172.217.27.0-255,2902,76915,8,330666
10806,0.00159,172.31.36.0-255,66,76981,8,330666
10807,0.001622,172.217.27.0-255,4320,81301,8,330666
10808,0.001625,172.31.36.0-255,66,81367,8,330666
10809,0.001629,172.217.27.0-255,2902,84269,8,330666
10810,0.00163,172.31.36.0-255,66,84335,8,330666
10811,0.001649,172.217.27.0-255,2902,87237,8,330666
10812,0.001651,172.31.36.0-255,66,87303,8,330666
10813,0.001703,172.217.27.0-255,5738,93041,8,330666
10814,0.001706,172.31.36.0-255,66,93107,8,330666
10815,0.001728,172.217.27.0-255,1484,94591,8,330666
10816,0.003376,172.217.27.0-255,4320,98911,8,330666
10817,0.003381,172.31.36.0-255,66,98977,8,330666
10818,0.005065,172.217.27.0-255,5738,104715,8,330666
10819,0.00507,172.31.36.0-255,66,104781,8,330666
10820,0.006762,172.217.27.0-255,5738,110519,8,330666
10821,0.006769,172.31.36.0-255,66,110585,8,330666
10822,0.008446,172.217.27.0-255,5738,116323,8,330666
10823,0.008457,172.31.36.0-255,66,116389,8,330666
10824,0.010275,172.217.27.0-255,5738,122127,8,330666
10825,0.010337,172.31.36.0-255,66,122193,8,330666
10826,0.012025,172.217.27.0-255,5738,127931,8,330666
10827,0.012031,172.31.36.0-255,66,127997,8,330666
10828,0.01372,172.217.27.0-255,5738,133735,8,330666
10829,0.013727,172.31.36.0-255,66,133801,8,330666
10830,0.015409,172.217.27.0-255,5738,139539,8,330666
10831,0.015417,172.31.36.0-255,66,139605,8,330666
10832,0.017092,172.217.27.0-255,5738,145343,8,330666
10833,0.0171,172.31.36.0-255,66,145409,8,330666
10834,0.01878,172.217.27.0-255,5738,151147,8,330666
10835,0.018787,172.31.36.0-255,66,151213,8,330666
10836,0.020468,172.217.27.0-255,5738,156951,8,330666
10837,0.020474,172.31.36.0-255,66,157017,8,330666
10838,0.022149,172.217.27.0-255,5738,162755,8,330666
10839,0.022155,172.31.36.0-255,66,162821,8,330666
10840,0.023845,172.217.27.0-255,5738,168559,8,330666
10841,0.02385,172.31.36.0-255,66,168625,8,330666
10842,0.025529,172.217.27.0-255,4320,172945,8,330666
10843,0.025535,172.31.36.0-255,66,173011,8,330666
10844,0.025561,172.217.27.0-255,1484,174495,8,330666
10845,0.027222,172.217.27.0-255,4320,178815,8,330666
10846,0.027229,172.31.36.0-255,66,178881,8,330666
10847,0.02891,172.217.27.0-255,5738,184619,8,330666
10848,0.028917,172.31.36.0-255,66,184685,8,330666
10849,0.030589,172.217.27.0-255,5738,190423,8,330666
10850,0.030596,172.31.36.0-255,66,190489,8,330666
10851,0.032271,172.217.27.0-255,5738,196227,8,330666
10852,0.032278,172.31.36.0-255,66,196293,8,330666
10853,0.033078,172.31.36.0-255,188,196481,8,330666
10854,0.033109,172.31.36.0-255,955,197436,8,330666
10855,0.033143,172.31.36.0-255,1514,198950,8,330666
10856,0.033145,172.31.36.0-255,1514,200464,8,330666
10857,0.033149,172.31.36.0-255,1514,201978,8,330666
10858,0.03315,172.31.36.0-255,1514,203492,8,330666
10859,0.033173,172.31.36.0-255,574,204066,8,330666
10860,0.033961,172.217.27.0-255,5738,209804,8,330666
10861,0.033967,172.31.36.0-255,66,209870,8,330666
10862,0.034665,104.244.42.0-255,66,209936,8,330666
10863,0.034673,104.244.42.0-255,66,210002,8,330666
10864,0.034705,104.244.42.0-255,66,210068,8,330666
10865,0.03471,104.244.42.0-255,66,210134,8,330666
10866,0.035648,172.217.27.0-255,5738,215872,8,330666
10867,0.035653,172.31.36.0-255,66,215938,8,330666
10868,0.03733,172.217.27.0-255,5738,221676,8,330666
10869,0.037335,172.31.36.0-255,66,221742,8,330666
10870,0.039025,172.217.27.0-255,5738,227480,8,330666
10871,0.039031,172.31.36.0-255,66,227546,8,330666
10872,0.040708,172.217.27.0-255,5738,233284,8,330666
10873,0.040713,172.31.36.0-255,66,233350,8,330666
10874,0.042393,172.217.27.0-255,5738,239088,8,330666
10875,0.042398,172.31.36.0-255,66,239154,8,330666
10876,0.04408,172.217.27.0-255,5738,244892,8,330666
10877,0.04409,172.31.36.0-255,66,244958,8,330666
10878,0.045761,172.217.27.0-255,5738,250696,8,330666
10879,0.045767,172.31.36.0-255,66,250762,8,330666
10880,0.047438,172.217.27.0-255,5738,256500,8,330666
10881,0.047444,172.31.36.0-255,66,256566,8,330666
10882,0.049147,172.217.27.0-255,5738,262304,8,330666
10883,0.049152,172.31.36.0-255,66,262370,8,330666
10884,0.050863,172.217.27.0-255,5738,268108,8,330666
10885,0.050868,172.31.36.0-255,66,268174,8,330666
10886,0.05254,172.217.27.0-255,4320,272494,8,330666
10887,0.052546,172.31.36.0-255,66,272560,8,330666
10888,0.052576,172.217.27.0-255,1484,274044,8,330666
10889,0.054236,172.217.27.0-255,4320,278364,8,330666
10890,0.054242,172.31.36.0-255,66,278430,8,330666
10891,0.055917,172.217.27.0-255,5738,284168,8,330666
10892,0.055924,172.31.36.0-255,66,284234,8,330666
10893,0.057629,172.217.27.0-255,5738,289972,8,330666
10894,0.057635,172.31.36.0-255,66,290038,8,330666
10895,0.059317,172.217.27.0-255,5738,295776,8,330666
10896,0.059324,172.31.36.0-255,66,295842,8,330666
10897,0.061009,172.217.27.0-255,5738,301580,8,330666
10898,0.061015,172.31.36.0-255,66,301646,8,330666
10899,0.062692,172.217.27.0-255,5738,307384,8,330666
10900,0.062699,172.31.36.0-255,66,307450,8,330666
10901,0.064377,172.217.27.0-255,5738,313188,8,330666
10902,0.064384,172.31.36.0-255,66,313254,8,330666
10903,0.06605,172.217.27.0-255,5738,318992,8,330666
10904,0.066056,172.31.36.0-255,66,319058,8,330666
10905,0.067729,172.217.27.0-255,5738,324796,8,330666
10906,0.067733,172.31.36.0-255,66,324862,8,330666
10907,0.069403,172.217.27.0-255,5738,330600,8,330666
10908,0.069408,172.31.36.0-255,66,330666,8,330666
10909,0.0,172.217.24.0-255,153,153,8,302853
10910,3.1e-05,172.31.36.0-255,66,219,8,302853
10911,3.9e-05,172.217.24.0-255,1484,1703,8,302853
10912,4.4e-05,172.31.36.0-255,66,1769,8,302853
10913,4.8e-05,172.217.24.0-255,2902,4671,8,302853
10914,5e-05,172.31.36.0-255,66,4737,8,302853
10915,5.5e-05,172.217.24.0-255,4320,9057,8,302853
10916,5.8e-05,172.31.36.0-255,66,9123,8,302853
10917,9.2e-05,172.217.24.0-255,2902,12025,8,302853
10918,9.4e-05,172.31.36.0-255,66,12091,8,302853
10919,9.8e-05,172.31.36.0-255,66,12157,8,302853
10920,0.00012,172.31.36.0-255,66,12223,8,302853
10921,0.000132,172.217.24.0-255,1125,13348,8,302853
10922,0.000134,172.31.36.0-255,66,13414,8,302853
10923,0.000203,172.217.24.0-255,1484,14898,8,302853
10924,0.000206,172.31.36.0-255,66,14964,8,302853
10925,0.00021,172.217.24.0-255,1484,16448,8,302853
10926,0.000212,172.31.36.0-255,66,16514,8,302853
10927,0.000226,172.217.24.0-255,1484,17998,8,302853
10928,0.000228,172.31.36.0-255,66,18064,8,302853
10929,0.000235,172.217.24.0-255,5738,23802,8,302853
10930,0.000237,172.31.36.0-255,66,23868,8,302853
10931,0.000245,172.217.24.0-255,6797,30665,8,302853
10932,0.000248,172.31.36.0-255,66,30731,8,302853
10933,0.000254,172.217.24.0-255,4320,35051,8,302853
10934,0.000257,172.31.36.0-255,66,35117,8,302853
10935,0.000271,172.217.24.0-255,2902,38019,8,302853
10936,0.000274,172.31.36.0-255,66,38085,8,302853
10937,0.00029,172.217.24.0-255,2902,40987,8,302853
10938,0.000293,172.31.36.0-255,66,41053,8,302853
10939,0.000312,172.217.24.0-255,6797,47850,8,302853
10940,0.000315,172.31.36.0-255,66,47916,8,302853
10941,0.000735,172.217.24.0-255,394,48310,8,302853
10942,0.000784,172.31.36.0-255,66,48376,8,302853
10943,0.001383,172.217.24.0-255,349,48725,8,302853
10944,0.001421,172.31.36.0-255,66,48791,8,302853
10945,0.001484,172.217.24.0-255,1484,50275,8,302853
10946,0.00149,172.217.24.0-255,2902,53177,8,302853
10947,0.001492,172.31.36.0-255,66,53243,8,302853
10948,0.001507,172.217.24.0-255,1484,54727,8,302853
10949,0.001529,172.217.24.0-255,2902,57629,8,302853
10950,0.001532,172.31.36.0-255,66,57695,8,302853
10951,0.001535,172.217.24.0-255,1484,59179,8,302853
10952,0.001547,172.217.24.0-255,2902,62081,8,302853
10953,0.001549,172.31.36.0-255,66,62147,8,302853
10954,0.001563,172.217.24.0-255,1484,63631,8,302853
10955,0.001567,172.217.24.0-255,2543,66174,8,302853
10956,0.001569,172.31.36.0-255,66,66240,8,302853
10957,0.001582,172.217.24.0-255,2902,69142,8,302853
10958,0.001584,172.31.36.0-255,66,69208,8,302853
10959,0.001606,172.217.24.0-255,2902,72110,8,302853
10960,0.001609,172.31.36.0-255,66,72176,8,302853
10961,0.001631,172.217.24.0-255,4320,76496,8,302853
10962,0.001633,172.31.36.0-255,66,76562,8,302853
10963,0.001638,172.217.24.0-255,4320,80882,8,302853
10964,0.00164,172.31.36.0-255,66,80948,8,302853
10965,0.001651,172.217.24.0-255,2543,83491,8,302853
10966,0.001653,172.31.36.0-255,66,83557,8,302853
10967,0.002292,172.217.24.0-255,1484,85041,8,302853
10968,0.0023,172.217.24.0-255,2902,87943,8,302853
10969,0.002303,172.31.36.0-255,66,88009,8,302853
10970,0.002324,172.217.24.0-255,2902,90911,8,302853
10971,0.002326,172.31.36.0-255,66,90977,8,302853
10972,0.002332,172.217.24.0-255,4320,95297,8,302853
10973,0.002333,172.31.36.0-255,66,95363,8,302853
10974,0.002341,172.217.24.0-255,7156,102519,8,302853
10975,0.002343,172.31.36.0-255,66,102585,8,302853
10976,0.002366,172.217.24.0-255,1484,104069,8,302853
10977,0.002372,172.217.24.0-255,5738,109807,8,302853
10978,0.002374,172.31.36.0-255,66,109873,8,302853
10979,0.002397,172.31.36.0-255,66,109939,8,302853
10980,0.002417,172.217.24.0-255,4320,114259,8,302853
10981,0.00242,172.31.36.0-255,66,114325,8,302853
10982,0.002426,172.217.24.0-255,5738,120063,8,302853
10983,0.002428,172.31.36.0-255,66,120129,8,302853
10984,0.002463,172.31.36.0-255,66,120195,8,302853
10985,0.002468,172.217.24.0-255,4320,124515,8,302853
10986,0.00247,172.31.36.0-255,66,124581,8,302853
10987,0.00249,172.31.36.0-255,66,124647,8,302853
10988,0.002589,172.217.24.0-255,1484,126131,8,302853
10989,0.002595,172.217.24.0-255,2902,129033,8,302853
10990,0.002599,172.31.36.0-255,66,129099,8,302853
10991,0.002602,172.217.24.0-255,1484,130583,8,302853
10992,0.00262,172.217.24.0-255,4320,134903,8,302853
10993,0.002623,172.31.36.0-255,66,134969,8,302853
10994,0.002632,172.31.36.0-255,66,135035,8,302853
10995,0.002641,172.31.36.0-255,66,135101,8,302853
10996,0.002657,172.217.24.0-255,1484,136585,8,302853
10997,0.002672,172.217.24.0-255,2902,139487,8,302853
10998,0.002674,172.31.36.0-255,66,139553,8,302853
10999,0.002688,172.217.24.0-255,2184,141737,8,302853
11000,0.002691,172.31.36.0-255,66,141803,8,302853
11001,0.002783,172.217.24.0-255,1484,143287,8,302853
11002,0.002786,172.217.24.0-255,1484,144771,8,302853
11003,0.002789,172.31.36.0-255,66,144837,8,302853
11004,0.002807,172.217.24.0-255,1484,146321,8,302853
11005,0.002813,172.217.24.0-255,5738,152059,8,302853
11006,0.002815,172.31.36.0-255,66,152125,8,302853
11007,0.002819,172.217.24.0-255,2902,155027,8,302853
11008,0.002821,172.31.36.0-255,66,155093,8,302853
11009,0.00284,172.217.24.0-255,7156,162249,8,302853
11010,0.002843,172.31.36.0-255,66,162315,8,302853
11011,0.002868,172.31.36.0-255,66,162381,8,302853
11012,0.002872,172.217.24.0-255,1484,163865,8,302853
11013,0.002875,172.217.24.0-255,2184,166049,8,302853
11014,0.002886,172.31.36.0-255,66,166115,8,302853
11015,0.003158,172.217.24.0-255,1484,167599,8,302853
11016,0.003163,172.217.24.0-255,2902,170501,8,302853
11017,0.003166,172.31.36.0-255,66,170567,8,302853
11018,0.00317,172.217.24.0-255,1484,172051,8,302853
11019,0.003187,172.217.24.0-255,4320,176371,8,302853
11020,0.003189,172.31.36.0-255,66,176437,8,302853
11021,0.00321,172.217.24.0-255,5738,182175,8,302853
11022,0.003229,172.217.24.0-255,1484,183659,8,302853
11023,0.003244,172.217.24.0-255,2184,185843,8,302853
11024,0.00326,172.31.36.0-255,66,185909,8,302853
11025,0.003443,172.217.24.0-255,1484,187393,8,302853
11026,0.00345,172.217.24.0-255,2902,190295,8,302853
11027,0.003453,172.31.36.0-255,66,190361,8,302853
11028,0.003457,172.217.24.0-255,1484,191845,8,302853
11029,0.003475,172.217.24.0-255,2902,194747,8,302853
11030,0.003494,172.217.24.0-255,1484,196231,8,302853
11031,0.003497,172.217.24.0-255,1484,197715,8,302853
11032,0.0035,172.217.24.0-255,1484,199199,8,302853
11033,0.00352,172.217.24.0-255,1484,200683,8,302853
11034,0.003528,172.31.36.0-255,66,200749,8,302853
11035,0.003551,172.217.24.0-255,7156,207905,8,302853
11036,0.003554,172.31.36.0-255,66,207971,8,302853
11037,0.003558,172.217.24.0-255,1484,209455,8,302853
11038,0.003561,172.217.24.0-255,1484,210939,8,302853
11039,0.003563,172.217.24.0-255,1484,212423,8,302853
11040,0.003565,172.217.24.0-255,1484,213907,8,302853
11041,0.003567,172.217.24.0-255,1484,215391,8,302853
11042,0.003582,172.217.24.0-255,2902,218293,8,302853
11043,0.003596,172.31.36.0-255,66,218359,8,302853
11044,0.00364,172.217.24.0-255,2184,220543,8,302853
11045,0.003647,172.31.36.0-255,66,220609,8,302853
11046,0.003711,172.217.24.0-255,1484,222093,8,302853
11047,0.003716,172.217.24.0-255,2902,224995,8,302853
11048,0.00372,172.31.36.0-255,66,225061,8,302853
11049,0.003743,172.217.24.0-255,5738,230799,8,302853
11050,0.003747,172.217.24.0-255,2902,233701,8,302853
11051,0.003765,172.217.24.0-255,4320,238021,8,302853
11052,0.003771,172.217.24.0-255,7156,245177,8,302853
11053,0.003774,172.31.36.0-255,66,245243,8,302853
11054,0.00378,172.31.36.0-255,66,245309,8,302853
11055,0.0038,172.217.24.0-255,7156,252465,8,302853
11056,0.003807,172.217.24.0-255,6438,258903,8,302853
11057,0.003813,172.217.24.0-255,7156,266059,8,302853
11058,0.003848,172.217.24.0-255,2902,268961,8,302853
11059,0.003874,172.217.24.0-255,6438,275399,8,302853
11060,0.00388,172.217.24.0-255,7156,282555,8,302853
11061,0.003897,172.217.24.0-255,5738,288293,8,302853
11062,0.003903,172.31.36.0-255,66,288359,8,302853
11063,0.003922,172.217.24.0-255,5020,293379,8,302853
11064,0.003942,172.31.36.0-255,66,293445,8,302853
11065,0.00396,172.217.24.0-255,2073,295518,8,302853
11066,0.003962,172.31.36.0-255,66,295584,8,302853
11067,0.003987,172.31.36.0-255,66,295650,8,302853
11068,0.004011,172.217.24.0-255,105,295755,8,302853
11069,0.005504,172.31.36.0-255,66,295821,8,302853
11070,0.005538,172.31.36.0-255,105,295926,8,302853
11071,0.007428,172.217.24.0-255,66,295992,8,302853
11072,0.032522,172.31.36.0-255,172,296164,8,302853
11073,0.032571,172.31.36.0-255,1112,297276,8,302853
11074,0.03265,172.31.36.0-255,1514,298790,8,302853
11075,0.032653,172.31.36.0-255,1514,300304,8,302853
11076,0.032657,172.31.36.0-255,1514,301818,8,302853
11077,0.032658,172.31.36.0-255,771,302589,8,302853
11078,0.034044,104.244.42.0-255,66,302655,8,302853
11079,0.034113,104.244.42.0-255,66,302721,8,302853
11080,0.03423,104.244.42.0-255,66,302787,8,302853
11081,0.034233,104.244.42.0-255,66,302853,8,302853
11082,0.0,172.217.194.0-255,153,153,8,98801
11083,1.6e-05,172.31.36.0-255,66,219,8,98801
11084,5.2e-05,172.217.194.0-255,1484,1703,8,98801
11085,5.8e-05,172.31.36.0-255,66,1769,8,98801
11086,6.3e-05,172.217.194.0-255,2902,4671,8,98801
11087,6.6e-05,172.31.36.0-255,66,4737,8,98801
11088,7.3e-05,172.217.194.0-255,5738,10475,8,98801
11089,7.6e-05,172.31.36.0-255,66,10541,8,98801
11090,0.000109,172.31.36.0-255,66,10607,8,98801
11091,0.000141,172.217.194.0-255,3466,14073,8,98801
11092,0.000144,172.31.36.0-255,66,14139,8,98801
11093,0.000151,172.217.194.0-255,6797,20936,8,98801
11094,0.000153,172.31.36.0-255,66,21002,8,98801
11095,0.00026,172.217.194.0-255,1484,22486,8,98801
11096,0.000265,172.31.36.0-255,66,22552,8,98801
11097,0.000296,172.217.194.0-255,2902,25454,8,98801
11098,0.000299,172.31.36.0-255,66,25520,8,98801
11099,0.000366,172.217.194.0-255,4320,29840,8,98801
11100,0.00037,172.31.36.0-255,66,29906,8,98801
11101,0.000373,172.217.194.0-255,1484,31390,8,98801
11102,0.000375,172.31.36.0-255,66,31456,8,98801
11103,0.000401,172.217.194.0-255,4320,35776,8,98801
11104,0.000405,172.31.36.0-255,66,35842,8,98801
11105,0.00041,172.217.194.0-255,2543,38385,8,98801
11106,0.000412,172.31.36.0-255,66,38451,8,98801
11107,0.000438,172.217.194.0-255,2902,41353,8,98801
11108,0.000442,172.31.36.0-255,66,41419,8,98801
11109,0.000488,172.217.194.0-255,1484,42903,8,98801
11110,0.000491,172.31.36.0-255,66,42969,8,98801
11111,0.000518,172.217.194.0-255,4320,47289,8,98801
11112,0.000523,172.31.36.0-255,66,47355,8,98801
11113,0.000529,172.217.194.0-255,5738,53093,8,98801
11114,0.000531,172.31.36.0-255,66,53159,8,98801
11115,0.000575,172.217.194.0-255,2796,55955,8,98801
11116,0.000578,172.31.36.0-255,66,56021,8,98801
11117,0.001277,172.217.194.0-255,112,56133,8,98801
11118,0.001682,172.217.194.0-255,1484,57617,8,98801
11119,0.001689,172.31.36.0-255,66,57683,8,98801
11120,0.001696,172.217.194.0-255,2902,60585,8,98801
11121,0.001698,172.31.36.0-255,66,60651,8,98801
11122,0.00171,172.217.194.0-255,5738,66389,8,98801
11123,0.001712,172.31.36.0-255,66,66455,8,98801
11124,0.001723,172.31.36.0-255,66,66521,8,98801
11125,0.001755,172.217.194.0-255,4320,70841,8,98801
11126,0.001759,172.31.36.0-255,66,70907,8,98801
11127,0.00177,172.31.36.0-255,66,70973,8,98801
11128,0.001796,172.217.194.0-255,1484,72457,8,98801
11129,0.001802,172.217.194.0-255,2902,75359,8,98801
11130,0.001804,172.31.36.0-255,66,75425,8,98801
11131,0.00181,172.217.194.0-255,5738,81163,8,98801
11132,0.001813,172.31.36.0-255,66,81229,8,98801
11133,0.001863,172.31.36.0-255,66,81295,8,98801
11134,0.001875,172.31.36.0-255,66,81361,8,98801
11135,0.001906,172.217.194.0-255,2902,84263,8,98801
11136,0.00191,172.31.36.0-255,66,84329,8,98801
11137,0.001964,172.31.36.0-255,66,84395,8,98801
11138,0.001976,172.31.36.0-255,66,84461,8,98801
11139,0.002016,172.31.36.0-255,66,84527,8,98801
11140,0.002026,172.31.36.0-255,66,84593,8,98801
11141,0.002073,172.31.36.0-255,66,84659,8,98801
11142,0.002076,172.217.194.0-255,1484,86143,8,98801
11143,0.002092,172.31.36.0-255,66,86209,8,98801
11144,0.002147,172.31.36.0-255,66,86275,8,98801
11145,0.002174,172.31.36.0-255,66,86341,8,98801
11146,0.002185,172.31.36.0-255,66,86407,8,98801
11147,0.002227,172.217.194.0-255,5738,92145,8,98801
11148,0.00223,172.31.36.0-255,66,92211,8,98801
11149,0.002289,172.31.36.0-255,66,92277,8,98801
11150,0.002311,172.31.36.0-255,66,92343,8,98801
11151,0.002332,172.31.36.0-255,66,92409,8,98801
11152,0.002369,172.217.194.0-255,2184,94593,8,98801
11153,0.002373,172.31.36.0-255,66,94659,8,98801
11154,0.002376,172.217.194.0-255,1484,96143,8,98801
11155,0.002395,172.31.36.0-255,66,96209,8,98801
11156,0.002412,172.31.36.0-255,66,96275,8,98801
11157,0.002422,172.31.36.0-255,66,96341,8,98801
11158,0.002463,172.31.36.0-255,66,96407,8,98801
11159,0.002489,172.217.194.0-255,105,96512,8,98801
11160,0.010941,172.31.36.0-255,66,96578,8,98801
11161,0.010995,172.31.36.0-255,105,96683,8,98801
11162,0.01359,172.217.194.0-255,66,96749,8,98801
11163,0.032123,172.31.36.0-255,172,96921,8,98801
11164,0.032157,172.31.36.0-255,1110,98031,8,98801
11165,0.03222,172.31.36.0-255,572,98603,8,98801
11166,0.033665,104.244.42.0-255,66,98669,8,98801
11167,0.033697,104.244.42.0-255,66,98735,8,98801
11168,0.033746,104.244.42.0-255,66,98801,8,98801
11169,0.0,172.217.194.0-255,153,153,8,230834
11170,3.3e-05,172.31.36.0-255,66,219,8,230834
11171,4.1e-05,172.217.194.0-255,1484,1703,8,230834
11172,4.6e-05,172.31.36.0-255,66,1769,8,230834
11173,5.1e-05,172.217.194.0-255,2902,4671,8,230834
11174,6.1e-05,172.31.36.0-255,66,4737,8,230834
11175,6.9e-05,172.217.194.0-255,7156,11893,8,230834
11176,7.2e-05,172.31.36.0-255,66,11959,8,230834
11177,7.5e-05,172.217.194.0-255,2048,14007,8,230834
11178,7.8e-05,172.31.36.0-255,66,14073,8,230834
11179,0.000319,172.217.194.0-255,1484,15557,8,230834
11180,0.000325,172.31.36.0-255,66,15623,8,230834
11181,0.000331,172.217.194.0-255,2902,18525,8,230834
11182,0.000334,172.31.36.0-255,66,18591,8,230834
11183,0.000347,172.217.194.0-255,5738,24329,8,230834
11184,0.00035,172.31.36.0-255,66,24395,8,230834
11185,0.000389,172.217.194.0-255,6797,31192,8,230834
11186,0.000394,172.31.36.0-255,66,31258,8,230834
11187,0.000418,172.217.194.0-255,1484,32742,8,230834
11188,0.000422,172.31.36.0-255,66,32808,8,230834
11189,0.000454,172.217.194.0-255,2902,35710,8,230834
11190,0.000458,172.31.36.0-255,66,35776,8,230834
11191,0.000466,172.217.194.0-255,5738,41514,8,230834
11192,0.000468,172.31.36.0-255,66,41580,8,230834
11193,0.000506,172.217.194.0-255,6797,48377,8,230834
11194,0.00051,172.31.36.0-255,66,48443,8,230834
11195,0.000536,172.217.194.0-255,2902,51345,8,230834
11196,0.00054,172.31.36.0-255,66,51411,8,230834
11197,0.000545,172.217.194.0-255,4320,55731,8,230834
11198,0.000547,172.31.36.0-255,66,55797,8,230834
11199,0.000566,172.217.194.0-255,4320,60117,8,230834
11200,0.00057,172.31.36.0-255,66,60183,8,230834
11201,0.000607,172.217.194.0-255,4320,64503,8,230834
11202,0.000611,172.31.36.0-255,66,64569,8,230834
11203,0.000614,172.217.194.0-255,1440,66009,8,230834
11204,0.000717,172.217.194.0-255,363,66372,8,230834
11205,0.000723,172.31.36.0-255,66,66438,8,230834
11206,0.000878,172.217.194.0-255,1484,67922,8,230834
11207,0.000885,172.217.194.0-255,2902,70824,8,230834
11208,0.000889,172.31.36.0-255,66,70890,8,230834
11209,0.000896,172.217.194.0-255,5738,76628,8,230834
11210,0.0009,172.31.36.0-255,66,76694,8,230834
11211,0.000951,172.31.36.0-255,66,76760,8,230834
11212,0.000963,172.31.36.0-255,66,76826,8,230834
11213,0.000972,172.217.194.0-255,766,77592,8,230834
11214,0.001215,172.217.194.0-255,1484,79076,8,230834
11215,0.001222,172.31.36.0-255,66,79142,8,230834
11216,0.001229,172.217.194.0-255,2902,82044,8,230834
11217,0.001231,172.31.36.0-255,66,82110,8,230834
11218,0.001243,172.217.194.0-255,5738,87848,8,230834
11219,0.001247,172.31.36.0-255,66,87914,8,230834
11220,0.001251,172.217.194.0-255,2902,90816,8,230834
11221,0.001254,172.31.36.0-255,66,90882,8,230834
11222,0.001292,172.217.194.0-255,7156,98038,8,230834
11223,0.001295,172.31.36.0-255,66,98104,8,230834
11224,0.001307,172.31.36.0-255,66,98170,8,230834
11225,0.001336,172.217.194.0-255,3602,101772,8,230834
11226,0.00134,172.31.36.0-255,66,101838,8,230834
11227,0.002325,172.217.194.0-255,1484,103322,8,230834
11228,0.002336,172.217.194.0-255,2902,106224,8,230834
11229,0.00234,172.31.36.0-255,66,106290,8,230834
11230,0.002345,172.217.194.0-255,1484,107774,8,230834
11231,0.002377,172.217.194.0-255,4320,112094,8,230834
11232,0.00238,172.31.36.0-255,66,112160,8,230834
11233,0.002383,172.217.194.0-255,1484,113644,8,230834
11234,0.002398,172.31.36.0-255,66,113710,8,230834
11235,0.002403,172.217.194.0-255,4320,118030,8,230834
11236,0.002405,172.31.36.0-255,66,118096,8,230834
11237,0.002449,172.31.36.0-255,66,118162,8,230834
11238,0.002747,172.217.194.0-255,1484,119646,8,230834
11239,0.002751,172.217.194.0-255,1484,121130,8,230834
11240,0.002755,172.31.36.0-255,66,121196,8,230834
11241,0.00278,172.217.194.0-255,1484,122680,8,230834
11242,0.002788,172.217.194.0-255,5738,128418,8,230834
11243,0.00279,172.31.36.0-255,66,128484,8,230834
11244,0.002797,172.217.194.0-255,7156,135640,8,230834
11245,0.002799,172.31.36.0-255,66,135706,8,230834
11246,0.002802,172.217.194.0-255,1484,137190,8,230834
11247,0.002843,172.31.36.0-255,66,137256,8,230834
11248,0.002848,172.217.194.0-255,5020,142276,8,230834
11249,0.00285,172.31.36.0-255,66,142342,8,230834
11250,0.002853,172.217.194.0-255,1484,143826,8,230834
11251,0.002861,172.217.194.0-255,1484,145310,8,230834
11252,0.002863,172.31.36.0-255,66,145376,8,230834
11253,0.002866,172.217.194.0-255,1484,146860,8,230834
11254,0.002906,172.31.36.0-255,66,146926,8,230834
11255,0.002928,172.217.194.0-255,7156,154082,8,230834
11256,0.002931,172.31.36.0-255,66,154148,8,230834
11257,0.002962,172.217.194.0-255,1484,155632,8,230834
11258,0.002965,172.217.194.0-255,1484,157116,8,230834
11259,0.002967,172.31.36.0-255,66,157182,8,230834
11260,0.002979,172.31.36.0-255,66,157248,8,230834
11261,0.003399,172.217.194.0-255,1484,158732,8,230834
11262,0.003404,172.217.194.0-255,1484,160216,8,230834
11263,0.003407,172.31.36.0-255,66,160282,8,230834
11264,0.003425,172.217.194.0-255,1484,161766,8,230834
11265,0.003432,172.217.194.0-255,5738,167504,8,230834
11266,0.003434,172.31.36.0-255,66,167570,8,230834
11267,0.003473,172.217.194.0-255,7156,174726,8,230834
11268,0.003476,172.31.36.0-255,66,174792,8,230834
11269,0.003532,172.31.36.0-255,66,174858,8,230834
11270,0.003557,172.217.194.0-255,1484,176342,8,230834
11271,0.003562,172.217.194.0-255,2184,178526,8,230834
11272,0.003564,172.31.36.0-255,66,178592,8,230834
11273,0.003568,172.217.194.0-255,2902,181494,8,230834
11274,0.00357,172.31.36.0-255,66,181560,8,230834
11275,0.003583,172.217.194.0-255,7156,188716,8,230834
11276,0.003586,172.31.36.0-255,66,188782,8,230834
11277,0.003598,172.31.36.0-255,66,188848,8,230834
11278,0.003601,172.217.194.0-255,1484,190332,8,230834
11279,0.003615,172.31.36.0-255,66,190398,8,230834
11280,0.003627,172.31.36.0-255,66,190464,8,230834
11281,0.003653,172.217.194.0-255,5738,196202,8,230834
11282,0.003656,172.31.36.0-255,66,196268,8,230834
11283,0.003667,172.31.36.0-255,66,196334,8,230834
11284,0.003675,172.217.194.0-255,1484,197818,8,230834
11285,0.003678,172.217.194.0-255,1484,199302,8,230834
11286,0.00368,172.31.36.0-255,66,199368,8,230834
11287,0.003686,172.217.194.0-255,5020,204388,8,230834
11288,0.003688,172.31.36.0-255,66,204454,8,230834
11289,0.003691,172.217.194.0-255,1484,205938,8,230834
11290,0.003721,172.217.194.0-255,4320,210258,8,230834
11291,0.003724,172.31.36.0-255,66,210324,8,230834
11292,0.003735,172.31.36.0-255,66,210390,8,230834
11293,0.003757,172.31.36.0-255,66,210456,8,230834
11294,0.003759,172.217.194.0-255,766,211222,8,230834
11295,0.003865,172.217.194.0-255,1484,212706,8,230834
11296,0.003868,172.31.36.0-255,66,212772,8,230834
11297,0.003872,172.217.194.0-255,1484,214256,8,230834
11298,0.003896,172.217.194.0-255,1484,215740,8,230834
11299,0.003898,172.31.36.0-255,66,215806,8,230834
11300,0.003905,172.217.194.0-255,5738,221544,8,230834
11301,0.003908,172.31.36.0-255,66,221610,8,230834
11302,0.003926,172.31.36.0-255,66,221676,8,230834
11303,0.003931,172.217.194.0-255,4320,225996,8,230834
11304,0.003933,172.31.36.0-255,66,226062,8,230834
11305,0.003972,172.31.36.0-255,66,226128,8,230834
11306,0.003975,172.217.194.0-255,105,226233,8,230834
11307,0.007028,172.31.36.0-255,66,226299,8,230834
11308,0.007073,172.31.36.0-255,105,226404,8,230834
11309,0.009358,172.217.194.0-255,66,226470,8,230834
11310,0.038336,172.31.36.0-255,172,226642,8,230834
11311,0.038384,172.31.36.0-255,1109,227751,8,230834
11312,0.038459,172.31.36.0-255,1514,229265,8,230834
11313,0.038461,172.31.36.0-255,1371,230636,8,230834
11314,0.039887,104.244.42.0-255,66,230702,8,230834
11315,0.039937,104.244.42.0-255,66,230768,8,230834
11316,0.04001,104.244.42.0-255,66,230834,8,230834
11317,0.0,74.125.24.0-255,153,153,8,153957
11318,2.1e-05,172.31.36.0-255,66,219,8,153957
11319,2.9e-05,74.125.24.0-255,1484,1703,8,153957
11320,3.4e-05,172.31.36.0-255,66,1769,8,153957
11321,4.8e-05,74.125.24.0-255,2902,4671,8,153957
11322,5.1e-05,172.31.36.0-255,66,4737,8,153957
11323,5.8e-05,74.125.24.0-255,7156,11893,8,153957
11324,6.2e-05,172.31.36.0-255,66,11959,8,153957
11325,6.6e-05,74.125.24.0-255,1966,13925,8,153957
11326,7e-05,172.31.36.0-255,66,13991,8,153957
11327,7.4e-05,74.125.24.0-255,2902,16893,8,153957
11328,7.8e-05,172.31.36.0-255,66,16959,8,153957
11329,0.000117,74.125.24.0-255,7156,24115,8,153957
11330,0.000121,172.31.36.0-255,66,24181,8,153957
11331,0.000128,74.125.24.0-255,6797,30978,8,153957
11332,0.000131,172.31.36.0-255,66,31044,8,153957
11333,0.000955,74.125.24.0-255,1484,32528,8,153957
11334,0.000962,172.31.36.0-255,66,32594,8,153957
11335,0.000972,74.125.24.0-255,2902,35496,8,153957
11336,0.000975,172.31.36.0-255,66,35562,8,153957
11337,0.000987,74.125.24.0-255,5738,41300,8,153957
11338,0.000989,172.31.36.0-255,66,41366,8,153957
11339,0.001033,172.31.36.0-255,66,41432,8,153957
11340,0.001081,172.31.36.0-255,66,41498,8,153957
11341,0.001168,74.125.24.0-255,647,42145,8,153957
11342,0.001172,172.31.36.0-255,66,42211,8,153957
11343,0.00156,74.125.24.0-255,1484,43695,8,153957
11344,0.001567,172.31.36.0-255,66,43761,8,153957
11345,0.001574,74.125.24.0-255,2902,46663,8,153957
11346,0.001578,172.31.36.0-255,66,46729,8,153957
11347,0.001606,74.125.24.0-255,5738,52467,8,153957
11348,0.001609,172.31.36.0-255,66,52533,8,153957
11349,0.001631,74.125.24.0-255,7156,59689,8,153957
11350,0.001634,172.31.36.0-255,66,59755,8,153957
11351,0.001665,74.125.24.0-255,4320,64075,8,153957
11352,0.001667,172.31.36.0-255,66,64141,8,153957
11353,0.001686,172.31.36.0-255,66,64207,8,153957
11354,0.001689,74.125.24.0-255,1484,65691,8,153957
11355,0.001694,74.125.24.0-255,2902,68593,8,153957
11356,0.001697,172.31.36.0-255,66,68659,8,153957
11357,0.001703,74.125.24.0-255,5738,74397,8,153957
11358,0.001706,172.31.36.0-255,66,74463,8,153957
11359,0.001774,172.31.36.0-255,66,74529,8,153957
11360,0.00179,172.31.36.0-255,66,74595,8,153957
11361,0.001795,74.125.24.0-255,2184,76779,8,153957
11362,0.001797,172.31.36.0-255,66,76845,8,153957
11363,0.001801,74.125.24.0-255,2902,79747,8,153957
11364,0.001804,172.31.36.0-255,66,79813,8,153957
11365,0.001811,74.125.24.0-255,7156,86969,8,153957
11366,0.001813,172.31.36.0-255,66,87035,8,153957
11367,0.001819,74.125.24.0-255,4320,91355,8,153957
11368,0.001822,172.31.36.0-255,66,91421,8,153957
11369,0.00186,172.31.36.0-255,66,91487,8,153957
11370,0.001865,74.125.24.0-255,2902,94389,8,153957
11371,0.001867,172.31.36.0-255,66,94455,8,153957
11372,0.001908,172.31.36.0-255,66,94521,8,153957
11373,0.001914,74.125.24.0-255,4320,98841,8,153957
11374,0.001916,172.31.36.0-255,66,98907,8,153957
11375,0.00192,74.125.24.0-255,2902,101809,8,153957
11376,0.001927,172.31.36.0-255,66,101875,8,153957
11377,0.001949,74.125.24.0-255,2902,104777,8,153957
11378,0.001952,172.31.36.0-255,66,104843,8,153957
11379,0.001963,172.31.36.0-255,66,104909,8,153957
11380,0.001991,74.125.24.0-255,2902,107811,8,153957
11381,0.001994,172.31.36.0-255,66,107877,8,153957
11382,0.002012,172.31.36.0-255,66,107943,8,153957
11383,0.002037,74.125.24.0-255,1484,109427,8,153957
11384,0.002042,74.125.24.0-255,2902,112329,8,153957
11385,0.002044,172.31.36.0-255,66,112395,8,153957
11386,0.002051,74.125.24.0-255,5738,118133,8,153957
11387,0.002053,172.31.36.0-255,66,118199,8,153957
11388,0.002105,172.31.36.0-255,66,118265,8,153957
11389,0.002134,74.125.24.0-255,2902,121167,8,153957
11390,0.002136,172.31.36.0-255,66,121233,8,153957
11391,0.002177,172.31.36.0-255,66,121299,8,153957
11392,0.002206,172.31.36.0-255,66,121365,8,153957
11393,0.002217,172.31.36.0-255,66,121431,8,153957
11394,0.002264,172.31.36.0-255,66,121497,8,153957
11395,0.00229,172.31.36.0-255,66,121563,8,153957
11396,0.002296,74.125.24.0-255,5020,126583,8,153957
11397,0.002299,172.31.36.0-255,66,126649,8,153957
11398,0.002358,74.125.24.0-255,5738,132387,8,153957
11399,0.002361,172.31.36.0-255,66,132453,8,153957
11400,0.002368,74.125.24.0-255,7156,139609,8,153957
11401,0.002371,172.31.36.0-255,66,139675,8,153957
11402,0.00239,172.31.36.0-255,66,139741,8,153957
11403,0.002397,74.125.24.0-255,6438,146179,8,153957
11404,0.002399,172.31.36.0-255,66,146245,8,153957
11405,0.002448,172.31.36.0-255,66,146311,8,153957
11406,0.00246,172.31.36.0-255,66,146377,8,153957
11407,0.002498,172.31.36.0-255,66,146443,8,153957
11408,0.002525,172.31.36.0-255,66,146509,8,153957
11409,0.002539,172.31.36.0-255,66,146575,8,153957
11410,0.002572,172.31.36.0-255,66,146641,8,153957
11411,0.002575,74.125.24.0-255,97,146738,8,153957
11412,0.002578,74.125.24.0-255,105,146843,8,153957
11413,0.007529,172.31.36.0-255,66,146909,8,153957
11414,0.007562,172.31.36.0-255,105,147014,8,153957
11415,0.0101,74.125.24.0-255,66,147080,8,153957
11416,0.040165,172.31.36.0-255,188,147268,8,153957
11417,0.0402,172.31.36.0-255,955,148223,8,153957
11418,0.040269,172.31.36.0-255,1514,149737,8,153957
11419,0.040271,172.31.36.0-255,1514,151251,8,153957
11420,0.040275,172.31.36.0-255,1514,152765,8,153957
11421,0.040276,172.31.36.0-255,928,153693,8,153957
11422,0.0417,104.244.42.0-255,66,153759,8,153957
11423,0.041747,104.244.42.0-255,66,153825,8,153957
11424,0.041798,104.244.42.0-255,66,153891,8,153957
11425,0.041803,104.244.42.0-255,66,153957,8,153957
11426,0.0,172.217.27.0-255,153,153,8,344424
11427,2.4e-05,172.31.36.0-255,66,219,8,344424
11428,3.2e-05,172.217.27.0-255,1484,1703,8,344424
11429,3.7e-05,172.31.36.0-255,66,1769,8,344424
11430,4.3e-05,172.217.27.0-255,2902,4671,8,344424
11431,4.7e-05,172.31.36.0-255,66,4737,8,344424
11432,5.5e-05,172.217.27.0-255,7156,11893,8,344424
11433,5.8e-05,172.31.36.0-255,66,11959,8,344424
11434,6.2e-05,172.217.27.0-255,1484,13443,8,344424
11435,6.5e-05,172.31.36.0-255,66,13509,8,344424
11436,0.000107,172.31.36.0-255,66,13575,8,344424
11437,0.000158,172.217.27.0-255,5738,19313,8,344424
11438,0.000161,172.31.36.0-255,66,19379,8,344424
11439,0.000176,172.217.27.0-255,1125,20504,8,344424
11440,0.000178,172.31.36.0-255,66,20570,8,344424
11441,0.000212,172.217.27.0-255,1484,22054,8,344424
11442,0.000214,172.31.36.0-255,66,22120,8,344424
11443,0.000219,172.217.27.0-255,2902,25022,8,344424
11444,0.000222,172.31.36.0-255,66,25088,8,344424
11445,0.000241,172.217.27.0-255,5738,30826,8,344424
11446,0.000244,172.31.36.0-255,66,30892,8,344424
11447,0.000274,172.217.27.0-255,1484,32376,8,344424
11448,0.000276,172.31.36.0-255,66,32442,8,344424
11449,0.000295,172.217.27.0-255,5379,37821,8,344424
11450,0.000298,172.31.36.0-255,66,37887,8,344424
11451,0.000306,172.217.27.0-255,7156,45043,8,344424
11452,0.000308,172.31.36.0-255,66,45109,8,344424
11453,0.000333,172.217.27.0-255,2902,48011,8,344424
11454,0.000335,172.31.36.0-255,66,48077,8,344424
11455,0.000355,172.217.27.0-255,6797,54874,8,344424
11456,0.000358,172.31.36.0-255,66,54940,8,344424
11457,0.000361,172.217.27.0-255,355,55295,8,344424
11458,0.000706,172.217.27.0-255,137,55432,8,344424
11459,0.000811,172.217.27.0-255,1484,56916,8,344424
11460,0.000815,172.31.36.0-255,66,56982,8,344424
11461,0.000863,172.217.27.0-255,2902,59884,8,344424
11462,0.000867,172.31.36.0-255,66,59950,8,344424
11463,0.000873,172.217.27.0-255,4320,64270,8,344424
11464,0.000875,172.31.36.0-255,66,64336,8,344424
11465,0.000894,172.217.27.0-255,1484,65820,8,344424
11466,0.000935,172.31.36.0-255,66,65886,8,344424
11467,0.000945,172.217.27.0-255,2902,68788,8,344424
11468,0.000947,172.31.36.0-255,66,68854,8,344424
11469,0.000984,172.31.36.0-255,66,68920,8,344424
11470,0.00099,172.217.27.0-255,3961,72881,8,344424
11471,0.000992,172.31.36.0-255,66,72947,8,344424
11472,0.00103,172.217.27.0-255,2902,75849,8,344424
11473,0.001034,172.31.36.0-255,66,75915,8,344424
11474,0.00104,172.217.27.0-255,4320,80235,8,344424
11475,0.001042,172.31.36.0-255,66,80301,8,344424
11476,0.001049,172.217.27.0-255,5738,86039,8,344424
11477,0.001051,172.31.36.0-255,66,86105,8,344424
11478,0.001068,172.217.27.0-255,2902,89007,8,344424
11479,0.00107,172.31.36.0-255,66,89073,8,344424
11480,0.001081,172.31.36.0-255,66,89139,8,344424
11481,0.001093,172.31.36.0-255,66,89205,8,344424
11482,0.001116,172.217.27.0-255,1484,90689,8,344424
11483,0.001121,172.217.27.0-255,2902,93591,8,344424
11484,0.001123,172.31.36.0-255,66,93657,8,344424
11485,0.001129,172.217.27.0-255,4320,97977,8,344424
11486,0.001131,172.31.36.0-255,66,98043,8,344424
11487,0.001157,172.217.27.0-255,1484,99527,8,344424
11488,0.001163,172.217.27.0-255,4320,103847,8,344424
11489,0.001166,172.31.36.0-255,66,103913,8,344424
11490,0.001173,172.217.27.0-255,5738,109651,8,344424
11491,0.001175,172.31.36.0-255,66,109717,8,344424
11492,0.001185,172.31.36.0-255,66,109783,8,344424
11493,0.001235,172.217.27.0-255,5020,114803,8,344424
11494,0.001239,172.31.36.0-255,66,114869,8,344424
11495,0.001277,172.217.27.0-255,5738,120607,8,344424
11496,0.001281,172.31.36.0-255,66,120673,8,344424
11497,0.001284,172.217.27.0-255,1484,122157,8,344424
11498,0.001288,172.217.27.0-255,1484,123641,8,344424
11499,0.00129,172.31.36.0-255,66,123707,8,344424
11500,0.001317,172.217.27.0-255,7156,130863,8,344424
11501,0.00132,172.31.36.0-255,66,130929,8,344424
11502,0.001324,172.217.27.0-255,827,131756,8,344424
11503,0.001385,172.217.27.0-255,1484,133240,8,344424
11504,0.001389,172.31.36.0-255,66,133306,8,344424
11505,0.001404,172.217.27.0-255,2902,136208,8,344424
11506,0.001406,172.31.36.0-255,66,136274,8,344424
11507,0.001433,172.217.27.0-255,5738,142012,8,344424
11508,0.001436,172.31.36.0-255,66,142078,8,344424
11509,0.001444,172.217.27.0-255,7156,149234,8,344424
11510,0.001446,172.31.36.0-255,66,149300,8,344424
11511,0.001487,172.31.36.0-255,66,149366,8,344424
11512,0.001491,172.217.27.0-255,2184,151550,8,344424
11513,0.001493,172.31.36.0-255,66,151616,8,344424
11514,0.001564,172.217.27.0-255,4320,155936,8,344424
11515,0.001567,172.31.36.0-255,66,156002,8,344424
11516,0.001595,172.31.36.0-255,66,156068,8,344424
11517,0.00161,172.217.27.0-255,1484,157552,8,344424
11518,0.001638,172.217.27.0-255,2902,160454,8,344424
11519,0.001641,172.31.36.0-255,66,160520,8,344424
11520,0.001647,172.217.27.0-255,4320,164840,8,344424
11521,0.00165,172.31.36.0-255,66,164906,8,344424
11522,0.001653,172.217.27.0-255,1484,166390,8,344424
11523,0.001673,172.217.27.0-255,1484,167874,8,344424
11524,0.001675,172.31.36.0-255,66,167940,8,344424
11525,0.003275,172.217.27.0-255,2902,170842,8,344424
11526,0.003282,172.31.36.0-255,66,170908,8,344424
11527,0.003305,172.217.27.0-255,2902,173810,8,344424
11528,0.003308,172.31.36.0-255,66,173876,8,344424
11529,0.004918,172.217.27.0-255,5738,179614,8,344424
11530,0.004926,172.31.36.0-255,66,179680,8,344424
11531,0.0066,172.217.27.0-255,5738,185418,8,344424
11532,0.006615,172.31.36.0-255,66,185484,8,344424
11533,0.008246,172.217.27.0-255,5738,191222,8,344424
11534,0.008254,172.31.36.0-255,66,191288,8,344424
11535,0.009892,172.217.27.0-255,5738,197026,8,344424
11536,0.009896,172.31.36.0-255,66,197092,8,344424
11537,0.011529,172.217.27.0-255,5738,202830,8,344424
11538,0.011536,172.31.36.0-255,66,202896,8,344424
11539,0.013311,172.217.27.0-255,5738,208634,8,344424
11540,0.013322,172.31.36.0-255,66,208700,8,344424
11541,0.014963,172.217.27.0-255,5738,214438,8,344424
11542,0.014975,172.31.36.0-255,66,214504,8,344424
11543,0.016642,172.217.27.0-255,5738,220242,8,344424
11544,0.016654,172.31.36.0-255,66,220308,8,344424
11545,0.018292,172.217.27.0-255,5738,226046,8,344424
11546,0.018301,172.31.36.0-255,66,226112,8,344424
11547,0.019935,172.217.27.0-255,5738,231850,8,344424
11548,0.019943,172.31.36.0-255,66,231916,8,344424
11549,0.021587,172.217.27.0-255,5738,237654,8,344424
11550,0.021602,172.31.36.0-255,66,237720,8,344424
11551,0.023237,172.217.27.0-255,5738,243458,8,344424
11552,0.023245,172.31.36.0-255,66,243524,8,344424
11553,0.024894,172.217.27.0-255,5738,249262,8,344424
11554,0.024904,172.31.36.0-255,66,249328,8,344424
11555,0.026546,172.217.27.0-255,5738,255066,8,344424
11556,0.026554,172.31.36.0-255,66,255132,8,344424
11557,0.028191,172.217.27.0-255,5738,260870,8,344424
11558,0.028198,172.31.36.0-255,66,260936,8,344424
11559,0.029838,172.217.27.0-255,5738,266674,8,344424
11560,0.029846,172.31.36.0-255,66,266740,8,344424
11561,0.031483,172.217.27.0-255,5738,272478,8,344424
11562,0.03149,172.31.36.0-255,66,272544,8,344424
11563,0.03315,172.217.27.0-255,5738,278282,8,344424
11564,0.033164,172.31.36.0-255,66,278348,8,344424
11565,0.034798,172.217.27.0-255,5738,284086,8,344424
11566,0.034806,172.31.36.0-255,66,284152,8,344424
11567,0.036443,172.217.27.0-255,2902,287054,8,344424
11568,0.036451,172.31.36.0-255,66,287120,8,344424
11569,0.036472,172.217.27.0-255,2902,290022,8,344424
11570,0.036475,172.31.36.0-255,66,290088,8,344424
11571,0.038088,172.217.27.0-255,4320,294408,8,344424
11572,0.038096,172.31.36.0-255,66,294474,8,344424
11573,0.038116,172.217.27.0-255,1484,295958,8,344424
11574,0.039746,172.217.27.0-255,4320,300278,8,344424
11575,0.039755,172.31.36.0-255,66,300344,8,344424
11576,0.041392,172.217.27.0-255,5738,306082,8,344424
11577,0.0414,172.31.36.0-255,66,306148,8,344424
11578,0.04303,172.217.27.0-255,5738,311886,8,344424
11579,0.043039,172.31.36.0-255,66,311952,8,344424
11580,0.044669,172.217.27.0-255,5738,317690,8,344424
11581,0.044677,172.31.36.0-255,66,317756,8,344424
11582,0.046303,172.217.27.0-255,5738,323494,8,344424
11583,0.046311,172.31.36.0-255,66,323560,8,344424
11584,0.047951,172.217.27.0-255,5738,329298,8,344424
11585,0.04796,172.31.36.0-255,66,329364,8,344424
11586,0.049594,172.217.27.0-255,4537,333901,8,344424
11587,0.049601,172.31.36.0-255,66,333967,8,344424
11588,0.049795,172.31.36.0-255,172,334139,8,344424
11589,0.049828,172.31.36.0-255,1111,335250,8,344424
11590,0.049976,172.31.36.0-255,1514,336764,8,344424
11591,0.049979,172.31.36.0-255,1514,338278,8,344424
11592,0.049985,172.31.36.0-255,1514,339792,8,344424
11593,0.049986,172.31.36.0-255,1514,341306,8,344424
11594,0.050006,172.31.36.0-255,1514,342820,8,344424
11595,0.050007,172.31.36.0-255,995,343815,8,344424
11596,0.05008,172.31.36.0-255,105,343920,8,344424
11597,0.051331,104.244.42.0-255,66,343986,8,344424
11598,0.051376,104.244.42.0-255,66,344052,8,344424
11599,0.05154,104.244.42.0-255,66,344118,8,344424
11600,0.051595,104.244.42.0-255,66,344184,8,344424
11601,0.051679,172.217.27.0-255,66,344250,8,344424
11602,0.061991,172.31.36.0-255,108,344358,8,344424
11603,0.063541,104.244.42.0-255,66,344424,8,344424
11604,0.0,74.125.24.0-255,153,153,8,243009
11605,2.5e-05,172.31.36.0-255,66,219,8,243009
11606,3.1e-05,74.125.24.0-255,1484,1703,8,243009
11607,3.6e-05,172.31.36.0-255,66,1769,8,243009
11608,4.1e-05,74.125.24.0-255,2902,4671,8,243009
11609,4.4e-05,172.31.36.0-255,66,4737,8,243009
11610,7e-05,74.125.24.0-255,5738,10475,8,243009
11611,7.2e-05,172.31.36.0-255,66,10541,8,243009
11612,0.000109,74.125.24.0-255,3493,14034,8,243009
11613,0.000113,172.31.36.0-255,66,14100,8,243009
11614,0.000149,74.125.24.0-255,1484,15584,8,243009
11615,0.000152,172.31.36.0-255,66,15650,8,243009
11616,0.000157,74.125.24.0-255,2902,18552,8,243009
11617,0.00016,172.31.36.0-255,66,18618,8,243009
11618,0.000171,74.125.24.0-255,1484,20102,8,243009
11619,0.000173,172.31.36.0-255,66,20168,8,243009
11620,0.000192,74.125.24.0-255,4320,24488,8,243009
11621,0.000195,172.31.36.0-255,66,24554,8,243009
11622,0.000202,74.125.24.0-255,5738,30292,8,243009
11623,0.000204,172.31.36.0-255,66,30358,8,243009
11624,0.000225,74.125.24.0-255,1125,31483,8,243009
11625,0.000228,172.31.36.0-255,66,31549,8,243009
11626,0.000234,74.125.24.0-255,5738,37287,8,243009
11627,0.000251,172.31.36.0-255,66,37353,8,243009
11628,0.000267,74.125.24.0-255,1484,38837,8,243009
11629,0.00027,172.31.36.0-255,66,38903,8,243009
11630,0.000282,172.31.36.0-255,66,38969,8,243009
11631,0.000313,74.125.24.0-255,2902,41871,8,243009
11632,0.000316,172.31.36.0-255,66,41937,8,243009
11633,0.000321,74.125.24.0-255,4320,46257,8,243009
11634,0.000324,172.31.36.0-255,66,46323,8,243009
11635,0.00033,74.125.24.0-255,7156,53479,8,243009
11636,0.000333,172.31.36.0-255,66,53545,8,243009
11637,0.000357,74.125.24.0-255,1484,55029,8,243009
11638,0.000361,74.125.24.0-255,1396,56425,8,243009
11639,0.000363,172.31.36.0-255,66,56491,8,243009
11640,0.000507,74.125.24.0-255,130,56621,8,243009
11641,0.000522,74.125.24.0-255,351,56972,8,243009
11642,0.000639,74.125.24.0-255,1484,58456,8,243009
11643,0.000644,172.31.36.0-255,66,58522,8,243009
11644,0.000649,74.125.24.0-255,2902,61424,8,243009
11645,0.000651,172.31.36.0-255,66,61490,8,243009
11646,0.000657,74.125.24.0-255,5738,67228,8,243009
11647,0.000661,172.31.36.0-255,66,67294,8,243009
11648,0.000698,172.31.36.0-255,66,67360,8,243009
11649,0.000727,172.31.36.0-255,66,67426,8,243009
11650,0.000874,74.125.24.0-255,1484,68910,8,243009
11651,0.000887,74.125.24.0-255,2902,71812,8,243009
11652,0.000891,172.31.36.0-255,66,71878,8,243009
11653,0.000912,74.125.24.0-255,5738,77616,8,243009
11654,0.000915,172.31.36.0-255,66,77682,8,243009
11655,0.000934,74.125.24.0-255,5738,83420,8,243009
11656,0.000937,172.31.36.0-255,66,83486,8,243009
11657,0.000954,74.125.24.0-255,7156,90642,8,243009
11658,0.000957,172.31.36.0-255,66,90708,8,243009
11659,0.00098,74.125.24.0-255,2902,93610,8,243009
11660,0.000983,172.31.36.0-255,66,93676,8,243009
11661,0.00101,172.31.36.0-255,66,93742,8,243009
11662,0.001145,74.125.24.0-255,1484,95226,8,243009
11663,0.00115,74.125.24.0-255,2902,98128,8,243009
11664,0.001153,172.31.36.0-255,66,98194,8,243009
11665,0.001176,74.125.24.0-255,5738,103932,8,243009
11666,0.001179,172.31.36.0-255,66,103998,8,243009
11667,0.001185,74.125.24.0-255,5738,109736,8,243009
11668,0.001187,172.31.36.0-255,66,109802,8,243009
11669,0.001221,74.125.24.0-255,1484,111286,8,243009
11670,0.001223,172.31.36.0-255,66,111352,8,243009
11671,0.001235,74.125.24.0-255,3602,114954,8,243009
11672,0.001238,172.31.36.0-255,66,115020,8,243009
11673,0.001479,74.125.24.0-255,1484,116504,8,243009
11674,0.001495,74.125.24.0-255,2902,119406,8,243009
11675,0.001499,172.31.36.0-255,66,119472,8,243009
11676,0.001505,74.125.24.0-255,5738,125210,8,243009
11677,0.001507,172.31.36.0-255,66,125276,8,243009
11678,0.001559,172.31.36.0-255,66,125342,8,243009
11679,0.001564,74.125.24.0-255,2902,128244,8,243009
11680,0.001566,172.31.36.0-255,66,128310,8,243009
11681,0.00159,172.31.36.0-255,66,128376,8,243009
11682,0.001612,74.125.24.0-255,1484,129860,8,243009
11683,0.001616,74.125.24.0-255,2902,132762,8,243009
11684,0.001619,172.31.36.0-255,66,132828,8,243009
11685,0.001633,74.125.24.0-255,5738,138566,8,243009
11686,0.001637,172.31.36.0-255,66,138632,8,243009
11687,0.001669,172.31.36.0-255,66,138698,8,243009
11688,0.001729,74.125.24.0-255,7156,145854,8,243009
11689,0.001733,172.31.36.0-255,66,145920,8,243009
11690,0.001757,74.125.24.0-255,6438,152358,8,243009
11691,0.00176,172.31.36.0-255,66,152424,8,243009
11692,0.001768,74.125.24.0-255,7156,159580,8,243009
11693,0.00177,172.31.36.0-255,66,159646,8,243009
11694,0.00178,172.31.36.0-255,66,159712,8,243009
11695,0.0018,172.31.36.0-255,66,159778,8,243009
11696,0.001824,74.125.24.0-255,4320,164098,8,243009
11697,0.001827,172.31.36.0-255,66,164164,8,243009
11698,0.00183,74.125.24.0-255,766,164930,8,243009
11699,0.001861,74.125.24.0-255,4320,169250,8,243009
11700,0.001865,172.31.36.0-255,66,169316,8,243009
11701,0.001888,74.125.24.0-255,4320,173636,8,243009
11702,0.001893,172.31.36.0-255,66,173702,8,243009
11703,0.0019,172.31.36.0-255,66,173768,8,243009
11704,0.00191,172.31.36.0-255,66,173834,8,243009
11705,0.001937,74.125.24.0-255,6438,180272,8,243009
11706,0.00194,172.31.36.0-255,66,180338,8,243009
11707,0.001954,74.125.24.0-255,1484,181822,8,243009
11708,0.001977,74.125.24.0-255,2902,184724,8,243009
11709,0.001981,172.31.36.0-255,66,184790,8,243009
11710,0.001985,74.125.24.0-255,2902,187692,8,243009
11711,0.001988,172.31.36.0-255,66,187758,8,243009
11712,0.002003,74.125.24.0-255,2902,190660,8,243009
11713,0.002006,172.31.36.0-255,66,190726,8,243009
11714,0.002012,74.125.24.0-255,5738,196464,8,243009
11715,0.002015,172.31.36.0-255,66,196530,8,243009
11716,0.002056,172.31.36.0-255,66,196596,8,243009
11717,0.002062,74.125.24.0-255,5020,201616,8,243009
11718,0.002064,172.31.36.0-255,66,201682,8,243009
11719,0.002162,74.125.24.0-255,1484,203166,8,243009
11720,0.002168,74.125.24.0-255,2902,206068,8,243009
11721,0.002173,172.31.36.0-255,66,206134,8,243009
11722,0.002179,74.125.24.0-255,5738,211872,8,243009
11723,0.002181,172.31.36.0-255,66,211938,8,243009
11724,0.002203,74.125.24.0-255,5738,217676,8,243009
11725,0.002207,172.31.36.0-255,66,217742,8,243009
11726,0.002228,74.125.24.0-255,5738,223480,8,243009
11727,0.002232,172.31.36.0-255,66,223546,8,243009
11728,0.002245,172.31.36.0-255,66,223612,8,243009
11729,0.002293,74.125.24.0-255,1484,225096,8,243009
11730,0.002297,74.125.24.0-255,1484,226580,8,243009
11731,0.0023,172.31.36.0-255,66,226646,8,243009
11732,0.002316,74.125.24.0-255,1484,228130,8,243009
11733,0.002323,74.125.24.0-255,5738,233868,8,243009
11734,0.002326,172.31.36.0-255,66,233934,8,243009
11735,0.002369,172.31.36.0-255,66,234000,8,243009
11736,0.00237,74.125.24.0-255,7156,241156,8,243009
11737,0.002373,172.31.36.0-255,66,241222,8,243009
11738,0.002432,172.31.36.0-255,66,241288,8,243009
11739,0.002488,74.125.24.0-255,105,241393,8,243009
11740,0.003635,172.31.36.0-255,66,241459,8,243009
11741,0.003662,172.31.36.0-255,105,241564,8,243009
11742,0.006253,74.125.24.0-255,66,241630,8,243009
11743,0.035062,172.31.36.0-255,172,241802,8,243009
11744,0.035093,172.31.36.0-255,1075,242877,8,243009
11745,0.0366,104.244.42.0-255,66,242943,8,243009
11746,0.036608,104.244.42.0-255,66,243009,8,243009
11747,0.0,172.217.194.0-255,153,153,8,166902
11748,2.4e-05,172.31.36.0-255,66,219,8,166902
11749,3.1e-05,172.217.194.0-255,1484,1703,8,166902
11750,3.6e-05,172.31.36.0-255,66,1769,8,166902
11751,4.2e-05,172.217.194.0-255,2902,4671,8,166902
11752,4.5e-05,172.31.36.0-255,66,4737,8,166902
11753,5.3e-05,172.217.194.0-255,7156,11893,8,166902
11754,5.6e-05,172.31.36.0-255,66,11959,8,166902
11755,5.9e-05,172.217.194.0-255,1484,13443,8,166902
11756,6.1e-05,172.31.36.0-255,66,13509,8,166902
11757,0.000115,172.31.36.0-255,66,13575,8,166902
11758,0.000144,172.217.194.0-255,6797,20372,8,166902
11759,0.000146,172.31.36.0-255,66,20438,8,166902
11760,0.000152,172.217.194.0-255,4320,24758,8,166902
11761,0.000154,172.31.36.0-255,66,24824,8,166902
11762,0.000174,172.217.194.0-255,2902,27726,8,166902
11763,0.000176,172.31.36.0-255,66,27792,8,166902
11764,0.000188,172.31.36.0-255,66,27858,8,166902
11765,0.000234,172.217.194.0-255,5738,33596,8,166902
11766,0.000237,172.31.36.0-255,66,33662,8,166902
11767,0.000268,172.31.36.0-255,66,33728,8,166902
11768,0.000361,172.217.194.0-255,364,34092,8,166902
11769,0.000364,172.31.36.0-255,66,34158,8,166902
11770,0.000496,172.217.194.0-255,1484,35642,8,166902
11771,0.0005,172.31.36.0-255,66,35708,8,166902
11772,0.000506,172.217.194.0-255,2902,38610,8,166902
11773,0.000508,172.31.36.0-255,66,38676,8,166902
11774,0.000515,172.217.194.0-255,5738,44414,8,166902
11775,0.000518,172.31.36.0-255,66,44480,8,166902
11776,0.000561,172.31.36.0-255,66,44546,8,166902
11777,0.000582,172.217.194.0-255,4320,48866,8,166902
11778,0.000585,172.31.36.0-255,66,48932,8,166902
11779,0.000615,172.31.36.0-255,66,48998,8,166902
11780,0.000781,172.217.194.0-255,1484,50482,8,166902
11781,0.000787,172.217.194.0-255,2902,53384,8,166902
11782,0.00079,172.31.36.0-255,66,53450,8,166902
11783,0.000798,172.217.194.0-255,5738,59188,8,166902
11784,0.0008,172.31.36.0-255,66,59254,8,166902
11785,0.000834,172.217.194.0-255,7156,66410,8,166902
11786,0.000837,172.31.36.0-255,66,66476,8,166902
11787,0.000862,172.217.194.0-255,5738,72214,8,166902
11788,0.000865,172.31.36.0-255,66,72280,8,166902
11789,0.000876,172.31.36.0-255,66,72346,8,166902
11790,0.000916,172.31.36.0-255,66,72412,8,166902
11791,0.00093,172.31.36.0-255,66,72478,8,166902
11792,0.000947,172.217.194.0-255,1484,73962,8,166902
11793,0.000969,172.31.36.0-255,66,74028,8,166902
11794,0.001027,172.217.194.0-255,1484,75512,8,166902
11795,0.001032,172.217.194.0-255,2902,78414,8,166902
11796,0.001035,172.31.36.0-255,66,78480,8,166902
11797,0.001039,172.217.194.0-255,1484,79964,8,166902
11798,0.001061,172.217.194.0-255,4320,84284,8,166902
11799,0.001064,172.31.36.0-255,66,84350,8,166902
11800,0.001072,172.217.194.0-255,7156,91506,8,166902
11801,0.001074,172.31.36.0-255,66,91572,8,166902
11802,0.001109,172.217.194.0-255,5738,97310,8,166902
11803,0.001112,172.31.36.0-255,66,97376,8,166902
11804,0.001124,172.31.36.0-255,66,97442,8,166902
11805,0.001478,172.217.194.0-255,1484,98926,8,166902
11806,0.001484,172.217.194.0-255,2902,101828,8,166902
11807,0.001488,172.31.36.0-255,66,101894,8,166902
11808,0.001495,172.217.194.0-255,5738,107632,8,166902
11809,0.001497,172.31.36.0-255,66,107698,8,166902
11810,0.001535,172.31.36.0-255,66,107764,8,166902
11811,0.001564,172.31.36.0-255,66,107830,8,166902
11812,0.001664,172.217.194.0-255,1484,109314,8,166902
11813,0.001669,172.217.194.0-255,2902,112216,8,166902
11814,0.001672,172.31.36.0-255,66,112282,8,166902
11815,0.001678,172.217.194.0-255,2902,115184,8,166902
11816,0.00168,172.31.36.0-255,66,115250,8,166902
11817,0.001694,172.217.194.0-255,2902,118152,8,166902
11818,0.001696,172.31.36.0-255,66,118218,8,166902
11819,0.001699,172.217.194.0-255,1484,119702,8,166902
11820,0.001728,172.31.36.0-255,66,119768,8,166902
11821,0.001741,172.31.36.0-255,66,119834,8,166902
11822,0.002099,172.217.194.0-255,1484,121318,8,166902
11823,0.00212,172.217.194.0-255,2902,124220,8,166902
11824,0.002123,172.31.36.0-255,66,124286,8,166902
11825,0.00213,172.217.194.0-255,5738,130024,8,166902
11826,0.002133,172.31.36.0-255,66,130090,8,166902
11827,0.002154,172.217.194.0-255,4320,134410,8,166902
11828,0.002157,172.31.36.0-255,66,134476,8,166902
11829,0.002198,172.31.36.0-255,66,134542,8,166902
11830,0.002211,172.31.36.0-255,66,134608,8,166902
11831,0.002232,172.217.194.0-255,1484,136092,8,166902
11832,0.002237,172.217.194.0-255,2902,138994,8,166902
11833,0.002239,172.31.36.0-255,66,139060,8,166902
11834,0.002266,172.217.194.0-255,5738,144798,8,166902
11835,0.002269,172.31.36.0-255,66,144864,8,166902
11836,0.002272,172.217.194.0-255,1484,146348,8,166902
11837,0.002302,172.31.36.0-255,66,146414,8,166902
11838,0.002317,172.31.36.0-255,66,146480,8,166902
11839,0.002364,172.31.36.0-255,66,146546,8,166902
11840,0.002377,172.217.194.0-255,1484,148030,8,166902
11841,0.00241,172.31.36.0-255,66,148096,8,166902
11842,0.002446,172.217.194.0-255,7156,155252,8,166902
11843,0.002449,172.31.36.0-255,66,155318,8,166902
11844,0.002487,172.31.36.0-255,66,155384,8,166902
11845,0.002499,172.31.36.0-255,66,155450,8,166902
11846,0.004897,172.217.194.0-255,5738,161188,8,166902
11847,0.004905,172.31.36.0-255,66,161254,8,166902
11848,0.007313,172.217.194.0-255,1384,162638,8,166902
11849,0.009002,172.31.36.0-255,66,162704,8,166902
11850,0.00904,172.31.36.0-255,105,162809,8,166902
11851,0.01137,172.217.194.0-255,66,162875,8,166902
11852,0.038018,172.31.36.0-255,176,163051,8,166902
11853,0.038054,172.31.36.0-255,1111,164162,8,166902
11854,0.038128,172.31.36.0-255,1514,165676,8,166902
11855,0.03813,172.31.36.0-255,1028,166704,8,166902
11856,0.039583,104.244.42.0-255,66,166770,8,166902
11857,0.039613,104.244.42.0-255,66,166836,8,166902
11858,0.039652,104.244.42.0-255,66,166902,8,166902
11859,0.0,74.125.24.0-255,156,156,8,272072
11860,2.1e-05,172.31.36.0-255,66,222,8,272072
11861,2.7e-05,74.125.24.0-255,1484,1706,8,272072
11862,3.2e-05,172.31.36.0-255,66,1772,8,272072
11863,4.4e-05,74.125.24.0-255,2902,4674,8,272072
11864,4.8e-05,172.31.36.0-255,66,4740,8,272072
11865,5.6e-05,74.125.24.0-255,7156,11896,8,272072
11866,5.9e-05,172.31.36.0-255,66,11962,8,272072
11867,6.3e-05,74.125.24.0-255,2088,14050,8,272072
11868,6.6e-05,172.31.36.0-255,66,14116,8,272072
11869,7.4e-05,74.125.24.0-255,5738,19854,8,272072
11870,7.7e-05,172.31.36.0-255,66,19920,8,272072
11871,0.000104,74.125.24.0-255,5738,25658,8,272072
11872,0.000108,172.31.36.0-255,66,25724,8,272072
11873,0.000119,74.125.24.0-255,5379,31103,8,272072
11874,0.000122,172.31.36.0-255,66,31169,8,272072
11875,0.000185,74.125.24.0-255,1484,32653,8,272072
11876,0.000188,172.31.36.0-255,66,32719,8,272072
11877,0.000216,74.125.24.0-255,2902,35621,8,272072
11878,0.000218,172.31.36.0-255,66,35687,8,272072
11879,0.000223,74.125.24.0-255,2902,38589,8,272072
11880,0.000225,172.31.36.0-255,66,38655,8,272072
11881,0.000247,74.125.24.0-255,1484,40139,8,272072
11882,0.000249,172.31.36.0-255,66,40205,8,272072
11883,0.000255,74.125.24.0-255,4320,44525,8,272072
11884,0.000257,172.31.36.0-255,66,44591,8,272072
11885,0.000289,74.125.24.0-255,3961,48552,8,272072
11886,0.000291,172.31.36.0-255,66,48618,8,272072
11887,0.000325,172.31.36.0-255,66,48684,8,272072
11888,0.000382,172.31.36.0-255,66,48750,8,272072
11889,0.001092,74.125.24.0-255,379,49129,8,272072
11890,0.001123,74.125.24.0-255,1484,50613,8,272072
11891,0.001127,172.31.36.0-255,66,50679,8,272072
11892,0.001155,74.125.24.0-255,4320,54999,8,272072
11893,0.001166,74.125.24.0-255,1484,56483,8,272072
11894,0.001183,74.125.24.0-255,5738,62221,8,272072
11895,0.00121,74.125.24.0-255,3961,66182,8,272072
11896,0.00144,74.125.24.0-255,1484,67666,8,272072
11897,0.001447,74.125.24.0-255,2902,70568,8,272072
11898,0.001466,74.125.24.0-255,5738,76306,8,272072
11899,0.001505,74.125.24.0-255,2902,79208,8,272072
11900,0.001527,74.125.24.0-255,3961,83169,8,272072
11901,0.001978,74.125.24.0-255,1484,84653,8,272072
11902,0.001986,74.125.24.0-255,2902,87555,8,272072
11903,0.002001,74.125.24.0-255,5738,93293,8,272072
11904,0.002016,74.125.24.0-255,1484,94777,8,272072
11905,0.002074,74.125.24.0-255,4320,99097,8,272072
11906,0.006746,172.31.36.0-255,66,99163,8,272072
11907,0.008805,74.125.24.0-255,5738,104901,8,272072
11908,0.008813,172.31.36.0-255,66,104967,8,272072
11909,0.010857,74.125.24.0-255,5738,110705,8,272072
11910,0.013263,172.31.36.0-255,66,110771,8,272072
11911,0.015302,74.125.24.0-255,5738,116509,8,272072
11912,0.015312,172.31.36.0-255,66,116575,8,272072
11913,0.017333,74.125.24.0-255,5738,122313,8,272072
11914,0.017342,172.31.36.0-255,66,122379,8,272072
11915,0.019382,74.125.24.0-255,5738,128117,8,272072
11916,0.01939,172.31.36.0-255,66,128183,8,272072
11917,0.021489,74.125.24.0-255,5738,133921,8,272072
11918,0.021498,172.31.36.0-255,66,133987,8,272072
11919,0.023534,74.125.24.0-255,5738,139725,8,272072
11920,0.023542,172.31.36.0-255,66,139791,8,272072
11921,0.025571,74.125.24.0-255,5738,145529,8,272072
11922,0.025579,172.31.36.0-255,66,145595,8,272072
11923,0.025955,172.31.36.0-255,477,146072,8,272072
11924,0.025986,172.31.36.0-255,1112,147184,8,272072
11925,0.026047,172.31.36.0-255,1514,148698,8,272072
11926,0.026049,172.31.36.0-255,1292,149990,8,272072
11927,0.027522,104.244.42.0-255,66,150056,8,272072
11928,0.027559,104.244.42.0-255,66,150122,8,272072
11929,0.027593,104.244.42.0-255,66,150188,8,272072
11930,0.027616,74.125.24.0-255,5738,155926,8,272072
11931,0.027626,172.31.36.0-255,66,155992,8,272072
11932,0.029724,74.125.24.0-255,5738,161730,8,272072
11933,0.029732,172.31.36.0-255,66,161796,8,272072
11934,0.031796,74.125.24.0-255,5738,167534,8,272072
11935,0.031803,172.31.36.0-255,66,167600,8,272072
11936,0.033846,74.125.24.0-255,5738,173338,8,272072
11937,0.033853,172.31.36.0-255,66,173404,8,272072
11938,0.035893,74.125.24.0-255,5738,179142,8,272072
11939,0.035899,172.31.36.0-255,66,179208,8,272072
11940,0.03796,74.125.24.0-255,5738,184946,8,272072
11941,0.037967,172.31.36.0-255,66,185012,8,272072
11942,0.040003,74.125.24.0-255,5738,190750,8,272072
11943,0.040011,172.31.36.0-255,66,190816,8,272072
11944,0.042045,74.125.24.0-255,5738,196554,8,272072
11945,0.042055,172.31.36.0-255,66,196620,8,272072
11946,0.044107,74.125.24.0-255,5738,202358,8,272072
11947,0.044116,172.31.36.0-255,66,202424,8,272072
11948,0.046154,74.125.24.0-255,5738,208162,8,272072
11949,0.046164,172.31.36.0-255,66,208228,8,272072
11950,0.048196,74.125.24.0-255,5738,213966,8,272072
11951,0.048203,172.31.36.0-255,66,214032,8,272072
11952,0.050265,74.125.24.0-255,5738,219770,8,272072
11953,0.050275,172.31.36.0-255,66,219836,8,272072
11954,0.052309,74.125.24.0-255,5738,225574,8,272072
11955,0.052316,172.31.36.0-255,66,225640,8,272072
11956,0.054357,74.125.24.0-255,5738,231378,8,272072
11957,0.054363,172.31.36.0-255,66,231444,8,272072
11958,0.056425,74.125.24.0-255,5738,237182,8,272072
11959,0.056432,172.31.36.0-255,66,237248,8,272072
11960,0.058466,74.125.24.0-255,5738,242986,8,272072
11961,0.058473,172.31.36.0-255,66,243052,8,272072
11962,0.060517,74.125.24.0-255,5738,248790,8,272072
11963,0.060524,172.31.36.0-255,66,248856,8,272072
11964,0.062579,74.125.24.0-255,5738,254594,8,272072
11965,0.062586,172.31.36.0-255,66,254660,8,272072
11966,0.064631,74.125.24.0-255,5738,260398,8,272072
11967,0.064638,172.31.36.0-255,66,260464,8,272072
11968,0.06674,74.125.24.0-255,5738,266202,8,272072
11969,0.066748,172.31.36.0-255,66,266268,8,272072
11970,0.06878,74.125.24.0-255,5738,272006,8,272072
11971,0.068787,172.31.36.0-255,66,272072,8,272072
11972,0.0,74.125.24.0-255,153,153,8,343760
11973,2.9e-05,172.31.36.0-255,66,219,8,343760
11974,3.7e-05,74.125.24.0-255,1484,1703,8,343760
11975,4.2e-05,172.31.36.0-255,66,1769,8,343760
11976,4.6e-05,74.125.24.0-255,2902,4671,8,343760
11977,4.9e-05,172.31.36.0-255,66,4737,8,343760
11978,6.4e-05,74.125.24.0-255,7156,11893,8,343760
11979,6.7e-05,172.31.36.0-255,66,11959,8,343760
11980,7.2e-05,74.125.24.0-255,2020,13979,8,343760
11981,7.4e-05,172.31.36.0-255,66,14045,8,343760
11982,0.000118,74.125.24.0-255,1484,15529,8,343760
11983,0.00012,172.31.36.0-255,66,15595,8,343760
11984,0.000152,74.125.24.0-255,2902,18497,8,343760
11985,0.000155,172.31.36.0-255,66,18563,8,343760
11986,0.000161,74.125.24.0-255,5738,24301,8,343760
11987,0.000163,172.31.36.0-255,66,24367,8,343760
11988,0.000167,74.125.24.0-255,1484,25851,8,343760
11989,0.000177,172.31.36.0-255,66,25917,8,343760
11990,0.000207,74.125.24.0-255,5379,31296,8,343760
11991,0.000211,172.31.36.0-255,66,31362,8,343760
11992,0.000388,74.125.24.0-255,1484,32846,8,343760
11993,0.000393,172.31.36.0-255,66,32912,8,343760
11994,0.000398,74.125.24.0-255,2902,35814,8,343760
11995,0.000401,172.31.36.0-255,66,35880,8,343760
11996,0.000425,74.125.24.0-255,5738,41618,8,343760
11997,0.000429,172.31.36.0-255,66,41684,8,343760
11998,0.000458,74.125.24.0-255,4320,46004,8,343760
11999,0.000461,172.31.36.0-255,66,46070,8,343760
12000,0.000498,172.31.36.0-255,66,46136,8,343760
12001,0.00053,74.125.24.0-255,7156,53292,8,343760
12002,0.000533,172.31.36.0-255,66,53358,8,343760
12003,0.000566,74.125.24.0-255,2853,56211,8,343760
12004,0.000569,172.31.36.0-255,66,56277,8,343760
12005,0.000836,74.125.24.0-255,112,56389,8,343760
12006,0.00087,172.31.36.0-255,66,56455,8,343760
12007,0.000931,74.125.24.0-255,1484,57939,8,343760
12008,0.000941,74.125.24.0-255,2902,60841,8,343760
12009,0.000944,172.31.36.0-255,66,60907,8,343760
12010,0.000952,74.125.24.0-255,5738,66645,8,343760
12011,0.000954,172.31.36.0-255,66,66711,8,343760
12012,0.000963,74.125.24.0-255,1484,68195,8,343760
12013,0.000989,74.125.24.0-255,4320,72515,8,343760
12014,0.000992,172.31.36.0-255,66,72581,8,343760
12015,0.000999,74.125.24.0-255,7156,79737,8,343760
12016,0.001001,172.31.36.0-255,66,79803,8,343760
12017,0.001032,74.125.24.0-255,5738,85541,8,343760
12018,0.001036,172.31.36.0-255,66,85607,8,343760
12019,0.001043,74.125.24.0-255,5285,90892,8,343760
12020,0.001045,172.31.36.0-255,66,90958,8,343760
12021,0.00112,74.125.24.0-255,5738,96696,8,343760
12022,0.001125,172.31.36.0-255,66,96762,8,343760
12023,0.001129,74.125.24.0-255,1484,98246,8,343760
12024,0.001147,172.31.36.0-255,66,98312,8,343760
12025,0.001183,172.31.36.0-255,66,98378,8,343760
12026,0.001231,172.31.36.0-255,66,98444,8,343760
12027,0.001437,74.125.24.0-255,1484,99928,8,343760
12028,0.001445,74.125.24.0-255,2902,102830,8,343760
12029,0.001449,172.31.36.0-255,66,102896,8,343760
12030,0.001455,74.125.24.0-255,4320,107216,8,343760
12031,0.001457,172.31.36.0-255,66,107282,8,343760
12032,0.001489,74.125.24.0-255,1484,108766,8,343760
12033,0.001506,172.31.36.0-255,66,108832,8,343760
12034,0.001545,172.31.36.0-255,66,108898,8,343760
12035,0.001643,74.125.24.0-255,1484,110382,8,343760
12036,0.001646,74.125.24.0-255,1484,111866,8,343760
12037,0.001649,172.31.36.0-255,66,111932,8,343760
12038,0.001664,74.125.24.0-255,1484,113416,8,343760
12039,0.001674,74.125.24.0-255,5738,119154,8,343760
12040,0.001679,74.125.24.0-255,5738,124892,8,343760
12041,0.001689,172.31.36.0-255,66,124958,8,343760
12042,0.001693,172.31.36.0-255,66,125024,8,343760
12043,0.001699,74.125.24.0-255,7156,132180,8,343760
12044,0.001701,172.31.36.0-255,66,132246,8,343760
12045,0.001733,74.125.24.0-255,5738,137984,8,343760
12046,0.001736,172.31.36.0-255,66,138050,8,343760
12047,0.001742,74.125.24.0-255,5020,143070,8,343760
12048,0.001745,172.31.36.0-255,66,143136,8,343760
12049,0.002053,74.125.24.0-255,1484,144620,8,343760
12050,0.00206,74.125.24.0-255,2902,147522,8,343760
12051,0.002063,172.31.36.0-255,66,147588,8,343760
12052,0.002068,74.125.24.0-255,2902,150490,8,343760
12053,0.00207,172.31.36.0-255,66,150556,8,343760
12054,0.002103,74.125.24.0-255,2902,153458,8,343760
12055,0.002106,172.31.36.0-255,66,153524,8,343760
12056,0.00211,74.125.24.0-255,2902,156426,8,343760
12057,0.002112,172.31.36.0-255,66,156492,8,343760
12058,0.002134,172.31.36.0-255,66,156558,8,343760
12059,0.002139,74.125.24.0-255,4320,160878,8,343760
12060,0.002142,172.31.36.0-255,66,160944,8,343760
12061,0.002178,74.125.24.0-255,6438,167382,8,343760
12062,0.002181,172.31.36.0-255,66,167448,8,343760
12063,0.002209,74.125.24.0-255,1484,168932,8,343760
12064,0.002226,74.125.24.0-255,2902,171834,8,343760
12065,0.00223,172.31.36.0-255,66,171900,8,343760
12066,0.002247,74.125.24.0-255,5738,177638,8,343760
12067,0.002255,172.31.36.0-255,66,177704,8,343760
12068,0.002327,172.31.36.0-255,66,177770,8,343760
12069,0.002333,74.125.24.0-255,4320,182090,8,343760
12070,0.002334,172.31.36.0-255,66,182156,8,343760
12071,0.002337,74.125.24.0-255,1484,183640,8,343760
12072,0.004599,74.125.24.0-255,4320,187960,8,343760
12073,0.004605,172.31.36.0-255,66,188026,8,343760
12074,0.006892,74.125.24.0-255,5738,193764,8,343760
12075,0.006896,172.31.36.0-255,66,193830,8,343760
12076,0.00919,74.125.24.0-255,5738,199568,8,343760
12077,0.009198,172.31.36.0-255,66,199634,8,343760
12078,0.011472,74.125.24.0-255,5738,205372,8,343760
12079,0.011478,172.31.36.0-255,66,205438,8,343760
12080,0.01379,74.125.24.0-255,5738,211176,8,343760
12081,0.013799,172.31.36.0-255,66,211242,8,343760
12082,0.01608,74.125.24.0-255,5738,216980,8,343760
12083,0.016088,172.31.36.0-255,66,217046,8,343760
12084,0.018342,74.125.24.0-255,2902,219948,8,343760
12085,0.018349,172.31.36.0-255,66,220014,8,343760
12086,0.018383,74.125.24.0-255,2902,222916,8,343760
12087,0.018387,172.31.36.0-255,66,222982,8,343760
12088,0.020635,74.125.24.0-255,2902,225884,8,343760
12089,0.020642,172.31.36.0-255,66,225950,8,343760
12090,0.020677,74.125.24.0-255,2902,228852,8,343760
12091,0.020681,172.31.36.0-255,66,228918,8,343760
12092,0.022924,74.125.24.0-255,2902,231820,8,343760
12093,0.02293,172.31.36.0-255,66,231886,8,343760
12094,0.022966,74.125.24.0-255,2902,234788,8,343760
12095,0.02297,172.31.36.0-255,66,234854,8,343760
12096,0.025212,74.125.24.0-255,2902,237756,8,343760
12097,0.02522,172.31.36.0-255,66,237822,8,343760
12098,0.025257,74.125.24.0-255,2902,240724,8,343760
12099,0.02526,172.31.36.0-255,66,240790,8,343760
12100,0.027545,74.125.24.0-255,5738,246528,8,343760
12101,0.027553,172.31.36.0-255,66,246594,8,343760
12102,0.029831,74.125.24.0-255,5738,252332,8,343760
12103,0.029838,172.31.36.0-255,66,252398,8,343760
12104,0.032113,74.125.24.0-255,5738,258136,8,343760
12105,0.032121,172.31.36.0-255,66,258202,8,343760
12106,0.034385,172.31.36.0-255,172,258374,8,343760
12107,0.034426,74.125.24.0-255,5738,264112,8,343760
12108,0.034432,172.31.36.0-255,66,264178,8,343760
12109,0.034467,172.31.36.0-255,1112,265290,8,343760
12110,0.034653,172.31.36.0-255,1514,266804,8,343760
12111,0.034655,172.31.36.0-255,1514,268318,8,343760
12112,0.03466,172.31.36.0-255,1514,269832,8,343760
12113,0.034661,172.31.36.0-255,1514,271346,8,343760
12114,0.034685,172.31.36.0-255,168,271514,8,343760
12115,0.035931,104.244.42.0-255,66,271580,8,343760
12116,0.036031,104.244.42.0-255,66,271646,8,343760
12117,0.036211,104.244.42.0-255,66,271712,8,343760
12118,0.036218,104.244.42.0-255,66,271778,8,343760
12119,0.036703,74.125.24.0-255,5738,277516,8,343760
12120,0.03671,172.31.36.0-255,66,277582,8,343760
12121,0.038967,74.125.24.0-255,5738,283320,8,343760
12122,0.038973,172.31.36.0-255,66,283386,8,343760
12123,0.041248,74.125.24.0-255,5738,289124,8,343760
12124,0.041254,172.31.36.0-255,66,289190,8,343760
12125,0.043534,74.125.24.0-255,5738,294928,8,343760
12126,0.043539,172.31.36.0-255,66,294994,8,343760
12127,0.045828,74.125.24.0-255,4320,299314,8,343760
12128,0.045834,172.31.36.0-255,66,299380,8,343760
12129,0.045865,74.125.24.0-255,1484,300864,8,343760
12130,0.048109,74.125.24.0-255,4320,305184,8,343760
12131,0.048115,172.31.36.0-255,66,305250,8,343760
12132,0.050396,74.125.24.0-255,5738,310988,8,343760
12133,0.050402,172.31.36.0-255,66,311054,8,343760
12134,0.052653,74.125.24.0-255,5738,316792,8,343760
12135,0.052659,172.31.36.0-255,66,316858,8,343760
12136,0.054956,74.125.24.0-255,5738,322596,8,343760
12137,0.054962,172.31.36.0-255,66,322662,8,343760
12138,0.057253,74.125.24.0-255,5738,328400,8,343760
12139,0.057258,172.31.36.0-255,66,328466,8,343760
12140,0.059552,74.125.24.0-255,1484,329950,8,343760
12141,0.059587,74.125.24.0-255,4320,334270,8,343760
12142,0.059591,172.31.36.0-255,66,334336,8,343760
12143,0.061866,74.125.24.0-255,5738,340074,8,343760
12144,0.061872,172.31.36.0-255,66,340140,8,343760
12145,0.064179,74.125.24.0-255,3383,343523,8,343760
12146,0.064184,172.31.36.0-255,66,343589,8,343760
12147,0.065037,172.31.36.0-255,105,343694,8,343760
12148,0.067272,74.125.24.0-255,66,343760,8,343760
12149,0.0,172.217.194.0-255,153,153,8,227546
12150,2.2e-05,172.31.36.0-255,66,219,8,227546
12151,2.8e-05,172.217.194.0-255,1484,1703,8,227546
12152,3.2e-05,172.31.36.0-255,66,1769,8,227546
12153,3.7e-05,172.217.194.0-255,2902,4671,8,227546
12154,5e-05,172.31.36.0-255,66,4737,8,227546
12155,5.8e-05,172.217.194.0-255,7156,11893,8,227546
12156,6e-05,172.31.36.0-255,66,11959,8,227546
12157,6.6e-05,172.217.194.0-255,4901,16860,8,227546
12158,6.9e-05,172.31.36.0-255,66,16926,8,227546
12159,7.5e-05,172.217.194.0-255,5738,22664,8,227546
12160,7.7e-05,172.31.36.0-255,66,22730,8,227546
12161,0.000115,172.31.36.0-255,66,22796,8,227546
12162,0.000224,172.217.194.0-255,1484,24280,8,227546
12163,0.000228,172.31.36.0-255,66,24346,8,227546
12164,0.000234,172.217.194.0-255,2902,27248,8,227546
12165,0.000236,172.31.36.0-255,66,27314,8,227546
12166,0.000277,172.217.194.0-255,5738,33052,8,227546
12167,0.000279,172.31.36.0-255,66,33118,8,227546
12168,0.000284,172.217.194.0-255,4320,37438,8,227546
12169,0.000286,172.31.36.0-255,66,37504,8,227546
12170,0.000322,172.31.36.0-255,66,37570,8,227546
12171,0.000333,172.31.36.0-255,66,37636,8,227546
12172,0.000358,172.217.194.0-255,98,37734,8,227546
12173,0.00036,172.31.36.0-255,66,37800,8,227546
12174,0.0004,172.217.194.0-255,1484,39284,8,227546
12175,0.000402,172.31.36.0-255,66,39350,8,227546
12176,0.000426,172.217.194.0-255,2902,42252,8,227546
12177,0.000428,172.31.36.0-255,66,42318,8,227546
12178,0.000433,172.217.194.0-255,4320,46638,8,227546
12179,0.000435,172.31.36.0-255,66,46704,8,227546
12180,0.000456,172.217.194.0-255,2902,49606,8,227546
12181,0.000462,172.31.36.0-255,66,49672,8,227546
12182,0.000469,172.217.194.0-255,5098,54770,8,227546
12183,0.000471,172.31.36.0-255,66,54836,8,227546
12184,0.000837,172.217.194.0-255,1484,56320,8,227546
12185,0.000843,172.217.194.0-255,1484,57804,8,227546
12186,0.000846,172.31.36.0-255,66,57870,8,227546
12187,0.000878,172.217.194.0-255,1484,59354,8,227546
12188,0.000883,172.217.194.0-255,4320,63674,8,227546
12189,0.000885,172.31.36.0-255,66,63740,8,227546
12190,0.000895,172.31.36.0-255,66,63806,8,227546
12191,0.000935,172.31.36.0-255,66,63872,8,227546
12192,0.001757,172.217.194.0-255,1484,65356,8,227546
12193,0.001766,172.217.194.0-255,2902,68258,8,227546
12194,0.00177,172.31.36.0-255,66,68324,8,227546
12195,0.001803,172.217.194.0-255,4320,72644,8,227546
12196,0.001805,172.31.36.0-255,66,72710,8,227546
12197,0.001813,172.217.194.0-255,7156,79866,8,227546
12198,0.001815,172.31.36.0-255,66,79932,8,227546
12199,0.001831,172.217.194.0-255,1484,81416,8,227546
12200,0.001835,172.217.194.0-255,2902,84318,8,227546
12201,0.001837,172.31.36.0-255,66,84384,8,227546
12202,0.001872,172.31.36.0-255,66,84450,8,227546
12203,0.004524,172.217.194.0-255,5738,90188,8,227546
12204,0.004531,172.31.36.0-255,66,90254,8,227546
12205,0.007214,172.217.194.0-255,5738,95992,8,227546
12206,0.007221,172.31.36.0-255,66,96058,8,227546
12207,0.009922,172.217.194.0-255,5738,101796,8,227546
12208,0.009929,172.31.36.0-255,66,101862,8,227546
12209,0.012596,172.217.194.0-255,5738,107600,8,227546
12210,0.012612,172.31.36.0-255,66,107666,8,227546
12211,0.015311,172.217.194.0-255,5738,113404,8,227546
12212,0.015321,172.31.36.0-255,66,113470,8,227546
12213,0.018009,172.217.194.0-255,5738,119208,8,227546
12214,0.018029,172.31.36.0-255,66,119274,8,227546
12215,0.020742,172.217.194.0-255,5738,125012,8,227546
12216,0.020755,172.31.36.0-255,66,125078,8,227546
12217,0.023434,172.217.194.0-255,5738,130816,8,227546
12218,0.023446,172.31.36.0-255,66,130882,8,227546
12219,0.026112,172.217.194.0-255,4320,135202,8,227546
12220,0.026116,172.31.36.0-255,66,135268,8,227546
12221,0.026142,172.217.194.0-255,1484,136752,8,227546
12222,0.028773,172.217.194.0-255,4320,141072,8,227546
12223,0.028782,172.31.36.0-255,66,141138,8,227546
12224,0.031466,172.217.194.0-255,5738,146876,8,227546
12225,0.031477,172.31.36.0-255,66,146942,8,227546
12226,0.034168,172.217.194.0-255,5738,152680,8,227546
12227,0.034177,172.31.36.0-255,66,152746,8,227546
12228,0.036829,172.217.194.0-255,5738,158484,8,227546
12229,0.036837,172.31.36.0-255,66,158550,8,227546
12230,0.037771,172.31.36.0-255,172,158722,8,227546
12231,0.037815,172.31.36.0-255,1111,159833,8,227546
12232,0.037932,172.31.36.0-255,571,160404,8,227546
12233,0.039314,104.244.42.0-255,66,160470,8,227546
12234,0.039414,104.244.42.0-255,66,160536,8,227546
12235,0.039476,104.244.42.0-255,66,160602,8,227546
12236,0.039489,172.217.194.0-255,4320,164922,8,227546
12237,0.039493,172.31.36.0-255,66,164988,8,227546
12238,0.039528,172.217.194.0-255,1484,166472,8,227546
12239,0.042146,172.217.194.0-255,4320,170792,8,227546
12240,0.042151,172.31.36.0-255,66,170858,8,227546
12241,0.044834,172.217.194.0-255,5738,176596,8,227546
12242,0.044842,172.31.36.0-255,66,176662,8,227546
12243,0.047533,172.217.194.0-255,4320,180982,8,227546
12244,0.04754,172.31.36.0-255,66,181048,8,227546
12245,0.047572,172.217.194.0-255,1484,182532,8,227546
12246,0.050266,172.217.194.0-255,4320,186852,8,227546
12247,0.05028,172.31.36.0-255,66,186918,8,227546
12248,0.05294,172.217.194.0-255,5738,192656,8,227546
12249,0.052949,172.31.36.0-255,66,192722,8,227546
12250,0.055636,172.217.194.0-255,5738,198460,8,227546
12251,0.055647,172.31.36.0-255,66,198526,8,227546
12252,0.058323,172.217.194.0-255,5738,204264,8,227546
12253,0.058332,172.31.36.0-255,66,204330,8,227546
12254,0.061009,172.217.194.0-255,5738,210068,8,227546
12255,0.061018,172.31.36.0-255,66,210134,8,227546
12256,0.063713,172.217.194.0-255,5738,215872,8,227546
12257,0.063719,172.31.36.0-255,66,215938,8,227546
12258,0.066394,172.217.194.0-255,5738,221676,8,227546
12259,0.0664,172.31.36.0-255,66,221742,8,227546
12260,0.069086,172.217.194.0-255,5738,227480,8,227546
12261,0.069092,172.31.36.0-255,66,227546,8,227546
12262,0.0,172.217.194.0-255,296,296,8,273022
12263,3.3e-05,172.31.36.0-255,66,362,8,273022
12264,4e-05,172.217.194.0-255,1484,1846,8,273022
12265,4.5e-05,172.31.36.0-255,66,1912,8,273022
12266,5.1e-05,172.217.194.0-255,4320,6232,8,273022
12267,5.4e-05,172.31.36.0-255,66,6298,8,273022
12268,5.9e-05,172.217.194.0-255,4320,10618,8,273022
12269,6.2e-05,172.31.36.0-255,66,10684,8,273022
12270,0.000109,172.217.194.0-255,3191,13875,8,273022
12271,0.000112,172.31.36.0-255,66,13941,8,273022
12272,0.000152,172.217.194.0-255,1484,15425,8,273022
12273,0.000156,172.31.36.0-255,66,15491,8,273022
12274,0.000162,172.217.194.0-255,2902,18393,8,273022
12275,0.000164,172.31.36.0-255,66,18459,8,273022
12276,0.000184,172.217.194.0-255,5738,24197,8,273022
12277,0.000187,172.31.36.0-255,66,24263,8,273022
12278,0.000217,172.31.36.0-255,66,24329,8,273022
12279,0.000237,172.217.194.0-255,3961,28290,8,273022
12280,0.000239,172.31.36.0-255,66,28356,8,273022
12281,0.000252,172.31.36.0-255,66,28422,8,273022
12282,0.000292,172.217.194.0-255,5738,34160,8,273022
12283,0.000296,172.31.36.0-255,66,34226,8,273022
12284,0.000322,172.31.36.0-255,66,34292,8,273022
12285,0.000394,172.217.194.0-255,119,34411,8,273022
12286,0.000398,172.31.36.0-255,66,34477,8,273022
12287,0.000615,172.217.194.0-255,1484,35961,8,273022
12288,0.000619,172.31.36.0-255,66,36027,8,273022
12289,0.000625,172.217.194.0-255,2902,38929,8,273022
12290,0.000628,172.31.36.0-255,66,38995,8,273022
12291,0.000634,172.217.194.0-255,5738,44733,8,273022
12292,0.000636,172.31.36.0-255,66,44799,8,273022
12293,0.000642,172.217.194.0-255,4320,49119,8,273022
12294,0.000645,172.31.36.0-255,66,49185,8,273022
12295,0.000676,172.31.36.0-255,66,49251,8,273022
12296,0.000689,172.31.36.0-255,66,49317,8,273022
12297,0.001571,172.217.194.0-255,1484,50801,8,273022
12298,0.001604,172.217.194.0-255,2902,53703,8,273022
12299,0.00161,172.31.36.0-255,66,53769,8,273022
12300,0.001617,172.217.194.0-255,5738,59507,8,273022
12301,0.001619,172.31.36.0-255,66,59573,8,273022
12302,0.001624,172.217.194.0-255,4320,63893,8,273022
12303,0.001625,172.31.36.0-255,66,63959,8,273022
12304,0.001683,172.31.36.0-255,66,64025,8,273022
12305,0.001686,172.217.194.0-255,1484,65509,8,273022
12306,0.001705,172.217.194.0-255,2184,67693,8,273022
12307,0.001709,172.31.36.0-255,66,67759,8,273022
12308,0.002005,172.217.194.0-255,1484,69243,8,273022
12309,0.002012,172.217.194.0-255,2902,72145,8,273022
12310,0.002015,172.31.36.0-255,66,72211,8,273022
12311,0.002031,172.217.194.0-255,1484,73695,8,273022
12312,0.002046,172.217.194.0-255,4320,78015,8,273022
12313,0.002048,172.31.36.0-255,66,78081,8,273022
12314,0.002074,172.31.36.0-255,66,78147,8,273022
12315,0.002101,172.217.194.0-255,2902,81049,8,273022
12316,0.002115,172.31.36.0-255,66,81115,8,273022
12317,0.002118,172.31.36.0-255,66,81181,8,273022
12318,0.00214,172.217.194.0-255,1484,82665,8,273022
12319,0.002158,172.217.194.0-255,7156,89821,8,273022
12320,0.002161,172.31.36.0-255,66,89887,8,273022
12321,0.002192,172.31.36.0-255,66,89953,8,273022
12322,0.002232,172.217.194.0-255,4320,94273,8,273022
12323,0.002235,172.31.36.0-255,66,94339,8,273022
12324,0.002271,172.31.36.0-255,66,94405,8,273022
12325,0.002291,172.217.194.0-255,766,95171,8,273022
12326,0.002297,172.217.194.0-255,4320,99491,8,273022
12327,0.0023,172.31.36.0-255,66,99557,8,273022
12328,0.002333,172.31.36.0-255,66,99623,8,273022
12329,0.002353,172.217.194.0-255,4320,103943,8,273022
12330,0.002355,172.31.36.0-255,66,104009,8,273022
12331,0.002358,172.217.194.0-255,766,104775,8,273022
12332,0.002362,172.217.194.0-255,1484,106259,8,273022
12333,0.002363,172.31.36.0-255,66,106325,8,273022
12334,0.002402,172.31.36.0-255,66,106391,8,273022
12335,0.004711,172.217.194.0-255,5738,112129,8,273022
12336,0.004721,172.31.36.0-255,66,112195,8,273022
12337,0.007028,172.217.194.0-255,5738,117933,8,273022
12338,0.00705,172.31.36.0-255,66,117999,8,273022
12339,0.009376,172.217.194.0-255,5738,123737,8,273022
12340,0.009396,172.31.36.0-255,66,123803,8,273022
12341,0.011726,172.217.194.0-255,5738,129541,8,273022
12342,0.011752,172.31.36.0-255,66,129607,8,273022
12343,0.014073,172.217.194.0-255,5738,135345,8,273022
12344,0.014092,172.31.36.0-255,66,135411,8,273022
12345,0.016395,172.217.194.0-255,5738,141149,8,273022
12346,0.016411,172.31.36.0-255,66,141215,8,273022
12347,0.018728,172.217.194.0-255,5738,146953,8,273022
12348,0.018747,172.31.36.0-255,66,147019,8,273022
12349,0.021067,172.217.194.0-255,5738,152757,8,273022
12350,0.021086,172.31.36.0-255,66,152823,8,273022
12351,0.023456,172.217.194.0-255,5738,158561,8,273022
12352,0.023475,172.31.36.0-255,66,158627,8,273022
12353,0.025784,172.217.194.0-255,5738,164365,8,273022
12354,0.025801,172.31.36.0-255,66,164431,8,273022
12355,0.028137,172.217.194.0-255,5738,170169,8,273022
12356,0.028158,172.31.36.0-255,66,170235,8,273022
12357,0.030492,172.217.194.0-255,5738,175973,8,273022
12358,0.030514,172.31.36.0-255,66,176039,8,273022
12359,0.03282,172.217.194.0-255,5738,181777,8,273022
12360,0.032836,172.31.36.0-255,66,181843,8,273022
12361,0.034968,172.31.36.0-255,172,182015,8,273022
12362,0.034996,172.31.36.0-255,1111,183126,8,273022
12363,0.035036,172.31.36.0-255,571,183697,8,273022
12364,0.035133,172.217.194.0-255,5738,189435,8,273022
12365,0.03514,172.31.36.0-255,66,189501,8,273022
12366,0.036514,104.244.42.0-255,66,189567,8,273022
12367,0.036545,104.244.42.0-255,66,189633,8,273022
12368,0.036587,104.244.42.0-255,66,189699,8,273022
12369,0.037409,172.217.194.0-255,4320,194019,8,273022
12370,0.037413,172.31.36.0-255,66,194085,8,273022
12371,0.037444,172.217.194.0-255,1484,195569,8,273022
12372,0.039694,172.217.194.0-255,4320,199889,8,273022
12373,0.0397,172.31.36.0-255,66,199955,8,273022
12374,0.041999,172.217.194.0-255,5738,205693,8,273022
12375,0.042007,172.31.36.0-255,66,205759,8,273022
12376,0.044265,172.217.194.0-255,2902,208661,8,273022
12377,0.044271,172.31.36.0-255,66,208727,8,273022
12378,0.0443,172.217.194.0-255,2902,211629,8,273022
12379,0.044304,172.31.36.0-255,66,211695,8,273022
12380,0.046559,172.217.194.0-255,2902,214597,8,273022
12381,0.046565,172.31.36.0-255,66,214663,8,273022
12382,0.046596,172.217.194.0-255,2902,217565,8,273022
12383,0.046599,172.31.36.0-255,66,217631,8,273022
12384,0.048828,172.217.194.0-255,2902,220533,8,273022
12385,0.048834,172.31.36.0-255,66,220599,8,273022
12386,0.048868,172.217.194.0-255,2902,223501,8,273022
12387,0.048872,172.31.36.0-255,66,223567,8,273022
12388,0.051124,172.217.194.0-255,2902,226469,8,273022
12389,0.05113,172.31.36.0-255,66,226535,8,273022
12390,0.051165,172.217.194.0-255,2902,229437,8,273022
12391,0.051168,172.31.36.0-255,66,229503,8,273022
12392,0.053427,172.217.194.0-255,2902,232405,8,273022
12393,0.053433,172.31.36.0-255,66,232471,8,273022
12394,0.053494,172.217.194.0-255,2902,235373,8,273022
12395,0.053499,172.31.36.0-255,66,235439,8,273022
12396,0.055715,172.217.194.0-255,2902,238341,8,273022
12397,0.055721,172.31.36.0-255,66,238407,8,273022
12398,0.055789,172.217.194.0-255,2902,241309,8,273022
12399,0.055794,172.31.36.0-255,66,241375,8,273022
12400,0.058001,172.217.194.0-255,1484,242859,8,273022
12401,0.058066,172.217.194.0-255,4320,247179,8,273022
12402,0.058071,172.31.36.0-255,66,247245,8,273022
12403,0.060382,172.217.194.0-255,5738,252983,8,273022
12404,0.060387,172.31.36.0-255,66,253049,8,273022
12405,0.062698,172.217.194.0-255,5738,258787,8,273022
12406,0.062704,172.31.36.0-255,66,258853,8,273022
12407,0.065025,172.217.194.0-255,4320,263173,8,273022
12408,0.06503,172.31.36.0-255,66,263239,8,273022
12409,0.06506,172.217.194.0-255,1484,264723,8,273022
12410,0.067331,172.217.194.0-255,4320,269043,8,273022
12411,0.067337,172.31.36.0-255,66,269109,8,273022
12412,0.069634,172.217.194.0-255,3742,272851,8,273022
12413,0.06964,172.31.36.0-255,66,272917,8,273022
12414,0.069838,172.31.36.0-255,105,273022,8,273022
12415,0.0,74.125.24.0-255,153,153,8,187246
12416,2.5e-05,172.31.36.0-255,66,219,8,187246
12417,3e-05,74.125.24.0-255,1484,1703,8,187246
12418,3.5e-05,172.31.36.0-255,66,1769,8,187246
12419,4.9e-05,74.125.24.0-255,2902,4671,8,187246
12420,5.1e-05,172.31.36.0-255,66,4737,8,187246
12421,5.4e-05,74.125.24.0-255,1484,6221,8,187246
12422,5.7e-05,172.31.36.0-255,66,6287,8,187246
12423,8e-05,74.125.24.0-255,1484,7771,8,187246
12424,8.2e-05,172.31.36.0-255,66,7837,8,187246
12425,0.000114,74.125.24.0-255,2902,10739,8,187246
12426,0.000117,172.31.36.0-255,66,10805,8,187246
12427,0.000136,74.125.24.0-255,3522,14327,8,187246
12428,0.000139,172.31.36.0-255,66,14393,8,187246
12429,0.000305,74.125.24.0-255,1484,15877,8,187246
12430,0.000309,172.31.36.0-255,66,15943,8,187246
12431,0.000329,74.125.24.0-255,2902,18845,8,187246
12432,0.000333,172.31.36.0-255,66,18911,8,187246
12433,0.000337,74.125.24.0-255,1484,20395,8,187246
12434,0.000339,172.31.36.0-255,66,20461,8,187246
12435,0.000366,74.125.24.0-255,4320,24781,8,187246
12436,0.00037,172.31.36.0-255,66,24847,8,187246
12437,0.0004,74.125.24.0-255,2902,27749,8,187246
12438,0.000403,172.31.36.0-255,66,27815,8,187246
12439,0.000417,74.125.24.0-255,3961,31776,8,187246
12440,0.000421,172.31.36.0-255,66,31842,8,187246
12441,0.000519,74.125.24.0-255,1484,33326,8,187246
12442,0.000523,172.31.36.0-255,66,33392,8,187246
12443,0.000528,74.125.24.0-255,2902,36294,8,187246
12444,0.00053,172.31.36.0-255,66,36360,8,187246
12445,0.000597,74.125.24.0-255,5738,42098,8,187246
12446,0.000601,172.31.36.0-255,66,42164,8,187246
12447,0.000626,172.31.36.0-255,66,42230,8,187246
12448,0.000649,74.125.24.0-255,5379,47609,8,187246
12449,0.000652,172.31.36.0-255,66,47675,8,187246
12450,0.000656,74.125.24.0-255,2902,50577,8,187246
12451,0.00066,172.31.36.0-255,66,50643,8,187246
12452,0.000667,74.125.24.0-255,7068,57711,8,187246
12453,0.00067,172.31.36.0-255,66,57777,8,187246
12454,0.000781,74.125.24.0-255,135,57912,8,187246
12455,0.000849,172.31.36.0-255,66,57978,8,187246
12456,0.000898,74.125.24.0-255,1484,59462,8,187246
12457,0.000906,74.125.24.0-255,1484,60946,8,187246
12458,0.000909,172.31.36.0-255,66,61012,8,187246
12459,0.000924,74.125.24.0-255,1484,62496,8,187246
12460,0.000935,74.125.24.0-255,1484,63980,8,187246
12461,0.000937,172.31.36.0-255,66,64046,8,187246
12462,0.000957,74.125.24.0-255,4320,68366,8,187246
12463,0.00096,172.31.36.0-255,66,68432,8,187246
12464,0.000974,172.31.36.0-255,66,68498,8,187246
12465,0.001005,74.125.24.0-255,2902,71400,8,187246
12466,0.001008,172.31.36.0-255,66,71466,8,187246
12467,0.001032,172.31.36.0-255,66,71532,8,187246
12468,0.001294,74.125.24.0-255,1484,73016,8,187246
12469,0.001301,74.125.24.0-255,2902,75918,8,187246
12470,0.001305,172.31.36.0-255,66,75984,8,187246
12471,0.001311,74.125.24.0-255,4320,80304,8,187246
12472,0.001313,172.31.36.0-255,66,80370,8,187246
12473,0.001325,74.125.24.0-255,1484,81854,8,187246
12474,0.001337,172.31.36.0-255,66,81920,8,187246
12475,0.001364,74.125.24.0-255,4320,86240,8,187246
12476,0.001369,172.31.36.0-255,66,86306,8,187246
12477,0.001382,172.31.36.0-255,66,86372,8,187246
12478,0.001407,74.125.24.0-255,7156,93528,8,187246
12479,0.00141,172.31.36.0-255,66,93594,8,187246
12480,0.001441,172.31.36.0-255,66,93660,8,187246
12481,0.001444,74.125.24.0-255,1484,95144,8,187246
12482,0.001478,172.31.36.0-255,66,95210,8,187246
12483,0.001497,74.125.24.0-255,4320,99530,8,187246
12484,0.001499,172.31.36.0-255,66,99596,8,187246
12485,0.001517,74.125.24.0-255,4320,103916,8,187246
12486,0.00152,172.31.36.0-255,66,103982,8,187246
12487,0.001531,172.31.36.0-255,66,104048,8,187246
12488,0.001564,74.125.24.0-255,2902,106950,8,187246
12489,0.001566,172.31.36.0-255,66,107016,8,187246
12490,0.001595,172.31.36.0-255,66,107082,8,187246
12491,0.001624,74.125.24.0-255,1484,108566,8,187246
12492,0.001629,74.125.24.0-255,2902,111468,8,187246
12493,0.001631,172.31.36.0-255,66,111534,8,187246
12494,0.001654,74.125.24.0-255,5738,117272,8,187246
12495,0.001656,172.31.36.0-255,66,117338,8,187246
12496,0.001663,74.125.24.0-255,7156,124494,8,187246
12497,0.001665,172.31.36.0-255,66,124560,8,187246
12498,0.001706,172.31.36.0-255,66,124626,8,187246
12499,0.001727,74.125.24.0-255,1484,126110,8,187246
12500,0.001747,172.31.36.0-255,66,126176,8,187246
12501,0.001751,74.125.24.0-255,2902,129078,8,187246
12502,0.001753,172.31.36.0-255,66,129144,8,187246
12503,0.001778,74.125.24.0-255,7156,136300,8,187246
12504,0.001781,172.31.36.0-255,66,136366,8,187246
12505,0.001834,172.31.36.0-255,66,136432,8,187246
12506,0.001853,74.125.24.0-255,766,137198,8,187246
12507,0.001857,74.125.24.0-255,1484,138682,8,187246
12508,0.001859,172.31.36.0-255,66,138748,8,187246
12509,0.001863,74.125.24.0-255,2902,141650,8,187246
12510,0.001865,172.31.36.0-255,66,141716,8,187246
12511,0.00188,74.125.24.0-255,5738,147454,8,187246
12512,0.001882,172.31.36.0-255,66,147520,8,187246
12513,0.001916,74.125.24.0-255,5738,153258,8,187246
12514,0.001919,172.31.36.0-255,66,153324,8,187246
12515,0.001946,74.125.24.0-255,7156,160480,8,187246
12516,0.001948,172.31.36.0-255,66,160546,8,187246
12517,0.001952,74.125.24.0-255,2902,163448,8,187246
12518,0.001954,172.31.36.0-255,66,163514,8,187246
12519,0.001975,172.31.36.0-255,66,163580,8,187246
12520,0.00199,74.125.24.0-255,1484,165064,8,187246
12521,0.001994,74.125.24.0-255,2902,167966,8,187246
12522,0.001996,172.31.36.0-255,66,168032,8,187246
12523,0.00202,74.125.24.0-255,5738,173770,8,187246
12524,0.002023,172.31.36.0-255,66,173836,8,187246
12525,0.002044,74.125.24.0-255,5738,179574,8,187246
12526,0.002046,172.31.36.0-255,66,179640,8,187246
12527,0.002056,172.31.36.0-255,66,179706,8,187246
12528,0.002075,74.125.24.0-255,4320,184026,8,187246
12529,0.002076,172.31.36.0-255,66,184092,8,187246
12530,0.002089,172.31.36.0-255,66,184158,8,187246
12531,0.002121,172.31.36.0-255,66,184224,8,187246
12532,0.002134,172.31.36.0-255,66,184290,8,187246
12533,0.002164,172.31.36.0-255,66,184356,8,187246
12534,0.002177,172.31.36.0-255,66,184422,8,187246
12535,0.002187,74.125.24.0-255,1484,185906,8,187246
12536,0.002211,172.31.36.0-255,66,185972,8,187246
12537,0.002234,172.31.36.0-255,66,186038,8,187246
12538,0.00439,74.125.24.0-255,105,186143,8,187246
12539,0.009342,172.31.36.0-255,66,186209,8,187246
12540,0.009377,172.31.36.0-255,105,186314,8,187246
12541,0.011571,74.125.24.0-255,66,186380,8,187246
12542,0.033649,172.31.36.0-255,172,186552,8,187246
12543,0.033679,172.31.36.0-255,562,187114,8,187246
12544,0.035187,104.244.42.0-255,66,187180,8,187246
12545,0.035195,104.244.42.0-255,66,187246,8,187246
12546,0.0,74.125.130.0-255,153,153,8,377950
12547,2.9e-05,172.31.36.0-255,66,219,8,377950
12548,3.6e-05,74.125.130.0-255,1484,1703,8,377950
12549,4e-05,172.31.36.0-255,66,1769,8,377950
12550,4.5e-05,74.125.130.0-255,2902,4671,8,377950
12551,4.8e-05,172.31.36.0-255,66,4737,8,377950
12552,5.4e-05,74.125.130.0-255,5738,10475,8,377950
12553,5.6e-05,172.31.36.0-255,66,10541,8,377950
12554,6.1e-05,74.125.130.0-255,2902,13443,8,377950
12555,6.4e-05,172.31.36.0-255,66,13509,8,377950
12556,9.8e-05,74.125.130.0-255,729,14238,8,377950
12557,0.000101,172.31.36.0-255,66,14304,8,377950
12558,0.00016,74.125.130.0-255,1484,15788,8,377950
12559,0.000164,172.31.36.0-255,66,15854,8,377950
12560,0.000167,74.125.130.0-255,1484,17338,8,377950
12561,0.00017,172.31.36.0-255,66,17404,8,377950
12562,0.000183,74.125.130.0-255,1484,18888,8,377950
12563,0.000186,172.31.36.0-255,66,18954,8,377950
12564,0.000191,74.125.130.0-255,4320,23274,8,377950
12565,0.000194,172.31.36.0-255,66,23340,8,377950
12566,0.000212,74.125.130.0-255,1484,24824,8,377950
12567,0.000214,172.31.36.0-255,66,24890,8,377950
12568,0.000222,74.125.130.0-255,6797,31687,8,377950
12569,0.000224,172.31.36.0-255,66,31753,8,377950
12570,0.000525,74.125.130.0-255,1484,33237,8,377950
12571,0.000529,172.31.36.0-255,66,33303,8,377950
12572,0.000536,74.125.130.0-255,2902,36205,8,377950
12573,0.000539,172.31.36.0-255,66,36271,8,377950
12574,0.000546,74.125.130.0-255,5738,42009,8,377950
12575,0.000548,172.31.36.0-255,66,42075,8,377950
12576,0.000587,74.125.130.0-255,2902,44977,8,377950
12577,0.00059,172.31.36.0-255,66,45043,8,377950
12578,0.000615,74.125.130.0-255,3961,49004,8,377950
12579,0.000618,172.31.36.0-255,66,49070,8,377950
12580,0.000625,74.125.130.0-255,7156,56226,8,377950
12581,0.000628,172.31.36.0-255,66,56292,8,377950
12582,0.000632,74.125.130.0-255,4320,60612,8,377950
12583,0.000635,172.31.36.0-255,66,60678,8,377950
12584,0.000663,74.125.130.0-255,5379,66057,8,377950
12585,0.000666,172.31.36.0-255,66,66123,8,377950
12586,0.001079,74.125.130.0-255,646,66769,8,377950
12587,0.001348,74.125.130.0-255,1484,68253,8,377950
12588,0.001355,172.31.36.0-255,66,68319,8,377950
12589,0.001361,74.125.130.0-255,2902,71221,8,377950
12590,0.001363,172.31.36.0-255,66,71287,8,377950
12591,0.00137,74.125.130.0-255,5738,77025,8,377950
12592,0.001372,172.31.36.0-255,66,77091,8,377950
12593,0.001417,74.125.130.0-255,2902,79993,8,377950
12594,0.00142,172.31.36.0-255,66,80059,8,377950
12595,0.001425,74.125.130.0-255,4320,84379,8,377950
12596,0.001427,172.31.36.0-255,66,84445,8,377950
12597,0.001432,74.125.130.0-255,2902,87347,8,377950
12598,0.001435,172.31.36.0-255,66,87413,8,377950
12599,0.001458,74.125.130.0-255,5738,93151,8,377950
12600,0.001463,172.31.36.0-255,66,93217,8,377950
12601,0.001477,74.125.130.0-255,1484,94701,8,377950
12602,0.001492,74.125.130.0-255,6438,101139,8,377950
12603,0.001494,172.31.36.0-255,66,101205,8,377950
12604,0.001583,74.125.130.0-255,1484,102689,8,377950
12605,0.001586,74.125.130.0-255,1484,104173,8,377950
12606,0.001588,172.31.36.0-255,66,104239,8,377950
12607,0.001602,74.125.130.0-255,1484,105723,8,377950
12608,0.001608,74.125.130.0-255,4320,110043,8,377950
12609,0.00161,172.31.36.0-255,66,110109,8,377950
12610,0.001633,74.125.130.0-255,1484,111593,8,377950
12611,0.001636,74.125.130.0-255,1484,113077,8,377950
12612,0.001638,172.31.36.0-255,66,113143,8,377950
12613,0.001666,172.31.36.0-255,66,113209,8,377950
12614,0.001673,74.125.130.0-255,7156,120365,8,377950
12615,0.001675,172.31.36.0-255,66,120431,8,377950
12616,0.001704,74.125.130.0-255,4320,124751,8,377950
12617,0.001706,172.31.36.0-255,66,124817,8,377950
12618,0.001717,172.31.36.0-255,66,124883,8,377950
12619,0.001729,172.31.36.0-255,66,124949,8,377950
12620,0.001755,172.31.36.0-255,66,125015,8,377950
12621,0.001793,74.125.130.0-255,1484,126499,8,377950
12622,0.001796,74.125.130.0-255,1484,127983,8,377950
12623,0.001799,172.31.36.0-255,66,128049,8,377950
12624,0.001818,74.125.130.0-255,1484,129533,8,377950
12625,0.001824,74.125.130.0-255,5738,135271,8,377950
12626,0.001826,172.31.36.0-255,66,135337,8,377950
12627,0.001831,74.125.130.0-255,4320,139657,8,377950
12628,0.001833,172.31.36.0-255,66,139723,8,377950
12629,0.001848,74.125.130.0-255,5738,145461,8,377950
12630,0.00185,172.31.36.0-255,66,145527,8,377950
12631,0.001855,74.125.130.0-255,4320,149847,8,377950
12632,0.001858,172.31.36.0-255,66,149913,8,377950
12633,0.001888,74.125.130.0-255,7156,157069,8,377950
12634,0.00189,172.31.36.0-255,66,157135,8,377950
12635,0.001894,74.125.130.0-255,2184,159319,8,377950
12636,0.001897,172.31.36.0-255,66,159385,8,377950
12637,0.001946,74.125.130.0-255,1484,160869,8,377950
12638,0.001958,74.125.130.0-255,2902,163771,8,377950
12639,0.00196,172.31.36.0-255,66,163837,8,377950
12640,0.001963,74.125.130.0-255,1484,165321,8,377950
12641,0.001982,74.125.130.0-255,4320,169641,8,377950
12642,0.001985,172.31.36.0-255,66,169707,8,377950
12643,0.001988,74.125.130.0-255,2902,172609,8,377950
12644,0.00199,172.31.36.0-255,66,172675,8,377950
12645,0.003926,74.125.130.0-255,5738,178413,8,377950
12646,0.003933,172.31.36.0-255,66,178479,8,377950
12647,0.005882,74.125.130.0-255,2902,181381,8,377950
12648,0.005885,172.31.36.0-255,66,181447,8,377950
12649,0.005905,74.125.130.0-255,2902,184349,8,377950
12650,0.005907,172.31.36.0-255,66,184415,8,377950
12651,0.007846,74.125.130.0-255,2902,187317,8,377950
12652,0.007854,172.31.36.0-255,66,187383,8,377950
12653,0.007887,74.125.130.0-255,2902,190285,8,377950
12654,0.00789,172.31.36.0-255,66,190351,8,377950
12655,0.009805,74.125.130.0-255,2902,193253,8,377950
12656,0.009813,172.31.36.0-255,66,193319,8,377950
12657,0.009835,74.125.130.0-255,2902,196221,8,377950
12658,0.009838,172.31.36.0-255,66,196287,8,377950
12659,0.011806,74.125.130.0-255,5738,202025,8,377950
12660,0.011817,172.31.36.0-255,66,202091,8,377950
12661,0.013813,74.125.130.0-255,5738,207829,8,377950
12662,0.013822,172.31.36.0-255,66,207895,8,377950
12663,0.015895,74.125.130.0-255,5738,213633,8,377950
12664,0.015908,172.31.36.0-255,66,213699,8,377950
12665,0.017923,74.125.130.0-255,5738,219437,8,377950
12666,0.017935,172.31.36.0-255,66,219503,8,377950
12667,0.019928,74.125.130.0-255,5738,225241,8,377950
12668,0.019939,172.31.36.0-255,66,225307,8,377950
12669,0.021929,74.125.130.0-255,5738,231045,8,377950
12670,0.021939,172.31.36.0-255,66,231111,8,377950
12671,0.023896,74.125.130.0-255,5738,236849,8,377950
12672,0.023907,172.31.36.0-255,66,236915,8,377950
12673,0.02591,74.125.130.0-255,5738,242653,8,377950
12674,0.025918,172.31.36.0-255,66,242719,8,377950
12675,0.026686,172.31.36.0-255,172,242891,8,377950
12676,0.026714,172.31.36.0-255,1111,244002,8,377950
12677,0.026769,172.31.36.0-255,1514,245516,8,377950
12678,0.026771,172.31.36.0-255,1514,247030,8,377950
12679,0.026773,172.31.36.0-255,1514,248544,8,377950
12680,0.026774,172.31.36.0-255,1514,250058,8,377950
12681,0.026803,172.31.36.0-255,1358,251416,8,377950
12682,0.027891,74.125.130.0-255,5738,257154,8,377950
12683,0.027899,172.31.36.0-255,66,257220,8,377950
12684,0.028985,104.244.42.0-255,66,257286,8,377950
12685,0.029853,74.125.130.0-255,5738,263024,8,377950
12686,0.029857,172.31.36.0-255,66,263090,8,377950
12687,0.031843,74.125.130.0-255,5738,268828,8,377950
12688,0.031853,172.31.36.0-255,66,268894,8,377950
12689,0.033837,74.125.130.0-255,5738,274632,8,377950
12690,0.03385,172.31.36.0-255,66,274698,8,377950
12691,0.035815,74.125.130.0-255,5738,280436,8,377950
12692,0.035828,172.31.36.0-255,66,280502,8,377950
12693,0.037804,74.125.130.0-255,5738,286240,8,377950
12694,0.037817,172.31.36.0-255,66,286306,8,377950
12695,0.039766,74.125.130.0-255,5738,292044,8,377950
12696,0.039796,172.31.36.0-255,66,292110,8,377950
12697,0.041756,74.125.130.0-255,5738,297848,8,377950
12698,0.041766,172.31.36.0-255,66,297914,8,377950
12699,0.043723,74.125.130.0-255,5738,303652,8,377950
12700,0.043741,172.31.36.0-255,66,303718,8,377950
12701,0.045692,74.125.130.0-255,5738,309456,8,377950
12702,0.0457,172.31.36.0-255,66,309522,8,377950
12703,0.047643,74.125.130.0-255,5738,315260,8,377950
12704,0.047653,172.31.36.0-255,66,315326,8,377950
12705,0.049611,74.125.130.0-255,5738,321064,8,377950
12706,0.049626,172.31.36.0-255,66,321130,8,377950
12707,0.051575,74.125.130.0-255,5738,326868,8,377950
12708,0.051584,172.31.36.0-255,66,326934,8,377950
12709,0.053578,74.125.130.0-255,5738,332672,8,377950
12710,0.053589,172.31.36.0-255,66,332738,8,377950
12711,0.055533,74.125.130.0-255,5738,338476,8,377950
12712,0.055542,172.31.36.0-255,66,338542,8,377950
12713,0.057481,74.125.130.0-255,1484,340026,8,377950
12714,0.057523,74.125.130.0-255,4320,344346,8,377950
12715,0.057529,172.31.36.0-255,66,344412,8,377950
12716,0.059465,74.125.130.0-255,5738,350150,8,377950
12717,0.059473,172.31.36.0-255,66,350216,8,377950
12718,0.061425,74.125.130.0-255,5738,355954,8,377950
12719,0.061433,172.31.36.0-255,66,356020,8,377950
12720,0.063371,74.125.130.0-255,5738,361758,8,377950
12721,0.063379,172.31.36.0-255,66,361824,8,377950
12722,0.06531,74.125.130.0-255,5738,367562,8,377950
12723,0.065317,172.31.36.0-255,66,367628,8,377950
12724,0.06724,74.125.130.0-255,4320,371948,8,377950
12725,0.067246,172.31.36.0-255,66,372014,8,377950
12726,0.067276,74.125.130.0-255,1484,373498,8,377950
12727,0.069196,74.125.130.0-255,4320,377818,8,377950
12728,0.069202,172.31.36.0-255,66,377884,8,377950
12729,0.069497,104.244.42.0-255,66,377950,8,377950
12730,0.0,172.217.194.0-255,153,153,8,300609
12731,3.6e-05,172.31.36.0-255,66,219,8,300609
12732,4.3e-05,172.217.194.0-255,1484,1703,8,300609
12733,4.7e-05,172.31.36.0-255,66,1769,8,300609
12734,5.2e-05,172.217.194.0-255,2902,4671,8,300609
12735,5.4e-05,172.31.36.0-255,66,4737,8,300609
12736,6.9e-05,172.217.194.0-255,5738,10475,8,300609
12737,7.1e-05,172.31.36.0-255,66,10541,8,300609
12738,0.000106,172.217.194.0-255,3393,13934,8,300609
12739,0.00011,172.31.36.0-255,66,14000,8,300609
12740,0.000166,172.217.194.0-255,1484,15484,8,300609
12741,0.000171,172.31.36.0-255,66,15550,8,300609
12742,0.000175,172.217.194.0-255,2902,18452,8,300609
12743,0.000177,172.31.36.0-255,66,18518,8,300609
12744,0.000181,172.217.194.0-255,2902,21420,8,300609
12745,0.000191,172.31.36.0-255,66,21486,8,300609
12746,0.000217,172.217.194.0-255,2902,24388,8,300609
12747,0.00022,172.31.36.0-255,66,24454,8,300609
12748,0.000227,172.217.194.0-255,6797,31251,8,300609
12749,0.00023,172.31.36.0-255,66,31317,8,300609
12750,0.000233,172.217.194.0-255,1484,32801,8,300609
12751,0.000235,172.31.36.0-255,66,32867,8,300609
12752,0.000287,172.31.36.0-255,66,32933,8,300609
12753,0.000303,172.31.36.0-255,66,32999,8,300609
12754,0.000307,172.217.194.0-255,3602,36601,8,300609
12755,0.00031,172.31.36.0-255,66,36667,8,300609
12756,0.000333,172.217.194.0-255,708,37375,8,300609
12757,0.000336,172.31.36.0-255,66,37441,8,300609
12758,0.000587,172.217.194.0-255,1484,38925,8,300609
12759,0.000593,172.31.36.0-255,66,38991,8,300609
12760,0.000599,172.217.194.0-255,2902,41893,8,300609
12761,0.000602,172.31.36.0-255,66,41959,8,300609
12762,0.000615,172.217.194.0-255,5738,47697,8,300609
12763,0.000618,172.31.36.0-255,66,47763,8,300609
12764,0.000625,172.217.194.0-255,5738,53501,8,300609
12765,0.000628,172.31.36.0-255,66,53567,8,300609
12766,0.000631,172.217.194.0-255,1484,55051,8,300609
12767,0.000669,172.31.36.0-255,66,55117,8,300609
12768,0.000694,172.217.194.0-255,2902,58019,8,300609
12769,0.000698,172.31.36.0-255,66,58085,8,300609
12770,0.000704,172.217.194.0-255,4471,62556,8,300609
12771,0.000707,172.31.36.0-255,66,62622,8,300609
12772,0.000865,172.217.194.0-255,1484,64106,8,300609
12773,0.000871,172.217.194.0-255,2902,67008,8,300609
12774,0.000874,172.31.36.0-255,66,67074,8,300609
12775,0.00088,172.217.194.0-255,4320,71394,8,300609
12776,0.000882,172.31.36.0-255,66,71460,8,300609
12777,0.000901,172.217.194.0-255,1484,72944,8,300609
12778,0.000909,172.217.194.0-255,6797,79741,8,300609
12779,0.000911,172.31.36.0-255,66,79807,8,300609
12780,0.001017,172.217.194.0-255,1484,81291,8,300609
12781,0.001031,172.217.194.0-255,2902,84193,8,300609
12782,0.001034,172.31.36.0-255,66,84259,8,300609
12783,0.001039,172.217.194.0-255,2902,87161,8,300609
12784,0.001042,172.31.36.0-255,66,87227,8,300609
12785,0.001063,172.217.194.0-255,2902,90129,8,300609
12786,0.001066,172.31.36.0-255,66,90195,8,300609
12787,0.001073,172.217.194.0-255,5738,95933,8,300609
12788,0.001075,172.31.36.0-255,66,95999,8,300609
12789,0.001086,172.31.36.0-255,66,96065,8,300609
12790,0.001111,172.217.194.0-255,2902,98967,8,300609
12791,0.001115,172.31.36.0-255,66,99033,8,300609
12792,0.001121,172.217.194.0-255,5020,104053,8,300609
12793,0.001124,172.31.36.0-255,66,104119,8,300609
12794,0.00113,172.217.194.0-255,5738,109857,8,300609
12795,0.001132,172.31.36.0-255,66,109923,8,300609
12796,0.001209,172.31.36.0-255,66,109989,8,300609
12797,0.001219,172.31.36.0-255,66,110055,8,300609
12798,0.001225,172.217.194.0-255,6438,116493,8,300609
12799,0.001228,172.31.36.0-255,66,116559,8,300609
12800,0.001311,172.217.194.0-255,1484,118043,8,300609
12801,0.001317,172.217.194.0-255,2902,120945,8,300609
12802,0.001322,172.31.36.0-255,66,121011,8,300609
12803,0.001349,172.217.194.0-255,5738,126749,8,300609
12804,0.001352,172.31.36.0-255,66,126815,8,300609
12805,0.001359,172.217.194.0-255,7156,133971,8,300609
12806,0.001361,172.31.36.0-255,66,134037,8,300609
12807,0.001402,172.217.194.0-255,5738,139775,8,300609
12808,0.001406,172.31.36.0-255,66,139841,8,300609
12809,0.001422,172.31.36.0-255,66,139907,8,300609
12810,0.001425,172.217.194.0-255,766,140673,8,300609
12811,0.001812,172.217.194.0-255,1484,142157,8,300609
12812,0.001816,172.31.36.0-255,66,142223,8,300609
12813,0.00182,172.217.194.0-255,1484,143707,8,300609
12814,0.001841,172.217.194.0-255,1484,145191,8,300609
12815,0.001844,172.31.36.0-255,66,145257,8,300609
12816,0.001851,172.217.194.0-255,5738,150995,8,300609
12817,0.001854,172.31.36.0-255,66,151061,8,300609
12818,0.001873,172.31.36.0-255,66,151127,8,300609
12819,0.001878,172.217.194.0-255,2902,154029,8,300609
12820,0.001883,172.31.36.0-255,66,154095,8,300609
12821,0.001923,172.31.36.0-255,66,154161,8,300609
12822,0.001926,172.217.194.0-255,1484,155645,8,300609
12823,0.001966,172.31.36.0-255,66,155711,8,300609
12824,0.001979,172.31.36.0-255,66,155777,8,300609
12825,0.001986,172.217.194.0-255,7156,162933,8,300609
12826,0.001989,172.31.36.0-255,66,162999,8,300609
12827,0.002018,172.217.194.0-255,5020,168019,8,300609
12828,0.002021,172.31.36.0-255,66,168085,8,300609
12829,0.004123,172.217.194.0-255,5738,173823,8,300609
12830,0.00413,172.31.36.0-255,66,173889,8,300609
12831,0.006245,172.217.194.0-255,4320,178209,8,300609
12832,0.00625,172.31.36.0-255,66,178275,8,300609
12833,0.006278,172.217.194.0-255,1484,179759,8,300609
12834,0.008295,172.217.194.0-255,4320,184079,8,300609
12835,0.008299,172.31.36.0-255,66,184145,8,300609
12836,0.010337,172.217.194.0-255,5738,189883,8,300609
12837,0.010344,172.31.36.0-255,66,189949,8,300609
12838,0.012443,172.217.194.0-255,5738,195687,8,300609
12839,0.012451,172.31.36.0-255,66,195753,8,300609
12840,0.014595,172.217.194.0-255,5738,201491,8,300609
12841,0.014601,172.31.36.0-255,66,201557,8,300609
12842,0.016758,172.217.194.0-255,5738,207295,8,300609
12843,0.016766,172.31.36.0-255,66,207361,8,300609
12844,0.018853,172.217.194.0-255,5738,213099,8,300609
12845,0.018861,172.31.36.0-255,66,213165,8,300609
12846,0.020932,172.217.194.0-255,5738,218903,8,300609
12847,0.020938,172.31.36.0-255,66,218969,8,300609
12848,0.023022,172.217.194.0-255,5738,224707,8,300609
12849,0.023029,172.31.36.0-255,66,224773,8,300609
12850,0.025082,172.217.194.0-255,5738,230511,8,300609
12851,0.025088,172.31.36.0-255,66,230577,8,300609
12852,0.027164,172.217.194.0-255,4320,234897,8,300609
12853,0.027171,172.31.36.0-255,66,234963,8,300609
12854,0.027208,172.217.194.0-255,1484,236447,8,300609
12855,0.029289,172.217.194.0-255,4320,240767,8,300609
12856,0.029295,172.31.36.0-255,66,240833,8,300609
12857,0.031369,172.217.194.0-255,5738,246571,8,300609
12858,0.031376,172.31.36.0-255,66,246637,8,300609
12859,0.033458,172.217.194.0-255,5738,252375,8,300609
12860,0.033465,172.31.36.0-255,66,252441,8,300609
12861,0.035532,172.217.194.0-255,5738,258179,8,300609
12862,0.035539,172.31.36.0-255,66,258245,8,300609
12863,0.037612,172.217.194.0-255,5738,263983,8,300609
12864,0.037619,172.31.36.0-255,66,264049,8,300609
12865,0.038776,172.31.36.0-255,172,264221,8,300609
12866,0.038806,172.31.36.0-255,1113,265334,8,300609
12867,0.038847,172.31.36.0-255,1514,266848,8,300609
12868,0.038848,172.31.36.0-255,1514,268362,8,300609
12869,0.038853,172.31.36.0-255,1514,269876,8,300609
12870,0.038854,172.31.36.0-255,771,270647,8,300609
12871,0.039701,172.217.194.0-255,5738,276385,8,300609
12872,0.039707,172.31.36.0-255,66,276451,8,300609
12873,0.040289,104.244.42.0-255,66,276517,8,300609
12874,0.04037,104.244.42.0-255,66,276583,8,300609
12875,0.040439,104.244.42.0-255,66,276649,8,300609
12876,0.040444,104.244.42.0-255,66,276715,8,300609
12877,0.041786,172.217.194.0-255,5738,282453,8,300609
12878,0.041792,172.31.36.0-255,66,282519,8,300609
12879,0.043866,172.217.194.0-255,5738,288257,8,300609
12880,0.043874,172.31.36.0-255,66,288323,8,300609
12881,0.045921,172.217.194.0-255,5738,294061,8,300609
12882,0.045929,172.31.36.0-255,66,294127,8,300609
12883,0.047978,172.217.194.0-255,5738,299865,8,300609
12884,0.047984,172.31.36.0-255,66,299931,8,300609
12885,0.050035,172.217.194.0-255,441,300372,8,300609
12886,0.050207,172.31.36.0-255,66,300438,8,300609
12887,0.050237,172.31.36.0-255,105,300543,8,300609
12888,0.052285,172.217.194.0-255,66,300609,8,300609
12889,0.0,74.125.130.0-255,153,153,8,300320
12890,3.3e-05,172.31.36.0-255,66,219,8,300320
12891,4e-05,74.125.130.0-255,1484,1703,8,300320
12892,4.4e-05,172.31.36.0-255,66,1769,8,300320
12893,4.9e-05,74.125.130.0-255,2902,4671,8,300320
12894,5.1e-05,172.31.36.0-255,66,4737,8,300320
12895,5.5e-05,74.125.130.0-255,2902,7639,8,300320
12896,5.8e-05,172.31.36.0-255,66,7705,8,300320
12897,6.3e-05,74.125.130.0-255,4320,12025,8,300320
12898,6.6e-05,172.31.36.0-255,66,12091,8,300320
12899,8.7e-05,74.125.130.0-255,1993,14084,8,300320
12900,9e-05,172.31.36.0-255,66,14150,8,300320
12901,0.000156,74.125.130.0-255,1484,15634,8,300320
12902,0.000159,172.31.36.0-255,66,15700,8,300320
12903,0.000164,74.125.130.0-255,2902,18602,8,300320
12904,0.000167,172.31.36.0-255,66,18668,8,300320
12905,0.000173,74.125.130.0-255,2902,21570,8,300320
12906,0.000175,172.31.36.0-255,66,21636,8,300320
12907,0.000203,74.125.130.0-255,2902,24538,8,300320
12908,0.000206,172.31.36.0-255,66,24604,8,300320
12909,0.000214,74.125.130.0-255,6797,31401,8,300320
12910,0.000216,172.31.36.0-255,66,31467,8,300320
12911,0.000244,74.125.130.0-255,5738,37205,8,300320
12912,0.000247,172.31.36.0-255,66,37271,8,300320
12913,0.000265,74.125.130.0-255,2902,40173,8,300320
12914,0.000267,172.31.36.0-255,66,40239,8,300320
12915,0.000285,74.125.130.0-255,2902,43141,8,300320
12916,0.000288,172.31.36.0-255,66,43207,8,300320
12917,0.000305,74.125.130.0-255,5379,48586,8,300320
12918,0.000308,172.31.36.0-255,66,48652,8,300320
12919,0.000329,74.125.130.0-255,4320,52972,8,300320
12920,0.000332,172.31.36.0-255,66,53038,8,300320
12921,0.000347,74.125.130.0-255,4320,57358,8,300320
12922,0.00035,172.31.36.0-255,66,57424,8,300320
12923,0.000355,74.125.130.0-255,4320,61744,8,300320
12924,0.000357,172.31.36.0-255,66,61810,8,300320
12925,0.000385,74.125.130.0-255,4272,66082,8,300320
12926,0.000389,172.31.36.0-255,66,66148,8,300320
12927,0.000423,74.125.130.0-255,100,66248,8,300320
12928,0.000542,74.125.130.0-255,1484,67732,8,300320
12929,0.000546,172.31.36.0-255,66,67798,8,300320
12930,0.000551,74.125.130.0-255,2902,70700,8,300320
12931,0.000554,172.31.36.0-255,66,70766,8,300320
12932,0.00057,74.125.130.0-255,2902,73668,8,300320
12933,0.000572,172.31.36.0-255,66,73734,8,300320
12934,0.000586,74.125.130.0-255,2902,76636,8,300320
12935,0.000588,172.31.36.0-255,66,76702,8,300320
12936,0.000592,74.125.130.0-255,1484,78186,8,300320
12937,0.000613,74.125.130.0-255,5676,83862,8,300320
12938,0.000616,172.31.36.0-255,66,83928,8,300320
12939,0.000658,74.125.130.0-255,1484,85412,8,300320
12940,0.000697,74.125.130.0-255,2902,88314,8,300320
12941,0.000703,74.125.130.0-255,5738,94052,8,300320
12942,0.000703,172.31.36.0-255,66,94118,8,300320
12943,0.000718,172.31.36.0-255,66,94184,8,300320
12944,0.000719,74.125.130.0-255,5738,99922,8,300320
12945,0.000721,172.31.36.0-255,66,99988,8,300320
12946,0.000744,74.125.130.0-255,1125,101113,8,300320
12947,0.001114,172.31.36.0-255,66,101179,8,300320
12948,0.001394,74.125.130.0-255,1484,102663,8,300320
12949,0.001403,74.125.130.0-255,2902,105565,8,300320
12950,0.001407,172.31.36.0-255,66,105631,8,300320
12951,0.001411,74.125.130.0-255,1484,107115,8,300320
12952,0.001431,74.125.130.0-255,4320,111435,8,300320
12953,0.001434,172.31.36.0-255,66,111501,8,300320
12954,0.001476,172.31.36.0-255,66,111567,8,300320
12955,0.001492,74.125.130.0-255,1484,113051,8,300320
12956,0.001496,74.125.130.0-255,2902,115953,8,300320
12957,0.001498,172.31.36.0-255,66,116019,8,300320
12958,0.001506,74.125.130.0-255,7156,123175,8,300320
12959,0.001509,172.31.36.0-255,66,123241,8,300320
12960,0.001529,74.125.130.0-255,766,124007,8,300320
12961,0.003743,74.125.130.0-255,4320,128327,8,300320
12962,0.003748,172.31.36.0-255,66,128393,8,300320
12963,0.005975,74.125.130.0-255,5738,134131,8,300320
12964,0.005978,172.31.36.0-255,66,134197,8,300320
12965,0.008216,74.125.130.0-255,5738,139935,8,300320
12966,0.008223,172.31.36.0-255,66,140001,8,300320
12967,0.010477,74.125.130.0-255,5738,145739,8,300320
12968,0.010487,172.31.36.0-255,66,145805,8,300320
12969,0.01273,74.125.130.0-255,5738,151543,8,300320
12970,0.012739,172.31.36.0-255,66,151609,8,300320
12971,0.014989,74.125.130.0-255,5738,157347,8,300320
12972,0.015,172.31.36.0-255,66,157413,8,300320
12973,0.017256,74.125.130.0-255,5738,163151,8,300320
12974,0.017267,172.31.36.0-255,66,163217,8,300320
12975,0.019514,74.125.130.0-255,5738,168955,8,300320
12976,0.019523,172.31.36.0-255,66,169021,8,300320
12977,0.021767,74.125.130.0-255,5738,174759,8,300320
12978,0.021778,172.31.36.0-255,66,174825,8,300320
12979,0.024023,74.125.130.0-255,5738,180563,8,300320
12980,0.024032,172.31.36.0-255,66,180629,8,300320
12981,0.026279,74.125.130.0-255,5738,186367,8,300320
12982,0.026289,172.31.36.0-255,66,186433,8,300320
12983,0.028538,74.125.130.0-255,2902,189335,8,300320
12984,0.028545,172.31.36.0-255,66,189401,8,300320
12985,0.02858,74.125.130.0-255,2902,192303,8,300320
12986,0.028583,172.31.36.0-255,66,192369,8,300320
12987,0.030803,74.125.130.0-255,2902,195271,8,300320
12988,0.030817,172.31.36.0-255,66,195337,8,300320
12989,0.030854,74.125.130.0-255,2902,198239,8,300320
12990,0.030857,172.31.36.0-255,66,198305,8,300320
12991,0.033063,74.125.130.0-255,2902,201207,8,300320
12992,0.03307,172.31.36.0-255,66,201273,8,300320
12993,0.033103,74.125.130.0-255,2902,204175,8,300320
12994,0.033106,172.31.36.0-255,66,204241,8,300320
12995,0.033542,172.31.36.0-255,188,204429,8,300320
12996,0.033571,172.31.36.0-255,955,205384,8,300320
12997,0.033613,172.31.36.0-255,1514,206898,8,300320
12998,0.033615,172.31.36.0-255,1184,208082,8,300320
12999,0.035093,104.244.42.0-255,66,208148,8,300320
13000,0.035134,104.244.42.0-255,66,208214,8,300320
13001,0.035218,104.244.42.0-255,66,208280,8,300320
13002,0.035347,74.125.130.0-255,5738,214018,8,300320
13003,0.035353,172.31.36.0-255,66,214084,8,300320
13004,0.037588,74.125.130.0-255,5738,219822,8,300320
13005,0.037595,172.31.36.0-255,66,219888,8,300320
13006,0.03986,74.125.130.0-255,5738,225626,8,300320
13007,0.039879,172.31.36.0-255,66,225692,8,300320
13008,0.042123,74.125.130.0-255,5738,231430,8,300320
13009,0.042133,172.31.36.0-255,66,231496,8,300320
13010,0.044374,74.125.130.0-255,5738,237234,8,300320
13011,0.044379,172.31.36.0-255,66,237300,8,300320
13012,0.046656,74.125.130.0-255,5738,243038,8,300320
13013,0.046662,172.31.36.0-255,66,243104,8,300320
13014,0.048894,74.125.130.0-255,5738,248842,8,300320
13015,0.048899,172.31.36.0-255,66,248908,8,300320
13016,0.051154,74.125.130.0-255,5738,254646,8,300320
13017,0.05116,172.31.36.0-255,66,254712,8,300320
13018,0.053428,74.125.130.0-255,5738,260450,8,300320
13019,0.053435,172.31.36.0-255,66,260516,8,300320
13020,0.055699,74.125.130.0-255,5738,266254,8,300320
13021,0.055705,172.31.36.0-255,66,266320,8,300320
13022,0.057941,74.125.130.0-255,5738,272058,8,300320
13023,0.057946,172.31.36.0-255,66,272124,8,300320
13024,0.060193,74.125.130.0-255,4320,276444,8,300320
13025,0.060198,172.31.36.0-255,66,276510,8,300320
13026,0.060224,74.125.130.0-255,1484,277994,8,300320
13027,0.062433,74.125.130.0-255,1484,279478,8,300320
13028,0.062439,172.31.36.0-255,66,279544,8,300320
13029,0.062474,74.125.130.0-255,2902,282446,8,300320
13030,0.062478,172.31.36.0-255,66,282512,8,300320
13031,0.064666,74.125.130.0-255,2902,285414,8,300320
13032,0.064672,172.31.36.0-255,66,285480,8,300320
13033,0.064707,74.125.130.0-255,2902,288382,8,300320
13034,0.06471,172.31.36.0-255,66,288448,8,300320
13035,0.066905,74.125.130.0-255,2902,291350,8,300320
13036,0.06691,172.31.36.0-255,66,291416,8,300320
13037,0.066942,74.125.130.0-255,2902,294318,8,300320
13038,0.066945,172.31.36.0-255,66,294384,8,300320
13039,0.069136,74.125.130.0-255,2902,297286,8,300320
13040,0.069157,172.31.36.0-255,66,297352,8,300320
13041,0.069183,74.125.130.0-255,2902,300254,8,300320
13042,0.069185,172.31.36.0-255,66,300320,8,300320
13043,0.0,172.217.24.0-255,153,153,8,252345
13044,1.5e-05,172.31.36.0-255,66,219,8,252345
13045,2.1e-05,172.217.24.0-255,1484,1703,8,252345
13046,2.6e-05,172.31.36.0-255,66,1769,8,252345
13047,2.8e-05,172.217.24.0-255,1484,3253,8,252345
13048,3.1e-05,172.31.36.0-255,66,3319,8,252345
13049,5.5e-05,172.217.24.0-255,1484,4803,8,252345
13050,5.7e-05,172.31.36.0-255,66,4869,8,252345
13051,6.7e-05,172.217.24.0-255,4320,9189,8,252345
13052,7e-05,172.31.36.0-255,66,9255,8,252345
13053,7.6e-05,172.217.24.0-255,4802,14057,8,252345
13054,7.8e-05,172.31.36.0-255,66,14123,8,252345
13055,0.000105,172.217.24.0-255,4320,18443,8,252345
13056,0.000108,172.31.36.0-255,66,18509,8,252345
13057,0.000118,172.217.24.0-255,5738,24247,8,252345
13058,0.000121,172.31.36.0-255,66,24313,8,252345
13059,0.000164,172.31.36.0-255,66,24379,8,252345
13060,0.000169,172.217.24.0-255,2902,27281,8,252345
13061,0.000171,172.31.36.0-255,66,27347,8,252345
13062,0.000202,172.31.36.0-255,66,27413,8,252345
13063,0.000224,172.217.24.0-255,1484,28897,8,252345
13064,0.000226,172.31.36.0-255,66,28963,8,252345
13065,0.00023,172.217.24.0-255,1484,30447,8,252345
13066,0.000232,172.31.36.0-255,66,30513,8,252345
13067,0.000262,172.217.24.0-255,1484,31997,8,252345
13068,0.000264,172.31.36.0-255,66,32063,8,252345
13069,0.00027,172.217.24.0-255,5738,37801,8,252345
13070,0.000273,172.31.36.0-255,66,37867,8,252345
13071,0.000284,172.217.24.0-255,6797,44664,8,252345
13072,0.000286,172.31.36.0-255,66,44730,8,252345
13073,0.000288,172.217.24.0-255,396,45126,8,252345
13074,0.00101,172.31.36.0-255,66,45192,8,252345
13075,0.002221,172.217.24.0-255,4320,49512,8,252345
13076,0.002232,172.31.36.0-255,66,49578,8,252345
13077,0.002941,172.217.24.0-255,1484,51062,8,252345
13078,0.004166,172.217.24.0-255,4320,55382,8,252345
13079,0.00417,172.31.36.0-255,66,55448,8,252345
13080,0.006123,172.217.24.0-255,5738,61186,8,252345
13081,0.006126,172.31.36.0-255,66,61252,8,252345
13082,0.008067,172.217.24.0-255,5738,66990,8,252345
13083,0.008075,172.31.36.0-255,66,67056,8,252345
13084,0.010028,172.217.24.0-255,5738,72794,8,252345
13085,0.010037,172.31.36.0-255,66,72860,8,252345
13086,0.011978,172.217.24.0-255,5738,78598,8,252345
13087,0.011987,172.31.36.0-255,66,78664,8,252345
13088,0.013983,172.217.24.0-255,5738,84402,8,252345
13089,0.013994,172.31.36.0-255,66,84468,8,252345
13090,0.015938,172.217.24.0-255,5738,90206,8,252345
13091,0.015946,172.31.36.0-255,66,90272,8,252345
13092,0.01791,172.217.24.0-255,5738,96010,8,252345
13093,0.01792,172.31.36.0-255,66,96076,8,252345
13094,0.019852,172.217.24.0-255,5738,101814,8,252345
13095,0.019861,172.31.36.0-255,66,101880,8,252345
13096,0.021817,172.217.24.0-255,5738,107618,8,252345
13097,0.021824,172.31.36.0-255,66,107684,8,252345
13098,0.023761,172.217.24.0-255,5738,113422,8,252345
13099,0.023768,172.31.36.0-255,66,113488,8,252345
13100,0.025495,172.31.36.0-255,187,113675,8,252345
13101,0.025524,172.31.36.0-255,979,114654,8,252345
13102,0.025562,172.31.36.0-255,1514,116168,8,252345
13103,0.025564,172.31.36.0-255,111,116279,8,252345
13104,0.025693,172.217.24.0-255,2902,119181,8,252345
13105,0.025699,172.31.36.0-255,66,119247,8,252345
13106,0.025738,172.217.24.0-255,2902,122149,8,252345
13107,0.025743,172.31.36.0-255,66,122215,8,252345
13108,0.027071,104.244.42.0-255,66,122281,8,252345
13109,0.027119,104.244.42.0-255,66,122347,8,252345
13110,0.027121,104.244.42.0-255,66,122413,8,252345
13111,0.027632,172.217.24.0-255,2902,125315,8,252345
13112,0.027636,172.31.36.0-255,66,125381,8,252345
13113,0.027686,172.217.24.0-255,2902,128283,8,252345
13114,0.02769,172.31.36.0-255,66,128349,8,252345
13115,0.029586,172.217.24.0-255,2902,131251,8,252345
13116,0.029591,172.31.36.0-255,66,131317,8,252345
13117,0.029628,172.217.24.0-255,2902,134219,8,252345
13118,0.029632,172.31.36.0-255,66,134285,8,252345
13119,0.031518,172.217.24.0-255,2902,137187,8,252345
13120,0.031524,172.31.36.0-255,66,137253,8,252345
13121,0.031561,172.217.24.0-255,2902,140155,8,252345
13122,0.031565,172.31.36.0-255,66,140221,8,252345
13123,0.033454,172.217.24.0-255,2902,143123,8,252345
13124,0.03346,172.31.36.0-255,66,143189,8,252345
13125,0.033495,172.217.24.0-255,2902,146091,8,252345
13126,0.033499,172.31.36.0-255,66,146157,8,252345
13127,0.035388,172.217.24.0-255,2902,149059,8,252345
13128,0.035394,172.31.36.0-255,66,149125,8,252345
13129,0.035429,172.217.24.0-255,2902,152027,8,252345
13130,0.035433,172.31.36.0-255,66,152093,8,252345
13131,0.037319,172.217.24.0-255,2902,154995,8,252345
13132,0.037326,172.31.36.0-255,66,155061,8,252345
13133,0.037362,172.217.24.0-255,2902,157963,8,252345
13134,0.037365,172.31.36.0-255,66,158029,8,252345
13135,0.039264,172.217.24.0-255,2902,160931,8,252345
13136,0.039269,172.31.36.0-255,66,160997,8,252345
13137,0.039308,172.217.24.0-255,2902,163899,8,252345
13138,0.039312,172.31.36.0-255,66,163965,8,252345
13139,0.041224,172.217.24.0-255,2902,166867,8,252345
13140,0.041244,172.31.36.0-255,66,166933,8,252345
13141,0.041272,172.217.24.0-255,2902,169835,8,252345
13142,0.041277,172.31.36.0-255,66,169901,8,252345
13143,0.043175,172.217.24.0-255,2902,172803,8,252345
13144,0.04318,172.31.36.0-255,66,172869,8,252345
13145,0.043212,172.217.24.0-255,2902,175771,8,252345
13146,0.043215,172.31.36.0-255,66,175837,8,252345
13147,0.045109,172.217.24.0-255,2902,178739,8,252345
13148,0.045114,172.31.36.0-255,66,178805,8,252345
13149,0.045148,172.217.24.0-255,2902,181707,8,252345
13150,0.045151,172.31.36.0-255,66,181773,8,252345
13151,0.047045,172.217.24.0-255,1484,183257,8,252345
13152,0.04708,172.217.24.0-255,4320,187577,8,252345
13153,0.047086,172.31.36.0-255,66,187643,8,252345
13154,0.049019,172.217.24.0-255,5738,193381,8,252345
13155,0.049025,172.31.36.0-255,66,193447,8,252345
13156,0.050952,172.217.24.0-255,5738,199185,8,252345
13157,0.050957,172.31.36.0-255,66,199251,8,252345
13158,0.052886,172.217.24.0-255,5738,204989,8,252345
13159,0.052891,172.31.36.0-255,66,205055,8,252345
13160,0.054828,172.217.24.0-255,5738,210793,8,252345
13161,0.054833,172.31.36.0-255,66,210859,8,252345
13162,0.056778,172.217.24.0-255,2902,213761,8,252345
13163,0.056784,172.31.36.0-255,66,213827,8,252345
13164,0.056816,172.217.24.0-255,2902,216729,8,252345
13165,0.05682,172.31.36.0-255,66,216795,8,252345
13166,0.05871,172.217.24.0-255,2902,219697,8,252345
13167,0.058716,172.31.36.0-255,66,219763,8,252345
13168,0.058751,172.217.24.0-255,2902,222665,8,252345
13169,0.058754,172.31.36.0-255,66,222731,8,252345
13170,0.06064,172.217.24.0-255,2902,225633,8,252345
13171,0.060645,172.31.36.0-255,66,225699,8,252345
13172,0.060711,172.217.24.0-255,2902,228601,8,252345
13173,0.060715,172.31.36.0-255,66,228667,8,252345
13174,0.062596,172.217.24.0-255,2902,231569,8,252345
13175,0.062602,172.31.36.0-255,66,231635,8,252345
13176,0.062636,172.217.24.0-255,2902,234537,8,252345
13177,0.06264,172.31.36.0-255,66,234603,8,252345
13178,0.064532,172.217.24.0-255,2902,237505,8,252345
13179,0.064538,172.31.36.0-255,66,237571,8,252345
13180,0.06458,172.217.24.0-255,2902,240473,8,252345
13181,0.064584,172.31.36.0-255,66,240539,8,252345
13182,0.066462,172.217.24.0-255,2902,243441,8,252345
13183,0.066468,172.31.36.0-255,66,243507,8,252345
13184,0.066511,172.217.24.0-255,2902,246409,8,252345
13185,0.066514,172.31.36.0-255,66,246475,8,252345
13186,0.068386,172.217.24.0-255,1484,247959,8,252345
13187,0.068432,172.217.24.0-255,4320,252279,8,252345
13188,0.068439,172.31.36.0-255,66,252345,8,252345
13189,0.0,172.217.27.0-255,146,146,8,316141
13190,3.5e-05,172.31.36.0-255,66,212,8,316141
13191,4.2e-05,172.217.27.0-255,1484,1696,8,316141
13192,4.5e-05,172.31.36.0-255,66,1762,8,316141
13193,5.1e-05,172.217.27.0-255,2902,4664,8,316141
13194,5.3e-05,172.31.36.0-255,66,4730,8,316141
13195,6.1e-05,172.217.27.0-255,7156,11886,8,316141
13196,6.4e-05,172.31.36.0-255,66,11952,8,316141
13197,6.7e-05,172.217.27.0-255,1995,13947,8,316141
13198,7e-05,172.31.36.0-255,66,14013,8,316141
13199,0.000109,172.217.27.0-255,2902,16915,8,316141
13200,0.000112,172.31.36.0-255,66,16981,8,316141
13201,0.000117,172.217.27.0-255,2902,19883,8,316141
13202,0.000118,172.31.36.0-255,66,19949,8,316141
13203,0.000132,172.217.27.0-255,1484,21433,8,316141
13204,0.000135,172.31.36.0-255,66,21499,8,316141
13205,0.00014,172.217.27.0-255,4320,25819,8,316141
13206,0.000141,172.31.36.0-255,66,25885,8,316141
13207,0.000168,172.217.27.0-255,4320,30205,8,316141
13208,0.00017,172.31.36.0-255,66,30271,8,316141
13209,0.000175,172.217.27.0-255,1125,31396,8,316141
13210,0.000178,172.31.36.0-255,66,31462,8,316141
13211,0.000293,172.217.27.0-255,1484,32946,8,316141
13212,0.000297,172.31.36.0-255,66,33012,8,316141
13213,0.000302,172.217.27.0-255,2902,35914,8,316141
13214,0.000304,172.31.36.0-255,66,35980,8,316141
13215,0.000308,172.217.27.0-255,2902,38882,8,316141
13216,0.00031,172.31.36.0-255,66,38948,8,316141
13217,0.000313,172.217.27.0-255,1484,40432,8,316141
13218,0.000315,172.31.36.0-255,66,40498,8,316141
13219,0.00033,172.217.27.0-255,2902,43400,8,316141
13220,0.000333,172.31.36.0-255,66,43466,8,316141
13221,0.000358,172.217.27.0-255,1484,44950,8,316141
13222,0.000361,172.31.36.0-255,66,45016,8,316141
13223,0.000382,172.217.27.0-255,3961,48977,8,316141
13224,0.000385,172.31.36.0-255,66,49043,8,316141
13225,0.000399,172.217.27.0-255,4320,53363,8,316141
13226,0.000403,172.31.36.0-255,66,53429,8,316141
13227,0.000424,172.217.27.0-255,1484,54913,8,316141
13228,0.000427,172.31.36.0-255,66,54979,8,316141
13229,0.000438,172.31.36.0-255,66,55045,8,316141
13230,0.000479,172.217.27.0-255,2870,57915,8,316141
13231,0.000483,172.31.36.0-255,66,57981,8,316141
13232,0.000828,172.217.27.0-255,114,58095,8,316141
13233,0.000832,172.31.36.0-255,66,58161,8,316141
13234,0.00096,172.217.27.0-255,333,58494,8,316141
13235,0.000965,172.31.36.0-255,66,58560,8,316141
13236,0.001318,172.217.27.0-255,1484,60044,8,316141
13237,0.001325,172.31.36.0-255,66,60110,8,316141
13238,0.001331,172.217.27.0-255,2902,63012,8,316141
13239,0.001333,172.31.36.0-255,66,63078,8,316141
13240,0.001338,172.217.27.0-255,2902,65980,8,316141
13241,0.00134,172.31.36.0-255,66,66046,8,316141
13242,0.001346,172.217.27.0-255,4320,70366,8,316141
13243,0.001348,172.31.36.0-255,66,70432,8,316141
13244,0.001383,172.31.36.0-255,66,70498,8,316141
13245,0.001391,172.217.27.0-255,5738,76236,8,316141
13246,0.001393,172.31.36.0-255,66,76302,8,316141
13247,0.001427,172.31.36.0-255,66,76368,8,316141
13248,0.003094,172.217.27.0-255,4320,80688,8,316141
13249,0.003098,172.31.36.0-255,66,80754,8,316141
13250,0.003115,172.217.27.0-255,1484,82238,8,316141
13251,0.003117,172.31.36.0-255,66,82304,8,316141
13252,0.004762,172.217.27.0-255,5738,88042,8,316141
13253,0.004765,172.31.36.0-255,66,88108,8,316141
13254,0.006428,172.217.27.0-255,5738,93846,8,316141
13255,0.006436,172.31.36.0-255,66,93912,8,316141
13256,0.008106,172.217.27.0-255,5738,99650,8,316141
13257,0.008113,172.31.36.0-255,66,99716,8,316141
13258,0.009784,172.217.27.0-255,5738,105454,8,316141
13259,0.009792,172.31.36.0-255,66,105520,8,316141
13260,0.011472,172.217.27.0-255,5738,111258,8,316141
13261,0.01148,172.31.36.0-255,66,111324,8,316141
13262,0.013155,172.217.27.0-255,5738,117062,8,316141
13263,0.013163,172.31.36.0-255,66,117128,8,316141
13264,0.014839,172.217.27.0-255,5738,122866,8,316141
13265,0.014848,172.31.36.0-255,66,122932,8,316141
13266,0.016517,172.217.27.0-255,5738,128670,8,316141
13267,0.016523,172.31.36.0-255,66,128736,8,316141
13268,0.018183,172.217.27.0-255,5738,134474,8,316141
13269,0.01819,172.31.36.0-255,66,134540,8,316141
13270,0.019849,172.217.27.0-255,5738,140278,8,316141
13271,0.019855,172.31.36.0-255,66,140344,8,316141
13272,0.021509,172.217.27.0-255,5738,146082,8,316141
13273,0.021516,172.31.36.0-255,66,146148,8,316141
13274,0.023185,172.217.27.0-255,5738,151886,8,316141
13275,0.023192,172.31.36.0-255,66,151952,8,316141
13276,0.024853,172.217.27.0-255,5738,157690,8,316141
13277,0.024861,172.31.36.0-255,66,157756,8,316141
13278,0.026539,172.217.27.0-255,5738,163494,8,316141
13279,0.026546,172.31.36.0-255,66,163560,8,316141
13280,0.028218,172.217.27.0-255,5738,169298,8,316141
13281,0.028224,172.31.36.0-255,66,169364,8,316141
13282,0.029891,172.217.27.0-255,5738,175102,8,316141
13283,0.029898,172.31.36.0-255,66,175168,8,316141
13284,0.031564,172.217.27.0-255,5738,180906,8,316141
13285,0.03157,172.31.36.0-255,66,180972,8,316141
13286,0.031889,172.31.36.0-255,172,181144,8,316141
13287,0.03193,172.31.36.0-255,1110,182254,8,316141
13288,0.032005,172.31.36.0-255,1514,183768,8,316141
13289,0.032007,172.31.36.0-255,1514,185282,8,316141
13290,0.032012,172.31.36.0-255,1514,186796,8,316141
13291,0.032013,172.31.36.0-255,1514,188310,8,316141
13292,0.03204,172.31.36.0-255,1231,189541,8,316141
13293,0.033254,172.217.27.0-255,5738,195279,8,316141
13294,0.033264,172.31.36.0-255,66,195345,8,316141
13295,0.033455,104.244.42.0-255,66,195411,8,316141
13296,0.033464,104.244.42.0-255,66,195477,8,316141
13297,0.033557,104.244.42.0-255,66,195543,8,316141
13298,0.033614,104.244.42.0-255,66,195609,8,316141
13299,0.034925,172.217.27.0-255,5738,201347,8,316141
13300,0.034933,172.31.36.0-255,66,201413,8,316141
13301,0.036606,172.217.27.0-255,5738,207151,8,316141
13302,0.036614,172.31.36.0-255,66,207217,8,316141
13303,0.038279,172.217.27.0-255,5738,212955,8,316141
13304,0.038288,172.31.36.0-255,66,213021,8,316141
13305,0.039954,172.217.27.0-255,5738,218759,8,316141
13306,0.039962,172.31.36.0-255,66,218825,8,316141
13307,0.041632,172.217.27.0-255,5738,224563,8,316141
13308,0.041648,172.31.36.0-255,66,224629,8,316141
13309,0.043337,172.217.27.0-255,5738,230367,8,316141
13310,0.043347,172.31.36.0-255,66,230433,8,316141
13311,0.045066,172.217.27.0-255,5738,236171,8,316141
13312,0.045072,172.31.36.0-255,66,236237,8,316141
13313,0.046736,172.217.27.0-255,5738,241975,8,316141
13314,0.046741,172.31.36.0-255,66,242041,8,316141
13315,0.048399,172.217.27.0-255,5738,247779,8,316141
13316,0.048406,172.31.36.0-255,66,247845,8,316141
13317,0.050081,172.217.27.0-255,5738,253583,8,316141
13318,0.050088,172.31.36.0-255,66,253649,8,316141
13319,0.051747,172.217.27.0-255,5738,259387,8,316141
13320,0.051753,172.31.36.0-255,66,259453,8,316141
13321,0.053411,172.217.27.0-255,5738,265191,8,316141
13322,0.053418,172.31.36.0-255,66,265257,8,316141
13323,0.055075,172.217.27.0-255,5738,270995,8,316141
13324,0.055081,172.31.36.0-255,66,271061,8,316141
13325,0.056747,172.217.27.0-255,4320,275381,8,316141
13326,0.056754,172.31.36.0-255,66,275447,8,316141
13327,0.056782,172.217.27.0-255,1484,276931,8,316141
13328,0.058412,172.217.27.0-255,4320,281251,8,316141
13329,0.058419,172.31.36.0-255,66,281317,8,316141
13330,0.060087,172.217.27.0-255,5738,287055,8,316141
13331,0.060128,172.31.36.0-255,66,287121,8,316141
13332,0.061798,172.217.27.0-255,5738,292859,8,316141
13333,0.061804,172.31.36.0-255,66,292925,8,316141
13334,0.063487,172.217.27.0-255,5738,298663,8,316141
13335,0.063497,172.31.36.0-255,66,298729,8,316141
13336,0.065166,172.217.27.0-255,5738,304467,8,316141
13337,0.065171,172.31.36.0-255,66,304533,8,316141
13338,0.066828,172.217.27.0-255,5738,310271,8,316141
13339,0.066834,172.31.36.0-255,66,310337,8,316141
13340,0.068496,172.217.27.0-255,5738,316075,8,316141
13341,0.068502,172.31.36.0-255,66,316141,8,316141
13342,0.0,172.217.160.0-255,146,146,8,332905
13343,1.7e-05,172.31.36.0-255,66,212,8,332905
13344,2.5e-05,172.217.160.0-255,1484,1696,8,332905
13345,3e-05,172.31.36.0-255,66,1762,8,332905
13346,3.6e-05,172.217.160.0-255,2902,4664,8,332905
13347,4e-05,172.31.36.0-255,66,4730,8,332905
13348,4.7e-05,172.217.160.0-255,5738,10468,8,332905
13349,5e-05,172.31.36.0-255,66,10534,8,332905
13350,7e-05,172.217.160.0-255,2902,13436,8,332905
13351,7.3e-05,172.31.36.0-255,66,13502,8,332905
13352,8.5e-05,172.217.160.0-255,568,14070,8,332905
13353,8.7e-05,172.31.36.0-255,66,14136,8,332905
13354,0.000119,172.217.160.0-255,4320,18456,8,332905
13355,0.000122,172.31.36.0-255,66,18522,8,332905
13356,0.000133,172.31.36.0-255,66,18588,8,332905
13357,0.000158,172.217.160.0-255,2543,21131,8,332905
13358,0.00016,172.31.36.0-255,66,21197,8,332905
13359,0.00018,172.217.160.0-255,5738,26935,8,332905
13360,0.000183,172.31.36.0-255,66,27001,8,332905
13361,0.000205,172.31.36.0-255,66,27067,8,332905
13362,0.000269,172.217.160.0-255,2543,29610,8,332905
13363,0.000272,172.31.36.0-255,66,29676,8,332905
13364,0.000275,172.217.160.0-255,1484,31160,8,332905
13365,0.000278,172.31.36.0-255,66,31226,8,332905
13366,0.000291,172.217.160.0-255,1484,32710,8,332905
13367,0.000293,172.31.36.0-255,66,32776,8,332905
13368,0.000301,172.217.160.0-255,7156,39932,8,332905
13369,0.000304,172.31.36.0-255,66,39998,8,332905
13370,0.00034,172.217.160.0-255,5738,45736,8,332905
13371,0.000344,172.31.36.0-255,66,45802,8,332905
13372,0.000378,172.217.160.0-255,1394,47196,8,332905
13373,0.000611,172.217.160.0-255,408,47604,8,332905
13374,0.000617,172.31.36.0-255,66,47670,8,332905
13375,0.000678,172.217.160.0-255,1484,49154,8,332905
13376,0.000683,172.217.160.0-255,2902,52056,8,332905
13377,0.000686,172.31.36.0-255,66,52122,8,332905
13378,0.000692,172.217.160.0-255,2902,55024,8,332905
13379,0.000694,172.31.36.0-255,66,55090,8,332905
13380,0.000707,172.217.160.0-255,2902,57992,8,332905
13381,0.000709,172.31.36.0-255,66,58058,8,332905
13382,0.000729,172.217.160.0-255,6797,64855,8,332905
13383,0.000731,172.31.36.0-255,66,64921,8,332905
13384,0.000779,172.31.36.0-255,66,64987,8,332905
13385,0.000803,172.217.160.0-255,5738,70725,8,332905
13386,0.000806,172.31.36.0-255,66,70791,8,332905
13387,0.000854,172.217.160.0-255,1484,72275,8,332905
13388,0.000856,172.217.160.0-255,1125,73400,8,332905
13389,0.000861,172.31.36.0-255,66,73466,8,332905
13390,0.000879,172.217.160.0-255,1484,74950,8,332905
13391,0.000893,172.217.160.0-255,2902,77852,8,332905
13392,0.000896,172.31.36.0-255,66,77918,8,332905
13393,0.000938,172.31.36.0-255,66,77984,8,332905
13394,0.000964,172.217.160.0-255,1484,79468,8,332905
13395,0.000971,172.217.160.0-255,5738,85206,8,332905
13396,0.000976,172.31.36.0-255,66,85272,8,332905
13397,0.001012,172.31.36.0-255,66,85338,8,332905
13398,0.001045,172.217.160.0-255,5020,90358,8,332905
13399,0.001067,172.31.36.0-255,66,90424,8,332905
13400,0.001077,172.217.160.0-255,4320,94744,8,332905
13401,0.001082,172.31.36.0-255,66,94810,8,332905
13402,0.001117,172.217.160.0-255,4320,99130,8,332905
13403,0.001131,172.31.36.0-255,66,99196,8,332905
13404,0.001198,172.31.36.0-255,66,99262,8,332905
13405,0.00121,172.217.160.0-255,6438,105700,8,332905
13406,0.001215,172.31.36.0-255,66,105766,8,332905
13407,0.001278,172.217.160.0-255,5738,111504,8,332905
13408,0.001297,172.31.36.0-255,66,111570,8,332905
13409,0.001318,172.31.36.0-255,66,111636,8,332905
13410,0.001369,172.217.160.0-255,7156,118792,8,332905
13411,0.001403,172.31.36.0-255,66,118858,8,332905
13412,0.001459,172.217.160.0-255,3602,122460,8,332905
13413,0.001464,172.31.36.0-255,66,122526,8,332905
13414,0.001513,172.217.160.0-255,1484,124010,8,332905
13415,0.001519,172.217.160.0-255,2902,126912,8,332905
13416,0.001526,172.31.36.0-255,66,126978,8,332905
13417,0.00154,172.217.160.0-255,5738,132716,8,332905
13418,0.001563,172.217.160.0-255,7156,139872,8,332905
13419,0.001579,172.217.160.0-255,5738,145610,8,332905
13420,0.001583,172.31.36.0-255,66,145676,8,332905
13421,0.001588,172.31.36.0-255,66,145742,8,332905
13422,0.00167,172.31.36.0-255,66,145808,8,332905
13423,0.003301,172.217.160.0-255,5738,151546,8,332905
13424,0.003309,172.31.36.0-255,66,151612,8,332905
13425,0.004934,172.217.160.0-255,5738,157350,8,332905
13426,0.004941,172.31.36.0-255,66,157416,8,332905
13427,0.006576,172.217.160.0-255,5738,163154,8,332905
13428,0.00658,172.31.36.0-255,66,163220,8,332905
13429,0.008198,172.217.160.0-255,5738,168958,8,332905
13430,0.008204,172.31.36.0-255,66,169024,8,332905
13431,0.009833,172.217.160.0-255,5738,174762,8,332905
13432,0.00984,172.31.36.0-255,66,174828,8,332905
13433,0.011474,172.217.160.0-255,5738,180566,8,332905
13434,0.011481,172.31.36.0-255,66,180632,8,332905
13435,0.013115,172.217.160.0-255,5738,186370,8,332905
13436,0.013123,172.31.36.0-255,66,186436,8,332905
13437,0.01475,172.217.160.0-255,5738,192174,8,332905
13438,0.014758,172.31.36.0-255,66,192240,8,332905
13439,0.016396,172.217.160.0-255,5738,197978,8,332905
13440,0.016404,172.31.36.0-255,66,198044,8,332905
13441,0.018049,172.217.160.0-255,5738,203782,8,332905
13442,0.018055,172.31.36.0-255,66,203848,8,332905
13443,0.01972,172.217.160.0-255,5738,209586,8,332905
13444,0.019729,172.31.36.0-255,66,209652,8,332905
13445,0.021349,172.217.160.0-255,5738,215390,8,332905
13446,0.021356,172.31.36.0-255,66,215456,8,332905
13447,0.022983,172.217.160.0-255,5738,221194,8,332905
13448,0.022989,172.31.36.0-255,66,221260,8,332905
13449,0.024609,172.217.160.0-255,5738,226998,8,332905
13450,0.024615,172.31.36.0-255,66,227064,8,332905
13451,0.02624,172.217.160.0-255,5738,232802,8,332905
13452,0.026247,172.31.36.0-255,66,232868,8,332905
13453,0.027888,172.217.160.0-255,5738,238606,8,332905
13454,0.027895,172.31.36.0-255,66,238672,8,332905
13455,0.029531,172.217.160.0-255,5738,244410,8,332905
13456,0.029539,172.31.36.0-255,66,244476,8,332905
13457,0.031168,172.217.160.0-255,5738,250214,8,332905
13458,0.031176,172.31.36.0-255,66,250280,8,332905
13459,0.032797,172.217.160.0-255,5738,256018,8,332905
13460,0.032804,172.31.36.0-255,66,256084,8,332905
13461,0.034428,172.217.160.0-255,5738,261822,8,332905
13462,0.034436,172.31.36.0-255,66,261888,8,332905
13463,0.036063,172.217.160.0-255,5738,267626,8,332905
13464,0.036071,172.31.36.0-255,66,267692,8,332905
13465,0.037701,172.217.160.0-255,5738,273430,8,332905
13466,0.037708,172.31.36.0-255,66,273496,8,332905
13467,0.038418,172.31.36.0-255,176,273672,8,332905
13468,0.038453,172.31.36.0-255,1111,274783,8,332905
13469,0.038518,172.31.36.0-255,1514,276297,8,332905
13470,0.038519,172.31.36.0-255,1514,277811,8,332905
13471,0.038525,172.31.36.0-255,1514,279325,8,332905
13472,0.038526,172.31.36.0-255,1514,280839,8,332905
13473,0.038544,172.31.36.0-255,1275,282114,8,332905
13474,0.039334,172.217.160.0-255,5738,287852,8,332905
13475,0.03934,172.31.36.0-255,66,287918,8,332905
13476,0.039948,104.244.42.0-255,66,287984,8,332905
13477,0.03999,104.244.42.0-255,66,288050,8,332905
13478,0.040078,104.244.42.0-255,66,288116,8,332905
13479,0.040083,104.244.42.0-255,66,288182,8,332905
13480,0.040964,172.217.160.0-255,5738,293920,8,332905
13481,0.040973,172.31.36.0-255,66,293986,8,332905
13482,0.042603,172.217.160.0-255,5738,299724,8,332905
13483,0.042609,172.31.36.0-255,66,299790,8,332905
13484,0.044229,172.217.160.0-255,5738,305528,8,332905
13485,0.044236,172.31.36.0-255,66,305594,8,332905
13486,0.045852,172.217.160.0-255,5738,311332,8,332905
13487,0.045858,172.31.36.0-255,66,311398,8,332905
13488,0.047475,172.217.160.0-255,5738,317136,8,332905
13489,0.047482,172.31.36.0-255,66,317202,8,332905
13490,0.049109,172.217.160.0-255,5738,322940,8,332905
13491,0.049115,172.31.36.0-255,66,323006,8,332905
13492,0.050736,172.217.160.0-255,5738,328744,8,332905
13493,0.050742,172.31.36.0-255,66,328810,8,332905
13494,0.052364,172.217.160.0-255,3858,332668,8,332905
13495,0.05237,172.31.36.0-255,66,332734,8,332905
13496,0.052547,172.31.36.0-255,105,332839,8,332905
13497,0.054133,172.217.160.0-255,66,332905,8,332905
13498,0.0,74.125.24.0-255,151,151,8,270065
13499,2.9e-05,172.31.36.0-255,66,217,8,270065
13500,3.6e-05,74.125.24.0-255,1484,1701,8,270065
13501,4.1e-05,172.31.36.0-255,66,1767,8,270065
13502,4.7e-05,74.125.24.0-255,2902,4669,8,270065
13503,5.9e-05,172.31.36.0-255,66,4735,8,270065
13504,6.7e-05,74.125.24.0-255,7156,11891,8,270065
13505,7e-05,172.31.36.0-255,66,11957,8,270065
13506,7.7e-05,74.125.24.0-255,2051,14008,8,270065
13507,8e-05,172.31.36.0-255,66,14074,8,270065
13508,0.000201,74.125.24.0-255,1484,15558,8,270065
13509,0.000205,172.31.36.0-255,66,15624,8,270065
13510,0.000211,74.125.24.0-255,2902,18526,8,270065
13511,0.000213,172.31.36.0-255,66,18592,8,270065
13512,0.000225,74.125.24.0-255,5738,24330,8,270065
13513,0.000227,172.31.36.0-255,66,24396,8,270065
13514,0.000253,74.125.24.0-255,6797,31193,8,270065
13515,0.000256,172.31.36.0-255,66,31259,8,270065
13516,0.000293,74.125.24.0-255,7156,38415,8,270065
13517,0.000296,172.31.36.0-255,66,38481,8,270065
13518,0.000301,74.125.24.0-255,2902,41383,8,270065
13519,0.000302,172.31.36.0-255,66,41449,8,270065
13520,0.000345,74.125.24.0-255,6797,48246,8,270065
13521,0.000348,172.31.36.0-255,66,48312,8,270065
13522,0.000901,74.125.24.0-255,1484,49796,8,270065
13523,0.000909,172.31.36.0-255,66,49862,8,270065
13524,0.000923,74.125.24.0-255,2902,52764,8,270065
13525,0.000925,172.31.36.0-255,66,52830,8,270065
13526,0.000936,74.125.24.0-255,5738,58568,8,270065
13527,0.000939,172.31.36.0-255,66,58634,8,270065
13528,0.000984,74.125.24.0-255,7098,65732,8,270065
13529,0.000987,172.31.36.0-255,66,65798,8,270065
13530,0.001538,74.125.24.0-255,376,66174,8,270065
13531,0.001683,74.125.24.0-255,1484,67658,8,270065
13532,0.001689,172.31.36.0-255,66,67724,8,270065
13533,0.001696,74.125.24.0-255,2902,70626,8,270065
13534,0.001698,172.31.36.0-255,66,70692,8,270065
13535,0.00171,74.125.24.0-255,5738,76430,8,270065
13536,0.001712,172.31.36.0-255,66,76496,8,270065
13537,0.001718,74.125.24.0-255,2902,79398,8,270065
13538,0.001721,172.31.36.0-255,66,79464,8,270065
13539,0.00175,74.125.24.0-255,3961,83425,8,270065
13540,0.001752,172.31.36.0-255,66,83491,8,270065
13541,0.001761,74.125.24.0-255,7156,90647,8,270065
13542,0.001763,172.31.36.0-255,66,90713,8,270065
13543,0.001792,74.125.24.0-255,7156,97869,8,270065
13544,0.001794,172.31.36.0-255,66,97935,8,270065
13545,0.001799,74.125.24.0-255,2543,100478,8,270065
13546,0.001801,172.31.36.0-255,66,100544,8,270065
13547,0.001887,74.125.24.0-255,1484,102028,8,270065
13548,0.0019,74.125.24.0-255,2902,104930,8,270065
13549,0.001903,172.31.36.0-255,66,104996,8,270065
13550,0.001931,74.125.24.0-255,5738,110734,8,270065
13551,0.001934,172.31.36.0-255,66,110800,8,270065
13552,0.001938,74.125.24.0-255,2902,113702,8,270065
13553,0.001941,172.31.36.0-255,66,113768,8,270065
13554,0.001966,74.125.24.0-255,3294,117062,8,270065
13555,0.001973,172.31.36.0-255,66,117128,8,270065
13556,0.004549,74.125.24.0-255,1484,118612,8,270065
13557,0.004587,74.125.24.0-255,4320,122932,8,270065
13558,0.004593,172.31.36.0-255,66,122998,8,270065
13559,0.007221,74.125.24.0-255,5738,128736,8,270065
13560,0.007237,172.31.36.0-255,66,128802,8,270065
13561,0.009895,74.125.24.0-255,5738,134540,8,270065
13562,0.009914,172.31.36.0-255,66,134606,8,270065
13563,0.012536,74.125.24.0-255,5738,140344,8,270065
13564,0.012551,172.31.36.0-255,66,140410,8,270065
13565,0.015183,74.125.24.0-255,5738,146148,8,270065
13566,0.015206,172.31.36.0-255,66,146214,8,270065
13567,0.01785,74.125.24.0-255,5738,151952,8,270065
13568,0.017866,172.31.36.0-255,66,152018,8,270065
13569,0.02047,74.125.24.0-255,5738,157756,8,270065
13570,0.020482,172.31.36.0-255,66,157822,8,270065
13571,0.02307,74.125.24.0-255,5738,163560,8,270065
13572,0.023083,172.31.36.0-255,66,163626,8,270065
13573,0.025692,74.125.24.0-255,5738,169364,8,270065
13574,0.025707,172.31.36.0-255,66,169430,8,270065
13575,0.026804,172.31.36.0-255,172,169602,8,270065
13576,0.026843,172.31.36.0-255,1112,170714,8,270065
13577,0.026919,172.31.36.0-255,1514,172228,8,270065
13578,0.026921,172.31.36.0-255,1514,173742,8,270065
13579,0.026923,172.31.36.0-255,1514,175256,8,270065
13580,0.026948,172.31.36.0-255,1514,176770,8,270065
13581,0.026949,172.31.36.0-255,167,176937,8,270065
13582,0.02835,104.244.42.0-255,66,177003,8,270065
13583,0.028361,74.125.24.0-255,5738,182741,8,270065
13584,0.028368,172.31.36.0-255,66,182807,8,270065
13585,0.028401,104.244.42.0-255,66,182873,8,270065
13586,0.028475,104.244.42.0-255,66,182939,8,270065
13587,0.028532,104.244.42.0-255,66,183005,8,270065
13588,0.031027,74.125.24.0-255,5738,188743,8,270065
13589,0.031037,172.31.36.0-255,66,188809,8,270065
13590,0.033671,74.125.24.0-255,5738,194547,8,270065
13591,0.033685,172.31.36.0-255,66,194613,8,270065
13592,0.036381,74.125.24.0-255,5738,200351,8,270065
13593,0.0364,172.31.36.0-255,66,200417,8,270065
13594,0.039027,74.125.24.0-255,5738,206155,8,270065
13595,0.03904,172.31.36.0-255,66,206221,8,270065
13596,0.041666,74.125.24.0-255,5738,211959,8,270065
13597,0.041674,172.31.36.0-255,66,212025,8,270065
13598,0.044297,74.125.24.0-255,5738,217763,8,270065
13599,0.04432,172.31.36.0-255,66,217829,8,270065
13600,0.046973,74.125.24.0-255,5738,223567,8,270065
13601,0.046984,172.31.36.0-255,66,223633,8,270065
13602,0.049612,74.125.24.0-255,5738,229371,8,270065
13603,0.049623,172.31.36.0-255,66,229437,8,270065
13604,0.052263,74.125.24.0-255,5738,235175,8,270065
13605,0.052274,172.31.36.0-255,66,235241,8,270065
13606,0.054963,74.125.24.0-255,5738,240979,8,270065
13607,0.054976,172.31.36.0-255,66,241045,8,270065
13608,0.057584,74.125.24.0-255,5738,246783,8,270065
13609,0.057595,172.31.36.0-255,66,246849,8,270065
13610,0.060241,74.125.24.0-255,5738,252587,8,270065
13611,0.060252,172.31.36.0-255,66,252653,8,270065
13612,0.062879,74.125.24.0-255,5738,258391,8,270065
13613,0.062892,172.31.36.0-255,66,258457,8,270065
13614,0.065491,74.125.24.0-255,5738,264195,8,270065
13615,0.065496,172.31.36.0-255,66,264261,8,270065
13616,0.068128,74.125.24.0-255,5738,269999,8,270065
13617,0.068144,172.31.36.0-255,66,270065,8,270065
13618,0.0,172.217.194.0-255,153,153,8,313846
13619,2.3e-05,172.31.36.0-255,66,219,8,313846
13620,3.1e-05,172.217.194.0-255,1484,1703,8,313846
13621,3.5e-05,172.31.36.0-255,66,1769,8,313846
13622,4.1e-05,172.217.194.0-255,2902,4671,8,313846
13623,4.4e-05,172.31.36.0-255,66,4737,8,313846
13624,5e-05,172.217.194.0-255,5738,10475,8,313846
13625,5.3e-05,172.31.36.0-255,66,10541,8,313846
13626,7.3e-05,172.217.194.0-255,5738,16279,8,313846
13627,7.6e-05,172.31.36.0-255,66,16345,8,313846
13628,9.6e-05,172.217.194.0-255,3435,19780,8,313846
13629,9.8e-05,172.31.36.0-255,66,19846,8,313846
13630,0.000121,172.31.36.0-255,66,19912,8,313846
13631,0.000123,172.217.194.0-255,1125,21037,8,313846
13632,0.000125,172.31.36.0-255,66,21103,8,313846
13633,0.000372,172.217.194.0-255,1484,22587,8,313846
13634,0.000377,172.31.36.0-255,66,22653,8,313846
13635,0.000399,172.217.194.0-255,2902,25555,8,313846
13636,0.000402,172.31.36.0-255,66,25621,8,313846
13637,0.000408,172.217.194.0-255,5738,31359,8,313846
13638,0.000411,172.31.36.0-255,66,31425,8,313846
13639,0.000429,172.217.194.0-255,7156,38581,8,313846
13640,0.000431,172.31.36.0-255,66,38647,8,313846
13641,0.000463,172.217.194.0-255,7156,45803,8,313846
13642,0.000466,172.31.36.0-255,66,45869,8,313846
13643,0.000491,172.217.194.0-255,7156,53025,8,313846
13644,0.000494,172.31.36.0-255,66,53091,8,313846
13645,0.000498,172.217.194.0-255,2184,55275,8,313846
13646,0.0005,172.31.36.0-255,66,55341,8,313846
13647,0.000567,172.217.194.0-255,646,55987,8,313846
13648,0.00057,172.31.36.0-255,66,56053,8,313846
13649,0.000589,172.217.194.0-255,1484,57537,8,313846
13650,0.00061,172.217.194.0-255,2902,60439,8,313846
13651,0.000613,172.31.36.0-255,66,60505,8,313846
13652,0.000631,172.217.194.0-255,1484,61989,8,313846
13653,0.000635,172.217.194.0-255,2902,64891,8,313846
13654,0.000637,172.31.36.0-255,66,64957,8,313846
13655,0.000642,172.217.194.0-255,2902,67859,8,313846
13656,0.000644,172.31.36.0-255,66,67925,8,313846
13657,0.000663,172.217.194.0-255,5738,73663,8,313846
13658,0.000666,172.31.36.0-255,66,73729,8,313846
13659,0.000684,172.217.194.0-255,7156,80885,8,313846
13660,0.000687,172.31.36.0-255,66,80951,8,313846
13661,0.000698,172.217.194.0-255,4320,85271,8,313846
13662,0.0007,172.31.36.0-255,66,85337,8,313846
13663,0.000746,172.217.194.0-255,2902,88239,8,313846
13664,0.000748,172.31.36.0-255,66,88305,8,313846
13665,0.000759,172.217.194.0-255,2184,90489,8,313846
13666,0.000761,172.31.36.0-255,66,90555,8,313846
13667,0.000874,172.217.194.0-255,1484,92039,8,313846
13668,0.000879,172.217.194.0-255,2902,94941,8,313846
13669,0.000881,172.31.36.0-255,66,95007,8,313846
13670,0.000902,172.217.194.0-255,5738,100745,8,313846
13671,0.000904,172.31.36.0-255,66,100811,8,313846
13672,0.000942,172.31.36.0-255,66,100877,8,313846
13673,0.000964,172.217.194.0-255,4320,105197,8,313846
13674,0.000967,172.31.36.0-255,66,105263,8,313846
13675,0.000973,172.217.194.0-255,5738,111001,8,313846
13676,0.000974,172.31.36.0-255,66,111067,8,313846
13677,0.000996,172.217.194.0-255,5020,116087,8,313846
13678,0.000998,172.31.36.0-255,66,116153,8,313846
13679,0.00127,172.217.194.0-255,1484,117637,8,313846
13680,0.001275,172.217.194.0-255,2902,120539,8,313846
13681,0.001278,172.31.36.0-255,66,120605,8,313846
13682,0.001302,172.217.194.0-255,5738,126343,8,313846
13683,0.001304,172.31.36.0-255,66,126409,8,313846
13684,0.001339,172.31.36.0-255,66,126475,8,313846
13685,0.001379,172.31.36.0-255,66,126541,8,313846
13686,0.001471,172.217.194.0-255,1484,128025,8,313846
13687,0.001494,172.217.194.0-255,2902,130927,8,313846
13688,0.001497,172.31.36.0-255,66,130993,8,313846
13689,0.001504,172.217.194.0-255,5738,136731,8,313846
13690,0.001506,172.31.36.0-255,66,136797,8,313846
13691,0.001538,172.217.194.0-255,1484,138281,8,313846
13692,0.001563,172.31.36.0-255,66,138347,8,313846
13693,0.00158,172.217.194.0-255,5738,144085,8,313846
13694,0.001582,172.31.36.0-255,66,144151,8,313846
13695,0.001597,172.217.194.0-255,6438,150589,8,313846
13696,0.001599,172.31.36.0-255,66,150655,8,313846
13697,0.001627,172.217.194.0-255,4320,154975,8,313846
13698,0.00163,172.31.36.0-255,66,155041,8,313846
13699,0.001651,172.217.194.0-255,5738,160779,8,313846
13700,0.001656,172.31.36.0-255,66,160845,8,313846
13701,0.001684,172.31.36.0-255,66,160911,8,313846
13702,0.001698,172.217.194.0-255,1484,162395,8,313846
13703,0.001704,172.217.194.0-255,5738,168133,8,313846
13704,0.001706,172.31.36.0-255,66,168199,8,313846
13705,0.001725,172.217.194.0-255,2902,171101,8,313846
13706,0.001728,172.31.36.0-255,66,171167,8,313846
13707,0.001764,172.217.194.0-255,2902,174069,8,313846
13708,0.001767,172.31.36.0-255,66,174135,8,313846
13709,0.001783,172.217.194.0-255,7156,181291,8,313846
13710,0.001785,172.31.36.0-255,66,181357,8,313846
13711,0.001819,172.217.194.0-255,5020,186377,8,313846
13712,0.001822,172.31.36.0-255,66,186443,8,313846
13713,0.00185,172.31.36.0-255,66,186509,8,313846
13714,0.001855,172.217.194.0-255,4320,190829,8,313846
13715,0.001857,172.31.36.0-255,66,190895,8,313846
13716,0.001861,172.217.194.0-255,2184,193079,8,313846
13717,0.001863,172.31.36.0-255,66,193145,8,313846
13718,0.001882,172.217.194.0-255,1484,194629,8,313846
13719,0.001908,172.217.194.0-255,2902,197531,8,313846
13720,0.001912,172.31.36.0-255,66,197597,8,313846
13721,0.001931,172.217.194.0-255,5738,203335,8,313846
13722,0.001934,172.31.36.0-255,66,203401,8,313846
13723,0.001937,172.217.194.0-255,1484,204885,8,313846
13724,0.001963,172.31.36.0-255,66,204951,8,313846
13725,0.002002,172.31.36.0-255,66,205017,8,313846
13726,0.002027,172.217.194.0-255,2184,207201,8,313846
13727,0.002032,172.31.36.0-255,66,207267,8,313846
13728,0.002271,172.217.194.0-255,1484,208751,8,313846
13729,0.002278,172.217.194.0-255,2902,211653,8,313846
13730,0.002282,172.31.36.0-255,66,211719,8,313846
13731,0.002298,172.217.194.0-255,2902,214621,8,313846
13732,0.0023,172.31.36.0-255,66,214687,8,313846
13733,0.002325,172.217.194.0-255,2902,217589,8,313846
13734,0.002327,172.31.36.0-255,66,217655,8,313846
13735,0.002348,172.217.194.0-255,5738,223393,8,313846
13736,0.00235,172.31.36.0-255,66,223459,8,313846
13737,0.002369,172.217.194.0-255,7156,230615,8,313846
13738,0.002372,172.31.36.0-255,66,230681,8,313846
13739,0.002385,172.31.36.0-255,66,230747,8,313846
13740,0.004717,172.217.194.0-255,5738,236485,8,313846
13741,0.004729,172.31.36.0-255,66,236551,8,313846
13742,0.007074,172.217.194.0-255,5738,242289,8,313846
13743,0.007079,172.31.36.0-255,66,242355,8,313846
13744,0.009431,172.217.194.0-255,5738,248093,8,313846
13745,0.009442,172.31.36.0-255,66,248159,8,313846
13746,0.011793,172.217.194.0-255,5738,253897,8,313846
13747,0.011808,172.31.36.0-255,66,253963,8,313846
13748,0.014209,172.217.194.0-255,5738,259701,8,313846
13749,0.014225,172.31.36.0-255,66,259767,8,313846
13750,0.016557,172.217.194.0-255,5738,265505,8,313846
13751,0.016571,172.31.36.0-255,66,265571,8,313846
13752,0.018923,172.217.194.0-255,5738,271309,8,313846
13753,0.018931,172.31.36.0-255,66,271375,8,313846
13754,0.02127,172.217.194.0-255,5738,277113,8,313846
13755,0.021278,172.31.36.0-255,66,277179,8,313846
13756,0.02363,172.217.194.0-255,5738,282917,8,313846
13757,0.023639,172.31.36.0-255,66,282983,8,313846
13758,0.025971,172.217.194.0-255,5738,288721,8,313846
13759,0.025978,172.31.36.0-255,66,288787,8,313846
13760,0.0283,172.217.194.0-255,5738,294525,8,313846
13761,0.02831,172.31.36.0-255,66,294591,8,313846
13762,0.030659,172.217.194.0-255,5738,300329,8,313846
13763,0.030668,172.31.36.0-255,66,300395,8,313846
13764,0.033004,172.217.194.0-255,5738,306133,8,313846
13765,0.033014,172.31.36.0-255,66,306199,8,313846
13766,0.035157,172.31.36.0-255,171,306370,8,313846
13767,0.035198,172.31.36.0-255,1150,307520,8,313846
13768,0.035272,172.31.36.0-255,1514,309034,8,313846
13769,0.035274,172.31.36.0-255,1514,310548,8,313846
13770,0.035279,172.31.36.0-255,1514,312062,8,313846
13771,0.03528,172.31.36.0-255,733,312795,8,313846
13772,0.035319,172.217.194.0-255,376,313171,8,313846
13773,0.035423,172.31.36.0-255,66,313237,8,313846
13774,0.035455,172.31.36.0-255,105,313342,8,313846
13775,0.036706,104.244.42.0-255,66,313408,8,313846
13776,0.036751,104.244.42.0-255,66,313474,8,313846
13777,0.036853,104.244.42.0-255,66,313540,8,313846
13778,0.036867,104.244.42.0-255,66,313606,8,313846
13779,0.03773,104.244.42.0-255,108,313714,8,313846
13780,0.037737,172.31.36.0-255,66,313780,8,313846
13781,0.037741,172.217.194.0-255,66,313846,8,313846
13782,0.0,172.217.194.0-255,153,153,8,258527
13783,2.7e-05,172.31.36.0-255,66,219,8,258527
13784,3.4e-05,172.217.194.0-255,1484,1703,8,258527
13785,3.9e-05,172.31.36.0-255,66,1769,8,258527
13786,4.4e-05,172.217.194.0-255,2902,4671,8,258527
13787,5.8e-05,172.31.36.0-255,66,4737,8,258527
13788,6.5e-05,172.217.194.0-255,5738,10475,8,258527
13789,6.8e-05,172.31.36.0-255,66,10541,8,258527
13790,8.1e-05,172.31.36.0-255,66,10607,8,258527
13791,0.000111,172.217.194.0-255,4320,14927,8,258527
13792,0.000115,172.31.36.0-255,66,14993,8,258527
13793,0.000151,172.217.194.0-255,5379,20372,8,258527
13794,0.000156,172.31.36.0-255,66,20438,8,258527
13795,0.000159,172.217.194.0-255,1484,21922,8,258527
13796,0.000161,172.31.36.0-255,66,21988,8,258527
13797,0.000166,172.217.194.0-255,2902,24890,8,258527
13798,0.000171,172.31.36.0-255,66,24956,8,258527
13799,0.000176,172.217.194.0-255,5738,30694,8,258527
13800,0.000178,172.31.36.0-255,66,30760,8,258527
13801,0.000192,172.31.36.0-255,66,30826,8,258527
13802,0.000198,172.217.194.0-255,7156,37982,8,258527
13803,0.000202,172.31.36.0-255,66,38048,8,258527
13804,0.000226,172.217.194.0-255,1484,39532,8,258527
13805,0.000228,172.31.36.0-255,66,39598,8,258527
13806,0.000233,172.217.194.0-255,2508,42106,8,258527
13807,0.000235,172.31.36.0-255,66,42172,8,258527
13808,0.000256,172.217.194.0-255,386,42558,8,258527
13809,0.000259,172.31.36.0-255,66,42624,8,258527
13810,0.000349,172.217.194.0-255,1484,44108,8,258527
13811,0.000354,172.31.36.0-255,66,44174,8,258527
13812,0.000358,172.217.194.0-255,1484,45658,8,258527
13813,0.00038,172.217.194.0-255,1484,47142,8,258527
13814,0.000384,172.31.36.0-255,66,47208,8,258527
13815,0.00039,172.217.194.0-255,5738,52946,8,258527
13816,0.000393,172.31.36.0-255,66,53012,8,258527
13817,0.000419,172.217.194.0-255,6797,59809,8,258527
13818,0.000423,172.31.36.0-255,66,59875,8,258527
13819,0.000429,172.217.194.0-255,5738,65613,8,258527
13820,0.000432,172.31.36.0-255,66,65679,8,258527
13821,0.000462,172.31.36.0-255,66,65745,8,258527
13822,0.000466,172.217.194.0-255,2543,68288,8,258527
13823,0.000469,172.31.36.0-255,66,68354,8,258527
13824,0.000784,172.217.194.0-255,1484,69838,8,258527
13825,0.00079,172.217.194.0-255,2902,72740,8,258527
13826,0.000793,172.31.36.0-255,66,72806,8,258527
13827,0.000799,172.217.194.0-255,4320,77126,8,258527
13828,0.000801,172.31.36.0-255,66,77192,8,258527
13829,0.000834,172.217.194.0-255,5738,82930,8,258527
13830,0.000838,172.31.36.0-255,66,82996,8,258527
13831,0.000845,172.217.194.0-255,5738,88734,8,258527
13832,0.000847,172.31.36.0-255,66,88800,8,258527
13833,0.000886,172.217.194.0-255,5738,94538,8,258527
13834,0.00089,172.31.36.0-255,66,94604,8,258527
13835,0.000901,172.31.36.0-255,66,94670,8,258527
13836,0.000966,172.217.194.0-255,1484,96154,8,258527
13837,0.000989,172.217.194.0-255,2902,99056,8,258527
13838,0.000993,172.31.36.0-255,66,99122,8,258527
13839,0.000999,172.217.194.0-255,5738,104860,8,258527
13840,0.001001,172.31.36.0-255,66,104926,8,258527
13841,0.001011,172.217.194.0-255,2902,107828,8,258527
13842,0.001014,172.31.36.0-255,66,107894,8,258527
13843,0.001067,172.31.36.0-255,66,107960,8,258527
13844,0.001074,172.217.194.0-255,6438,114398,8,258527
13845,0.001076,172.31.36.0-255,66,114464,8,258527
13846,0.001116,172.217.194.0-255,1484,115948,8,258527
13847,0.00114,172.217.194.0-255,2902,118850,8,258527
13848,0.001144,172.31.36.0-255,66,118916,8,258527
13849,0.001179,172.217.194.0-255,4320,123236,8,258527
13850,0.001183,172.31.36.0-255,66,123302,8,258527
13851,0.001189,172.217.194.0-255,5738,129040,8,258527
13852,0.001193,172.31.36.0-255,66,129106,8,258527
13853,0.001217,172.31.36.0-255,66,129172,8,258527
13854,0.001246,172.217.194.0-255,1484,130656,8,258527
13855,0.001258,172.31.36.0-255,66,130722,8,258527
13856,0.001275,172.217.194.0-255,1484,132206,8,258527
13857,0.001299,172.217.194.0-255,2902,135108,8,258527
13858,0.001302,172.31.36.0-255,66,135174,8,258527
13859,0.001348,172.217.194.0-255,4320,139494,8,258527
13860,0.001351,172.31.36.0-255,66,139560,8,258527
13861,0.001375,172.217.194.0-255,1484,141044,8,258527
13862,0.001386,172.31.36.0-255,66,141110,8,258527
13863,0.001408,172.31.36.0-255,66,141176,8,258527
13864,0.001411,172.217.194.0-255,1484,142660,8,258527
13865,0.001439,172.217.194.0-255,7156,149816,8,258527
13866,0.001443,172.31.36.0-255,66,149882,8,258527
13867,0.001449,172.217.194.0-255,7156,157038,8,258527
13868,0.001452,172.31.36.0-255,66,157104,8,258527
13869,0.001489,172.217.194.0-255,2902,160006,8,258527
13870,0.001493,172.31.36.0-255,66,160072,8,258527
13871,0.001496,172.217.194.0-255,1484,161556,8,258527
13872,0.001517,172.217.194.0-255,7156,168712,8,258527
13873,0.001521,172.31.36.0-255,66,168778,8,258527
13874,0.00155,172.217.194.0-255,6438,175216,8,258527
13875,0.001554,172.31.36.0-255,66,175282,8,258527
13876,0.001566,172.31.36.0-255,66,175348,8,258527
13877,0.001605,172.217.194.0-255,1484,176832,8,258527
13878,0.00162,172.31.36.0-255,66,176898,8,258527
13879,0.001623,172.217.194.0-255,1484,178382,8,258527
13880,0.00165,172.217.194.0-255,2902,181284,8,258527
13881,0.001658,172.31.36.0-255,66,181350,8,258527
13882,0.001679,172.217.194.0-255,5020,186370,8,258527
13883,0.001683,172.31.36.0-255,66,186436,8,258527
13884,0.001731,172.217.194.0-255,4320,190756,8,258527
13885,0.001736,172.31.36.0-255,66,190822,8,258527
13886,0.001819,172.217.194.0-255,1484,192306,8,258527
13887,0.001833,172.217.194.0-255,2902,195208,8,258527
13888,0.001836,172.31.36.0-255,66,195274,8,258527
13889,0.001864,172.217.194.0-255,5738,201012,8,258527
13890,0.001868,172.31.36.0-255,66,201078,8,258527
13891,0.001909,172.31.36.0-255,66,201144,8,258527
13892,0.001916,172.217.194.0-255,6438,207582,8,258527
13893,0.001919,172.31.36.0-255,66,207648,8,258527
13894,0.002004,172.217.194.0-255,1484,209132,8,258527
13895,0.002009,172.217.194.0-255,2902,212034,8,258527
13896,0.002012,172.31.36.0-255,66,212100,8,258527
13897,0.00204,172.217.194.0-255,5738,217838,8,258527
13898,0.002047,172.217.194.0-255,7156,224994,8,258527
13899,0.002047,172.31.36.0-255,66,225060,8,258527
13900,0.002049,172.217.194.0-255,1484,226544,8,258527
13901,0.002051,172.31.36.0-255,66,226610,8,258527
13902,0.002082,172.217.194.0-255,7156,233766,8,258527
13903,0.002086,172.217.194.0-255,1484,235250,8,258527
13904,0.002088,172.31.36.0-255,66,235316,8,258527
13905,0.002121,172.217.194.0-255,6438,241754,8,258527
13906,0.002129,172.31.36.0-255,66,241820,8,258527
13907,0.002149,172.217.194.0-255,5738,247558,8,258527
13908,0.002155,172.31.36.0-255,66,247624,8,258527
13909,0.002176,172.217.194.0-255,2902,250526,8,258527
13910,0.00218,172.31.36.0-255,66,250592,8,258527
13911,0.002188,172.217.194.0-255,1484,252076,8,258527
13912,0.002198,172.31.36.0-255,66,252142,8,258527
13913,0.002225,172.31.36.0-255,66,252208,8,258527
13914,0.002284,172.31.36.0-255,66,252274,8,258527
13915,0.002306,172.217.194.0-255,105,252379,8,258527
13916,0.003656,172.31.36.0-255,66,252445,8,258527
13917,0.008446,172.31.36.0-255,105,252550,8,258527
13918,0.010918,172.217.194.0-255,66,252616,8,258527
13919,0.026856,172.31.36.0-255,172,252788,8,258527
13920,0.026888,172.31.36.0-255,1110,253898,8,258527
13921,0.02701,172.31.36.0-255,1514,255412,8,258527
13922,0.027013,172.31.36.0-255,1514,256926,8,258527
13923,0.027014,172.31.36.0-255,1337,258263,8,258527
13924,0.028441,104.244.42.0-255,66,258329,8,258527
13925,0.028453,104.244.42.0-255,66,258395,8,258527
13926,0.028569,104.244.42.0-255,66,258461,8,258527
13927,0.028571,104.244.42.0-255,66,258527,8,258527
13928,0.0,74.125.130.0-255,159,159,8,317632
13929,3.3e-05,172.31.36.0-255,66,225,8,317632
13930,4.1e-05,74.125.130.0-255,1484,1709,8,317632
13931,4.5e-05,172.31.36.0-255,66,1775,8,317632
13932,4.9e-05,74.125.130.0-255,2902,4677,8,317632
13933,5.2e-05,172.31.36.0-255,66,4743,8,317632
13934,6e-05,74.125.130.0-255,7156,11899,8,317632
13935,6.2e-05,172.31.36.0-255,66,11965,8,317632
13936,8.4e-05,74.125.130.0-255,1992,13957,8,317632
13937,8.7e-05,172.31.36.0-255,66,14023,8,317632
13938,0.000264,74.125.130.0-255,1484,15507,8,317632
13939,0.000269,172.31.36.0-255,66,15573,8,317632
13940,0.000275,74.125.130.0-255,2902,18475,8,317632
13941,0.000277,172.31.36.0-255,66,18541,8,317632
13942,0.000311,74.125.130.0-255,4320,22861,8,317632
13943,0.000318,172.31.36.0-255,66,22927,8,317632
13944,0.000326,74.125.130.0-255,2902,25829,8,317632
13945,0.000329,172.31.36.0-255,66,25895,8,317632
13946,0.000341,74.125.130.0-255,2902,28797,8,317632
13947,0.000346,172.31.36.0-255,66,28863,8,317632
13948,0.000353,74.125.130.0-255,2543,31406,8,317632
13949,0.000356,172.31.36.0-255,66,31472,8,317632
13950,0.001197,74.125.130.0-255,1484,32956,8,317632
13951,0.001203,172.31.36.0-255,66,33022,8,317632
13952,0.001226,74.125.130.0-255,2902,35924,8,317632
13953,0.001229,172.31.36.0-255,66,35990,8,317632
13954,0.001235,74.125.130.0-255,4320,40310,8,317632
13955,0.001237,172.31.36.0-255,66,40376,8,317632
13956,0.001279,74.125.130.0-255,7156,47532,8,317632
13957,0.001283,172.31.36.0-255,66,47598,8,317632
13958,0.001317,172.31.36.0-255,66,47664,8,317632
13959,0.001334,172.31.36.0-255,66,47730,8,317632
13960,0.001369,74.125.130.0-255,1413,49143,8,317632
13961,0.001395,74.125.130.0-255,100,49243,8,317632
13962,0.00155,172.31.36.0-255,66,49309,8,317632
13963,0.001828,74.125.130.0-255,1484,50793,8,317632
13964,0.00185,74.125.130.0-255,2902,53695,8,317632
13965,0.001856,74.125.130.0-255,5738,59433,8,317632
13966,0.00186,74.125.130.0-255,2902,62335,8,317632
13967,0.001874,172.31.36.0-255,66,62401,8,317632
13968,0.001876,74.125.130.0-255,2902,65303,8,317632
13969,0.001879,172.31.36.0-255,66,65369,8,317632
13970,0.001881,74.125.130.0-255,4320,69689,8,317632
13971,0.001895,74.125.130.0-255,2902,72591,8,317632
13972,0.001906,172.31.36.0-255,66,72657,8,317632
13973,0.00191,74.125.130.0-255,1484,74141,8,317632
13974,0.001923,74.125.130.0-255,2902,77043,8,317632
13975,0.001943,172.31.36.0-255,66,77109,8,317632
13976,0.001947,74.125.130.0-255,5738,82847,8,317632
13977,0.00195,74.125.130.0-255,766,83613,8,317632
13978,0.001958,172.31.36.0-255,66,83679,8,317632
13979,0.002173,74.125.130.0-255,1484,85163,8,317632
13980,0.002176,74.125.130.0-255,1484,86647,8,317632
13981,0.002179,172.31.36.0-255,66,86713,8,317632
13982,0.002193,74.125.130.0-255,1484,88197,8,317632
13983,0.002198,74.125.130.0-255,2902,91099,8,317632
13984,0.002205,172.31.36.0-255,66,91165,8,317632
13985,0.002215,74.125.130.0-255,2902,94067,8,317632
13986,0.002219,172.31.36.0-255,66,94133,8,317632
13987,0.00222,74.125.130.0-255,2902,97035,8,317632
13988,0.002223,172.31.36.0-255,66,97101,8,317632
13989,0.002238,74.125.130.0-255,7156,104257,8,317632
13990,0.002242,74.125.130.0-255,2902,107159,8,317632
13991,0.002247,172.31.36.0-255,66,107225,8,317632
13992,0.002285,74.125.130.0-255,1484,108709,8,317632
13993,0.002287,172.31.36.0-255,66,108775,8,317632
13994,0.002311,74.125.130.0-255,7156,115931,8,317632
13995,0.002316,74.125.130.0-255,4320,120251,8,317632
13996,0.002325,172.31.36.0-255,66,120317,8,317632
13997,0.002351,74.125.130.0-255,766,121083,8,317632
13998,0.00237,172.31.36.0-255,66,121149,8,317632
13999,0.002387,74.125.130.0-255,1484,122633,8,317632
14000,0.002391,74.125.130.0-255,1484,124117,8,317632
14001,0.002396,172.31.36.0-255,66,124183,8,317632
14002,0.002402,74.125.130.0-255,1484,125667,8,317632
14003,0.002417,74.125.130.0-255,5738,131405,8,317632
14004,0.002424,172.31.36.0-255,66,131471,8,317632
14005,0.002429,74.125.130.0-255,4320,135791,8,317632
14006,0.002442,172.31.36.0-255,66,135857,8,317632
14007,0.002476,74.125.130.0-255,5738,141595,8,317632
14008,0.002485,172.31.36.0-255,66,141661,8,317632
14009,0.002488,74.125.130.0-255,1484,143145,8,317632
14010,0.002506,74.125.130.0-255,5738,148883,8,317632
14011,0.002511,172.31.36.0-255,66,148949,8,317632
14012,0.002529,74.125.130.0-255,4320,153269,8,317632
14013,0.002537,172.31.36.0-255,66,153335,8,317632
14014,0.002546,74.125.130.0-255,2184,155519,8,317632
14015,0.002551,172.31.36.0-255,66,155585,8,317632
14016,0.005085,74.125.130.0-255,2902,158487,8,317632
14017,0.005091,172.31.36.0-255,66,158553,8,317632
14018,0.005117,74.125.130.0-255,2902,161455,8,317632
14019,0.005127,172.31.36.0-255,66,161521,8,317632
14020,0.007643,74.125.130.0-255,2902,164423,8,317632
14021,0.007648,172.31.36.0-255,66,164489,8,317632
14022,0.007678,74.125.130.0-255,2902,167391,8,317632
14023,0.007686,172.31.36.0-255,66,167457,8,317632
14024,0.010244,74.125.130.0-255,5738,173195,8,317632
14025,0.010346,172.31.36.0-255,66,173261,8,317632
14026,0.012932,74.125.130.0-255,5738,178999,8,317632
14027,0.01295,172.31.36.0-255,66,179065,8,317632
14028,0.015549,74.125.130.0-255,5738,184803,8,317632
14029,0.015563,172.31.36.0-255,66,184869,8,317632
14030,0.018128,74.125.130.0-255,5738,190607,8,317632
14031,0.018139,172.31.36.0-255,66,190673,8,317632
14032,0.020697,74.125.130.0-255,5738,196411,8,317632
14033,0.020706,172.31.36.0-255,66,196477,8,317632
14034,0.023312,74.125.130.0-255,5738,202215,8,317632
14035,0.02332,172.31.36.0-255,66,202281,8,317632
14036,0.025958,74.125.130.0-255,5738,208019,8,317632
14037,0.025966,172.31.36.0-255,66,208085,8,317632
14038,0.026698,172.31.36.0-255,172,208257,8,317632
14039,0.026733,172.31.36.0-255,1110,209367,8,317632
14040,0.02677,172.31.36.0-255,1514,210881,8,317632
14041,0.026772,172.31.36.0-255,1514,212395,8,317632
14042,0.026778,172.31.36.0-255,1514,213909,8,317632
14043,0.02678,172.31.36.0-255,1514,215423,8,317632
14044,0.026805,172.31.36.0-255,1231,216654,8,317632
14045,0.028236,104.244.42.0-255,66,216720,8,317632
14046,0.028284,104.244.42.0-255,66,216786,8,317632
14047,0.028342,104.244.42.0-255,66,216852,8,317632
14048,0.028345,104.244.42.0-255,66,216918,8,317632
14049,0.028553,74.125.130.0-255,1484,218402,8,317632
14050,0.028582,74.125.130.0-255,4320,222722,8,317632
14051,0.028587,172.31.36.0-255,66,222788,8,317632
14052,0.031134,74.125.130.0-255,5738,228526,8,317632
14053,0.03114,172.31.36.0-255,66,228592,8,317632
14054,0.033691,74.125.130.0-255,5738,234330,8,317632
14055,0.033696,172.31.36.0-255,66,234396,8,317632
14056,0.036238,74.125.130.0-255,2902,237298,8,317632
14057,0.036243,172.31.36.0-255,66,237364,8,317632
14058,0.036276,74.125.130.0-255,2902,240266,8,317632
14059,0.036292,172.31.36.0-255,66,240332,8,317632
14060,0.03881,74.125.130.0-255,2902,243234,8,317632
14061,0.038816,172.31.36.0-255,66,243300,8,317632
14062,0.038849,74.125.130.0-255,2902,246202,8,317632
14063,0.038871,172.31.36.0-255,66,246268,8,317632
14064,0.041366,74.125.130.0-255,2902,249170,8,317632
14065,0.041371,172.31.36.0-255,66,249236,8,317632
14066,0.041413,74.125.130.0-255,2902,252138,8,317632
14067,0.041424,172.31.36.0-255,66,252204,8,317632
14068,0.043925,74.125.130.0-255,2902,255106,8,317632
14069,0.043931,172.31.36.0-255,66,255172,8,317632
14070,0.043962,74.125.130.0-255,2902,258074,8,317632
14071,0.043981,172.31.36.0-255,66,258140,8,317632
14072,0.046487,74.125.130.0-255,2902,261042,8,317632
14073,0.046493,172.31.36.0-255,66,261108,8,317632
14074,0.046535,74.125.130.0-255,2902,264010,8,317632
14075,0.046546,172.31.36.0-255,66,264076,8,317632
14076,0.049054,74.125.130.0-255,2902,266978,8,317632
14077,0.049059,172.31.36.0-255,66,267044,8,317632
14078,0.049104,74.125.130.0-255,2902,269946,8,317632
14079,0.049111,172.31.36.0-255,66,270012,8,317632
14080,0.051627,74.125.130.0-255,2902,272914,8,317632
14081,0.051633,172.31.36.0-255,66,272980,8,317632
14082,0.051663,74.125.130.0-255,1484,274464,8,317632
14083,0.051681,74.125.130.0-255,1484,275948,8,317632
14084,0.05169,172.31.36.0-255,66,276014,8,317632
14085,0.054203,74.125.130.0-255,2902,278916,8,317632
14086,0.054209,172.31.36.0-255,66,278982,8,317632
14087,0.054242,74.125.130.0-255,2902,281884,8,317632
14088,0.054267,172.31.36.0-255,66,281950,8,317632
14089,0.056766,74.125.130.0-255,2902,284852,8,317632
14090,0.056772,172.31.36.0-255,66,284918,8,317632
14091,0.056808,74.125.130.0-255,2902,287820,8,317632
14092,0.056829,172.31.36.0-255,66,287886,8,317632
14093,0.059323,74.125.130.0-255,2902,290788,8,317632
14094,0.059329,172.31.36.0-255,66,290854,8,317632
14095,0.059366,74.125.130.0-255,2902,293756,8,317632
14096,0.059386,172.31.36.0-255,66,293822,8,317632
14097,0.061866,74.125.130.0-255,2902,296724,8,317632
14098,0.061871,172.31.36.0-255,66,296790,8,317632
14099,0.061935,74.125.130.0-255,2902,299692,8,317632
14100,0.061941,172.31.36.0-255,66,299758,8,317632
14101,0.06441,74.125.130.0-255,1484,301242,8,317632
14102,0.06444,74.125.130.0-255,1484,302726,8,317632
14103,0.064445,172.31.36.0-255,66,302792,8,317632
14104,0.064481,74.125.130.0-255,2902,305694,8,317632
14105,0.064488,172.31.36.0-255,66,305760,8,317632
14106,0.067019,74.125.130.0-255,2902,308662,8,317632
14107,0.067025,172.31.36.0-255,66,308728,8,317632
14108,0.067045,74.125.130.0-255,2902,311630,8,317632
14109,0.067185,172.31.36.0-255,66,311696,8,317632
14110,0.069569,74.125.130.0-255,2902,314598,8,317632
14111,0.069574,172.31.36.0-255,66,314664,8,317632
14112,0.069738,74.125.130.0-255,2902,317566,8,317632
14113,0.069745,172.31.36.0-255,66,317632,8,317632
14114,0.0,172.31.36.0-255,161,161,8,227
14115,0.005912,172.217.194.0-255,66,227,8,227
14116,0.0,74.125.24.0-255,153,153,8,238052
14117,2.5e-05,172.31.36.0-255,66,219,8,238052
14118,3.2e-05,74.125.24.0-255,1484,1703,8,238052
14119,3.8e-05,172.31.36.0-255,66,1769,8,238052
14120,5.1e-05,74.125.24.0-255,2902,4671,8,238052
14121,5.4e-05,172.31.36.0-255,66,4737,8,238052
14122,6.3e-05,74.125.24.0-255,7156,11893,8,238052
14123,6.6e-05,172.31.36.0-255,66,11959,8,238052
14124,7.9e-05,172.31.36.0-255,66,12025,8,238052
14125,0.000122,172.31.36.0-255,66,12091,8,238052
14126,0.000127,74.125.24.0-255,2543,14634,8,238052
14127,0.000129,172.31.36.0-255,66,14700,8,238052
14128,0.000901,74.125.24.0-255,1484,16184,8,238052
14129,0.000908,172.31.36.0-255,66,16250,8,238052
14130,0.000918,74.125.24.0-255,2902,19152,8,238052
14131,0.00092,172.31.36.0-255,66,19218,8,238052
14132,0.000932,74.125.24.0-255,5738,24956,8,238052
14133,0.000934,172.31.36.0-255,66,25022,8,238052
14134,0.000964,74.125.24.0-255,5738,30760,8,238052
14135,0.000966,172.31.36.0-255,66,30826,8,238052
14136,0.001003,172.31.36.0-255,66,30892,8,238052
14137,0.001014,172.31.36.0-255,66,30958,8,238052
14138,0.001022,74.125.24.0-255,1400,32358,8,238052
14139,0.001024,172.31.36.0-255,66,32424,8,238052
14140,0.001389,74.125.24.0-255,129,32553,8,238052
14141,0.001395,172.31.36.0-255,66,32619,8,238052
14142,0.00158,74.125.24.0-255,1484,34103,8,238052
14143,0.001587,172.31.36.0-255,66,34169,8,238052
14144,0.001606,74.125.24.0-255,2902,37071,8,238052
14145,0.00161,172.31.36.0-255,66,37137,8,238052
14146,0.001615,74.125.24.0-255,4320,41457,8,238052
14147,0.001618,172.31.36.0-255,66,41523,8,238052
14148,0.001663,74.125.24.0-255,4320,45843,8,238052
14149,0.001666,172.31.36.0-255,66,45909,8,238052
14150,0.001696,74.125.24.0-255,5379,51288,8,238052
14151,0.001699,172.31.36.0-255,66,51354,8,238052
14152,0.001711,172.31.36.0-255,66,51420,8,238052
14153,0.001722,74.125.24.0-255,5379,56799,8,238052
14154,0.001724,172.31.36.0-255,66,56865,8,238052
14155,0.002206,74.125.24.0-255,1484,58349,8,238052
14156,0.002226,74.125.24.0-255,2902,61251,8,238052
14157,0.002229,172.31.36.0-255,66,61317,8,238052
14158,0.002232,74.125.24.0-255,1484,62801,8,238052
14159,0.002259,74.125.24.0-255,4320,67121,8,238052
14160,0.002262,172.31.36.0-255,66,67187,8,238052
14161,0.002268,74.125.24.0-255,5738,72925,8,238052
14162,0.002271,172.31.36.0-255,66,72991,8,238052
14163,0.002304,74.125.24.0-255,7156,80147,8,238052
14164,0.002307,172.31.36.0-255,66,80213,8,238052
14165,0.002339,172.31.36.0-255,66,80279,8,238052
14166,0.002513,74.125.24.0-255,1484,81763,8,238052
14167,0.002532,74.125.24.0-255,2902,84665,8,238052
14168,0.002535,172.31.36.0-255,66,84731,8,238052
14169,0.002543,74.125.24.0-255,4320,89051,8,238052
14170,0.002546,172.31.36.0-255,66,89117,8,238052
14171,0.002578,74.125.24.0-255,1484,90601,8,238052
14172,0.002594,172.31.36.0-255,66,90667,8,238052
14173,0.002606,172.31.36.0-255,66,90733,8,238052
14174,0.002671,172.31.36.0-255,66,90799,8,238052
14175,0.002717,172.31.36.0-255,66,90865,8,238052
14176,0.002728,172.31.36.0-255,66,90931,8,238052
14177,0.005294,74.125.24.0-255,4320,95251,8,238052
14178,0.005299,172.31.36.0-255,66,95317,8,238052
14179,0.005327,74.125.24.0-255,1484,96801,8,238052
14180,0.007899,74.125.24.0-255,4320,101121,8,238052
14181,0.007905,172.31.36.0-255,66,101187,8,238052
14182,0.010507,74.125.24.0-255,5738,106925,8,238052
14183,0.010516,172.31.36.0-255,66,106991,8,238052
14184,0.013163,74.125.24.0-255,5738,112729,8,238052
14185,0.013173,172.31.36.0-255,66,112795,8,238052
14186,0.015753,74.125.24.0-255,5738,118533,8,238052
14187,0.015763,172.31.36.0-255,66,118599,8,238052
14188,0.018398,74.125.24.0-255,4320,122919,8,238052
14189,0.018408,172.31.36.0-255,66,122985,8,238052
14190,0.018441,74.125.24.0-255,1484,124469,8,238052
14191,0.021055,74.125.24.0-255,4320,128789,8,238052
14192,0.021062,172.31.36.0-255,66,128855,8,238052
14193,0.023627,74.125.24.0-255,5738,134593,8,238052
14194,0.023635,172.31.36.0-255,66,134659,8,238052
14195,0.026288,74.125.24.0-255,5738,140397,8,238052
14196,0.026311,172.31.36.0-255,66,140463,8,238052
14197,0.029168,74.125.24.0-255,5738,146201,8,238052
14198,0.029176,172.31.36.0-255,66,146267,8,238052
14199,0.031831,74.125.24.0-255,5738,152005,8,238052
14200,0.031839,172.31.36.0-255,66,152071,8,238052
14201,0.03194,172.31.36.0-255,171,152242,8,238052
14202,0.031968,172.31.36.0-255,1136,153378,8,238052
14203,0.032029,172.31.36.0-255,1514,154892,8,238052
14204,0.03203,172.31.36.0-255,1268,156160,8,238052
14205,0.033521,104.244.42.0-255,66,156226,8,238052
14206,0.03353,104.244.42.0-255,66,156292,8,238052
14207,0.0336,104.244.42.0-255,66,156358,8,238052
14208,0.034292,104.244.42.0-255,108,156466,8,238052
14209,0.034302,172.31.36.0-255,66,156532,8,238052
14210,0.034458,74.125.24.0-255,5738,162270,8,238052
14211,0.034463,172.31.36.0-255,66,162336,8,238052
14212,0.037093,74.125.24.0-255,5738,168074,8,238052
14213,0.037102,172.31.36.0-255,66,168140,8,238052
14214,0.039686,74.125.24.0-255,5738,173878,8,238052
14215,0.039692,172.31.36.0-255,66,173944,8,238052
14216,0.042366,74.125.24.0-255,5738,179682,8,238052
14217,0.042372,172.31.36.0-255,66,179748,8,238052
14218,0.044976,74.125.24.0-255,5738,185486,8,238052
14219,0.044983,172.31.36.0-255,66,185552,8,238052
14220,0.047623,74.125.24.0-255,5738,191290,8,238052
14221,0.047631,172.31.36.0-255,66,191356,8,238052
14222,0.050259,74.125.24.0-255,5738,197094,8,238052
14223,0.050266,172.31.36.0-255,66,197160,8,238052
14224,0.052936,74.125.24.0-255,5738,202898,8,238052
14225,0.052947,172.31.36.0-255,66,202964,8,238052
14226,0.055616,74.125.24.0-255,5738,208702,8,238052
14227,0.055622,172.31.36.0-255,66,208768,8,238052
14228,0.058265,74.125.24.0-255,5738,214506,8,238052
14229,0.058271,172.31.36.0-255,66,214572,8,238052
14230,0.060911,74.125.24.0-255,5738,220310,8,238052
14231,0.060918,172.31.36.0-255,66,220376,8,238052
14232,0.063529,74.125.24.0-255,5738,226114,8,238052
14233,0.063536,172.31.36.0-255,66,226180,8,238052
14234,0.06615,74.125.24.0-255,2902,229082,8,238052
14235,0.066157,172.31.36.0-255,66,229148,8,238052
14236,0.066186,74.125.24.0-255,2902,232050,8,238052
14237,0.066189,172.31.36.0-255,66,232116,8,238052
14238,0.068741,74.125.24.0-255,2902,235018,8,238052
14239,0.068761,172.31.36.0-255,66,235084,8,238052
14240,0.068816,74.125.24.0-255,2902,237986,8,238052
14241,0.06882,172.31.36.0-255,66,238052,8,238052
14242,0.0,74.125.24.0-255,153,153,8,243747
14243,2.5e-05,172.31.36.0-255,66,219,8,243747
14244,3.3e-05,74.125.24.0-255,1484,1703,8,243747
14245,3.7e-05,172.31.36.0-255,66,1769,8,243747
14246,4.3e-05,74.125.24.0-255,2902,4671,8,243747
14247,4.6e-05,172.31.36.0-255,66,4737,8,243747
14248,5.4e-05,74.125.24.0-255,7156,11893,8,243747
14249,5.7e-05,172.31.36.0-255,66,11959,8,243747
14250,6.3e-05,74.125.24.0-255,4814,16773,8,243747
14251,6.7e-05,172.31.36.0-255,66,16839,8,243747
14252,0.00011,172.31.36.0-255,66,16905,8,243747
14253,0.000206,74.125.24.0-255,1484,18389,8,243747
14254,0.000209,172.31.36.0-255,66,18455,8,243747
14255,0.000215,74.125.24.0-255,2902,21357,8,243747
14256,0.000217,172.31.36.0-255,66,21423,8,243747
14257,0.000248,74.125.24.0-255,5738,27161,8,243747
14258,0.000251,172.31.36.0-255,66,27227,8,243747
14259,0.000256,74.125.24.0-255,2902,30129,8,243747
14260,0.000258,172.31.36.0-255,66,30195,8,243747
14261,0.000302,74.125.24.0-255,7156,37351,8,243747
14262,0.000305,172.31.36.0-255,66,37417,8,243747
14263,0.000323,74.125.24.0-255,3961,41378,8,243747
14264,0.000325,172.31.36.0-255,66,41444,8,243747
14265,0.000337,172.31.36.0-255,66,41510,8,243747
14266,0.000359,74.125.24.0-255,646,42156,8,243747
14267,0.000362,172.31.36.0-255,66,42222,8,243747
14268,0.000491,74.125.24.0-255,1484,43706,8,243747
14269,0.000496,172.31.36.0-255,66,43772,8,243747
14270,0.000501,74.125.24.0-255,2902,46674,8,243747
14271,0.000503,172.31.36.0-255,66,46740,8,243747
14272,0.000507,74.125.24.0-255,1484,48224,8,243747
14273,0.000532,74.125.24.0-255,4320,52544,8,243747
14274,0.000535,172.31.36.0-255,66,52610,8,243747
14275,0.000567,74.125.24.0-255,5738,58348,8,243747
14276,0.00057,172.31.36.0-255,66,58414,8,243747
14277,0.000586,74.125.24.0-255,4320,62734,8,243747
14278,0.000589,172.31.36.0-255,66,62800,8,243747
14279,0.000611,74.125.24.0-255,2543,65343,8,243747
14280,0.000613,172.31.36.0-255,66,65409,8,243747
14281,0.000616,74.125.24.0-255,1484,66893,8,243747
14282,0.000621,74.125.24.0-255,2902,69795,8,243747
14283,0.000623,172.31.36.0-255,66,69861,8,243747
14284,0.000657,74.125.24.0-255,5738,75599,8,243747
14285,0.00066,172.31.36.0-255,66,75665,8,243747
14286,0.000663,74.125.24.0-255,1125,76790,8,243747
14287,0.00078,74.125.24.0-255,1484,78274,8,243747
14288,0.000784,172.31.36.0-255,66,78340,8,243747
14289,0.00079,74.125.24.0-255,2902,81242,8,243747
14290,0.000792,172.31.36.0-255,66,81308,8,243747
14291,0.000824,74.125.24.0-255,5738,87046,8,243747
14292,0.000827,172.31.36.0-255,66,87112,8,243747
14293,0.000858,74.125.24.0-255,6234,93346,8,243747
14294,0.000861,172.31.36.0-255,66,93412,8,243747
14295,0.001617,74.125.24.0-255,1484,94896,8,243747
14296,0.001626,74.125.24.0-255,2902,97798,8,243747
14297,0.001632,172.31.36.0-255,66,97864,8,243747
14298,0.001639,74.125.24.0-255,5738,103602,8,243747
14299,0.001641,172.31.36.0-255,66,103668,8,243747
14300,0.001673,172.31.36.0-255,66,103734,8,243747
14301,0.001695,74.125.24.0-255,4320,108054,8,243747
14302,0.001697,172.31.36.0-255,66,108120,8,243747
14303,0.001711,172.31.36.0-255,66,108186,8,243747
14304,0.002003,74.125.24.0-255,1484,109670,8,243747
14305,0.002011,74.125.24.0-255,2902,112572,8,243747
14306,0.002016,172.31.36.0-255,66,112638,8,243747
14307,0.002023,74.125.24.0-255,5738,118376,8,243747
14308,0.002026,172.31.36.0-255,66,118442,8,243747
14309,0.002049,74.125.24.0-255,1484,119926,8,243747
14310,0.002073,172.31.36.0-255,66,119992,8,243747
14311,0.002079,74.125.24.0-255,4320,124312,8,243747
14312,0.002081,172.31.36.0-255,66,124378,8,243747
14313,0.002102,172.31.36.0-255,66,124444,8,243747
14314,0.002107,74.125.24.0-255,2902,127346,8,243747
14315,0.00211,172.31.36.0-255,66,127412,8,243747
14316,0.002149,172.31.36.0-255,66,127478,8,243747
14317,0.002161,172.31.36.0-255,66,127544,8,243747
14318,0.002185,74.125.24.0-255,2902,130446,8,243747
14319,0.002187,172.31.36.0-255,66,130512,8,243747
14320,0.002215,172.31.36.0-255,66,130578,8,243747
14321,0.002249,172.31.36.0-255,66,130644,8,243747
14322,0.002264,172.31.36.0-255,66,130710,8,243747
14323,0.002313,74.125.24.0-255,4320,135030,8,243747
14324,0.002316,172.31.36.0-255,66,135096,8,243747
14325,0.002344,172.31.36.0-255,66,135162,8,243747
14326,0.002358,172.31.36.0-255,66,135228,8,243747
14327,0.00238,172.31.36.0-255,66,135294,8,243747
14328,0.002408,74.125.24.0-255,5020,140314,8,243747
14329,0.002411,172.31.36.0-255,66,140380,8,243747
14330,0.002423,172.31.36.0-255,66,140446,8,243747
14331,0.002429,74.125.24.0-255,4320,144766,8,243747
14332,0.002431,172.31.36.0-255,66,144832,8,243747
14333,0.002448,74.125.24.0-255,1484,146316,8,243747
14334,0.004836,74.125.24.0-255,4320,150636,8,243747
14335,0.004841,172.31.36.0-255,66,150702,8,243747
14336,0.007267,74.125.24.0-255,5738,156440,8,243747
14337,0.007287,172.31.36.0-255,66,156506,8,243747
14338,0.009667,74.125.24.0-255,5738,162244,8,243747
14339,0.009675,172.31.36.0-255,66,162310,8,243747
14340,0.012122,74.125.24.0-255,5738,168048,8,243747
14341,0.012134,172.31.36.0-255,66,168114,8,243747
14342,0.014547,74.125.24.0-255,5738,173852,8,243747
14343,0.014553,172.31.36.0-255,66,173918,8,243747
14344,0.017015,74.125.24.0-255,5738,179656,8,243747
14345,0.01703,172.31.36.0-255,66,179722,8,243747
14346,0.019453,74.125.24.0-255,5738,185460,8,243747
14347,0.01947,172.31.36.0-255,66,185526,8,243747
14348,0.021903,74.125.24.0-255,5738,191264,8,243747
14349,0.021911,172.31.36.0-255,66,191330,8,243747
14350,0.024288,74.125.24.0-255,5738,197068,8,243747
14351,0.024297,172.31.36.0-255,66,197134,8,243747
14352,0.026707,74.125.24.0-255,5738,202872,8,243747
14353,0.02672,172.31.36.0-255,66,202938,8,243747
14354,0.029149,74.125.24.0-255,5738,208676,8,243747
14355,0.02916,172.31.36.0-255,66,208742,8,243747
14356,0.031576,74.125.24.0-255,5738,214480,8,243747
14357,0.031584,172.31.36.0-255,66,214546,8,243747
14358,0.033978,74.125.24.0-255,5738,220284,8,243747
14359,0.033988,172.31.36.0-255,66,220350,8,243747
14360,0.036376,74.125.24.0-255,5738,226088,8,243747
14361,0.036383,172.31.36.0-255,66,226154,8,243747
14362,0.038776,74.125.24.0-255,5738,231892,8,243747
14363,0.038787,172.31.36.0-255,66,231958,8,243747
14364,0.04121,74.125.24.0-255,1266,233224,8,243747
14365,0.041374,172.31.36.0-255,66,233290,8,243747
14366,0.041415,172.31.36.0-255,105,233395,8,243747
14367,0.043799,74.125.24.0-255,66,233461,8,243747
14368,0.047999,172.31.36.0-255,172,233633,8,243747
14369,0.048038,172.31.36.0-255,1111,234744,8,243747
14370,0.048109,172.31.36.0-255,1514,236258,8,243747
14371,0.048111,172.31.36.0-255,1514,237772,8,243747
14372,0.048117,172.31.36.0-255,1514,239286,8,243747
14373,0.048119,172.31.36.0-255,1514,240800,8,243747
14374,0.048137,172.31.36.0-255,1514,242314,8,243747
14375,0.048139,172.31.36.0-255,995,243309,8,243747
14376,0.049541,104.244.42.0-255,66,243375,8,243747
14377,0.049597,104.244.42.0-255,66,243441,8,243747
14378,0.04969,104.244.42.0-255,66,243507,8,243747
14379,0.049696,104.244.42.0-255,66,243573,8,243747
14380,0.057665,172.31.36.0-255,108,243681,8,243747
14381,0.059332,104.244.42.0-255,66,243747,8,243747
14382,0.0,172.217.194.0-255,155,155,8,244804
14383,3.5e-05,172.31.36.0-255,66,221,8,244804
14384,4.1e-05,172.217.194.0-255,1484,1705,8,244804
14385,4.5e-05,172.31.36.0-255,66,1771,8,244804
14386,4.9e-05,172.217.194.0-255,2902,4673,8,244804
14387,5.2e-05,172.31.36.0-255,66,4739,8,244804
14388,6e-05,172.217.194.0-255,7156,11895,8,244804
14389,6.3e-05,172.31.36.0-255,66,11961,8,244804
14390,6.7e-05,172.217.194.0-255,2072,14033,8,244804
14391,6.9e-05,172.31.36.0-255,66,14099,8,244804
14392,9.3e-05,172.217.194.0-255,2902,17001,8,244804
14393,9.6e-05,172.31.36.0-255,66,17067,8,244804
14394,0.000122,172.217.194.0-255,7156,24223,8,244804
14395,0.000125,172.31.36.0-255,66,24289,8,244804
14396,0.000155,172.217.194.0-255,5738,30027,8,244804
14397,0.000159,172.31.36.0-255,66,30093,8,244804
14398,0.000176,172.217.194.0-255,5738,35831,8,244804
14399,0.000178,172.31.36.0-255,66,35897,8,244804
14400,0.000184,172.217.194.0-255,4320,40217,8,244804
14401,0.000186,172.31.36.0-255,66,40283,8,244804
14402,0.000213,172.31.36.0-255,66,40349,8,244804
14403,0.000377,172.217.194.0-255,1484,41833,8,244804
14404,0.000383,172.31.36.0-255,66,41899,8,244804
14405,0.000389,172.217.194.0-255,2902,44801,8,244804
14406,0.000391,172.31.36.0-255,66,44867,8,244804
14407,0.00042,172.217.194.0-255,5738,50605,8,244804
14408,0.000424,172.31.36.0-255,66,50671,8,244804
14409,0.000429,172.217.194.0-255,4320,54991,8,244804
14410,0.000431,172.31.36.0-255,66,55057,8,244804
14411,0.000474,172.217.194.0-255,2823,57880,8,244804
14412,0.000479,172.31.36.0-255,66,57946,8,244804
14413,0.001937,172.217.194.0-255,1484,59430,8,244804
14414,0.001948,172.217.194.0-255,2902,62332,8,244804
14415,0.001953,172.31.36.0-255,66,62398,8,244804
14416,0.001961,172.217.194.0-255,5738,68136,8,244804
14417,0.001963,172.31.36.0-255,66,68202,8,244804
14418,0.001966,172.217.194.0-255,1484,69686,8,244804
14419,0.001999,172.31.36.0-255,66,69752,8,244804
14420,0.002006,172.217.194.0-255,5738,75490,8,244804
14421,0.002007,172.31.36.0-255,66,75556,8,244804
14422,0.002028,172.217.194.0-255,5020,80576,8,244804
14423,0.002029,172.31.36.0-255,66,80642,8,244804
14424,0.005158,172.217.194.0-255,1484,82126,8,244804
14425,0.005167,172.217.194.0-255,2902,85028,8,244804
14426,0.005172,172.31.36.0-255,66,85094,8,244804
14427,0.005184,172.217.194.0-255,1484,86578,8,244804
14428,0.007484,172.217.194.0-255,4320,90898,8,244804
14429,0.00749,172.31.36.0-255,66,90964,8,244804
14430,0.009787,172.217.194.0-255,5738,96702,8,244804
14431,0.009795,172.31.36.0-255,66,96768,8,244804
14432,0.012123,172.217.194.0-255,5738,102506,8,244804
14433,0.012131,172.31.36.0-255,66,102572,8,244804
14434,0.014431,172.217.194.0-255,5738,108310,8,244804
14435,0.014441,172.31.36.0-255,66,108376,8,244804
14436,0.016765,172.217.194.0-255,5738,114114,8,244804
14437,0.016773,172.31.36.0-255,66,114180,8,244804
14438,0.019104,172.217.194.0-255,5738,119918,8,244804
14439,0.01911,172.31.36.0-255,66,119984,8,244804
14440,0.021402,172.217.194.0-255,5738,125722,8,244804
14441,0.021412,172.31.36.0-255,66,125788,8,244804
14442,0.023739,172.217.194.0-255,5738,131526,8,244804
14443,0.023746,172.31.36.0-255,66,131592,8,244804
14444,0.026034,172.217.194.0-255,5738,137330,8,244804
14445,0.026043,172.31.36.0-255,66,137396,8,244804
14446,0.028344,172.217.194.0-255,5738,143134,8,244804
14447,0.028344,172.31.36.0-255,172,143306,8,244804
14448,0.028348,172.31.36.0-255,66,143372,8,244804
14449,0.028371,172.31.36.0-255,1112,144484,8,244804
14450,0.028415,172.31.36.0-255,1514,145998,8,244804
14451,0.028417,172.31.36.0-255,1292,147290,8,244804
14452,0.029888,104.244.42.0-255,66,147356,8,244804
14453,0.029916,104.244.42.0-255,66,147422,8,244804
14454,0.02997,104.244.42.0-255,66,147488,8,244804
14455,0.030664,172.217.194.0-255,5738,153226,8,244804
14456,0.03067,172.31.36.0-255,66,153292,8,244804
14457,0.032981,172.217.194.0-255,4320,157612,8,244804
14458,0.032987,172.31.36.0-255,66,157678,8,244804
14459,0.033017,172.217.194.0-255,1484,159162,8,244804
14460,0.035297,172.217.194.0-255,4320,163482,8,244804
14461,0.035302,172.31.36.0-255,66,163548,8,244804
14462,0.037609,172.217.194.0-255,5738,169286,8,244804
14463,0.037616,172.31.36.0-255,66,169352,8,244804
14464,0.039941,172.217.194.0-255,5738,175090,8,244804
14465,0.039947,172.31.36.0-255,66,175156,8,244804
14466,0.042247,172.217.194.0-255,5738,180894,8,244804
14467,0.042253,172.31.36.0-255,66,180960,8,244804
14468,0.044571,172.217.194.0-255,5738,186698,8,244804
14469,0.044577,172.31.36.0-255,66,186764,8,244804
14470,0.046881,172.217.194.0-255,5738,192502,8,244804
14471,0.046886,172.31.36.0-255,66,192568,8,244804
14472,0.049218,172.217.194.0-255,5738,198306,8,244804
14473,0.049224,172.31.36.0-255,66,198372,8,244804
14474,0.051521,172.217.194.0-255,5738,204110,8,244804
14475,0.051528,172.31.36.0-255,66,204176,8,244804
14476,0.053853,172.217.194.0-255,5738,209914,8,244804
14477,0.053862,172.31.36.0-255,66,209980,8,244804
14478,0.05618,172.217.194.0-255,5738,215718,8,244804
14479,0.056186,172.31.36.0-255,66,215784,8,244804
14480,0.058479,172.217.194.0-255,5738,221522,8,244804
14481,0.058483,172.31.36.0-255,66,221588,8,244804
14482,0.060769,172.217.194.0-255,5738,227326,8,244804
14483,0.060775,172.31.36.0-255,66,227392,8,244804
14484,0.063063,172.217.194.0-255,5738,233130,8,244804
14485,0.063066,172.31.36.0-255,66,233196,8,244804
14486,0.065411,172.217.194.0-255,5738,238934,8,244804
14487,0.065418,172.31.36.0-255,66,239000,8,244804
14488,0.067708,172.217.194.0-255,5738,244738,8,244804
14489,0.067714,172.31.36.0-255,66,244804,8,244804
14490,0.0,172.217.194.0-255,152,152,8,269479
14491,2.8e-05,172.31.36.0-255,66,218,8,269479
14492,3.5e-05,172.217.194.0-255,1484,1702,8,269479
14493,3.8e-05,172.31.36.0-255,66,1768,8,269479
14494,4.3e-05,172.217.194.0-255,2902,4670,8,269479
14495,4.7e-05,172.31.36.0-255,66,4736,8,269479
14496,5.4e-05,172.217.194.0-255,7156,11892,8,269479
14497,5.7e-05,172.31.36.0-255,66,11958,8,269479
14498,6e-05,172.217.194.0-255,2045,14003,8,269479
14499,6.2e-05,172.31.36.0-255,66,14069,8,269479
14500,0.000107,172.217.194.0-255,1484,15553,8,269479
14501,0.00011,172.31.36.0-255,66,15619,8,269479
14502,0.000141,172.31.36.0-255,66,15685,8,269479
14503,0.000147,172.217.194.0-255,5379,21064,8,269479
14504,0.00015,172.31.36.0-255,66,21130,8,269479
14505,0.000182,172.217.194.0-255,1484,22614,8,269479
14506,0.000185,172.31.36.0-255,66,22680,8,269479
14507,0.000201,172.217.194.0-255,2902,25582,8,269479
14508,0.000204,172.31.36.0-255,66,25648,8,269479
14509,0.000209,172.217.194.0-255,4320,29968,8,269479
14510,0.000211,172.31.36.0-255,66,30034,8,269479
14511,0.000233,172.217.194.0-255,1484,31518,8,269479
14512,0.000235,172.31.36.0-255,66,31584,8,269479
14513,0.000242,172.217.194.0-255,6797,38381,8,269479
14514,0.000245,172.31.36.0-255,66,38447,8,269479
14515,0.000252,172.217.194.0-255,5738,44185,8,269479
14516,0.000254,172.31.36.0-255,66,44251,8,269479
14517,0.000288,172.31.36.0-255,66,44317,8,269479
14518,0.000292,172.217.194.0-255,2842,47159,8,269479
14519,0.000296,172.31.36.0-255,66,47225,8,269479
14520,0.000766,172.217.194.0-255,378,47603,8,269479
14521,0.000806,172.31.36.0-255,66,47669,8,269479
14522,0.00102,172.217.194.0-255,1484,49153,8,269479
14523,0.001029,172.217.194.0-255,2902,52055,8,269479
14524,0.001034,172.31.36.0-255,66,52121,8,269479
14525,0.001038,172.217.194.0-255,1484,53605,8,269479
14526,0.001058,172.217.194.0-255,4320,57925,8,269479
14527,0.001061,172.31.36.0-255,66,57991,8,269479
14528,0.00108,172.217.194.0-255,2902,60893,8,269479
14529,0.001083,172.31.36.0-255,66,60959,8,269479
14530,0.00111,172.31.36.0-255,66,61025,8,269479
14531,0.001126,172.217.194.0-255,2902,63927,8,269479
14532,0.001129,172.31.36.0-255,66,63993,8,269479
14533,0.002018,172.217.194.0-255,1484,65477,8,269479
14534,0.002036,172.217.194.0-255,2902,68379,8,269479
14535,0.002053,172.217.194.0-255,5738,74117,8,269479
14536,0.002056,172.217.194.0-255,2902,77019,8,269479
14537,0.002071,172.217.194.0-255,4320,81339,8,269479
14538,0.002083,172.217.194.0-255,4320,85659,8,269479
14539,0.002106,172.217.194.0-255,2184,87843,8,269479
14540,0.002264,172.217.194.0-255,1484,89327,8,269479
14541,0.002278,172.217.194.0-255,1484,90811,8,269479
14542,0.002571,172.31.36.0-255,66,90877,8,269479
14543,0.004814,172.217.194.0-255,5738,96615,8,269479
14544,0.00482,172.31.36.0-255,66,96681,8,269479
14545,0.007074,172.217.194.0-255,5738,102419,8,269479
14546,0.00708,172.31.36.0-255,66,102485,8,269479
14547,0.009394,172.217.194.0-255,5738,108223,8,269479
14548,0.009404,172.31.36.0-255,66,108289,8,269479
14549,0.01167,172.217.194.0-255,5738,114027,8,269479
14550,0.011679,172.31.36.0-255,66,114093,8,269479
14551,0.013914,172.217.194.0-255,5738,119831,8,269479
14552,0.013924,172.31.36.0-255,66,119897,8,269479
14553,0.01621,172.217.194.0-255,5738,125635,8,269479
14554,0.016221,172.31.36.0-255,66,125701,8,269479
14555,0.018481,172.217.194.0-255,5738,131439,8,269479
14556,0.018489,172.31.36.0-255,66,131505,8,269479
14557,0.018675,172.31.36.0-255,172,131677,8,269479
14558,0.01871,172.31.36.0-255,1110,132787,8,269479
14559,0.018866,172.31.36.0-255,1514,134301,8,269479
14560,0.018868,172.31.36.0-255,1514,135815,8,269479
14561,0.018874,172.31.36.0-255,1514,137329,8,269479
14562,0.018876,172.31.36.0-255,1514,138843,8,269479
14563,0.018899,172.31.36.0-255,1514,140357,8,269479
14564,0.018906,172.31.36.0-255,996,141353,8,269479
14565,0.020248,104.244.42.0-255,66,141419,8,269479
14566,0.020258,104.244.42.0-255,66,141485,8,269479
14567,0.020435,104.244.42.0-255,66,141551,8,269479
14568,0.020443,104.244.42.0-255,66,141617,8,269479
14569,0.02073,172.217.194.0-255,5738,147355,8,269479
14570,0.020739,172.31.36.0-255,66,147421,8,269479
14571,0.022984,172.217.194.0-255,5738,153159,8,269479
14572,0.022993,172.31.36.0-255,66,153225,8,269479
14573,0.025251,172.217.194.0-255,5738,158963,8,269479
14574,0.025259,172.31.36.0-255,66,159029,8,269479
14575,0.027503,172.217.194.0-255,5738,164767,8,269479
14576,0.027514,172.31.36.0-255,66,164833,8,269479
14577,0.029785,172.217.194.0-255,5738,170571,8,269479
14578,0.029798,172.31.36.0-255,66,170637,8,269479
14579,0.032086,172.217.194.0-255,5738,176375,8,269479
14580,0.032098,172.31.36.0-255,66,176441,8,269479
14581,0.034376,172.217.194.0-255,5738,182179,8,269479
14582,0.034386,172.31.36.0-255,66,182245,8,269479
14583,0.036387,172.31.36.0-255,108,182353,8,269479
14584,0.036635,172.217.194.0-255,5738,188091,8,269479
14585,0.036642,172.31.36.0-255,66,188157,8,269479
14586,0.037955,104.244.42.0-255,66,188223,8,269479
14587,0.038899,172.217.194.0-255,5738,193961,8,269479
14588,0.038909,172.31.36.0-255,66,194027,8,269479
14589,0.041181,172.217.194.0-255,5738,199765,8,269479
14590,0.041189,172.31.36.0-255,66,199831,8,269479
14591,0.043465,172.217.194.0-255,5738,205569,8,269479
14592,0.043474,172.31.36.0-255,66,205635,8,269479
14593,0.045764,172.217.194.0-255,5738,211373,8,269479
14594,0.045777,172.31.36.0-255,66,211439,8,269479
14595,0.048051,172.217.194.0-255,5738,217177,8,269479
14596,0.048062,172.31.36.0-255,66,217243,8,269479
14597,0.050357,172.217.194.0-255,5738,222981,8,269479
14598,0.050366,172.31.36.0-255,66,223047,8,269479
14599,0.052605,172.217.194.0-255,5738,228785,8,269479
14600,0.052615,172.31.36.0-255,66,228851,8,269479
14601,0.054883,172.217.194.0-255,5738,234589,8,269479
14602,0.054892,172.31.36.0-255,66,234655,8,269479
14603,0.057159,172.217.194.0-255,5738,240393,8,269479
14604,0.057172,172.31.36.0-255,66,240459,8,269479
14605,0.059455,172.217.194.0-255,5738,246197,8,269479
14606,0.059467,172.31.36.0-255,66,246263,8,269479
14607,0.061708,172.217.194.0-255,5738,252001,8,269479
14608,0.061716,172.31.36.0-255,66,252067,8,269479
14609,0.063974,172.217.194.0-255,5738,257805,8,269479
14610,0.063987,172.31.36.0-255,66,257871,8,269479
14611,0.066242,172.217.194.0-255,5738,263609,8,269479
14612,0.066254,172.31.36.0-255,66,263675,8,269479
14613,0.06855,172.217.194.0-255,5738,269413,8,269479
14614,0.068561,172.31.36.0-255,66,269479,8,269479
14615,0.0,172.31.36.0-255,105,105,8,459
14616,0.000227,172.31.36.0-255,90,195,8,459
14617,0.000238,172.31.36.0-255,66,261,8,459
14618,0.003151,74.125.130.0-255,66,327,8,459
14619,0.003171,74.125.130.0-255,66,393,8,459
14620,0.003186,172.31.36.0-255,66,459,8,459
14621,0.0,74.125.68.0-255,153,153,8,269413
14622,2.6e-05,172.31.36.0-255,66,219,8,269413
14623,3.4e-05,74.125.68.0-255,1484,1703,8,269413
14624,3.9e-05,172.31.36.0-255,66,1769,8,269413
14625,4.6e-05,74.125.68.0-255,2902,4671,8,269413
14626,4.9e-05,172.31.36.0-255,66,4737,8,269413
14627,5.8e-05,74.125.68.0-255,7156,11893,8,269413
14628,6.1e-05,172.31.36.0-255,66,11959,8,269413
14629,0.000115,74.125.68.0-255,2003,13962,8,269413
14630,0.000118,172.31.36.0-255,66,14028,8,269413
14631,0.000122,74.125.68.0-255,1484,15512,8,269413
14632,0.000124,172.31.36.0-255,66,15578,8,269413
14633,0.000141,74.125.68.0-255,2902,18480,8,269413
14634,0.000144,172.31.36.0-255,66,18546,8,269413
14635,0.000172,74.125.68.0-255,5738,24284,8,269413
14636,0.000175,172.31.36.0-255,66,24350,8,269413
14637,0.000179,74.125.68.0-255,2902,27252,8,269413
14638,0.000181,172.31.36.0-255,66,27318,8,269413
14639,0.000225,74.125.68.0-255,3961,31279,8,269413
14640,0.000227,172.31.36.0-255,66,31345,8,269413
14641,0.00035,74.125.68.0-255,1484,32829,8,269413
14642,0.000354,172.31.36.0-255,66,32895,8,269413
14643,0.000358,74.125.68.0-255,1484,34379,8,269413
14644,0.000361,172.31.36.0-255,66,34445,8,269413
14645,0.000378,74.125.68.0-255,2902,37347,8,269413
14646,0.000381,172.31.36.0-255,66,37413,8,269413
14647,0.000407,74.125.68.0-255,2902,40315,8,269413
14648,0.00041,172.31.36.0-255,66,40381,8,269413
14649,0.000431,74.125.68.0-255,2902,43283,8,269413
14650,0.000434,172.31.36.0-255,66,43349,8,269413
14651,0.00044,74.125.68.0-255,5379,48728,8,269413
14652,0.000442,172.31.36.0-255,66,48794,8,269413
14653,0.001427,74.125.68.0-255,1484,50278,8,269413
14654,0.001437,74.125.68.0-255,1484,51762,8,269413
14655,0.001442,172.31.36.0-255,66,51828,8,269413
14656,0.001464,74.125.68.0-255,1484,53312,8,269413
14657,0.001471,74.125.68.0-255,5738,59050,8,269413
14658,0.001474,172.31.36.0-255,66,59116,8,269413
14659,0.001492,74.125.68.0-255,4320,63436,8,269413
14660,0.001494,172.31.36.0-255,66,63502,8,269413
14661,0.001516,74.125.68.0-255,2543,66045,8,269413
14662,0.001518,172.31.36.0-255,66,66111,8,269413
14663,0.001954,74.125.68.0-255,1484,67595,8,269413
14664,0.001963,74.125.68.0-255,2902,70497,8,269413
14665,0.001967,172.31.36.0-255,66,70563,8,269413
14666,0.001991,74.125.68.0-255,5738,76301,8,269413
14667,0.001994,172.31.36.0-255,66,76367,8,269413
14668,0.001998,74.125.68.0-255,2902,79269,8,269413
14669,0.002001,172.31.36.0-255,66,79335,8,269413
14670,0.002006,74.125.68.0-255,4320,83655,8,269413
14671,0.002008,172.31.36.0-255,66,83721,8,269413
14672,0.002034,74.125.68.0-255,7156,90877,8,269413
14673,0.002037,172.31.36.0-255,66,90943,8,269413
14674,0.002055,74.125.68.0-255,1484,92427,8,269413
14675,0.00206,74.125.68.0-255,4320,96747,8,269413
14676,0.002062,172.31.36.0-255,66,96813,8,269413
14677,0.002096,74.125.68.0-255,3602,100415,8,269413
14678,0.002099,172.31.36.0-255,66,100481,8,269413
14679,0.004303,74.125.68.0-255,1484,101965,8,269413
14680,0.004349,74.125.68.0-255,4320,106285,8,269413
14681,0.004353,172.31.36.0-255,66,106351,8,269413
14682,0.006602,74.125.68.0-255,4320,110671,8,269413
14683,0.006609,172.31.36.0-255,66,110737,8,269413
14684,0.006626,74.125.68.0-255,1484,112221,8,269413
14685,0.008868,74.125.68.0-255,4320,116541,8,269413
14686,0.008875,172.31.36.0-255,66,116607,8,269413
14687,0.011143,74.125.68.0-255,2902,119509,8,269413
14688,0.011151,172.31.36.0-255,66,119575,8,269413
14689,0.011172,74.125.68.0-255,2902,122477,8,269413
14690,0.011175,172.31.36.0-255,66,122543,8,269413
14691,0.013412,74.125.68.0-255,2902,125445,8,269413
14692,0.01342,172.31.36.0-255,66,125511,8,269413
14693,0.013442,74.125.68.0-255,2902,128413,8,269413
14694,0.013445,172.31.36.0-255,66,128479,8,269413
14695,0.015705,74.125.68.0-255,5738,134217,8,269413
14696,0.015717,172.31.36.0-255,66,134283,8,269413
14697,0.017974,74.125.68.0-255,5738,140021,8,269413
14698,0.017982,172.31.36.0-255,66,140087,8,269413
14699,0.020255,74.125.68.0-255,5738,145825,8,269413
14700,0.020264,172.31.36.0-255,66,145891,8,269413
14701,0.022534,74.125.68.0-255,5738,151629,8,269413
14702,0.022546,172.31.36.0-255,66,151695,8,269413
14703,0.024802,74.125.68.0-255,5738,157433,8,269413
14704,0.024809,172.31.36.0-255,66,157499,8,269413
14705,0.027056,74.125.68.0-255,5738,163237,8,269413
14706,0.027064,172.31.36.0-255,66,163303,8,269413
14707,0.029325,74.125.68.0-255,4320,167623,8,269413
14708,0.029334,172.31.36.0-255,66,167689,8,269413
14709,0.02937,74.125.68.0-255,1484,169173,8,269413
14710,0.031607,74.125.68.0-255,4320,173493,8,269413
14711,0.031619,172.31.36.0-255,66,173559,8,269413
14712,0.033893,74.125.68.0-255,5738,179297,8,269413
14713,0.033904,172.31.36.0-255,66,179363,8,269413
14714,0.036165,74.125.68.0-255,5738,185101,8,269413
14715,0.036174,172.31.36.0-255,66,185167,8,269413
14716,0.03843,74.125.68.0-255,5738,190905,8,269413
14717,0.038438,172.31.36.0-255,66,190971,8,269413
14718,0.039221,172.31.36.0-255,188,191159,8,269413
14719,0.039254,172.31.36.0-255,955,192114,8,269413
14720,0.039318,172.31.36.0-255,1514,193628,8,269413
14721,0.039319,172.31.36.0-255,135,193763,8,269413
14722,0.040737,74.125.68.0-255,5738,199501,8,269413
14723,0.040745,172.31.36.0-255,66,199567,8,269413
14724,0.040771,104.244.42.0-255,66,199633,8,269413
14725,0.040804,104.244.42.0-255,66,199699,8,269413
14726,0.04086,104.244.42.0-255,66,199765,8,269413
14727,0.043019,74.125.68.0-255,5738,205503,8,269413
14728,0.043026,172.31.36.0-255,66,205569,8,269413
14729,0.045306,74.125.68.0-255,5738,211307,8,269413
14730,0.045312,172.31.36.0-255,66,211373,8,269413
14731,0.047595,74.125.68.0-255,5738,217111,8,269413
14732,0.047602,172.31.36.0-255,66,217177,8,269413
14733,0.049866,74.125.68.0-255,5738,222915,8,269413
14734,0.049872,172.31.36.0-255,66,222981,8,269413
14735,0.052148,74.125.68.0-255,5738,228719,8,269413
14736,0.052155,172.31.36.0-255,66,228785,8,269413
14737,0.054422,74.125.68.0-255,5738,234523,8,269413
14738,0.054429,172.31.36.0-255,66,234589,8,269413
14739,0.056697,74.125.68.0-255,5738,240327,8,269413
14740,0.056703,172.31.36.0-255,66,240393,8,269413
14741,0.058964,74.125.68.0-255,5738,246131,8,269413
14742,0.05897,172.31.36.0-255,66,246197,8,269413
14743,0.061244,74.125.68.0-255,5738,251935,8,269413
14744,0.061253,172.31.36.0-255,66,252001,8,269413
14745,0.063526,74.125.68.0-255,5738,257739,8,269413
14746,0.063534,172.31.36.0-255,66,257805,8,269413
14747,0.065811,74.125.68.0-255,5738,263543,8,269413
14748,0.065818,172.31.36.0-255,66,263609,8,269413
14749,0.068099,74.125.68.0-255,5738,269347,8,269413
14750,0.068106,172.31.36.0-255,66,269413,8,269413
14751,0.0,74.125.200.0-255,289,289,8,351681
14752,3.5e-05,172.31.36.0-255,66,355,8,351681
14753,4.2e-05,74.125.200.0-255,1484,1839,8,351681
14754,4.6e-05,172.31.36.0-255,66,1905,8,351681
14755,5.1e-05,74.125.200.0-255,2902,4807,8,351681
14756,5.4e-05,172.31.36.0-255,66,4873,8,351681
14757,6.1e-05,74.125.200.0-255,5738,10611,8,351681
14758,6.4e-05,172.31.36.0-255,66,10677,8,351681
14759,6.9e-05,74.125.200.0-255,3358,14035,8,351681
14760,7.2e-05,172.31.36.0-255,66,14101,8,351681
14761,7.6e-05,74.125.200.0-255,2902,17003,8,351681
14762,7.9e-05,172.31.36.0-255,66,17069,8,351681
14763,9.4e-05,74.125.200.0-255,1484,18553,8,351681
14764,9.7e-05,172.31.36.0-255,66,18619,8,351681
14765,0.000121,74.125.200.0-255,5738,24357,8,351681
14766,0.000124,172.31.36.0-255,66,24423,8,351681
14767,0.000148,74.125.200.0-255,4320,28743,8,351681
14768,0.000151,172.31.36.0-255,66,28809,8,351681
14769,0.000156,74.125.200.0-255,2543,31352,8,351681
14770,0.000158,172.31.36.0-255,66,31418,8,351681
14771,0.000257,74.125.200.0-255,1484,32902,8,351681
14772,0.000262,172.31.36.0-255,66,32968,8,351681
14773,0.000265,74.125.200.0-255,1484,34452,8,351681
14774,0.000267,172.31.36.0-255,66,34518,8,351681
14775,0.000282,74.125.200.0-255,2902,37420,8,351681
14776,0.000284,172.31.36.0-255,66,37486,8,351681
14777,0.000312,74.125.200.0-255,5738,43224,8,351681
14778,0.000315,74.125.200.0-255,1484,44708,8,351681
14779,0.000318,172.31.36.0-255,66,44774,8,351681
14780,0.000322,172.31.36.0-255,66,44840,8,351681
14781,0.00034,74.125.200.0-255,6797,51637,8,351681
14782,0.000343,172.31.36.0-255,66,51703,8,351681
14783,0.000356,172.31.36.0-255,66,51769,8,351681
14784,0.000372,74.125.200.0-255,2902,54671,8,351681
14785,0.000375,172.31.36.0-255,66,54737,8,351681
14786,0.000398,74.125.200.0-255,2543,57280,8,351681
14787,0.000402,172.31.36.0-255,66,57346,8,351681
14788,0.000797,74.125.200.0-255,648,57994,8,351681
14789,0.000841,172.31.36.0-255,66,58060,8,351681
14790,0.000988,74.125.200.0-255,1484,59544,8,351681
14791,0.001011,74.125.200.0-255,1484,61028,8,351681
14792,0.001015,172.31.36.0-255,66,61094,8,351681
14793,0.00102,74.125.200.0-255,1484,62578,8,351681
14794,0.001033,74.125.200.0-255,1484,64062,8,351681
14795,0.001036,172.31.36.0-255,66,64128,8,351681
14796,0.00104,74.125.200.0-255,1484,65612,8,351681
14797,0.001058,74.125.200.0-255,4320,69932,8,351681
14798,0.001062,172.31.36.0-255,66,69998,8,351681
14799,0.001066,74.125.200.0-255,2902,72900,8,351681
14800,0.001069,172.31.36.0-255,66,72966,8,351681
14801,0.001072,74.125.200.0-255,1484,74450,8,351681
14802,0.001095,74.125.200.0-255,2902,77352,8,351681
14803,0.001098,172.31.36.0-255,66,77418,8,351681
14804,0.001122,172.31.36.0-255,66,77484,8,351681
14805,0.001162,74.125.200.0-255,4320,81804,8,351681
14806,0.001167,172.31.36.0-255,66,81870,8,351681
14807,0.001184,74.125.200.0-255,2184,84054,8,351681
14808,0.001186,172.31.36.0-255,66,84120,8,351681
14809,0.001574,74.125.200.0-255,1484,85604,8,351681
14810,0.001582,74.125.200.0-255,2902,88506,8,351681
14811,0.001586,172.31.36.0-255,66,88572,8,351681
14812,0.001592,74.125.200.0-255,2902,91474,8,351681
14813,0.001594,172.31.36.0-255,66,91540,8,351681
14814,0.001609,74.125.200.0-255,2902,94442,8,351681
14815,0.001611,172.31.36.0-255,66,94508,8,351681
14816,0.001618,74.125.200.0-255,7156,101664,8,351681
14817,0.00162,172.31.36.0-255,66,101730,8,351681
14818,0.001684,172.31.36.0-255,66,101796,8,351681
14819,0.001695,172.31.36.0-255,66,101862,8,351681
14820,0.001713,74.125.200.0-255,1484,103346,8,351681
14821,0.00173,74.125.200.0-255,2902,106248,8,351681
14822,0.001734,172.31.36.0-255,66,106314,8,351681
14823,0.001753,74.125.200.0-255,5738,112052,8,351681
14824,0.001756,172.31.36.0-255,66,112118,8,351681
14825,0.001782,172.31.36.0-255,66,112184,8,351681
14826,0.001812,172.31.36.0-255,66,112250,8,351681
14827,0.001815,74.125.200.0-255,2184,114434,8,351681
14828,0.001817,172.31.36.0-255,66,114500,8,351681
14829,0.002145,74.125.200.0-255,1484,115984,8,351681
14830,0.002149,74.125.200.0-255,2902,118886,8,351681
14831,0.002151,172.31.36.0-255,66,118952,8,351681
14832,0.002169,74.125.200.0-255,5738,124690,8,351681
14833,0.002172,172.31.36.0-255,66,124756,8,351681
14834,0.002194,74.125.200.0-255,5738,130494,8,351681
14835,0.002197,172.31.36.0-255,66,130560,8,351681
14836,0.002218,74.125.200.0-255,4320,134880,8,351681
14837,0.00222,172.31.36.0-255,66,134946,8,351681
14838,0.002223,74.125.200.0-255,1484,136430,8,351681
14839,0.002243,74.125.200.0-255,7156,143586,8,351681
14840,0.002246,172.31.36.0-255,66,143652,8,351681
14841,0.002268,74.125.200.0-255,2902,146554,8,351681
14842,0.00227,172.31.36.0-255,66,146620,8,351681
14843,0.002274,74.125.200.0-255,2184,148804,8,351681
14844,0.002276,172.31.36.0-255,66,148870,8,351681
14845,0.002281,74.125.200.0-255,2902,151772,8,351681
14846,0.002285,172.31.36.0-255,66,151838,8,351681
14847,0.00229,74.125.200.0-255,4320,156158,8,351681
14848,0.002292,172.31.36.0-255,66,156224,8,351681
14849,0.002318,74.125.200.0-255,7156,163380,8,351681
14850,0.00232,172.31.36.0-255,66,163446,8,351681
14851,0.002335,74.125.200.0-255,1484,164930,8,351681
14852,0.002342,74.125.200.0-255,5738,170668,8,351681
14853,0.002344,172.31.36.0-255,66,170734,8,351681
14854,0.002361,74.125.200.0-255,1484,172218,8,351681
14855,0.002371,172.31.36.0-255,66,172284,8,351681
14856,0.002375,74.125.200.0-255,2902,175186,8,351681
14857,0.002377,172.31.36.0-255,66,175252,8,351681
14858,0.002397,74.125.200.0-255,5020,180272,8,351681
14859,0.0024,172.31.36.0-255,66,180338,8,351681
14860,0.002418,172.31.36.0-255,66,180404,8,351681
14861,0.002439,74.125.200.0-255,7156,187560,8,351681
14862,0.002442,172.31.36.0-255,66,187626,8,351681
14863,0.002464,74.125.200.0-255,7156,194782,8,351681
14864,0.002467,172.31.36.0-255,66,194848,8,351681
14865,0.002492,74.125.200.0-255,5020,199868,8,351681
14866,0.002496,172.31.36.0-255,66,199934,8,351681
14867,0.002559,74.125.200.0-255,1484,201418,8,351681
14868,0.002564,74.125.200.0-255,1484,202902,8,351681
14869,0.002568,172.31.36.0-255,66,202968,8,351681
14870,0.002587,74.125.200.0-255,1484,204452,8,351681
14871,0.002591,74.125.200.0-255,2902,207354,8,351681
14872,0.002594,172.31.36.0-255,66,207420,8,351681
14873,0.002609,74.125.200.0-255,4320,211740,8,351681
14874,0.002613,172.31.36.0-255,66,211806,8,351681
14875,0.002617,74.125.200.0-255,2902,214708,8,351681
14876,0.002619,172.31.36.0-255,66,214774,8,351681
14877,0.005195,74.125.200.0-255,5738,220512,8,351681
14878,0.005207,172.31.36.0-255,66,220578,8,351681
14879,0.007858,74.125.200.0-255,4320,224898,8,351681
14880,0.007865,172.31.36.0-255,66,224964,8,351681
14881,0.007881,74.125.200.0-255,1484,226448,8,351681
14882,0.010501,74.125.200.0-255,4320,230768,8,351681
14883,0.010509,172.31.36.0-255,66,230834,8,351681
14884,0.013108,74.125.200.0-255,5738,236572,8,351681
14885,0.013121,172.31.36.0-255,66,236638,8,351681
14886,0.015731,74.125.200.0-255,5738,242376,8,351681
14887,0.015745,172.31.36.0-255,66,242442,8,351681
14888,0.018333,74.125.200.0-255,5738,248180,8,351681
14889,0.018349,172.31.36.0-255,66,248246,8,351681
14890,0.020944,74.125.200.0-255,5738,253984,8,351681
14891,0.020959,172.31.36.0-255,66,254050,8,351681
14892,0.023565,74.125.200.0-255,5738,259788,8,351681
14893,0.023577,172.31.36.0-255,66,259854,8,351681
14894,0.026176,74.125.200.0-255,5738,265592,8,351681
14895,0.026192,172.31.36.0-255,66,265658,8,351681
14896,0.026829,172.31.36.0-255,172,265830,8,351681
14897,0.026875,172.31.36.0-255,1111,266941,8,351681
14898,0.026976,172.31.36.0-255,1514,268455,8,351681
14899,0.026978,172.31.36.0-255,1514,269969,8,351681
14900,0.026979,172.31.36.0-255,1256,271225,8,351681
14901,0.028588,104.244.42.0-255,66,271291,8,351681
14902,0.028772,74.125.200.0-255,5738,277029,8,351681
14903,0.028777,172.31.36.0-255,66,277095,8,351681
14904,0.031366,74.125.200.0-255,5738,282833,8,351681
14905,0.031378,172.31.36.0-255,66,282899,8,351681
14906,0.033952,74.125.200.0-255,5738,288637,8,351681
14907,0.033961,172.31.36.0-255,66,288703,8,351681
14908,0.036548,74.125.200.0-255,5738,294441,8,351681
14909,0.036573,172.31.36.0-255,66,294507,8,351681
14910,0.039211,74.125.200.0-255,5738,300245,8,351681
14911,0.039219,172.31.36.0-255,66,300311,8,351681
14912,0.041796,74.125.200.0-255,5738,306049,8,351681
14913,0.041803,172.31.36.0-255,66,306115,8,351681
14914,0.044375,74.125.200.0-255,4320,310435,8,351681
14915,0.044384,172.31.36.0-255,66,310501,8,351681
14916,0.044416,74.125.200.0-255,1484,311985,8,351681
14917,0.046958,74.125.200.0-255,4320,316305,8,351681
14918,0.046973,172.31.36.0-255,66,316371,8,351681
14919,0.049564,74.125.200.0-255,5738,322109,8,351681
14920,0.049577,172.31.36.0-255,66,322175,8,351681
14921,0.052163,74.125.200.0-255,5738,327913,8,351681
14922,0.052174,172.31.36.0-255,66,327979,8,351681
14923,0.054747,74.125.200.0-255,5738,333717,8,351681
14924,0.054757,172.31.36.0-255,66,333783,8,351681
14925,0.05733,74.125.200.0-255,5738,339521,8,351681
14926,0.057338,172.31.36.0-255,66,339587,8,351681
14927,0.059933,74.125.200.0-255,5738,345325,8,351681
14928,0.059941,172.31.36.0-255,66,345391,8,351681
14929,0.062545,74.125.200.0-255,5738,351129,8,351681
14930,0.062559,172.31.36.0-255,66,351195,8,351681
14931,0.065109,74.125.200.0-255,183,351378,8,351681
14932,0.065258,172.31.36.0-255,66,351444,8,351681
14933,0.065288,172.31.36.0-255,105,351549,8,351681
14934,0.067822,74.125.200.0-255,66,351615,8,351681
14935,0.068891,104.244.42.0-255,66,351681,8,351681
14936,0.0,74.125.68.0-255,153,153,8,277654
14937,1.6e-05,172.31.36.0-255,66,219,8,277654
14938,2.2e-05,74.125.68.0-255,1484,1703,8,277654
14939,2.7e-05,172.31.36.0-255,66,1769,8,277654
14940,3.1e-05,74.125.68.0-255,1484,3253,8,277654
14941,3.4e-05,172.31.36.0-255,66,3319,8,277654
14942,7.4e-05,74.125.68.0-255,1484,4803,8,277654
14943,7.7e-05,172.31.36.0-255,66,4869,8,277654
14944,8.6e-05,74.125.68.0-255,7156,12025,8,277654
14945,8.9e-05,172.31.36.0-255,66,12091,8,277654
14946,9.2e-05,74.125.68.0-255,1484,13575,8,277654
14947,9.4e-05,172.31.36.0-255,66,13641,8,277654
14948,9.9e-05,74.125.68.0-255,2027,15668,8,277654
14949,0.000101,172.31.36.0-255,66,15734,8,277654
14950,0.000105,74.125.68.0-255,2902,18636,8,277654
14951,0.000108,172.31.36.0-255,66,18702,8,277654
14952,0.00014,74.125.68.0-255,2902,21604,8,277654
14953,0.000144,172.31.36.0-255,66,21670,8,277654
14954,0.00015,74.125.68.0-255,4320,25990,8,277654
14955,0.000152,172.31.36.0-255,66,26056,8,277654
14956,0.000158,74.125.68.0-255,5379,31435,8,277654
14957,0.00016,172.31.36.0-255,66,31501,8,277654
14958,0.000216,74.125.68.0-255,1484,32985,8,277654
14959,0.000219,172.31.36.0-255,66,33051,8,277654
14960,0.000247,74.125.68.0-255,2902,35953,8,277654
14961,0.00025,172.31.36.0-255,66,36019,8,277654
14962,0.000257,74.125.68.0-255,5738,41757,8,277654
14963,0.000259,172.31.36.0-255,66,41823,8,277654
14964,0.000271,74.125.68.0-255,1484,43307,8,277654
14965,0.000273,172.31.36.0-255,66,43373,8,277654
14966,0.000299,74.125.68.0-255,5379,48752,8,277654
14967,0.000301,172.31.36.0-255,66,48818,8,277654
14968,0.000902,74.125.68.0-255,1484,50302,8,277654
14969,0.00091,74.125.68.0-255,2902,53204,8,277654
14970,0.000914,172.31.36.0-255,66,53270,8,277654
14971,0.000942,74.125.68.0-255,5738,59008,8,277654
14972,0.000945,74.125.68.0-255,1484,60492,8,277654
14973,0.000956,74.125.68.0-255,1484,61976,8,277654
14974,0.000972,74.125.68.0-255,1484,63460,8,277654
14975,0.000984,172.31.36.0-255,66,63526,8,277654
14976,0.001007,74.125.68.0-255,2543,66069,8,277654
14977,0.00103,172.31.36.0-255,66,66135,8,277654
14978,0.001865,74.125.68.0-255,1484,67619,8,277654
14979,0.001876,74.125.68.0-255,2902,70521,8,277654
14980,0.001881,172.31.36.0-255,66,70587,8,277654
14981,0.001908,74.125.68.0-255,2902,73489,8,277654
14982,0.001923,74.125.68.0-255,1484,74973,8,277654
14983,0.001935,74.125.68.0-255,2902,77875,8,277654
14984,0.001948,74.125.68.0-255,1484,79359,8,277654
14985,0.001962,74.125.68.0-255,2902,82261,8,277654
14986,0.001991,74.125.68.0-255,5738,87999,8,277654
14987,0.001994,74.125.68.0-255,1484,89483,8,277654
14988,0.00201,74.125.68.0-255,2902,92385,8,277654
14989,0.002044,74.125.68.0-255,4320,96705,8,277654
14990,0.002063,74.125.68.0-255,1484,98189,8,277654
14991,0.002066,74.125.68.0-255,1484,99673,8,277654
14992,0.002093,74.125.68.0-255,766,100439,8,277654
14993,0.004034,172.31.36.0-255,66,100505,8,277654
14994,0.006252,74.125.68.0-255,5738,106243,8,277654
14995,0.006257,172.31.36.0-255,66,106309,8,277654
14996,0.008464,74.125.68.0-255,5738,112047,8,277654
14997,0.008471,172.31.36.0-255,66,112113,8,277654
14998,0.010681,74.125.68.0-255,5738,117851,8,277654
14999,0.01091,172.31.36.0-255,66,117917,8,277654
15000,0.013121,74.125.68.0-255,5738,123655,8,277654
15001,0.013128,172.31.36.0-255,66,123721,8,277654
15002,0.015347,74.125.68.0-255,5738,129459,8,277654
15003,0.015355,172.31.36.0-255,66,129525,8,277654
15004,0.017573,74.125.68.0-255,5738,135263,8,277654
15005,0.017584,172.31.36.0-255,66,135329,8,277654
15006,0.019803,74.125.68.0-255,5738,141067,8,277654
15007,0.01981,172.31.36.0-255,66,141133,8,277654
15008,0.022027,74.125.68.0-255,5738,146871,8,277654
15009,0.022035,172.31.36.0-255,66,146937,8,277654
15010,0.024278,74.125.68.0-255,5738,152675,8,277654
15011,0.024286,172.31.36.0-255,66,152741,8,277654
15012,0.026514,74.125.68.0-255,5738,158479,8,277654
15013,0.026521,172.31.36.0-255,66,158545,8,277654
15014,0.028736,74.125.68.0-255,5738,164283,8,277654
15015,0.028743,172.31.36.0-255,66,164349,8,277654
15016,0.03095,74.125.68.0-255,5738,170087,8,277654
15017,0.030958,172.31.36.0-255,66,170153,8,277654
15018,0.033167,74.125.68.0-255,5738,175891,8,277654
15019,0.033176,172.31.36.0-255,66,175957,8,277654
15020,0.033945,172.31.36.0-255,172,176129,8,277654
15021,0.033976,172.31.36.0-255,1110,177239,8,277654
15022,0.034045,172.31.36.0-255,1514,178753,8,277654
15023,0.034047,172.31.36.0-255,1514,180267,8,277654
15024,0.034048,172.31.36.0-255,1514,181781,8,277654
15025,0.03405,172.31.36.0-255,1514,183295,8,277654
15026,0.034077,172.31.36.0-255,1231,184526,8,277654
15027,0.035382,74.125.68.0-255,5738,190264,8,277654
15028,0.03539,172.31.36.0-255,66,190330,8,277654
15029,0.035487,104.244.42.0-255,66,190396,8,277654
15030,0.035549,104.244.42.0-255,66,190462,8,277654
15031,0.035635,104.244.42.0-255,66,190528,8,277654
15032,0.03564,104.244.42.0-255,66,190594,8,277654
15033,0.037613,74.125.68.0-255,5738,196332,8,277654
15034,0.037621,172.31.36.0-255,66,196398,8,277654
15035,0.039844,74.125.68.0-255,5738,202136,8,277654
15036,0.039851,172.31.36.0-255,66,202202,8,277654
15037,0.042068,74.125.68.0-255,5738,207940,8,277654
15038,0.042073,172.31.36.0-255,66,208006,8,277654
15039,0.0443,74.125.68.0-255,5738,213744,8,277654
15040,0.044305,172.31.36.0-255,66,213810,8,277654
15041,0.046535,74.125.68.0-255,5738,219548,8,277654
15042,0.046542,172.31.36.0-255,66,219614,8,277654
15043,0.048757,74.125.68.0-255,5738,225352,8,277654
15044,0.048766,172.31.36.0-255,66,225418,8,277654
15045,0.050995,74.125.68.0-255,5738,231156,8,277654
15046,0.051002,172.31.36.0-255,66,231222,8,277654
15047,0.053216,74.125.68.0-255,5738,236960,8,277654
15048,0.053222,172.31.36.0-255,66,237026,8,277654
15049,0.05544,74.125.68.0-255,5738,242764,8,277654
15050,0.055447,172.31.36.0-255,66,242830,8,277654
15051,0.057679,74.125.68.0-255,5738,248568,8,277654
15052,0.057685,172.31.36.0-255,66,248634,8,277654
15053,0.059922,74.125.68.0-255,5738,254372,8,277654
15054,0.059929,172.31.36.0-255,66,254438,8,277654
15055,0.062149,74.125.68.0-255,5738,260176,8,277654
15056,0.062157,172.31.36.0-255,66,260242,8,277654
15057,0.06438,74.125.68.0-255,5738,265980,8,277654
15058,0.064387,172.31.36.0-255,66,266046,8,277654
15059,0.066608,74.125.68.0-255,5738,271784,8,277654
15060,0.066613,172.31.36.0-255,66,271850,8,277654
15061,0.06883,74.125.68.0-255,5738,277588,8,277654
15062,0.068836,172.31.36.0-255,66,277654,8,277654
15063,0.0,74.125.68.0-255,153,153,8,268588
15064,2.4e-05,172.31.36.0-255,66,219,8,268588
15065,3.1e-05,74.125.68.0-255,1484,1703,8,268588
15066,3.5e-05,172.31.36.0-255,66,1769,8,268588
15067,4.1e-05,74.125.68.0-255,2902,4671,8,268588
15068,4.5e-05,172.31.36.0-255,66,4737,8,268588
15069,4.9e-05,74.125.68.0-255,1484,6221,8,268588
15070,5.1e-05,172.31.36.0-255,66,6287,8,268588
15071,7.8e-05,74.125.68.0-255,5738,12025,8,268588
15072,8.2e-05,172.31.36.0-255,66,12091,8,268588
15073,0.000102,74.125.68.0-255,2045,14136,8,268588
15074,0.000105,172.31.36.0-255,66,14202,8,268588
15075,0.000208,74.125.68.0-255,1484,15686,8,268588
15076,0.000213,172.31.36.0-255,66,15752,8,268588
15077,0.000233,74.125.68.0-255,2902,18654,8,268588
15078,0.000236,172.31.36.0-255,66,18720,8,268588
15079,0.000239,74.125.68.0-255,1484,20204,8,268588
15080,0.000241,172.31.36.0-255,66,20270,8,268588
15081,0.000268,74.125.68.0-255,4320,24590,8,268588
15082,0.000271,172.31.36.0-255,66,24656,8,268588
15083,0.000275,74.125.68.0-255,2902,27558,8,268588
15084,0.000277,172.31.36.0-255,66,27624,8,268588
15085,0.000281,74.125.68.0-255,1484,29108,8,268588
15086,0.000284,172.31.36.0-255,66,29174,8,268588
15087,0.0003,74.125.68.0-255,2543,31717,8,268588
15088,0.000303,172.31.36.0-255,66,31783,8,268588
15089,0.000762,74.125.68.0-255,1484,33267,8,268588
15090,0.000767,172.31.36.0-255,66,33333,8,268588
15091,0.000776,74.125.68.0-255,2902,36235,8,268588
15092,0.000779,172.31.36.0-255,66,36301,8,268588
15093,0.000825,74.125.68.0-255,1484,37785,8,268588
15094,0.000828,172.31.36.0-255,66,37851,8,268588
15095,0.000848,74.125.68.0-255,2902,40753,8,268588
15096,0.00085,172.31.36.0-255,66,40819,8,268588
15097,0.000856,74.125.68.0-255,4320,45139,8,268588
15098,0.000858,172.31.36.0-255,66,45205,8,268588
15099,0.000874,74.125.68.0-255,1484,46689,8,268588
15100,0.000879,74.125.68.0-255,1484,48173,8,268588
15101,0.000881,172.31.36.0-255,66,48239,8,268588
15102,0.000911,74.125.68.0-255,3961,52200,8,268588
15103,0.000915,172.31.36.0-255,66,52266,8,268588
15104,0.00092,74.125.68.0-255,2902,55168,8,268588
15105,0.000922,172.31.36.0-255,66,55234,8,268588
15106,0.000936,74.125.68.0-255,2902,58136,8,268588
15107,0.000939,172.31.36.0-255,66,58202,8,268588
15108,0.000946,74.125.68.0-255,4320,62522,8,268588
15109,0.000948,172.31.36.0-255,66,62588,8,268588
15110,0.000968,74.125.68.0-255,3961,66549,8,268588
15111,0.000971,172.31.36.0-255,66,66615,8,268588
15112,0.001816,74.125.68.0-255,646,67261,8,268588
15113,0.001996,74.125.68.0-255,1484,68745,8,268588
15114,0.002,172.31.36.0-255,66,68811,8,268588
15115,0.002023,74.125.68.0-255,2902,71713,8,268588
15116,0.002026,172.31.36.0-255,66,71779,8,268588
15117,0.00205,74.125.68.0-255,4320,76099,8,268588
15118,0.002052,172.31.36.0-255,66,76165,8,268588
15119,0.002088,74.125.68.0-255,7156,83321,8,268588
15120,0.00209,172.31.36.0-255,66,83387,8,268588
15121,0.002093,74.125.68.0-255,1484,84871,8,268588
15122,0.002111,74.125.68.0-255,7156,92027,8,268588
15123,0.002114,172.31.36.0-255,66,92093,8,268588
15124,0.002142,172.31.36.0-255,66,92159,8,268588
15125,0.00439,74.125.68.0-255,5738,97897,8,268588
15126,0.004394,172.31.36.0-255,66,97963,8,268588
15127,0.00665,74.125.68.0-255,4320,102283,8,268588
15128,0.006656,172.31.36.0-255,66,102349,8,268588
15129,0.006676,74.125.68.0-255,1484,103833,8,268588
15130,0.008918,74.125.68.0-255,4320,108153,8,268588
15131,0.008927,172.31.36.0-255,66,108219,8,268588
15132,0.011196,74.125.68.0-255,5738,113957,8,268588
15133,0.011205,172.31.36.0-255,66,114023,8,268588
15134,0.013472,74.125.68.0-255,5738,119761,8,268588
15135,0.01348,172.31.36.0-255,66,119827,8,268588
15136,0.015771,74.125.68.0-255,5738,125565,8,268588
15137,0.01578,172.31.36.0-255,66,125631,8,268588
15138,0.018041,74.125.68.0-255,5738,131369,8,268588
15139,0.018048,172.31.36.0-255,66,131435,8,268588
15140,0.02032,74.125.68.0-255,5738,137173,8,268588
15141,0.02033,172.31.36.0-255,66,137239,8,268588
15142,0.02262,74.125.68.0-255,5738,142977,8,268588
15143,0.022629,172.31.36.0-255,66,143043,8,268588
15144,0.024917,74.125.68.0-255,5738,148781,8,268588
15145,0.024925,172.31.36.0-255,66,148847,8,268588
15146,0.025525,172.31.36.0-255,164,149011,8,268588
15147,0.025559,172.31.36.0-255,1118,150129,8,268588
15148,0.025623,172.31.36.0-255,1514,151643,8,268588
15149,0.025625,172.31.36.0-255,1514,153157,8,268588
15150,0.02563,172.31.36.0-255,1514,154671,8,268588
15151,0.025631,172.31.36.0-255,1514,156185,8,268588
15152,0.025658,172.31.36.0-255,1514,157699,8,268588
15153,0.025664,172.31.36.0-255,867,158566,8,268588
15154,0.027049,104.244.42.0-255,66,158632,8,268588
15155,0.027144,104.244.42.0-255,66,158698,8,268588
15156,0.027186,104.244.42.0-255,66,158764,8,268588
15157,0.027194,74.125.68.0-255,5738,164502,8,268588
15158,0.027199,172.31.36.0-255,66,164568,8,268588
15159,0.02724,104.244.42.0-255,66,164634,8,268588
15160,0.029466,74.125.68.0-255,2902,167536,8,268588
15161,0.029474,172.31.36.0-255,66,167602,8,268588
15162,0.029499,74.125.68.0-255,2902,170504,8,268588
15163,0.029502,172.31.36.0-255,66,170570,8,268588
15164,0.03174,74.125.68.0-255,2902,173472,8,268588
15165,0.031748,172.31.36.0-255,66,173538,8,268588
15166,0.031771,74.125.68.0-255,2902,176440,8,268588
15167,0.031774,172.31.36.0-255,66,176506,8,268588
15168,0.034018,74.125.68.0-255,2902,179408,8,268588
15169,0.034026,172.31.36.0-255,66,179474,8,268588
15170,0.03405,74.125.68.0-255,2902,182376,8,268588
15171,0.034053,172.31.36.0-255,66,182442,8,268588
15172,0.036292,74.125.68.0-255,2902,185344,8,268588
15173,0.0363,172.31.36.0-255,66,185410,8,268588
15174,0.036322,74.125.68.0-255,2902,188312,8,268588
15175,0.036325,172.31.36.0-255,66,188378,8,268588
15176,0.038563,74.125.68.0-255,5738,194116,8,268588
15177,0.03857,172.31.36.0-255,66,194182,8,268588
15178,0.040837,74.125.68.0-255,5738,199920,8,268588
15179,0.040847,172.31.36.0-255,66,199986,8,268588
15180,0.043126,74.125.68.0-255,5738,205724,8,268588
15181,0.043133,172.31.36.0-255,66,205790,8,268588
15182,0.044352,172.31.36.0-255,108,205898,8,268588
15183,0.045404,74.125.68.0-255,5738,211636,8,268588
15184,0.045414,172.31.36.0-255,66,211702,8,268588
15185,0.045917,104.244.42.0-255,66,211768,8,268588
15186,0.047674,74.125.68.0-255,5738,217506,8,268588
15187,0.047681,172.31.36.0-255,66,217572,8,268588
15188,0.049956,74.125.68.0-255,5738,223310,8,268588
15189,0.049965,172.31.36.0-255,66,223376,8,268588
15190,0.052233,74.125.68.0-255,5738,229114,8,268588
15191,0.052241,172.31.36.0-255,66,229180,8,268588
15192,0.054525,74.125.68.0-255,2902,232082,8,268588
15193,0.054532,172.31.36.0-255,66,232148,8,268588
15194,0.054557,74.125.68.0-255,2902,235050,8,268588
15195,0.05456,172.31.36.0-255,66,235116,8,268588
15196,0.056816,74.125.68.0-255,5738,240854,8,268588
15197,0.056828,172.31.36.0-255,66,240920,8,268588
15198,0.059102,74.125.68.0-255,5738,246658,8,268588
15199,0.059109,172.31.36.0-255,66,246724,8,268588
15200,0.061375,74.125.68.0-255,5738,252462,8,268588
15201,0.061381,172.31.36.0-255,66,252528,8,268588
15202,0.063651,74.125.68.0-255,5738,258266,8,268588
15203,0.063658,172.31.36.0-255,66,258332,8,268588
15204,0.066085,74.125.68.0-255,4320,262652,8,268588
15205,0.066092,172.31.36.0-255,66,262718,8,268588
15206,0.066113,74.125.68.0-255,1484,264202,8,268588
15207,0.068356,74.125.68.0-255,4320,268522,8,268588
15208,0.068363,172.31.36.0-255,66,268588,8,268588
15209,0.0,172.217.194.0-255,148,148,8,172641
15210,3.3e-05,172.31.36.0-255,66,214,8,172641
15211,4e-05,172.217.194.0-255,1484,1698,8,172641
15212,4.4e-05,172.31.36.0-255,66,1764,8,172641
15213,4.9e-05,172.217.194.0-255,2902,4666,8,172641
15214,5.2e-05,172.31.36.0-255,66,4732,8,172641
15215,5.9e-05,172.217.194.0-255,7156,11888,8,172641
15216,6.1e-05,172.31.36.0-255,66,11954,8,172641
15217,0.000102,172.31.36.0-255,66,12020,8,172641
15218,0.000105,172.217.194.0-255,1484,13504,8,172641
15219,0.000106,172.31.36.0-255,66,13570,8,172641
15220,0.00011,172.217.194.0-255,1125,14695,8,172641
15221,0.000111,172.31.36.0-255,66,14761,8,172641
15222,0.000154,172.217.194.0-255,1484,16245,8,172641
15223,0.000156,172.31.36.0-255,66,16311,8,172641
15224,0.00016,172.217.194.0-255,1484,17795,8,172641
15225,0.000161,172.31.36.0-255,66,17861,8,172641
15226,0.000182,172.217.194.0-255,2902,20763,8,172641
15227,0.000185,172.31.36.0-255,66,20829,8,172641
15228,0.000192,172.217.194.0-255,7156,27985,8,172641
15229,0.000194,172.31.36.0-255,66,28051,8,172641
15230,0.000235,172.31.36.0-255,66,28117,8,172641
15231,0.000253,172.217.194.0-255,2543,30660,8,172641
15232,0.000255,172.31.36.0-255,66,30726,8,172641
15233,0.000278,172.217.194.0-255,5738,36464,8,172641
15234,0.000282,172.31.36.0-255,66,36530,8,172641
15235,0.000302,172.217.194.0-255,4216,40746,8,172641
15236,0.000307,172.31.36.0-255,66,40812,8,172641
15237,0.00031,172.217.194.0-255,434,41246,8,172641
15238,0.000312,172.31.36.0-255,66,41312,8,172641
15239,0.000487,172.217.194.0-255,1484,42796,8,172641
15240,0.000495,172.217.194.0-255,2902,45698,8,172641
15241,0.000498,172.31.36.0-255,66,45764,8,172641
15242,0.000506,172.217.194.0-255,5738,51502,8,172641
15243,0.000508,172.31.36.0-255,66,51568,8,172641
15244,0.000526,172.217.194.0-255,2902,54470,8,172641
15245,0.00053,172.31.36.0-255,66,54536,8,172641
15246,0.000567,172.31.36.0-255,66,54602,8,172641
15247,0.000654,172.31.36.0-255,66,54668,8,172641
15248,0.000675,172.217.194.0-255,2184,56852,8,172641
15249,0.000678,172.31.36.0-255,66,56918,8,172641
15250,0.000742,172.217.194.0-255,1484,58402,8,172641
15251,0.000777,172.217.194.0-255,2902,61304,8,172641
15252,0.000781,172.31.36.0-255,66,61370,8,172641
15253,0.000787,172.217.194.0-255,5738,67108,8,172641
15254,0.000789,172.31.36.0-255,66,67174,8,172641
15255,0.000799,172.31.36.0-255,66,67240,8,172641
15256,0.000827,172.217.194.0-255,4320,71560,8,172641
15257,0.000831,172.31.36.0-255,66,71626,8,172641
15258,0.000842,172.31.36.0-255,66,71692,8,172641
15259,0.000845,172.217.194.0-255,766,72458,8,172641
15260,0.001277,172.217.194.0-255,1484,73942,8,172641
15261,0.001281,172.31.36.0-255,66,74008,8,172641
15262,0.001287,172.217.194.0-255,2902,76910,8,172641
15263,0.001289,172.31.36.0-255,66,76976,8,172641
15264,0.00132,172.217.194.0-255,1484,78460,8,172641
15265,0.001347,172.217.194.0-255,4320,82780,8,172641
15266,0.00135,172.31.36.0-255,66,82846,8,172641
15267,0.001362,172.31.36.0-255,66,82912,8,172641
15268,0.001369,172.217.194.0-255,7156,90068,8,172641
15269,0.001371,172.31.36.0-255,66,90134,8,172641
15270,0.001399,172.217.194.0-255,6438,96572,8,172641
15271,0.001402,172.31.36.0-255,66,96638,8,172641
15272,0.001433,172.31.36.0-255,66,96704,8,172641
15273,0.001447,172.31.36.0-255,66,96770,8,172641
15274,0.001474,172.217.194.0-255,7156,103926,8,172641
15275,0.001477,172.31.36.0-255,66,103992,8,172641
15276,0.001496,172.217.194.0-255,2184,106176,8,172641
15277,0.001498,172.31.36.0-255,66,106242,8,172641
15278,0.001515,172.217.194.0-255,1484,107726,8,172641
15279,0.001532,172.217.194.0-255,2902,110628,8,172641
15280,0.001535,172.31.36.0-255,66,110694,8,172641
15281,0.001541,172.217.194.0-255,5738,116432,8,172641
15282,0.001543,172.31.36.0-255,66,116498,8,172641
15283,0.001568,172.31.36.0-255,66,116564,8,172641
15284,0.00159,172.217.194.0-255,4320,120884,8,172641
15285,0.001594,172.31.36.0-255,66,120950,8,172641
15286,0.001623,172.217.194.0-255,4320,125270,8,172641
15287,0.001627,172.31.36.0-255,66,125336,8,172641
15288,0.001647,172.217.194.0-255,6438,131774,8,172641
15289,0.001651,172.31.36.0-255,66,131840,8,172641
15290,0.001669,172.217.194.0-255,1484,133324,8,172641
15291,0.001715,172.31.36.0-255,66,133390,8,172641
15292,0.001742,172.31.36.0-255,66,133456,8,172641
15293,0.001747,172.31.36.0-255,66,133522,8,172641
15294,0.001786,172.217.194.0-255,1484,135006,8,172641
15295,0.001799,172.217.194.0-255,2902,137908,8,172641
15296,0.001813,172.31.36.0-255,66,137974,8,172641
15297,0.00182,172.217.194.0-255,5738,143712,8,172641
15298,0.001828,172.31.36.0-255,66,143778,8,172641
15299,0.001844,172.31.36.0-255,66,143844,8,172641
15300,0.001895,172.31.36.0-255,66,143910,8,172641
15301,0.001924,172.217.194.0-255,5738,149648,8,172641
15302,0.001926,172.31.36.0-255,66,149714,8,172641
15303,0.001943,172.31.36.0-255,66,149780,8,172641
15304,0.001975,172.217.194.0-255,7156,156936,8,172641
15305,0.00198,172.31.36.0-255,66,157002,8,172641
15306,0.001997,172.217.194.0-255,2184,159186,8,172641
15307,0.002007,172.31.36.0-255,66,159252,8,172641
15308,0.002021,172.31.36.0-255,66,159318,8,172641
15309,0.002029,172.217.194.0-255,1484,160802,8,172641
15310,0.002056,172.31.36.0-255,66,160868,8,172641
15311,0.002071,172.31.36.0-255,66,160934,8,172641
15312,0.002085,172.31.36.0-255,66,161000,8,172641
15313,0.002103,172.217.194.0-255,5020,166020,8,172641
15314,0.002109,172.217.194.0-255,4578,170598,8,172641
15315,0.002109,172.31.36.0-255,66,170664,8,172641
15316,0.002111,172.217.194.0-255,105,170769,8,172641
15317,0.002115,172.31.36.0-255,66,170835,8,172641
15318,0.003606,172.31.36.0-255,66,170901,8,172641
15319,0.003633,172.31.36.0-255,105,171006,8,172641
15320,0.005867,172.217.194.0-255,66,171072,8,172641
15321,0.039128,172.31.36.0-255,192,171264,8,172641
15322,0.03916,172.31.36.0-255,956,172220,8,172641
15323,0.039196,172.31.36.0-255,223,172443,8,172641
15324,0.04068,104.244.42.0-255,66,172509,8,172641
15325,0.040726,104.244.42.0-255,66,172575,8,172641
15326,0.040728,104.244.42.0-255,66,172641,8,172641
15327,0.0,172.31.36.0-255,66,66,8,66
15328,0.0,172.217.194.0-255,143,143,8,148920
15329,3.3e-05,172.31.36.0-255,66,209,8,148920
15330,3.9e-05,172.217.194.0-255,1484,1693,8,148920
15331,4.3e-05,172.31.36.0-255,66,1759,8,148920
15332,4.8e-05,172.217.194.0-255,2902,4661,8,148920
15333,5e-05,172.31.36.0-255,66,4727,8,148920
15334,6.2e-05,172.217.194.0-255,2902,7629,8,148920
15335,6.5e-05,172.31.36.0-255,66,7695,8,148920
15336,7.6e-05,172.31.36.0-255,66,7761,8,148920
15337,0.000118,172.31.36.0-255,66,7827,8,148920
15338,0.000182,172.217.194.0-255,1484,9311,8,148920
15339,0.000186,172.31.36.0-255,66,9377,8,148920
15340,0.00019,172.217.194.0-255,1484,10861,8,148920
15341,0.000192,172.31.36.0-255,66,10927,8,148920
15342,0.000212,172.217.194.0-255,1484,12411,8,148920
15343,0.00022,172.31.36.0-255,66,12477,8,148920
15344,0.000226,172.217.194.0-255,5738,18215,8,148920
15345,0.000228,172.31.36.0-255,66,18281,8,148920
15346,0.000233,172.217.194.0-255,2902,21183,8,148920
15347,0.000236,172.31.36.0-255,66,21249,8,148920
15348,0.000284,172.31.36.0-255,66,21315,8,148920
15349,0.000296,172.31.36.0-255,66,21381,8,148920
15350,0.000327,172.217.194.0-255,100,21481,8,148920
15351,0.000332,172.31.36.0-255,66,21547,8,148920
15352,0.000457,172.217.194.0-255,1484,23031,8,148920
15353,0.000461,172.31.36.0-255,66,23097,8,148920
15354,0.000466,172.217.194.0-255,2902,25999,8,148920
15355,0.000469,172.31.36.0-255,66,26065,8,148920
15356,0.000473,172.217.194.0-255,2902,28967,8,148920
15357,0.000474,172.31.36.0-255,66,29033,8,148920
15358,0.000492,172.217.194.0-255,2902,31935,8,148920
15359,0.000494,172.31.36.0-255,66,32001,8,148920
15360,0.000499,172.217.194.0-255,2902,34903,8,148920
15361,0.000506,172.31.36.0-255,66,34969,8,148920
15362,0.000548,172.31.36.0-255,66,35035,8,148920
15363,0.000585,172.217.194.0-255,4320,39355,8,148920
15364,0.000588,172.31.36.0-255,66,39421,8,148920
15365,0.000618,172.217.194.0-255,5379,44800,8,148920
15366,0.000621,172.31.36.0-255,66,44866,8,148920
15367,0.000627,172.217.194.0-255,2902,47768,8,148920
15368,0.000629,172.31.36.0-255,66,47834,8,148920
15369,0.000634,172.217.194.0-255,4320,52154,8,148920
15370,0.000636,172.31.36.0-255,66,52220,8,148920
15371,0.000647,172.31.36.0-255,66,52286,8,148920
15372,0.000682,172.31.36.0-255,66,52352,8,148920
15373,0.000707,172.217.194.0-255,6438,58790,8,148920
15374,0.00071,172.31.36.0-255,66,58856,8,148920
15375,0.00073,172.31.36.0-255,66,58922,8,148920
15376,0.000753,172.217.194.0-255,1484,60406,8,148920
15377,0.000775,172.31.36.0-255,66,60472,8,148920
15378,0.000787,172.31.36.0-255,66,60538,8,148920
15379,0.000824,172.217.194.0-255,1484,62022,8,148920
15380,0.000838,172.217.194.0-255,2902,64924,8,148920
15381,0.000841,172.31.36.0-255,66,64990,8,148920
15382,0.000847,172.217.194.0-255,5738,70728,8,148920
15383,0.000849,172.31.36.0-255,66,70794,8,148920
15384,0.000867,172.217.194.0-255,4320,75114,8,148920
15385,0.000869,172.31.36.0-255,66,75180,8,148920
15386,0.000914,172.31.36.0-255,66,75246,8,148920
15387,0.000926,172.31.36.0-255,66,75312,8,148920
15388,0.000959,172.217.194.0-255,5738,81050,8,148920
15389,0.000963,172.31.36.0-255,66,81116,8,148920
15390,0.000991,172.217.194.0-255,5738,86854,8,148920
15391,0.000994,172.31.36.0-255,66,86920,8,148920
15392,0.001002,172.217.194.0-255,7156,94076,8,148920
15393,0.001004,172.31.36.0-255,66,94142,8,148920
15394,0.001049,172.31.36.0-255,66,94208,8,148920
15395,0.001054,172.217.194.0-255,2902,97110,8,148920
15396,0.001056,172.31.36.0-255,66,97176,8,148920
15397,0.001101,172.31.36.0-255,66,97242,8,148920
15398,0.00112,172.31.36.0-255,66,97308,8,148920
15399,0.001126,172.217.194.0-255,5020,102328,8,148920
15400,0.001131,172.31.36.0-255,66,102394,8,148920
15401,0.001173,172.217.194.0-255,1484,103878,8,148920
15402,0.00118,172.217.194.0-255,2902,106780,8,148920
15403,0.001184,172.31.36.0-255,66,106846,8,148920
15404,0.001187,172.217.194.0-255,1484,108330,8,148920
15405,0.001213,172.217.194.0-255,4320,112650,8,148920
15406,0.001217,172.31.36.0-255,66,112716,8,148920
15407,0.001259,172.217.194.0-255,4320,117036,8,148920
15408,0.001262,172.31.36.0-255,66,117102,8,148920
15409,0.001297,172.31.36.0-255,66,117168,8,148920
15410,0.001305,172.31.36.0-255,66,117234,8,148920
15411,0.001308,172.217.194.0-255,1484,118718,8,148920
15412,0.001342,172.217.194.0-255,2902,121620,8,148920
15413,0.001345,172.31.36.0-255,66,121686,8,148920
15414,0.001351,172.217.194.0-255,5738,127424,8,148920
15415,0.001354,172.31.36.0-255,66,127490,8,148920
15416,0.001373,172.31.36.0-255,66,127556,8,148920
15417,0.001395,172.217.194.0-255,1484,129040,8,148920
15418,0.001413,172.31.36.0-255,66,129106,8,148920
15419,0.001442,172.217.194.0-255,1484,130590,8,148920
15420,0.001447,172.217.194.0-255,2902,133492,8,148920
15421,0.00145,172.31.36.0-255,66,133558,8,148920
15422,0.001479,172.217.194.0-255,5738,139296,8,148920
15423,0.001482,172.31.36.0-255,66,139362,8,148920
15424,0.001493,172.31.36.0-255,66,139428,8,148920
15425,0.001536,172.217.194.0-255,5738,145166,8,148920
15426,0.00154,172.31.36.0-255,66,145232,8,148920
15427,0.001583,172.31.36.0-255,66,145298,8,148920
15428,0.001591,172.31.36.0-255,66,145364,8,148920
15429,0.001616,172.31.36.0-255,66,145430,8,148920
15430,0.001658,172.31.36.0-255,66,145496,8,148920
15431,0.001662,172.217.194.0-255,105,145601,8,148920
15432,0.003502,172.31.36.0-255,66,145667,8,148920
15433,0.003527,172.31.36.0-255,105,145772,8,148920
15434,0.005618,172.217.194.0-255,66,145838,8,148920
15435,0.028176,172.31.36.0-255,172,146010,8,148920
15436,0.028207,172.31.36.0-255,1110,147120,8,148920
15437,0.028247,172.31.36.0-255,1428,148548,8,148920
15438,0.029702,104.244.42.0-255,66,148614,8,148920
15439,0.029774,104.244.42.0-255,66,148680,8,148920
15440,0.02983,104.244.42.0-255,66,148746,8,148920
15441,0.030363,104.244.42.0-255,108,148854,8,148920
15442,0.030388,172.31.36.0-255,66,148920,8,148920
15443,0.0,74.125.200.0-255,66,66,8,66
15444,0.0,74.125.24.0-255,146,146,8,331203
15445,2.8e-05,172.31.36.0-255,66,212,8,331203
15446,3.6e-05,74.125.24.0-255,1484,1696,8,331203
15447,4e-05,172.31.36.0-255,66,1762,8,331203
15448,4.5e-05,74.125.24.0-255,2902,4664,8,331203
15449,4.7e-05,172.31.36.0-255,66,4730,8,331203
15450,6.1e-05,74.125.24.0-255,7156,11886,8,331203
15451,6.4e-05,172.31.36.0-255,66,11952,8,331203
15452,7.1e-05,74.125.24.0-255,7156,19108,8,331203
15453,7.3e-05,172.31.36.0-255,66,19174,8,331203
15454,0.00011,74.125.24.0-255,6242,25416,8,331203
15455,0.000114,172.31.36.0-255,66,25482,8,331203
15456,0.000119,74.125.24.0-255,5379,30861,8,331203
15457,0.000121,172.31.36.0-255,66,30927,8,331203
15458,0.000515,74.125.24.0-255,1484,32411,8,331203
15459,0.000521,172.31.36.0-255,66,32477,8,331203
15460,0.000526,74.125.24.0-255,2902,35379,8,331203
15461,0.000529,172.31.36.0-255,66,35445,8,331203
15462,0.000556,74.125.24.0-255,5738,41183,8,331203
15463,0.000559,172.31.36.0-255,66,41249,8,331203
15464,0.000569,74.125.24.0-255,2902,44151,8,331203
15465,0.000571,172.31.36.0-255,66,44217,8,331203
15466,0.000605,74.125.24.0-255,6797,51014,8,331203
15467,0.000609,172.31.36.0-255,66,51080,8,331203
15468,0.000625,172.31.36.0-255,66,51146,8,331203
15469,0.000641,74.125.24.0-255,1484,52630,8,331203
15470,0.000644,172.31.36.0-255,66,52696,8,331203
15471,0.000669,74.125.24.0-255,2856,55552,8,331203
15472,0.000678,172.31.36.0-255,66,55618,8,331203
15473,0.000681,74.125.24.0-255,109,55727,8,331203
15474,0.000684,172.31.36.0-255,66,55793,8,331203
15475,0.00084,74.125.24.0-255,1484,57277,8,331203
15476,0.000844,74.125.24.0-255,1484,58761,8,331203
15477,0.000847,172.31.36.0-255,66,58827,8,331203
15478,0.000877,74.125.24.0-255,1484,60311,8,331203
15479,0.000884,74.125.24.0-255,5738,66049,8,331203
15480,0.000888,172.31.36.0-255,66,66115,8,331203
15481,0.000898,172.31.36.0-255,66,66181,8,331203
15482,0.000907,74.125.24.0-255,1484,67665,8,331203
15483,0.000931,74.125.24.0-255,1484,69149,8,331203
15484,0.000935,172.31.36.0-255,66,69215,8,331203
15485,0.00097,172.31.36.0-255,66,69281,8,331203
15486,0.001301,74.125.24.0-255,332,69613,8,331203
15487,0.001484,74.125.24.0-255,1484,71097,8,331203
15488,0.00149,172.31.36.0-255,66,71163,8,331203
15489,0.001496,74.125.24.0-255,2902,74065,8,331203
15490,0.001499,172.31.36.0-255,66,74131,8,331203
15491,0.001523,74.125.24.0-255,5738,79869,8,331203
15492,0.001526,172.31.36.0-255,66,79935,8,331203
15493,0.001538,74.125.24.0-255,4320,84255,8,331203
15494,0.00154,172.31.36.0-255,66,84321,8,331203
15495,0.001584,172.31.36.0-255,66,84387,8,331203
15496,0.001589,74.125.24.0-255,2902,87289,8,331203
15497,0.001591,172.31.36.0-255,66,87355,8,331203
15498,0.001619,74.125.24.0-255,5020,92375,8,331203
15499,0.001621,172.31.36.0-255,66,92441,8,331203
15500,0.001734,74.125.24.0-255,1484,93925,8,331203
15501,0.00174,74.125.24.0-255,2902,96827,8,331203
15502,0.001744,172.31.36.0-255,66,96893,8,331203
15503,0.00175,74.125.24.0-255,5738,102631,8,331203
15504,0.001753,172.31.36.0-255,66,102697,8,331203
15505,0.00178,172.31.36.0-255,66,102763,8,331203
15506,0.001812,74.125.24.0-255,4320,107083,8,331203
15507,0.001815,172.31.36.0-255,66,107149,8,331203
15508,0.001826,172.31.36.0-255,66,107215,8,331203
15509,0.001858,74.125.24.0-255,2184,109399,8,331203
15510,0.001861,172.31.36.0-255,66,109465,8,331203
15511,0.00201,74.125.24.0-255,1484,110949,8,331203
15512,0.002016,74.125.24.0-255,2902,113851,8,331203
15513,0.002021,172.31.36.0-255,66,113917,8,331203
15514,0.002026,74.125.24.0-255,2902,116819,8,331203
15515,0.002027,172.31.36.0-255,66,116885,8,331203
15516,0.002048,74.125.24.0-255,2902,119787,8,331203
15517,0.002051,172.31.36.0-255,66,119853,8,331203
15518,0.002061,74.125.24.0-255,7156,127009,8,331203
15519,0.002064,172.31.36.0-255,66,127075,8,331203
15520,0.002113,172.31.36.0-255,66,127141,8,331203
15521,0.002117,74.125.24.0-255,2184,129325,8,331203
15522,0.002119,172.31.36.0-255,66,129391,8,331203
15523,0.002272,74.125.24.0-255,1484,130875,8,331203
15524,0.002282,74.125.24.0-255,1484,132359,8,331203
15525,0.002284,172.31.36.0-255,66,132425,8,331203
15526,0.002304,74.125.24.0-255,1484,133909,8,331203
15527,0.002307,74.125.24.0-255,1484,135393,8,331203
15528,0.00231,172.31.36.0-255,66,135459,8,331203
15529,0.002334,74.125.24.0-255,4320,139779,8,331203
15530,0.002337,172.31.36.0-255,66,139845,8,331203
15531,0.002343,74.125.24.0-255,7156,147001,8,331203
15532,0.002345,172.31.36.0-255,66,147067,8,331203
15533,0.002374,74.125.24.0-255,5738,152805,8,331203
15534,0.002377,172.31.36.0-255,66,152871,8,331203
15535,0.002382,74.125.24.0-255,4320,157191,8,331203
15536,0.002384,172.31.36.0-255,66,157257,8,331203
15537,0.002413,74.125.24.0-255,4320,161577,8,331203
15538,0.002416,172.31.36.0-255,66,161643,8,331203
15539,0.00245,172.31.36.0-255,66,161709,8,331203
15540,0.004775,74.125.24.0-255,4320,166029,8,331203
15541,0.004778,172.31.36.0-255,66,166095,8,331203
15542,0.004802,74.125.24.0-255,1484,167579,8,331203
15543,0.007199,74.125.24.0-255,4320,171899,8,331203
15544,0.007205,172.31.36.0-255,66,171965,8,331203
15545,0.009597,74.125.24.0-255,5738,177703,8,331203
15546,0.009605,172.31.36.0-255,66,177769,8,331203
15547,0.011973,74.125.24.0-255,5738,183507,8,331203
15548,0.011984,172.31.36.0-255,66,183573,8,331203
15549,0.014358,74.125.24.0-255,5738,189311,8,331203
15550,0.014366,172.31.36.0-255,66,189377,8,331203
15551,0.016739,74.125.24.0-255,5738,195115,8,331203
15552,0.016747,172.31.36.0-255,66,195181,8,331203
15553,0.019149,74.125.24.0-255,5738,200919,8,331203
15554,0.019158,172.31.36.0-255,66,200985,8,331203
15555,0.021537,74.125.24.0-255,5738,206723,8,331203
15556,0.021545,172.31.36.0-255,66,206789,8,331203
15557,0.023896,74.125.24.0-255,5738,212527,8,331203
15558,0.023903,172.31.36.0-255,66,212593,8,331203
15559,0.026257,74.125.24.0-255,5738,218331,8,331203
15560,0.026265,172.31.36.0-255,66,218397,8,331203
15561,0.028615,74.125.24.0-255,5738,224135,8,331203
15562,0.028622,172.31.36.0-255,66,224201,8,331203
15563,0.031011,74.125.24.0-255,5738,229939,8,331203
15564,0.03102,172.31.36.0-255,66,230005,8,331203
15565,0.033398,74.125.24.0-255,5738,235743,8,331203
15566,0.033406,172.31.36.0-255,66,235809,8,331203
15567,0.035769,74.125.24.0-255,5738,241547,8,331203
15568,0.035777,172.31.36.0-255,66,241613,8,331203
15569,0.038113,74.125.24.0-255,5738,247351,8,331203
15570,0.03812,172.31.36.0-255,66,247417,8,331203
15571,0.038347,172.31.36.0-255,188,247605,8,331203
15572,0.038375,172.31.36.0-255,955,248560,8,331203
15573,0.038425,172.31.36.0-255,1514,250074,8,331203
15574,0.038427,172.31.36.0-255,1514,251588,8,331203
15575,0.038433,172.31.36.0-255,1514,253102,8,331203
15576,0.038434,172.31.36.0-255,1514,254616,8,331203
15577,0.038462,172.31.36.0-255,1431,256047,8,331203
15578,0.039893,104.244.42.0-255,66,256113,8,331203
15579,0.039932,104.244.42.0-255,66,256179,8,331203
15580,0.040022,104.244.42.0-255,66,256245,8,331203
15581,0.04007,104.244.42.0-255,66,256311,8,331203
15582,0.040499,74.125.24.0-255,5738,262049,8,331203
15583,0.040504,172.31.36.0-255,66,262115,8,331203
15584,0.042884,74.125.24.0-255,2902,265017,8,331203
15585,0.042905,172.31.36.0-255,66,265083,8,331203
15586,0.042924,74.125.24.0-255,2902,267985,8,331203
15587,0.042929,172.31.36.0-255,66,268051,8,331203
15588,0.045296,74.125.24.0-255,5738,273789,8,331203
15589,0.045302,172.31.36.0-255,66,273855,8,331203
15590,0.047656,74.125.24.0-255,4320,278175,8,331203
15591,0.047661,172.31.36.0-255,66,278241,8,331203
15592,0.047693,74.125.24.0-255,1484,279725,8,331203
15593,0.049997,74.125.24.0-255,4320,284045,8,331203
15594,0.050002,172.31.36.0-255,66,284111,8,331203
15595,0.052345,74.125.24.0-255,5738,289849,8,331203
15596,0.05235,172.31.36.0-255,66,289915,8,331203
15597,0.054732,74.125.24.0-255,5738,295653,8,331203
15598,0.054739,172.31.36.0-255,66,295719,8,331203
15599,0.057123,74.125.24.0-255,2902,298621,8,331203
15600,0.057129,172.31.36.0-255,66,298687,8,331203
15601,0.057162,74.125.24.0-255,2902,301589,8,331203
15602,0.057165,172.31.36.0-255,66,301655,8,331203
15603,0.059513,74.125.24.0-255,5738,307393,8,331203
15604,0.059519,172.31.36.0-255,66,307459,8,331203
15605,0.061864,74.125.24.0-255,2902,310361,8,331203
15606,0.061869,172.31.36.0-255,66,310427,8,331203
15607,0.061904,74.125.24.0-255,2902,313329,8,331203
15608,0.061907,172.31.36.0-255,66,313395,8,331203
15609,0.064225,74.125.24.0-255,2902,316297,8,331203
15610,0.06423,172.31.36.0-255,66,316363,8,331203
15611,0.064263,74.125.24.0-255,2902,319265,8,331203
15612,0.064266,172.31.36.0-255,66,319331,8,331203
15613,0.066579,74.125.24.0-255,2902,322233,8,331203
15614,0.066584,172.31.36.0-255,66,322299,8,331203
15615,0.066616,74.125.24.0-255,2902,325201,8,331203
15616,0.066619,172.31.36.0-255,66,325267,8,331203
15617,0.068937,74.125.24.0-255,2902,328169,8,331203
15618,0.068943,172.31.36.0-255,66,328235,8,331203
15619,0.068986,74.125.24.0-255,2902,331137,8,331203
15620,0.068989,172.31.36.0-255,66,331203,8,331203
15621,0.0,172.217.194.0-255,431,431,8,74733
15622,1.9e-05,172.217.194.0-255,1484,1915,8,74733
15623,3e-05,172.31.36.0-255,66,1981,8,74733
15624,3.9e-05,172.217.194.0-255,4320,6301,8,74733
15625,4.3e-05,172.31.36.0-255,66,6367,8,74733
15626,6e-05,172.217.194.0-255,7156,13523,8,74733
15627,6.4e-05,172.31.36.0-255,66,13589,8,74733
15628,0.000313,172.31.36.0-255,66,13655,8,74733
15629,0.000341,172.217.194.0-255,3572,17227,8,74733
15630,0.000344,172.31.36.0-255,66,17293,8,74733
15631,0.000846,172.217.194.0-255,2691,19984,8,74733
15632,0.000853,172.31.36.0-255,66,20050,8,74733
15633,0.002615,172.217.194.0-255,5738,25788,8,74733
15634,0.002622,172.31.36.0-255,66,25854,8,74733
15635,0.002696,172.217.194.0-255,2902,28756,8,74733
15636,0.002699,172.31.36.0-255,66,28822,8,74733
15637,0.002728,172.217.194.0-255,5738,34560,8,74733
15638,0.00305,172.217.194.0-255,2902,37462,8,74733
15639,0.003064,172.217.194.0-255,5738,43200,8,74733
15640,0.003078,172.217.194.0-255,5738,48938,8,74733
15641,0.003631,172.217.194.0-255,2902,51840,8,74733
15642,0.00365,172.217.194.0-255,5738,57578,8,74733
15643,0.003677,172.217.194.0-255,5738,63316,8,74733
15644,0.003776,172.31.36.0-255,66,63382,8,74733
15645,0.004217,172.31.36.0-255,66,63448,8,74733
15646,0.004731,172.217.194.0-255,2902,66350,8,74733
15647,0.004737,172.31.36.0-255,66,66416,8,74733
15648,0.004767,172.217.194.0-255,2902,69318,8,74733
15649,0.00477,172.31.36.0-255,66,69384,8,74733
15650,0.00648,172.31.36.0-255,66,69450,8,74733
15651,0.006829,172.31.36.0-255,66,69516,8,74733
15652,0.006884,172.31.36.0-255,66,69582,8,74733
15653,0.007603,172.31.36.0-255,66,69648,8,74733
15654,0.007662,172.31.36.0-255,66,69714,8,74733
15655,0.009483,172.31.36.0-255,66,69780,8,74733
15656,0.009538,172.31.36.0-255,66,69846,8,74733
15657,0.009811,172.31.36.0-255,66,69912,8,74733
15658,0.009875,172.31.36.0-255,66,69978,8,74733
15659,0.009902,172.217.194.0-255,4320,74298,8,74733
15660,0.009906,172.31.36.0-255,66,74364,8,74733
15661,0.010401,172.31.36.0-255,66,74430,8,74733
15662,0.010496,172.31.36.0-255,66,74496,8,74733
15663,0.014515,172.31.36.0-255,66,74562,8,74733
15664,0.016155,172.31.36.0-255,105,74667,8,74733
15665,0.023091,172.217.194.0-255,66,74733,8,74733
15666,0.0,74.125.24.0-255,150,150,8,253150
15667,2.4e-05,172.31.36.0-255,66,216,8,253150
15668,3.2e-05,74.125.24.0-255,1484,1700,8,253150
15669,3.7e-05,172.31.36.0-255,66,1766,8,253150
15670,5.1e-05,74.125.24.0-255,2902,4668,8,253150
15671,5.5e-05,172.31.36.0-255,66,4734,8,253150
15672,6.2e-05,74.125.24.0-255,4320,9054,8,253150
15673,6.5e-05,172.31.36.0-255,66,9120,8,253150
15674,9.8e-05,74.125.24.0-255,2902,12022,8,253150
15675,0.0001,172.31.36.0-255,66,12088,8,253150
15676,0.000105,74.125.24.0-255,2035,14123,8,253150
15677,0.000108,172.31.36.0-255,66,14189,8,253150
15678,0.000222,74.125.24.0-255,1484,15673,8,253150
15679,0.000225,172.31.36.0-255,66,15739,8,253150
15680,0.000231,74.125.24.0-255,2902,18641,8,253150
15681,0.000233,172.31.36.0-255,66,18707,8,253150
15682,0.000263,74.125.24.0-255,2902,21609,8,253150
15683,0.000265,172.31.36.0-255,66,21675,8,253150
15684,0.00029,74.125.24.0-255,2902,24577,8,253150
15685,0.000292,172.31.36.0-255,66,24643,8,253150
15686,0.000314,74.125.24.0-255,1484,26127,8,253150
15687,0.000316,172.31.36.0-255,66,26193,8,253150
15688,0.000342,74.125.24.0-255,5379,31572,8,253150
15689,0.000345,172.31.36.0-255,66,31638,8,253150
15690,0.001212,74.125.24.0-255,1484,33122,8,253150
15691,0.001219,172.31.36.0-255,66,33188,8,253150
15692,0.001229,74.125.24.0-255,2902,36090,8,253150
15693,0.001232,172.31.36.0-255,66,36156,8,253150
15694,0.001242,74.125.24.0-255,1484,37640,8,253150
15695,0.001244,172.31.36.0-255,66,37706,8,253150
15696,0.001248,74.125.24.0-255,1484,39190,8,253150
15697,0.00125,172.31.36.0-255,66,39256,8,253150
15698,0.001282,74.125.24.0-255,4320,43576,8,253150
15699,0.001284,172.31.36.0-255,66,43642,8,253150
15700,0.001291,74.125.24.0-255,5379,49021,8,253150
15701,0.001294,172.31.36.0-255,66,49087,8,253150
15702,0.001322,74.125.24.0-255,5738,54825,8,253150
15703,0.001324,172.31.36.0-255,66,54891,8,253150
15704,0.001327,74.125.24.0-255,1484,56375,8,253150
15705,0.001354,74.125.24.0-255,1484,57859,8,253150
15706,0.001356,172.31.36.0-255,66,57925,8,253150
15707,0.001389,74.125.24.0-255,5738,63663,8,253150
15708,0.001392,172.31.36.0-255,66,63729,8,253150
15709,0.001419,74.125.24.0-255,2855,66584,8,253150
15710,0.001423,172.31.36.0-255,66,66650,8,253150
15711,0.001775,74.125.24.0-255,342,66992,8,253150
15712,0.002243,74.125.24.0-255,1484,68476,8,253150
15713,0.002247,172.31.36.0-255,66,68542,8,253150
15714,0.002254,74.125.24.0-255,2902,71444,8,253150
15715,0.002257,172.31.36.0-255,66,71510,8,253150
15716,0.002281,74.125.24.0-255,4320,75830,8,253150
15717,0.002284,172.31.36.0-255,66,75896,8,253150
15718,0.002312,74.125.24.0-255,1484,77380,8,253150
15719,0.002319,74.125.24.0-255,7156,84536,8,253150
15720,0.002322,172.31.36.0-255,66,84602,8,253150
15721,0.002325,74.125.24.0-255,1484,86086,8,253150
15722,0.002351,74.125.24.0-255,7156,93242,8,253150
15723,0.002354,172.31.36.0-255,66,93308,8,253150
15724,0.002366,172.31.36.0-255,66,93374,8,253150
15725,0.002618,74.125.24.0-255,1484,94858,8,253150
15726,0.002623,74.125.24.0-255,2902,97760,8,253150
15727,0.002626,172.31.36.0-255,66,97826,8,253150
15728,0.002629,74.125.24.0-255,1484,99310,8,253150
15729,0.002658,74.125.24.0-255,4320,103630,8,253150
15730,0.00266,172.31.36.0-255,66,103696,8,253150
15731,0.002663,74.125.24.0-255,1484,105180,8,253150
15732,0.005274,74.125.24.0-255,4320,109500,8,253150
15733,0.00528,172.31.36.0-255,66,109566,8,253150
15734,0.007936,74.125.24.0-255,5738,115304,8,253150
15735,0.007943,172.31.36.0-255,66,115370,8,253150
15736,0.010562,74.125.24.0-255,5738,121108,8,253150
15737,0.010571,172.31.36.0-255,66,121174,8,253150
15738,0.013195,74.125.24.0-255,5738,126912,8,253150
15739,0.013204,172.31.36.0-255,66,126978,8,253150
15740,0.015819,74.125.24.0-255,5738,132716,8,253150
15741,0.015831,172.31.36.0-255,66,132782,8,253150
15742,0.018442,74.125.24.0-255,5738,138520,8,253150
15743,0.01845,172.31.36.0-255,66,138586,8,253150
15744,0.021085,74.125.24.0-255,5738,144324,8,253150
15745,0.021092,172.31.36.0-255,66,144390,8,253150
15746,0.023702,74.125.24.0-255,5738,150128,8,253150
15747,0.023711,172.31.36.0-255,66,150194,8,253150
15748,0.026304,74.125.24.0-255,5738,155932,8,253150
15749,0.026311,172.31.36.0-255,66,155998,8,253150
15750,0.028056,172.31.36.0-255,172,156170,8,253150
15751,0.028089,172.31.36.0-255,1112,157282,8,253150
15752,0.028147,172.31.36.0-255,1514,158796,8,253150
15753,0.028149,172.31.36.0-255,1292,160088,8,253150
15754,0.028922,74.125.24.0-255,5738,165826,8,253150
15755,0.028929,172.31.36.0-255,66,165892,8,253150
15756,0.029633,104.244.42.0-255,66,165958,8,253150
15757,0.029641,104.244.42.0-255,66,166024,8,253150
15758,0.029716,104.244.42.0-255,66,166090,8,253150
15759,0.031543,74.125.24.0-255,5738,171828,8,253150
15760,0.031555,172.31.36.0-255,66,171894,8,253150
15761,0.034168,74.125.24.0-255,5738,177632,8,253150
15762,0.034174,172.31.36.0-255,66,177698,8,253150
15763,0.036778,74.125.24.0-255,5738,183436,8,253150
15764,0.036785,172.31.36.0-255,66,183502,8,253150
15765,0.039385,74.125.24.0-255,5738,189240,8,253150
15766,0.039393,172.31.36.0-255,66,189306,8,253150
15767,0.041974,74.125.24.0-255,5738,195044,8,253150
15768,0.041984,172.31.36.0-255,66,195110,8,253150
15769,0.044607,74.125.24.0-255,5738,200848,8,253150
15770,0.044613,172.31.36.0-255,66,200914,8,253150
15771,0.04725,74.125.24.0-255,5738,206652,8,253150
15772,0.04726,172.31.36.0-255,66,206718,8,253150
15773,0.049853,74.125.24.0-255,5738,212456,8,253150
15774,0.04986,172.31.36.0-255,66,212522,8,253150
15775,0.052515,74.125.24.0-255,5738,218260,8,253150
15776,0.052521,172.31.36.0-255,66,218326,8,253150
15777,0.055157,74.125.24.0-255,5738,224064,8,253150
15778,0.055164,172.31.36.0-255,66,224130,8,253150
15779,0.057787,74.125.24.0-255,5738,229868,8,253150
15780,0.057793,172.31.36.0-255,66,229934,8,253150
15781,0.060403,74.125.24.0-255,5738,235672,8,253150
15782,0.060409,172.31.36.0-255,66,235738,8,253150
15783,0.063036,74.125.24.0-255,5738,241476,8,253150
15784,0.06305,172.31.36.0-255,66,241542,8,253150
15785,0.065746,74.125.24.0-255,5738,247280,8,253150
15786,0.065752,172.31.36.0-255,66,247346,8,253150
15787,0.068361,74.125.24.0-255,5738,253084,8,253150
15788,0.068369,172.31.36.0-255,66,253150,8,253150
15789,0.0,74.125.68.0-255,298,298,8,366674
15790,3.3e-05,172.31.36.0-255,66,364,8,366674
15791,4e-05,74.125.68.0-255,1484,1848,8,366674
15792,4.4e-05,172.31.36.0-255,66,1914,8,366674
15793,5e-05,74.125.68.0-255,2902,4816,8,366674
15794,5.3e-05,172.31.36.0-255,66,4882,8,366674
15795,6.1e-05,74.125.68.0-255,5738,10620,8,366674
15796,6.3e-05,172.31.36.0-255,66,10686,8,366674
15797,8.9e-05,74.125.68.0-255,3260,13946,8,366674
15798,9.2e-05,172.31.36.0-255,66,14012,8,366674
15799,9.8e-05,74.125.68.0-255,4320,18332,8,366674
15800,0.0001,172.31.36.0-255,66,18398,8,366674
15801,0.000127,74.125.68.0-255,2902,21300,8,366674
15802,0.00013,172.31.36.0-255,66,21366,8,366674
15803,0.000167,74.125.68.0-255,7156,28522,8,366674
15804,0.000171,172.31.36.0-255,66,28588,8,366674
15805,0.000189,74.125.68.0-255,2543,31131,8,366674
15806,0.000192,172.31.36.0-255,66,31197,8,366674
15807,0.00021,74.125.68.0-255,2902,34099,8,366674
15808,0.000213,172.31.36.0-255,66,34165,8,366674
15809,0.000229,74.125.68.0-255,2902,37067,8,366674
15810,0.000231,172.31.36.0-255,66,37133,8,366674
15811,0.000235,74.125.68.0-255,1484,38617,8,366674
15812,0.000237,172.31.36.0-255,66,38683,8,366674
15813,0.000258,74.125.68.0-255,2902,41585,8,366674
15814,0.00026,172.31.36.0-255,66,41651,8,366674
15815,0.000282,74.125.68.0-255,1484,43135,8,366674
15816,0.000284,172.31.36.0-255,66,43201,8,366674
15817,0.000308,74.125.68.0-255,5379,48580,8,366674
15818,0.000311,172.31.36.0-255,66,48646,8,366674
15819,0.000705,74.125.68.0-255,1484,50130,8,366674
15820,0.000711,172.31.36.0-255,66,50196,8,366674
15821,0.000718,74.125.68.0-255,2902,53098,8,366674
15822,0.000721,172.31.36.0-255,66,53164,8,366674
15823,0.000727,74.125.68.0-255,4320,57484,8,366674
15824,0.000729,172.31.36.0-255,66,57550,8,366674
15825,0.000754,74.125.68.0-255,1484,59034,8,366674
15826,0.00076,74.125.68.0-255,2902,61936,8,366674
15827,0.000762,172.31.36.0-255,66,62002,8,366674
15828,0.000767,74.125.68.0-255,3961,65963,8,366674
15829,0.000769,172.31.36.0-255,66,66029,8,366674
15830,0.000811,74.125.68.0-255,1484,67513,8,366674
15831,0.000815,74.125.68.0-255,1484,68997,8,366674
15832,0.000818,172.31.36.0-255,66,69063,8,366674
15833,0.000837,74.125.68.0-255,1484,70547,8,366674
15834,0.000842,74.125.68.0-255,2902,73449,8,366674
15835,0.000846,74.125.68.0-255,4320,77769,8,366674
15836,0.000847,172.31.36.0-255,66,77835,8,366674
15837,0.000851,172.31.36.0-255,66,77901,8,366674
15838,0.000906,74.125.68.0-255,2902,80803,8,366674
15839,0.00091,172.31.36.0-255,66,80869,8,366674
15840,0.000934,74.125.68.0-255,6797,87666,8,366674
15841,0.000938,172.31.36.0-255,66,87732,8,366674
15842,0.000944,74.125.68.0-255,5738,93470,8,366674
15843,0.000947,172.31.36.0-255,66,93536,8,366674
15844,0.000953,74.125.68.0-255,5738,99274,8,366674
15845,0.000955,172.31.36.0-255,66,99340,8,366674
15846,0.000975,74.125.68.0-255,1125,100465,8,366674
15847,0.000988,74.125.68.0-255,1484,101949,8,366674
15848,0.000992,172.31.36.0-255,66,102015,8,366674
15849,0.001013,74.125.68.0-255,3484,105499,8,366674
15850,0.001016,172.31.36.0-255,66,105565,8,366674
15851,0.001022,74.125.68.0-255,5738,111303,8,366674
15852,0.001024,172.31.36.0-255,66,111369,8,366674
15853,0.001061,74.125.68.0-255,2902,114271,8,366674
15854,0.001065,172.31.36.0-255,66,114337,8,366674
15855,0.001087,74.125.68.0-255,3410,117747,8,366674
15856,0.00109,172.31.36.0-255,66,117813,8,366674
15857,0.001093,74.125.68.0-255,1484,119297,8,366674
15858,0.001123,74.125.68.0-255,2902,122199,8,366674
15859,0.001128,172.31.36.0-255,66,122265,8,366674
15860,0.001147,74.125.68.0-255,1484,123749,8,366674
15861,0.001162,74.125.68.0-255,4320,128069,8,366674
15862,0.001166,172.31.36.0-255,66,128135,8,366674
15863,0.001191,74.125.68.0-255,7156,135291,8,366674
15864,0.001195,172.31.36.0-255,66,135357,8,366674
15865,0.001199,74.125.68.0-255,1484,136841,8,366674
15866,0.001224,172.31.36.0-255,66,136907,8,366674
15867,0.001243,74.125.68.0-255,4320,141227,8,366674
15868,0.001247,172.31.36.0-255,66,141293,8,366674
15869,0.001252,74.125.68.0-255,2184,143477,8,366674
15870,0.001254,172.31.36.0-255,66,143543,8,366674
15871,0.001393,74.125.68.0-255,1484,145027,8,366674
15872,0.0014,74.125.68.0-255,2902,147929,8,366674
15873,0.001404,172.31.36.0-255,66,147995,8,366674
15874,0.001408,74.125.68.0-255,1484,149479,8,366674
15875,0.001431,74.125.68.0-255,4320,153799,8,366674
15876,0.001435,172.31.36.0-255,66,153865,8,366674
15877,0.001464,172.31.36.0-255,66,153931,8,366674
15878,0.001496,172.31.36.0-255,66,153997,8,366674
15879,0.001722,74.125.68.0-255,1484,155481,8,366674
15880,0.00174,74.125.68.0-255,2902,158383,8,366674
15881,0.001745,172.31.36.0-255,66,158449,8,366674
15882,0.001749,74.125.68.0-255,1484,159933,8,366674
15883,0.001783,74.125.68.0-255,4320,164253,8,366674
15884,0.001787,172.31.36.0-255,66,164319,8,366674
15885,0.001795,74.125.68.0-255,7156,171475,8,366674
15886,0.001797,172.31.36.0-255,66,171541,8,366674
15887,0.00183,172.31.36.0-255,66,171607,8,366674
15888,0.001848,74.125.68.0-255,1484,173091,8,366674
15889,0.001853,74.125.68.0-255,2184,175275,8,366674
15890,0.001855,172.31.36.0-255,66,175341,8,366674
15891,0.002039,74.125.68.0-255,1484,176825,8,366674
15892,0.002046,74.125.68.0-255,2902,179727,8,366674
15893,0.00205,172.31.36.0-255,66,179793,8,366674
15894,0.002058,74.125.68.0-255,5738,185531,8,366674
15895,0.00206,172.31.36.0-255,66,185597,8,366674
15896,0.002063,74.125.68.0-255,1484,187081,8,366674
15897,0.002085,74.125.68.0-255,5738,192819,8,366674
15898,0.002088,172.31.36.0-255,66,192885,8,366674
15899,0.002108,74.125.68.0-255,5738,198623,8,366674
15900,0.00211,172.31.36.0-255,66,198689,8,366674
15901,0.002142,74.125.68.0-255,5738,204427,8,366674
15902,0.002146,172.31.36.0-255,66,204493,8,366674
15903,0.00217,74.125.68.0-255,5020,209513,8,366674
15904,0.002173,172.31.36.0-255,66,209579,8,366674
15905,0.002262,74.125.68.0-255,1484,211063,8,366674
15906,0.002289,74.125.68.0-255,2902,213965,8,366674
15907,0.002293,172.31.36.0-255,66,214031,8,366674
15908,0.0023,74.125.68.0-255,5738,219769,8,366674
15909,0.002303,172.31.36.0-255,66,219835,8,366674
15910,0.002341,74.125.68.0-255,1484,221319,8,366674
15911,0.002363,74.125.68.0-255,5738,227057,8,366674
15912,0.002366,172.31.36.0-255,66,227123,8,366674
15913,0.002377,172.31.36.0-255,66,227189,8,366674
15914,0.002384,74.125.68.0-255,7156,234345,8,366674
15915,0.002387,172.31.36.0-255,66,234411,8,366674
15916,0.00239,74.125.68.0-255,766,235177,8,366674
15917,0.002405,74.125.68.0-255,5738,240915,8,366674
15918,0.002408,172.31.36.0-255,66,240981,8,366674
15919,0.002435,74.125.68.0-255,4320,245301,8,366674
15920,0.002438,172.31.36.0-255,66,245367,8,366674
15921,0.002444,74.125.68.0-255,4320,249687,8,366674
15922,0.002446,172.31.36.0-255,66,249753,8,366674
15923,0.004752,74.125.68.0-255,2902,252655,8,366674
15924,0.004759,172.31.36.0-255,66,252721,8,366674
15925,0.004779,74.125.68.0-255,2902,255623,8,366674
15926,0.004782,172.31.36.0-255,66,255689,8,366674
15927,0.007089,74.125.68.0-255,5738,261427,8,366674
15928,0.007095,172.31.36.0-255,66,261493,8,366674
15929,0.009431,74.125.68.0-255,5738,267231,8,366674
15930,0.009441,172.31.36.0-255,66,267297,8,366674
15931,0.011772,74.125.68.0-255,5738,273035,8,366674
15932,0.011782,172.31.36.0-255,66,273101,8,366674
15933,0.014103,74.125.68.0-255,5738,278839,8,366674
15934,0.014112,172.31.36.0-255,66,278905,8,366674
15935,0.016439,74.125.68.0-255,5738,284643,8,366674
15936,0.016445,172.31.36.0-255,66,284709,8,366674
15937,0.018759,74.125.68.0-255,5738,290447,8,366674
15938,0.018767,172.31.36.0-255,66,290513,8,366674
15939,0.0211,74.125.68.0-255,5738,296251,8,366674
15940,0.021108,172.31.36.0-255,66,296317,8,366674
15941,0.023431,74.125.68.0-255,5738,302055,8,366674
15942,0.023438,172.31.36.0-255,66,302121,8,366674
15943,0.025786,74.125.68.0-255,5738,307859,8,366674
15944,0.025793,172.31.36.0-255,66,307925,8,366674
15945,0.028104,74.125.68.0-255,5738,313663,8,366674
15946,0.028111,172.31.36.0-255,66,313729,8,366674
15947,0.030431,74.125.68.0-255,5738,319467,8,366674
15948,0.030439,172.31.36.0-255,66,319533,8,366674
15949,0.032765,74.125.68.0-255,5738,325271,8,366674
15950,0.032772,172.31.36.0-255,66,325337,8,366674
15951,0.035092,74.125.68.0-255,5738,331075,8,366674
15952,0.035099,172.31.36.0-255,66,331141,8,366674
15953,0.037427,74.125.68.0-255,4320,335461,8,366674
15954,0.037435,172.31.36.0-255,66,335527,8,366674
15955,0.037469,74.125.68.0-255,1484,337011,8,366674
15956,0.039782,74.125.68.0-255,4320,341331,8,366674
15957,0.039794,172.31.36.0-255,66,341397,8,366674
15958,0.041883,172.31.36.0-255,188,341585,8,366674
15959,0.041914,172.31.36.0-255,955,342540,8,366674
15960,0.041958,172.31.36.0-255,1514,344054,8,366674
15961,0.04196,172.31.36.0-255,1514,345568,8,366674
15962,0.041983,172.31.36.0-255,77,345645,8,366674
15963,0.042112,74.125.68.0-255,5738,351383,8,366674
15964,0.042118,172.31.36.0-255,66,351449,8,366674
15965,0.043466,104.244.42.0-255,66,351515,8,366674
15966,0.0435,104.244.42.0-255,66,351581,8,366674
15967,0.043544,104.244.42.0-255,66,351647,8,366674
15968,0.043546,104.244.42.0-255,66,351713,8,366674
15969,0.044437,74.125.68.0-255,2902,354615,8,366674
15970,0.044442,172.31.36.0-255,66,354681,8,366674
15971,0.044476,74.125.68.0-255,2902,357583,8,366674
15972,0.04448,172.31.36.0-255,66,357649,8,366674
15973,0.046802,74.125.68.0-255,5738,363387,8,366674
15974,0.046806,172.31.36.0-255,66,363453,8,366674
15975,0.049133,74.125.68.0-255,2984,366437,8,366674
15976,0.049138,172.31.36.0-255,66,366503,8,366674
15977,0.049282,172.31.36.0-255,105,366608,8,366674
15978,0.051555,74.125.68.0-255,66,366674,8,366674
15979,0.0,172.217.194.0-255,153,153,8,253048
15980,3.4e-05,172.31.36.0-255,66,219,8,253048
15981,4.1e-05,172.217.194.0-255,1484,1703,8,253048
15982,4.5e-05,172.31.36.0-255,66,1769,8,253048
15983,5e-05,172.217.194.0-255,2902,4671,8,253048
15984,5.2e-05,172.31.36.0-255,66,4737,8,253048
15985,6e-05,172.217.194.0-255,7156,11893,8,253048
15986,6.2e-05,172.31.36.0-255,66,11959,8,253048
15987,9.9e-05,172.31.36.0-255,66,12025,8,253048
15988,0.000105,172.217.194.0-255,5738,17763,8,253048
15989,0.000107,172.31.36.0-255,66,17829,8,253048
15990,0.000131,172.217.194.0-255,2902,20731,8,253048
15991,0.000134,172.31.36.0-255,66,20797,8,253048
15992,0.000138,172.217.194.0-255,2543,23340,8,253048
15993,0.000139,172.31.36.0-255,66,23406,8,253048
15994,0.000166,172.217.194.0-255,2902,26308,8,253048
15995,0.000171,172.31.36.0-255,66,26374,8,253048
15996,0.00019,172.217.194.0-255,4320,30694,8,253048
15997,0.000193,172.31.36.0-255,66,30760,8,253048
15998,0.000195,172.217.194.0-255,1484,32244,8,253048
15999,0.000198,172.31.36.0-255,66,32310,8,253048
16000,0.000222,172.217.194.0-255,7156,39466,8,253048
16001,0.000224,172.31.36.0-255,66,39532,8,253048
16002,0.000227,172.217.194.0-255,1125,40657,8,253048
16003,0.000229,172.31.36.0-255,66,40723,8,253048
16004,0.000551,172.217.194.0-255,1484,42207,8,253048
16005,0.000556,172.31.36.0-255,66,42273,8,253048
16006,0.000561,172.217.194.0-255,2902,45175,8,253048
16007,0.000564,172.31.36.0-255,66,45241,8,253048
16008,0.000592,172.217.194.0-255,5738,50979,8,253048
16009,0.000595,172.31.36.0-255,66,51045,8,253048
16010,0.000634,172.217.194.0-255,2902,53947,8,253048
16011,0.000637,172.31.36.0-255,66,54013,8,253048
16012,0.00066,172.217.194.0-255,4542,58555,8,253048
16013,0.000662,172.31.36.0-255,66,58621,8,253048
16014,0.000696,172.217.194.0-255,1484,60105,8,253048
16015,0.000701,172.217.194.0-255,2902,63007,8,253048
16016,0.000704,172.31.36.0-255,66,63073,8,253048
16017,0.000719,172.217.194.0-255,1484,64557,8,253048
16018,0.000736,172.217.194.0-255,4320,68877,8,253048
16019,0.000739,172.31.36.0-255,66,68943,8,253048
16020,0.000742,172.217.194.0-255,1484,70427,8,253048
16021,0.000768,172.31.36.0-255,66,70493,8,253048
16022,0.00081,172.31.36.0-255,66,70559,8,253048
16023,0.0016,172.217.194.0-255,1484,72043,8,253048
16024,0.001612,172.217.194.0-255,2902,74945,8,253048
16025,0.001616,172.31.36.0-255,66,75011,8,253048
16026,0.001623,172.217.194.0-255,5738,80749,8,253048
16027,0.001625,172.31.36.0-255,66,80815,8,253048
16028,0.00164,172.217.194.0-255,2902,83717,8,253048
16029,0.001642,172.31.36.0-255,66,83783,8,253048
16030,0.001665,172.31.36.0-255,66,83849,8,253048
16031,0.00167,172.217.194.0-255,4320,88169,8,253048
16032,0.001672,172.31.36.0-255,66,88235,8,253048
16033,0.001697,172.217.194.0-255,4320,92555,8,253048
16034,0.001699,172.31.36.0-255,66,92621,8,253048
16035,0.001717,172.217.194.0-255,2184,94805,8,253048
16036,0.001719,172.31.36.0-255,66,94871,8,253048
16037,0.004277,172.217.194.0-255,5738,100609,8,253048
16038,0.00428,172.31.36.0-255,66,100675,8,253048
16039,0.006835,172.217.194.0-255,5738,106413,8,253048
16040,0.006841,172.31.36.0-255,66,106479,8,253048
16041,0.009412,172.217.194.0-255,5738,112217,8,253048
16042,0.00942,172.31.36.0-255,66,112283,8,253048
16043,0.011979,172.217.194.0-255,5738,118021,8,253048
16044,0.011986,172.31.36.0-255,66,118087,8,253048
16045,0.014544,172.217.194.0-255,5738,123825,8,253048
16046,0.014552,172.31.36.0-255,66,123891,8,253048
16047,0.017096,172.217.194.0-255,5738,129629,8,253048
16048,0.017102,172.31.36.0-255,66,129695,8,253048
16049,0.01967,172.217.194.0-255,5738,135433,8,253048
16050,0.019679,172.31.36.0-255,66,135499,8,253048
16051,0.022233,172.217.194.0-255,5738,141237,8,253048
16052,0.02224,172.31.36.0-255,66,141303,8,253048
16053,0.0248,172.217.194.0-255,5738,147041,8,253048
16054,0.024807,172.31.36.0-255,66,147107,8,253048
16055,0.027396,172.217.194.0-255,5738,152845,8,253048
16056,0.027404,172.31.36.0-255,66,152911,8,253048
16057,0.029959,172.217.194.0-255,5738,158649,8,253048
16058,0.029966,172.31.36.0-255,66,158715,8,253048
16059,0.032514,172.217.194.0-255,5738,164453,8,253048
16060,0.032519,172.31.36.0-255,66,164519,8,253048
16061,0.032729,172.31.36.0-255,172,164691,8,253048
16062,0.032758,172.31.36.0-255,1111,165802,8,253048
16063,0.032808,172.31.36.0-255,1514,167316,8,253048
16064,0.03281,172.31.36.0-255,1514,168830,8,253048
16065,0.032812,172.31.36.0-255,1514,170344,8,253048
16066,0.032812,172.31.36.0-255,1514,171858,8,253048
16067,0.032814,172.31.36.0-255,956,172814,8,253048
16068,0.034315,104.244.42.0-255,66,172880,8,253048
16069,0.034323,104.244.42.0-255,66,172946,8,253048
16070,0.034396,104.244.42.0-255,66,173012,8,253048
16071,0.034399,104.244.42.0-255,66,173078,8,253048
16072,0.035058,172.217.194.0-255,5738,178816,8,253048
16073,0.035062,172.31.36.0-255,66,178882,8,253048
16074,0.037629,172.217.194.0-255,4320,183202,8,253048
16075,0.037635,172.31.36.0-255,66,183268,8,253048
16076,0.037667,172.217.194.0-255,1484,184752,8,253048
16077,0.040171,172.217.194.0-255,4320,189072,8,253048
16078,0.040176,172.31.36.0-255,66,189138,8,253048
16079,0.042755,172.217.194.0-255,5738,194876,8,253048
16080,0.04276,172.31.36.0-255,66,194942,8,253048
16081,0.045323,172.217.194.0-255,5738,200680,8,253048
16082,0.045329,172.31.36.0-255,66,200746,8,253048
16083,0.047881,172.217.194.0-255,5738,206484,8,253048
16084,0.047886,172.31.36.0-255,66,206550,8,253048
16085,0.050423,172.217.194.0-255,5738,212288,8,253048
16086,0.050428,172.31.36.0-255,66,212354,8,253048
16087,0.053,172.217.194.0-255,5738,218092,8,253048
16088,0.053006,172.31.36.0-255,66,218158,8,253048
16089,0.055705,172.217.194.0-255,5738,223896,8,253048
16090,0.05571,172.31.36.0-255,66,223962,8,253048
16091,0.05828,172.217.194.0-255,5738,229700,8,253048
16092,0.058286,172.31.36.0-255,66,229766,8,253048
16093,0.060842,172.217.194.0-255,5738,235504,8,253048
16094,0.060847,172.31.36.0-255,66,235570,8,253048
16095,0.063401,172.217.194.0-255,1484,237054,8,253048
16096,0.063427,172.217.194.0-255,4320,241374,8,253048
16097,0.063432,172.31.36.0-255,66,241440,8,253048
16098,0.065998,172.217.194.0-255,5738,247178,8,253048
16099,0.066003,172.31.36.0-255,66,247244,8,253048
16100,0.068555,172.217.194.0-255,5738,252982,8,253048
16101,0.06856,172.31.36.0-255,66,253048,8,253048
16102,0.0,74.125.200.0-255,66,66,8,66
16103,0.0,74.125.24.0-255,153,153,8,170659
16104,3.8e-05,172.31.36.0-255,66,219,8,170659
16105,4.4e-05,74.125.24.0-255,1484,1703,8,170659
16106,4.8e-05,172.31.36.0-255,66,1769,8,170659
16107,5.3e-05,74.125.24.0-255,2902,4671,8,170659
16108,5.6e-05,172.31.36.0-255,66,4737,8,170659
16109,6e-05,74.125.24.0-255,2902,7639,8,170659
16110,6.2e-05,172.31.36.0-255,66,7705,8,170659
16111,9.4e-05,74.125.24.0-255,7156,14861,8,170659
16112,9.9e-05,172.31.36.0-255,66,14927,8,170659
16113,0.000108,74.125.24.0-255,683,15610,8,170659
16114,0.00011,172.31.36.0-255,66,15676,8,170659
16115,0.000133,172.31.36.0-255,66,15742,8,170659
16116,0.00015,74.125.24.0-255,1484,17226,8,170659
16117,0.000156,172.31.36.0-255,66,17292,8,170659
16118,0.000216,172.31.36.0-255,66,17358,8,170659
16119,0.000221,74.125.24.0-255,2184,19542,8,170659
16120,0.000224,172.31.36.0-255,66,19608,8,170659
16121,0.000235,172.31.36.0-255,66,19674,8,170659
16122,0.000272,74.125.24.0-255,7137,26811,8,170659
16123,0.000275,172.31.36.0-255,66,26877,8,170659
16124,0.000326,74.125.24.0-255,7156,34033,8,170659
16125,0.000331,172.31.36.0-255,66,34099,8,170659
16126,0.000343,172.31.36.0-255,66,34165,8,170659
16127,0.000368,74.125.24.0-255,7156,41321,8,170659
16128,0.000373,172.31.36.0-255,66,41387,8,170659
16129,0.000393,172.31.36.0-255,66,41453,8,170659
16130,0.000396,74.125.24.0-255,1047,42500,8,170659
16131,0.000654,74.125.24.0-255,1484,43984,8,170659
16132,0.000661,74.125.24.0-255,2902,46886,8,170659
16133,0.000668,172.31.36.0-255,66,46952,8,170659
16134,0.000688,74.125.24.0-255,5738,52690,8,170659
16135,0.000695,74.125.24.0-255,5738,58428,8,170659
16136,0.000698,74.125.24.0-255,1484,59912,8,170659
16137,0.000701,172.31.36.0-255,66,59978,8,170659
16138,0.000716,74.125.24.0-255,5738,65716,8,170659
16139,0.000732,172.31.36.0-255,66,65782,8,170659
16140,0.000751,172.31.36.0-255,66,65848,8,170659
16141,0.000879,74.125.24.0-255,1484,67332,8,170659
16142,0.000886,74.125.24.0-255,2902,70234,8,170659
16143,0.000892,74.125.24.0-255,4320,74554,8,170659
16144,0.000897,172.31.36.0-255,66,74620,8,170659
16145,0.00091,74.125.24.0-255,1484,76104,8,170659
16146,0.000914,74.125.24.0-255,1484,77588,8,170659
16147,0.000929,172.31.36.0-255,66,77654,8,170659
16148,0.000959,74.125.24.0-255,7156,84810,8,170659
16149,0.000966,172.31.36.0-255,66,84876,8,170659
16150,0.000977,74.125.24.0-255,1484,86360,8,170659
16151,0.000994,74.125.24.0-255,2184,88544,8,170659
16152,0.000999,172.31.36.0-255,66,88610,8,170659
16153,0.001192,74.125.24.0-255,1484,90094,8,170659
16154,0.001199,74.125.24.0-255,2902,92996,8,170659
16155,0.001204,172.31.36.0-255,66,93062,8,170659
16156,0.001209,74.125.24.0-255,2902,95964,8,170659
16157,0.001214,172.31.36.0-255,66,96030,8,170659
16158,0.001227,74.125.24.0-255,2902,98932,8,170659
16159,0.001239,172.31.36.0-255,66,98998,8,170659
16160,0.001242,74.125.24.0-255,2902,101900,8,170659
16161,0.001257,172.31.36.0-255,66,101966,8,170659
16162,0.001272,74.125.24.0-255,1484,103450,8,170659
16163,0.001275,172.31.36.0-255,66,103516,8,170659
16164,0.001285,74.125.24.0-255,2902,106418,8,170659
16165,0.001292,172.31.36.0-255,66,106484,8,170659
16166,0.001304,74.125.24.0-255,6438,112922,8,170659
16167,0.001309,172.31.36.0-255,66,112988,8,170659
16168,0.001804,74.125.24.0-255,1484,114472,8,170659
16169,0.001812,74.125.24.0-255,2902,117374,8,170659
16170,0.001817,172.31.36.0-255,66,117440,8,170659
16171,0.001824,74.125.24.0-255,5738,123178,8,170659
16172,0.001832,172.31.36.0-255,66,123244,8,170659
16173,0.001893,172.31.36.0-255,66,123310,8,170659
16174,0.001906,172.31.36.0-255,66,123376,8,170659
16175,0.001917,74.125.24.0-255,2184,125560,8,170659
16176,0.001923,172.31.36.0-255,66,125626,8,170659
16177,0.001969,74.125.24.0-255,1484,127110,8,170659
16178,0.001975,74.125.24.0-255,2902,130012,8,170659
16179,0.001985,172.31.36.0-255,66,130078,8,170659
16180,0.002007,74.125.24.0-255,5738,135816,8,170659
16181,0.00201,74.125.24.0-255,1484,137300,8,170659
16182,0.002015,74.125.24.0-255,4320,141620,8,170659
16183,0.002015,172.31.36.0-255,66,141686,8,170659
16184,0.00202,172.31.36.0-255,66,141752,8,170659
16185,0.002047,74.125.24.0-255,4320,146072,8,170659
16186,0.002054,74.125.24.0-255,5738,151810,8,170659
16187,0.002058,172.31.36.0-255,66,151876,8,170659
16188,0.002081,74.125.24.0-255,2902,154778,8,170659
16189,0.002087,172.31.36.0-255,66,154844,8,170659
16190,0.002137,172.31.36.0-255,66,154910,8,170659
16191,0.002141,172.31.36.0-255,66,154976,8,170659
16192,0.002161,74.125.24.0-255,1484,156460,8,170659
16193,0.002217,172.31.36.0-255,66,156526,8,170659
16194,0.002239,74.125.24.0-255,2902,159428,8,170659
16195,0.002244,172.31.36.0-255,66,159494,8,170659
16196,0.002246,74.125.24.0-255,6438,165932,8,170659
16197,0.002265,172.31.36.0-255,66,165998,8,170659
16198,0.002291,172.31.36.0-255,66,166064,8,170659
16199,0.002343,172.31.36.0-255,66,166130,8,170659
16200,0.002365,74.125.24.0-255,3154,169284,8,170659
16201,0.002368,74.125.24.0-255,105,169389,8,170659
16202,0.002371,172.31.36.0-255,66,169455,8,170659
16203,0.003073,172.31.36.0-255,101,169556,8,170659
16204,0.003824,172.31.36.0-255,105,169661,8,170659
16205,0.005417,74.125.24.0-255,66,169727,8,170659
16206,0.006135,74.125.24.0-255,66,169793,8,170659
16207,0.028926,172.31.36.0-255,172,169965,8,170659
16208,0.028964,172.31.36.0-255,562,170527,8,170659
16209,0.03048,104.244.42.0-255,66,170593,8,170659
16210,0.030502,104.244.42.0-255,66,170659,8,170659
16211,0.0,172.217.194.0-255,153,153,8,227878
16212,2.5e-05,172.31.36.0-255,66,219,8,227878
16213,3.2e-05,172.217.194.0-255,1484,1703,8,227878
16214,3.6e-05,172.31.36.0-255,66,1769,8,227878
16215,6.6e-05,172.217.194.0-255,2902,4671,8,227878
16216,7e-05,172.31.36.0-255,66,4737,8,227878
16217,7.6e-05,172.217.194.0-255,7156,11893,8,227878
16218,7.9e-05,172.31.36.0-255,66,11959,8,227878
16219,8.2e-05,172.217.194.0-255,1484,13443,8,227878
16220,8.4e-05,172.31.36.0-255,66,13509,8,227878
16221,0.000121,172.217.194.0-255,3526,17035,8,227878
16222,0.000125,172.31.36.0-255,66,17101,8,227878
16223,0.000132,172.217.194.0-255,7156,24257,8,227878
16224,0.000134,172.31.36.0-255,66,24323,8,227878
16225,0.000189,172.217.194.0-255,6797,31120,8,227878
16226,0.000193,172.31.36.0-255,66,31186,8,227878
16227,0.000197,172.217.194.0-255,1484,32670,8,227878
16228,0.000199,172.31.36.0-255,66,32736,8,227878
16229,0.000203,172.217.194.0-255,2902,35638,8,227878
16230,0.000213,172.31.36.0-255,66,35704,8,227878
16231,0.000221,172.217.194.0-255,5738,41442,8,227878
16232,0.000223,172.31.36.0-255,66,41508,8,227878
16233,0.00023,172.217.194.0-255,6797,48305,8,227878
16234,0.000232,172.31.36.0-255,66,48371,8,227878
16235,0.000239,172.217.194.0-255,7156,55527,8,227878
16236,0.000241,172.31.36.0-255,66,55593,8,227878
16237,0.000299,172.31.36.0-255,66,55659,8,227878
16238,0.000462,172.217.194.0-255,647,56306,8,227878
16239,0.000467,172.31.36.0-255,66,56372,8,227878
16240,0.000563,172.217.194.0-255,1484,57856,8,227878
16241,0.000566,172.31.36.0-255,66,57922,8,227878
16242,0.000572,172.217.194.0-255,2902,60824,8,227878
16243,0.00058,172.31.36.0-255,66,60890,8,227878
16244,0.000602,172.217.194.0-255,5738,66628,8,227878
16245,0.000605,172.31.36.0-255,66,66694,8,227878
16246,0.000627,172.217.194.0-255,6797,73491,8,227878
16247,0.00063,172.31.36.0-255,66,73557,8,227878
16248,0.000636,172.217.194.0-255,5738,79295,8,227878
16249,0.000638,172.31.36.0-255,66,79361,8,227878
16250,0.000666,172.217.194.0-255,1484,80845,8,227878
16251,0.000691,172.217.194.0-255,7156,88001,8,227878
16252,0.000695,172.31.36.0-255,66,88067,8,227878
16253,0.000721,172.217.194.0-255,2543,90610,8,227878
16254,0.000725,172.31.36.0-255,66,90676,8,227878
16255,0.001096,172.217.194.0-255,1484,92160,8,227878
16256,0.001102,172.217.194.0-255,2902,95062,8,227878
16257,0.001105,172.31.36.0-255,66,95128,8,227878
16258,0.00111,172.217.194.0-255,2902,98030,8,227878
16259,0.001112,172.31.36.0-255,66,98096,8,227878
16260,0.001145,172.217.194.0-255,2902,100998,8,227878
16261,0.001149,172.31.36.0-255,66,101064,8,227878
16262,0.001156,172.217.194.0-255,7156,108220,8,227878
16263,0.001158,172.31.36.0-255,66,108286,8,227878
16264,0.001174,172.31.36.0-255,66,108352,8,227878
16265,0.001202,172.217.194.0-255,5738,114090,8,227878
16266,0.001205,172.31.36.0-255,66,114156,8,227878
16267,0.001209,172.217.194.0-255,2184,116340,8,227878
16268,0.001211,172.31.36.0-255,66,116406,8,227878
16269,0.001214,172.217.194.0-255,1484,117890,8,227878
16270,0.001231,172.217.194.0-255,2902,120792,8,227878
16271,0.001233,172.31.36.0-255,66,120858,8,227878
16272,0.001243,172.217.194.0-255,4320,125178,8,227878
16273,0.001246,172.31.36.0-255,66,125244,8,227878
16274,0.001257,172.217.194.0-255,1484,126728,8,227878
16275,0.001289,172.31.36.0-255,66,126794,8,227878
16276,0.001296,172.217.194.0-255,7156,133950,8,227878
16277,0.001298,172.31.36.0-255,66,134016,8,227878
16278,0.001339,172.217.194.0-255,3602,137618,8,227878
16279,0.001342,172.31.36.0-255,66,137684,8,227878
16280,0.001391,172.217.194.0-255,1484,139168,8,227878
16281,0.001397,172.217.194.0-255,2902,142070,8,227878
16282,0.0014,172.31.36.0-255,66,142136,8,227878
16283,0.001404,172.217.194.0-255,1484,143620,8,227878
16284,0.001431,172.217.194.0-255,4320,147940,8,227878
16285,0.001434,172.31.36.0-255,66,148006,8,227878
16286,0.001442,172.217.194.0-255,7156,155162,8,227878
16287,0.001444,172.31.36.0-255,66,155228,8,227878
16288,0.00147,172.217.194.0-255,5738,160966,8,227878
16289,0.001474,172.31.36.0-255,66,161032,8,227878
16290,0.001486,172.217.194.0-255,1484,162516,8,227878
16291,0.001526,172.217.194.0-255,4320,166836,8,227878
16292,0.001527,172.31.36.0-255,66,166902,8,227878
16293,0.001531,172.31.36.0-255,66,166968,8,227878
16294,0.001559,172.217.194.0-255,7156,174124,8,227878
16295,0.001562,172.31.36.0-255,66,174190,8,227878
16296,0.001583,172.31.36.0-255,66,174256,8,227878
16297,0.001585,172.217.194.0-255,1484,175740,8,227878
16298,0.001599,172.217.194.0-255,3602,179342,8,227878
16299,0.001606,172.31.36.0-255,66,179408,8,227878
16300,0.001745,172.217.194.0-255,1484,180892,8,227878
16301,0.00175,172.217.194.0-255,2902,183794,8,227878
16302,0.001753,172.31.36.0-255,66,183860,8,227878
16303,0.001757,172.217.194.0-255,1484,185344,8,227878
16304,0.001779,172.217.194.0-255,4320,189664,8,227878
16305,0.001783,172.31.36.0-255,66,189730,8,227878
16306,0.001817,172.217.194.0-255,4320,194050,8,227878
16307,0.00182,172.31.36.0-255,66,194116,8,227878
16308,0.001863,172.31.36.0-255,66,194182,8,227878
16309,0.001875,172.31.36.0-255,66,194248,8,227878
16310,0.001878,172.217.194.0-255,2184,196432,8,227878
16311,0.001881,172.31.36.0-255,66,196498,8,227878
16312,0.001885,172.217.194.0-255,2902,199400,8,227878
16313,0.001887,172.31.36.0-255,66,199466,8,227878
16314,0.001892,172.217.194.0-255,4320,203786,8,227878
16315,0.001894,172.31.36.0-255,66,203852,8,227878
16316,0.001932,172.31.36.0-255,66,203918,8,227878
16317,0.001966,172.217.194.0-255,2902,206820,8,227878
16318,0.00197,172.31.36.0-255,66,206886,8,227878
16319,0.001998,172.31.36.0-255,66,206952,8,227878
16320,0.002024,172.31.36.0-255,66,207018,8,227878
16321,0.002028,172.217.194.0-255,2902,209920,8,227878
16322,0.00203,172.31.36.0-255,66,209986,8,227878
16323,0.002038,172.217.194.0-255,7156,217142,8,227878
16324,0.00204,172.31.36.0-255,66,217208,8,227878
16325,0.002094,172.31.36.0-255,66,217274,8,227878
16326,0.002101,172.217.194.0-255,5020,222294,8,227878
16327,0.002103,172.31.36.0-255,66,222360,8,227878
16328,0.002115,172.31.36.0-255,66,222426,8,227878
16329,0.002165,172.31.36.0-255,66,222492,8,227878
16330,0.002194,172.217.194.0-255,2902,225394,8,227878
16331,0.002197,172.31.36.0-255,66,225460,8,227878
16332,0.002211,172.31.36.0-255,66,225526,8,227878
16333,0.002235,172.31.36.0-255,66,225592,8,227878
16334,0.002238,172.217.194.0-255,105,225697,8,227878
16335,0.003704,172.31.36.0-255,66,225763,8,227878
16336,0.00373,172.31.36.0-255,105,225868,8,227878
16337,0.006313,172.217.194.0-255,66,225934,8,227878
16338,0.025093,172.31.36.0-255,172,226106,8,227878
16339,0.025122,172.31.36.0-255,1111,227217,8,227878
16340,0.025164,172.31.36.0-255,463,227680,8,227878
16341,0.026649,104.244.42.0-255,66,227746,8,227878
16342,0.026679,104.244.42.0-255,66,227812,8,227878
16343,0.026682,104.244.42.0-255,66,227878,8,227878
16344,0.0,74.125.24.0-255,153,153,8,318642
16345,1.5e-05,172.31.36.0-255,66,219,8,318642
16346,2.2e-05,74.125.24.0-255,1484,1703,8,318642
16347,2.7e-05,172.31.36.0-255,66,1769,8,318642
16348,4.1e-05,74.125.24.0-255,2902,4671,8,318642
16349,4.5e-05,172.31.36.0-255,66,4737,8,318642
16350,5.4e-05,74.125.24.0-255,7156,11893,8,318642
16351,5.7e-05,172.31.36.0-255,66,11959,8,318642
16352,6.1e-05,74.125.24.0-255,2075,14034,8,318642
16353,6.3e-05,172.31.36.0-255,66,14100,8,318642
16354,7.7e-05,172.31.36.0-255,66,14166,8,318642
16355,8.3e-05,74.125.24.0-255,5379,19545,8,318642
16356,8.7e-05,172.31.36.0-255,66,19611,8,318642
16357,0.000316,74.125.24.0-255,1484,21095,8,318642
16358,0.000322,172.31.36.0-255,66,21161,8,318642
16359,0.000328,74.125.24.0-255,2902,24063,8,318642
16360,0.00033,172.31.36.0-255,66,24129,8,318642
16361,0.000365,74.125.24.0-255,5738,29867,8,318642
16362,0.000368,172.31.36.0-255,66,29933,8,318642
16363,0.000391,74.125.24.0-255,4320,34253,8,318642
16364,0.000393,172.31.36.0-255,66,34319,8,318642
16365,0.000432,172.31.36.0-255,66,34385,8,318642
16366,0.000442,172.31.36.0-255,66,34451,8,318642
16367,0.000445,74.125.24.0-255,1395,35846,8,318642
16368,0.000447,172.31.36.0-255,66,35912,8,318642
16369,0.000472,74.125.24.0-255,134,36046,8,318642
16370,0.000474,172.31.36.0-255,66,36112,8,318642
16371,0.000565,74.125.24.0-255,1484,37596,8,318642
16372,0.000569,172.31.36.0-255,66,37662,8,318642
16373,0.000589,74.125.24.0-255,2902,40564,8,318642
16374,0.000613,74.125.24.0-255,5738,46302,8,318642
16375,0.000617,172.31.36.0-255,66,46368,8,318642
16376,0.000626,74.125.24.0-255,1484,47852,8,318642
16377,0.000631,172.31.36.0-255,66,47918,8,318642
16378,0.000651,74.125.24.0-255,6797,54715,8,318642
16379,0.000684,74.125.24.0-255,2902,57617,8,318642
16380,0.000698,74.125.24.0-255,4221,61838,8,318642
16381,0.000716,172.31.36.0-255,66,61904,8,318642
16382,0.001175,74.125.24.0-255,1484,63388,8,318642
16383,0.001199,74.125.24.0-255,2902,66290,8,318642
16384,0.001203,172.31.36.0-255,66,66356,8,318642
16385,0.00121,74.125.24.0-255,4320,70676,8,318642
16386,0.00123,74.125.24.0-255,1484,72160,8,318642
16387,0.001263,74.125.24.0-255,1484,73644,8,318642
16388,0.001274,172.31.36.0-255,66,73710,8,318642
16389,0.00128,172.31.36.0-255,66,73776,8,318642
16390,0.001301,74.125.24.0-255,2184,75960,8,318642
16391,0.001323,172.31.36.0-255,66,76026,8,318642
16392,0.001353,74.125.24.0-255,1484,77510,8,318642
16393,0.00137,74.125.24.0-255,2902,80412,8,318642
16394,0.001375,172.31.36.0-255,66,80478,8,318642
16395,0.001402,74.125.24.0-255,5738,86216,8,318642
16396,0.001407,74.125.24.0-255,4320,90536,8,318642
16397,0.001421,74.125.24.0-255,2902,93438,8,318642
16398,0.001467,74.125.24.0-255,2902,96340,8,318642
16399,0.001471,74.125.24.0-255,2184,98524,8,318642
16400,0.001477,172.31.36.0-255,66,98590,8,318642
16401,0.0015,74.125.24.0-255,1484,100074,8,318642
16402,0.001517,74.125.24.0-255,2902,102976,8,318642
16403,0.001534,74.125.24.0-255,5738,108714,8,318642
16404,0.001539,74.125.24.0-255,2902,111616,8,318642
16405,0.001546,172.31.36.0-255,66,111682,8,318642
16406,0.001567,74.125.24.0-255,7156,118838,8,318642
16407,0.001587,74.125.24.0-255,2902,121740,8,318642
16408,0.001601,74.125.24.0-255,2902,124642,8,318642
16409,0.001606,172.31.36.0-255,66,124708,8,318642
16410,0.001641,172.31.36.0-255,66,124774,8,318642
16411,0.001724,74.125.24.0-255,1484,126258,8,318642
16412,0.001729,74.125.24.0-255,2902,129160,8,318642
16413,0.001749,74.125.24.0-255,5738,134898,8,318642
16414,0.001754,172.31.36.0-255,66,134964,8,318642
16415,0.001801,74.125.24.0-255,4320,139284,8,318642
16416,0.001836,74.125.24.0-255,4320,143604,8,318642
16417,0.001848,74.125.24.0-255,1484,145088,8,318642
16418,0.001851,74.125.24.0-255,766,145854,8,318642
16419,0.001859,172.31.36.0-255,66,145920,8,318642
16420,0.001955,74.125.24.0-255,1484,147404,8,318642
16421,0.00198,74.125.24.0-255,2902,150306,8,318642
16422,0.001987,74.125.24.0-255,5738,156044,8,318642
16423,0.00199,74.125.24.0-255,1484,157528,8,318642
16424,0.002002,74.125.24.0-255,2902,160430,8,318642
16425,0.002037,74.125.24.0-255,4320,164750,8,318642
16426,0.002055,74.125.24.0-255,4320,169070,8,318642
16427,0.006058,172.31.36.0-255,66,169136,8,318642
16428,0.008136,74.125.24.0-255,4320,173456,8,318642
16429,0.008143,172.31.36.0-255,66,173522,8,318642
16430,0.00817,74.125.24.0-255,1484,175006,8,318642
16431,0.01022,74.125.24.0-255,4320,179326,8,318642
16432,0.010226,172.31.36.0-255,66,179392,8,318642
16433,0.012288,74.125.24.0-255,5738,185130,8,318642
16434,0.017818,172.31.36.0-255,66,185196,8,318642
16435,0.019919,74.125.24.0-255,5738,190934,8,318642
16436,0.019935,172.31.36.0-255,66,191000,8,318642
16437,0.022032,74.125.24.0-255,5738,196738,8,318642
16438,0.022039,172.31.36.0-255,66,196804,8,318642
16439,0.024136,74.125.24.0-255,5738,202542,8,318642
16440,0.024144,172.31.36.0-255,66,202608,8,318642
16441,0.026217,74.125.24.0-255,5738,208346,8,318642
16442,0.026224,172.31.36.0-255,66,208412,8,318642
16443,0.028302,74.125.24.0-255,5738,214150,8,318642
16444,0.028309,172.31.36.0-255,66,214216,8,318642
16445,0.030198,172.31.36.0-255,171,214387,8,318642
16446,0.03023,172.31.36.0-255,1136,215523,8,318642
16447,0.030289,172.31.36.0-255,1514,217037,8,318642
16448,0.030291,172.31.36.0-255,1514,218551,8,318642
16449,0.030293,172.31.36.0-255,307,218858,8,318642
16450,0.03039,74.125.24.0-255,5738,224596,8,318642
16451,0.030396,172.31.36.0-255,66,224662,8,318642
16452,0.031769,104.244.42.0-255,66,224728,8,318642
16453,0.031797,104.244.42.0-255,66,224794,8,318642
16454,0.031845,104.244.42.0-255,66,224860,8,318642
16455,0.031859,104.244.42.0-255,66,224926,8,318642
16456,0.032461,74.125.24.0-255,5738,230664,8,318642
16457,0.032466,172.31.36.0-255,66,230730,8,318642
16458,0.034529,74.125.24.0-255,5738,236468,8,318642
16459,0.034536,172.31.36.0-255,66,236534,8,318642
16460,0.036632,74.125.24.0-255,5738,242272,8,318642
16461,0.036638,172.31.36.0-255,66,242338,8,318642
16462,0.038726,74.125.24.0-255,5738,248076,8,318642
16463,0.038733,172.31.36.0-255,66,248142,8,318642
16464,0.040794,74.125.24.0-255,5738,253880,8,318642
16465,0.040801,172.31.36.0-255,66,253946,8,318642
16466,0.042916,74.125.24.0-255,5738,259684,8,318642
16467,0.042923,172.31.36.0-255,66,259750,8,318642
16468,0.045001,74.125.24.0-255,5738,265488,8,318642
16469,0.045008,172.31.36.0-255,66,265554,8,318642
16470,0.047117,74.125.24.0-255,5738,271292,8,318642
16471,0.047123,172.31.36.0-255,66,271358,8,318642
16472,0.04922,74.125.24.0-255,5738,277096,8,318642
16473,0.049227,172.31.36.0-255,66,277162,8,318642
16474,0.051306,74.125.24.0-255,5738,282900,8,318642
16475,0.051322,172.31.36.0-255,66,282966,8,318642
16476,0.053394,74.125.24.0-255,5738,288704,8,318642
16477,0.0534,172.31.36.0-255,66,288770,8,318642
16478,0.055475,74.125.24.0-255,5738,294508,8,318642
16479,0.055481,172.31.36.0-255,66,294574,8,318642
16480,0.057563,74.125.24.0-255,5738,300312,8,318642
16481,0.057571,172.31.36.0-255,66,300378,8,318642
16482,0.059651,74.125.24.0-255,5738,306116,8,318642
16483,0.059658,172.31.36.0-255,66,306182,8,318642
16484,0.061744,74.125.24.0-255,5738,311920,8,318642
16485,0.06175,172.31.36.0-255,66,311986,8,318642
16486,0.063823,74.125.24.0-255,5738,317724,8,318642
16487,0.063829,172.31.36.0-255,66,317790,8,318642
16488,0.065906,74.125.24.0-255,615,318405,8,318642
16489,0.066064,172.31.36.0-255,66,318471,8,318642
16490,0.066102,172.31.36.0-255,105,318576,8,318642
16491,0.068162,74.125.24.0-255,66,318642,8,318642
16492,0.0,172.217.194.0-255,150,150,8,222602
16493,3.5e-05,172.31.36.0-255,66,216,8,222602
16494,4.3e-05,172.217.194.0-255,1484,1700,8,222602
16495,4.8e-05,172.31.36.0-255,66,1766,8,222602
16496,5.2e-05,172.217.194.0-255,2902,4668,8,222602
16497,5.5e-05,172.31.36.0-255,66,4734,8,222602
16498,6.6e-05,172.217.194.0-255,1484,6218,8,222602
16499,6.9e-05,172.31.36.0-255,66,6284,8,222602
16500,0.0001,172.217.194.0-255,2902,9186,8,222602
16501,0.000103,172.31.36.0-255,66,9252,8,222602
16502,0.000164,172.31.36.0-255,66,9318,8,222602
16503,0.000304,172.31.36.0-255,66,9384,8,222602
16504,0.00051,172.31.36.0-255,66,9450,8,222602
16505,0.000541,172.217.194.0-255,2902,12352,8,222602
16506,0.000545,172.31.36.0-255,66,12418,8,222602
16507,0.000712,172.217.194.0-255,5738,18156,8,222602
16508,0.000719,172.31.36.0-255,66,18222,8,222602
16509,0.000745,172.31.36.0-255,66,18288,8,222602
16510,0.001035,172.217.194.0-255,382,18670,8,222602
16511,0.00104,172.31.36.0-255,66,18736,8,222602
16512,0.001088,172.31.36.0-255,66,18802,8,222602
16513,0.001123,172.31.36.0-255,66,18868,8,222602
16514,0.001442,172.31.36.0-255,66,18934,8,222602
16515,0.001492,172.31.36.0-255,66,19000,8,222602
16516,0.001882,172.31.36.0-255,66,19066,8,222602
16517,0.001946,172.31.36.0-255,66,19132,8,222602
16518,0.002672,172.31.36.0-255,66,19198,8,222602
16519,0.002766,172.31.36.0-255,66,19264,8,222602
16520,0.002791,172.217.194.0-255,7156,26420,8,222602
16521,0.002794,172.31.36.0-255,66,26486,8,222602
16522,0.004788,172.217.194.0-255,5738,32224,8,222602
16523,0.004806,172.31.36.0-255,66,32290,8,222602
16524,0.006823,172.217.194.0-255,5738,38028,8,222602
16525,0.006831,172.31.36.0-255,66,38094,8,222602
16526,0.008847,172.217.194.0-255,5738,43832,8,222602
16527,0.008859,172.31.36.0-255,66,43898,8,222602
16528,0.010866,172.217.194.0-255,5738,49636,8,222602
16529,0.010875,172.31.36.0-255,66,49702,8,222602
16530,0.012903,172.217.194.0-255,2902,52604,8,222602
16531,0.012914,172.31.36.0-255,66,52670,8,222602
16532,0.012922,172.217.194.0-255,2902,55572,8,222602
16533,0.012926,172.31.36.0-255,66,55638,8,222602
16534,0.014968,172.217.194.0-255,5738,61376,8,222602
16535,0.014981,172.31.36.0-255,66,61442,8,222602
16536,0.017044,172.217.194.0-255,5738,67180,8,222602
16537,0.017062,172.31.36.0-255,66,67246,8,222602
16538,0.019081,172.217.194.0-255,5738,72984,8,222602
16539,0.019099,172.31.36.0-255,66,73050,8,222602
16540,0.021109,172.217.194.0-255,5738,78788,8,222602
16541,0.021117,172.31.36.0-255,66,78854,8,222602
16542,0.023135,172.217.194.0-255,5738,84592,8,222602
16543,0.023146,172.31.36.0-255,66,84658,8,222602
16544,0.025159,172.217.194.0-255,5738,90396,8,222602
16545,0.02517,172.31.36.0-255,66,90462,8,222602
16546,0.027189,172.217.194.0-255,5738,96200,8,222602
16547,0.027199,172.31.36.0-255,66,96266,8,222602
16548,0.029215,172.217.194.0-255,5738,102004,8,222602
16549,0.029226,172.31.36.0-255,66,102070,8,222602
16550,0.030627,172.31.36.0-255,188,102258,8,222602
16551,0.030673,172.31.36.0-255,955,103213,8,222602
16552,0.030743,172.31.36.0-255,1514,104727,8,222602
16553,0.030746,172.31.36.0-255,1514,106241,8,222602
16554,0.030751,172.31.36.0-255,1514,107755,8,222602
16555,0.030752,172.31.36.0-255,1514,109269,8,222602
16556,0.030778,172.31.36.0-255,574,109843,8,222602
16557,0.03125,172.217.194.0-255,5738,115581,8,222602
16558,0.031258,172.31.36.0-255,66,115647,8,222602
16559,0.032127,104.244.42.0-255,66,115713,8,222602
16560,0.032167,104.244.42.0-255,66,115779,8,222602
16561,0.032265,104.244.42.0-255,66,115845,8,222602
16562,0.032271,104.244.42.0-255,66,115911,8,222602
16563,0.033287,172.217.194.0-255,5738,121649,8,222602
16564,0.033294,172.31.36.0-255,66,121715,8,222602
16565,0.035308,172.217.194.0-255,5738,127453,8,222602
16566,0.035315,172.31.36.0-255,66,127519,8,222602
16567,0.037309,172.217.194.0-255,5738,133257,8,222602
16568,0.037317,172.31.36.0-255,66,133323,8,222602
16569,0.039349,172.217.194.0-255,5738,139061,8,222602
16570,0.039356,172.31.36.0-255,66,139127,8,222602
16571,0.04138,172.217.194.0-255,5738,144865,8,222602
16572,0.04139,172.31.36.0-255,66,144931,8,222602
16573,0.043418,172.217.194.0-255,5738,150669,8,222602
16574,0.043426,172.31.36.0-255,66,150735,8,222602
16575,0.045436,172.217.194.0-255,5738,156473,8,222602
16576,0.045443,172.31.36.0-255,66,156539,8,222602
16577,0.047491,172.217.194.0-255,5738,162277,8,222602
16578,0.047498,172.31.36.0-255,66,162343,8,222602
16579,0.049528,172.217.194.0-255,5738,168081,8,222602
16580,0.049535,172.31.36.0-255,66,168147,8,222602
16581,0.051558,172.217.194.0-255,5738,173885,8,222602
16582,0.051565,172.31.36.0-255,66,173951,8,222602
16583,0.053581,172.217.194.0-255,5738,179689,8,222602
16584,0.053588,172.31.36.0-255,66,179755,8,222602
16585,0.055681,172.217.194.0-255,5738,185493,8,222602
16586,0.055687,172.31.36.0-255,66,185559,8,222602
16587,0.057709,172.217.194.0-255,5738,191297,8,222602
16588,0.057716,172.31.36.0-255,66,191363,8,222602
16589,0.059724,172.217.194.0-255,4320,195683,8,222602
16590,0.059731,172.31.36.0-255,66,195749,8,222602
16591,0.059759,172.217.194.0-255,1484,197233,8,222602
16592,0.06176,172.217.194.0-255,4320,201553,8,222602
16593,0.061768,172.31.36.0-255,66,201619,8,222602
16594,0.063814,172.217.194.0-255,5738,207357,8,222602
16595,0.063822,172.31.36.0-255,66,207423,8,222602
16596,0.065843,172.217.194.0-255,5738,213161,8,222602
16597,0.06585,172.31.36.0-255,66,213227,8,222602
16598,0.067944,172.217.194.0-255,5738,218965,8,222602
16599,0.067951,172.31.36.0-255,66,219031,8,222602
16600,0.069947,172.217.194.0-255,3505,222536,8,222602
16601,0.069954,172.31.36.0-255,66,222602,8,222602
16602,0.0,74.125.200.0-255,152,152,8,272449
16603,3.4e-05,172.31.36.0-255,66,218,8,272449
16604,4.1e-05,74.125.200.0-255,1484,1702,8,272449
16605,4.6e-05,172.31.36.0-255,66,1768,8,272449
16606,7.3e-05,74.125.200.0-255,2902,4670,8,272449
16607,7.5e-05,172.31.36.0-255,66,4736,8,272449
16608,8e-05,74.125.200.0-255,4320,9056,8,272449
16609,8.3e-05,172.31.36.0-255,66,9122,8,272449
16610,0.000121,74.125.200.0-255,4854,13976,8,272449
16611,0.000125,172.31.36.0-255,66,14042,8,272449
16612,0.000177,74.125.200.0-255,1484,15526,8,272449
16613,0.000182,172.31.36.0-255,66,15592,8,272449
16614,0.000203,74.125.200.0-255,1484,17076,8,272449
16615,0.000205,172.31.36.0-255,66,17142,8,272449
16616,0.00022,74.125.200.0-255,1484,18626,8,272449
16617,0.000222,172.31.36.0-255,66,18692,8,272449
16618,0.000235,74.125.200.0-255,1484,20176,8,272449
16619,0.000237,172.31.36.0-255,66,20242,8,272449
16620,0.000244,74.125.200.0-255,5738,25980,8,272449
16621,0.000246,172.31.36.0-255,66,26046,8,272449
16622,0.000268,74.125.200.0-255,5379,31425,8,272449
16623,0.000272,172.31.36.0-255,66,31491,8,272449
16624,0.000376,74.125.200.0-255,1484,32975,8,272449
16625,0.000382,172.31.36.0-255,66,33041,8,272449
16626,0.000388,74.125.200.0-255,1484,34525,8,272449
16627,0.00039,172.31.36.0-255,66,34591,8,272449
16628,0.000403,74.125.200.0-255,1484,36075,8,272449
16629,0.000406,172.31.36.0-255,66,36141,8,272449
16630,0.00041,74.125.200.0-255,2902,39043,8,272449
16631,0.000412,172.31.36.0-255,66,39109,8,272449
16632,0.000439,74.125.200.0-255,4320,43429,8,272449
16633,0.000442,172.31.36.0-255,66,43495,8,272449
16634,0.00046,74.125.200.0-255,1484,44979,8,272449
16635,0.000475,74.125.200.0-255,5379,50358,8,272449
16636,0.000477,172.31.36.0-255,66,50424,8,272449
16637,0.000483,74.125.200.0-255,5738,56162,8,272449
16638,0.000485,172.31.36.0-255,66,56228,8,272449
16639,0.000506,74.125.200.0-255,1484,57712,8,272449
16640,0.000516,74.125.200.0-255,1484,59196,8,272449
16641,0.000518,172.31.36.0-255,66,59262,8,272449
16642,0.000538,74.125.200.0-255,4320,63582,8,272449
16643,0.00054,172.31.36.0-255,66,63648,8,272449
16644,0.000567,74.125.200.0-255,2543,66191,8,272449
16645,0.00057,172.31.36.0-255,66,66257,8,272449
16646,0.000984,74.125.200.0-255,647,66904,8,272449
16647,0.00144,74.125.200.0-255,1484,68388,8,272449
16648,0.001446,172.31.36.0-255,66,68454,8,272449
16649,0.001468,74.125.200.0-255,2902,71356,8,272449
16650,0.00147,172.31.36.0-255,66,71422,8,272449
16651,0.001484,74.125.200.0-255,1484,72906,8,272449
16652,0.001488,74.125.200.0-255,1484,74390,8,272449
16653,0.00149,172.31.36.0-255,66,74456,8,272449
16654,0.001509,74.125.200.0-255,1484,75940,8,272449
16655,0.001515,74.125.200.0-255,5738,81678,8,272449
16656,0.001518,172.31.36.0-255,66,81744,8,272449
16657,0.001536,74.125.200.0-255,4320,86064,8,272449
16658,0.001538,172.31.36.0-255,66,86130,8,272449
16659,0.00156,74.125.200.0-255,4320,90450,8,272449
16660,0.001562,172.31.36.0-255,66,90516,8,272449
16661,0.001572,172.31.36.0-255,66,90582,8,272449
16662,0.001575,74.125.200.0-255,766,91348,8,272449
16663,0.002279,74.125.200.0-255,1484,92832,8,272449
16664,0.002282,172.31.36.0-255,66,92898,8,272449
16665,0.002286,74.125.200.0-255,1484,94382,8,272449
16666,0.0023,74.125.200.0-255,1484,95866,8,272449
16667,0.002302,172.31.36.0-255,66,95932,8,272449
16668,0.002305,74.125.200.0-255,1484,97416,8,272449
16669,0.004546,74.125.200.0-255,1484,98900,8,272449
16670,0.004549,172.31.36.0-255,66,98966,8,272449
16671,0.004563,74.125.200.0-255,2902,101868,8,272449
16672,0.004565,172.31.36.0-255,66,101934,8,272449
16673,0.00682,74.125.200.0-255,5738,107672,8,272449
16674,0.006826,172.31.36.0-255,66,107738,8,272449
16675,0.009099,74.125.200.0-255,5738,113476,8,272449
16676,0.009106,172.31.36.0-255,66,113542,8,272449
16677,0.011567,74.125.200.0-255,5738,119280,8,272449
16678,0.01163,172.31.36.0-255,66,119346,8,272449
16679,0.013927,74.125.200.0-255,5738,125084,8,272449
16680,0.013935,172.31.36.0-255,66,125150,8,272449
16681,0.016221,74.125.200.0-255,5738,130888,8,272449
16682,0.016229,172.31.36.0-255,66,130954,8,272449
16683,0.018511,74.125.200.0-255,5738,136692,8,272449
16684,0.018521,172.31.36.0-255,66,136758,8,272449
16685,0.020812,74.125.200.0-255,5738,142496,8,272449
16686,0.02082,172.31.36.0-255,66,142562,8,272449
16687,0.02312,74.125.200.0-255,5738,148300,8,272449
16688,0.023127,172.31.36.0-255,66,148366,8,272449
16689,0.025399,74.125.200.0-255,5738,154104,8,272449
16690,0.025407,172.31.36.0-255,66,154170,8,272449
16691,0.027687,74.125.200.0-255,5738,159908,8,272449
16692,0.027696,172.31.36.0-255,66,159974,8,272449
16693,0.029969,74.125.200.0-255,2902,162876,8,272449
16694,0.029976,172.31.36.0-255,66,162942,8,272449
16695,0.029991,74.125.200.0-255,2902,165844,8,272449
16696,0.030015,172.31.36.0-255,66,165910,8,272449
16697,0.030192,172.31.36.0-255,172,166082,8,272449
16698,0.030219,172.31.36.0-255,1112,167194,8,272449
16699,0.030283,172.31.36.0-255,1514,168708,8,272449
16700,0.030284,172.31.36.0-255,1514,170222,8,272449
16701,0.030292,172.31.36.0-255,1514,171736,8,272449
16702,0.030293,172.31.36.0-255,1514,173250,8,272449
16703,0.030322,172.31.36.0-255,167,173417,8,272449
16704,0.031721,104.244.42.0-255,66,173483,8,272449
16705,0.031769,104.244.42.0-255,66,173549,8,272449
16706,0.031818,104.244.42.0-255,66,173615,8,272449
16707,0.031822,104.244.42.0-255,66,173681,8,272449
16708,0.03224,74.125.200.0-255,2902,176583,8,272449
16709,0.032245,172.31.36.0-255,66,176649,8,272449
16710,0.032275,74.125.200.0-255,2902,179551,8,272449
16711,0.032278,172.31.36.0-255,66,179617,8,272449
16712,0.034509,74.125.200.0-255,2902,182519,8,272449
16713,0.034515,172.31.36.0-255,66,182585,8,272449
16714,0.034544,74.125.200.0-255,2902,185487,8,272449
16715,0.034548,172.31.36.0-255,66,185553,8,272449
16716,0.036774,74.125.200.0-255,2902,188455,8,272449
16717,0.03678,172.31.36.0-255,66,188521,8,272449
16718,0.036814,74.125.200.0-255,2902,191423,8,272449
16719,0.036817,172.31.36.0-255,66,191489,8,272449
16720,0.039062,74.125.200.0-255,2902,194391,8,272449
16721,0.039068,172.31.36.0-255,66,194457,8,272449
16722,0.039128,74.125.200.0-255,2902,197359,8,272449
16723,0.039133,172.31.36.0-255,66,197425,8,272449
16724,0.041338,74.125.200.0-255,2902,200327,8,272449
16725,0.041343,172.31.36.0-255,66,200393,8,272449
16726,0.041399,74.125.200.0-255,2902,203295,8,272449
16727,0.041403,172.31.36.0-255,66,203361,8,272449
16728,0.043617,74.125.200.0-255,2902,206263,8,272449
16729,0.043626,172.31.36.0-255,66,206329,8,272449
16730,0.043654,74.125.200.0-255,2902,209231,8,272449
16731,0.043657,172.31.36.0-255,66,209297,8,272449
16732,0.045896,74.125.200.0-255,2902,212199,8,272449
16733,0.045901,172.31.36.0-255,66,212265,8,272449
16734,0.045938,74.125.200.0-255,2902,215167,8,272449
16735,0.045941,172.31.36.0-255,66,215233,8,272449
16736,0.04817,74.125.200.0-255,2902,218135,8,272449
16737,0.048175,172.31.36.0-255,66,218201,8,272449
16738,0.048205,74.125.200.0-255,2902,221103,8,272449
16739,0.048208,172.31.36.0-255,66,221169,8,272449
16740,0.050452,74.125.200.0-255,2902,224071,8,272449
16741,0.05046,172.31.36.0-255,66,224137,8,272449
16742,0.050498,74.125.200.0-255,2902,227039,8,272449
16743,0.050501,172.31.36.0-255,66,227105,8,272449
16744,0.052731,74.125.200.0-255,2902,230007,8,272449
16745,0.052737,172.31.36.0-255,66,230073,8,272449
16746,0.052771,74.125.200.0-255,2902,232975,8,272449
16747,0.052774,172.31.36.0-255,66,233041,8,272449
16748,0.055008,74.125.200.0-255,1484,234525,8,272449
16749,0.055039,74.125.200.0-255,2902,237427,8,272449
16750,0.055044,172.31.36.0-255,66,237493,8,272449
16751,0.055066,74.125.200.0-255,1484,238977,8,272449
16752,0.057314,74.125.200.0-255,4320,243297,8,272449
16753,0.05732,172.31.36.0-255,66,243363,8,272449
16754,0.059585,74.125.200.0-255,5738,249101,8,272449
16755,0.059592,172.31.36.0-255,66,249167,8,272449
16756,0.061857,74.125.200.0-255,5738,254905,8,272449
16757,0.061863,172.31.36.0-255,66,254971,8,272449
16758,0.064128,74.125.200.0-255,5738,260709,8,272449
16759,0.064133,172.31.36.0-255,66,260775,8,272449
16760,0.066422,74.125.200.0-255,1484,262259,8,272449
16761,0.066453,74.125.200.0-255,4320,266579,8,272449
16762,0.066458,172.31.36.0-255,66,266645,8,272449
16763,0.068735,74.125.200.0-255,5738,272383,8,272449
16764,0.06874,172.31.36.0-255,66,272449,8,272449
16765,0.0,74.125.24.0-255,153,153,8,255758
16766,2.8e-05,172.31.36.0-255,66,219,8,255758
16767,3.5e-05,74.125.24.0-255,1484,1703,8,255758
16768,3.9e-05,172.31.36.0-255,66,1769,8,255758
16769,4.4e-05,74.125.24.0-255,2902,4671,8,255758
16770,4.7e-05,172.31.36.0-255,66,4737,8,255758
16771,5.8e-05,74.125.24.0-255,1484,6221,8,255758
16772,6e-05,172.31.36.0-255,66,6287,8,255758
16773,6.5e-05,74.125.24.0-255,2902,9189,8,255758
16774,6.8e-05,172.31.36.0-255,66,9255,8,255758
16775,0.000109,74.125.24.0-255,4776,14031,8,255758
16776,0.000112,172.31.36.0-255,66,14097,8,255758
16777,0.000149,74.125.24.0-255,1484,15581,8,255758
16778,0.000152,172.31.36.0-255,66,15647,8,255758
16779,0.00017,74.125.24.0-255,2902,18549,8,255758
16780,0.000173,172.31.36.0-255,66,18615,8,255758
16781,0.000206,74.125.24.0-255,5738,24353,8,255758
16782,0.000209,172.31.36.0-255,66,24419,8,255758
16783,0.000212,74.125.24.0-255,1484,25903,8,255758
16784,0.000214,172.31.36.0-255,66,25969,8,255758
16785,0.000258,74.125.24.0-255,5379,31348,8,255758
16786,0.000262,172.31.36.0-255,66,31414,8,255758
16787,0.000399,74.125.24.0-255,1484,32898,8,255758
16788,0.000403,172.31.36.0-255,66,32964,8,255758
16789,0.000409,74.125.24.0-255,2902,35866,8,255758
16790,0.000411,172.31.36.0-255,66,35932,8,255758
16791,0.000423,74.125.24.0-255,5738,41670,8,255758
16792,0.000426,172.31.36.0-255,66,41736,8,255758
16793,0.00045,74.125.24.0-255,2902,44638,8,255758
16794,0.000455,172.31.36.0-255,66,44704,8,255758
16795,0.000491,74.125.24.0-255,6797,51501,8,255758
16796,0.000495,172.31.36.0-255,66,51567,8,255758
16797,0.000508,172.31.36.0-255,66,51633,8,255758
16798,0.000513,74.125.24.0-255,3961,55594,8,255758
16799,0.000516,172.31.36.0-255,66,55660,8,255758
16800,0.000681,74.125.24.0-255,415,56075,8,255758
16801,0.000733,74.125.24.0-255,329,56404,8,255758
16802,0.000764,172.31.36.0-255,66,56470,8,255758
16803,0.003173,74.125.24.0-255,1484,57954,8,255758
16804,0.003183,74.125.24.0-255,2902,60856,8,255758
16805,0.003187,172.31.36.0-255,66,60922,8,255758
16806,0.003192,74.125.24.0-255,1484,62406,8,255758
16807,0.005184,74.125.24.0-255,4320,66726,8,255758
16808,0.005189,172.31.36.0-255,66,66792,8,255758
16809,0.007234,74.125.24.0-255,5738,72530,8,255758
16810,0.00724,172.31.36.0-255,66,72596,8,255758
16811,0.009278,74.125.24.0-255,5738,78334,8,255758
16812,0.009285,172.31.36.0-255,66,78400,8,255758
16813,0.011298,74.125.24.0-255,5738,84138,8,255758
16814,0.011305,172.31.36.0-255,66,84204,8,255758
16815,0.013316,74.125.24.0-255,5738,89942,8,255758
16816,0.013323,172.31.36.0-255,66,90008,8,255758
16817,0.015324,74.125.24.0-255,5738,95746,8,255758
16818,0.015332,172.31.36.0-255,66,95812,8,255758
16819,0.01737,74.125.24.0-255,5738,101550,8,255758
16820,0.017376,172.31.36.0-255,66,101616,8,255758
16821,0.019408,74.125.24.0-255,5738,107354,8,255758
16822,0.019416,172.31.36.0-255,66,107420,8,255758
16823,0.021446,74.125.24.0-255,5738,113158,8,255758
16824,0.021454,172.31.36.0-255,66,113224,8,255758
16825,0.02345,74.125.24.0-255,5738,118962,8,255758
16826,0.023457,172.31.36.0-255,66,119028,8,255758
16827,0.025482,74.125.24.0-255,5738,124766,8,255758
16828,0.02549,172.31.36.0-255,66,124832,8,255758
16829,0.027491,74.125.24.0-255,5738,130570,8,255758
16830,0.027498,172.31.36.0-255,66,130636,8,255758
16831,0.027604,172.31.36.0-255,172,130808,8,255758
16832,0.02767,172.31.36.0-255,1111,131919,8,255758
16833,0.027865,172.31.36.0-255,1514,133433,8,255758
16834,0.027868,172.31.36.0-255,1514,134947,8,255758
16835,0.027873,172.31.36.0-255,1514,136461,8,255758
16836,0.027874,172.31.36.0-255,1514,137975,8,255758
16837,0.027904,172.31.36.0-255,1514,139489,8,255758
16838,0.027906,172.31.36.0-255,995,140484,8,255758
16839,0.029145,104.244.42.0-255,66,140550,8,255758
16840,0.029251,104.244.42.0-255,66,140616,8,255758
16841,0.029438,104.244.42.0-255,66,140682,8,255758
16842,0.029488,104.244.42.0-255,66,140748,8,255758
16843,0.029517,74.125.24.0-255,5738,146486,8,255758
16844,0.029522,172.31.36.0-255,66,146552,8,255758
16845,0.03003,104.244.42.0-255,108,146660,8,255758
16846,0.030037,172.31.36.0-255,66,146726,8,255758
16847,0.031546,74.125.24.0-255,5738,152464,8,255758
16848,0.031558,172.31.36.0-255,66,152530,8,255758
16849,0.033562,74.125.24.0-255,5738,158268,8,255758
16850,0.033569,172.31.36.0-255,66,158334,8,255758
16851,0.035572,74.125.24.0-255,4320,162654,8,255758
16852,0.035579,172.31.36.0-255,66,162720,8,255758
16853,0.035609,74.125.24.0-255,1484,164204,8,255758
16854,0.036294,172.31.36.0-255,108,164312,8,255758
16855,0.037594,74.125.24.0-255,4320,168632,8,255758
16856,0.037601,172.31.36.0-255,66,168698,8,255758
16857,0.039615,74.125.24.0-255,5738,174436,8,255758
16858,0.039622,172.31.36.0-255,66,174502,8,255758
16859,0.041636,74.125.24.0-255,5738,180240,8,255758
16860,0.041644,172.31.36.0-255,66,180306,8,255758
16861,0.04367,74.125.24.0-255,5738,186044,8,255758
16862,0.043679,172.31.36.0-255,66,186110,8,255758
16863,0.045694,74.125.24.0-255,5738,191848,8,255758
16864,0.045704,172.31.36.0-255,66,191914,8,255758
16865,0.04773,74.125.24.0-255,5738,197652,8,255758
16866,0.04774,172.31.36.0-255,66,197718,8,255758
16867,0.049787,74.125.24.0-255,5738,203456,8,255758
16868,0.049797,172.31.36.0-255,66,203522,8,255758
16869,0.051813,74.125.24.0-255,5738,209260,8,255758
16870,0.051823,172.31.36.0-255,66,209326,8,255758
16871,0.053822,74.125.24.0-255,5738,215064,8,255758
16872,0.05383,172.31.36.0-255,66,215130,8,255758
16873,0.05583,74.125.24.0-255,5738,220868,8,255758
16874,0.055837,172.31.36.0-255,66,220934,8,255758
16875,0.057846,74.125.24.0-255,5738,226672,8,255758
16876,0.057853,172.31.36.0-255,66,226738,8,255758
16877,0.059859,74.125.24.0-255,5738,232476,8,255758
16878,0.059866,172.31.36.0-255,66,232542,8,255758
16879,0.061896,74.125.24.0-255,5738,238280,8,255758
16880,0.061905,172.31.36.0-255,66,238346,8,255758
16881,0.063935,74.125.24.0-255,5738,244084,8,255758
16882,0.063948,172.31.36.0-255,66,244150,8,255758
16883,0.065979,74.125.24.0-255,5738,249888,8,255758
16884,0.066,172.31.36.0-255,66,249954,8,255758
16885,0.068104,74.125.24.0-255,5738,255692,8,255758
16886,0.068123,172.31.36.0-255,66,255758,8,255758
16887,0.0,74.125.68.0-255,145,145,8,376079
16888,3e-05,172.31.36.0-255,66,211,8,376079
16889,3.7e-05,74.125.68.0-255,1484,1695,8,376079
16890,4.2e-05,172.31.36.0-255,66,1761,8,376079
16891,4.7e-05,74.125.68.0-255,2902,4663,8,376079
16892,4.9e-05,172.31.36.0-255,66,4729,8,376079
16893,5.4e-05,74.125.68.0-255,5738,10467,8,376079
16894,5.7e-05,172.31.36.0-255,66,10533,8,376079
16895,8.7e-05,74.125.68.0-255,3420,13953,8,376079
16896,9.2e-05,172.31.36.0-255,66,14019,8,376079
16897,0.000311,74.125.68.0-255,1484,15503,8,376079
16898,0.000316,172.31.36.0-255,66,15569,8,376079
16899,0.000321,74.125.68.0-255,2902,18471,8,376079
16900,0.000323,172.31.36.0-255,66,18537,8,376079
16901,0.000339,74.125.68.0-255,5738,24275,8,376079
16902,0.000343,172.31.36.0-255,66,24341,8,376079
16903,0.00035,74.125.68.0-255,2902,27243,8,376079
16904,0.000352,172.31.36.0-255,66,27309,8,376079
16905,0.00037,74.125.68.0-255,2902,30211,8,376079
16906,0.000372,172.31.36.0-255,66,30277,8,376079
16907,0.000404,74.125.68.0-255,1125,31402,8,376079
16908,0.000407,172.31.36.0-255,66,31468,8,376079
16909,0.000558,74.125.68.0-255,1484,32952,8,376079
16910,0.000561,172.31.36.0-255,66,33018,8,376079
16911,0.000567,74.125.68.0-255,1484,34502,8,376079
16912,0.000569,172.31.36.0-255,66,34568,8,376079
16913,0.0006,74.125.68.0-255,1484,36052,8,376079
16914,0.000603,172.31.36.0-255,66,36118,8,376079
16915,0.000618,74.125.68.0-255,1484,37602,8,376079
16916,0.000621,172.31.36.0-255,66,37668,8,376079
16917,0.000632,74.125.68.0-255,2902,40570,8,376079
16918,0.000635,172.31.36.0-255,66,40636,8,376079
16919,0.000657,74.125.68.0-255,2902,43538,8,376079
16920,0.00066,172.31.36.0-255,66,43604,8,376079
16921,0.000665,74.125.68.0-255,4320,47924,8,376079
16922,0.000666,172.31.36.0-255,66,47990,8,376079
16923,0.000677,74.125.68.0-255,1484,49474,8,376079
16924,0.000696,74.125.68.0-255,3961,53435,8,376079
16925,0.000699,172.31.36.0-255,66,53501,8,376079
16926,0.000704,74.125.68.0-255,5738,59239,8,376079
16927,0.000706,172.31.36.0-255,66,59305,8,376079
16928,0.000719,74.125.68.0-255,2902,62207,8,376079
16929,0.000721,172.31.36.0-255,66,62273,8,376079
16930,0.000725,74.125.68.0-255,1484,63757,8,376079
16931,0.000785,74.125.68.0-255,1484,65241,8,376079
16932,0.000789,172.31.36.0-255,66,65307,8,376079
16933,0.000804,74.125.68.0-255,1432,66739,8,376079
16934,0.000827,74.125.68.0-255,115,66854,8,376079
16935,0.000918,74.125.68.0-255,331,67185,8,376079
16936,0.000922,172.31.36.0-255,66,67251,8,376079
16937,0.001062,74.125.68.0-255,1484,68735,8,376079
16938,0.001076,74.125.68.0-255,1484,70219,8,376079
16939,0.001079,172.31.36.0-255,66,70285,8,376079
16940,0.001107,74.125.68.0-255,1484,71769,8,376079
16941,0.001118,74.125.68.0-255,1484,73253,8,376079
16942,0.001119,172.31.36.0-255,66,73319,8,376079
16943,0.001176,74.125.68.0-255,1484,74803,8,376079
16944,0.001193,74.125.68.0-255,1484,76287,8,376079
16945,0.001194,172.31.36.0-255,66,76353,8,376079
16946,0.001212,74.125.68.0-255,2902,79255,8,376079
16947,0.001214,172.31.36.0-255,66,79321,8,376079
16948,0.001276,74.125.68.0-255,1484,80805,8,376079
16949,0.00129,74.125.68.0-255,1484,82289,8,376079
16950,0.001292,172.31.36.0-255,66,82355,8,376079
16951,0.001304,74.125.68.0-255,2902,85257,8,376079
16952,0.001306,172.31.36.0-255,66,85323,8,376079
16953,0.001326,74.125.68.0-255,2902,88225,8,376079
16954,0.001328,172.31.36.0-255,66,88291,8,376079
16955,0.001333,74.125.68.0-255,5738,94029,8,376079
16956,0.001335,172.31.36.0-255,66,94095,8,376079
16957,0.001339,74.125.68.0-255,4320,98415,8,376079
16958,0.00134,172.31.36.0-255,66,98481,8,376079
16959,0.001364,74.125.68.0-255,2902,101383,8,376079
16960,0.001366,172.31.36.0-255,66,101449,8,376079
16961,0.001368,74.125.68.0-255,766,102215,8,376079
16962,0.001479,74.125.68.0-255,1484,103699,8,376079
16963,0.001481,172.31.36.0-255,66,103765,8,376079
16964,0.001503,74.125.68.0-255,1484,105249,8,376079
16965,0.001517,74.125.68.0-255,1484,106733,8,376079
16966,0.001519,172.31.36.0-255,66,106799,8,376079
16967,0.001531,74.125.68.0-255,2902,109701,8,376079
16968,0.001533,172.31.36.0-255,66,109767,8,376079
16969,0.001544,74.125.68.0-255,1484,111251,8,376079
16970,0.001547,74.125.68.0-255,2902,114153,8,376079
16971,0.001549,172.31.36.0-255,66,114219,8,376079
16972,0.001573,74.125.68.0-255,1484,115703,8,376079
16973,0.001586,74.125.68.0-255,2902,118605,8,376079
16974,0.001588,172.31.36.0-255,66,118671,8,376079
16975,0.001591,74.125.68.0-255,1484,120155,8,376079
16976,0.001608,74.125.68.0-255,4320,124475,8,376079
16977,0.00161,172.31.36.0-255,66,124541,8,376079
16978,0.001622,74.125.68.0-255,2902,127443,8,376079
16979,0.001624,172.31.36.0-255,66,127509,8,376079
16980,0.001636,74.125.68.0-255,1484,128993,8,376079
16981,0.001648,74.125.68.0-255,2902,131895,8,376079
16982,0.001649,172.31.36.0-255,66,131961,8,376079
16983,0.001665,74.125.68.0-255,2902,134863,8,376079
16984,0.001667,172.31.36.0-255,66,134929,8,376079
16985,0.001682,74.125.68.0-255,2184,137113,8,376079
16986,0.001684,172.31.36.0-255,66,137179,8,376079
16987,0.00196,74.125.68.0-255,1484,138663,8,376079
16988,0.002003,74.125.68.0-255,2902,141565,8,376079
16989,0.002005,172.31.36.0-255,66,141631,8,376079
16990,0.002008,74.125.68.0-255,1484,143115,8,376079
16991,0.002039,74.125.68.0-255,4320,147435,8,376079
16992,0.002041,172.31.36.0-255,66,147501,8,376079
16993,0.002044,74.125.68.0-255,2902,150403,8,376079
16994,0.002046,172.31.36.0-255,66,150469,8,376079
16995,0.002066,74.125.68.0-255,2902,153371,8,376079
16996,0.002067,172.31.36.0-255,66,153437,8,376079
16997,0.002079,74.125.68.0-255,1484,154921,8,376079
16998,0.002082,74.125.68.0-255,2902,157823,8,376079
16999,0.002084,172.31.36.0-255,66,157889,8,376079
17000,0.002098,74.125.68.0-255,5738,163627,8,376079
17001,0.0021,172.31.36.0-255,66,163693,8,376079
17002,0.002104,74.125.68.0-255,4320,168013,8,376079
17003,0.002106,172.31.36.0-255,66,168079,8,376079
17004,0.002128,74.125.68.0-255,3602,171681,8,376079
17005,0.00213,172.31.36.0-255,66,171747,8,376079
17006,0.004076,74.125.68.0-255,1484,173231,8,376079
17007,0.004089,74.125.68.0-255,4320,177551,8,376079
17008,0.004091,172.31.36.0-255,66,177617,8,376079
17009,0.006063,74.125.68.0-255,5738,183355,8,376079
17010,0.006069,172.31.36.0-255,66,183421,8,376079
17011,0.008051,74.125.68.0-255,5738,189159,8,376079
17012,0.008058,172.31.36.0-255,66,189225,8,376079
17013,0.010058,74.125.68.0-255,5738,194963,8,376079
17014,0.010065,172.31.36.0-255,66,195029,8,376079
17015,0.012037,74.125.68.0-255,5738,200767,8,376079
17016,0.012044,172.31.36.0-255,66,200833,8,376079
17017,0.014016,74.125.68.0-255,5738,206571,8,376079
17018,0.014024,172.31.36.0-255,66,206637,8,376079
17019,0.016001,74.125.68.0-255,5738,212375,8,376079
17020,0.016008,172.31.36.0-255,66,212441,8,376079
17021,0.017974,74.125.68.0-255,5738,218179,8,376079
17022,0.017979,172.31.36.0-255,66,218245,8,376079
17023,0.019957,74.125.68.0-255,5738,223983,8,376079
17024,0.019965,172.31.36.0-255,66,224049,8,376079
17025,0.021964,74.125.68.0-255,5738,229787,8,376079
17026,0.021971,172.31.36.0-255,66,229853,8,376079
17027,0.023942,74.125.68.0-255,5738,235591,8,376079
17028,0.023949,172.31.36.0-255,66,235657,8,376079
17029,0.025916,74.125.68.0-255,5738,241395,8,376079
17030,0.025923,172.31.36.0-255,66,241461,8,376079
17031,0.02791,74.125.68.0-255,5738,247199,8,376079
17032,0.027918,172.31.36.0-255,66,247265,8,376079
17033,0.029898,74.125.68.0-255,5738,253003,8,376079
17034,0.029905,172.31.36.0-255,66,253069,8,376079
17035,0.031878,74.125.68.0-255,5738,258807,8,376079
17036,0.031885,172.31.36.0-255,66,258873,8,376079
17037,0.03387,74.125.68.0-255,5738,264611,8,376079
17038,0.033877,172.31.36.0-255,66,264677,8,376079
17039,0.0359,74.125.68.0-255,5738,270415,8,376079
17040,0.035907,172.31.36.0-255,66,270481,8,376079
17041,0.036496,172.31.36.0-255,188,270669,8,376079
17042,0.036532,172.31.36.0-255,955,271624,8,376079
17043,0.036602,172.31.36.0-255,1514,273138,8,376079
17044,0.036604,172.31.36.0-255,1514,274652,8,376079
17045,0.036605,172.31.36.0-255,77,274729,8,376079
17046,0.037871,74.125.68.0-255,2902,277631,8,376079
17047,0.037876,172.31.36.0-255,66,277697,8,376079
17048,0.037909,74.125.68.0-255,2902,280599,8,376079
17049,0.037912,172.31.36.0-255,66,280665,8,376079
17050,0.038041,104.244.42.0-255,66,280731,8,376079
17051,0.038098,104.244.42.0-255,66,280797,8,376079
17052,0.038188,104.244.42.0-255,66,280863,8,376079
17053,0.038194,104.244.42.0-255,66,280929,8,376079
17054,0.038943,104.244.42.0-255,108,281037,8,376079
17055,0.038948,172.31.36.0-255,66,281103,8,376079
17056,0.039838,74.125.68.0-255,2902,284005,8,376079
17057,0.039844,172.31.36.0-255,66,284071,8,376079
17058,0.039879,74.125.68.0-255,2902,286973,8,376079
17059,0.039883,172.31.36.0-255,66,287039,8,376079
17060,0.041806,74.125.68.0-255,2902,289941,8,376079
17061,0.041826,172.31.36.0-255,66,290007,8,376079
17062,0.041846,74.125.68.0-255,2902,292909,8,376079
17063,0.04185,172.31.36.0-255,66,292975,8,376079
17064,0.043792,74.125.68.0-255,2902,295877,8,376079
17065,0.043798,172.31.36.0-255,66,295943,8,376079
17066,0.043826,74.125.68.0-255,2902,298845,8,376079
17067,0.043829,172.31.36.0-255,66,298911,8,376079
17068,0.045768,74.125.68.0-255,2902,301813,8,376079
17069,0.045774,172.31.36.0-255,66,301879,8,376079
17070,0.045801,74.125.68.0-255,2902,304781,8,376079
17071,0.045804,172.31.36.0-255,66,304847,8,376079
17072,0.047745,74.125.68.0-255,2902,307749,8,376079
17073,0.04775,172.31.36.0-255,66,307815,8,376079
17074,0.047779,74.125.68.0-255,2902,310717,8,376079
17075,0.047782,172.31.36.0-255,66,310783,8,376079
17076,0.049712,74.125.68.0-255,2902,313685,8,376079
17077,0.049717,172.31.36.0-255,66,313751,8,376079
17078,0.049747,74.125.68.0-255,2902,316653,8,376079
17079,0.04975,172.31.36.0-255,66,316719,8,376079
17080,0.051688,74.125.68.0-255,2902,319621,8,376079
17081,0.051692,172.31.36.0-255,66,319687,8,376079
17082,0.051718,74.125.68.0-255,2902,322589,8,376079
17083,0.05172,172.31.36.0-255,66,322655,8,376079
17084,0.053656,74.125.68.0-255,2902,325557,8,376079
17085,0.053662,172.31.36.0-255,66,325623,8,376079
17086,0.053682,74.125.68.0-255,2902,328525,8,376079
17087,0.053684,172.31.36.0-255,66,328591,8,376079
17088,0.055624,74.125.68.0-255,2902,331493,8,376079
17089,0.055631,172.31.36.0-255,66,331559,8,376079
17090,0.055664,74.125.68.0-255,2902,334461,8,376079
17091,0.055667,172.31.36.0-255,66,334527,8,376079
17092,0.057609,74.125.68.0-255,2902,337429,8,376079
17093,0.057614,172.31.36.0-255,66,337495,8,376079
17094,0.057642,74.125.68.0-255,2902,340397,8,376079
17095,0.057644,172.31.36.0-255,66,340463,8,376079
17096,0.059584,74.125.68.0-255,2902,343365,8,376079
17097,0.05959,172.31.36.0-255,66,343431,8,376079
17098,0.05962,74.125.68.0-255,2902,346333,8,376079
17099,0.059623,172.31.36.0-255,66,346399,8,376079
17100,0.061554,74.125.68.0-255,2902,349301,8,376079
17101,0.06156,172.31.36.0-255,66,349367,8,376079
17102,0.06159,74.125.68.0-255,2902,352269,8,376079
17103,0.061593,172.31.36.0-255,66,352335,8,376079
17104,0.063527,74.125.68.0-255,2902,355237,8,376079
17105,0.063532,172.31.36.0-255,66,355303,8,376079
17106,0.063562,74.125.68.0-255,2902,358205,8,376079
17107,0.063565,172.31.36.0-255,66,358271,8,376079
17108,0.065497,74.125.68.0-255,2902,361173,8,376079
17109,0.065502,172.31.36.0-255,66,361239,8,376079
17110,0.065534,74.125.68.0-255,2902,364141,8,376079
17111,0.065537,172.31.36.0-255,66,364207,8,376079
17112,0.067464,74.125.68.0-255,2902,367109,8,376079
17113,0.067469,172.31.36.0-255,66,367175,8,376079
17114,0.067504,74.125.68.0-255,2902,370077,8,376079
17115,0.067507,172.31.36.0-255,66,370143,8,376079
17116,0.069435,74.125.68.0-255,2902,373045,8,376079
17117,0.06944,172.31.36.0-255,66,373111,8,376079
17118,0.069471,74.125.68.0-255,2902,376013,8,376079
17119,0.069474,172.31.36.0-255,66,376079,8,376079
17120,0.0,74.125.24.0-255,298,298,8,310182
17121,2.6e-05,172.31.36.0-255,66,364,8,310182
17122,3.3e-05,74.125.24.0-255,1484,1848,8,310182
17123,3.8e-05,172.31.36.0-255,66,1914,8,310182
17124,5.2e-05,74.125.24.0-255,4320,6234,8,310182
17125,5.6e-05,172.31.36.0-255,66,6300,8,310182
17126,6.5e-05,74.125.24.0-255,7156,13456,8,310182
17127,6.8e-05,172.31.36.0-255,66,13522,8,310182
17128,0.000112,172.31.36.0-255,66,13588,8,310182
17129,0.000118,74.125.24.0-255,3961,17549,8,310182
17130,0.00012,172.31.36.0-255,66,17615,8,310182
17131,0.00029,74.125.24.0-255,1484,19099,8,310182
17132,0.000295,172.31.36.0-255,66,19165,8,310182
17133,0.000301,74.125.24.0-255,2902,22067,8,310182
17134,0.000304,172.31.36.0-255,66,22133,8,310182
17135,0.000316,74.125.24.0-255,5738,27871,8,310182
17136,0.000318,172.31.36.0-255,66,27937,8,310182
17137,0.000379,172.31.36.0-255,66,28003,8,310182
17138,0.000399,172.31.36.0-255,66,28069,8,310182
17139,0.001161,74.125.24.0-255,645,28714,8,310182
17140,0.001167,172.31.36.0-255,66,28780,8,310182
17141,0.001289,74.125.24.0-255,1484,30264,8,310182
17142,0.001294,172.31.36.0-255,66,30330,8,310182
17143,0.001301,74.125.24.0-255,2902,33232,8,310182
17144,0.001303,172.31.36.0-255,66,33298,8,310182
17145,0.001338,74.125.24.0-255,4320,37618,8,310182
17146,0.00134,172.31.36.0-255,66,37684,8,310182
17147,0.001347,74.125.24.0-255,5738,43422,8,310182
17148,0.00135,172.31.36.0-255,66,43488,8,310182
17149,0.001358,74.125.24.0-255,1484,44972,8,310182
17150,0.001412,74.125.24.0-255,4320,49292,8,310182
17151,0.001424,74.125.24.0-255,2543,51835,8,310182
17152,0.001823,74.125.24.0-255,1484,53319,8,310182
17153,0.001831,74.125.24.0-255,2902,56221,8,310182
17154,0.001838,74.125.24.0-255,5738,61959,8,310182
17155,0.001861,74.125.24.0-255,1484,63443,8,310182
17156,0.001895,74.125.24.0-255,5738,69181,8,310182
17157,0.001909,74.125.24.0-255,4320,73501,8,310182
17158,0.001911,74.125.24.0-255,766,74267,8,310182
17159,0.001952,74.125.24.0-255,1484,75751,8,310182
17160,0.00197,74.125.24.0-255,4320,80071,8,310182
17161,0.001991,74.125.24.0-255,5738,85809,8,310182
17162,0.001994,74.125.24.0-255,1484,87293,8,310182
17163,0.0021,74.125.24.0-255,1484,88777,8,310182
17164,0.002119,74.125.24.0-255,2902,91679,8,310182
17165,0.002124,74.125.24.0-255,2902,94581,8,310182
17166,0.00214,74.125.24.0-255,2902,97483,8,310182
17167,0.002145,74.125.24.0-255,2902,100385,8,310182
17168,0.002161,74.125.24.0-255,7156,107541,8,310182
17169,0.002184,74.125.24.0-255,4320,111861,8,310182
17170,0.002369,74.125.24.0-255,1484,113345,8,310182
17171,0.002377,74.125.24.0-255,2902,116247,8,310182
17172,0.002394,74.125.24.0-255,5738,121985,8,310182
17173,0.002421,74.125.24.0-255,7156,129141,8,310182
17174,0.002441,74.125.24.0-255,2902,132043,8,310182
17175,0.00248,74.125.24.0-255,5738,137781,8,310182
17176,0.00254,74.125.24.0-255,1484,139265,8,310182
17177,0.002543,74.125.24.0-255,1484,140749,8,310182
17178,0.002561,74.125.24.0-255,1484,142233,8,310182
17179,0.002566,74.125.24.0-255,5738,147971,8,310182
17180,0.002588,74.125.24.0-255,5738,153709,8,310182
17181,0.002611,74.125.24.0-255,7156,160865,8,310182
17182,0.005949,172.31.36.0-255,66,160931,8,310182
17183,0.008573,74.125.24.0-255,5738,166669,8,310182
17184,0.00858,172.31.36.0-255,66,166735,8,310182
17185,0.011156,74.125.24.0-255,5738,172473,8,310182
17186,0.011163,172.31.36.0-255,66,172539,8,310182
17187,0.013738,74.125.24.0-255,5738,178277,8,310182
17188,0.013746,172.31.36.0-255,66,178343,8,310182
17189,0.016333,74.125.24.0-255,5738,184081,8,310182
17190,0.016345,172.31.36.0-255,66,184147,8,310182
17191,0.018949,74.125.24.0-255,5738,189885,8,310182
17192,0.01896,172.31.36.0-255,66,189951,8,310182
17193,0.021561,74.125.24.0-255,5738,195689,8,310182
17194,0.02157,172.31.36.0-255,66,195755,8,310182
17195,0.02415,74.125.24.0-255,5738,201493,8,310182
17196,0.02416,172.31.36.0-255,66,201559,8,310182
17197,0.02675,74.125.24.0-255,5738,207297,8,310182
17198,0.026759,172.31.36.0-255,66,207363,8,310182
17199,0.029342,74.125.24.0-255,5738,213101,8,310182
17200,0.02935,172.31.36.0-255,66,213167,8,310182
17201,0.031965,74.125.24.0-255,5738,218905,8,310182
17202,0.031972,172.31.36.0-255,66,218971,8,310182
17203,0.034579,74.125.24.0-255,5738,224709,8,310182
17204,0.034591,172.31.36.0-255,66,224775,8,310182
17205,0.037202,74.125.24.0-255,5738,230513,8,310182
17206,0.037213,172.31.36.0-255,66,230579,8,310182
17207,0.039795,74.125.24.0-255,5738,236317,8,310182
17208,0.039805,172.31.36.0-255,66,236383,8,310182
17209,0.042387,74.125.24.0-255,5738,242121,8,310182
17210,0.0424,172.31.36.0-255,66,242187,8,310182
17211,0.044976,74.125.24.0-255,5738,247925,8,310182
17212,0.044984,172.31.36.0-255,66,247991,8,310182
17213,0.04653,172.31.36.0-255,172,248163,8,310182
17214,0.046563,172.31.36.0-255,1111,249274,8,310182
17215,0.046625,172.31.36.0-255,1514,250788,8,310182
17216,0.046627,172.31.36.0-255,1514,252302,8,310182
17217,0.046633,172.31.36.0-255,1514,253816,8,310182
17218,0.046634,172.31.36.0-255,1514,255330,8,310182
17219,0.046651,172.31.36.0-255,1230,256560,8,310182
17220,0.047553,74.125.24.0-255,5738,262298,8,310182
17221,0.047561,172.31.36.0-255,66,262364,8,310182
17222,0.048092,104.244.42.0-255,66,262430,8,310182
17223,0.04812,104.244.42.0-255,66,262496,8,310182
17224,0.048177,104.244.42.0-255,66,262562,8,310182
17225,0.048183,104.244.42.0-255,66,262628,8,310182
17226,0.050151,74.125.24.0-255,2902,265530,8,310182
17227,0.050157,172.31.36.0-255,66,265596,8,310182
17228,0.050191,74.125.24.0-255,2902,268498,8,310182
17229,0.050218,172.31.36.0-255,66,268564,8,310182
17230,0.052737,74.125.24.0-255,2902,271466,8,310182
17231,0.052744,172.31.36.0-255,66,271532,8,310182
17232,0.052797,74.125.24.0-255,2902,274434,8,310182
17233,0.052831,172.31.36.0-255,66,274500,8,310182
17234,0.055322,74.125.24.0-255,2902,277402,8,310182
17235,0.055328,172.31.36.0-255,66,277468,8,310182
17236,0.055408,74.125.24.0-255,2902,280370,8,310182
17237,0.055432,172.31.36.0-255,66,280436,8,310182
17238,0.057913,74.125.24.0-255,2902,283338,8,310182
17239,0.057925,172.31.36.0-255,66,283404,8,310182
17240,0.058021,74.125.24.0-255,2902,286306,8,310182
17241,0.058049,172.31.36.0-255,66,286372,8,310182
17242,0.060565,74.125.24.0-255,2902,289274,8,310182
17243,0.060572,172.31.36.0-255,66,289340,8,310182
17244,0.060604,74.125.24.0-255,2902,292242,8,310182
17245,0.060634,172.31.36.0-255,66,292308,8,310182
17246,0.063156,74.125.24.0-255,2902,295210,8,310182
17247,0.063163,172.31.36.0-255,66,295276,8,310182
17248,0.063193,74.125.24.0-255,2902,298178,8,310182
17249,0.063222,172.31.36.0-255,66,298244,8,310182
17250,0.065741,74.125.24.0-255,2902,301146,8,310182
17251,0.065749,172.31.36.0-255,66,301212,8,310182
17252,0.065776,74.125.24.0-255,1484,302696,8,310182
17253,0.065795,74.125.24.0-255,1484,304180,8,310182
17254,0.065813,172.31.36.0-255,66,304246,8,310182
17255,0.068327,74.125.24.0-255,2902,307148,8,310182
17256,0.068335,172.31.36.0-255,66,307214,8,310182
17257,0.068368,74.125.24.0-255,2902,310116,8,310182
17258,0.068398,172.31.36.0-255,66,310182,8,310182
17259,0.0,172.217.26.0-255,297,297,8,309777
17260,1.5e-05,172.31.36.0-255,66,363,8,309777
17261,2e-05,172.217.26.0-255,1484,1847,8,309777
17262,2.3e-05,172.31.36.0-255,66,1913,8,309777
17263,2.8e-05,172.217.26.0-255,2902,4815,8,309777
17264,3e-05,172.31.36.0-255,66,4881,8,309777
17265,6e-05,172.217.26.0-255,5738,10619,8,309777
17266,6.3e-05,172.31.36.0-255,66,10685,8,309777
17267,8.5e-05,172.217.26.0-255,3259,13944,8,309777
17268,8.8e-05,172.31.36.0-255,66,14010,8,309777
17269,9.2e-05,172.217.26.0-255,4320,18330,8,309777
17270,9.4e-05,172.31.36.0-255,66,18396,8,309777
17271,0.000109,172.217.26.0-255,2902,21298,8,309777
17272,0.000111,172.31.36.0-255,66,21364,8,309777
17273,0.000127,172.217.26.0-255,7156,28520,8,309777
17274,0.00013,172.31.36.0-255,66,28586,8,309777
17275,0.000133,172.217.26.0-255,2543,31129,8,309777
17276,0.000135,172.31.36.0-255,66,31195,8,309777
17277,0.000252,172.217.26.0-255,1484,32679,8,309777
17278,0.000255,172.31.36.0-255,66,32745,8,309777
17279,0.00026,172.217.26.0-255,2902,35647,8,309777
17280,0.000262,172.31.36.0-255,66,35713,8,309777
17281,0.000266,172.217.26.0-255,2902,38615,8,309777
17282,0.000268,172.31.36.0-255,66,38681,8,309777
17283,0.000294,172.217.26.0-255,2902,41583,8,309777
17284,0.000296,172.31.36.0-255,66,41649,8,309777
17285,0.000302,172.217.26.0-255,5738,47387,8,309777
17286,0.000304,172.31.36.0-255,66,47453,8,309777
17287,0.000311,172.217.26.0-255,6797,54250,8,309777
17288,0.000313,172.31.36.0-255,66,54316,8,309777
17289,0.000346,172.31.36.0-255,66,54382,8,309777
17290,0.000363,172.217.26.0-255,1484,55866,8,309777
17291,0.000378,172.217.26.0-255,1432,57298,8,309777
17292,0.000381,172.31.36.0-255,66,57364,8,309777
17293,0.001315,172.217.26.0-255,115,57479,8,309777
17294,0.001344,172.31.36.0-255,66,57545,8,309777
17295,0.001421,172.217.26.0-255,1484,59029,8,309777
17296,0.001429,172.217.26.0-255,2902,61931,8,309777
17297,0.001432,172.31.36.0-255,66,61997,8,309777
17298,0.001435,172.217.26.0-255,1484,63481,8,309777
17299,0.001448,172.217.26.0-255,4320,67801,8,309777
17300,0.001451,172.31.36.0-255,66,67867,8,309777
17301,0.001455,172.217.26.0-255,2902,70769,8,309777
17302,0.001457,172.31.36.0-255,66,70835,8,309777
17303,0.001483,172.217.26.0-255,3961,74796,8,309777
17304,0.001486,172.31.36.0-255,66,74862,8,309777
17305,0.001498,172.217.26.0-255,1484,76346,8,309777
17306,0.001501,172.217.26.0-255,1484,77830,8,309777
17307,0.001503,172.31.36.0-255,66,77896,8,309777
17308,0.001526,172.217.26.0-255,1484,79380,8,309777
17309,0.001533,172.217.26.0-255,5738,85118,8,309777
17310,0.001535,172.31.36.0-255,66,85184,8,309777
17311,0.001538,172.217.26.0-255,1484,86668,8,309777
17312,0.001559,172.217.26.0-255,5379,92047,8,309777
17313,0.001561,172.31.36.0-255,66,92113,8,309777
17314,0.001861,172.217.26.0-255,1484,93597,8,309777
17315,0.001867,172.217.26.0-255,2902,96499,8,309777
17316,0.00187,172.31.36.0-255,66,96565,8,309777
17317,0.001898,172.217.26.0-255,2902,99467,8,309777
17318,0.001901,172.31.36.0-255,66,99533,8,309777
17319,0.001922,172.217.26.0-255,1484,101017,8,309777
17320,0.001946,172.217.26.0-255,2902,103919,8,309777
17321,0.001948,172.31.36.0-255,66,103985,8,309777
17322,0.001954,172.217.26.0-255,5738,109723,8,309777
17323,0.001956,172.31.36.0-255,66,109789,8,309777
17324,0.001965,172.31.36.0-255,66,109855,8,309777
17325,0.00197,172.217.26.0-255,5020,114875,8,309777
17326,0.001972,172.31.36.0-255,66,114941,8,309777
17327,0.00393,172.217.26.0-255,5738,120679,8,309777
17328,0.003935,172.31.36.0-255,66,120745,8,309777
17329,0.005906,172.217.26.0-255,5738,126483,8,309777
17330,0.005911,172.31.36.0-255,66,126549,8,309777
17331,0.007903,172.217.26.0-255,4320,130869,8,309777
17332,0.00791,172.31.36.0-255,66,130935,8,309777
17333,0.00793,172.217.26.0-255,1484,132419,8,309777
17334,0.009912,172.217.26.0-255,4320,136739,8,309777
17335,0.009919,172.31.36.0-255,66,136805,8,309777
17336,0.01191,172.217.26.0-255,5738,142543,8,309777
17337,0.011917,172.31.36.0-255,66,142609,8,309777
17338,0.013915,172.217.26.0-255,5738,148347,8,309777
17339,0.013924,172.31.36.0-255,66,148413,8,309777
17340,0.015906,172.217.26.0-255,5738,154151,8,309777
17341,0.015913,172.31.36.0-255,66,154217,8,309777
17342,0.017892,172.217.26.0-255,5738,159955,8,309777
17343,0.017899,172.31.36.0-255,66,160021,8,309777
17344,0.019873,172.217.26.0-255,5738,165759,8,309777
17345,0.019879,172.31.36.0-255,66,165825,8,309777
17346,0.021858,172.217.26.0-255,5738,171563,8,309777
17347,0.021864,172.31.36.0-255,66,171629,8,309777
17348,0.023845,172.217.26.0-255,5738,177367,8,309777
17349,0.023852,172.31.36.0-255,66,177433,8,309777
17350,0.025818,172.217.26.0-255,5738,183171,8,309777
17351,0.025826,172.31.36.0-255,66,183237,8,309777
17352,0.027108,172.31.36.0-255,172,183409,8,309777
17353,0.027151,172.31.36.0-255,1110,184519,8,309777
17354,0.027223,172.31.36.0-255,1428,185947,8,309777
17355,0.027814,172.217.26.0-255,5738,191685,8,309777
17356,0.02782,172.31.36.0-255,66,191751,8,309777
17357,0.028659,104.244.42.0-255,66,191817,8,309777
17358,0.028703,104.244.42.0-255,66,191883,8,309777
17359,0.028797,104.244.42.0-255,66,191949,8,309777
17360,0.029791,172.217.26.0-255,5738,197687,8,309777
17361,0.029799,172.31.36.0-255,66,197753,8,309777
17362,0.031768,172.217.26.0-255,5738,203491,8,309777
17363,0.031774,172.31.36.0-255,66,203557,8,309777
17364,0.033742,172.217.26.0-255,4320,207877,8,309777
17365,0.033748,172.31.36.0-255,66,207943,8,309777
17366,0.033779,172.217.26.0-255,1484,209427,8,309777
17367,0.035712,172.217.26.0-255,4320,213747,8,309777
17368,0.035718,172.31.36.0-255,66,213813,8,309777
17369,0.037682,172.217.26.0-255,4320,218133,8,309777
17370,0.037687,172.31.36.0-255,66,218199,8,309777
17371,0.037714,172.217.26.0-255,1484,219683,8,309777
17372,0.039654,172.217.26.0-255,4320,224003,8,309777
17373,0.03966,172.31.36.0-255,66,224069,8,309777
17374,0.041626,172.217.26.0-255,5738,229807,8,309777
17375,0.041631,172.31.36.0-255,66,229873,8,309777
17376,0.043612,172.217.26.0-255,5738,235611,8,309777
17377,0.043617,172.31.36.0-255,66,235677,8,309777
17378,0.045591,172.217.26.0-255,5738,241415,8,309777
17379,0.0456,172.31.36.0-255,66,241481,8,309777
17380,0.047571,172.217.26.0-255,5738,247219,8,309777
17381,0.047576,172.31.36.0-255,66,247285,8,309777
17382,0.049538,172.217.26.0-255,5738,253023,8,309777
17383,0.049543,172.31.36.0-255,66,253089,8,309777
17384,0.051507,172.217.26.0-255,5738,258827,8,309777
17385,0.051512,172.31.36.0-255,66,258893,8,309777
17386,0.05347,172.217.26.0-255,5738,264631,8,309777
17387,0.053474,172.31.36.0-255,66,264697,8,309777
17388,0.055454,172.217.26.0-255,5738,270435,8,309777
17389,0.05546,172.31.36.0-255,66,270501,8,309777
17390,0.057459,172.217.26.0-255,5738,276239,8,309777
17391,0.057466,172.31.36.0-255,66,276305,8,309777
17392,0.059433,172.217.26.0-255,5738,282043,8,309777
17393,0.059441,172.31.36.0-255,66,282109,8,309777
17394,0.061406,172.217.26.0-255,4320,286429,8,309777
17395,0.061413,172.31.36.0-255,66,286495,8,309777
17396,0.061445,172.217.26.0-255,1484,287979,8,309777
17397,0.063379,172.217.26.0-255,4320,292299,8,309777
17398,0.063384,172.31.36.0-255,66,292365,8,309777
17399,0.065369,172.217.26.0-255,5738,298103,8,309777
17400,0.065374,172.31.36.0-255,66,298169,8,309777
17401,0.067347,172.217.26.0-255,5738,303907,8,309777
17402,0.067351,172.31.36.0-255,66,303973,8,309777
17403,0.06932,172.217.26.0-255,5738,309711,8,309777
17404,0.069325,172.31.36.0-255,66,309777,8,309777
17405,0.0,172.217.194.0-255,153,153,8,210543
17406,2.4e-05,172.31.36.0-255,66,219,8,210543
17407,3.2e-05,172.217.194.0-255,1484,1703,8,210543
17408,3.6e-05,172.31.36.0-255,66,1769,8,210543
17409,4.2e-05,172.217.194.0-255,2902,4671,8,210543
17410,4.6e-05,172.31.36.0-255,66,4737,8,210543
17411,0.000117,172.217.194.0-255,4320,9057,8,210543
17412,0.00012,172.31.36.0-255,66,9123,8,210543
17413,0.000139,172.217.194.0-255,2902,12025,8,210543
17414,0.000142,172.31.36.0-255,66,12091,8,210543
17415,0.000347,172.217.194.0-255,2018,14109,8,210543
17416,0.000354,172.31.36.0-255,66,14175,8,210543
17417,0.000414,172.217.194.0-255,2902,17077,8,210543
17418,0.000418,172.31.36.0-255,66,17143,8,210543
17419,0.000497,172.217.194.0-255,5738,22881,8,210543
17420,0.000502,172.31.36.0-255,66,22947,8,210543
17421,0.00052,172.217.194.0-255,1484,24431,8,210543
17422,0.000522,172.31.36.0-255,66,24497,8,210543
17423,0.000728,172.217.194.0-255,4320,28817,8,210543
17424,0.000733,172.31.36.0-255,66,28883,8,210543
17425,0.000764,172.31.36.0-255,66,28949,8,210543
17426,0.001244,172.31.36.0-255,66,29015,8,210543
17427,0.001274,172.31.36.0-255,66,29081,8,210543
17428,0.002059,172.31.36.0-255,66,29147,8,210543
17429,0.0021,172.31.36.0-255,66,29213,8,210543
17430,0.003007,172.217.194.0-255,5738,34951,8,210543
17431,0.003012,172.31.36.0-255,66,35017,8,210543
17432,0.003057,172.217.194.0-255,5319,40336,8,210543
17433,0.003818,172.217.194.0-255,7156,47492,8,210543
17434,0.005569,172.31.36.0-255,66,47558,8,210543
17435,0.007845,172.217.194.0-255,1484,49042,8,210543
17436,0.007864,172.217.194.0-255,4320,53362,8,210543
17437,0.007869,172.31.36.0-255,66,53428,8,210543
17438,0.010204,172.217.194.0-255,5738,59166,8,210543
17439,0.010381,172.31.36.0-255,66,59232,8,210543
17440,0.012668,172.217.194.0-255,5738,64970,8,210543
17441,0.012678,172.31.36.0-255,66,65036,8,210543
17442,0.014958,172.217.194.0-255,5738,70774,8,210543
17443,0.014968,172.31.36.0-255,66,70840,8,210543
17444,0.017262,172.217.194.0-255,5738,76578,8,210543
17445,0.017271,172.31.36.0-255,66,76644,8,210543
17446,0.019563,172.217.194.0-255,5738,82382,8,210543
17447,0.019571,172.31.36.0-255,66,82448,8,210543
17448,0.021922,172.217.194.0-255,5738,88186,8,210543
17449,0.021929,172.31.36.0-255,66,88252,8,210543
17450,0.024228,172.217.194.0-255,5738,93990,8,210543
17451,0.024236,172.31.36.0-255,66,94056,8,210543
17452,0.026532,172.217.194.0-255,5738,99794,8,210543
17453,0.026541,172.31.36.0-255,66,99860,8,210543
17454,0.02883,172.217.194.0-255,5738,105598,8,210543
17455,0.028837,172.31.36.0-255,66,105664,8,210543
17456,0.031115,172.217.194.0-255,5738,111402,8,210543
17457,0.031124,172.31.36.0-255,66,111468,8,210543
17458,0.033418,172.217.194.0-255,4320,115788,8,210543
17459,0.033426,172.31.36.0-255,66,115854,8,210543
17460,0.033456,172.217.194.0-255,1484,117338,8,210543
17461,0.034367,172.31.36.0-255,172,117510,8,210543
17462,0.034404,172.31.36.0-255,1112,118622,8,210543
17463,0.034475,172.31.36.0-255,1514,120136,8,210543
17464,0.034477,172.31.36.0-255,1514,121650,8,210543
17465,0.034482,172.31.36.0-255,1514,123164,8,210543
17466,0.034483,172.31.36.0-255,771,123935,8,210543
17467,0.035724,172.217.194.0-255,4320,128255,8,210543
17468,0.035732,172.31.36.0-255,66,128321,8,210543
17469,0.035932,104.244.42.0-255,66,128387,8,210543
17470,0.036115,104.244.42.0-255,66,128453,8,210543
17471,0.036149,104.244.42.0-255,66,128519,8,210543
17472,0.036153,104.244.42.0-255,66,128585,8,210543
17473,0.036749,104.244.42.0-255,108,128693,8,210543
17474,0.036759,172.31.36.0-255,66,128759,8,210543
17475,0.038001,172.217.194.0-255,5738,134497,8,210543
17476,0.038034,172.31.36.0-255,66,134563,8,210543
17477,0.040334,172.217.194.0-255,5738,140301,8,210543
17478,0.040345,172.31.36.0-255,66,140367,8,210543
17479,0.042648,172.217.194.0-255,5738,146105,8,210543
17480,0.042655,172.31.36.0-255,66,146171,8,210543
17481,0.044957,172.217.194.0-255,5738,151909,8,210543
17482,0.044965,172.31.36.0-255,66,151975,8,210543
17483,0.047243,172.217.194.0-255,5738,157713,8,210543
17484,0.047251,172.31.36.0-255,66,157779,8,210543
17485,0.04956,172.217.194.0-255,5738,163517,8,210543
17486,0.049571,172.31.36.0-255,66,163583,8,210543
17487,0.05187,172.217.194.0-255,5738,169321,8,210543
17488,0.051878,172.31.36.0-255,66,169387,8,210543
17489,0.054194,172.217.194.0-255,5738,175125,8,210543
17490,0.054201,172.31.36.0-255,66,175191,8,210543
17491,0.056483,172.217.194.0-255,5738,180929,8,210543
17492,0.056489,172.31.36.0-255,66,180995,8,210543
17493,0.05877,172.217.194.0-255,5738,186733,8,210543
17494,0.058777,172.31.36.0-255,66,186799,8,210543
17495,0.061073,172.217.194.0-255,2902,189701,8,210543
17496,0.061079,172.31.36.0-255,66,189767,8,210543
17497,0.0611,172.217.194.0-255,2902,192669,8,210543
17498,0.061124,172.31.36.0-255,66,192735,8,210543
17499,0.063347,172.217.194.0-255,2902,195637,8,210543
17500,0.063354,172.31.36.0-255,66,195703,8,210543
17501,0.063404,172.217.194.0-255,2902,198605,8,210543
17502,0.063439,172.31.36.0-255,66,198671,8,210543
17503,0.065637,172.217.194.0-255,2902,201573,8,210543
17504,0.065643,172.31.36.0-255,66,201639,8,210543
17505,0.065712,172.217.194.0-255,2902,204541,8,210543
17506,0.065729,172.31.36.0-255,66,204607,8,210543
17507,0.067905,172.217.194.0-255,2902,207509,8,210543
17508,0.067908,172.31.36.0-255,66,207575,8,210543
17509,0.068012,172.217.194.0-255,2902,210477,8,210543
17510,0.068016,172.31.36.0-255,66,210543,8,210543
17511,0.0,172.217.194.0-255,145,145,8,303702
17512,7.3e-05,172.31.36.0-255,66,211,8,303702
17513,8e-05,172.217.194.0-255,1484,1695,8,303702
17514,8.6e-05,172.31.36.0-255,66,1761,8,303702
17515,9.1e-05,172.217.194.0-255,2902,4663,8,303702
17516,9.4e-05,172.31.36.0-255,66,4729,8,303702
17517,0.000101,172.217.194.0-255,5738,10467,8,303702
17518,0.000104,172.31.36.0-255,66,10533,8,303702
17519,0.000129,172.217.194.0-255,3453,13986,8,303702
17520,0.000131,172.31.36.0-255,66,14052,8,303702
17521,0.000159,172.217.194.0-255,1484,15536,8,303702
17522,0.000162,172.31.36.0-255,66,15602,8,303702
17523,0.000177,172.217.194.0-255,2902,18504,8,303702
17524,0.000181,172.31.36.0-255,66,18570,8,303702
17525,0.0002,172.217.194.0-255,4320,22890,8,303702
17526,0.000203,172.31.36.0-255,66,22956,8,303702
17527,0.000227,172.217.194.0-255,1484,24440,8,303702
17528,0.000229,172.31.36.0-255,66,24506,8,303702
17529,0.000235,172.217.194.0-255,4320,28826,8,303702
17530,0.000238,172.31.36.0-255,66,28892,8,303702
17531,0.000268,172.31.36.0-255,66,28958,8,303702
17532,0.000275,172.217.194.0-255,5738,34696,8,303702
17533,0.000277,172.31.36.0-255,66,34762,8,303702
17534,0.0003,172.217.194.0-255,4320,39082,8,303702
17535,0.000305,172.31.36.0-255,66,39148,8,303702
17536,0.00033,172.217.194.0-255,5379,44527,8,303702
17537,0.000334,172.31.36.0-255,66,44593,8,303702
17538,0.000339,172.217.194.0-255,4320,48913,8,303702
17539,0.000342,172.31.36.0-255,66,48979,8,303702
17540,0.000357,172.217.194.0-255,4320,53299,8,303702
17541,0.000361,172.31.36.0-255,66,53365,8,303702
17542,0.000376,172.217.194.0-255,1484,54849,8,303702
17543,0.000383,172.217.194.0-255,2543,57392,8,303702
17544,0.000386,172.31.36.0-255,66,57458,8,303702
17545,0.000789,172.217.194.0-255,645,58103,8,303702
17546,0.000829,172.31.36.0-255,66,58169,8,303702
17547,0.000899,172.217.194.0-255,1484,59653,8,303702
17548,0.000928,172.217.194.0-255,2902,62555,8,303702
17549,0.000932,172.31.36.0-255,66,62621,8,303702
17550,0.000938,172.217.194.0-255,4320,66941,8,303702
17551,0.000941,172.31.36.0-255,66,67007,8,303702
17552,0.000966,172.217.194.0-255,1484,68491,8,303702
17553,0.000974,172.217.194.0-255,5738,74229,8,303702
17554,0.000977,172.31.36.0-255,66,74295,8,303702
17555,0.001007,172.217.194.0-255,7156,81451,8,303702
17556,0.001011,172.31.36.0-255,66,81517,8,303702
17557,0.001018,172.217.194.0-255,7156,88673,8,303702
17558,0.00102,172.31.36.0-255,66,88739,8,303702
17559,0.001037,172.217.194.0-255,1484,90223,8,303702
17560,0.001059,172.217.194.0-255,2184,92407,8,303702
17561,0.001063,172.31.36.0-255,66,92473,8,303702
17562,0.001389,172.217.194.0-255,1484,93957,8,303702
17563,0.001395,172.217.194.0-255,2902,96859,8,303702
17564,0.0014,172.31.36.0-255,66,96925,8,303702
17565,0.001408,172.217.194.0-255,5738,102663,8,303702
17566,0.00141,172.31.36.0-255,66,102729,8,303702
17567,0.001416,172.217.194.0-255,4320,107049,8,303702
17568,0.001418,172.31.36.0-255,66,107115,8,303702
17569,0.001446,172.217.194.0-255,1484,108599,8,303702
17570,0.001454,172.217.194.0-255,7156,115755,8,303702
17571,0.001457,172.31.36.0-255,66,115821,8,303702
17572,0.001481,172.217.194.0-255,5738,121559,8,303702
17573,0.001484,172.31.36.0-255,66,121625,8,303702
17574,0.00149,172.217.194.0-255,5020,126645,8,303702
17575,0.001493,172.31.36.0-255,66,126711,8,303702
17576,0.001497,172.217.194.0-255,1484,128195,8,303702
17577,0.001525,172.217.194.0-255,5738,133933,8,303702
17578,0.00153,172.217.194.0-255,5738,139671,8,303702
17579,0.001533,172.31.36.0-255,66,139737,8,303702
17580,0.001541,172.31.36.0-255,66,139803,8,303702
17581,0.001545,172.217.194.0-255,2902,142705,8,303702
17582,0.001548,172.31.36.0-255,66,142771,8,303702
17583,0.001551,172.217.194.0-255,1484,144255,8,303702
17584,0.001584,172.31.36.0-255,66,144321,8,303702
17585,0.001603,172.217.194.0-255,4320,148641,8,303702
17586,0.001605,172.31.36.0-255,66,148707,8,303702
17587,0.001608,172.217.194.0-255,766,149473,8,303702
17588,0.002026,172.217.194.0-255,1484,150957,8,303702
17589,0.002031,172.31.36.0-255,66,151023,8,303702
17590,0.002051,172.217.194.0-255,2902,153925,8,303702
17591,0.002053,172.31.36.0-255,66,153991,8,303702
17592,0.002056,172.217.194.0-255,1484,155475,8,303702
17593,0.002073,172.217.194.0-255,4320,159795,8,303702
17594,0.002076,172.31.36.0-255,66,159861,8,303702
17595,0.00208,172.217.194.0-255,2902,162763,8,303702
17596,0.002082,172.31.36.0-255,66,162829,8,303702
17597,0.002111,172.31.36.0-255,66,162895,8,303702
17598,0.002167,172.31.36.0-255,66,162961,8,303702
17599,0.002295,172.217.194.0-255,1484,164445,8,303702
17600,0.002301,172.217.194.0-255,2902,167347,8,303702
17601,0.002305,172.31.36.0-255,66,167413,8,303702
17602,0.002359,172.217.194.0-255,5738,173151,8,303702
17603,0.002363,172.31.36.0-255,66,173217,8,303702
17604,0.002375,172.31.36.0-255,66,173283,8,303702
17605,0.002388,172.217.194.0-255,1484,174767,8,303702
17606,0.002399,172.31.36.0-255,66,174833,8,303702
17607,0.002424,172.217.194.0-255,766,175599,8,303702
17608,0.00251,172.217.194.0-255,1484,177083,8,303702
17609,0.002514,172.31.36.0-255,66,177149,8,303702
17610,0.002518,172.217.194.0-255,2902,180051,8,303702
17611,0.00252,172.31.36.0-255,66,180117,8,303702
17612,0.002543,172.217.194.0-255,5738,185855,8,303702
17613,0.002545,172.31.36.0-255,66,185921,8,303702
17614,0.002596,172.31.36.0-255,66,185987,8,303702
17615,0.002599,172.217.194.0-255,1484,187471,8,303702
17616,0.002626,172.31.36.0-255,66,187537,8,303702
17617,0.002643,172.217.194.0-255,5020,192557,8,303702
17618,0.002647,172.31.36.0-255,66,192623,8,303702
17619,0.002661,172.31.36.0-255,66,192689,8,303702
17620,0.002689,172.217.194.0-255,2902,195591,8,303702
17621,0.002692,172.31.36.0-255,66,195657,8,303702
17622,0.002706,172.31.36.0-255,66,195723,8,303702
17623,0.002724,172.217.194.0-255,4320,200043,8,303702
17624,0.002727,172.31.36.0-255,66,200109,8,303702
17625,0.002766,172.31.36.0-255,66,200175,8,303702
17626,0.003404,172.31.36.0-255,101,200276,8,303702
17627,0.005436,172.217.194.0-255,5738,206014,8,303702
17628,0.005441,172.31.36.0-255,66,206080,8,303702
17629,0.005995,172.217.194.0-255,66,206146,8,303702
17630,0.008089,172.217.194.0-255,5738,211884,8,303702
17631,0.008096,172.31.36.0-255,66,211950,8,303702
17632,0.010788,172.217.194.0-255,5738,217688,8,303702
17633,0.010798,172.31.36.0-255,66,217754,8,303702
17634,0.013457,172.217.194.0-255,5738,223492,8,303702
17635,0.01347,172.31.36.0-255,66,223558,8,303702
17636,0.01613,172.217.194.0-255,5738,229296,8,303702
17637,0.01614,172.31.36.0-255,66,229362,8,303702
17638,0.018803,172.217.194.0-255,5738,235100,8,303702
17639,0.018813,172.31.36.0-255,66,235166,8,303702
17640,0.021477,172.217.194.0-255,5738,240904,8,303702
17641,0.021484,172.31.36.0-255,66,240970,8,303702
17642,0.024117,172.217.194.0-255,5738,246708,8,303702
17643,0.024125,172.31.36.0-255,66,246774,8,303702
17644,0.0255,172.31.36.0-255,167,246941,8,303702
17645,0.025542,172.31.36.0-255,1112,248053,8,303702
17646,0.025614,172.31.36.0-255,1514,249567,8,303702
17647,0.025617,172.31.36.0-255,1292,250859,8,303702
17648,0.026754,172.217.194.0-255,5738,256597,8,303702
17649,0.02676,172.31.36.0-255,66,256663,8,303702
17650,0.027081,104.244.42.0-255,66,256729,8,303702
17651,0.027124,104.244.42.0-255,66,256795,8,303702
17652,0.027166,104.244.42.0-255,66,256861,8,303702
17653,0.02941,172.217.194.0-255,2902,259763,8,303702
17654,0.029414,172.31.36.0-255,66,259829,8,303702
17655,0.029444,172.217.194.0-255,2902,262731,8,303702
17656,0.029447,172.31.36.0-255,66,262797,8,303702
17657,0.032052,172.217.194.0-255,2902,265699,8,303702
17658,0.032059,172.31.36.0-255,66,265765,8,303702
17659,0.032091,172.217.194.0-255,2902,268667,8,303702
17660,0.032095,172.31.36.0-255,66,268733,8,303702
17661,0.034708,172.217.194.0-255,2902,271635,8,303702
17662,0.034714,172.31.36.0-255,66,271701,8,303702
17663,0.034742,172.217.194.0-255,1484,273185,8,303702
17664,0.034756,172.217.194.0-255,1484,274669,8,303702
17665,0.034759,172.31.36.0-255,66,274735,8,303702
17666,0.037394,172.217.194.0-255,2902,277637,8,303702
17667,0.037399,172.31.36.0-255,66,277703,8,303702
17668,0.037432,172.217.194.0-255,2902,280605,8,303702
17669,0.037435,172.31.36.0-255,66,280671,8,303702
17670,0.040039,172.217.194.0-255,2902,283573,8,303702
17671,0.040044,172.31.36.0-255,66,283639,8,303702
17672,0.040087,172.217.194.0-255,2902,286541,8,303702
17673,0.040091,172.31.36.0-255,66,286607,8,303702
17674,0.0427,172.217.194.0-255,2902,289509,8,303702
17675,0.042705,172.31.36.0-255,66,289575,8,303702
17676,0.042738,172.217.194.0-255,2902,292477,8,303702
17677,0.042741,172.31.36.0-255,66,292543,8,303702
17678,0.045364,172.217.194.0-255,2902,295445,8,303702
17679,0.04537,172.31.36.0-255,66,295511,8,303702
17680,0.045402,172.217.194.0-255,2902,298413,8,303702
17681,0.045406,172.31.36.0-255,66,298479,8,303702
17682,0.048036,172.217.194.0-255,2902,301381,8,303702
17683,0.048041,172.31.36.0-255,66,301447,8,303702
17684,0.048071,172.217.194.0-255,2018,303465,8,303702
17685,0.048074,172.31.36.0-255,66,303531,8,303702
17686,0.048239,172.31.36.0-255,105,303636,8,303702
17687,0.054935,172.217.194.0-255,66,303702,8,303702
17688,0.0,74.125.24.0-255,153,153,8,275256
17689,2.8e-05,172.31.36.0-255,66,219,8,275256
17690,3.5e-05,74.125.24.0-255,1484,1703,8,275256
17691,3.9e-05,172.31.36.0-255,66,1769,8,275256
17692,4.4e-05,74.125.24.0-255,2902,4671,8,275256
17693,4.6e-05,172.31.36.0-255,66,4737,8,275256
17694,5.3e-05,74.125.24.0-255,7156,11893,8,275256
17695,5.6e-05,172.31.36.0-255,66,11959,8,275256
17696,5.9e-05,74.125.24.0-255,1484,13443,8,275256
17697,6.2e-05,172.31.36.0-255,66,13509,8,275256
17698,8.2e-05,74.125.24.0-255,602,14111,8,275256
17699,8.4e-05,172.31.36.0-255,66,14177,8,275256
17700,0.000163,74.125.24.0-255,1484,15661,8,275256
17701,0.000168,172.31.36.0-255,66,15727,8,275256
17702,0.000175,74.125.24.0-255,2902,18629,8,275256
17703,0.000178,172.31.36.0-255,66,18695,8,275256
17704,0.000183,74.125.24.0-255,4320,23015,8,275256
17705,0.000185,172.31.36.0-255,66,23081,8,275256
17706,0.0002,74.125.24.0-255,1484,24565,8,275256
17707,0.000203,172.31.36.0-255,66,24631,8,275256
17708,0.00023,74.125.24.0-255,1484,26115,8,275256
17709,0.000232,172.31.36.0-255,66,26181,8,275256
17710,0.000255,74.125.24.0-255,5379,31560,8,275256
17711,0.000258,172.31.36.0-255,66,31626,8,275256
17712,0.000275,74.125.24.0-255,1484,33110,8,275256
17713,0.000277,172.31.36.0-255,66,33176,8,275256
17714,0.000282,74.125.24.0-255,2902,36078,8,275256
17715,0.000284,172.31.36.0-255,66,36144,8,275256
17716,0.000302,74.125.24.0-255,5738,41882,8,275256
17717,0.000305,172.31.36.0-255,66,41948,8,275256
17718,0.000311,74.125.24.0-255,5738,47686,8,275256
17719,0.000314,172.31.36.0-255,66,47752,8,275256
17720,0.000335,74.125.24.0-255,1125,48877,8,275256
17721,0.000647,172.31.36.0-255,66,48943,8,275256
17722,0.000819,74.125.24.0-255,1484,50427,8,275256
17723,0.000829,74.125.24.0-255,2902,53329,8,275256
17724,0.000833,172.31.36.0-255,66,53395,8,275256
17725,0.00084,74.125.24.0-255,4320,57715,8,275256
17726,0.000842,172.31.36.0-255,66,57781,8,275256
17727,0.000856,74.125.24.0-255,1484,59265,8,275256
17728,0.000868,74.125.24.0-255,1484,60749,8,275256
17729,0.00087,172.31.36.0-255,66,60815,8,275256
17730,0.000892,74.125.24.0-255,5379,66194,8,275256
17731,0.000895,172.31.36.0-255,66,66260,8,275256
17732,0.001294,74.125.24.0-255,1484,67744,8,275256
17733,0.001302,74.125.24.0-255,2902,70646,8,275256
17734,0.001307,172.31.36.0-255,66,70712,8,275256
17735,0.001314,74.125.24.0-255,5738,76450,8,275256
17736,0.001316,172.31.36.0-255,66,76516,8,275256
17737,0.00133,74.125.24.0-255,5738,82254,8,275256
17738,0.001332,172.31.36.0-255,66,82320,8,275256
17739,0.001345,74.125.24.0-255,4320,86640,8,275256
17740,0.001348,172.31.36.0-255,66,86706,8,275256
17741,0.00139,74.125.24.0-255,5738,92444,8,275256
17742,0.001393,172.31.36.0-255,66,92510,8,275256
17743,0.001419,172.31.36.0-255,66,92576,8,275256
17744,0.003675,74.125.24.0-255,5738,98314,8,275256
17745,0.003679,172.31.36.0-255,66,98380,8,275256
17746,0.005924,74.125.24.0-255,5738,104118,8,275256
17747,0.005929,172.31.36.0-255,66,104184,8,275256
17748,0.008186,74.125.24.0-255,5738,109922,8,275256
17749,0.008193,172.31.36.0-255,66,109988,8,275256
17750,0.010429,74.125.24.0-255,5738,115726,8,275256
17751,0.010436,172.31.36.0-255,66,115792,8,275256
17752,0.012682,74.125.24.0-255,5738,121530,8,275256
17753,0.012689,172.31.36.0-255,66,121596,8,275256
17754,0.014937,74.125.24.0-255,5738,127334,8,275256
17755,0.014946,172.31.36.0-255,66,127400,8,275256
17756,0.017167,74.125.24.0-255,5738,133138,8,275256
17757,0.017174,172.31.36.0-255,66,133204,8,275256
17758,0.019425,74.125.24.0-255,5738,138942,8,275256
17759,0.019432,172.31.36.0-255,66,139008,8,275256
17760,0.021666,74.125.24.0-255,5738,144746,8,275256
17761,0.021671,172.31.36.0-255,66,144812,8,275256
17762,0.0239,74.125.24.0-255,5738,150550,8,275256
17763,0.023906,172.31.36.0-255,66,150616,8,275256
17764,0.026138,74.125.24.0-255,5738,156354,8,275256
17765,0.026144,172.31.36.0-255,66,156420,8,275256
17766,0.028369,74.125.24.0-255,5738,162158,8,275256
17767,0.028375,172.31.36.0-255,66,162224,8,275256
17768,0.030584,74.125.24.0-255,5738,167962,8,275256
17769,0.030591,172.31.36.0-255,66,168028,8,275256
17770,0.030661,172.31.36.0-255,172,168200,8,275256
17771,0.030689,172.31.36.0-255,1112,169312,8,275256
17772,0.030741,172.31.36.0-255,1514,170826,8,275256
17773,0.030742,172.31.36.0-255,1514,172340,8,275256
17774,0.030747,172.31.36.0-255,1514,173854,8,275256
17775,0.030748,172.31.36.0-255,1514,175368,8,275256
17776,0.030765,172.31.36.0-255,1514,176882,8,275256
17777,0.030766,172.31.36.0-255,794,177676,8,275256
17778,0.032184,104.244.42.0-255,66,177742,8,275256
17779,0.032255,104.244.42.0-255,66,177808,8,275256
17780,0.032315,104.244.42.0-255,66,177874,8,275256
17781,0.032343,104.244.42.0-255,66,177940,8,275256
17782,0.032837,74.125.24.0-255,5738,183678,8,275256
17783,0.032842,172.31.36.0-255,66,183744,8,275256
17784,0.035055,74.125.24.0-255,5738,189482,8,275256
17785,0.035061,172.31.36.0-255,66,189548,8,275256
17786,0.037305,74.125.24.0-255,5738,195286,8,275256
17787,0.03731,172.31.36.0-255,66,195352,8,275256
17788,0.039572,74.125.24.0-255,5738,201090,8,275256
17789,0.039593,172.31.36.0-255,66,201156,8,275256
17790,0.041837,74.125.24.0-255,5738,206894,8,275256
17791,0.041843,172.31.36.0-255,66,206960,8,275256
17792,0.044088,74.125.24.0-255,5738,212698,8,275256
17793,0.044094,172.31.36.0-255,66,212764,8,275256
17794,0.046348,74.125.24.0-255,5738,218502,8,275256
17795,0.046354,172.31.36.0-255,66,218568,8,275256
17796,0.048611,74.125.24.0-255,5738,224306,8,275256
17797,0.048618,172.31.36.0-255,66,224372,8,275256
17798,0.050834,74.125.24.0-255,5738,230110,8,275256
17799,0.050839,172.31.36.0-255,66,230176,8,275256
17800,0.053047,74.125.24.0-255,4320,234496,8,275256
17801,0.053052,172.31.36.0-255,66,234562,8,275256
17802,0.053078,74.125.24.0-255,1484,236046,8,275256
17803,0.055329,74.125.24.0-255,4320,240366,8,275256
17804,0.055335,172.31.36.0-255,66,240432,8,275256
17805,0.057591,74.125.24.0-255,5738,246170,8,275256
17806,0.057598,172.31.36.0-255,66,246236,8,275256
17807,0.060035,74.125.24.0-255,5738,251974,8,275256
17808,0.060042,172.31.36.0-255,66,252040,8,275256
17809,0.062283,74.125.24.0-255,5738,257778,8,275256
17810,0.062289,172.31.36.0-255,66,257844,8,275256
17811,0.064548,74.125.24.0-255,5738,263582,8,275256
17812,0.064553,172.31.36.0-255,66,263648,8,275256
17813,0.066778,74.125.24.0-255,5738,269386,8,275256
17814,0.066783,172.31.36.0-255,66,269452,8,275256
17815,0.069005,74.125.24.0-255,5738,275190,8,275256
17816,0.06901,172.31.36.0-255,66,275256,8,275256
17817,0.0,74.125.68.0-255,153,153,8,316703
17818,2.4e-05,172.31.36.0-255,66,219,8,316703
17819,4.1e-05,74.125.68.0-255,1484,1703,8,316703
17820,5.2e-05,172.31.36.0-255,66,1769,8,316703
17821,5.8e-05,74.125.68.0-255,2902,4671,8,316703
17822,6e-05,172.31.36.0-255,66,4737,8,316703
17823,0.000102,74.125.68.0-255,5738,10475,8,316703
17824,0.000107,172.31.36.0-255,66,10541,8,316703
17825,0.000116,74.125.68.0-255,1484,12025,8,316703
17826,0.000118,172.31.36.0-255,66,12091,8,316703
17827,0.000122,74.125.68.0-255,2015,14106,8,316703
17828,0.000124,172.31.36.0-255,66,14172,8,316703
17829,0.000248,74.125.68.0-255,1484,15656,8,316703
17830,0.000253,172.31.36.0-255,66,15722,8,316703
17831,0.000284,74.125.68.0-255,2902,18624,8,316703
17832,0.000288,172.31.36.0-255,66,18690,8,316703
17833,0.000318,74.125.68.0-255,4320,23010,8,316703
17834,0.000322,172.31.36.0-255,66,23076,8,316703
17835,0.00035,74.125.68.0-255,4320,27396,8,316703
17836,0.000353,172.31.36.0-255,66,27462,8,316703
17837,0.00038,74.125.68.0-255,2902,30364,8,316703
17838,0.000384,172.31.36.0-255,66,30430,8,316703
17839,0.00039,74.125.68.0-255,4320,34750,8,316703
17840,0.000392,172.31.36.0-255,66,34816,8,316703
17841,0.000417,74.125.68.0-255,3961,38777,8,316703
17842,0.000425,172.31.36.0-255,66,38843,8,316703
17843,0.00043,74.125.68.0-255,4320,43163,8,316703
17844,0.000432,172.31.36.0-255,66,43229,8,316703
17845,0.000438,74.125.68.0-255,4320,47549,8,316703
17846,0.000442,172.31.36.0-255,66,47615,8,316703
17847,0.000486,172.31.36.0-255,66,47681,8,316703
17848,0.000492,74.125.68.0-255,5738,53419,8,316703
17849,0.000495,74.125.68.0-255,2184,55603,8,316703
17850,0.000495,172.31.36.0-255,66,55669,8,316703
17851,0.000499,172.31.36.0-255,66,55735,8,316703
17852,0.000531,74.125.68.0-255,427,56162,8,316703
17853,0.000836,172.31.36.0-255,66,56228,8,316703
17854,0.000837,74.125.68.0-255,1484,57712,8,316703
17855,0.00084,74.125.68.0-255,1484,59196,8,316703
17856,0.000842,172.31.36.0-255,66,59262,8,316703
17857,0.000846,74.125.68.0-255,1484,60746,8,316703
17858,0.000875,74.125.68.0-255,1484,62230,8,316703
17859,0.000878,172.31.36.0-255,66,62296,8,316703
17860,0.000885,74.125.68.0-255,5738,68034,8,316703
17861,0.000888,172.31.36.0-255,66,68100,8,316703
17862,0.000897,74.125.68.0-255,1484,69584,8,316703
17863,0.000924,74.125.68.0-255,2902,72486,8,316703
17864,0.000928,172.31.36.0-255,66,72552,8,316703
17865,0.000955,74.125.68.0-255,5738,78290,8,316703
17866,0.000958,172.31.36.0-255,66,78356,8,316703
17867,0.000985,74.125.68.0-255,7156,85512,8,316703
17868,0.000988,172.31.36.0-255,66,85578,8,316703
17869,0.001016,74.125.68.0-255,4721,90299,8,316703
17870,0.00102,172.31.36.0-255,66,90365,8,316703
17871,0.001072,74.125.68.0-255,1484,91849,8,316703
17872,0.001079,74.125.68.0-255,2902,94751,8,316703
17873,0.001082,172.31.36.0-255,66,94817,8,316703
17874,0.001098,74.125.68.0-255,1484,96301,8,316703
17875,0.001121,74.125.68.0-255,4320,100621,8,316703
17876,0.001124,172.31.36.0-255,66,100687,8,316703
17877,0.001131,74.125.68.0-255,7156,107843,8,316703
17878,0.001134,172.31.36.0-255,66,107909,8,316703
17879,0.001165,172.31.36.0-255,66,107975,8,316703
17880,0.001194,74.125.68.0-255,4320,112295,8,316703
17881,0.001197,172.31.36.0-255,66,112361,8,316703
17882,0.001202,74.125.68.0-255,3602,115963,8,316703
17883,0.001204,172.31.36.0-255,66,116029,8,316703
17884,0.00319,74.125.68.0-255,5738,121767,8,316703
17885,0.003196,172.31.36.0-255,66,121833,8,316703
17886,0.005182,74.125.68.0-255,2902,124735,8,316703
17887,0.005187,172.31.36.0-255,66,124801,8,316703
17888,0.005222,74.125.68.0-255,2902,127703,8,316703
17889,0.005225,172.31.36.0-255,66,127769,8,316703
17890,0.007181,74.125.68.0-255,2902,130671,8,316703
17891,0.007188,172.31.36.0-255,66,130737,8,316703
17892,0.007223,74.125.68.0-255,2902,133639,8,316703
17893,0.007226,172.31.36.0-255,66,133705,8,316703
17894,0.009172,74.125.68.0-255,2902,136607,8,316703
17895,0.009179,172.31.36.0-255,66,136673,8,316703
17896,0.009217,74.125.68.0-255,2902,139575,8,316703
17897,0.009221,172.31.36.0-255,66,139641,8,316703
17898,0.011187,74.125.68.0-255,4320,143961,8,316703
17899,0.011193,172.31.36.0-255,66,144027,8,316703
17900,0.011254,74.125.68.0-255,1484,145511,8,316703
17901,0.013172,74.125.68.0-255,4320,149831,8,316703
17902,0.013179,172.31.36.0-255,66,149897,8,316703
17903,0.015174,74.125.68.0-255,5738,155635,8,316703
17904,0.015182,172.31.36.0-255,66,155701,8,316703
17905,0.017167,74.125.68.0-255,5738,161439,8,316703
17906,0.017175,172.31.36.0-255,66,161505,8,316703
17907,0.019174,74.125.68.0-255,5738,167243,8,316703
17908,0.01919,172.31.36.0-255,66,167309,8,316703
17909,0.021193,74.125.68.0-255,5738,173047,8,316703
17910,0.021205,172.31.36.0-255,66,173113,8,316703
17911,0.0232,74.125.68.0-255,5738,178851,8,316703
17912,0.023208,172.31.36.0-255,66,178917,8,316703
17913,0.02519,74.125.68.0-255,5738,184655,8,316703
17914,0.025197,172.31.36.0-255,66,184721,8,316703
17915,0.027194,74.125.68.0-255,5738,190459,8,316703
17916,0.027201,172.31.36.0-255,66,190525,8,316703
17917,0.029197,74.125.68.0-255,5738,196263,8,316703
17918,0.029205,172.31.36.0-255,66,196329,8,316703
17919,0.031235,74.125.68.0-255,5738,202067,8,316703
17920,0.031244,172.31.36.0-255,66,202133,8,316703
17921,0.033243,74.125.68.0-255,5738,207871,8,316703
17922,0.033251,172.31.36.0-255,66,207937,8,316703
17923,0.03525,74.125.68.0-255,5738,213675,8,316703
17924,0.035257,172.31.36.0-255,66,213741,8,316703
17925,0.037247,74.125.68.0-255,5738,219479,8,316703
17926,0.037254,172.31.36.0-255,66,219545,8,316703
17927,0.039243,74.125.68.0-255,5738,225283,8,316703
17928,0.039251,172.31.36.0-255,66,225349,8,316703
17929,0.041245,74.125.68.0-255,5738,231087,8,316703
17930,0.041253,172.31.36.0-255,66,231153,8,316703
17931,0.042046,172.31.36.0-255,210,231363,8,316703
17932,0.042075,172.31.36.0-255,955,232318,8,316703
17933,0.04214,172.31.36.0-255,1514,233832,8,316703
17934,0.042142,172.31.36.0-255,1184,235016,8,316703
17935,0.043243,74.125.68.0-255,5738,240754,8,316703
17936,0.043252,172.31.36.0-255,66,240820,8,316703
17937,0.043402,172.31.36.0-255,101,240921,8,316703
17938,0.043624,104.244.42.0-255,66,240987,8,316703
17939,0.043666,104.244.42.0-255,66,241053,8,316703
17940,0.043708,104.244.42.0-255,66,241119,8,316703
17941,0.045243,74.125.68.0-255,5738,246857,8,316703
17942,0.04525,172.31.36.0-255,66,246923,8,316703
17943,0.045343,74.125.68.0-255,66,246989,8,316703
17944,0.047246,74.125.68.0-255,5738,252727,8,316703
17945,0.047255,172.31.36.0-255,66,252793,8,316703
17946,0.04924,74.125.68.0-255,5738,258531,8,316703
17947,0.049262,172.31.36.0-255,66,258597,8,316703
17948,0.051253,74.125.68.0-255,5738,264335,8,316703
17949,0.051259,172.31.36.0-255,66,264401,8,316703
17950,0.053241,74.125.68.0-255,5738,270139,8,316703
17951,0.053248,172.31.36.0-255,66,270205,8,316703
17952,0.055234,74.125.68.0-255,5738,275943,8,316703
17953,0.055241,172.31.36.0-255,66,276009,8,316703
17954,0.057218,74.125.68.0-255,5738,281747,8,316703
17955,0.057225,172.31.36.0-255,66,281813,8,316703
17956,0.059212,74.125.68.0-255,5738,287551,8,316703
17957,0.059218,172.31.36.0-255,66,287617,8,316703
17958,0.061202,74.125.68.0-255,5738,293355,8,316703
17959,0.061209,172.31.36.0-255,66,293421,8,316703
17960,0.063197,74.125.68.0-255,5738,299159,8,316703
17961,0.063207,172.31.36.0-255,66,299225,8,316703
17962,0.065185,74.125.68.0-255,5738,304963,8,316703
17963,0.065191,172.31.36.0-255,66,305029,8,316703
17964,0.06718,74.125.68.0-255,5738,310767,8,316703
17965,0.067186,172.31.36.0-255,66,310833,8,316703
17966,0.06917,74.125.68.0-255,4320,315153,8,316703
17967,0.069175,172.31.36.0-255,66,315219,8,316703
17968,0.069205,74.125.68.0-255,1484,316703,8,316703
17969,0.0,172.217.194.0-255,153,153,8,261353
17970,3.1e-05,172.31.36.0-255,66,219,8,261353
17971,3.8e-05,172.217.194.0-255,1484,1703,8,261353
17972,4.3e-05,172.31.36.0-255,66,1769,8,261353
17973,4.8e-05,172.217.194.0-255,2902,4671,8,261353
17974,5e-05,172.31.36.0-255,66,4737,8,261353
17975,6.5e-05,172.217.194.0-255,5738,10475,8,261353
17976,6.7e-05,172.31.36.0-255,66,10541,8,261353
17977,0.000115,172.217.194.0-255,3430,13971,8,261353
17978,0.000118,172.31.36.0-255,66,14037,8,261353
17979,0.000179,172.217.194.0-255,1484,15521,8,261353
17980,0.000183,172.31.36.0-255,66,15587,8,261353
17981,0.000188,172.217.194.0-255,2902,18489,8,261353
17982,0.00019,172.31.36.0-255,66,18555,8,261353
17983,0.000216,172.217.194.0-255,5738,24293,8,261353
17984,0.000223,172.31.36.0-255,66,24359,8,261353
17985,0.000251,172.217.194.0-255,7156,31515,8,261353
17986,0.000255,172.31.36.0-255,66,31581,8,261353
17987,0.000287,172.217.194.0-255,3961,35542,8,261353
17988,0.000291,172.31.36.0-255,66,35608,8,261353
17989,0.000304,172.31.36.0-255,66,35674,8,261353
17990,0.000329,172.31.36.0-255,66,35740,8,261353
17991,0.000332,172.217.194.0-255,368,36108,8,261353
17992,0.000334,172.31.36.0-255,66,36174,8,261353
17993,0.000493,172.217.194.0-255,1484,37658,8,261353
17994,0.000499,172.31.36.0-255,66,37724,8,261353
17995,0.000519,172.217.194.0-255,2902,40626,8,261353
17996,0.000522,172.31.36.0-255,66,40692,8,261353
17997,0.000529,172.217.194.0-255,5738,46430,8,261353
17998,0.000532,172.31.36.0-255,66,46496,8,261353
17999,0.000534,172.217.194.0-255,1484,47980,8,261353
18000,0.000565,172.217.194.0-255,1484,49464,8,261353
18001,0.000582,172.31.36.0-255,66,49530,8,261353
18002,0.000603,172.217.194.0-255,3961,53491,8,261353
18003,0.000608,172.31.36.0-255,66,53557,8,261353
18004,0.00122,172.217.194.0-255,1484,55041,8,261353
18005,0.00123,172.217.194.0-255,2902,57943,8,261353
18006,0.001235,172.31.36.0-255,66,58009,8,261353
18007,0.001243,172.217.194.0-255,5738,63747,8,261353
18008,0.001248,172.217.194.0-255,4320,68067,8,261353
18009,0.001272,172.217.194.0-255,1484,69551,8,261353
18010,0.001306,172.217.194.0-255,2902,72453,8,261353
18011,0.001349,172.217.194.0-255,2902,75355,8,261353
18012,0.001369,172.217.194.0-255,2184,77539,8,261353
18013,0.001376,172.217.194.0-255,5738,83277,8,261353
18014,0.001412,172.217.194.0-255,2902,86179,8,261353
18015,0.001458,172.217.194.0-255,5738,91917,8,261353
18016,0.00148,172.217.194.0-255,6438,98355,8,261353
18017,0.001525,172.217.194.0-255,1484,99839,8,261353
18018,0.001528,172.217.194.0-255,1484,101323,8,261353
18019,0.00154,172.217.194.0-255,1484,102807,8,261353
18020,0.001601,172.217.194.0-255,5738,108545,8,261353
18021,0.001625,172.217.194.0-255,7156,115701,8,261353
18022,0.001658,172.217.194.0-255,4320,120021,8,261353
18023,0.001678,172.217.194.0-255,7156,127177,8,261353
18024,0.001731,172.217.194.0-255,6438,133615,8,261353
18025,0.001737,172.217.194.0-255,7156,140771,8,261353
18026,0.001762,172.217.194.0-255,2902,143673,8,261353
18027,0.001811,172.217.194.0-255,4320,147993,8,261353
18028,0.001836,172.217.194.0-255,6438,154431,8,261353
18029,0.001913,172.217.194.0-255,1484,155915,8,261353
18030,0.001924,172.217.194.0-255,2902,158817,8,261353
18031,0.001945,172.217.194.0-255,5738,164555,8,261353
18032,0.001959,172.217.194.0-255,2902,167457,8,261353
18033,0.001974,172.217.194.0-255,5738,173195,8,261353
18034,0.00203,172.217.194.0-255,4320,177515,8,261353
18035,0.002151,172.217.194.0-255,1484,178999,8,261353
18036,0.002157,172.217.194.0-255,2902,181901,8,261353
18037,0.002181,172.217.194.0-255,5738,187639,8,261353
18038,0.002223,172.217.194.0-255,1484,189123,8,261353
18039,0.002253,172.217.194.0-255,1484,190607,8,261353
18040,0.002301,172.217.194.0-255,7156,197763,8,261353
18041,0.002316,172.217.194.0-255,766,198529,8,261353
18042,0.002337,172.217.194.0-255,4320,202849,8,261353
18043,0.002394,172.217.194.0-255,7156,210005,8,261353
18044,0.002399,172.31.36.0-255,66,210071,8,261353
18045,0.002405,172.31.36.0-255,66,210137,8,261353
18046,0.002408,172.217.194.0-255,6438,216575,8,261353
18047,0.002433,172.31.36.0-255,66,216641,8,261353
18048,0.002452,172.217.194.0-255,1484,218125,8,261353
18049,0.002481,172.217.194.0-255,4320,222445,8,261353
18050,0.002485,172.31.36.0-255,66,222511,8,261353
18051,0.004839,172.217.194.0-255,5738,228249,8,261353
18052,0.004844,172.31.36.0-255,66,228315,8,261353
18053,0.00719,172.217.194.0-255,5738,234053,8,261353
18054,0.009188,172.31.36.0-255,66,234119,8,261353
18055,0.01155,172.217.194.0-255,5738,239857,8,261353
18056,0.011557,172.31.36.0-255,66,239923,8,261353
18057,0.013908,172.217.194.0-255,5738,245661,8,261353
18058,0.013916,172.31.36.0-255,66,245727,8,261353
18059,0.016277,172.217.194.0-255,5738,251465,8,261353
18060,0.016284,172.31.36.0-255,66,251531,8,261353
18061,0.018623,172.217.194.0-255,1640,253171,8,261353
18062,0.01863,172.31.36.0-255,66,253237,8,261353
18063,0.01881,172.31.36.0-255,105,253342,8,261353
18064,0.021134,172.217.194.0-255,66,253408,8,261353
18065,0.033532,172.31.36.0-255,172,253580,8,261353
18066,0.033568,172.31.36.0-255,1113,254693,8,261353
18067,0.033614,172.31.36.0-255,1514,256207,8,261353
18068,0.033616,172.31.36.0-255,1514,257721,8,261353
18069,0.033622,172.31.36.0-255,1514,259235,8,261353
18070,0.033623,172.31.36.0-255,1514,260749,8,261353
18071,0.033642,172.31.36.0-255,166,260915,8,261353
18072,0.035127,104.244.42.0-255,66,260981,8,261353
18073,0.035182,104.244.42.0-255,66,261047,8,261353
18074,0.035211,104.244.42.0-255,66,261113,8,261353
18075,0.035213,104.244.42.0-255,66,261179,8,261353
18076,0.036545,104.244.42.0-255,108,261287,8,261353
18077,0.03655,172.31.36.0-255,66,261353,8,261353
18078,0.0,74.125.24.0-255,153,153,8,213368
18079,1.8e-05,172.31.36.0-255,66,219,8,213368
18080,2.5e-05,74.125.24.0-255,1484,1703,8,213368
18081,3e-05,172.31.36.0-255,66,1769,8,213368
18082,3.6e-05,74.125.24.0-255,2902,4671,8,213368
18083,5.1e-05,172.31.36.0-255,66,4737,8,213368
18084,6e-05,74.125.24.0-255,7156,11893,8,213368
18085,6.2e-05,172.31.36.0-255,66,11959,8,213368
18086,6.7e-05,74.125.24.0-255,2902,14861,8,213368
18087,7e-05,172.31.36.0-255,66,14927,8,213368
18088,0.000107,172.31.36.0-255,66,14993,8,213368
18089,0.000114,74.125.24.0-255,6797,21790,8,213368
18090,0.000117,172.31.36.0-255,66,21856,8,213368
18091,0.000202,74.125.24.0-255,1484,23340,8,213368
18092,0.000206,172.31.36.0-255,66,23406,8,213368
18093,0.000225,74.125.24.0-255,2902,26308,8,213368
18094,0.000228,172.31.36.0-255,66,26374,8,213368
18095,0.000233,74.125.24.0-255,2902,29276,8,213368
18096,0.000235,172.31.36.0-255,66,29342,8,213368
18097,0.000261,74.125.24.0-255,2902,32244,8,213368
18098,0.000264,172.31.36.0-255,66,32310,8,213368
18099,0.000269,74.125.24.0-255,2902,35212,8,213368
18100,0.000271,172.31.36.0-255,66,35278,8,213368
18101,0.000303,172.31.36.0-255,66,35344,8,213368
18102,0.000355,74.125.24.0-255,4320,39664,8,213368
18103,0.000359,172.31.36.0-255,66,39730,8,213368
18104,0.000388,74.125.24.0-255,5690,45420,8,213368
18105,0.000391,172.31.36.0-255,66,45486,8,213368
18106,0.000496,74.125.24.0-255,110,45596,8,213368
18107,0.000501,172.31.36.0-255,66,45662,8,213368
18108,0.000518,74.125.24.0-255,331,45993,8,213368
18109,0.000728,74.125.24.0-255,1484,47477,8,213368
18110,0.000733,172.31.36.0-255,66,47543,8,213368
18111,0.000739,74.125.24.0-255,2902,50445,8,213368
18112,0.000742,172.31.36.0-255,66,50511,8,213368
18113,0.000767,74.125.24.0-255,2902,53413,8,213368
18114,0.000772,172.31.36.0-255,66,53479,8,213368
18115,0.000782,74.125.24.0-255,4320,57799,8,213368
18116,0.000785,172.31.36.0-255,66,57865,8,213368
18117,0.00082,74.125.24.0-255,2902,60767,8,213368
18118,0.000822,172.31.36.0-255,66,60833,8,213368
18119,0.000829,74.125.24.0-255,5738,66571,8,213368
18120,0.000832,172.31.36.0-255,66,66637,8,213368
18121,0.000882,172.31.36.0-255,66,66703,8,213368
18122,0.002323,74.125.24.0-255,1484,68187,8,213368
18123,0.00233,74.125.24.0-255,1484,69671,8,213368
18124,0.002334,172.31.36.0-255,66,69737,8,213368
18125,0.002356,74.125.24.0-255,4320,74057,8,213368
18126,0.002359,172.31.36.0-255,66,74123,8,213368
18127,0.002363,74.125.24.0-255,2902,77025,8,213368
18128,0.002365,172.31.36.0-255,66,77091,8,213368
18129,0.002394,74.125.24.0-255,4320,81411,8,213368
18130,0.002396,172.31.36.0-255,66,81477,8,213368
18131,0.002432,74.125.24.0-255,5738,87215,8,213368
18132,0.002434,172.31.36.0-255,66,87281,8,213368
18133,0.002461,172.31.36.0-255,66,87347,8,213368
18134,0.002464,74.125.24.0-255,1484,88831,8,213368
18135,0.00247,74.125.24.0-255,3602,92433,8,213368
18136,0.002472,172.31.36.0-255,66,92499,8,213368
18137,0.002537,74.125.24.0-255,1484,93983,8,213368
18138,0.002549,74.125.24.0-255,2902,96885,8,213368
18139,0.002552,172.31.36.0-255,66,96951,8,213368
18140,0.002584,74.125.24.0-255,5738,102689,8,213368
18141,0.002586,172.31.36.0-255,66,102755,8,213368
18142,0.002593,74.125.24.0-255,5738,108493,8,213368
18143,0.002596,172.31.36.0-255,66,108559,8,213368
18144,0.002633,74.125.24.0-255,7156,115715,8,213368
18145,0.002636,172.31.36.0-255,66,115781,8,213368
18146,0.002648,172.31.36.0-255,66,115847,8,213368
18147,0.002656,74.125.24.0-255,7156,123003,8,213368
18148,0.002658,172.31.36.0-255,66,123069,8,213368
18149,0.002687,74.125.24.0-255,4320,127389,8,213368
18150,0.00269,172.31.36.0-255,66,127455,8,213368
18151,0.002692,74.125.24.0-255,1484,128939,8,213368
18152,0.002706,172.31.36.0-255,66,129005,8,213368
18153,0.002713,74.125.24.0-255,6438,135443,8,213368
18154,0.002716,172.31.36.0-255,66,135509,8,213368
18155,0.002787,74.125.24.0-255,4320,139829,8,213368
18156,0.00279,172.31.36.0-255,66,139895,8,213368
18157,0.002796,74.125.24.0-255,5738,145633,8,213368
18158,0.002799,172.31.36.0-255,66,145699,8,213368
18159,0.002812,172.31.36.0-255,66,145765,8,213368
18160,0.00282,74.125.24.0-255,7156,152921,8,213368
18161,0.002822,172.31.36.0-255,66,152987,8,213368
18162,0.002853,74.125.24.0-255,5020,158007,8,213368
18163,0.002856,172.31.36.0-255,66,158073,8,213368
18164,0.002859,74.125.24.0-255,1484,159557,8,213368
18165,0.002864,74.125.24.0-255,2902,162459,8,213368
18166,0.002867,172.31.36.0-255,66,162525,8,213368
18167,0.002871,74.125.24.0-255,2902,165427,8,213368
18168,0.002873,172.31.36.0-255,66,165493,8,213368
18169,0.002908,74.125.24.0-255,2902,168395,8,213368
18170,0.002911,172.31.36.0-255,66,168461,8,213368
18171,0.002929,172.31.36.0-255,66,168527,8,213368
18172,0.002932,74.125.24.0-255,1484,170011,8,213368
18173,0.002939,74.125.24.0-255,5738,175749,8,213368
18174,0.002942,172.31.36.0-255,66,175815,8,213368
18175,0.002983,172.31.36.0-255,66,175881,8,213368
18176,0.002987,74.125.24.0-255,1484,177365,8,213368
18177,0.002989,74.125.24.0-255,1484,178849,8,213368
18178,0.002992,172.31.36.0-255,66,178915,8,213368
18179,0.003006,172.31.36.0-255,66,178981,8,213368
18180,0.003009,74.125.24.0-255,1484,180465,8,213368
18181,0.003026,74.125.24.0-255,7156,187621,8,213368
18182,0.003028,172.31.36.0-255,66,187687,8,213368
18183,0.003065,74.125.24.0-255,5020,192707,8,213368
18184,0.003124,74.125.24.0-255,4320,197027,8,213368
18185,0.003225,74.125.24.0-255,3602,200629,8,213368
18186,0.003841,74.125.24.0-255,1484,202113,8,213368
18187,0.003854,74.125.24.0-255,2902,205015,8,213368
18188,0.003857,74.125.24.0-255,797,205812,8,213368
18189,0.003943,74.125.24.0-255,105,205917,8,213368
18190,0.005542,172.31.36.0-255,66,205983,8,213368
18191,0.01021,172.31.36.0-255,105,206088,8,213368
18192,0.01232,74.125.24.0-255,66,206154,8,213368
18193,0.036836,172.31.36.0-255,525,206679,8,213368
18194,0.036871,172.31.36.0-255,1113,207792,8,213368
18195,0.036933,172.31.36.0-255,1514,209306,8,213368
18196,0.036935,172.31.36.0-255,1514,210820,8,213368
18197,0.036941,172.31.36.0-255,1514,212334,8,213368
18198,0.036943,172.31.36.0-255,770,213104,8,213368
18199,0.038452,104.244.42.0-255,66,213170,8,213368
18200,0.038462,104.244.42.0-255,66,213236,8,213368
18201,0.038527,104.244.42.0-255,66,213302,8,213368
18202,0.038533,104.244.42.0-255,66,213368,8,213368
18203,0.0,172.31.36.0-255,247,247,8,313
18204,0.006428,172.217.194.0-255,66,313,8,313
18205,0.0,74.125.24.0-255,152,152,8,341078
18206,2.5e-05,172.31.36.0-255,66,218,8,341078
18207,3.2e-05,74.125.24.0-255,1484,1702,8,341078
18208,3.5e-05,172.31.36.0-255,66,1768,8,341078
18209,4e-05,74.125.24.0-255,2902,4670,8,341078
18210,5.1e-05,172.31.36.0-255,66,4736,8,341078
18211,7.5e-05,74.125.24.0-255,4320,9056,8,341078
18212,7.8e-05,172.31.36.0-255,66,9122,8,341078
18213,8.1e-05,74.125.24.0-255,1484,10606,8,341078
18214,8.3e-05,172.31.36.0-255,66,10672,8,341078
18215,0.000116,74.125.24.0-255,3466,14138,8,341078
18216,0.00012,172.31.36.0-255,66,14204,8,341078
18217,0.000126,74.125.24.0-255,4320,18524,8,341078
18218,0.000129,172.31.36.0-255,66,18590,8,341078
18219,0.000169,74.125.24.0-255,7156,25746,8,341078
18220,0.000173,172.31.36.0-255,66,25812,8,341078
18221,0.000179,74.125.24.0-255,5379,31191,8,341078
18222,0.000182,172.31.36.0-255,66,31257,8,341078
18223,0.000376,74.125.24.0-255,1484,32741,8,341078
18224,0.000381,172.31.36.0-255,66,32807,8,341078
18225,0.000388,74.125.24.0-255,2902,35709,8,341078
18226,0.00039,172.31.36.0-255,66,35775,8,341078
18227,0.000419,74.125.24.0-255,5738,41513,8,341078
18228,0.000425,172.31.36.0-255,66,41579,8,341078
18229,0.000427,74.125.24.0-255,7156,48735,8,341078
18230,0.00043,172.31.36.0-255,66,48801,8,341078
18231,0.000452,74.125.24.0-255,1484,50285,8,341078
18232,0.000455,172.31.36.0-255,66,50351,8,341078
18233,0.000511,172.31.36.0-255,66,50417,8,341078
18234,0.000517,74.125.24.0-255,2184,52601,8,341078
18235,0.000519,172.31.36.0-255,66,52667,8,341078
18236,0.000522,74.125.24.0-255,401,53068,8,341078
18237,0.000649,74.125.24.0-255,342,53410,8,341078
18238,0.000805,172.31.36.0-255,66,53476,8,341078
18239,0.001128,74.125.24.0-255,1484,54960,8,341078
18240,0.001139,74.125.24.0-255,2902,57862,8,341078
18241,0.001143,172.31.36.0-255,66,57928,8,341078
18242,0.001152,74.125.24.0-255,5738,63666,8,341078
18243,0.001155,172.31.36.0-255,66,63732,8,341078
18244,0.001192,172.31.36.0-255,66,63798,8,341078
18245,0.001224,74.125.24.0-255,4320,68118,8,341078
18246,0.001227,172.31.36.0-255,66,68184,8,341078
18247,0.001234,74.125.24.0-255,5738,73922,8,341078
18248,0.001237,172.31.36.0-255,66,73988,8,341078
18249,0.001243,74.125.24.0-255,5020,79008,8,341078
18250,0.001245,172.31.36.0-255,66,79074,8,341078
18251,0.001281,74.125.24.0-255,5738,84812,8,341078
18252,0.001284,172.31.36.0-255,66,84878,8,341078
18253,0.001293,74.125.24.0-255,7156,92034,8,341078
18254,0.001295,172.31.36.0-255,66,92100,8,341078
18255,0.001324,74.125.24.0-255,5738,97838,8,341078
18256,0.001327,172.31.36.0-255,66,97904,8,341078
18257,0.001333,74.125.24.0-255,5738,103642,8,341078
18258,0.001336,172.31.36.0-255,66,103708,8,341078
18259,0.001369,74.125.24.0-255,4320,108028,8,341078
18260,0.001373,172.31.36.0-255,66,108094,8,341078
18261,0.001401,74.125.24.0-255,5020,113114,8,341078
18262,0.001405,172.31.36.0-255,66,113180,8,341078
18263,0.001624,74.125.24.0-255,1484,114664,8,341078
18264,0.001647,74.125.24.0-255,1484,116148,8,341078
18265,0.001651,172.31.36.0-255,66,116214,8,341078
18266,0.001676,74.125.24.0-255,1484,117698,8,341078
18267,0.00169,74.125.24.0-255,4320,122018,8,341078
18268,0.001693,172.31.36.0-255,66,122084,8,341078
18269,0.001719,74.125.24.0-255,2902,124986,8,341078
18270,0.001722,172.31.36.0-255,66,125052,8,341078
18271,0.001751,172.31.36.0-255,66,125118,8,341078
18272,0.001756,74.125.24.0-255,4320,129438,8,341078
18273,0.001758,172.31.36.0-255,66,129504,8,341078
18274,0.001778,74.125.24.0-255,4320,133824,8,341078
18275,0.00178,172.31.36.0-255,66,133890,8,341078
18276,0.001823,74.125.24.0-255,5020,138910,8,341078
18277,0.001826,172.31.36.0-255,66,138976,8,341078
18278,0.001962,74.125.24.0-255,1484,140460,8,341078
18279,0.002004,74.125.24.0-255,2902,143362,8,341078
18280,0.002007,172.31.36.0-255,66,143428,8,341078
18281,0.002033,74.125.24.0-255,4320,147748,8,341078
18282,0.002035,172.31.36.0-255,66,147814,8,341078
18283,0.002062,74.125.24.0-255,7156,154970,8,341078
18284,0.002064,172.31.36.0-255,66,155036,8,341078
18285,0.002085,74.125.24.0-255,1484,156520,8,341078
18286,0.002101,74.125.24.0-255,4320,160840,8,341078
18287,0.002104,172.31.36.0-255,66,160906,8,341078
18288,0.002122,74.125.24.0-255,1484,162390,8,341078
18289,0.002139,74.125.24.0-255,2902,165292,8,341078
18290,0.002141,172.31.36.0-255,66,165358,8,341078
18291,0.002175,74.125.24.0-255,5738,171096,8,341078
18292,0.002179,172.31.36.0-255,66,171162,8,341078
18293,0.002213,74.125.24.0-255,2184,173346,8,341078
18294,0.002217,172.31.36.0-255,66,173412,8,341078
18295,0.002493,172.31.36.0-255,101,173513,8,341078
18296,0.004513,74.125.24.0-255,5738,179251,8,341078
18297,0.004518,172.31.36.0-255,66,179317,8,341078
18298,0.004821,74.125.24.0-255,66,179383,8,341078
18299,0.006921,74.125.24.0-255,2902,182285,8,341078
18300,0.006927,172.31.36.0-255,66,182351,8,341078
18301,0.006965,74.125.24.0-255,2902,185253,8,341078
18302,0.006968,172.31.36.0-255,66,185319,8,341078
18303,0.009268,74.125.24.0-255,2902,188221,8,341078
18304,0.009275,172.31.36.0-255,66,188287,8,341078
18305,0.009322,74.125.24.0-255,2902,191189,8,341078
18306,0.009326,172.31.36.0-255,66,191255,8,341078
18307,0.01156,74.125.24.0-255,2902,194157,8,341078
18308,0.011568,172.31.36.0-255,66,194223,8,341078
18309,0.011627,74.125.24.0-255,2902,197125,8,341078
18310,0.011632,172.31.36.0-255,66,197191,8,341078
18311,0.013889,74.125.24.0-255,2902,200093,8,341078
18312,0.013897,172.31.36.0-255,66,200159,8,341078
18313,0.013976,74.125.24.0-255,2902,203061,8,341078
18314,0.013981,172.31.36.0-255,66,203127,8,341078
18315,0.016253,74.125.24.0-255,2902,206029,8,341078
18316,0.016264,172.31.36.0-255,66,206095,8,341078
18317,0.016306,74.125.24.0-255,2902,208997,8,341078
18318,0.016311,172.31.36.0-255,66,209063,8,341078
18319,0.018632,74.125.24.0-255,2902,211965,8,341078
18320,0.018638,172.31.36.0-255,66,212031,8,341078
18321,0.018672,74.125.24.0-255,2902,214933,8,341078
18322,0.018676,172.31.36.0-255,66,214999,8,341078
18323,0.021063,74.125.24.0-255,2902,217901,8,341078
18324,0.021071,172.31.36.0-255,66,217967,8,341078
18325,0.021112,74.125.24.0-255,2902,220869,8,341078
18326,0.021117,172.31.36.0-255,66,220935,8,341078
18327,0.023448,74.125.24.0-255,5738,226673,8,341078
18328,0.023455,172.31.36.0-255,66,226739,8,341078
18329,0.025819,74.125.24.0-255,5738,232477,8,341078
18330,0.025831,172.31.36.0-255,66,232543,8,341078
18331,0.028193,74.125.24.0-255,5738,238281,8,341078
18332,0.028202,172.31.36.0-255,66,238347,8,341078
18333,0.030542,74.125.24.0-255,5738,244085,8,341078
18334,0.03055,172.31.36.0-255,66,244151,8,341078
18335,0.032936,74.125.24.0-255,5738,249889,8,341078
18336,0.032943,172.31.36.0-255,66,249955,8,341078
18337,0.03531,74.125.24.0-255,5738,255693,8,341078
18338,0.035319,172.31.36.0-255,66,255759,8,341078
18339,0.037688,74.125.24.0-255,4320,260079,8,341078
18340,0.037694,172.31.36.0-255,66,260145,8,341078
18341,0.037728,74.125.24.0-255,1484,261629,8,341078
18342,0.040043,74.125.24.0-255,4320,265949,8,341078
18343,0.04005,172.31.36.0-255,66,266015,8,341078
18344,0.04237,74.125.24.0-255,5738,271753,8,341078
18345,0.042378,172.31.36.0-255,66,271819,8,341078
18346,0.044699,74.125.24.0-255,5738,277557,8,341078
18347,0.044708,172.31.36.0-255,66,277623,8,341078
18348,0.046393,172.31.36.0-255,172,277795,8,341078
18349,0.046423,172.31.36.0-255,1111,278906,8,341078
18350,0.046467,172.31.36.0-255,1514,280420,8,341078
18351,0.046469,172.31.36.0-255,1514,281934,8,341078
18352,0.04647,172.31.36.0-255,708,282642,8,341078
18353,0.047063,74.125.24.0-255,5738,288380,8,341078
18354,0.04707,172.31.36.0-255,66,288446,8,341078
18355,0.047965,104.244.42.0-255,66,288512,8,341078
18356,0.047974,104.244.42.0-255,66,288578,8,341078
18357,0.048008,104.244.42.0-255,66,288644,8,341078
18358,0.048012,104.244.42.0-255,66,288710,8,341078
18359,0.049383,74.125.24.0-255,5738,294448,8,341078
18360,0.049389,172.31.36.0-255,66,294514,8,341078
18361,0.05175,74.125.24.0-255,5738,300252,8,341078
18362,0.051756,172.31.36.0-255,66,300318,8,341078
18363,0.054111,74.125.24.0-255,5738,306056,8,341078
18364,0.054117,172.31.36.0-255,66,306122,8,341078
18365,0.056436,74.125.24.0-255,5738,311860,8,341078
18366,0.056442,172.31.36.0-255,66,311926,8,341078
18367,0.058809,74.125.24.0-255,2902,314828,8,341078
18368,0.058815,172.31.36.0-255,66,314894,8,341078
18369,0.058845,74.125.24.0-255,2902,317796,8,341078
18370,0.058849,172.31.36.0-255,66,317862,8,341078
18371,0.061149,74.125.24.0-255,5738,323600,8,341078
18372,0.061155,172.31.36.0-255,66,323666,8,341078
18373,0.063531,74.125.24.0-255,5738,329404,8,341078
18374,0.063536,172.31.36.0-255,66,329470,8,341078
18375,0.065903,74.125.24.0-255,5738,335208,8,341078
18376,0.06591,172.31.36.0-255,66,335274,8,341078
18377,0.068229,74.125.24.0-255,5738,341012,8,341078
18378,0.068235,172.31.36.0-255,66,341078,8,341078
18379,0.0,172.217.194.0-255,153,153,8,330380
18380,3.5e-05,172.31.36.0-255,66,219,8,330380
18381,4.2e-05,172.217.194.0-255,1484,1703,8,330380
18382,4.7e-05,172.31.36.0-255,66,1769,8,330380
18383,5.2e-05,172.217.194.0-255,2902,4671,8,330380
18384,5.4e-05,172.31.36.0-255,66,4737,8,330380
18385,6.1e-05,172.217.194.0-255,7156,11893,8,330380
18386,6.4e-05,172.31.36.0-255,66,11959,8,330380
18387,6.8e-05,172.217.194.0-255,2056,14015,8,330380
18388,7.1e-05,172.31.36.0-255,66,14081,8,330380
18389,0.000115,172.217.194.0-255,5738,19819,8,330380
18390,0.000118,172.31.36.0-255,66,19885,8,330380
18391,0.000142,172.217.194.0-255,5738,25623,8,330380
18392,0.000145,172.31.36.0-255,66,25689,8,330380
18393,0.000147,172.217.194.0-255,1484,27173,8,330380
18394,0.00015,172.31.36.0-255,66,27239,8,330380
18395,0.000164,172.31.36.0-255,66,27305,8,330380
18396,0.000168,172.217.194.0-255,1484,28789,8,330380
18397,0.000169,172.31.36.0-255,66,28855,8,330380
18398,0.000187,172.217.194.0-255,5020,33875,8,330380
18399,0.00019,172.31.36.0-255,66,33941,8,330380
18400,0.000304,172.217.194.0-255,1484,35425,8,330380
18401,0.000308,172.31.36.0-255,66,35491,8,330380
18402,0.000315,172.217.194.0-255,2902,38393,8,330380
18403,0.000319,172.31.36.0-255,66,38459,8,330380
18404,0.000329,172.217.194.0-255,4320,42779,8,330380
18405,0.000333,172.31.36.0-255,66,42845,8,330380
18406,0.00035,172.217.194.0-255,1484,44329,8,330380
18407,0.000352,172.31.36.0-255,66,44395,8,330380
18408,0.000357,172.217.194.0-255,2902,47297,8,330380
18409,0.000359,172.31.36.0-255,66,47363,8,330380
18410,0.000379,172.217.194.0-255,4232,51595,8,330380
18411,0.000382,172.31.36.0-255,66,51661,8,330380
18412,0.00042,172.217.194.0-255,385,52046,8,330380
18413,0.000722,172.217.194.0-255,1484,53530,8,330380
18414,0.000727,172.31.36.0-255,66,53596,8,330380
18415,0.000749,172.217.194.0-255,2902,56498,8,330380
18416,0.000751,172.31.36.0-255,66,56564,8,330380
18417,0.000758,172.217.194.0-255,5738,62302,8,330380
18418,0.00076,172.31.36.0-255,66,62368,8,330380
18419,0.000809,172.217.194.0-255,4320,66688,8,330380
18420,0.000813,172.31.36.0-255,66,66754,8,330380
18421,0.000842,172.31.36.0-255,66,66820,8,330380
18422,0.000849,172.217.194.0-255,7156,73976,8,330380
18423,0.000851,172.31.36.0-255,66,74042,8,330380
18424,0.000856,172.217.194.0-255,3602,77644,8,330380
18425,0.000858,172.31.36.0-255,66,77710,8,330380
18426,0.00123,172.217.194.0-255,1484,79194,8,330380
18427,0.001251,172.217.194.0-255,2902,82096,8,330380
18428,0.001255,172.31.36.0-255,66,82162,8,330380
18429,0.001292,172.217.194.0-255,4320,86482,8,330380
18430,0.001296,172.31.36.0-255,66,86548,8,330380
18431,0.001314,172.217.194.0-255,1484,88032,8,330380
18432,0.001319,172.217.194.0-255,4320,92352,8,330380
18433,0.001322,172.31.36.0-255,66,92418,8,330380
18434,0.001338,172.217.194.0-255,1484,93902,8,330380
18435,0.001364,172.31.36.0-255,66,93968,8,330380
18436,0.001367,172.217.194.0-255,1484,95452,8,330380
18437,0.001418,172.217.194.0-255,1484,96936,8,330380
18438,0.001422,172.31.36.0-255,66,97002,8,330380
18439,0.001443,172.217.194.0-255,5020,102022,8,330380
18440,0.001446,172.31.36.0-255,66,102088,8,330380
18441,0.001618,172.217.194.0-255,1484,103572,8,330380
18442,0.001625,172.217.194.0-255,2902,106474,8,330380
18443,0.001629,172.31.36.0-255,66,106540,8,330380
18444,0.001635,172.217.194.0-255,2902,109442,8,330380
18445,0.001637,172.31.36.0-255,66,109508,8,330380
18446,0.001651,172.217.194.0-255,2902,112410,8,330380
18447,0.001654,172.31.36.0-255,66,112476,8,330380
18448,0.001658,172.217.194.0-255,1484,113960,8,330380
18449,0.001682,172.217.194.0-255,4320,118280,8,330380
18450,0.001685,172.31.36.0-255,66,118346,8,330380
18451,0.001691,172.217.194.0-255,7156,125502,8,330380
18452,0.001693,172.31.36.0-255,66,125568,8,330380
18453,0.001702,172.217.194.0-255,1484,127052,8,330380
18454,0.001725,172.217.194.0-255,7156,134208,8,330380
18455,0.001727,172.31.36.0-255,66,134274,8,330380
18456,0.001754,172.217.194.0-255,2184,136458,8,330380
18457,0.001757,172.31.36.0-255,66,136524,8,330380
18458,0.001961,172.217.194.0-255,1484,138008,8,330380
18459,0.001965,172.217.194.0-255,2902,140910,8,330380
18460,0.001968,172.31.36.0-255,66,140976,8,330380
18461,0.001986,172.217.194.0-255,4320,145296,8,330380
18462,0.001988,172.31.36.0-255,66,145362,8,330380
18463,0.002008,172.217.194.0-255,1484,146846,8,330380
18464,0.002041,172.31.36.0-255,66,146912,8,330380
18465,0.002094,172.217.194.0-255,7156,154068,8,330380
18466,0.002097,172.31.36.0-255,66,154134,8,330380
18467,0.002124,172.217.194.0-255,5020,159154,8,330380
18468,0.002126,172.31.36.0-255,66,159220,8,330380
18469,0.002279,172.217.194.0-255,1484,160704,8,330380
18470,0.004352,172.217.194.0-255,4320,165024,8,330380
18471,0.004356,172.31.36.0-255,66,165090,8,330380
18472,0.00662,172.217.194.0-255,5738,170828,8,330380
18473,0.006628,172.31.36.0-255,66,170894,8,330380
18474,0.008876,172.217.194.0-255,5738,176632,8,330380
18475,0.008883,172.31.36.0-255,66,176698,8,330380
18476,0.011142,172.217.194.0-255,5738,182436,8,330380
18477,0.011151,172.31.36.0-255,66,182502,8,330380
18478,0.013413,172.217.194.0-255,5738,188240,8,330380
18479,0.013418,172.31.36.0-255,66,188306,8,330380
18480,0.01567,172.217.194.0-255,5738,194044,8,330380
18481,0.015676,172.31.36.0-255,66,194110,8,330380
18482,0.017982,172.217.194.0-255,5738,199848,8,330380
18483,0.017989,172.31.36.0-255,66,199914,8,330380
18484,0.020341,172.217.194.0-255,5738,205652,8,330380
18485,0.020349,172.31.36.0-255,66,205718,8,330380
18486,0.022624,172.217.194.0-255,5738,211456,8,330380
18487,0.022634,172.31.36.0-255,66,211522,8,330380
18488,0.024943,172.217.194.0-255,5738,217260,8,330380
18489,0.02495,172.31.36.0-255,66,217326,8,330380
18490,0.027245,172.217.194.0-255,5738,223064,8,330380
18491,0.027252,172.31.36.0-255,66,223130,8,330380
18492,0.029494,172.217.194.0-255,5738,228868,8,330380
18493,0.029501,172.31.36.0-255,66,228934,8,330380
18494,0.031742,172.217.194.0-255,5738,234672,8,330380
18495,0.031749,172.31.36.0-255,66,234738,8,330380
18496,0.034022,172.217.194.0-255,5738,240476,8,330380
18497,0.03403,172.31.36.0-255,66,240542,8,330380
18498,0.036274,172.217.194.0-255,5738,246280,8,330380
18499,0.036282,172.31.36.0-255,66,246346,8,330380
18500,0.038542,172.217.194.0-255,5738,252084,8,330380
18501,0.038549,172.31.36.0-255,66,252150,8,330380
18502,0.040791,172.217.194.0-255,5738,257888,8,330380
18503,0.0408,172.31.36.0-255,66,257954,8,330380
18504,0.043059,172.217.194.0-255,5738,263692,8,330380
18505,0.043087,172.31.36.0-255,66,263758,8,330380
18506,0.045371,172.217.194.0-255,5738,269496,8,330380
18507,0.045379,172.31.36.0-255,66,269562,8,330380
18508,0.047664,172.217.194.0-255,5738,275300,8,330380
18509,0.047671,172.31.36.0-255,66,275366,8,330380
18510,0.049923,172.217.194.0-255,5738,281104,8,330380
18511,0.049929,172.31.36.0-255,66,281170,8,330380
18512,0.049954,172.31.36.0-255,172,281342,8,330380
18513,0.049977,172.31.36.0-255,1110,282452,8,330380
18514,0.050109,172.31.36.0-255,572,283024,8,330380
18515,0.051472,104.244.42.0-255,66,283090,8,330380
18516,0.051515,104.244.42.0-255,66,283156,8,330380
18517,0.051654,104.244.42.0-255,66,283222,8,330380
18518,0.052166,172.217.194.0-255,5738,288960,8,330380
18519,0.052173,172.31.36.0-255,66,289026,8,330380
18520,0.054423,172.217.194.0-255,5738,294764,8,330380
18521,0.054428,172.31.36.0-255,66,294830,8,330380
18522,0.056653,172.217.194.0-255,5738,300568,8,330380
18523,0.056659,172.31.36.0-255,66,300634,8,330380
18524,0.058892,172.217.194.0-255,2902,303536,8,330380
18525,0.058897,172.31.36.0-255,66,303602,8,330380
18526,0.058927,172.217.194.0-255,2902,306504,8,330380
18527,0.05893,172.31.36.0-255,66,306570,8,330380
18528,0.061147,172.217.194.0-255,2902,309472,8,330380
18529,0.061153,172.31.36.0-255,66,309538,8,330380
18530,0.061177,172.217.194.0-255,2902,312440,8,330380
18531,0.061179,172.31.36.0-255,66,312506,8,330380
18532,0.063397,172.217.194.0-255,2902,315408,8,330380
18533,0.063402,172.31.36.0-255,66,315474,8,330380
18534,0.063429,172.217.194.0-255,2902,318376,8,330380
18535,0.063431,172.31.36.0-255,66,318442,8,330380
18536,0.065628,172.217.194.0-255,2902,321344,8,330380
18537,0.065634,172.31.36.0-255,66,321410,8,330380
18538,0.065667,172.217.194.0-255,2902,324312,8,330380
18539,0.065669,172.31.36.0-255,66,324378,8,330380
18540,0.067882,172.217.194.0-255,2902,327280,8,330380
18541,0.067888,172.31.36.0-255,66,327346,8,330380
18542,0.067921,172.217.194.0-255,1484,328830,8,330380
18543,0.067937,172.217.194.0-255,1484,330314,8,330380
18544,0.06794,172.31.36.0-255,66,330380,8,330380
18545,0.0,74.125.200.0-255,153,153,8,359388
18546,2.3e-05,172.31.36.0-255,66,219,8,359388
18547,3.1e-05,74.125.200.0-255,1484,1703,8,359388
18548,3.6e-05,172.31.36.0-255,66,1769,8,359388
18549,4e-05,74.125.200.0-255,1484,3253,8,359388
18550,4.4e-05,172.31.36.0-255,66,3319,8,359388
18551,6.3e-05,74.125.200.0-255,1484,4803,8,359388
18552,6.6e-05,172.31.36.0-255,66,4869,8,359388
18553,6.9e-05,74.125.200.0-255,1484,6353,8,359388
18554,7.2e-05,172.31.36.0-255,66,6419,8,359388
18555,7.8e-05,74.125.200.0-255,2902,9321,8,359388
18556,8e-05,172.31.36.0-255,66,9387,8,359388
18557,0.000112,74.125.200.0-255,6242,15629,8,359388
18558,0.000114,172.31.36.0-255,66,15695,8,359388
18559,0.000141,74.125.200.0-255,7156,22851,8,359388
18560,0.000145,172.31.36.0-255,66,22917,8,359388
18561,0.000182,172.31.36.0-255,66,22983,8,359388
18562,0.000314,74.125.200.0-255,1484,24467,8,359388
18563,0.000319,172.31.36.0-255,66,24533,8,359388
18564,0.000323,74.125.200.0-255,1484,26017,8,359388
18565,0.000325,172.31.36.0-255,66,26083,8,359388
18566,0.000338,74.125.200.0-255,1484,27567,8,359388
18567,0.00034,172.31.36.0-255,66,27633,8,359388
18568,0.000347,74.125.200.0-255,5738,33371,8,359388
18569,0.00035,172.31.36.0-255,66,33437,8,359388
18570,0.000378,74.125.200.0-255,5738,39175,8,359388
18571,0.000381,172.31.36.0-255,66,39241,8,359388
18572,0.000414,74.125.200.0-255,4320,43561,8,359388
18573,0.000417,172.31.36.0-255,66,43627,8,359388
18574,0.000432,74.125.200.0-255,2543,46170,8,359388
18575,0.000435,172.31.36.0-255,66,46236,8,359388
18576,0.000443,74.125.200.0-255,7156,53392,8,359388
18577,0.000446,172.31.36.0-255,66,53458,8,359388
18578,0.000474,74.125.200.0-255,3961,57419,8,359388
18579,0.000477,172.31.36.0-255,66,57485,8,359388
18580,0.000542,74.125.200.0-255,647,58132,8,359388
18581,0.000717,74.125.200.0-255,1484,59616,8,359388
18582,0.000722,172.31.36.0-255,66,59682,8,359388
18583,0.000728,74.125.200.0-255,2902,62584,8,359388
18584,0.000731,172.31.36.0-255,66,62650,8,359388
18585,0.000753,74.125.200.0-255,2902,65552,8,359388
18586,0.000755,172.31.36.0-255,66,65618,8,359388
18587,0.000761,74.125.200.0-255,4320,69938,8,359388
18588,0.000763,172.31.36.0-255,66,70004,8,359388
18589,0.000787,74.125.200.0-255,1484,71488,8,359388
18590,0.000806,74.125.200.0-255,3411,74899,8,359388
18591,0.000811,172.31.36.0-255,66,74965,8,359388
18592,0.000853,74.125.200.0-255,1484,76449,8,359388
18593,0.000874,74.125.200.0-255,2902,79351,8,359388
18594,0.000878,172.31.36.0-255,66,79417,8,359388
18595,0.000894,74.125.200.0-255,1484,80901,8,359388
18596,0.000917,74.125.200.0-255,4320,85221,8,359388
18597,0.00092,172.31.36.0-255,66,85287,8,359388
18598,0.000925,74.125.200.0-255,2902,88189,8,359388
18599,0.000927,172.31.36.0-255,66,88255,8,359388
18600,0.000933,74.125.200.0-255,3961,92216,8,359388
18601,0.000935,172.31.36.0-255,66,92282,8,359388
18602,0.000938,74.125.200.0-255,1484,93766,8,359388
18603,0.00097,74.125.200.0-255,7156,100922,8,359388
18604,0.000973,172.31.36.0-255,66,100988,8,359388
18605,0.000977,74.125.200.0-255,2902,103890,8,359388
18606,0.00098,172.31.36.0-255,66,103956,8,359388
18607,0.000995,74.125.200.0-255,1484,105440,8,359388
18608,0.001011,74.125.200.0-255,3961,109401,8,359388
18609,0.001014,172.31.36.0-255,66,109467,8,359388
18610,0.001038,74.125.200.0-255,5738,115205,8,359388
18611,0.00104,172.31.36.0-255,66,115271,8,359388
18612,0.001045,74.125.200.0-255,2902,118173,8,359388
18613,0.001047,172.31.36.0-255,66,118239,8,359388
18614,0.001052,74.125.200.0-255,2902,121141,8,359388
18615,0.001054,172.31.36.0-255,66,121207,8,359388
18616,0.001069,74.125.200.0-255,1484,122691,8,359388
18617,0.001099,74.125.200.0-255,3961,126652,8,359388
18618,0.001102,172.31.36.0-255,66,126718,8,359388
18619,0.001123,74.125.200.0-255,4320,131038,8,359388
18620,0.001126,172.31.36.0-255,66,131104,8,359388
18621,0.001144,74.125.200.0-255,1484,132588,8,359388
18622,0.001172,172.31.36.0-255,66,132654,8,359388
18623,0.001209,74.125.200.0-255,5379,138033,8,359388
18624,0.001213,172.31.36.0-255,66,138099,8,359388
18625,0.001219,74.125.200.0-255,5738,143837,8,359388
18626,0.001221,172.31.36.0-255,66,143903,8,359388
18627,0.001253,74.125.200.0-255,4320,148223,8,359388
18628,0.001257,172.31.36.0-255,66,148289,8,359388
18629,0.001277,74.125.200.0-255,3961,152250,8,359388
18630,0.001279,172.31.36.0-255,66,152316,8,359388
18631,0.001755,74.125.200.0-255,1484,153800,8,359388
18632,0.00178,74.125.200.0-255,2902,156702,8,359388
18633,0.001784,172.31.36.0-255,66,156768,8,359388
18634,0.001788,74.125.200.0-255,1484,158252,8,359388
18635,0.001804,74.125.200.0-255,2902,161154,8,359388
18636,0.001806,172.31.36.0-255,66,161220,8,359388
18637,0.001842,172.31.36.0-255,66,161286,8,359388
18638,0.003836,74.125.200.0-255,5738,167024,8,359388
18639,0.003847,172.31.36.0-255,66,167090,8,359388
18640,0.005841,74.125.200.0-255,5738,172828,8,359388
18641,0.005848,172.31.36.0-255,66,172894,8,359388
18642,0.00782,74.125.200.0-255,1484,174378,8,359388
18643,0.007836,74.125.200.0-255,4320,178698,8,359388
18644,0.007839,172.31.36.0-255,66,178764,8,359388
18645,0.009843,74.125.200.0-255,5738,184502,8,359388
18646,0.009852,172.31.36.0-255,66,184568,8,359388
18647,0.011854,74.125.200.0-255,5738,190306,8,359388
18648,0.011863,172.31.36.0-255,66,190372,8,359388
18649,0.013849,74.125.200.0-255,5738,196110,8,359388
18650,0.013858,172.31.36.0-255,66,196176,8,359388
18651,0.015852,74.125.200.0-255,5738,201914,8,359388
18652,0.015861,172.31.36.0-255,66,201980,8,359388
18653,0.017853,74.125.200.0-255,5738,207718,8,359388
18654,0.01786,172.31.36.0-255,66,207784,8,359388
18655,0.019847,74.125.200.0-255,5738,213522,8,359388
18656,0.019855,172.31.36.0-255,66,213588,8,359388
18657,0.021856,74.125.200.0-255,5738,219326,8,359388
18658,0.021865,172.31.36.0-255,66,219392,8,359388
18659,0.02386,74.125.200.0-255,5738,225130,8,359388
18660,0.023868,172.31.36.0-255,66,225196,8,359388
18661,0.025871,74.125.200.0-255,5738,230934,8,359388
18662,0.025881,172.31.36.0-255,66,231000,8,359388
18663,0.02787,74.125.200.0-255,5738,236738,8,359388
18664,0.027878,172.31.36.0-255,66,236804,8,359388
18665,0.029874,74.125.200.0-255,5738,242542,8,359388
18666,0.029883,172.31.36.0-255,66,242608,8,359388
18667,0.031881,74.125.200.0-255,5738,248346,8,359388
18668,0.031889,172.31.36.0-255,66,248412,8,359388
18669,0.033872,74.125.200.0-255,5738,254150,8,359388
18670,0.03388,172.31.36.0-255,66,254216,8,359388
18671,0.03588,74.125.200.0-255,5738,259954,8,359388
18672,0.035889,172.31.36.0-255,66,260020,8,359388
18673,0.037876,74.125.200.0-255,5738,265758,8,359388
18674,0.037884,172.31.36.0-255,66,265824,8,359388
18675,0.039062,172.31.36.0-255,172,265996,8,359388
18676,0.039095,172.31.36.0-255,1111,267107,8,359388
18677,0.039151,172.31.36.0-255,571,267678,8,359388
18678,0.039879,74.125.200.0-255,5738,273416,8,359388
18679,0.039886,172.31.36.0-255,66,273482,8,359388
18680,0.040596,104.244.42.0-255,66,273548,8,359388
18681,0.040618,104.244.42.0-255,66,273614,8,359388
18682,0.04067,104.244.42.0-255,66,273680,8,359388
18683,0.041901,74.125.200.0-255,5738,279418,8,359388
18684,0.041908,172.31.36.0-255,66,279484,8,359388
18685,0.043903,74.125.200.0-255,5738,285222,8,359388
18686,0.043911,172.31.36.0-255,66,285288,8,359388
18687,0.045901,74.125.200.0-255,5738,291026,8,359388
18688,0.045914,172.31.36.0-255,66,291092,8,359388
18689,0.047908,74.125.200.0-255,5738,296830,8,359388
18690,0.047918,172.31.36.0-255,66,296896,8,359388
18691,0.049901,74.125.200.0-255,5738,302634,8,359388
18692,0.049908,172.31.36.0-255,66,302700,8,359388
18693,0.051904,74.125.200.0-255,5738,308438,8,359388
18694,0.051911,172.31.36.0-255,66,308504,8,359388
18695,0.053902,74.125.200.0-255,5738,314242,8,359388
18696,0.053909,172.31.36.0-255,66,314308,8,359388
18697,0.055903,74.125.200.0-255,5738,320046,8,359388
18698,0.05591,172.31.36.0-255,66,320112,8,359388
18699,0.057893,74.125.200.0-255,5738,325850,8,359388
18700,0.0579,172.31.36.0-255,66,325916,8,359388
18701,0.059895,74.125.200.0-255,5738,331654,8,359388
18702,0.059901,172.31.36.0-255,66,331720,8,359388
18703,0.061928,74.125.200.0-255,5738,337458,8,359388
18704,0.061935,172.31.36.0-255,66,337524,8,359388
18705,0.063914,74.125.200.0-255,4320,341844,8,359388
18706,0.063921,172.31.36.0-255,66,341910,8,359388
18707,0.063938,74.125.200.0-255,1484,343394,8,359388
18708,0.065908,74.125.200.0-255,4320,347714,8,359388
18709,0.06592,172.31.36.0-255,66,347780,8,359388
18710,0.067921,74.125.200.0-255,5738,353518,8,359388
18711,0.067929,172.31.36.0-255,66,353584,8,359388
18712,0.06994,74.125.200.0-255,5738,359322,8,359388
18713,0.069951,172.31.36.0-255,66,359388,8,359388
18714,0.0,74.125.130.0-255,146,146,8,304386
18715,2.6e-05,172.31.36.0-255,66,212,8,304386
18716,3.3e-05,74.125.130.0-255,1484,1696,8,304386
18717,3.7e-05,172.31.36.0-255,66,1762,8,304386
18718,4.2e-05,74.125.130.0-255,2902,4664,8,304386
18719,4.6e-05,172.31.36.0-255,66,4730,8,304386
18720,8.8e-05,74.125.130.0-255,4320,9050,8,304386
18721,9.1e-05,172.31.36.0-255,66,9116,8,304386
18722,9.9e-05,74.125.130.0-255,4848,13964,8,304386
18723,0.000102,172.31.36.0-255,66,14030,8,304386
18724,0.000158,74.125.130.0-255,1484,15514,8,304386
18725,0.000162,172.31.36.0-255,66,15580,8,304386
18726,0.000168,74.125.130.0-255,2902,18482,8,304386
18727,0.000171,172.31.36.0-255,66,18548,8,304386
18728,0.000186,74.125.130.0-255,5738,24286,8,304386
18729,0.000188,172.31.36.0-255,66,24352,8,304386
18730,0.000194,74.125.130.0-255,5738,30090,8,304386
18731,0.000197,172.31.36.0-255,66,30156,8,304386
18732,0.000205,74.125.130.0-255,7156,37312,8,304386
18733,0.000208,172.31.36.0-255,66,37378,8,304386
18734,0.000256,172.31.36.0-255,66,37444,8,304386
18735,0.000294,74.125.130.0-255,1484,38928,8,304386
18736,0.000298,172.31.36.0-255,66,38994,8,304386
18737,0.000303,74.125.130.0-255,2902,41896,8,304386
18738,0.000307,172.31.36.0-255,66,41962,8,304386
18739,0.000325,74.125.130.0-255,1484,43446,8,304386
18740,0.000327,172.31.36.0-255,66,43512,8,304386
18741,0.000341,74.125.130.0-255,5738,49250,8,304386
18742,0.000345,172.31.36.0-255,66,49316,8,304386
18743,0.000373,74.125.130.0-255,4320,53636,8,304386
18744,0.000377,172.31.36.0-255,66,53702,8,304386
18745,0.000402,74.125.130.0-255,1429,55131,8,304386
18746,0.000486,74.125.130.0-255,1484,56615,8,304386
18747,0.000491,172.31.36.0-255,66,56681,8,304386
18748,0.000496,74.125.130.0-255,2902,59583,8,304386
18749,0.000499,172.31.36.0-255,66,59649,8,304386
18750,0.000529,74.125.130.0-255,5738,65387,8,304386
18751,0.000533,172.31.36.0-255,66,65453,8,304386
18752,0.000541,74.125.130.0-255,7156,72609,8,304386
18753,0.000543,172.31.36.0-255,66,72675,8,304386
18754,0.000577,74.125.130.0-255,2902,75577,8,304386
18755,0.000581,172.31.36.0-255,66,75643,8,304386
18756,0.000616,74.125.130.0-255,7156,82799,8,304386
18757,0.000619,172.31.36.0-255,66,82865,8,304386
18758,0.000624,74.125.130.0-255,2902,85767,8,304386
18759,0.000626,172.31.36.0-255,66,85833,8,304386
18760,0.000647,74.125.130.0-255,3602,89435,8,304386
18761,0.000655,172.31.36.0-255,66,89501,8,304386
18762,0.000685,74.125.130.0-255,376,89877,8,304386
18763,0.001098,172.31.36.0-255,66,89943,8,304386
18764,0.001311,74.125.130.0-255,1484,91427,8,304386
18765,0.001331,74.125.130.0-255,1484,92911,8,304386
18766,0.001335,172.31.36.0-255,66,92977,8,304386
18767,0.001362,74.125.130.0-255,1484,94461,8,304386
18768,0.001368,74.125.130.0-255,4320,98781,8,304386
18769,0.001371,172.31.36.0-255,66,98847,8,304386
18770,0.001379,74.125.130.0-255,5738,104585,8,304386
18771,0.001381,172.31.36.0-255,66,104651,8,304386
18772,0.0014,74.125.130.0-255,2902,107553,8,304386
18773,0.001403,172.31.36.0-255,66,107619,8,304386
18774,0.001414,74.125.130.0-255,2902,110521,8,304386
18775,0.001416,172.31.36.0-255,66,110587,8,304386
18776,0.001429,172.31.36.0-255,66,110653,8,304386
18777,0.001454,74.125.130.0-255,1484,112137,8,304386
18778,0.001462,74.125.130.0-255,766,112903,8,304386
18779,0.001464,172.31.36.0-255,66,112969,8,304386
18780,0.003431,74.125.130.0-255,2902,115871,8,304386
18781,0.003437,172.31.36.0-255,66,115937,8,304386
18782,0.003463,74.125.130.0-255,2902,118839,8,304386
18783,0.003465,172.31.36.0-255,66,118905,8,304386
18784,0.005444,74.125.130.0-255,2902,121807,8,304386
18785,0.005451,172.31.36.0-255,66,121873,8,304386
18786,0.005475,74.125.130.0-255,2902,124775,8,304386
18787,0.005478,172.31.36.0-255,66,124841,8,304386
18788,0.00747,74.125.130.0-255,2902,127743,8,304386
18789,0.007473,172.31.36.0-255,66,127809,8,304386
18790,0.007484,74.125.130.0-255,2902,130711,8,304386
18791,0.007491,172.31.36.0-255,66,130777,8,304386
18792,0.009482,74.125.130.0-255,2902,133679,8,304386
18793,0.009489,172.31.36.0-255,66,133745,8,304386
18794,0.00952,74.125.130.0-255,2902,136647,8,304386
18795,0.009524,172.31.36.0-255,66,136713,8,304386
18796,0.011488,74.125.130.0-255,2902,139615,8,304386
18797,0.011495,172.31.36.0-255,66,139681,8,304386
18798,0.011532,74.125.130.0-255,2902,142583,8,304386
18799,0.011535,172.31.36.0-255,66,142649,8,304386
18800,0.013531,74.125.130.0-255,4320,146969,8,304386
18801,0.013538,172.31.36.0-255,66,147035,8,304386
18802,0.013572,74.125.130.0-255,1484,148519,8,304386
18803,0.015544,74.125.130.0-255,4320,152839,8,304386
18804,0.015551,172.31.36.0-255,66,152905,8,304386
18805,0.017558,74.125.130.0-255,5738,158643,8,304386
18806,0.017564,172.31.36.0-255,66,158709,8,304386
18807,0.019577,74.125.130.0-255,5738,164447,8,304386
18808,0.019584,172.31.36.0-255,66,164513,8,304386
18809,0.021614,74.125.130.0-255,5738,170251,8,304386
18810,0.021623,172.31.36.0-255,66,170317,8,304386
18811,0.023639,74.125.130.0-255,5738,176055,8,304386
18812,0.02365,172.31.36.0-255,66,176121,8,304386
18813,0.025698,74.125.130.0-255,5738,181859,8,304386
18814,0.025706,172.31.36.0-255,66,181925,8,304386
18815,0.027704,74.125.130.0-255,2902,184827,8,304386
18816,0.027711,172.31.36.0-255,66,184893,8,304386
18817,0.02775,74.125.130.0-255,2902,187795,8,304386
18818,0.027753,172.31.36.0-255,66,187861,8,304386
18819,0.029716,74.125.130.0-255,2902,190763,8,304386
18820,0.029722,172.31.36.0-255,66,190829,8,304386
18821,0.029763,74.125.130.0-255,2902,193731,8,304386
18822,0.029767,172.31.36.0-255,66,193797,8,304386
18823,0.03173,74.125.130.0-255,2902,196699,8,304386
18824,0.031737,172.31.36.0-255,66,196765,8,304386
18825,0.031777,74.125.130.0-255,2902,199667,8,304386
18826,0.031782,172.31.36.0-255,66,199733,8,304386
18827,0.033747,74.125.130.0-255,2902,202635,8,304386
18828,0.033755,172.31.36.0-255,66,202701,8,304386
18829,0.033792,74.125.130.0-255,2902,205603,8,304386
18830,0.033795,172.31.36.0-255,66,205669,8,304386
18831,0.035765,74.125.130.0-255,2902,208571,8,304386
18832,0.035773,172.31.36.0-255,66,208637,8,304386
18833,0.035795,74.125.130.0-255,2902,211539,8,304386
18834,0.035798,172.31.36.0-255,66,211605,8,304386
18835,0.037785,74.125.130.0-255,4320,215925,8,304386
18836,0.037793,172.31.36.0-255,66,215991,8,304386
18837,0.03783,74.125.130.0-255,1484,217475,8,304386
18838,0.039798,74.125.130.0-255,4320,221795,8,304386
18839,0.039805,172.31.36.0-255,66,221861,8,304386
18840,0.041819,74.125.130.0-255,5738,227599,8,304386
18841,0.041825,172.31.36.0-255,66,227665,8,304386
18842,0.043853,74.125.130.0-255,5738,233403,8,304386
18843,0.043864,172.31.36.0-255,66,233469,8,304386
18844,0.04587,74.125.130.0-255,5738,239207,8,304386
18845,0.045877,172.31.36.0-255,66,239273,8,304386
18846,0.046631,172.31.36.0-255,188,239461,8,304386
18847,0.046659,172.31.36.0-255,955,240416,8,304386
18848,0.046711,172.31.36.0-255,1514,241930,8,304386
18849,0.046712,172.31.36.0-255,1184,243114,8,304386
18850,0.047878,74.125.130.0-255,4320,247434,8,304386
18851,0.047885,172.31.36.0-255,66,247500,8,304386
18852,0.047917,74.125.130.0-255,1484,248984,8,304386
18853,0.048193,104.244.42.0-255,66,249050,8,304386
18854,0.048234,104.244.42.0-255,66,249116,8,304386
18855,0.048279,104.244.42.0-255,66,249182,8,304386
18856,0.04988,74.125.130.0-255,2902,252084,8,304386
18857,0.049886,172.31.36.0-255,66,252150,8,304386
18858,0.05189,74.125.130.0-255,5738,257888,8,304386
18859,0.051896,172.31.36.0-255,66,257954,8,304386
18860,0.053902,74.125.130.0-255,5738,263692,8,304386
18861,0.053908,172.31.36.0-255,66,263758,8,304386
18862,0.055909,74.125.130.0-255,5738,269496,8,304386
18863,0.055915,172.31.36.0-255,66,269562,8,304386
18864,0.057915,74.125.130.0-255,5738,275300,8,304386
18865,0.057921,172.31.36.0-255,66,275366,8,304386
18866,0.059927,74.125.130.0-255,5738,281104,8,304386
18867,0.059932,172.31.36.0-255,66,281170,8,304386
18868,0.061947,74.125.130.0-255,5738,286908,8,304386
18869,0.061951,172.31.36.0-255,66,286974,8,304386
18870,0.063958,74.125.130.0-255,5738,292712,8,304386
18871,0.063963,172.31.36.0-255,66,292778,8,304386
18872,0.066067,74.125.130.0-255,5738,298516,8,304386
18873,0.066072,172.31.36.0-255,66,298582,8,304386
18874,0.068075,74.125.130.0-255,5738,304320,8,304386
18875,0.068081,172.31.36.0-255,66,304386,8,304386
18876,0.0,172.217.194.0-255,153,153,8,160993
18877,3.6e-05,172.31.36.0-255,66,219,8,160993
18878,4.4e-05,172.217.194.0-255,1484,1703,8,160993
18879,4.9e-05,172.31.36.0-255,66,1769,8,160993
18880,6.4e-05,172.217.194.0-255,2902,4671,8,160993
18881,6.7e-05,172.31.36.0-255,66,4737,8,160993
18882,7.5e-05,172.217.194.0-255,7156,11893,8,160993
18883,7.8e-05,172.31.36.0-255,66,11959,8,160993
18884,0.00013,172.31.36.0-255,66,12025,8,160993
18885,0.000136,172.217.194.0-255,3961,15986,8,160993
18886,0.000138,172.31.36.0-255,66,16052,8,160993
18887,0.000173,172.217.194.0-255,4320,20372,8,160993
18888,0.000177,172.31.36.0-255,66,20438,8,160993
18889,0.000189,172.31.36.0-255,66,20504,8,160993
18890,0.000193,172.217.194.0-255,2543,23047,8,160993
18891,0.000196,172.31.36.0-255,66,23113,8,160993
18892,0.000241,172.217.194.0-255,4320,27433,8,160993
18893,0.000245,172.31.36.0-255,66,27499,8,160993
18894,0.000286,172.31.36.0-255,66,27565,8,160993
18895,0.000291,172.217.194.0-255,2543,30108,8,160993
18896,0.000293,172.31.36.0-255,66,30174,8,160993
18897,0.0004,172.217.194.0-255,363,30537,8,160993
18898,0.000406,172.31.36.0-255,66,30603,8,160993
18899,0.000409,172.217.194.0-255,379,30982,8,160993
18900,0.000411,172.31.36.0-255,66,31048,8,160993
18901,0.000859,172.217.194.0-255,1484,32532,8,160993
18902,0.000866,172.31.36.0-255,66,32598,8,160993
18903,0.000885,172.217.194.0-255,2902,35500,8,160993
18904,0.000888,172.31.36.0-255,66,35566,8,160993
18905,0.000895,172.217.194.0-255,5738,41304,8,160993
18906,0.000898,172.31.36.0-255,66,41370,8,160993
18907,0.000904,172.217.194.0-255,4320,45690,8,160993
18908,0.000906,172.31.36.0-255,66,45756,8,160993
18909,0.000944,172.31.36.0-255,66,45822,8,160993
18910,0.000949,172.217.194.0-255,2902,48724,8,160993
18911,0.000951,172.31.36.0-255,66,48790,8,160993
18912,0.000966,172.217.194.0-255,5020,53810,8,160993
18913,0.000969,172.31.36.0-255,66,53876,8,160993
18914,0.001112,172.217.194.0-255,1484,55360,8,160993
18915,0.001128,172.217.194.0-255,2902,58262,8,160993
18916,0.001131,172.31.36.0-255,66,58328,8,160993
18917,0.001135,172.217.194.0-255,1484,59812,8,160993
18918,0.00116,172.217.194.0-255,4320,64132,8,160993
18919,0.001163,172.31.36.0-255,66,64198,8,160993
18920,0.001174,172.31.36.0-255,66,64264,8,160993
18921,0.001235,172.31.36.0-255,66,64330,8,160993
18922,0.00124,172.217.194.0-255,2902,67232,8,160993
18923,0.001242,172.31.36.0-255,66,67298,8,160993
18924,0.001289,172.31.36.0-255,66,67364,8,160993
18925,0.001301,172.31.36.0-255,66,67430,8,160993
18926,0.001304,172.217.194.0-255,1484,68914,8,160993
18927,0.001335,172.217.194.0-255,6438,75352,8,160993
18928,0.001339,172.31.36.0-255,66,75418,8,160993
18929,0.001351,172.31.36.0-255,66,75484,8,160993
18930,0.001358,172.217.194.0-255,7156,82640,8,160993
18931,0.001361,172.31.36.0-255,66,82706,8,160993
18932,0.001396,172.31.36.0-255,66,82772,8,160993
18933,0.001402,172.217.194.0-255,6438,89210,8,160993
18934,0.001405,172.31.36.0-255,66,89276,8,160993
18935,0.001438,172.31.36.0-255,66,89342,8,160993
18936,0.001472,172.31.36.0-255,66,89408,8,160993
18937,0.001483,172.31.36.0-255,66,89474,8,160993
18938,0.001513,172.217.194.0-255,6438,95912,8,160993
18939,0.001519,172.217.194.0-255,5738,101650,8,160993
18940,0.001518,172.31.36.0-255,66,101716,8,160993
18941,0.001523,172.31.36.0-255,66,101782,8,160993
18942,0.001563,172.31.36.0-255,66,101848,8,160993
18943,0.001583,172.31.36.0-255,66,101914,8,160993
18944,0.001595,172.31.36.0-255,66,101980,8,160993
18945,0.001638,172.217.194.0-255,2902,104882,8,160993
18946,0.001642,172.31.36.0-255,66,104948,8,160993
18947,0.001686,172.31.36.0-255,66,105014,8,160993
18948,0.001697,172.31.36.0-255,66,105080,8,160993
18949,0.0017,172.217.194.0-255,1484,106564,8,160993
18950,0.001704,172.217.194.0-255,2902,109466,8,160993
18951,0.001707,172.31.36.0-255,66,109532,8,160993
18952,0.001737,172.217.194.0-255,5738,115270,8,160993
18953,0.00174,172.31.36.0-255,66,115336,8,160993
18954,0.001757,172.217.194.0-255,5738,121074,8,160993
18955,0.00176,172.31.36.0-255,66,121140,8,160993
18956,0.001783,172.217.194.0-255,7156,128296,8,160993
18957,0.001788,172.31.36.0-255,66,128362,8,160993
18958,0.001832,172.31.36.0-255,66,128428,8,160993
18959,0.001904,172.217.194.0-255,1484,129912,8,160993
18960,0.001916,172.217.194.0-255,1484,131396,8,160993
18961,0.001919,172.31.36.0-255,66,131462,8,160993
18962,0.001948,172.217.194.0-255,1484,132946,8,160993
18963,0.001955,172.217.194.0-255,5738,138684,8,160993
18964,0.001958,172.31.36.0-255,66,138750,8,160993
18965,0.001974,172.31.36.0-255,66,138816,8,160993
18966,0.002001,172.31.36.0-255,66,138882,8,160993
18967,0.002025,172.217.194.0-255,2184,141066,8,160993
18968,0.002029,172.31.36.0-255,66,141132,8,160993
18969,0.002038,172.217.194.0-255,7156,148288,8,160993
18970,0.002047,172.31.36.0-255,66,148354,8,160993
18971,0.002059,172.217.194.0-255,2902,151256,8,160993
18972,0.002064,172.31.36.0-255,66,151322,8,160993
18973,0.002086,172.31.36.0-255,66,151388,8,160993
18974,0.002091,172.217.194.0-255,1484,152872,8,160993
18975,0.002112,172.31.36.0-255,66,152938,8,160993
18976,0.002127,172.217.194.0-255,1484,154422,8,160993
18977,0.002156,172.217.194.0-255,5363,159785,8,160993
18978,0.00216,172.217.194.0-255,105,159890,8,160993
18979,0.002164,172.31.36.0-255,66,159956,8,160993
18980,0.009842,172.31.36.0-255,105,160061,8,160993
18981,0.01219,172.217.194.0-255,66,160127,8,160993
18982,0.035373,172.31.36.0-255,172,160299,8,160993
18983,0.035404,172.31.36.0-255,562,160861,8,160993
18984,0.036955,104.244.42.0-255,66,160927,8,160993
18985,0.036966,104.244.42.0-255,66,160993,8,160993
18986,0.0,172.217.194.0-255,66,66,8,66
18987,0.0,172.253.118.0-255,146,146,8,310181
18988,2.7e-05,172.31.36.0-255,66,212,8,310181
18989,3.4e-05,172.253.118.0-255,1484,1696,8,310181
18990,3.8e-05,172.31.36.0-255,66,1762,8,310181
18991,4.3e-05,172.253.118.0-255,2902,4664,8,310181
18992,5.3e-05,172.31.36.0-255,66,4730,8,310181
18993,6e-05,172.253.118.0-255,7156,11886,8,310181
18994,6.4e-05,172.31.36.0-255,66,11952,8,310181
18995,0.000105,172.31.36.0-255,66,12018,8,310181
18996,0.000137,172.253.118.0-255,5379,17397,8,310181
18997,0.00014,172.31.36.0-255,66,17463,8,310181
18998,0.000263,172.253.118.0-255,1484,18947,8,310181
18999,0.000268,172.31.36.0-255,66,19013,8,310181
19000,0.000273,172.253.118.0-255,2902,21915,8,310181
19001,0.000276,172.31.36.0-255,66,21981,8,310181
19002,0.000305,172.253.118.0-255,5738,27719,8,310181
19003,0.000309,172.31.36.0-255,66,27785,8,310181
19004,0.000322,172.253.118.0-255,2902,30687,8,310181
19005,0.000329,172.31.36.0-255,66,30753,8,310181
19006,0.000369,172.31.36.0-255,66,30819,8,310181
19007,0.000373,172.253.118.0-255,2902,33721,8,310181
19008,0.000377,172.31.36.0-255,66,33787,8,310181
19009,0.000408,172.253.118.0-255,6797,40584,8,310181
19010,0.000411,172.31.36.0-255,66,40650,8,310181
19011,0.000414,172.253.118.0-255,412,41062,8,310181
19012,0.00042,172.31.36.0-255,66,41128,8,310181
19013,0.000465,172.253.118.0-255,331,41459,8,310181
19014,0.000468,172.31.36.0-255,66,41525,8,310181
19015,0.000738,172.253.118.0-255,1484,43009,8,310181
19016,0.000742,172.31.36.0-255,66,43075,8,310181
19017,0.000748,172.253.118.0-255,2902,45977,8,310181
19018,0.00075,172.31.36.0-255,66,46043,8,310181
19019,0.000756,172.253.118.0-255,5738,51781,8,310181
19020,0.000764,172.31.36.0-255,66,51847,8,310181
19021,0.000768,172.253.118.0-255,1484,53331,8,310181
19022,0.00077,172.31.36.0-255,66,53397,8,310181
19023,0.000814,172.31.36.0-255,66,53463,8,310181
19024,0.00082,172.253.118.0-255,5738,59201,8,310181
19025,0.000823,172.31.36.0-255,66,59267,8,310181
19026,0.000851,172.253.118.0-255,5020,64287,8,310181
19027,0.000854,172.31.36.0-255,66,64353,8,310181
19028,0.00105,172.253.118.0-255,1484,65837,8,310181
19029,0.001055,172.31.36.0-255,66,65903,8,310181
19030,0.00106,172.253.118.0-255,2902,68805,8,310181
19031,0.001062,172.31.36.0-255,66,68871,8,310181
19032,0.001086,172.253.118.0-255,5738,74609,8,310181
19033,0.001089,172.31.36.0-255,66,74675,8,310181
19034,0.001094,172.253.118.0-255,2902,77577,8,310181
19035,0.001096,172.31.36.0-255,66,77643,8,310181
19036,0.001139,172.31.36.0-255,66,77709,8,310181
19037,0.001144,172.253.118.0-255,4320,82029,8,310181
19038,0.001146,172.31.36.0-255,66,82095,8,310181
19039,0.001204,172.253.118.0-255,6438,88533,8,310181
19040,0.001208,172.31.36.0-255,66,88599,8,310181
19041,0.001737,172.253.118.0-255,1484,90083,8,310181
19042,0.001743,172.31.36.0-255,66,90149,8,310181
19043,0.001753,172.253.118.0-255,2902,93051,8,310181
19044,0.001755,172.31.36.0-255,66,93117,8,310181
19045,0.001769,172.253.118.0-255,5738,98855,8,310181
19046,0.001772,172.31.36.0-255,66,98921,8,310181
19047,0.001785,172.253.118.0-255,2902,101823,8,310181
19048,0.001788,172.31.36.0-255,66,101889,8,310181
19049,0.001821,172.31.36.0-255,66,101955,8,310181
19050,0.001828,172.253.118.0-255,7156,109111,8,310181
19051,0.001849,172.253.118.0-255,3602,112713,8,310181
19052,0.002055,172.253.118.0-255,1484,114197,8,310181
19053,0.002062,172.253.118.0-255,2902,117099,8,310181
19054,0.002065,172.253.118.0-255,1484,118583,8,310181
19055,0.002081,172.253.118.0-255,4320,122903,8,310181
19056,0.002102,172.253.118.0-255,1484,124387,8,310181
19057,0.002115,172.253.118.0-255,7156,131543,8,310181
19058,0.002137,172.253.118.0-255,2902,134445,8,310181
19059,0.002181,172.253.118.0-255,766,135211,8,310181
19060,0.002197,172.253.118.0-255,7156,142367,8,310181
19061,0.002214,172.253.118.0-255,2902,145269,8,310181
19062,0.00222,172.253.118.0-255,5738,151007,8,310181
19063,0.006203,172.31.36.0-255,66,151073,8,310181
19064,0.008492,172.253.118.0-255,5738,156811,8,310181
19065,0.0085,172.31.36.0-255,66,156877,8,310181
19066,0.010787,172.253.118.0-255,5738,162615,8,310181
19067,0.010793,172.31.36.0-255,66,162681,8,310181
19068,0.013083,172.253.118.0-255,5738,168419,8,310181
19069,0.013091,172.31.36.0-255,66,168485,8,310181
19070,0.015417,172.253.118.0-255,5738,174223,8,310181
19071,0.015427,172.31.36.0-255,66,174289,8,310181
19072,0.017698,172.253.118.0-255,5738,180027,8,310181
19073,0.017706,172.31.36.0-255,66,180093,8,310181
19074,0.020008,172.253.118.0-255,5738,185831,8,310181
19075,0.020016,172.31.36.0-255,66,185897,8,310181
19076,0.022307,172.253.118.0-255,5738,191635,8,310181
19077,0.022313,172.31.36.0-255,66,191701,8,310181
19078,0.024602,172.253.118.0-255,5738,197439,8,310181
19079,0.024613,172.31.36.0-255,66,197505,8,310181
19080,0.02689,172.253.118.0-255,5738,203243,8,310181
19081,0.026898,172.31.36.0-255,66,203309,8,310181
19082,0.029187,172.253.118.0-255,5738,209047,8,310181
19083,0.029203,172.31.36.0-255,66,209113,8,310181
19084,0.031489,172.253.118.0-255,5738,214851,8,310181
19085,0.031502,172.31.36.0-255,66,214917,8,310181
19086,0.033787,172.253.118.0-255,5738,220655,8,310181
19087,0.033793,172.31.36.0-255,66,220721,8,310181
19088,0.035108,172.31.36.0-255,175,220896,8,310181
19089,0.035141,172.31.36.0-255,1135,222031,8,310181
19090,0.035175,172.31.36.0-255,1514,223545,8,310181
19091,0.035177,172.31.36.0-255,730,224275,8,310181
19092,0.036101,172.253.118.0-255,5738,230013,8,310181
19093,0.036107,172.31.36.0-255,66,230079,8,310181
19094,0.036681,104.244.42.0-255,66,230145,8,310181
19095,0.036722,104.244.42.0-255,66,230211,8,310181
19096,0.036724,104.244.42.0-255,66,230277,8,310181
19097,0.038384,172.253.118.0-255,4320,234597,8,310181
19098,0.038389,172.31.36.0-255,66,234663,8,310181
19099,0.03842,172.253.118.0-255,1484,236147,8,310181
19100,0.040665,172.253.118.0-255,4320,240467,8,310181
19101,0.040671,172.31.36.0-255,66,240533,8,310181
19102,0.042958,172.253.118.0-255,5738,246271,8,310181
19103,0.043012,172.31.36.0-255,66,246337,8,310181
19104,0.045281,172.253.118.0-255,5738,252075,8,310181
19105,0.045286,172.31.36.0-255,66,252141,8,310181
19106,0.047551,172.253.118.0-255,5738,257879,8,310181
19107,0.047558,172.31.36.0-255,66,257945,8,310181
19108,0.049839,172.253.118.0-255,5738,263683,8,310181
19109,0.049845,172.31.36.0-255,66,263749,8,310181
19110,0.052124,172.253.118.0-255,5738,269487,8,310181
19111,0.05213,172.31.36.0-255,66,269553,8,310181
19112,0.054432,172.253.118.0-255,5738,275291,8,310181
19113,0.054437,172.31.36.0-255,66,275357,8,310181
19114,0.05671,172.253.118.0-255,5738,281095,8,310181
19115,0.056715,172.31.36.0-255,66,281161,8,310181
19116,0.059015,172.253.118.0-255,5738,286899,8,310181
19117,0.059021,172.31.36.0-255,66,286965,8,310181
19118,0.061299,172.253.118.0-255,5738,292703,8,310181
19119,0.061306,172.31.36.0-255,66,292769,8,310181
19120,0.063556,172.253.118.0-255,5738,298507,8,310181
19121,0.063562,172.31.36.0-255,66,298573,8,310181
19122,0.065838,172.253.118.0-255,5738,304311,8,310181
19123,0.065845,172.31.36.0-255,66,304377,8,310181
19124,0.068119,172.253.118.0-255,5738,310115,8,310181
19125,0.068125,172.31.36.0-255,66,310181,8,310181
19126,0.0,74.125.130.0-255,146,146,8,297170
19127,3.6e-05,172.31.36.0-255,66,212,8,297170
19128,4.4e-05,74.125.130.0-255,1484,1696,8,297170
19129,4.9e-05,172.31.36.0-255,66,1762,8,297170
19130,5.4e-05,74.125.130.0-255,2902,4664,8,297170
19131,5.6e-05,172.31.36.0-255,66,4730,8,297170
19132,7.1e-05,74.125.130.0-255,5738,10468,8,297170
19133,7.4e-05,172.31.36.0-255,66,10534,8,297170
19134,7.9e-05,74.125.130.0-255,2902,13436,8,297170
19135,8.2e-05,172.31.36.0-255,66,13502,8,297170
19136,0.000116,74.125.130.0-255,3468,16970,8,297170
19137,0.000119,172.31.36.0-255,66,17036,8,297170
19138,0.000126,74.125.130.0-255,7156,24192,8,297170
19139,0.000129,172.31.36.0-255,66,24258,8,297170
19140,0.000132,74.125.130.0-255,1484,25742,8,297170
19141,0.000133,172.31.36.0-255,66,25808,8,297170
19142,0.000169,74.125.130.0-255,5379,31187,8,297170
19143,0.000172,172.31.36.0-255,66,31253,8,297170
19144,0.000262,74.125.130.0-255,1484,32737,8,297170
19145,0.000266,172.31.36.0-255,66,32803,8,297170
19146,0.00029,74.125.130.0-255,1484,34287,8,297170
19147,0.000293,172.31.36.0-255,66,34353,8,297170
19148,0.000298,74.125.130.0-255,2902,37255,8,297170
19149,0.0003,172.31.36.0-255,66,37321,8,297170
19150,0.000304,74.125.130.0-255,2902,40223,8,297170
19151,0.000311,172.31.36.0-255,66,40289,8,297170
19152,0.000335,74.125.130.0-255,2902,43191,8,297170
19153,0.000338,172.31.36.0-255,66,43257,8,297170
19154,0.000344,74.125.130.0-255,5379,48636,8,297170
19155,0.000346,172.31.36.0-255,66,48702,8,297170
19156,0.000373,74.125.130.0-255,5738,54440,8,297170
19157,0.000376,172.31.36.0-255,66,54506,8,297170
19158,0.000383,74.125.130.0-255,5738,60244,8,297170
19159,0.000385,172.31.36.0-255,66,60310,8,297170
19160,0.000441,74.125.130.0-255,1484,61794,8,297170
19161,0.000445,172.31.36.0-255,66,61860,8,297170
19162,0.000475,74.125.130.0-255,4214,66074,8,297170
19163,0.000478,172.31.36.0-255,66,66140,8,297170
19164,0.000481,74.125.130.0-255,121,66261,8,297170
19165,0.000794,172.31.36.0-255,66,66327,8,297170
19166,0.001031,74.125.130.0-255,380,66707,8,297170
19167,0.001269,74.125.130.0-255,1484,68191,8,297170
19168,0.001275,172.31.36.0-255,66,68257,8,297170
19169,0.001282,74.125.130.0-255,2902,71159,8,297170
19170,0.001284,172.31.36.0-255,66,71225,8,297170
19171,0.001294,74.125.130.0-255,1484,72709,8,297170
19172,0.001296,172.31.36.0-255,66,72775,8,297170
19173,0.001301,74.125.130.0-255,2902,75677,8,297170
19174,0.001332,74.125.130.0-255,5738,81415,8,297170
19175,0.001349,74.125.130.0-255,1484,82899,8,297170
19176,0.001354,74.125.130.0-255,2902,85801,8,297170
19177,0.001379,74.125.130.0-255,5738,91539,8,297170
19178,0.001384,74.125.130.0-255,2902,94441,8,297170
19179,0.001408,74.125.130.0-255,4320,98761,8,297170
19180,0.001438,74.125.130.0-255,2184,100945,8,297170
19181,0.001804,74.125.130.0-255,1484,102429,8,297170
19182,0.001823,74.125.130.0-255,2902,105331,8,297170
19183,0.001847,74.125.130.0-255,2902,108233,8,297170
19184,0.001872,74.125.130.0-255,4320,112553,8,297170
19185,0.001897,74.125.130.0-255,1484,114037,8,297170
19186,0.001906,74.125.130.0-255,1484,115521,8,297170
19187,0.001955,74.125.130.0-255,5738,121259,8,297170
19188,0.001971,74.125.130.0-255,5020,126279,8,297170
19189,0.002047,74.125.130.0-255,1484,127763,8,297170
19190,0.002058,74.125.130.0-255,2902,130665,8,297170
19191,0.002069,74.125.130.0-255,2902,133567,8,297170
19192,0.002081,74.125.130.0-255,2902,136469,8,297170
19193,0.002098,74.125.130.0-255,4320,140789,8,297170
19194,0.002114,74.125.130.0-255,1484,142273,8,297170
19195,0.006362,172.31.36.0-255,66,142339,8,297170
19196,0.008454,74.125.130.0-255,5738,148077,8,297170
19197,0.008462,172.31.36.0-255,66,148143,8,297170
19198,0.01056,74.125.130.0-255,5738,153881,8,297170
19199,0.010568,172.31.36.0-255,66,153947,8,297170
19200,0.012658,74.125.130.0-255,5738,159685,8,297170
19201,0.012667,172.31.36.0-255,66,159751,8,297170
19202,0.014738,74.125.130.0-255,5738,165489,8,297170
19203,0.014747,172.31.36.0-255,66,165555,8,297170
19204,0.01681,74.125.130.0-255,5738,171293,8,297170
19205,0.016818,172.31.36.0-255,66,171359,8,297170
19206,0.01889,74.125.130.0-255,5738,177097,8,297170
19207,0.018898,172.31.36.0-255,66,177163,8,297170
19208,0.020961,74.125.130.0-255,5738,182901,8,297170
19209,0.020968,172.31.36.0-255,66,182967,8,297170
19210,0.023033,74.125.130.0-255,5738,188705,8,297170
19211,0.02304,172.31.36.0-255,66,188771,8,297170
19212,0.025099,74.125.130.0-255,5738,194509,8,297170
19213,0.025106,172.31.36.0-255,66,194575,8,297170
19214,0.027157,74.125.130.0-255,5738,200313,8,297170
19215,0.027163,172.31.36.0-255,66,200379,8,297170
19216,0.029257,74.125.130.0-255,5738,206117,8,297170
19217,0.029267,172.31.36.0-255,66,206183,8,297170
19218,0.031336,74.125.130.0-255,5738,211921,8,297170
19219,0.031344,172.31.36.0-255,66,211987,8,297170
19220,0.033414,74.125.130.0-255,5738,217725,8,297170
19221,0.033422,172.31.36.0-255,66,217791,8,297170
19222,0.035484,74.125.130.0-255,5738,223529,8,297170
19223,0.035492,172.31.36.0-255,66,223595,8,297170
19224,0.037554,74.125.130.0-255,5738,229333,8,297170
19225,0.037561,172.31.36.0-255,66,229399,8,297170
19226,0.039622,74.125.130.0-255,5738,235137,8,297170
19227,0.03963,172.31.36.0-255,66,235203,8,297170
19228,0.041692,74.125.130.0-255,5738,240941,8,297170
19229,0.0417,172.31.36.0-255,66,241007,8,297170
19230,0.043768,74.125.130.0-255,5738,246745,8,297170
19231,0.050609,172.31.36.0-255,66,246811,8,297170
19232,0.051454,74.125.130.0-255,1484,248295,8,297170
19233,0.05267,74.125.130.0-255,4320,252615,8,297170
19234,0.052679,172.31.36.0-255,66,252681,8,297170
19235,0.05302,172.31.36.0-255,172,252853,8,297170
19236,0.053113,172.31.36.0-255,1111,253964,8,297170
19237,0.053726,172.31.36.0-255,1514,255478,8,297170
19238,0.053729,172.31.36.0-255,866,256344,8,297170
19239,0.054528,104.244.42.0-255,66,256410,8,297170
19240,0.054653,104.244.42.0-255,66,256476,8,297170
19241,0.054749,74.125.130.0-255,5738,262214,8,297170
19242,0.055266,104.244.42.0-255,66,262280,8,297170
19243,0.055606,172.31.36.0-255,66,262346,8,297170
19244,0.057667,74.125.130.0-255,5738,268084,8,297170
19245,0.057677,172.31.36.0-255,66,268150,8,297170
19246,0.059767,74.125.130.0-255,5738,273888,8,297170
19247,0.059776,172.31.36.0-255,66,273954,8,297170
19248,0.061827,74.125.130.0-255,5738,279692,8,297170
19249,0.061833,172.31.36.0-255,66,279758,8,297170
19250,0.063908,74.125.130.0-255,5738,285496,8,297170
19251,0.063915,172.31.36.0-255,66,285562,8,297170
19252,0.065975,74.125.130.0-255,5738,291300,8,297170
19253,0.065981,172.31.36.0-255,66,291366,8,297170
19254,0.068046,74.125.130.0-255,5738,297104,8,297170
19255,0.068053,172.31.36.0-255,66,297170,8,297170
19256,0.0,74.125.68.0-255,153,153,8,402638
19257,3e-05,172.31.36.0-255,66,219,8,402638
19258,3.7e-05,74.125.68.0-255,1484,1703,8,402638
19259,4.1e-05,172.31.36.0-255,66,1769,8,402638
19260,4.4e-05,74.125.68.0-255,1484,3253,8,402638
19261,4.6e-05,172.31.36.0-255,66,3319,8,402638
19262,5.1e-05,74.125.68.0-255,2902,6221,8,402638
19263,5.4e-05,172.31.36.0-255,66,6287,8,402638
19264,6e-05,74.125.68.0-255,5738,12025,8,402638
19265,6.2e-05,172.31.36.0-255,66,12091,8,402638
19266,9.3e-05,74.125.68.0-255,3466,15557,8,402638
19267,9.6e-05,172.31.36.0-255,66,15623,8,402638
19268,0.000101,74.125.68.0-255,4320,19943,8,402638
19269,0.000102,172.31.36.0-255,66,20009,8,402638
19270,0.000136,74.125.68.0-255,5738,25747,8,402638
19271,0.000139,172.31.36.0-255,66,25813,8,402638
19272,0.000155,74.125.68.0-255,2902,28715,8,402638
19273,0.000157,172.31.36.0-255,66,28781,8,402638
19274,0.000177,74.125.68.0-255,1484,30265,8,402638
19275,0.000179,172.31.36.0-255,66,30331,8,402638
19276,0.000184,74.125.68.0-255,1125,31456,8,402638
19277,0.000186,172.31.36.0-255,66,31522,8,402638
19278,0.000246,74.125.68.0-255,1484,33006,8,402638
19279,0.00025,172.31.36.0-255,66,33072,8,402638
19280,0.000255,74.125.68.0-255,2902,35974,8,402638
19281,0.000257,172.31.36.0-255,66,36040,8,402638
19282,0.00027,74.125.68.0-255,1484,37524,8,402638
19283,0.000272,172.31.36.0-255,66,37590,8,402638
19284,0.000294,74.125.68.0-255,4320,41910,8,402638
19285,0.000297,172.31.36.0-255,66,41976,8,402638
19286,0.000304,74.125.68.0-255,6797,48773,8,402638
19287,0.000307,172.31.36.0-255,66,48839,8,402638
19288,0.00056,74.125.68.0-255,1484,50323,8,402638
19289,0.00058,74.125.68.0-255,2902,53225,8,402638
19290,0.000584,172.31.36.0-255,66,53291,8,402638
19291,0.00059,74.125.68.0-255,4320,57611,8,402638
19292,0.000592,172.31.36.0-255,66,57677,8,402638
19293,0.000615,74.125.68.0-255,1484,59161,8,402638
19294,0.00062,74.125.68.0-255,2902,62063,8,402638
19295,0.000622,172.31.36.0-255,66,62129,8,402638
19296,0.000649,74.125.68.0-255,2902,65031,8,402638
19297,0.000652,172.31.36.0-255,66,65097,8,402638
19298,0.00067,74.125.68.0-255,1705,66802,8,402638
19299,0.000672,172.31.36.0-255,66,66868,8,402638
19300,0.000852,74.125.68.0-255,1484,68352,8,402638
19301,0.000868,74.125.68.0-255,2902,71254,8,402638
19302,0.000871,172.31.36.0-255,66,71320,8,402638
19303,0.000876,74.125.68.0-255,2902,74222,8,402638
19304,0.000878,172.31.36.0-255,66,74288,8,402638
19305,0.000897,74.125.68.0-255,2902,77190,8,402638
19306,0.0009,172.31.36.0-255,66,77256,8,402638
19307,0.000903,74.125.68.0-255,1484,78740,8,402638
19308,0.000919,74.125.68.0-255,5379,84119,8,402638
19309,0.000922,172.31.36.0-255,66,84185,8,402638
19310,0.000926,74.125.68.0-255,2902,87087,8,402638
19311,0.000928,172.31.36.0-255,66,87153,8,402638
19312,0.000948,74.125.68.0-255,4320,91473,8,402638
19313,0.000951,172.31.36.0-255,66,91539,8,402638
19314,0.000968,74.125.68.0-255,7156,98695,8,402638
19315,0.000971,172.31.36.0-255,66,98761,8,402638
19316,0.001006,74.125.68.0-255,2543,101304,8,402638
19317,0.001009,172.31.36.0-255,66,101370,8,402638
19318,0.001025,74.125.68.0-255,2902,104272,8,402638
19319,0.001027,172.31.36.0-255,66,104338,8,402638
19320,0.001049,74.125.68.0-255,5738,110076,8,402638
19321,0.001052,172.31.36.0-255,66,110142,8,402638
19322,0.001068,74.125.68.0-255,1484,111626,8,402638
19323,0.001073,74.125.68.0-255,2902,114528,8,402638
19324,0.001075,172.31.36.0-255,66,114594,8,402638
19325,0.001093,74.125.68.0-255,2902,117496,8,402638
19326,0.001095,172.31.36.0-255,66,117562,8,402638
19327,0.001098,74.125.68.0-255,562,118124,8,402638
19328,0.001532,74.125.68.0-255,1484,119608,8,402638
19329,0.001539,172.31.36.0-255,66,119674,8,402638
19330,0.001545,74.125.68.0-255,2902,122576,8,402638
19331,0.001547,172.31.36.0-255,66,122642,8,402638
19332,0.001552,74.125.68.0-255,2902,125544,8,402638
19333,0.001554,172.31.36.0-255,66,125610,8,402638
19334,0.001579,74.125.68.0-255,2902,128512,8,402638
19335,0.001581,172.31.36.0-255,66,128578,8,402638
19336,0.001586,74.125.68.0-255,2902,131480,8,402638
19337,0.001588,172.31.36.0-255,66,131546,8,402638
19338,0.001593,74.125.68.0-255,4320,135866,8,402638
19339,0.001595,172.31.36.0-255,66,135932,8,402638
19340,0.001598,74.125.68.0-255,1484,137416,8,402638
19341,0.001625,74.125.68.0-255,7156,144572,8,402638
19342,0.001628,172.31.36.0-255,66,144638,8,402638
19343,0.001634,74.125.68.0-255,5738,150376,8,402638
19344,0.001637,172.31.36.0-255,66,150442,8,402638
19345,0.001672,74.125.68.0-255,2184,152626,8,402638
19346,0.001675,172.31.36.0-255,66,152692,8,402638
19347,0.001756,74.125.68.0-255,1484,154176,8,402638
19348,0.001761,74.125.68.0-255,1484,155660,8,402638
19349,0.001764,172.31.36.0-255,66,155726,8,402638
19350,0.001782,74.125.68.0-255,1484,157210,8,402638
19351,0.001789,74.125.68.0-255,4320,161530,8,402638
19352,0.001791,172.31.36.0-255,66,161596,8,402638
19353,0.001808,74.125.68.0-255,1484,163080,8,402638
19354,0.001828,74.125.68.0-255,7156,170236,8,402638
19355,0.001831,172.31.36.0-255,66,170302,8,402638
19356,0.001837,74.125.68.0-255,4320,174622,8,402638
19357,0.001839,172.31.36.0-255,66,174688,8,402638
19358,0.001845,74.125.68.0-255,5738,180426,8,402638
19359,0.001847,172.31.36.0-255,66,180492,8,402638
19360,0.001907,172.31.36.0-255,66,180558,8,402638
19361,0.001916,172.31.36.0-255,66,180624,8,402638
19362,0.001921,74.125.68.0-255,5738,186362,8,402638
19363,0.001923,172.31.36.0-255,66,186428,8,402638
19364,0.001946,74.125.68.0-255,2902,189330,8,402638
19365,0.001948,172.31.36.0-255,66,189396,8,402638
19366,0.001957,172.31.36.0-255,66,189462,8,402638
19367,0.001977,74.125.68.0-255,1484,190946,8,402638
19368,0.001982,74.125.68.0-255,3988,194934,8,402638
19369,0.001984,172.31.36.0-255,66,195000,8,402638
19370,0.002155,74.125.68.0-255,1484,196484,8,402638
19371,0.00218,74.125.68.0-255,2902,199386,8,402638
19372,0.002182,172.31.36.0-255,66,199452,8,402638
19373,0.0022,74.125.68.0-255,4320,203772,8,402638
19374,0.002202,172.31.36.0-255,66,203838,8,402638
19375,0.002213,74.125.68.0-255,2902,206740,8,402638
19376,0.002215,172.31.36.0-255,66,206806,8,402638
19377,0.002232,74.125.68.0-255,5738,212544,8,402638
19378,0.002234,172.31.36.0-255,66,212610,8,402638
19379,0.002236,74.125.68.0-255,1484,214094,8,402638
19380,0.00226,74.125.68.0-255,2902,216996,8,402638
19381,0.002262,172.31.36.0-255,66,217062,8,402638
19382,0.002267,74.125.68.0-255,5738,222800,8,402638
19383,0.002269,172.31.36.0-255,66,222866,8,402638
19384,0.002279,74.125.68.0-255,4320,227186,8,402638
19385,0.002281,172.31.36.0-255,66,227252,8,402638
19386,0.004527,74.125.68.0-255,2902,230154,8,402638
19387,0.00453,172.31.36.0-255,66,230220,8,402638
19388,0.004548,74.125.68.0-255,2902,233122,8,402638
19389,0.00455,172.31.36.0-255,66,233188,8,402638
19390,0.006764,74.125.68.0-255,4320,237508,8,402638
19391,0.00677,172.31.36.0-255,66,237574,8,402638
19392,0.006787,74.125.68.0-255,1484,239058,8,402638
19393,0.009032,74.125.68.0-255,4320,243378,8,402638
19394,0.00904,172.31.36.0-255,66,243444,8,402638
19395,0.011284,74.125.68.0-255,5738,249182,8,402638
19396,0.011293,172.31.36.0-255,66,249248,8,402638
19397,0.013543,74.125.68.0-255,5738,254986,8,402638
19398,0.013552,172.31.36.0-255,66,255052,8,402638
19399,0.015784,74.125.68.0-255,5738,260790,8,402638
19400,0.015791,172.31.36.0-255,66,260856,8,402638
19401,0.018027,74.125.68.0-255,5738,266594,8,402638
19402,0.018037,172.31.36.0-255,66,266660,8,402638
19403,0.020277,74.125.68.0-255,5738,272398,8,402638
19404,0.020284,172.31.36.0-255,66,272464,8,402638
19405,0.022516,74.125.68.0-255,5738,278202,8,402638
19406,0.022523,172.31.36.0-255,66,278268,8,402638
19407,0.02475,74.125.68.0-255,5738,284006,8,402638
19408,0.024756,172.31.36.0-255,66,284072,8,402638
19409,0.027001,74.125.68.0-255,5738,289810,8,402638
19410,0.027008,172.31.36.0-255,66,289876,8,402638
19411,0.029254,74.125.68.0-255,5738,295614,8,402638
19412,0.029267,172.31.36.0-255,66,295680,8,402638
19413,0.031514,74.125.68.0-255,5738,301418,8,402638
19414,0.031522,172.31.36.0-255,66,301484,8,402638
19415,0.033754,74.125.68.0-255,5738,307222,8,402638
19416,0.033761,172.31.36.0-255,66,307288,8,402638
19417,0.035999,74.125.68.0-255,4320,311608,8,402638
19418,0.036005,172.31.36.0-255,66,311674,8,402638
19419,0.036038,74.125.68.0-255,1484,313158,8,402638
19420,0.037602,172.31.36.0-255,172,313330,8,402638
19421,0.037636,172.31.36.0-255,1110,314440,8,402638
19422,0.037678,172.31.36.0-255,1514,315954,8,402638
19423,0.037679,172.31.36.0-255,1514,317468,8,402638
19424,0.037685,172.31.36.0-255,1514,318982,8,402638
19425,0.037687,172.31.36.0-255,1514,320496,8,402638
19426,0.037705,172.31.36.0-255,1514,322010,8,402638
19427,0.037706,172.31.36.0-255,995,323005,8,402638
19428,0.038259,74.125.68.0-255,4320,327325,8,402638
19429,0.038266,172.31.36.0-255,66,327391,8,402638
19430,0.039183,104.244.42.0-255,66,327457,8,402638
19431,0.039253,104.244.42.0-255,66,327523,8,402638
19432,0.039304,104.244.42.0-255,66,327589,8,402638
19433,0.03931,104.244.42.0-255,66,327655,8,402638
19434,0.040496,74.125.68.0-255,5738,333393,8,402638
19435,0.040502,172.31.36.0-255,66,333459,8,402638
19436,0.042745,74.125.68.0-255,5738,339197,8,402638
19437,0.042752,172.31.36.0-255,66,339263,8,402638
19438,0.044994,74.125.68.0-255,5738,345001,8,402638
19439,0.045003,172.31.36.0-255,66,345067,8,402638
19440,0.047282,74.125.68.0-255,5738,350805,8,402638
19441,0.04729,172.31.36.0-255,66,350871,8,402638
19442,0.049534,74.125.68.0-255,5738,356609,8,402638
19443,0.049541,172.31.36.0-255,66,356675,8,402638
19444,0.051782,74.125.68.0-255,4320,360995,8,402638
19445,0.051789,172.31.36.0-255,66,361061,8,402638
19446,0.051803,74.125.68.0-255,1484,362545,8,402638
19447,0.05214,172.31.36.0-255,108,362653,8,402638
19448,0.053771,104.244.42.0-255,66,362719,8,402638
19449,0.054034,74.125.68.0-255,2902,365621,8,402638
19450,0.05404,172.31.36.0-255,66,365687,8,402638
19451,0.056304,74.125.68.0-255,5738,371425,8,402638
19452,0.056311,172.31.36.0-255,66,371491,8,402638
19453,0.058558,74.125.68.0-255,5738,377229,8,402638
19454,0.058564,172.31.36.0-255,66,377295,8,402638
19455,0.060802,74.125.68.0-255,5738,383033,8,402638
19456,0.060809,172.31.36.0-255,66,383099,8,402638
19457,0.063057,74.125.68.0-255,5738,388837,8,402638
19458,0.063066,172.31.36.0-255,66,388903,8,402638
19459,0.065304,74.125.68.0-255,5738,394641,8,402638
19460,0.065311,172.31.36.0-255,66,394707,8,402638
19461,0.067534,74.125.68.0-255,4320,399027,8,402638
19462,0.06754,172.31.36.0-255,66,399093,8,402638
19463,0.067557,74.125.68.0-255,1484,400577,8,402638
19464,0.069765,74.125.68.0-255,1890,402467,8,402638
19465,0.069771,172.31.36.0-255,66,402533,8,402638
19466,0.069917,172.31.36.0-255,105,402638,8,402638
19467,0.0,74.125.24.0-255,296,296,8,288417
19468,2.1e-05,172.31.36.0-255,66,362,8,288417
19469,2.7e-05,74.125.24.0-255,1484,1846,8,288417
19470,3.1e-05,172.31.36.0-255,66,1912,8,288417
19471,3.7e-05,74.125.24.0-255,4320,6232,8,288417
19472,3.9e-05,172.31.36.0-255,66,6298,8,288417
19473,5.8e-05,172.31.36.0-255,66,6364,8,288417
19474,0.000106,172.31.36.0-255,66,6430,8,288417
19475,0.000239,74.125.24.0-255,1484,7914,8,288417
19476,0.000243,172.31.36.0-255,66,7980,8,288417
19477,0.000248,74.125.24.0-255,2902,10882,8,288417
19478,0.00025,172.31.36.0-255,66,10948,8,288417
19479,0.000255,74.125.24.0-255,4320,15268,8,288417
19480,0.000263,172.31.36.0-255,66,15334,8,288417
19481,0.000289,74.125.24.0-255,1484,16818,8,288417
19482,0.000291,172.31.36.0-255,66,16884,8,288417
19483,0.000296,74.125.24.0-255,4320,21204,8,288417
19484,0.000298,172.31.36.0-255,66,21270,8,288417
19485,0.000301,74.125.24.0-255,2902,24172,8,288417
19486,0.000303,172.31.36.0-255,66,24238,8,288417
19487,0.000352,172.31.36.0-255,66,24304,8,288417
19488,0.000356,74.125.24.0-255,2543,26847,8,288417
19489,0.000358,172.31.36.0-255,66,26913,8,288417
19490,0.00036,74.125.24.0-255,443,27356,8,288417
19491,0.000362,172.31.36.0-255,66,27422,8,288417
19492,0.000389,74.125.24.0-255,333,27755,8,288417
19493,0.000391,172.31.36.0-255,66,27821,8,288417
19494,0.00071,74.125.24.0-255,1484,29305,8,288417
19495,0.000714,172.31.36.0-255,66,29371,8,288417
19496,0.000719,74.125.24.0-255,2902,32273,8,288417
19497,0.000721,172.31.36.0-255,66,32339,8,288417
19498,0.000724,74.125.24.0-255,1484,33823,8,288417
19499,0.000741,74.125.24.0-255,4320,38143,8,288417
19500,0.000743,172.31.36.0-255,66,38209,8,288417
19501,0.000748,74.125.24.0-255,4320,42529,8,288417
19502,0.00075,172.31.36.0-255,66,42595,8,288417
19503,0.000796,172.31.36.0-255,66,42661,8,288417
19504,0.000807,172.31.36.0-255,66,42727,8,288417
19505,0.001136,74.125.24.0-255,1484,44211,8,288417
19506,0.001142,74.125.24.0-255,2902,47113,8,288417
19507,0.001144,172.31.36.0-255,66,47179,8,288417
19508,0.001177,74.125.24.0-255,5738,52917,8,288417
19509,0.001181,74.125.24.0-255,2902,55819,8,288417
19510,0.001185,172.31.36.0-255,66,55885,8,288417
19511,0.001188,172.31.36.0-255,66,55951,8,288417
19512,0.00122,172.31.36.0-255,66,56017,8,288417
19513,0.001268,172.31.36.0-255,66,56083,8,288417
19514,0.001279,172.31.36.0-255,66,56149,8,288417
19515,0.00131,74.125.24.0-255,2902,59051,8,288417
19516,0.001312,172.31.36.0-255,66,59117,8,288417
19517,0.001348,172.31.36.0-255,66,59183,8,288417
19518,0.001355,74.125.24.0-255,7156,66339,8,288417
19519,0.001356,172.31.36.0-255,66,66405,8,288417
19520,0.001378,74.125.24.0-255,2184,68589,8,288417
19521,0.00138,172.31.36.0-255,66,68655,8,288417
19522,0.001533,74.125.24.0-255,1484,70139,8,288417
19523,0.001567,74.125.24.0-255,1484,71623,8,288417
19524,0.00157,172.31.36.0-255,66,71689,8,288417
19525,0.001594,74.125.24.0-255,1484,73173,8,288417
19526,0.001598,74.125.24.0-255,1484,74657,8,288417
19527,0.001599,172.31.36.0-255,66,74723,8,288417
19528,0.001627,74.125.24.0-255,4320,79043,8,288417
19529,0.001629,172.31.36.0-255,66,79109,8,288417
19530,0.001634,74.125.24.0-255,4320,83429,8,288417
19531,0.001636,172.31.36.0-255,66,83495,8,288417
19532,0.001679,172.31.36.0-255,66,83561,8,288417
19533,0.001691,172.31.36.0-255,66,83627,8,288417
19534,0.003662,74.125.24.0-255,5738,89365,8,288417
19535,0.003672,172.31.36.0-255,66,89431,8,288417
19536,0.005609,74.125.24.0-255,5738,95169,8,288417
19537,0.005614,172.31.36.0-255,66,95235,8,288417
19538,0.00758,74.125.24.0-255,5738,100973,8,288417
19539,0.007585,172.31.36.0-255,66,101039,8,288417
19540,0.009564,74.125.24.0-255,5738,106777,8,288417
19541,0.00957,172.31.36.0-255,66,106843,8,288417
19542,0.011569,74.125.24.0-255,5738,112581,8,288417
19543,0.011578,172.31.36.0-255,66,112647,8,288417
19544,0.013534,74.125.24.0-255,5738,118385,8,288417
19545,0.013541,172.31.36.0-255,66,118451,8,288417
19546,0.015521,74.125.24.0-255,5738,124189,8,288417
19547,0.015528,172.31.36.0-255,66,124255,8,288417
19548,0.017476,74.125.24.0-255,5738,129993,8,288417
19549,0.01749,172.31.36.0-255,66,130059,8,288417
19550,0.019476,74.125.24.0-255,5738,135797,8,288417
19551,0.019484,172.31.36.0-255,66,135863,8,288417
19552,0.021458,74.125.24.0-255,5738,141601,8,288417
19553,0.021465,172.31.36.0-255,66,141667,8,288417
19554,0.023454,74.125.24.0-255,5738,147405,8,288417
19555,0.02346,172.31.36.0-255,66,147471,8,288417
19556,0.025429,74.125.24.0-255,4320,151791,8,288417
19557,0.025435,172.31.36.0-255,66,151857,8,288417
19558,0.025458,74.125.24.0-255,1484,153341,8,288417
19559,0.027407,74.125.24.0-255,4320,157661,8,288417
19560,0.027412,172.31.36.0-255,66,157727,8,288417
19561,0.02936,74.125.24.0-255,5738,163465,8,288417
19562,0.029367,172.31.36.0-255,66,163531,8,288417
19563,0.031353,74.125.24.0-255,5738,169269,8,288417
19564,0.031361,172.31.36.0-255,66,169335,8,288417
19565,0.03334,74.125.24.0-255,5738,175073,8,288417
19566,0.033348,172.31.36.0-255,66,175139,8,288417
19567,0.035304,74.125.24.0-255,5738,180877,8,288417
19568,0.035311,172.31.36.0-255,66,180943,8,288417
19569,0.037266,74.125.24.0-255,5738,186681,8,288417
19570,0.037273,172.31.36.0-255,66,186747,8,288417
19571,0.037698,172.31.36.0-255,164,186911,8,288417
19572,0.037738,172.31.36.0-255,1118,188029,8,288417
19573,0.03781,172.31.36.0-255,1514,189543,8,288417
19574,0.037812,172.31.36.0-255,1514,191057,8,288417
19575,0.037817,172.31.36.0-255,1514,192571,8,288417
19576,0.037818,172.31.36.0-255,1514,194085,8,288417
19577,0.037846,172.31.36.0-255,1514,195599,8,288417
19578,0.037847,172.31.36.0-255,868,196467,8,288417
19579,0.039227,74.125.24.0-255,5738,202205,8,288417
19580,0.03924,172.31.36.0-255,66,202271,8,288417
19581,0.039266,104.244.42.0-255,66,202337,8,288417
19582,0.039361,104.244.42.0-255,66,202403,8,288417
19583,0.039394,104.244.42.0-255,66,202469,8,288417
19584,0.039399,104.244.42.0-255,66,202535,8,288417
19585,0.041233,74.125.24.0-255,5738,208273,8,288417
19586,0.041239,172.31.36.0-255,66,208339,8,288417
19587,0.043215,74.125.24.0-255,5738,214077,8,288417
19588,0.043222,172.31.36.0-255,66,214143,8,288417
19589,0.0452,74.125.24.0-255,5738,219881,8,288417
19590,0.045211,172.31.36.0-255,66,219947,8,288417
19591,0.047214,74.125.24.0-255,5738,225685,8,288417
19592,0.047221,172.31.36.0-255,66,225751,8,288417
19593,0.049192,74.125.24.0-255,4320,230071,8,288417
19594,0.049198,172.31.36.0-255,66,230137,8,288417
19595,0.049223,74.125.24.0-255,1484,231621,8,288417
19596,0.051193,74.125.24.0-255,4320,235941,8,288417
19597,0.051201,172.31.36.0-255,66,236007,8,288417
19598,0.05272,172.31.36.0-255,108,236115,8,288417
19599,0.053209,74.125.24.0-255,5738,241853,8,288417
19600,0.053216,172.31.36.0-255,66,241919,8,288417
19601,0.054284,104.244.42.0-255,66,241985,8,288417
19602,0.055267,74.125.24.0-255,5738,247723,8,288417
19603,0.055275,172.31.36.0-255,66,247789,8,288417
19604,0.057253,74.125.24.0-255,5738,253527,8,288417
19605,0.05726,172.31.36.0-255,66,253593,8,288417
19606,0.059223,74.125.24.0-255,5738,259331,8,288417
19607,0.059228,172.31.36.0-255,66,259397,8,288417
19608,0.061229,74.125.24.0-255,5738,265135,8,288417
19609,0.061235,172.31.36.0-255,66,265201,8,288417
19610,0.063189,74.125.24.0-255,5738,270939,8,288417
19611,0.063196,172.31.36.0-255,66,271005,8,288417
19612,0.065199,74.125.24.0-255,5738,276743,8,288417
19613,0.065207,172.31.36.0-255,66,276809,8,288417
19614,0.06717,74.125.24.0-255,5738,282547,8,288417
19615,0.067177,172.31.36.0-255,66,282613,8,288417
19616,0.069157,74.125.24.0-255,5738,288351,8,288417
19617,0.069164,172.31.36.0-255,66,288417,8,288417
19618,0.0,172.217.194.0-255,143,143,8,173256
19619,1.6e-05,172.31.36.0-255,66,209,8,173256
19620,2.2e-05,172.217.194.0-255,1484,1693,8,173256
19621,2.6e-05,172.31.36.0-255,66,1759,8,173256
19622,3.2e-05,172.217.194.0-255,2902,4661,8,173256
19623,4.5e-05,172.31.36.0-255,66,4727,8,173256
19624,5.2e-05,172.217.194.0-255,7156,11883,8,173256
19625,5.5e-05,172.31.36.0-255,66,11949,8,173256
19626,7.9e-05,172.217.194.0-255,6211,18160,8,173256
19627,8.2e-05,172.31.36.0-255,66,18226,8,173256
19628,9.2e-05,172.217.194.0-255,5738,23964,8,173256
19629,9.4e-05,172.31.36.0-255,66,24030,8,173256
19630,0.000116,172.217.194.0-255,1484,25514,8,173256
19631,0.000119,172.31.36.0-255,66,25580,8,173256
19632,0.000129,172.217.194.0-255,5379,30959,8,173256
19633,0.000131,172.31.36.0-255,66,31025,8,173256
19634,0.000186,172.217.194.0-255,1484,32509,8,173256
19635,0.000188,172.31.36.0-255,66,32575,8,173256
19636,0.000207,172.217.194.0-255,2902,35477,8,173256
19637,0.000209,172.31.36.0-255,66,35543,8,173256
19638,0.000229,172.217.194.0-255,5738,41281,8,173256
19639,0.000231,172.31.36.0-255,66,41347,8,173256
19640,0.000264,172.217.194.0-255,4320,45667,8,173256
19641,0.000266,172.31.36.0-255,66,45733,8,173256
19642,0.000289,172.31.36.0-255,66,45799,8,173256
19643,0.000315,172.217.194.0-255,5738,51537,8,173256
19644,0.000317,172.31.36.0-255,66,51603,8,173256
19645,0.000345,172.217.194.0-255,4250,55853,8,173256
19646,0.000348,172.31.36.0-255,66,55919,8,173256
19647,0.000658,172.217.194.0-255,98,56017,8,173256
19648,0.000664,172.31.36.0-255,66,56083,8,173256
19649,0.000758,172.217.194.0-255,1484,57567,8,173256
19650,0.000764,172.217.194.0-255,1484,59051,8,173256
19651,0.000767,172.31.36.0-255,66,59117,8,173256
19652,0.000799,172.217.194.0-255,1484,60601,8,173256
19653,0.000806,172.217.194.0-255,5738,66339,8,173256
19654,0.00082,172.217.194.0-255,1484,67823,8,173256
19655,0.00083,172.31.36.0-255,66,67889,8,173256
19656,0.000834,172.31.36.0-255,66,67955,8,173256
19657,0.000843,172.217.194.0-255,7156,75111,8,173256
19658,0.00085,172.31.36.0-255,66,75177,8,173256
19659,0.000853,172.217.194.0-255,844,76021,8,173256
19660,0.000981,172.217.194.0-255,1484,77505,8,173256
19661,0.000986,172.31.36.0-255,66,77571,8,173256
19662,0.000991,172.217.194.0-255,2902,80473,8,173256
19663,0.000994,172.31.36.0-255,66,80539,8,173256
19664,0.001026,172.217.194.0-255,5738,86277,8,173256
19665,0.001029,172.31.36.0-255,66,86343,8,173256
19666,0.001048,172.31.36.0-255,66,86409,8,173256
19667,0.001087,172.217.194.0-255,5738,92147,8,173256
19668,0.00109,172.31.36.0-255,66,92213,8,173256
19669,0.00112,172.217.194.0-255,5020,97233,8,173256
19670,0.001123,172.31.36.0-255,66,97299,8,173256
19671,0.001292,172.217.194.0-255,1484,98783,8,173256
19672,0.001306,172.217.194.0-255,2902,101685,8,173256
19673,0.00131,172.31.36.0-255,66,101751,8,173256
19674,0.001315,172.217.194.0-255,2902,104653,8,173256
19675,0.001317,172.31.36.0-255,66,104719,8,173256
19676,0.00135,172.217.194.0-255,2902,107621,8,173256
19677,0.001353,172.31.36.0-255,66,107687,8,173256
19678,0.001361,172.217.194.0-255,7156,114843,8,173256
19679,0.001363,172.31.36.0-255,66,114909,8,173256
19680,0.001375,172.31.36.0-255,66,114975,8,173256
19681,0.001412,172.217.194.0-255,4320,119295,8,173256
19682,0.001415,172.31.36.0-255,66,119361,8,173256
19683,0.001419,172.217.194.0-255,2184,121545,8,173256
19684,0.001422,172.31.36.0-255,66,121611,8,173256
19685,0.001633,172.217.194.0-255,1484,123095,8,173256
19686,0.00164,172.217.194.0-255,2902,125997,8,173256
19687,0.001643,172.31.36.0-255,66,126063,8,173256
19688,0.00165,172.217.194.0-255,5738,131801,8,173256
19689,0.001652,172.31.36.0-255,66,131867,8,173256
19690,0.001688,172.31.36.0-255,66,131933,8,173256
19691,0.0017,172.31.36.0-255,66,131999,8,173256
19692,0.001745,172.31.36.0-255,66,132065,8,173256
19693,0.001795,172.31.36.0-255,66,132131,8,173256
19694,0.001823,172.217.194.0-255,6438,138569,8,173256
19695,0.001826,172.31.36.0-255,66,138635,8,173256
19696,0.001836,172.31.36.0-255,66,138701,8,173256
19697,0.00185,172.31.36.0-255,66,138767,8,173256
19698,0.001896,172.31.36.0-255,66,138833,8,173256
19699,0.001917,172.31.36.0-255,66,138899,8,173256
19700,0.001947,172.217.194.0-255,3602,142501,8,173256
19701,0.001949,172.31.36.0-255,66,142567,8,173256
19702,0.001971,172.31.36.0-255,66,142633,8,173256
19703,0.002007,172.31.36.0-255,66,142699,8,173256
19704,0.00201,172.217.194.0-255,1484,144183,8,173256
19705,0.002025,172.31.36.0-255,66,144249,8,173256
19706,0.002066,172.31.36.0-255,66,144315,8,173256
19707,0.002081,172.31.36.0-255,66,144381,8,173256
19708,0.002096,172.31.36.0-255,66,144447,8,173256
19709,0.002102,172.217.194.0-255,7156,151603,8,173256
19710,0.002104,172.31.36.0-255,66,151669,8,173256
19711,0.002107,172.217.194.0-255,1484,153153,8,173256
19712,0.00214,172.217.194.0-255,7156,160309,8,173256
19713,0.002149,172.217.194.0-255,6215,166524,8,173256
19714,0.002185,172.31.36.0-255,66,166590,8,173256
19715,0.002191,172.31.36.0-255,66,166656,8,173256
19716,0.004234,172.217.194.0-255,168,166824,8,173256
19717,0.008102,172.31.36.0-255,105,166929,8,173256
19718,0.008141,172.31.36.0-255,105,167034,8,173256
19719,0.008428,172.31.36.0-255,90,167124,8,173256
19720,0.008438,172.31.36.0-255,66,167190,8,173256
19721,0.010158,172.217.194.0-255,66,167256,8,173256
19722,0.010178,172.217.194.0-255,66,167322,8,173256
19723,0.010458,172.217.194.0-255,66,167388,8,173256
19724,0.010483,172.217.194.0-255,66,167454,8,173256
19725,0.010489,172.31.36.0-255,66,167520,8,173256
19726,0.010514,172.217.194.0-255,66,167586,8,173256
19727,0.035407,172.31.36.0-255,187,167773,8,173256
19728,0.035442,172.31.36.0-255,979,168752,8,173256
19729,0.035531,172.31.36.0-255,1514,170266,8,173256
19730,0.035553,172.31.36.0-255,1514,171780,8,173256
19731,0.035555,172.31.36.0-255,1212,172992,8,173256
19732,0.036959,104.244.42.0-255,66,173058,8,173256
19733,0.037006,104.244.42.0-255,66,173124,8,173256
19734,0.037163,104.244.42.0-255,66,173190,8,173256
19735,0.037209,104.244.42.0-255,66,173256,8,173256
19736,0.0,172.217.194.0-255,153,153,8,244850
19737,1.3e-05,172.31.36.0-255,66,219,8,244850
19738,2e-05,172.217.194.0-255,1484,1703,8,244850
19739,2.4e-05,172.31.36.0-255,66,1769,8,244850
19740,3.1e-05,172.217.194.0-255,2902,4671,8,244850
19741,3.4e-05,172.31.36.0-255,66,4737,8,244850
19742,3.7e-05,172.217.194.0-255,1484,6221,8,244850
19743,3.9e-05,172.31.36.0-255,66,6287,8,244850
19744,6.8e-05,172.217.194.0-255,5738,12025,8,244850
19745,7.1e-05,172.31.36.0-255,66,12091,8,244850
19746,7.5e-05,172.217.194.0-255,2062,14153,8,244850
19747,7.7e-05,172.31.36.0-255,66,14219,8,244850
19748,0.000152,172.217.194.0-255,1484,15703,8,244850
19749,0.000156,172.31.36.0-255,66,15769,8,244850
19750,0.000161,172.217.194.0-255,2902,18671,8,244850
19751,0.000163,172.31.36.0-255,66,18737,8,244850
19752,0.000169,172.217.194.0-255,5738,24475,8,244850
19753,0.000172,172.31.36.0-255,66,24541,8,244850
19754,0.000176,172.217.194.0-255,2902,27443,8,244850
19755,0.000178,172.31.36.0-255,66,27509,8,244850
19756,0.000202,172.217.194.0-255,3961,31470,8,244850
19757,0.000204,172.31.36.0-255,66,31536,8,244850
19758,0.000216,172.31.36.0-255,66,31602,8,244850
19759,0.000231,172.217.194.0-255,5738,37340,8,244850
19760,0.000235,172.31.36.0-255,66,37406,8,244850
19761,0.000246,172.31.36.0-255,66,37472,8,244850
19762,0.00027,172.217.194.0-255,7156,44628,8,244850
19763,0.000272,172.31.36.0-255,66,44694,8,244850
19764,0.000277,172.217.194.0-255,2513,47207,8,244850
19765,0.000279,172.31.36.0-255,66,47273,8,244850
19766,0.000452,172.217.194.0-255,380,47653,8,244850
19767,0.000889,172.217.194.0-255,1484,49137,8,244850
19768,0.000894,172.31.36.0-255,66,49203,8,244850
19769,0.0009,172.217.194.0-255,2902,52105,8,244850
19770,0.000906,172.217.194.0-255,4320,56425,8,244850
19771,0.000918,172.217.194.0-255,1484,57909,8,244850
19772,0.000931,172.31.36.0-255,66,57975,8,244850
19773,0.000943,172.217.194.0-255,7156,65131,8,244850
19774,0.000952,172.31.36.0-255,66,65197,8,244850
19775,0.000959,172.217.194.0-255,5738,70935,8,244850
19776,0.000986,172.217.194.0-255,766,71701,8,244850
19777,0.000994,172.31.36.0-255,66,71767,8,244850
19778,0.001167,172.217.194.0-255,1484,73251,8,244850
19779,0.001173,172.217.194.0-255,2902,76153,8,244850
19780,0.001177,172.31.36.0-255,66,76219,8,244850
19781,0.001184,172.217.194.0-255,5738,81957,8,244850
19782,0.001187,172.217.194.0-255,1484,83441,8,244850
19783,0.001191,172.31.36.0-255,66,83507,8,244850
19784,0.001211,172.217.194.0-255,2902,86409,8,244850
19785,0.001229,172.31.36.0-255,66,86475,8,244850
19786,0.001253,172.217.194.0-255,4320,90795,8,244850
19787,0.001267,172.217.194.0-255,3602,94397,8,244850
19788,0.001275,172.31.36.0-255,66,94463,8,244850
19789,0.001592,172.217.194.0-255,1484,95947,8,244850
19790,0.001612,172.217.194.0-255,2902,98849,8,244850
19791,0.001616,172.31.36.0-255,66,98915,8,244850
19792,0.001623,172.217.194.0-255,5738,104653,8,244850
19793,0.001633,172.31.36.0-255,66,104719,8,244850
19794,0.00165,172.217.194.0-255,5738,110457,8,244850
19795,0.001673,172.217.194.0-255,7156,117613,8,244850
19796,0.001679,172.217.194.0-255,5738,123351,8,244850
19797,0.001694,172.31.36.0-255,66,123417,8,244850
19798,0.001722,172.217.194.0-255,5020,128437,8,244850
19799,0.001728,172.31.36.0-255,66,128503,8,244850
19800,0.002048,172.217.194.0-255,1484,129987,8,244850
19801,0.002068,172.217.194.0-255,2902,132889,8,244850
19802,0.002072,172.31.36.0-255,66,132955,8,244850
19803,0.00208,172.217.194.0-255,5738,138693,8,244850
19804,0.002154,172.31.36.0-255,66,138759,8,244850
19805,0.002787,172.217.194.0-255,1484,140243,8,244850
19806,0.002797,172.217.194.0-255,2902,143145,8,244850
19807,0.002802,172.31.36.0-255,66,143211,8,244850
19808,0.002809,172.217.194.0-255,4320,147531,8,244850
19809,0.002823,172.217.194.0-255,1484,149015,8,244850
19810,0.002846,172.217.194.0-255,5738,154753,8,244850
19811,0.002864,172.217.194.0-255,7156,161909,8,244850
19812,0.002869,172.217.194.0-255,2902,164811,8,244850
19813,0.002896,172.217.194.0-255,7156,171967,8,244850
19814,0.002899,172.217.194.0-255,766,172733,8,244850
19815,0.002981,172.217.194.0-255,1484,174217,8,244850
19816,0.002987,172.217.194.0-255,2902,177119,8,244850
19817,0.00299,172.217.194.0-255,1484,178603,8,244850
19818,0.003006,172.217.194.0-255,4320,182923,8,244850
19819,0.00302,172.217.194.0-255,1484,184407,8,244850
19820,0.003092,172.217.194.0-255,2184,186591,8,244850
19821,0.003123,172.217.194.0-255,2902,189493,8,244850
19822,0.003142,172.217.194.0-255,7156,196649,8,244850
19823,0.003147,172.217.194.0-255,2902,199551,8,244850
19824,0.003167,172.217.194.0-255,5738,205289,8,244850
19825,0.003193,172.217.194.0-255,2902,208191,8,244850
19826,0.003208,172.217.194.0-255,7156,215347,8,244850
19827,0.003232,172.217.194.0-255,5020,220367,8,244850
19828,0.003239,172.217.194.0-255,5738,226105,8,244850
19829,0.003271,172.217.194.0-255,1484,227589,8,244850
19830,0.003301,172.217.194.0-255,4320,231909,8,244850
19831,0.003396,172.217.194.0-255,5738,237647,8,244850
19832,0.003505,172.217.194.0-255,105,237752,8,244850
19833,0.007381,172.31.36.0-255,66,237818,8,244850
19834,0.009027,172.31.36.0-255,105,237923,8,244850
19835,0.01127,172.217.194.0-255,66,237989,8,244850
19836,0.041145,172.31.36.0-255,172,238161,8,244850
19837,0.04118,172.31.36.0-255,1112,239273,8,244850
19838,0.041248,172.31.36.0-255,1514,240787,8,244850
19839,0.04125,172.31.36.0-255,1514,242301,8,244850
19840,0.041254,172.31.36.0-255,1514,243815,8,244850
19841,0.041256,172.31.36.0-255,771,244586,8,244850
19842,0.042723,104.244.42.0-255,66,244652,8,244850
19843,0.042733,104.244.42.0-255,66,244718,8,244850
19844,0.042827,104.244.42.0-255,66,244784,8,244850
19845,0.042831,104.244.42.0-255,66,244850,8,244850
19846,0.0,172.217.194.0-255,153,153,8,203537
19847,2.8e-05,172.31.36.0-255,66,219,8,203537
19848,3.5e-05,172.217.194.0-255,1484,1703,8,203537
19849,3.9e-05,172.31.36.0-255,66,1769,8,203537
19850,4.5e-05,172.217.194.0-255,2902,4671,8,203537
19851,4.7e-05,172.31.36.0-255,66,4737,8,203537
19852,5.4e-05,172.217.194.0-255,7156,11893,8,203537
19853,5.7e-05,172.31.36.0-255,66,11959,8,203537
19854,6e-05,172.217.194.0-255,1484,13443,8,203537
19855,6.2e-05,172.31.36.0-255,66,13509,8,203537
19856,0.000103,172.31.36.0-255,66,13575,8,203537
19857,0.000108,172.217.194.0-255,4320,17895,8,203537
19858,0.00011,172.31.36.0-255,66,17961,8,203537
19859,0.000128,172.217.194.0-255,5738,23699,8,203537
19860,0.000131,172.31.36.0-255,66,23765,8,203537
19861,0.000182,172.31.36.0-255,66,23831,8,203537
19862,0.000207,172.217.194.0-255,1484,25315,8,203537
19863,0.000209,172.31.36.0-255,66,25381,8,203537
19864,0.000223,172.217.194.0-255,5738,31119,8,203537
19865,0.000226,172.31.36.0-255,66,31185,8,203537
19866,0.000257,172.217.194.0-255,7156,38341,8,203537
19867,0.00026,172.31.36.0-255,66,38407,8,203537
19868,0.000263,172.217.194.0-255,1484,39891,8,203537
19869,0.000267,172.31.36.0-255,66,39957,8,203537
19870,0.000279,172.217.194.0-255,1125,41082,8,203537
19871,0.000281,172.31.36.0-255,66,41148,8,203537
19872,0.000293,172.217.194.0-255,345,41493,8,203537
19873,0.000296,172.31.36.0-255,66,41559,8,203537
19874,0.00047,172.217.194.0-255,118,41677,8,203537
19875,0.000474,172.31.36.0-255,66,41743,8,203537
19876,0.000876,172.217.194.0-255,1484,43227,8,203537
19877,0.000886,172.217.194.0-255,2902,46129,8,203537
19878,0.000891,172.31.36.0-255,66,46195,8,203537
19879,0.000898,172.217.194.0-255,5738,51933,8,203537
19880,0.0009,172.31.36.0-255,66,51999,8,203537
19881,0.000941,172.31.36.0-255,66,52065,8,203537
19882,0.000965,172.217.194.0-255,1484,53549,8,203537
19883,0.001002,172.31.36.0-255,66,53615,8,203537
19884,0.001009,172.217.194.0-255,2902,56517,8,203537
19885,0.001011,172.31.36.0-255,66,56583,8,203537
19886,0.001043,172.31.36.0-255,66,56649,8,203537
19887,0.001073,172.217.194.0-255,1484,58133,8,203537
19888,0.001099,172.217.194.0-255,5738,63871,8,203537
19889,0.001103,172.31.36.0-255,66,63937,8,203537
19890,0.001129,172.217.194.0-255,7156,71093,8,203537
19891,0.001132,172.31.36.0-255,66,71159,8,203537
19892,0.001139,172.217.194.0-255,6438,77597,8,203537
19893,0.001142,172.31.36.0-255,66,77663,8,203537
19894,0.001153,172.31.36.0-255,66,77729,8,203537
19895,0.001167,172.31.36.0-255,66,77795,8,203537
19896,0.001201,172.217.194.0-255,2902,80697,8,203537
19897,0.001204,172.31.36.0-255,66,80763,8,203537
19898,0.001239,172.31.36.0-255,66,80829,8,203537
19899,0.001252,172.217.194.0-255,1484,82313,8,203537
19900,0.00127,172.217.194.0-255,2902,85215,8,203537
19901,0.001272,172.31.36.0-255,66,85281,8,203537
19902,0.001296,172.217.194.0-255,5738,91019,8,203537
19903,0.001299,172.31.36.0-255,66,91085,8,203537
19904,0.001305,172.217.194.0-255,5738,96823,8,203537
19905,0.001308,172.31.36.0-255,66,96889,8,203537
19906,0.001329,172.217.194.0-255,7156,104045,8,203537
19907,0.001332,172.31.36.0-255,66,104111,8,203537
19908,0.001341,172.217.194.0-255,7156,111267,8,203537
19909,0.001343,172.31.36.0-255,66,111333,8,203537
19910,0.001367,172.217.194.0-255,3602,114935,8,203537
19911,0.001371,172.31.36.0-255,66,115001,8,203537
19912,0.001403,172.217.194.0-255,4320,119321,8,203537
19913,0.001406,172.31.36.0-255,66,119387,8,203537
19914,0.001428,172.217.194.0-255,7156,126543,8,203537
19915,0.001432,172.31.36.0-255,66,126609,8,203537
19916,0.001448,172.217.194.0-255,4320,130929,8,203537
19917,0.001451,172.31.36.0-255,66,130995,8,203537
19918,0.001471,172.31.36.0-255,66,131061,8,203537
19919,0.001478,172.217.194.0-255,5738,136799,8,203537
19920,0.001481,172.31.36.0-255,66,136865,8,203537
19921,0.001497,172.217.194.0-255,3602,140467,8,203537
19922,0.0015,172.31.36.0-255,66,140533,8,203537
19923,0.001757,172.217.194.0-255,1484,142017,8,203537
19924,0.001763,172.217.194.0-255,2902,144919,8,203537
19925,0.001766,172.31.36.0-255,66,144985,8,203537
19926,0.00179,172.217.194.0-255,5738,150723,8,203537
19927,0.001793,172.31.36.0-255,66,150789,8,203537
19928,0.001798,172.217.194.0-255,2902,153691,8,203537
19929,0.0018,172.31.36.0-255,66,153757,8,203537
19930,0.001827,172.31.36.0-255,66,153823,8,203537
19931,0.001848,172.217.194.0-255,1484,155307,8,203537
19932,0.001861,172.31.36.0-255,66,155373,8,203537
19933,0.001864,172.217.194.0-255,1484,156857,8,203537
19934,0.00191,172.31.36.0-255,66,156923,8,203537
19935,0.001922,172.31.36.0-255,66,156989,8,203537
19936,0.00195,172.31.36.0-255,66,157055,8,203537
19937,0.001975,172.217.194.0-255,5020,162075,8,203537
19938,0.00198,172.31.36.0-255,66,162141,8,203537
19939,0.001983,172.217.194.0-255,1484,163625,8,203537
19940,0.001988,172.217.194.0-255,2902,166527,8,203537
19941,0.00199,172.31.36.0-255,66,166593,8,203537
19942,0.002026,172.217.194.0-255,5738,172331,8,203537
19943,0.002031,172.217.194.0-255,4320,176651,8,203537
19944,0.002032,172.31.36.0-255,66,176717,8,203537
19945,0.002036,172.31.36.0-255,66,176783,8,203537
19946,0.002066,172.31.36.0-255,66,176849,8,203537
19947,0.00207,172.217.194.0-255,1484,178333,8,203537
19948,0.002086,172.217.194.0-255,2902,181235,8,203537
19949,0.002089,172.31.36.0-255,66,181301,8,203537
19950,0.002135,172.217.194.0-255,6438,187739,8,203537
19951,0.00214,172.31.36.0-255,66,187805,8,203537
19952,0.002152,172.31.36.0-255,66,187871,8,203537
19953,0.002202,172.31.36.0-255,66,187937,8,203537
19954,0.002231,172.217.194.0-255,7156,195093,8,203537
19955,0.002235,172.31.36.0-255,66,195159,8,203537
19956,0.002253,172.31.36.0-255,66,195225,8,203537
19957,0.002265,172.31.36.0-255,66,195291,8,203537
19958,0.002283,172.31.36.0-255,66,195357,8,203537
19959,0.002307,172.217.194.0-255,105,195462,8,203537
19960,0.00388,172.31.36.0-255,66,195528,8,203537
19961,0.003903,172.31.36.0-255,105,195633,8,203537
19962,0.006223,172.217.194.0-255,66,195699,8,203537
19963,0.036521,172.31.36.0-255,172,195871,8,203537
19964,0.036552,172.31.36.0-255,1112,196983,8,203537
19965,0.036617,172.31.36.0-255,1514,198497,8,203537
19966,0.036619,172.31.36.0-255,1514,200011,8,203537
19967,0.036626,172.31.36.0-255,1514,201525,8,203537
19968,0.036627,172.31.36.0-255,1514,203039,8,203537
19969,0.036644,172.31.36.0-255,168,203207,8,203537
19970,0.038116,104.244.42.0-255,66,203273,8,203537
19971,0.038151,104.244.42.0-255,66,203339,8,203537
19972,0.038281,104.244.42.0-255,66,203405,8,203537
19973,0.038284,104.244.42.0-255,66,203471,8,203537
19974,0.038286,104.244.42.0-255,66,203537,8,203537
19975,0.0,172.217.194.0-255,153,153,8,246774
19976,2.8e-05,172.31.36.0-255,66,219,8,246774
19977,3.3e-05,172.217.194.0-255,1484,1703,8,246774
19978,3.8e-05,172.31.36.0-255,66,1769,8,246774
19979,4.3e-05,172.217.194.0-255,2902,4671,8,246774
19980,4.5e-05,172.31.36.0-255,66,4737,8,246774
19981,4.8e-05,172.217.194.0-255,1484,6221,8,246774
19982,5e-05,172.31.36.0-255,66,6287,8,246774
19983,7.7e-05,172.217.194.0-255,5738,12025,8,246774
19984,7.9e-05,172.31.36.0-255,66,12091,8,246774
19985,9.7e-05,172.217.194.0-255,2085,14176,8,246774
19986,0.000101,172.31.36.0-255,66,14242,8,246774
19987,0.000186,172.217.194.0-255,1484,15726,8,246774
19988,0.000191,172.31.36.0-255,66,15792,8,246774
19989,0.000197,172.217.194.0-255,2902,18694,8,246774
19990,0.000199,172.31.36.0-255,66,18760,8,246774
19991,0.000214,172.217.194.0-255,5738,24498,8,246774
19992,0.000217,172.31.36.0-255,66,24564,8,246774
19993,0.000246,172.217.194.0-255,4320,28884,8,246774
19994,0.000249,172.31.36.0-255,66,28950,8,246774
19995,0.000286,172.31.36.0-255,66,29016,8,246774
19996,0.000299,172.31.36.0-255,66,29082,8,246774
19997,0.000311,172.31.36.0-255,66,29148,8,246774
19998,0.000335,172.217.194.0-255,2902,32050,8,246774
19999,0.000339,172.31.36.0-255,66,32116,8,246774
20000,0.000344,172.217.194.0-255,2477,34593,8,246774
20001,0.000349,172.31.36.0-255,66,34659,8,246774
20002,0.000365,172.217.194.0-255,384,35043,8,246774
20003,0.000367,172.31.36.0-255,66,35109,8,246774
20004,0.000646,172.217.194.0-255,1484,36593,8,246774
20005,0.000652,172.217.194.0-255,2902,39495,8,246774
20006,0.000656,172.31.36.0-255,66,39561,8,246774
20007,0.000681,172.217.194.0-255,5738,45299,8,246774
20008,0.000684,172.31.36.0-255,66,45365,8,246774
20009,0.000691,172.217.194.0-255,5738,51103,8,246774
20010,0.000693,172.31.36.0-255,66,51169,8,246774
20011,0.000723,172.217.194.0-255,7156,58325,8,246774
20012,0.000727,172.31.36.0-255,66,58391,8,246774
20013,0.000734,172.217.194.0-255,7156,65547,8,246774
20014,0.000738,172.31.36.0-255,66,65613,8,246774
20015,0.000759,172.217.194.0-255,5738,71351,8,246774
20016,0.000762,172.31.36.0-255,66,71417,8,246774
20017,0.0008,172.31.36.0-255,66,71483,8,246774
20018,0.00086,172.217.194.0-255,1484,72967,8,246774
20019,0.000865,172.217.194.0-255,2902,75869,8,246774
20020,0.000868,172.31.36.0-255,66,75935,8,246774
20021,0.000873,172.217.194.0-255,2902,78837,8,246774
20022,0.000875,172.31.36.0-255,66,78903,8,246774
20023,0.000889,172.217.194.0-255,2902,81805,8,246774
20024,0.000892,172.31.36.0-255,66,81871,8,246774
20025,0.000928,172.217.194.0-255,4320,86191,8,246774
20026,0.000931,172.31.36.0-255,66,86257,8,246774
20027,0.000957,172.31.36.0-255,66,86323,8,246774
20028,0.00096,172.217.194.0-255,1484,87807,8,246774
20029,0.00097,172.31.36.0-255,66,87873,8,246774
20030,0.000991,172.217.194.0-255,7156,95029,8,246774
20031,0.000994,172.31.36.0-255,66,95095,8,246774
20032,0.001008,172.217.194.0-255,2902,97997,8,246774
20033,0.001011,172.31.36.0-255,66,98063,8,246774
20034,0.001019,172.217.194.0-255,6797,104860,8,246774
20035,0.001021,172.31.36.0-255,66,104926,8,246774
20036,0.001054,172.217.194.0-255,4320,109246,8,246774
20037,0.001058,172.31.36.0-255,66,109312,8,246774
20038,0.00108,172.217.194.0-255,5738,115050,8,246774
20039,0.001084,172.31.36.0-255,66,115116,8,246774
20040,0.001086,172.217.194.0-255,5738,120854,8,246774
20041,0.001088,172.31.36.0-255,66,120920,8,246774
20042,0.001109,172.217.194.0-255,5738,126658,8,246774
20043,0.001112,172.31.36.0-255,66,126724,8,246774
20044,0.001119,172.217.194.0-255,5738,132462,8,246774
20045,0.001121,172.31.36.0-255,66,132528,8,246774
20046,0.001145,172.217.194.0-255,6438,138966,8,246774
20047,0.001148,172.31.36.0-255,66,139032,8,246774
20048,0.00116,172.217.194.0-255,1484,140516,8,246774
20049,0.001182,172.217.194.0-255,2902,143418,8,246774
20050,0.001186,172.31.36.0-255,66,143484,8,246774
20051,0.001192,172.217.194.0-255,5738,149222,8,246774
20052,0.001194,172.31.36.0-255,66,149288,8,246774
20053,0.00123,172.31.36.0-255,66,149354,8,246774
20054,0.001233,172.217.194.0-255,1484,150838,8,246774
20055,0.001272,172.31.36.0-255,66,150904,8,246774
20056,0.001501,172.217.194.0-255,1484,152388,8,246774
20057,0.001515,172.217.194.0-255,2902,155290,8,246774
20058,0.001518,172.31.36.0-255,66,155356,8,246774
20059,0.001524,172.217.194.0-255,2902,158258,8,246774
20060,0.001526,172.31.36.0-255,66,158324,8,246774
20061,0.001539,172.217.194.0-255,2902,161226,8,246774
20062,0.001541,172.31.36.0-255,66,161292,8,246774
20063,0.001561,172.217.194.0-255,7156,168448,8,246774
20064,0.001579,172.31.36.0-255,66,168514,8,246774
20065,0.001601,172.217.194.0-255,5738,174252,8,246774
20066,0.001605,172.31.36.0-255,66,174318,8,246774
20067,0.001615,172.31.36.0-255,66,174384,8,246774
20068,0.001617,172.217.194.0-255,766,175150,8,246774
20069,0.001713,172.217.194.0-255,1484,176634,8,246774
20070,0.001717,172.31.36.0-255,66,176700,8,246774
20071,0.001722,172.217.194.0-255,2902,179602,8,246774
20072,0.001725,172.31.36.0-255,66,179668,8,246774
20073,0.001728,172.217.194.0-255,1484,181152,8,246774
20074,0.001754,172.217.194.0-255,4320,185472,8,246774
20075,0.001756,172.31.36.0-255,66,185538,8,246774
20076,0.001771,172.31.36.0-255,66,185604,8,246774
20077,0.001777,172.217.194.0-255,7156,192760,8,246774
20078,0.001779,172.31.36.0-255,66,192826,8,246774
20079,0.0018,172.217.194.0-255,1484,194310,8,246774
20080,0.001818,172.217.194.0-255,2184,196494,8,246774
20081,0.001821,172.31.36.0-255,66,196560,8,246774
20082,0.001869,172.217.194.0-255,1484,198044,8,246774
20083,0.00189,172.217.194.0-255,2902,200946,8,246774
20084,0.001894,172.31.36.0-255,66,201012,8,246774
20085,0.001899,172.217.194.0-255,5738,206750,8,246774
20086,0.001902,172.31.36.0-255,66,206816,8,246774
20087,0.001969,172.31.36.0-255,66,206882,8,246774
20088,0.00198,172.31.36.0-255,66,206948,8,246774
20089,0.001985,172.217.194.0-255,3602,210550,8,246774
20090,0.001986,172.31.36.0-255,66,210616,8,246774
20091,0.001991,172.217.194.0-255,4320,214936,8,246774
20092,0.001993,172.31.36.0-255,66,215002,8,246774
20093,0.002029,172.31.36.0-255,66,215068,8,246774
20094,0.002062,172.31.36.0-255,66,215134,8,246774
20095,0.002131,172.217.194.0-255,1484,216618,8,246774
20096,0.002144,172.217.194.0-255,2902,219520,8,246774
20097,0.002148,172.31.36.0-255,66,219586,8,246774
20098,0.002154,172.217.194.0-255,5738,225324,8,246774
20099,0.002157,172.31.36.0-255,66,225390,8,246774
20100,0.002175,172.217.194.0-255,4320,229710,8,246774
20101,0.002178,172.31.36.0-255,66,229776,8,246774
20102,0.002215,172.31.36.0-255,66,229842,8,246774
20103,0.002227,172.31.36.0-255,66,229908,8,246774
20104,0.00223,172.217.194.0-255,1484,231392,8,246774
20105,0.002247,172.217.194.0-255,5738,237130,8,246774
20106,0.00225,172.31.36.0-255,66,237196,8,246774
20107,0.002263,172.217.194.0-255,4161,241357,8,246774
20108,0.002266,172.31.36.0-255,66,241423,8,246774
20109,0.002269,172.217.194.0-255,105,241528,8,246774
20110,0.008484,172.31.36.0-255,66,241594,8,246774
20111,0.008511,172.31.36.0-255,105,241699,8,246774
20112,0.010787,172.217.194.0-255,66,241765,8,246774
20113,0.034259,172.31.36.0-255,172,241937,8,246774
20114,0.034291,172.31.36.0-255,1111,243048,8,246774
20115,0.03433,172.31.36.0-255,1514,244562,8,246774
20116,0.034332,172.31.36.0-255,1514,246076,8,246774
20117,0.034353,172.31.36.0-255,434,246510,8,246774
20118,0.035759,104.244.42.0-255,66,246576,8,246774
20119,0.035768,104.244.42.0-255,66,246642,8,246774
20120,0.03582,104.244.42.0-255,66,246708,8,246774
20121,0.035832,104.244.42.0-255,66,246774,8,246774
20122,0.0,74.125.24.0-255,150,150,8,196453
20123,2.2e-05,172.31.36.0-255,66,216,8,196453
20124,2.9e-05,74.125.24.0-255,1484,1700,8,196453
20125,3.3e-05,172.31.36.0-255,66,1766,8,196453
20126,3.9e-05,74.125.24.0-255,2902,4668,8,196453
20127,5.2e-05,172.31.36.0-255,66,4734,8,196453
20128,5.6e-05,74.125.24.0-255,1484,6218,8,196453
20129,5.8e-05,172.31.36.0-255,66,6284,8,196453
20130,6.4e-05,74.125.24.0-255,2902,9186,8,196453
20131,6.8e-05,172.31.36.0-255,66,9252,8,196453
20132,7.1e-05,74.125.24.0-255,1484,10736,8,196453
20133,7.3e-05,172.31.36.0-255,66,10802,8,196453
20134,0.000113,74.125.24.0-255,4942,15744,8,196453
20135,0.000116,172.31.36.0-255,66,15810,8,196453
20136,0.000122,74.125.24.0-255,4320,20130,8,196453
20137,0.000124,172.31.36.0-255,66,20196,8,196453
20138,0.00015,172.31.36.0-255,66,20262,8,196453
20139,0.000176,74.125.24.0-255,2543,22805,8,196453
20140,0.000178,172.31.36.0-255,66,22871,8,196453
20141,0.000266,74.125.24.0-255,1484,24355,8,196453
20142,0.000269,172.31.36.0-255,66,24421,8,196453
20143,0.000275,74.125.24.0-255,2902,27323,8,196453
20144,0.000277,172.31.36.0-255,66,27389,8,196453
20145,0.000307,74.125.24.0-255,5738,33127,8,196453
20146,0.00031,172.31.36.0-255,66,33193,8,196453
20147,0.000318,74.125.24.0-255,7156,40349,8,196453
20148,0.00032,172.31.36.0-255,66,40415,8,196453
20149,0.000331,74.125.24.0-255,4320,44735,8,196453
20150,0.000333,172.31.36.0-255,66,44801,8,196453
20151,0.000376,172.31.36.0-255,66,44867,8,196453
20152,0.000381,74.125.24.0-255,2184,47051,8,196453
20153,0.000383,172.31.36.0-255,66,47117,8,196453
20154,0.000385,74.125.24.0-255,425,47542,8,196453
20155,0.000543,74.125.24.0-255,1484,49026,8,196453
20156,0.000548,172.31.36.0-255,66,49092,8,196453
20157,0.000554,74.125.24.0-255,2902,51994,8,196453
20158,0.000557,172.31.36.0-255,66,52060,8,196453
20159,0.000579,74.125.24.0-255,5738,57798,8,196453
20160,0.000581,172.31.36.0-255,66,57864,8,196453
20161,0.000621,172.31.36.0-255,66,57930,8,196453
20162,0.000626,74.125.24.0-255,4320,62250,8,196453
20163,0.000629,172.31.36.0-255,66,62316,8,196453
20164,0.000661,172.31.36.0-255,66,62382,8,196453
20165,0.0007,74.125.24.0-255,7156,69538,8,196453
20166,0.000704,172.31.36.0-255,66,69604,8,196453
20167,0.000739,74.125.24.0-255,5738,75342,8,196453
20168,0.000743,172.31.36.0-255,66,75408,8,196453
20169,0.000749,74.125.24.0-255,5738,81146,8,196453
20170,0.000752,172.31.36.0-255,66,81212,8,196453
20171,0.00076,74.125.24.0-255,2902,84114,8,196453
20172,0.000763,172.31.36.0-255,66,84180,8,196453
20173,0.000806,172.31.36.0-255,66,84246,8,196453
20174,0.000809,74.125.24.0-255,1484,85730,8,196453
20175,0.000812,74.125.24.0-255,1484,87214,8,196453
20176,0.000814,172.31.36.0-255,66,87280,8,196453
20177,0.000838,74.125.24.0-255,1484,88764,8,196453
20178,0.000844,74.125.24.0-255,5738,94502,8,196453
20179,0.000846,172.31.36.0-255,66,94568,8,196453
20180,0.000857,172.31.36.0-255,66,94634,8,196453
20181,0.000888,74.125.24.0-255,4320,98954,8,196453
20182,0.000892,172.31.36.0-255,66,99020,8,196453
20183,0.000904,172.31.36.0-255,66,99086,8,196453
20184,0.000906,74.125.24.0-255,766,99852,8,196453
20185,0.000935,74.125.24.0-255,1484,101336,8,196453
20186,0.000937,172.31.36.0-255,66,101402,8,196453
20187,0.000944,74.125.24.0-255,4320,105722,8,196453
20188,0.000946,172.31.36.0-255,66,105788,8,196453
20189,0.000986,74.125.24.0-255,1484,107272,8,196453
20190,0.001015,172.31.36.0-255,66,107338,8,196453
20191,0.00102,74.125.24.0-255,4320,111658,8,196453
20192,0.001022,172.31.36.0-255,66,111724,8,196453
20193,0.001035,172.31.36.0-255,66,111790,8,196453
20194,0.001047,74.125.24.0-255,2184,113974,8,196453
20195,0.00105,172.31.36.0-255,66,114040,8,196453
20196,0.001231,74.125.24.0-255,1484,115524,8,196453
20197,0.001237,74.125.24.0-255,2902,118426,8,196453
20198,0.00124,172.31.36.0-255,66,118492,8,196453
20199,0.001244,74.125.24.0-255,1484,119976,8,196453
20200,0.001271,74.125.24.0-255,4320,124296,8,196453
20201,0.001274,172.31.36.0-255,66,124362,8,196453
20202,0.001286,172.31.36.0-255,66,124428,8,196453
20203,0.001323,74.125.24.0-255,2902,127330,8,196453
20204,0.001327,172.31.36.0-255,66,127396,8,196453
20205,0.001362,172.31.36.0-255,66,127462,8,196453
20206,0.001386,74.125.24.0-255,1484,128946,8,196453
20207,0.001391,74.125.24.0-255,2902,131848,8,196453
20208,0.001394,172.31.36.0-255,66,131914,8,196453
20209,0.001398,74.125.24.0-255,2902,134816,8,196453
20210,0.001401,172.31.36.0-255,66,134882,8,196453
20211,0.001413,74.125.24.0-255,2902,137784,8,196453
20212,0.001415,172.31.36.0-255,66,137850,8,196453
20213,0.001421,74.125.24.0-255,4320,142170,8,196453
20214,0.001423,172.31.36.0-255,66,142236,8,196453
20215,0.001472,74.125.24.0-255,7156,149392,8,196453
20216,0.001476,172.31.36.0-255,66,149458,8,196453
20217,0.00149,172.31.36.0-255,66,149524,8,196453
20218,0.001504,172.31.36.0-255,66,149590,8,196453
20219,0.001528,74.125.24.0-255,5738,155328,8,196453
20220,0.001531,172.31.36.0-255,66,155394,8,196453
20221,0.001541,172.31.36.0-255,66,155460,8,196453
20222,0.001573,74.125.24.0-255,6438,161898,8,196453
20223,0.001576,172.31.36.0-255,66,161964,8,196453
20224,0.00158,74.125.24.0-255,1484,163448,8,196453
20225,0.001584,74.125.24.0-255,2902,166350,8,196453
20226,0.001586,172.31.36.0-255,66,166416,8,196453
20227,0.001589,74.125.24.0-255,1484,167900,8,196453
20228,0.001625,74.125.24.0-255,4320,172220,8,196453
20229,0.001628,172.31.36.0-255,66,172286,8,196453
20230,0.00164,172.31.36.0-255,66,172352,8,196453
20231,0.00165,172.31.36.0-255,66,172418,8,196453
20232,0.001686,74.125.24.0-255,2184,174602,8,196453
20233,0.001689,172.31.36.0-255,66,174668,8,196453
20234,0.001731,74.125.24.0-255,2902,177570,8,196453
20235,0.001734,172.31.36.0-255,66,177636,8,196453
20236,0.001742,74.125.24.0-255,7156,184792,8,196453
20237,0.001745,172.31.36.0-255,66,184858,8,196453
20238,0.001756,172.31.36.0-255,66,184924,8,196453
20239,0.001826,74.125.24.0-255,1484,186408,8,196453
20240,0.001862,172.31.36.0-255,66,186474,8,196453
20241,0.001875,172.31.36.0-255,66,186540,8,196453
20242,0.0019,74.125.24.0-255,97,186637,8,196453
20243,0.001903,74.125.24.0-255,105,186742,8,196453
20244,0.001929,172.31.36.0-255,66,186808,8,196453
20245,0.011359,172.31.36.0-255,105,186913,8,196453
20246,0.013589,74.125.24.0-255,66,186979,8,196453
20247,0.038252,172.31.36.0-255,176,187155,8,196453
20248,0.038285,172.31.36.0-255,1111,188266,8,196453
20249,0.03835,172.31.36.0-255,1514,189780,8,196453
20250,0.038352,172.31.36.0-255,1514,191294,8,196453
20251,0.038358,172.31.36.0-255,1514,192808,8,196453
20252,0.038359,172.31.36.0-255,1514,194322,8,196453
20253,0.038378,172.31.36.0-255,1514,195836,8,196453
20254,0.03838,172.31.36.0-255,353,196189,8,196453
20255,0.039805,104.244.42.0-255,66,196255,8,196453
20256,0.039857,104.244.42.0-255,66,196321,8,196453
20257,0.039939,104.244.42.0-255,66,196387,8,196453
20258,0.039944,104.244.42.0-255,66,196453,8,196453
20259,0.0,172.217.194.0-255,146,146,8,326953
20260,2.7e-05,172.31.36.0-255,66,212,8,326953
20261,3.3e-05,172.217.194.0-255,1484,1696,8,326953
20262,3.8e-05,172.31.36.0-255,66,1762,8,326953
20263,4.3e-05,172.217.194.0-255,2902,4664,8,326953
20264,4.5e-05,172.31.36.0-255,66,4730,8,326953
20265,6e-05,172.217.194.0-255,7156,11886,8,326953
20266,6.3e-05,172.31.36.0-255,66,11952,8,326953
20267,6.7e-05,172.217.194.0-255,2041,13993,8,326953
20268,7e-05,172.31.36.0-255,66,14059,8,326953
20269,0.000104,172.217.194.0-255,1484,15543,8,326953
20270,0.000107,172.31.36.0-255,66,15609,8,326953
20271,0.000139,172.217.194.0-255,2902,18511,8,326953
20272,0.000143,172.31.36.0-255,66,18577,8,326953
20273,0.00015,172.217.194.0-255,5738,24315,8,326953
20274,0.000152,172.31.36.0-255,66,24381,8,326953
20275,0.000196,172.217.194.0-255,6797,31178,8,326953
20276,0.0002,172.31.36.0-255,66,31244,8,326953
20277,0.000227,172.217.194.0-255,1484,32728,8,326953
20278,0.000229,172.31.36.0-255,66,32794,8,326953
20279,0.000234,172.217.194.0-255,2902,35696,8,326953
20280,0.000236,172.31.36.0-255,66,35762,8,326953
20281,0.000239,172.217.194.0-255,1484,37246,8,326953
20282,0.000248,172.31.36.0-255,66,37312,8,326953
20283,0.000285,172.217.194.0-255,4320,41632,8,326953
20284,0.000289,172.31.36.0-255,66,41698,8,326953
20285,0.000295,172.217.194.0-255,4320,46018,8,326953
20286,0.000298,172.31.36.0-255,66,46084,8,326953
20287,0.000316,172.31.36.0-255,66,46150,8,326953
20288,0.000331,172.217.194.0-255,3961,50111,8,326953
20289,0.000335,172.31.36.0-255,66,50177,8,326953
20290,0.000346,172.217.194.0-255,6797,56974,8,326953
20291,0.000348,172.217.194.0-255,388,57362,8,326953
20292,0.000351,172.31.36.0-255,66,57428,8,326953
20293,0.000394,172.217.194.0-255,387,57815,8,326953
20294,0.000491,172.217.194.0-255,1484,59299,8,326953
20295,0.000496,172.31.36.0-255,66,59365,8,326953
20296,0.000501,172.217.194.0-255,2902,62267,8,326953
20297,0.000503,172.31.36.0-255,66,62333,8,326953
20298,0.000531,172.217.194.0-255,4320,66653,8,326953
20299,0.000535,172.31.36.0-255,66,66719,8,326953
20300,0.000541,172.217.194.0-255,5738,72457,8,326953
20301,0.000544,172.31.36.0-255,66,72523,8,326953
20302,0.000573,172.217.194.0-255,2543,75066,8,326953
20303,0.000577,172.31.36.0-255,66,75132,8,326953
20304,0.000588,172.217.194.0-255,1484,76616,8,326953
20305,0.000602,172.217.194.0-255,1484,78100,8,326953
20306,0.000605,172.31.36.0-255,66,78166,8,326953
20307,0.00061,172.217.194.0-255,2902,81068,8,326953
20308,0.000613,172.31.36.0-255,66,81134,8,326953
20309,0.000642,172.217.194.0-255,4320,85454,8,326953
20310,0.000646,172.31.36.0-255,66,85520,8,326953
20311,0.000653,172.217.194.0-255,5738,91258,8,326953
20312,0.000655,172.31.36.0-255,66,91324,8,326953
20313,0.000664,172.217.194.0-255,575,91899,8,326953
20314,0.000933,172.217.194.0-255,1484,93383,8,326953
20315,0.000937,172.31.36.0-255,66,93449,8,326953
20316,0.000943,172.217.194.0-255,2902,96351,8,326953
20317,0.000945,172.31.36.0-255,66,96417,8,326953
20318,0.000972,172.217.194.0-255,5738,102155,8,326953
20319,0.000976,172.31.36.0-255,66,102221,8,326953
20320,0.001011,172.31.36.0-255,66,102287,8,326953
20321,0.001038,172.217.194.0-255,2902,105189,8,326953
20322,0.001041,172.31.36.0-255,66,105255,8,326953
20323,0.00108,172.31.36.0-255,66,105321,8,326953
20324,0.0013,172.217.194.0-255,1484,106805,8,326953
20325,0.001316,172.217.194.0-255,2902,109707,8,326953
20326,0.001319,172.31.36.0-255,66,109773,8,326953
20327,0.001333,172.217.194.0-255,4320,114093,8,326953
20328,0.001341,172.31.36.0-255,66,114159,8,326953
20329,0.001367,172.31.36.0-255,66,114225,8,326953
20330,0.001397,172.217.194.0-255,7156,121381,8,326953
20331,0.0014,172.31.36.0-255,66,121447,8,326953
20332,0.001428,172.217.194.0-255,5738,127185,8,326953
20333,0.001431,172.31.36.0-255,66,127251,8,326953
20334,0.001436,172.217.194.0-255,3602,130853,8,326953
20335,0.001438,172.31.36.0-255,66,130919,8,326953
20336,0.002055,172.217.194.0-255,1484,132403,8,326953
20337,0.002065,172.217.194.0-255,2902,135305,8,326953
20338,0.00207,172.31.36.0-255,66,135371,8,326953
20339,0.002075,172.217.194.0-255,1484,136855,8,326953
20340,0.002113,172.217.194.0-255,5738,142593,8,326953
20341,0.002116,172.31.36.0-255,66,142659,8,326953
20342,0.002127,172.31.36.0-255,66,142725,8,326953
20343,0.002162,172.217.194.0-255,4320,147045,8,326953
20344,0.002166,172.31.36.0-255,66,147111,8,326953
20345,0.002177,172.31.36.0-255,66,147177,8,326953
20346,0.002185,172.217.194.0-255,766,147943,8,326953
20347,0.002441,172.31.36.0-255,66,148009,8,326953
20348,0.004425,172.217.194.0-255,4320,152329,8,326953
20349,0.00443,172.31.36.0-255,66,152395,8,326953
20350,0.004674,172.217.194.0-255,1484,153879,8,326953
20351,0.006663,172.217.194.0-255,4320,158199,8,326953
20352,0.006668,172.31.36.0-255,66,158265,8,326953
20353,0.008925,172.217.194.0-255,5738,164003,8,326953
20354,0.008932,172.31.36.0-255,66,164069,8,326953
20355,0.01116,172.217.194.0-255,5738,169807,8,326953
20356,0.011167,172.31.36.0-255,66,169873,8,326953
20357,0.013418,172.217.194.0-255,4320,174193,8,326953
20358,0.013426,172.31.36.0-255,66,174259,8,326953
20359,0.01346,172.217.194.0-255,1484,175743,8,326953
20360,0.0157,172.217.194.0-255,4320,180063,8,326953
20361,0.015706,172.31.36.0-255,66,180129,8,326953
20362,0.017927,172.217.194.0-255,4320,184449,8,326953
20363,0.017933,172.31.36.0-255,66,184515,8,326953
20364,0.017966,172.217.194.0-255,1484,185999,8,326953
20365,0.02018,172.217.194.0-255,4320,190319,8,326953
20366,0.020189,172.31.36.0-255,66,190385,8,326953
20367,0.022465,172.217.194.0-255,5738,196123,8,326953
20368,0.022471,172.31.36.0-255,66,196189,8,326953
20369,0.024735,172.217.194.0-255,5738,201927,8,326953
20370,0.024743,172.31.36.0-255,66,201993,8,326953
20371,0.026991,172.217.194.0-255,5738,207731,8,326953
20372,0.027,172.31.36.0-255,66,207797,8,326953
20373,0.02925,172.217.194.0-255,5738,213535,8,326953
20374,0.029257,172.31.36.0-255,66,213601,8,326953
20375,0.029987,172.31.36.0-255,172,213773,8,326953
20376,0.030029,172.31.36.0-255,1110,214883,8,326953
20377,0.030109,172.31.36.0-255,1514,216397,8,326953
20378,0.030112,172.31.36.0-255,1514,217911,8,326953
20379,0.030116,172.31.36.0-255,1514,219425,8,326953
20380,0.030118,172.31.36.0-255,1514,220939,8,326953
20381,0.030141,172.31.36.0-255,1514,222453,8,326953
20382,0.030142,172.31.36.0-255,876,223329,8,326953
20383,0.031519,104.244.42.0-255,66,223395,8,326953
20384,0.03153,172.217.194.0-255,5738,229133,8,326953
20385,0.031536,172.31.36.0-255,66,229199,8,326953
20386,0.031656,104.244.42.0-255,66,229265,8,326953
20387,0.031688,104.244.42.0-255,66,229331,8,326953
20388,0.031726,104.244.42.0-255,66,229397,8,326953
20389,0.031733,104.244.42.0-255,66,229463,8,326953
20390,0.033781,172.217.194.0-255,5738,235201,8,326953
20391,0.033788,172.31.36.0-255,66,235267,8,326953
20392,0.036041,172.217.194.0-255,5738,241005,8,326953
20393,0.036047,172.31.36.0-255,66,241071,8,326953
20394,0.038284,172.217.194.0-255,5738,246809,8,326953
20395,0.038293,172.31.36.0-255,66,246875,8,326953
20396,0.040532,172.217.194.0-255,5738,252613,8,326953
20397,0.040541,172.31.36.0-255,66,252679,8,326953
20398,0.042799,172.217.194.0-255,5738,258417,8,326953
20399,0.042814,172.31.36.0-255,66,258483,8,326953
20400,0.045068,172.217.194.0-255,5738,264221,8,326953
20401,0.045074,172.31.36.0-255,66,264287,8,326953
20402,0.047345,172.217.194.0-255,5738,270025,8,326953
20403,0.047353,172.31.36.0-255,66,270091,8,326953
20404,0.049601,172.217.194.0-255,5738,275829,8,326953
20405,0.04961,172.31.36.0-255,66,275895,8,326953
20406,0.051189,172.31.36.0-255,108,276003,8,326953
20407,0.05187,172.217.194.0-255,5738,281741,8,326953
20408,0.051878,172.31.36.0-255,66,281807,8,326953
20409,0.052737,104.244.42.0-255,66,281873,8,326953
20410,0.054104,172.217.194.0-255,5738,287611,8,326953
20411,0.054113,172.31.36.0-255,66,287677,8,326953
20412,0.056345,172.217.194.0-255,5738,293415,8,326953
20413,0.056354,172.31.36.0-255,66,293481,8,326953
20414,0.058589,172.217.194.0-255,5738,299219,8,326953
20415,0.058596,172.31.36.0-255,66,299285,8,326953
20416,0.060813,172.217.194.0-255,5738,305023,8,326953
20417,0.060819,172.31.36.0-255,66,305089,8,326953
20418,0.06307,172.217.194.0-255,5738,310827,8,326953
20419,0.063077,172.31.36.0-255,66,310893,8,326953
20420,0.065286,172.217.194.0-255,4320,315213,8,326953
20421,0.06529,172.31.36.0-255,66,315279,8,326953
20422,0.065315,172.217.194.0-255,1484,316763,8,326953
20423,0.067497,172.217.194.0-255,4320,321083,8,326953
20424,0.067504,172.31.36.0-255,66,321149,8,326953
20425,0.06975,172.217.194.0-255,5738,326887,8,326953
20426,0.069756,172.31.36.0-255,66,326953,8,326953
20427,0.0,172.217.194.0-255,153,153,8,213896
20428,3.5e-05,172.31.36.0-255,66,219,8,213896
20429,4.1e-05,172.217.194.0-255,1484,1703,8,213896
20430,4.5e-05,172.31.36.0-255,66,1769,8,213896
20431,5e-05,172.217.194.0-255,2902,4671,8,213896
20432,5.4e-05,172.31.36.0-255,66,4737,8,213896
20433,6.2e-05,172.217.194.0-255,7156,11893,8,213896
20434,6.5e-05,172.31.36.0-255,66,11959,8,213896
20435,6.9e-05,172.217.194.0-255,2902,14861,8,213896
20436,7.2e-05,172.31.36.0-255,66,14927,8,213896
20437,0.000106,172.31.36.0-255,66,14993,8,213896
20438,0.000126,172.217.194.0-255,6797,21790,8,213896
20439,0.00013,172.31.36.0-255,66,21856,8,213896
20440,0.000148,172.217.194.0-255,7156,29012,8,213896
20441,0.000151,172.31.36.0-255,66,29078,8,213896
20442,0.000174,172.217.194.0-255,4320,33398,8,213896
20443,0.000177,172.31.36.0-255,66,33464,8,213896
20444,0.000198,172.217.194.0-255,5379,38843,8,213896
20445,0.000202,172.31.36.0-255,66,38909,8,213896
20446,0.000213,172.217.194.0-255,1484,40393,8,213896
20447,0.000215,172.31.36.0-255,66,40459,8,213896
20448,0.000238,172.217.194.0-255,2902,43361,8,213896
20449,0.000241,172.31.36.0-255,66,43427,8,213896
20450,0.000247,172.217.194.0-255,5738,49165,8,213896
20451,0.000249,172.31.36.0-255,66,49231,8,213896
20452,0.000291,172.217.194.0-255,7111,56342,8,213896
20453,0.000295,172.31.36.0-255,66,56408,8,213896
20454,0.000548,172.217.194.0-255,363,56771,8,213896
20455,0.000553,172.31.36.0-255,66,56837,8,213896
20456,0.001124,172.217.194.0-255,1484,58321,8,213896
20457,0.001129,172.31.36.0-255,66,58387,8,213896
20458,0.001138,172.217.194.0-255,2902,61289,8,213896
20459,0.00114,172.31.36.0-255,66,61355,8,213896
20460,0.001148,172.217.194.0-255,5738,67093,8,213896
20461,0.001151,172.31.36.0-255,66,67159,8,213896
20462,0.001163,172.31.36.0-255,66,67225,8,213896
20463,0.00118,172.217.194.0-255,1484,68709,8,213896
20464,0.001206,172.217.194.0-255,5738,74447,8,213896
20465,0.001208,172.31.36.0-255,66,74513,8,213896
20466,0.001226,172.31.36.0-255,66,74579,8,213896
20467,0.001534,172.217.194.0-255,1484,76063,8,213896
20468,0.001552,172.217.194.0-255,2902,78965,8,213896
20469,0.001555,172.31.36.0-255,66,79031,8,213896
20470,0.001562,172.217.194.0-255,5738,84769,8,213896
20471,0.001564,172.31.36.0-255,66,84835,8,213896
20472,0.001568,172.217.194.0-255,1484,86319,8,213896
20473,0.001602,172.31.36.0-255,66,86385,8,213896
20474,0.001614,172.217.194.0-255,4320,90705,8,213896
20475,0.001616,172.31.36.0-255,66,90771,8,213896
20476,0.001633,172.217.194.0-255,6438,97209,8,213896
20477,0.001635,172.31.36.0-255,66,97275,8,213896
20478,0.001648,172.217.194.0-255,1484,98759,8,213896
20479,0.001673,172.31.36.0-255,66,98825,8,213896
20480,0.001684,172.31.36.0-255,66,98891,8,213896
20481,0.001724,172.217.194.0-255,5738,104629,8,213896
20482,0.001726,172.31.36.0-255,66,104695,8,213896
20483,0.001752,172.31.36.0-255,66,104761,8,213896
20484,0.001767,172.217.194.0-255,2902,107663,8,213896
20485,0.001769,172.31.36.0-255,66,107729,8,213896
20486,0.001774,172.217.194.0-255,4320,112049,8,213896
20487,0.001777,172.31.36.0-255,66,112115,8,213896
20488,0.001807,172.31.36.0-255,66,112181,8,213896
20489,0.001823,172.217.194.0-255,7156,119337,8,213896
20490,0.001825,172.31.36.0-255,66,119403,8,213896
20491,0.001848,172.31.36.0-255,66,119469,8,213896
20492,0.001915,172.217.194.0-255,1484,120953,8,213896
20493,0.001919,172.217.194.0-255,2902,123855,8,213896
20494,0.001921,172.31.36.0-255,66,123921,8,213896
20495,0.001925,172.217.194.0-255,1484,125405,8,213896
20496,0.001943,172.217.194.0-255,4320,129725,8,213896
20497,0.001945,172.31.36.0-255,66,129791,8,213896
20498,0.001951,172.217.194.0-255,5738,135529,8,213896
20499,0.001953,172.31.36.0-255,66,135595,8,213896
20500,0.001972,172.217.194.0-255,7156,142751,8,213896
20501,0.001975,172.31.36.0-255,66,142817,8,213896
20502,0.001986,172.31.36.0-255,66,142883,8,213896
20503,0.00206,172.217.194.0-255,1484,144367,8,213896
20504,0.002071,172.217.194.0-255,2902,147269,8,213896
20505,0.002073,172.31.36.0-255,66,147335,8,213896
20506,0.002136,172.217.194.0-255,5738,153073,8,213896
20507,0.002139,172.31.36.0-255,66,153139,8,213896
20508,0.002157,172.31.36.0-255,66,153205,8,213896
20509,0.002163,172.217.194.0-255,7156,160361,8,213896
20510,0.002165,172.31.36.0-255,66,160427,8,213896
20511,0.002171,172.217.194.0-255,5738,166165,8,213896
20512,0.002174,172.31.36.0-255,66,166231,8,213896
20513,0.002211,172.31.36.0-255,66,166297,8,213896
20514,0.002225,172.31.36.0-255,66,166363,8,213896
20515,0.002273,172.31.36.0-255,66,166429,8,213896
20516,0.0023,172.31.36.0-255,66,166495,8,213896
20517,0.00232,172.217.194.0-255,2184,168679,8,213896
20518,0.002322,172.31.36.0-255,66,168745,8,213896
20519,0.002332,172.31.36.0-255,66,168811,8,213896
20520,0.002359,172.217.194.0-255,4320,173131,8,213896
20521,0.002361,172.31.36.0-255,66,173197,8,213896
20522,0.002375,172.31.36.0-255,66,173263,8,213896
20523,0.002385,172.31.36.0-255,66,173329,8,213896
20524,0.002401,172.217.194.0-255,3602,176931,8,213896
20525,0.002403,172.31.36.0-255,66,176997,8,213896
20526,0.004698,172.217.194.0-255,1484,178481,8,213896
20527,0.004726,172.217.194.0-255,4320,182801,8,213896
20528,0.004729,172.31.36.0-255,66,182867,8,213896
20529,0.007066,172.217.194.0-255,5738,188605,8,213896
20530,0.007073,172.31.36.0-255,66,188671,8,213896
20531,0.009411,172.217.194.0-255,5738,194409,8,213896
20532,0.009417,172.31.36.0-255,66,194475,8,213896
20533,0.011751,172.217.194.0-255,5738,200213,8,213896
20534,0.011758,172.31.36.0-255,66,200279,8,213896
20535,0.014102,172.217.194.0-255,5738,206017,8,213896
20536,0.014111,172.31.36.0-255,66,206083,8,213896
20537,0.01643,172.217.194.0-255,3553,209636,8,213896
20538,0.01644,172.31.36.0-255,66,209702,8,213896
20539,0.016658,172.31.36.0-255,105,209807,8,213896
20540,0.018951,172.217.194.0-255,66,209873,8,213896
20541,0.033439,172.31.36.0-255,172,210045,8,213896
20542,0.033469,172.31.36.0-255,1111,211156,8,213896
20543,0.033514,172.31.36.0-255,1514,212670,8,213896
20544,0.033516,172.31.36.0-255,1028,213698,8,213896
20545,0.03496,104.244.42.0-255,66,213764,8,213896
20546,0.034984,104.244.42.0-255,66,213830,8,213896
20547,0.03503,104.244.42.0-255,66,213896,8,213896
20548,0.0,74.125.68.0-255,153,153,8,348697
20549,3.3e-05,172.31.36.0-255,66,219,8,348697
20550,4e-05,74.125.68.0-255,1484,1703,8,348697
20551,4.5e-05,172.31.36.0-255,66,1769,8,348697
20552,6.7e-05,74.125.68.0-255,2902,4671,8,348697
20553,7e-05,172.31.36.0-255,66,4737,8,348697
20554,7.3e-05,74.125.68.0-255,1484,6221,8,348697
20555,7.5e-05,172.31.36.0-255,66,6287,8,348697
20556,0.000103,74.125.68.0-255,2902,9189,8,348697
20557,0.000106,172.31.36.0-255,66,9255,8,348697
20558,0.000113,74.125.68.0-255,4836,14091,8,348697
20559,0.000115,172.31.36.0-255,66,14157,8,348697
20560,0.000245,74.125.68.0-255,1484,15641,8,348697
20561,0.000251,172.31.36.0-255,66,15707,8,348697
20562,0.000265,74.125.68.0-255,2902,18609,8,348697
20563,0.000267,172.31.36.0-255,66,18675,8,348697
20564,0.000271,74.125.68.0-255,1484,20159,8,348697
20565,0.000274,172.31.36.0-255,66,20225,8,348697
20566,0.000293,74.125.68.0-255,2902,23127,8,348697
20567,0.000295,172.31.36.0-255,66,23193,8,348697
20568,0.000315,74.125.68.0-255,2902,26095,8,348697
20569,0.000318,172.31.36.0-255,66,26161,8,348697
20570,0.000337,74.125.68.0-255,2902,29063,8,348697
20571,0.000341,172.31.36.0-255,66,29129,8,348697
20572,0.000344,74.125.68.0-255,1484,30613,8,348697
20573,0.000346,172.31.36.0-255,66,30679,8,348697
20574,0.000381,74.125.68.0-255,2543,33222,8,348697
20575,0.000385,172.31.36.0-255,66,33288,8,348697
20576,0.000388,74.125.68.0-255,1484,34772,8,348697
20577,0.00039,172.31.36.0-255,66,34838,8,348697
20578,0.000404,74.125.68.0-255,1484,36322,8,348697
20579,0.000407,172.31.36.0-255,66,36388,8,348697
20580,0.000427,74.125.68.0-255,7156,43544,8,348697
20581,0.00043,172.31.36.0-255,66,43610,8,348697
20582,0.000434,74.125.68.0-255,2902,46512,8,348697
20583,0.000439,172.31.36.0-255,66,46578,8,348697
20584,0.000464,74.125.68.0-255,4320,50898,8,348697
20585,0.000468,172.31.36.0-255,66,50964,8,348697
20586,0.000496,74.125.68.0-255,7156,58120,8,348697
20587,0.000501,172.31.36.0-255,66,58186,8,348697
20588,0.000506,172.31.36.0-255,66,58252,8,348697
20589,0.000509,74.125.68.0-255,368,58620,8,348697
20590,0.000556,74.125.68.0-255,133,58753,8,348697
20591,0.000656,74.125.68.0-255,1484,60237,8,348697
20592,0.000662,172.31.36.0-255,66,60303,8,348697
20593,0.000668,74.125.68.0-255,2902,63205,8,348697
20594,0.000671,172.31.36.0-255,66,63271,8,348697
20595,0.000695,74.125.68.0-255,4320,67591,8,348697
20596,0.000698,172.31.36.0-255,66,67657,8,348697
20597,0.000704,74.125.68.0-255,4320,71977,8,348697
20598,0.000706,172.31.36.0-255,66,72043,8,348697
20599,0.000726,74.125.68.0-255,1484,73527,8,348697
20600,0.000729,74.125.68.0-255,1484,75011,8,348697
20601,0.000732,172.31.36.0-255,66,75077,8,348697
20602,0.000758,172.31.36.0-255,66,75143,8,348697
20603,0.000764,74.125.68.0-255,4320,79463,8,348697
20604,0.000766,172.31.36.0-255,66,79529,8,348697
20605,0.000802,74.125.68.0-255,3602,83131,8,348697
20606,0.000806,172.31.36.0-255,66,83197,8,348697
20607,0.000819,74.125.68.0-255,342,83539,8,348697
20608,0.000858,74.125.68.0-255,1484,85023,8,348697
20609,0.000861,172.31.36.0-255,66,85089,8,348697
20610,0.000884,74.125.68.0-255,4320,89409,8,348697
20611,0.000887,172.31.36.0-255,66,89475,8,348697
20612,0.00089,74.125.68.0-255,1484,90959,8,348697
20613,0.000908,74.125.68.0-255,4320,95279,8,348697
20614,0.000911,172.31.36.0-255,66,95345,8,348697
20615,0.000917,74.125.68.0-255,4320,99665,8,348697
20616,0.000919,172.31.36.0-255,66,99731,8,348697
20617,0.000932,74.125.68.0-255,2902,102633,8,348697
20618,0.000935,172.31.36.0-255,66,102699,8,348697
20619,0.000955,74.125.68.0-255,2902,105601,8,348697
20620,0.000957,172.31.36.0-255,66,105667,8,348697
20621,0.000988,172.31.36.0-255,66,105733,8,348697
20622,0.000991,74.125.68.0-255,766,106499,8,348697
20623,0.001008,74.125.68.0-255,1484,107983,8,348697
20624,0.001011,172.31.36.0-255,66,108049,8,348697
20625,0.001032,74.125.68.0-255,4320,112369,8,348697
20626,0.001035,172.31.36.0-255,66,112435,8,348697
20627,0.001088,74.125.68.0-255,7156,119591,8,348697
20628,0.001095,172.31.36.0-255,66,119657,8,348697
20629,0.001098,172.31.36.0-255,66,119723,8,348697
20630,0.001104,74.125.68.0-255,5738,125461,8,348697
20631,0.001106,172.31.36.0-255,66,125527,8,348697
20632,0.001131,74.125.68.0-255,6438,131965,8,348697
20633,0.001134,172.31.36.0-255,66,132031,8,348697
20634,0.001296,74.125.68.0-255,1484,133515,8,348697
20635,0.001301,74.125.68.0-255,2902,136417,8,348697
20636,0.001304,172.31.36.0-255,66,136483,8,348697
20637,0.001327,74.125.68.0-255,5738,142221,8,348697
20638,0.00133,172.31.36.0-255,66,142287,8,348697
20639,0.001352,74.125.68.0-255,2902,145189,8,348697
20640,0.001355,172.31.36.0-255,66,145255,8,348697
20641,0.001373,74.125.68.0-255,1484,146739,8,348697
20642,0.001379,74.125.68.0-255,5738,152477,8,348697
20643,0.001382,172.31.36.0-255,66,152543,8,348697
20644,0.001398,74.125.68.0-255,1484,154027,8,348697
20645,0.001413,74.125.68.0-255,4320,158347,8,348697
20646,0.001416,172.31.36.0-255,66,158413,8,348697
20647,0.001431,74.125.68.0-255,5738,164151,8,348697
20648,0.001433,172.31.36.0-255,66,164217,8,348697
20649,0.00145,74.125.68.0-255,1484,165701,8,348697
20650,0.001452,74.125.68.0-255,766,166467,8,348697
20651,0.001455,172.31.36.0-255,66,166533,8,348697
20652,0.002124,74.125.68.0-255,1484,168017,8,348697
20653,0.002131,74.125.68.0-255,1484,169501,8,348697
20654,0.002135,172.31.36.0-255,66,169567,8,348697
20655,0.002152,74.125.68.0-255,1484,171051,8,348697
20656,0.002156,74.125.68.0-255,2902,173953,8,348697
20657,0.002159,172.31.36.0-255,66,174019,8,348697
20658,0.002176,74.125.68.0-255,2902,176921,8,348697
20659,0.002178,172.31.36.0-255,66,176987,8,348697
20660,0.002182,74.125.68.0-255,1484,178471,8,348697
20661,0.002206,172.31.36.0-255,66,178537,8,348697
20662,0.002228,74.125.68.0-255,2902,181439,8,348697
20663,0.002231,172.31.36.0-255,66,181505,8,348697
20664,0.00225,74.125.68.0-255,2902,184407,8,348697
20665,0.002254,172.31.36.0-255,66,184473,8,348697
20666,0.00226,74.125.68.0-255,7156,191629,8,348697
20667,0.002263,172.31.36.0-255,66,191695,8,348697
20668,0.002265,74.125.68.0-255,766,192461,8,348697
20669,0.002581,74.125.68.0-255,1484,193945,8,348697
20670,0.002587,172.31.36.0-255,66,194011,8,348697
20671,0.002594,74.125.68.0-255,2902,196913,8,348697
20672,0.002596,172.31.36.0-255,66,196979,8,348697
20673,0.002618,74.125.68.0-255,4320,201299,8,348697
20674,0.002621,172.31.36.0-255,66,201365,8,348697
20675,0.005164,74.125.68.0-255,1484,202849,8,348697
20676,0.005214,74.125.68.0-255,4320,207169,8,348697
20677,0.005219,172.31.36.0-255,66,207235,8,348697
20678,0.007808,74.125.68.0-255,5738,212973,8,348697
20679,0.007814,172.31.36.0-255,66,213039,8,348697
20680,0.01039,74.125.68.0-255,5738,218777,8,348697
20681,0.010398,172.31.36.0-255,66,218843,8,348697
20682,0.012996,74.125.68.0-255,5738,224581,8,348697
20683,0.013006,172.31.36.0-255,66,224647,8,348697
20684,0.015592,74.125.68.0-255,5738,230385,8,348697
20685,0.015604,172.31.36.0-255,66,230451,8,348697
20686,0.018189,74.125.68.0-255,5738,236189,8,348697
20687,0.0182,172.31.36.0-255,66,236255,8,348697
20688,0.020794,74.125.68.0-255,5738,241993,8,348697
20689,0.020802,172.31.36.0-255,66,242059,8,348697
20690,0.023391,74.125.68.0-255,5738,247797,8,348697
20691,0.023399,172.31.36.0-255,66,247863,8,348697
20692,0.02598,74.125.68.0-255,5738,253601,8,348697
20693,0.025989,172.31.36.0-255,66,253667,8,348697
20694,0.028578,74.125.68.0-255,5738,259405,8,348697
20695,0.028587,172.31.36.0-255,66,259471,8,348697
20696,0.031174,74.125.68.0-255,5738,265209,8,348697
20697,0.031181,172.31.36.0-255,66,265275,8,348697
20698,0.033769,74.125.68.0-255,5738,271013,8,348697
20699,0.033794,172.31.36.0-255,66,271079,8,348697
20700,0.036383,74.125.68.0-255,5738,276817,8,348697
20701,0.036393,172.31.36.0-255,66,276883,8,348697
20702,0.038959,74.125.68.0-255,1484,278367,8,348697
20703,0.039038,74.125.68.0-255,4320,282687,8,348697
20704,0.039045,172.31.36.0-255,66,282753,8,348697
20705,0.040225,172.31.36.0-255,188,282941,8,348697
20706,0.040256,172.31.36.0-255,955,283896,8,348697
20707,0.040299,172.31.36.0-255,1514,285410,8,348697
20708,0.040301,172.31.36.0-255,135,285545,8,348697
20709,0.041634,74.125.68.0-255,5738,291283,8,348697
20710,0.04164,172.31.36.0-255,66,291349,8,348697
20711,0.041814,104.244.42.0-255,66,291415,8,348697
20712,0.041822,104.244.42.0-255,66,291481,8,348697
20713,0.041869,104.244.42.0-255,66,291547,8,348697
20714,0.044225,74.125.68.0-255,5738,297285,8,348697
20715,0.044231,172.31.36.0-255,66,297351,8,348697
20716,0.046805,74.125.68.0-255,4320,301671,8,348697
20717,0.046811,172.31.36.0-255,66,301737,8,348697
20718,0.046838,74.125.68.0-255,1484,303221,8,348697
20719,0.049393,74.125.68.0-255,4320,307541,8,348697
20720,0.049399,172.31.36.0-255,66,307607,8,348697
20721,0.051982,74.125.68.0-255,5738,313345,8,348697
20722,0.051987,172.31.36.0-255,66,313411,8,348697
20723,0.05456,74.125.68.0-255,2902,316313,8,348697
20724,0.054565,172.31.36.0-255,66,316379,8,348697
20725,0.054626,74.125.68.0-255,2902,319281,8,348697
20726,0.054629,172.31.36.0-255,66,319347,8,348697
20727,0.057151,74.125.68.0-255,2902,322249,8,348697
20728,0.057157,172.31.36.0-255,66,322315,8,348697
20729,0.057208,74.125.68.0-255,2902,325217,8,348697
20730,0.057213,172.31.36.0-255,66,325283,8,348697
20731,0.059739,74.125.68.0-255,2902,328185,8,348697
20732,0.059745,172.31.36.0-255,66,328251,8,348697
20733,0.059801,74.125.68.0-255,2902,331153,8,348697
20734,0.059805,172.31.36.0-255,66,331219,8,348697
20735,0.062312,74.125.68.0-255,1484,332703,8,348697
20736,0.062377,74.125.68.0-255,4320,337023,8,348697
20737,0.062384,172.31.36.0-255,66,337089,8,348697
20738,0.065069,74.125.68.0-255,5738,342827,8,348697
20739,0.065076,172.31.36.0-255,66,342893,8,348697
20740,0.067653,74.125.68.0-255,5738,348631,8,348697
20741,0.067659,172.31.36.0-255,66,348697,8,348697
20742,0.0,74.125.68.0-255,153,153,8,252956
20743,3.7e-05,172.31.36.0-255,66,219,8,252956
20744,4.4e-05,74.125.68.0-255,1484,1703,8,252956
20745,5e-05,172.31.36.0-255,66,1769,8,252956
20746,6.3e-05,74.125.68.0-255,2902,4671,8,252956
20747,6.6e-05,172.31.36.0-255,66,4737,8,252956
20748,7.1e-05,74.125.68.0-255,4320,9057,8,252956
20749,7.5e-05,172.31.36.0-255,66,9123,8,252956
20750,8.1e-05,74.125.68.0-255,4906,14029,8,252956
20751,8.4e-05,172.31.36.0-255,66,14095,8,252956
20752,0.00016,74.125.68.0-255,1484,15579,8,252956
20753,0.000166,172.31.36.0-255,66,15645,8,252956
20754,0.000171,74.125.68.0-255,2902,18547,8,252956
20755,0.000173,172.31.36.0-255,66,18613,8,252956
20756,0.000194,74.125.68.0-255,1484,20097,8,252956
20757,0.000197,172.31.36.0-255,66,20163,8,252956
20758,0.000225,74.125.68.0-255,4320,24483,8,252956
20759,0.000235,172.31.36.0-255,66,24549,8,252956
20760,0.00024,74.125.68.0-255,4320,28869,8,252956
20761,0.000243,172.31.36.0-255,66,28935,8,252956
20762,0.000275,74.125.68.0-255,5379,34314,8,252956
20763,0.000278,172.31.36.0-255,66,34380,8,252956
20764,0.000284,74.125.68.0-255,5738,40118,8,252956
20765,0.000287,172.31.36.0-255,66,40184,8,252956
20766,0.000344,172.31.36.0-255,66,40250,8,252956
20767,0.001267,74.125.68.0-255,1484,41734,8,252956
20768,0.001275,172.31.36.0-255,66,41800,8,252956
20769,0.001281,74.125.68.0-255,2902,44702,8,252956
20770,0.001284,172.31.36.0-255,66,44768,8,252956
20771,0.001297,74.125.68.0-255,5738,50506,8,252956
20772,0.001298,172.31.36.0-255,66,50572,8,252956
20773,0.001338,172.31.36.0-255,66,50638,8,252956
20774,0.001383,74.125.68.0-255,1484,52122,8,252956
20775,0.001388,74.125.68.0-255,3961,56083,8,252956
20776,0.001418,74.125.68.0-255,2902,58985,8,252956
20777,0.00143,74.125.68.0-255,2902,61887,8,252956
20778,0.001447,74.125.68.0-255,1484,63371,8,252956
20779,0.001476,74.125.68.0-255,4320,67691,8,252956
20780,0.001494,74.125.68.0-255,4320,72011,8,252956
20781,0.001497,74.125.68.0-255,1705,73716,8,252956
20782,0.002326,74.125.68.0-255,1484,75200,8,252956
20783,0.002345,74.125.68.0-255,1484,76684,8,252956
20784,0.00236,74.125.68.0-255,1484,78168,8,252956
20785,0.002364,74.125.68.0-255,2902,81070,8,252956
20786,0.00238,74.125.68.0-255,2902,83972,8,252956
20787,0.002412,74.125.68.0-255,4320,88292,8,252956
20788,0.002429,74.125.68.0-255,5738,94030,8,252956
20789,0.002443,74.125.68.0-255,1484,95514,8,252956
20790,0.002447,74.125.68.0-255,2184,97698,8,252956
20791,0.003397,172.31.36.0-255,66,97764,8,252956
20792,0.005925,74.125.68.0-255,5738,103502,8,252956
20793,0.005941,172.31.36.0-255,66,103568,8,252956
20794,0.00847,74.125.68.0-255,5738,109306,8,252956
20795,0.008486,172.31.36.0-255,66,109372,8,252956
20796,0.01101,74.125.68.0-255,5738,115110,8,252956
20797,0.01103,172.31.36.0-255,66,115176,8,252956
20798,0.01356,74.125.68.0-255,5738,120914,8,252956
20799,0.013577,172.31.36.0-255,66,120980,8,252956
20800,0.016104,74.125.68.0-255,5738,126718,8,252956
20801,0.016119,172.31.36.0-255,66,126784,8,252956
20802,0.018643,74.125.68.0-255,5738,132522,8,252956
20803,0.018658,172.31.36.0-255,66,132588,8,252956
20804,0.021182,74.125.68.0-255,5738,138326,8,252956
20805,0.021198,172.31.36.0-255,66,138392,8,252956
20806,0.023141,172.31.36.0-255,172,138564,8,252956
20807,0.023188,172.31.36.0-255,1112,139676,8,252956
20808,0.023249,172.31.36.0-255,1514,141190,8,252956
20809,0.023251,172.31.36.0-255,1292,142482,8,252956
20810,0.023737,74.125.68.0-255,5738,148220,8,252956
20811,0.023746,172.31.36.0-255,66,148286,8,252956
20812,0.024674,104.244.42.0-255,66,148352,8,252956
20813,0.024787,104.244.42.0-255,66,148418,8,252956
20814,0.024832,104.244.42.0-255,66,148484,8,252956
20815,0.026275,74.125.68.0-255,5738,154222,8,252956
20816,0.026289,172.31.36.0-255,66,154288,8,252956
20817,0.028811,74.125.68.0-255,5738,160026,8,252956
20818,0.028828,172.31.36.0-255,66,160092,8,252956
20819,0.031341,74.125.68.0-255,5738,165830,8,252956
20820,0.031355,172.31.36.0-255,66,165896,8,252956
20821,0.03386,74.125.68.0-255,5738,171634,8,252956
20822,0.033869,172.31.36.0-255,66,171700,8,252956
20823,0.036404,74.125.68.0-255,5738,177438,8,252956
20824,0.036412,172.31.36.0-255,66,177504,8,252956
20825,0.038924,74.125.68.0-255,5738,183242,8,252956
20826,0.03893,172.31.36.0-255,66,183308,8,252956
20827,0.04147,74.125.68.0-255,5738,189046,8,252956
20828,0.041496,172.31.36.0-255,66,189112,8,252956
20829,0.044013,74.125.68.0-255,5738,194850,8,252956
20830,0.044019,172.31.36.0-255,66,194916,8,252956
20831,0.046531,74.125.68.0-255,5738,200654,8,252956
20832,0.046539,172.31.36.0-255,66,200720,8,252956
20833,0.049055,74.125.68.0-255,5738,206458,8,252956
20834,0.049062,172.31.36.0-255,66,206524,8,252956
20835,0.05157,74.125.68.0-255,5738,212262,8,252956
20836,0.051579,172.31.36.0-255,66,212328,8,252956
20837,0.054108,74.125.68.0-255,5738,218066,8,252956
20838,0.054123,172.31.36.0-255,66,218132,8,252956
20839,0.05664,74.125.68.0-255,5738,223870,8,252956
20840,0.056655,172.31.36.0-255,66,223936,8,252956
20841,0.059163,74.125.68.0-255,5738,229674,8,252956
20842,0.059171,172.31.36.0-255,66,229740,8,252956
20843,0.061696,74.125.68.0-255,5738,235478,8,252956
20844,0.061709,172.31.36.0-255,66,235544,8,252956
20845,0.064227,74.125.68.0-255,5738,241282,8,252956
20846,0.064235,172.31.36.0-255,66,241348,8,252956
20847,0.066744,74.125.68.0-255,5738,247086,8,252956
20848,0.066752,172.31.36.0-255,66,247152,8,252956
20849,0.069261,74.125.68.0-255,5738,252890,8,252956
20850,0.06927,172.31.36.0-255,66,252956,8,252956
20851,0.0,172.217.194.0-255,152,152,8,276006
20852,2.3e-05,172.31.36.0-255,66,218,8,276006
20853,3e-05,172.217.194.0-255,1484,1702,8,276006
20854,3.4e-05,172.31.36.0-255,66,1768,8,276006
20855,4e-05,172.217.194.0-255,2902,4670,8,276006
20856,4.3e-05,172.31.36.0-255,66,4736,8,276006
20857,5.2e-05,172.217.194.0-255,7156,11892,8,276006
20858,5.4e-05,172.31.36.0-255,66,11958,8,276006
20859,5.8e-05,172.217.194.0-255,1484,13442,8,276006
20860,6e-05,172.31.36.0-255,66,13508,8,276006
20861,0.000107,172.31.36.0-255,66,13574,8,276006
20862,0.000111,172.217.194.0-255,2543,16117,8,276006
20863,0.000113,172.31.36.0-255,66,16183,8,276006
20864,0.000149,172.217.194.0-255,1484,17667,8,276006
20865,0.000152,172.31.36.0-255,66,17733,8,276006
20866,0.000157,172.217.194.0-255,2902,20635,8,276006
20867,0.000159,172.31.36.0-255,66,20701,8,276006
20868,0.000165,172.217.194.0-255,4320,25021,8,276006
20869,0.000167,172.31.36.0-255,66,25087,8,276006
20870,0.000195,172.217.194.0-255,1484,26571,8,276006
20871,0.000197,172.31.36.0-255,66,26637,8,276006
20872,0.000204,172.217.194.0-255,5738,32375,8,276006
20873,0.000207,172.31.36.0-255,66,32441,8,276006
20874,0.000211,172.217.194.0-255,2902,35343,8,276006
20875,0.000213,172.31.36.0-255,66,35409,8,276006
20876,0.000245,172.31.36.0-255,66,35475,8,276006
20877,0.00025,172.217.194.0-255,3961,39436,8,276006
20878,0.000252,172.31.36.0-255,66,39502,8,276006
20879,0.000286,172.217.194.0-255,646,40148,8,276006
20880,0.000288,172.31.36.0-255,66,40214,8,276006
20881,0.000452,172.217.194.0-255,1484,41698,8,276006
20882,0.000458,172.217.194.0-255,1484,43182,8,276006
20883,0.000461,172.31.36.0-255,66,43248,8,276006
20884,0.000479,172.217.194.0-255,1484,44732,8,276006
20885,0.000486,172.217.194.0-255,5738,50470,8,276006
20886,0.000488,172.31.36.0-255,66,50536,8,276006
20887,0.000494,172.217.194.0-255,4320,54856,8,276006
20888,0.000497,172.31.36.0-255,66,54922,8,276006
20889,0.000537,172.31.36.0-255,66,54988,8,276006
20890,0.000544,172.217.194.0-255,5738,60726,8,276006
20891,0.000547,172.31.36.0-255,66,60792,8,276006
20892,0.000563,172.217.194.0-255,2184,62976,8,276006
20893,0.000566,172.31.36.0-255,66,63042,8,276006
20894,0.001881,172.217.194.0-255,1484,64526,8,276006
20895,0.00189,172.217.194.0-255,2902,67428,8,276006
20896,0.001896,172.31.36.0-255,66,67494,8,276006
20897,0.001904,172.217.194.0-255,5738,73232,8,276006
20898,0.001906,172.31.36.0-255,66,73298,8,276006
20899,0.001932,172.217.194.0-255,7156,80454,8,276006
20900,0.001935,172.31.36.0-255,66,80520,8,276006
20901,0.001957,172.217.194.0-255,5738,86258,8,276006
20902,0.001959,172.31.36.0-255,66,86324,8,276006
20903,0.001969,172.31.36.0-255,66,86390,8,276006
20904,0.001986,172.217.194.0-255,2184,88574,8,276006
20905,0.001988,172.31.36.0-255,66,88640,8,276006
20906,0.004078,172.217.194.0-255,5738,94378,8,276006
20907,0.004084,172.31.36.0-255,66,94444,8,276006
20908,0.006122,172.217.194.0-255,4320,98764,8,276006
20909,0.006125,172.31.36.0-255,66,98830,8,276006
20910,0.006143,172.217.194.0-255,1484,100314,8,276006
20911,0.008214,172.217.194.0-255,4320,104634,8,276006
20912,0.00822,172.31.36.0-255,66,104700,8,276006
20913,0.010305,172.217.194.0-255,5738,110438,8,276006
20914,0.010313,172.31.36.0-255,66,110504,8,276006
20915,0.012372,172.217.194.0-255,5738,116242,8,276006
20916,0.012383,172.31.36.0-255,66,116308,8,276006
20917,0.014446,172.217.194.0-255,5738,122046,8,276006
20918,0.014455,172.31.36.0-255,66,122112,8,276006
20919,0.016542,172.217.194.0-255,5738,127850,8,276006
20920,0.016553,172.31.36.0-255,66,127916,8,276006
20921,0.018642,172.217.194.0-255,5738,133654,8,276006
20922,0.018652,172.31.36.0-255,66,133720,8,276006
20923,0.020145,172.31.36.0-255,188,133908,8,276006
20924,0.02018,172.31.36.0-255,955,134863,8,276006
20925,0.020244,172.31.36.0-255,1514,136377,8,276006
20926,0.020246,172.31.36.0-255,135,136512,8,276006
20927,0.020706,172.217.194.0-255,5738,142250,8,276006
20928,0.020712,172.31.36.0-255,66,142316,8,276006
20929,0.021686,104.244.42.0-255,66,142382,8,276006
20930,0.021747,104.244.42.0-255,66,142448,8,276006
20931,0.021803,104.244.42.0-255,66,142514,8,276006
20932,0.022836,172.217.194.0-255,5738,148252,8,276006
20933,0.022843,172.31.36.0-255,66,148318,8,276006
20934,0.024944,172.217.194.0-255,5738,154056,8,276006
20935,0.02495,172.31.36.0-255,66,154122,8,276006
20936,0.027032,172.217.194.0-255,5738,159860,8,276006
20937,0.027039,172.31.36.0-255,66,159926,8,276006
20938,0.029109,172.217.194.0-255,5738,165664,8,276006
20939,0.029115,172.31.36.0-255,66,165730,8,276006
20940,0.031193,172.217.194.0-255,5738,171468,8,276006
20941,0.031199,172.31.36.0-255,66,171534,8,276006
20942,0.033276,172.217.194.0-255,5738,177272,8,276006
20943,0.033282,172.31.36.0-255,66,177338,8,276006
20944,0.035367,172.217.194.0-255,5738,183076,8,276006
20945,0.035374,172.31.36.0-255,66,183142,8,276006
20946,0.037452,172.217.194.0-255,5738,188880,8,276006
20947,0.037458,172.31.36.0-255,66,188946,8,276006
20948,0.039535,172.217.194.0-255,5738,194684,8,276006
20949,0.039541,172.31.36.0-255,66,194750,8,276006
20950,0.041628,172.217.194.0-255,5738,200488,8,276006
20951,0.041635,172.31.36.0-255,66,200554,8,276006
20952,0.043739,172.217.194.0-255,5738,206292,8,276006
20953,0.043748,172.31.36.0-255,66,206358,8,276006
20954,0.045812,172.217.194.0-255,5738,212096,8,276006
20955,0.045819,172.31.36.0-255,66,212162,8,276006
20956,0.047894,172.217.194.0-255,5738,217900,8,276006
20957,0.0479,172.31.36.0-255,66,217966,8,276006
20958,0.049952,172.217.194.0-255,5738,223704,8,276006
20959,0.049959,172.31.36.0-255,66,223770,8,276006
20960,0.052023,172.217.194.0-255,5738,229508,8,276006
20961,0.052029,172.31.36.0-255,66,229574,8,276006
20962,0.054098,172.217.194.0-255,5738,235312,8,276006
20963,0.054105,172.31.36.0-255,66,235378,8,276006
20964,0.056188,172.217.194.0-255,5738,241116,8,276006
20965,0.056194,172.31.36.0-255,66,241182,8,276006
20966,0.058266,172.217.194.0-255,5738,246920,8,276006
20967,0.058272,172.31.36.0-255,66,246986,8,276006
20968,0.06035,172.217.194.0-255,5738,252724,8,276006
20969,0.060356,172.31.36.0-255,66,252790,8,276006
20970,0.062475,172.217.194.0-255,5738,258528,8,276006
20971,0.062481,172.31.36.0-255,66,258594,8,276006
20972,0.064563,172.217.194.0-255,5738,264332,8,276006
20973,0.064571,172.31.36.0-255,66,264398,8,276006
20974,0.066666,172.217.194.0-255,5738,270136,8,276006
20975,0.066673,172.31.36.0-255,66,270202,8,276006
20976,0.068766,172.217.194.0-255,5738,275940,8,276006
20977,0.068772,172.31.36.0-255,66,276006,8,276006
20978,0.0,74.125.24.0-255,153,153,8,294014
20979,3.4e-05,172.31.36.0-255,66,219,8,294014
20980,4.1e-05,74.125.24.0-255,1484,1703,8,294014
20981,4.6e-05,172.31.36.0-255,66,1769,8,294014
20982,5e-05,74.125.24.0-255,2902,4671,8,294014
20983,5.3e-05,172.31.36.0-255,66,4737,8,294014
20984,5.8e-05,74.125.24.0-255,4320,9057,8,294014
20985,6.1e-05,172.31.36.0-255,66,9123,8,294014
20986,6.7e-05,74.125.24.0-255,4856,13979,8,294014
20987,6.9e-05,172.31.36.0-255,66,14045,8,294014
20988,9.1e-05,74.125.24.0-255,1484,15529,8,294014
20989,9.5e-05,172.31.36.0-255,66,15595,8,294014
20990,0.000127,172.31.36.0-255,66,15661,8,294014
20991,0.000144,74.125.24.0-255,1484,17145,8,294014
20992,0.000147,172.31.36.0-255,66,17211,8,294014
20993,0.000168,74.125.24.0-255,3961,21172,8,294014
20994,0.000172,172.31.36.0-255,66,21238,8,294014
20995,0.000234,74.125.24.0-255,1484,22722,8,294014
20996,0.000238,172.31.36.0-255,66,22788,8,294014
20997,0.000255,74.125.24.0-255,2902,25690,8,294014
20998,0.000258,172.31.36.0-255,66,25756,8,294014
20999,0.000264,74.125.24.0-255,2902,28658,8,294014
21000,0.000266,172.31.36.0-255,66,28724,8,294014
21001,0.000282,74.125.24.0-255,2902,31626,8,294014
21002,0.000286,172.31.36.0-255,66,31692,8,294014
21003,0.00029,74.125.24.0-255,2902,34594,8,294014
21004,0.000292,172.31.36.0-255,66,34660,8,294014
21005,0.000314,74.125.24.0-255,3961,38621,8,294014
21006,0.000317,172.31.36.0-255,66,38687,8,294014
21007,0.000323,74.125.24.0-255,7156,45843,8,294014
21008,0.000325,172.31.36.0-255,66,45909,8,294014
21009,0.000366,74.125.24.0-255,4320,50229,8,294014
21010,0.000369,172.31.36.0-255,66,50295,8,294014
21011,0.000384,74.125.24.0-255,5690,55985,8,294014
21012,0.000387,172.31.36.0-255,66,56051,8,294014
21013,0.00039,74.125.24.0-255,110,56161,8,294014
21014,0.000488,74.125.24.0-255,1484,57645,8,294014
21015,0.000491,172.31.36.0-255,66,57711,8,294014
21016,0.000497,74.125.24.0-255,2902,60613,8,294014
21017,0.0005,172.31.36.0-255,66,60679,8,294014
21018,0.00052,74.125.24.0-255,4320,64999,8,294014
21019,0.000522,172.31.36.0-255,66,65065,8,294014
21020,0.00054,74.125.24.0-255,1484,66549,8,294014
21021,0.000546,74.125.24.0-255,4320,70869,8,294014
21022,0.000548,172.31.36.0-255,66,70935,8,294014
21023,0.000565,74.125.24.0-255,1484,72419,8,294014
21024,0.000569,74.125.24.0-255,2902,75321,8,294014
21025,0.000572,172.31.36.0-255,66,75387,8,294014
21026,0.000591,74.125.24.0-255,3961,79348,8,294014
21027,0.000593,172.31.36.0-255,66,79414,8,294014
21028,0.000598,74.125.24.0-255,2902,82316,8,294014
21029,0.0006,172.31.36.0-255,66,82382,8,294014
21030,0.000624,172.31.36.0-255,66,82448,8,294014
21031,0.000627,74.125.24.0-255,333,82781,8,294014
21032,0.000867,74.125.24.0-255,1484,84265,8,294014
21033,0.000871,172.31.36.0-255,66,84331,8,294014
21034,0.000876,74.125.24.0-255,2902,87233,8,294014
21035,0.000878,172.31.36.0-255,66,87299,8,294014
21036,0.000891,74.125.24.0-255,2902,90201,8,294014
21037,0.000894,172.31.36.0-255,66,90267,8,294014
21038,0.000914,74.125.24.0-255,2902,93169,8,294014
21039,0.000917,172.31.36.0-255,66,93235,8,294014
21040,0.000943,172.31.36.0-255,66,93301,8,294014
21041,0.000965,74.125.24.0-255,7156,100457,8,294014
21042,0.000967,172.31.36.0-255,66,100523,8,294014
21043,0.001007,74.125.24.0-255,4320,104843,8,294014
21044,0.00101,172.31.36.0-255,66,104909,8,294014
21045,0.001027,74.125.24.0-255,2184,107093,8,294014
21046,0.00103,172.31.36.0-255,66,107159,8,294014
21047,0.00117,74.125.24.0-255,1484,108643,8,294014
21048,0.001174,74.125.24.0-255,1484,110127,8,294014
21049,0.001176,172.31.36.0-255,66,110193,8,294014
21050,0.00119,74.125.24.0-255,1484,111677,8,294014
21051,0.001198,74.125.24.0-255,4320,115997,8,294014
21052,0.001201,172.31.36.0-255,66,116063,8,294014
21053,0.001222,74.125.24.0-255,1484,117547,8,294014
21054,0.001226,74.125.24.0-255,1484,119031,8,294014
21055,0.001227,172.31.36.0-255,66,119097,8,294014
21056,0.001235,74.125.24.0-255,7156,126253,8,294014
21057,0.001237,172.31.36.0-255,66,126319,8,294014
21058,0.001253,74.125.24.0-255,1484,127803,8,294014
21059,0.001259,74.125.24.0-255,4320,132123,8,294014
21060,0.001261,172.31.36.0-255,66,132189,8,294014
21061,0.001291,172.31.36.0-255,66,132255,8,294014
21062,0.001653,74.125.24.0-255,1484,133739,8,294014
21063,0.001663,74.125.24.0-255,2902,136641,8,294014
21064,0.001667,172.31.36.0-255,66,136707,8,294014
21065,0.001673,74.125.24.0-255,2902,139609,8,294014
21066,0.001676,172.31.36.0-255,66,139675,8,294014
21067,0.001693,74.125.24.0-255,2902,142577,8,294014
21068,0.001696,172.31.36.0-255,66,142643,8,294014
21069,0.001707,172.31.36.0-255,66,142709,8,294014
21070,0.001733,74.125.24.0-255,4320,147029,8,294014
21071,0.001736,172.31.36.0-255,66,147095,8,294014
21072,0.001747,172.31.36.0-255,66,147161,8,294014
21073,0.001772,74.125.24.0-255,2184,149345,8,294014
21074,0.001776,172.31.36.0-255,66,149411,8,294014
21075,0.001856,74.125.24.0-255,1484,150895,8,294014
21076,0.001883,74.125.24.0-255,2902,153797,8,294014
21077,0.001886,172.31.36.0-255,66,153863,8,294014
21078,0.001908,74.125.24.0-255,5738,159601,8,294014
21079,0.00191,172.31.36.0-255,66,159667,8,294014
21080,0.001917,74.125.24.0-255,5738,165405,8,294014
21081,0.001919,172.31.36.0-255,66,165471,8,294014
21082,0.00193,74.125.24.0-255,1484,166955,8,294014
21083,0.001959,172.31.36.0-255,66,167021,8,294014
21084,0.001965,74.125.24.0-255,5020,172041,8,294014
21085,0.001967,172.31.36.0-255,66,172107,8,294014
21086,0.002123,74.125.24.0-255,1484,173591,8,294014
21087,0.002129,74.125.24.0-255,2902,176493,8,294014
21088,0.002134,172.31.36.0-255,66,176559,8,294014
21089,0.002193,74.125.24.0-255,5738,182297,8,294014
21090,0.002196,172.31.36.0-255,66,182363,8,294014
21091,0.002214,172.31.36.0-255,66,182429,8,294014
21092,0.002216,74.125.24.0-255,1484,183913,8,294014
21093,0.002244,172.31.36.0-255,66,183979,8,294014
21094,0.002256,172.31.36.0-255,66,184045,8,294014
21095,0.002284,74.125.24.0-255,1484,185529,8,294014
21096,0.002294,172.31.36.0-255,66,185595,8,294014
21097,0.00231,74.125.24.0-255,1484,187079,8,294014
21098,0.002337,172.31.36.0-255,66,187145,8,294014
21099,0.002362,74.125.24.0-255,6438,193583,8,294014
21100,0.002364,172.31.36.0-255,66,193649,8,294014
21101,0.00237,74.125.24.0-255,5738,199387,8,294014
21102,0.002372,172.31.36.0-255,66,199453,8,294014
21103,0.004669,74.125.24.0-255,4320,203773,8,294014
21104,0.004674,172.31.36.0-255,66,203839,8,294014
21105,0.004686,74.125.24.0-255,1484,205323,8,294014
21106,0.006972,74.125.24.0-255,4320,209643,8,294014
21107,0.006979,172.31.36.0-255,66,209709,8,294014
21108,0.009278,74.125.24.0-255,5738,215447,8,294014
21109,0.009289,172.31.36.0-255,66,215513,8,294014
21110,0.011541,74.125.24.0-255,5738,221251,8,294014
21111,0.011549,172.31.36.0-255,66,221317,8,294014
21112,0.013833,74.125.24.0-255,5738,227055,8,294014
21113,0.013841,172.31.36.0-255,66,227121,8,294014
21114,0.016128,74.125.24.0-255,5738,232859,8,294014
21115,0.016136,172.31.36.0-255,66,232925,8,294014
21116,0.018416,74.125.24.0-255,5738,238663,8,294014
21117,0.018424,172.31.36.0-255,66,238729,8,294014
21118,0.020699,74.125.24.0-255,5738,244467,8,294014
21119,0.020707,172.31.36.0-255,66,244533,8,294014
21120,0.022992,74.125.24.0-255,5738,250271,8,294014
21121,0.023,172.31.36.0-255,66,250337,8,294014
21122,0.02525,74.125.24.0-255,5738,256075,8,294014
21123,0.025257,172.31.36.0-255,66,256141,8,294014
21124,0.027549,74.125.24.0-255,5738,261879,8,294014
21125,0.027563,172.31.36.0-255,66,261945,8,294014
21126,0.029846,74.125.24.0-255,5738,267683,8,294014
21127,0.029853,172.31.36.0-255,66,267749,8,294014
21128,0.03209,74.125.24.0-255,5738,273487,8,294014
21129,0.032098,172.31.36.0-255,66,273553,8,294014
21130,0.03435,74.125.24.0-255,5738,279291,8,294014
21131,0.034357,172.31.36.0-255,66,279357,8,294014
21132,0.036618,74.125.24.0-255,5738,285095,8,294014
21133,0.036624,172.31.36.0-255,66,285161,8,294014
21134,0.036731,172.31.36.0-255,182,285343,8,294014
21135,0.036755,172.31.36.0-255,1110,286453,8,294014
21136,0.036796,172.31.36.0-255,572,287025,8,294014
21137,0.038287,104.244.42.0-255,66,287091,8,294014
21138,0.038333,104.244.42.0-255,66,287157,8,294014
21139,0.038337,104.244.42.0-255,66,287223,8,294014
21140,0.038897,74.125.24.0-255,5738,292961,8,294014
21141,0.038904,172.31.36.0-255,66,293027,8,294014
21142,0.041127,74.125.24.0-255,750,293777,8,294014
21143,0.041272,172.31.36.0-255,66,293843,8,294014
21144,0.041299,172.31.36.0-255,105,293948,8,294014
21145,0.04351,74.125.24.0-255,66,294014,8,294014
21146,0.0,74.125.24.0-255,153,153,8,238452
21147,3.6e-05,172.31.36.0-255,66,219,8,238452
21148,4.3e-05,74.125.24.0-255,1484,1703,8,238452
21149,4.8e-05,172.31.36.0-255,66,1769,8,238452
21150,5.3e-05,74.125.24.0-255,2902,4671,8,238452
21151,5.5e-05,172.31.36.0-255,66,4737,8,238452
21152,6.9e-05,74.125.24.0-255,7156,11893,8,238452
21153,7.2e-05,172.31.36.0-255,66,11959,8,238452
21154,0.000113,74.125.24.0-255,2057,14016,8,238452
21155,0.000115,172.31.36.0-255,66,14082,8,238452
21156,0.000149,74.125.24.0-255,4320,18402,8,238452
21157,0.000153,172.31.36.0-255,66,18468,8,238452
21158,0.000158,74.125.24.0-255,2902,21370,8,238452
21159,0.00016,172.31.36.0-255,66,21436,8,238452
21160,0.000193,74.125.24.0-255,5738,27174,8,238452
21161,0.000196,172.31.36.0-255,66,27240,8,238452
21162,0.000237,74.125.24.0-255,3961,31201,8,238452
21163,0.000241,172.31.36.0-255,66,31267,8,238452
21164,0.000313,74.125.24.0-255,1484,32751,8,238452
21165,0.000316,172.31.36.0-255,66,32817,8,238452
21166,0.000321,74.125.24.0-255,2902,35719,8,238452
21167,0.000324,172.31.36.0-255,66,35785,8,238452
21168,0.000357,74.125.24.0-255,5738,41523,8,238452
21169,0.000362,172.31.36.0-255,66,41589,8,238452
21170,0.000387,74.125.24.0-255,1484,43073,8,238452
21171,0.00039,172.31.36.0-255,66,43139,8,238452
21172,0.000418,172.31.36.0-255,66,43205,8,238452
21173,0.000519,74.125.24.0-255,7156,50361,8,238452
21174,0.000523,172.31.36.0-255,66,50427,8,238452
21175,0.000572,74.125.24.0-255,2840,53267,8,238452
21176,0.000575,172.31.36.0-255,66,53333,8,238452
21177,0.000599,74.125.24.0-255,382,53715,8,238452
21178,0.000681,74.125.24.0-255,1484,55199,8,238452
21179,0.00069,172.31.36.0-255,66,55265,8,238452
21180,0.000695,74.125.24.0-255,2902,58167,8,238452
21181,0.000697,172.31.36.0-255,66,58233,8,238452
21182,0.000733,74.125.24.0-255,5738,63971,8,238452
21183,0.000737,172.31.36.0-255,66,64037,8,238452
21184,0.000761,74.125.24.0-255,6797,70834,8,238452
21185,0.000764,172.31.36.0-255,66,70900,8,238452
21186,0.000816,74.125.24.0-255,2902,73802,8,238452
21187,0.000819,172.31.36.0-255,66,73868,8,238452
21188,0.000838,74.125.24.0-255,4320,78188,8,238452
21189,0.00084,172.31.36.0-255,66,78254,8,238452
21190,0.000876,74.125.24.0-255,5738,83992,8,238452
21191,0.000879,172.31.36.0-255,66,84058,8,238452
21192,0.000929,74.125.24.0-255,3961,88019,8,238452
21193,0.000932,172.31.36.0-255,66,88085,8,238452
21194,0.001218,74.125.24.0-255,1484,89569,8,238452
21195,0.001224,74.125.24.0-255,2902,92471,8,238452
21196,0.001227,172.31.36.0-255,66,92537,8,238452
21197,0.001255,74.125.24.0-255,5738,98275,8,238452
21198,0.001258,172.31.36.0-255,66,98341,8,238452
21199,0.001295,74.125.24.0-255,7156,105497,8,238452
21200,0.001299,172.31.36.0-255,66,105563,8,238452
21201,0.001328,74.125.24.0-255,5738,111301,8,238452
21202,0.001331,172.31.36.0-255,66,111367,8,238452
21203,0.00142,172.31.36.0-255,66,111433,8,238452
21204,0.001499,74.125.24.0-255,5738,117171,8,238452
21205,0.001503,172.31.36.0-255,66,117237,8,238452
21206,0.001535,74.125.24.0-255,5738,122975,8,238452
21207,0.001538,172.31.36.0-255,66,123041,8,238452
21208,0.001643,172.31.36.0-255,66,123107,8,238452
21209,0.001684,172.31.36.0-255,66,123173,8,238452
21210,0.001812,172.31.36.0-255,66,123239,8,238452
21211,0.001848,172.31.36.0-255,66,123305,8,238452
21212,0.001993,74.125.24.0-255,5738,129043,8,238452
21213,0.001998,172.31.36.0-255,66,129109,8,238452
21214,0.002031,74.125.24.0-255,5020,134129,8,238452
21215,0.002034,172.31.36.0-255,66,134195,8,238452
21216,0.002091,74.125.24.0-255,5738,139933,8,238452
21217,0.002096,172.31.36.0-255,66,139999,8,238452
21218,0.002149,172.31.36.0-255,66,140065,8,238452
21219,0.002394,74.125.24.0-255,7156,147221,8,238452
21220,0.0024,172.31.36.0-255,66,147287,8,238452
21221,0.002419,74.125.24.0-255,5738,153025,8,238452
21222,0.002422,172.31.36.0-255,66,153091,8,238452
21223,0.002514,74.125.24.0-255,5738,158829,8,238452
21224,0.002517,172.31.36.0-255,66,158895,8,238452
21225,0.002571,172.31.36.0-255,66,158961,8,238452
21226,0.002987,172.31.36.0-255,66,159027,8,238452
21227,0.003029,172.31.36.0-255,66,159093,8,238452
21228,0.005125,74.125.24.0-255,5738,164831,8,238452
21229,0.009186,172.31.36.0-255,66,164897,8,238452
21230,0.011289,74.125.24.0-255,5738,170635,8,238452
21231,0.011298,172.31.36.0-255,66,170701,8,238452
21232,0.013373,74.125.24.0-255,5738,176439,8,238452
21233,0.013381,172.31.36.0-255,66,176505,8,238452
21234,0.015468,74.125.24.0-255,4320,180825,8,238452
21235,0.015475,172.31.36.0-255,66,180891,8,238452
21236,0.015499,74.125.24.0-255,1484,182375,8,238452
21237,0.017555,74.125.24.0-255,4320,186695,8,238452
21238,0.017562,172.31.36.0-255,66,186761,8,238452
21239,0.019659,74.125.24.0-255,5738,192499,8,238452
21240,0.019668,172.31.36.0-255,66,192565,8,238452
21241,0.021761,74.125.24.0-255,5738,198303,8,238452
21242,0.021769,172.31.36.0-255,66,198369,8,238452
21243,0.023885,74.125.24.0-255,5738,204107,8,238452
21244,0.023892,172.31.36.0-255,66,204173,8,238452
21245,0.025982,74.125.24.0-255,5738,209911,8,238452
21246,0.025991,172.31.36.0-255,66,209977,8,238452
21247,0.028079,74.125.24.0-255,5738,215715,8,238452
21248,0.028086,172.31.36.0-255,66,215781,8,238452
21249,0.030175,74.125.24.0-255,5738,221519,8,238452
21250,0.030183,172.31.36.0-255,66,221585,8,238452
21251,0.032254,74.125.24.0-255,5738,227323,8,238452
21252,0.032261,172.31.36.0-255,66,227389,8,238452
21253,0.034373,74.125.24.0-255,5738,233127,8,238452
21254,0.03438,172.31.36.0-255,66,233193,8,238452
21255,0.036469,74.125.24.0-255,618,233811,8,238452
21256,0.036631,172.31.36.0-255,66,233877,8,238452
21257,0.036849,172.31.36.0-255,105,233982,8,238452
21258,0.038893,74.125.24.0-255,66,234048,8,238452
21259,0.043164,172.31.36.0-255,172,234220,8,238452
21260,0.043195,172.31.36.0-255,1111,235331,8,238452
21261,0.043256,172.31.36.0-255,1514,236845,8,238452
21262,0.043258,172.31.36.0-255,1409,238254,8,238452
21263,0.044642,104.244.42.0-255,66,238320,8,238452
21264,0.044756,104.244.42.0-255,66,238386,8,238452
21265,0.04476,104.244.42.0-255,66,238452,8,238452
21266,0.0,172.217.194.0-255,150,150,8,246188
21267,3e-05,172.31.36.0-255,66,216,8,246188
21268,3.7e-05,172.217.194.0-255,1484,1700,8,246188
21269,4e-05,172.31.36.0-255,66,1766,8,246188
21270,4.5e-05,172.217.194.0-255,2902,4668,8,246188
21271,4.7e-05,172.31.36.0-255,66,4734,8,246188
21272,5.2e-05,172.217.194.0-255,7156,11890,8,246188
21273,5.5e-05,172.31.36.0-255,66,11956,8,246188
21274,7.7e-05,172.217.194.0-255,2902,14858,8,246188
21275,8.1e-05,172.31.36.0-255,66,14924,8,246188
21276,8.9e-05,172.217.194.0-255,4320,19244,8,246188
21277,9.1e-05,172.31.36.0-255,66,19310,8,246188
21278,0.000115,172.217.194.0-255,4884,24194,8,246188
21279,0.000118,172.31.36.0-255,66,24260,8,246188
21280,0.000123,172.217.194.0-255,6797,31057,8,246188
21281,0.000125,172.31.36.0-255,66,31123,8,246188
21282,0.000184,172.217.194.0-255,1484,32607,8,246188
21283,0.000186,172.31.36.0-255,66,32673,8,246188
21284,0.000191,172.217.194.0-255,2902,35575,8,246188
21285,0.000193,172.31.36.0-255,66,35641,8,246188
21286,0.000197,172.217.194.0-255,2902,38543,8,246188
21287,0.000199,172.31.36.0-255,66,38609,8,246188
21288,0.00022,172.217.194.0-255,2902,41511,8,246188
21289,0.000222,172.31.36.0-255,66,41577,8,246188
21290,0.000235,172.217.194.0-255,5738,47315,8,246188
21291,0.000238,172.31.36.0-255,66,47381,8,246188
21292,0.000277,172.31.36.0-255,66,47447,8,246188
21293,0.000288,172.31.36.0-255,66,47513,8,246188
21294,0.00029,172.217.194.0-255,399,47912,8,246188
21295,0.000292,172.31.36.0-255,66,47978,8,246188
21296,0.000396,172.217.194.0-255,1484,49462,8,246188
21297,0.000401,172.217.194.0-255,2902,52364,8,246188
21298,0.000405,172.31.36.0-255,66,52430,8,246188
21299,0.000425,172.217.194.0-255,5738,58168,8,246188
21300,0.000428,172.31.36.0-255,66,58234,8,246188
21301,0.000458,172.31.36.0-255,66,58300,8,246188
21302,0.000463,172.217.194.0-255,4320,62620,8,246188
21303,0.000465,172.31.36.0-255,66,62686,8,246188
21304,0.000483,172.217.194.0-255,5738,68424,8,246188
21305,0.000485,172.31.36.0-255,66,68490,8,246188
21306,0.000488,172.217.194.0-255,216,68706,8,246188
21307,0.000697,172.217.194.0-255,1484,70190,8,246188
21308,0.0007,172.31.36.0-255,66,70256,8,246188
21309,0.000721,172.217.194.0-255,2902,73158,8,246188
21310,0.000724,172.31.36.0-255,66,73224,8,246188
21311,0.00073,172.217.194.0-255,5738,78962,8,246188
21312,0.000733,172.31.36.0-255,66,79028,8,246188
21313,0.000761,172.217.194.0-255,5738,84766,8,246188
21314,0.000764,172.31.36.0-255,66,84832,8,246188
21315,0.000782,172.217.194.0-255,7156,91988,8,246188
21316,0.000785,172.31.36.0-255,66,92054,8,246188
21317,0.000794,172.31.36.0-255,66,92120,8,246188
21318,0.000832,172.217.194.0-255,2184,94304,8,246188
21319,0.000835,172.31.36.0-255,66,94370,8,246188
21320,0.000985,172.217.194.0-255,1484,95854,8,246188
21321,0.000989,172.217.194.0-255,2902,98756,8,246188
21322,0.000991,172.31.36.0-255,66,98822,8,246188
21323,0.000997,172.217.194.0-255,5738,104560,8,246188
21324,0.000999,172.31.36.0-255,66,104626,8,246188
21325,0.001047,172.217.194.0-255,7156,111782,8,246188
21326,0.00105,172.31.36.0-255,66,111848,8,246188
21327,0.001056,172.217.194.0-255,5738,117586,8,246188
21328,0.001058,172.31.36.0-255,66,117652,8,246188
21329,0.001078,172.31.36.0-255,66,117718,8,246188
21330,0.001081,172.217.194.0-255,2184,119902,8,246188
21331,0.001083,172.31.36.0-255,66,119968,8,246188
21332,0.001371,172.217.194.0-255,1484,121452,8,246188
21333,0.001376,172.217.194.0-255,2902,124354,8,246188
21334,0.001378,172.31.36.0-255,66,124420,8,246188
21335,0.001382,172.217.194.0-255,1484,125904,8,246188
21336,0.001401,172.217.194.0-255,4320,130224,8,246188
21337,0.001403,172.31.36.0-255,66,130290,8,246188
21338,0.00142,172.217.194.0-255,5738,136028,8,246188
21339,0.001422,172.31.36.0-255,66,136094,8,246188
21340,0.001437,172.217.194.0-255,7156,143250,8,246188
21341,0.001439,172.31.36.0-255,66,143316,8,246188
21342,0.001449,172.31.36.0-255,66,143382,8,246188
21343,0.001487,172.217.194.0-255,2902,146284,8,246188
21344,0.001489,172.31.36.0-255,66,146350,8,246188
21345,0.001516,172.31.36.0-255,66,146416,8,246188
21346,0.001529,172.31.36.0-255,66,146482,8,246188
21347,0.001532,172.217.194.0-255,2902,149384,8,246188
21348,0.001534,172.31.36.0-255,66,149450,8,246188
21349,0.001555,172.217.194.0-255,3602,153052,8,246188
21350,0.001557,172.31.36.0-255,66,153118,8,246188
21351,0.001579,172.217.194.0-255,7156,160274,8,246188
21352,0.001583,172.31.36.0-255,66,160340,8,246188
21353,0.001585,172.217.194.0-255,7156,167496,8,246188
21354,0.001587,172.31.36.0-255,66,167562,8,246188
21355,0.001607,172.217.194.0-255,2902,170464,8,246188
21356,0.001609,172.31.36.0-255,66,170530,8,246188
21357,0.001642,172.217.194.0-255,4320,174850,8,246188
21358,0.001644,172.31.36.0-255,66,174916,8,246188
21359,0.001672,172.31.36.0-255,66,174982,8,246188
21360,0.001675,172.217.194.0-255,1484,176466,8,246188
21361,0.00171,172.31.36.0-255,66,176532,8,246188
21362,0.001719,172.31.36.0-255,66,176598,8,246188
21363,0.001739,172.217.194.0-255,5738,182336,8,246188
21364,0.001742,172.31.36.0-255,66,182402,8,246188
21365,0.001746,172.217.194.0-255,3602,186004,8,246188
21366,0.001748,172.31.36.0-255,66,186070,8,246188
21367,0.001882,172.217.194.0-255,1484,187554,8,246188
21368,0.001886,172.217.194.0-255,2902,190456,8,246188
21369,0.001888,172.31.36.0-255,66,190522,8,246188
21370,0.001911,172.217.194.0-255,5738,196260,8,246188
21371,0.001913,172.31.36.0-255,66,196326,8,246188
21372,0.001941,172.31.36.0-255,66,196392,8,246188
21373,0.001965,172.217.194.0-255,1484,197876,8,246188
21374,0.001976,172.31.36.0-255,66,197942,8,246188
21375,0.002045,172.31.36.0-255,66,198008,8,246188
21376,0.002051,172.31.36.0-255,66,198074,8,246188
21377,0.002064,172.217.194.0-255,766,198840,8,246188
21378,0.002679,172.31.36.0-255,66,198906,8,246188
21379,0.0044,172.217.194.0-255,4320,203226,8,246188
21380,0.004409,172.31.36.0-255,66,203292,8,246188
21381,0.005007,172.217.194.0-255,1484,204776,8,246188
21382,0.006726,172.217.194.0-255,4320,209096,8,246188
21383,0.006731,172.31.36.0-255,66,209162,8,246188
21384,0.009077,172.217.194.0-255,5738,214900,8,246188
21385,0.009081,172.31.36.0-255,66,214966,8,246188
21386,0.01141,172.217.194.0-255,5738,220704,8,246188
21387,0.011417,172.31.36.0-255,66,220770,8,246188
21388,0.013753,172.217.194.0-255,5738,226508,8,246188
21389,0.01376,172.31.36.0-255,66,226574,8,246188
21390,0.016103,172.217.194.0-255,5738,232312,8,246188
21391,0.016112,172.31.36.0-255,66,232378,8,246188
21392,0.018446,172.217.194.0-255,5738,238116,8,246188
21393,0.018454,172.31.36.0-255,66,238182,8,246188
21394,0.020799,172.217.194.0-255,3099,241281,8,246188
21395,0.020806,172.31.36.0-255,66,241347,8,246188
21396,0.020986,172.31.36.0-255,105,241452,8,246188
21397,0.023283,172.217.194.0-255,66,241518,8,246188
21398,0.041339,172.31.36.0-255,478,241996,8,246188
21399,0.041373,172.31.36.0-255,1109,243105,8,246188
21400,0.04143,172.31.36.0-255,1514,244619,8,246188
21401,0.041432,172.31.36.0-255,1371,245990,8,246188
21402,0.042899,104.244.42.0-255,66,246056,8,246188
21403,0.042943,104.244.42.0-255,66,246122,8,246188
21404,0.042986,104.244.42.0-255,66,246188,8,246188
21405,0.0,172.253.118.0-255,172,172,8,333559
21406,2.4e-05,172.31.36.0-255,66,238,8,333559
21407,3.1e-05,172.253.118.0-255,1484,1722,8,333559
21408,3.7e-05,172.31.36.0-255,66,1788,8,333559
21409,4.3e-05,172.253.118.0-255,2902,4690,8,333559
21410,4.5e-05,172.31.36.0-255,66,4756,8,333559
21411,5.3e-05,172.253.118.0-255,7156,11912,8,333559
21412,5.5e-05,172.31.36.0-255,66,11978,8,333559
21413,5.9e-05,172.253.118.0-255,2030,14008,8,333559
21414,6.2e-05,172.31.36.0-255,66,14074,8,333559
21415,9.1e-05,172.253.118.0-255,1484,15558,8,333559
21416,9.4e-05,172.31.36.0-255,66,15624,8,333559
21417,9.9e-05,172.253.118.0-255,2902,18526,8,333559
21418,0.000102,172.31.36.0-255,66,18592,8,333559
21419,0.000108,172.253.118.0-255,5738,24330,8,333559
21420,0.00011,172.31.36.0-255,66,24396,8,333559
21421,0.000128,172.253.118.0-255,2902,27298,8,333559
21422,0.00013,172.31.36.0-255,66,27364,8,333559
21423,0.000157,172.253.118.0-255,3961,31325,8,333559
21424,0.00016,172.31.36.0-255,66,31391,8,333559
21425,0.000216,172.253.118.0-255,1484,32875,8,333559
21426,0.000218,172.31.36.0-255,66,32941,8,333559
21427,0.000223,172.253.118.0-255,2902,35843,8,333559
21428,0.000225,172.31.36.0-255,66,35909,8,333559
21429,0.000246,172.253.118.0-255,5738,41647,8,333559
21430,0.000249,172.31.36.0-255,66,41713,8,333559
21431,0.000278,172.31.36.0-255,66,41779,8,333559
21432,0.000302,172.253.118.0-255,5379,47158,8,333559
21433,0.000304,172.31.36.0-255,66,47224,8,333559
21434,0.000312,172.253.118.0-255,7156,54380,8,333559
21435,0.000314,172.31.36.0-255,66,54446,8,333559
21436,0.000343,172.253.118.0-255,2900,57346,8,333559
21437,0.000346,172.31.36.0-255,66,57412,8,333559
21438,0.000694,172.253.118.0-255,351,57763,8,333559
21439,0.000964,172.253.118.0-255,1484,59247,8,333559
21440,0.000968,172.31.36.0-255,66,59313,8,333559
21441,0.000974,172.253.118.0-255,2902,62215,8,333559
21442,0.000976,172.31.36.0-255,66,62281,8,333559
21443,0.000981,172.253.118.0-255,2902,65183,8,333559
21444,0.000983,172.31.36.0-255,66,65249,8,333559
21445,0.000998,172.253.118.0-255,2902,68151,8,333559
21446,0.001,172.253.118.0-255,1484,69635,8,333559
21447,0.001003,172.31.36.0-255,66,69701,8,333559
21448,0.001015,172.253.118.0-255,4320,74021,8,333559
21449,0.001018,172.31.36.0-255,66,74087,8,333559
21450,0.001048,172.253.118.0-255,7156,81243,8,333559
21451,0.001051,172.31.36.0-255,66,81309,8,333559
21452,0.001064,172.31.36.0-255,66,81375,8,333559
21453,0.001178,172.253.118.0-255,1484,82859,8,333559
21454,0.001183,172.253.118.0-255,2902,85761,8,333559
21455,0.001194,172.31.36.0-255,66,85827,8,333559
21456,0.001202,172.253.118.0-255,5738,91565,8,333559
21457,0.001205,172.31.36.0-255,66,91631,8,333559
21458,0.001253,172.253.118.0-255,7156,98787,8,333559
21459,0.001256,172.31.36.0-255,66,98853,8,333559
21460,0.001275,172.253.118.0-255,5738,104591,8,333559
21461,0.001277,172.31.36.0-255,66,104657,8,333559
21462,0.001288,172.31.36.0-255,66,104723,8,333559
21463,0.001293,172.253.118.0-255,2184,106907,8,333559
21464,0.001295,172.31.36.0-255,66,106973,8,333559
21465,0.001409,172.253.118.0-255,1484,108457,8,333559
21466,0.001413,172.253.118.0-255,2902,111359,8,333559
21467,0.001419,172.31.36.0-255,66,111425,8,333559
21468,0.001429,172.253.118.0-255,1484,112909,8,333559
21469,0.001443,172.253.118.0-255,4320,117229,8,333559
21470,0.001446,172.31.36.0-255,66,117295,8,333559
21471,0.00145,172.253.118.0-255,1484,118779,8,333559
21472,0.00148,172.31.36.0-255,66,118845,8,333559
21473,0.001504,172.253.118.0-255,5738,124583,8,333559
21474,0.001506,172.31.36.0-255,66,124649,8,333559
21475,0.001534,172.31.36.0-255,66,124715,8,333559
21476,0.001563,172.253.118.0-255,1484,126199,8,333559
21477,0.001576,172.253.118.0-255,1484,127683,8,333559
21478,0.001579,172.31.36.0-255,66,127749,8,333559
21479,0.0016,172.253.118.0-255,1484,129233,8,333559
21480,0.001607,172.253.118.0-255,5738,134971,8,333559
21481,0.00161,172.31.36.0-255,66,135037,8,333559
21482,0.001618,172.253.118.0-255,7156,142193,8,333559
21483,0.001621,172.31.36.0-255,66,142259,8,333559
21484,0.001642,172.253.118.0-255,4320,146579,8,333559
21485,0.001645,172.31.36.0-255,66,146645,8,333559
21486,0.001681,172.31.36.0-255,66,146711,8,333559
21487,0.001702,172.253.118.0-255,2184,148895,8,333559
21488,0.001705,172.31.36.0-255,66,148961,8,333559
21489,0.001886,172.253.118.0-255,1484,150445,8,333559
21490,0.001891,172.253.118.0-255,1484,151929,8,333559
21491,0.001893,172.31.36.0-255,66,151995,8,333559
21492,0.001916,172.253.118.0-255,1484,153479,8,333559
21493,0.001922,172.253.118.0-255,5738,159217,8,333559
21494,0.001924,172.31.36.0-255,66,159283,8,333559
21495,0.001944,172.253.118.0-255,2902,162185,8,333559
21496,0.001947,172.31.36.0-255,66,162251,8,333559
21497,0.001963,172.253.118.0-255,7156,169407,8,333559
21498,0.001965,172.31.36.0-255,66,169473,8,333559
21499,0.001987,172.253.118.0-255,2902,172375,8,333559
21500,0.001991,172.31.36.0-255,66,172441,8,333559
21501,0.001996,172.253.118.0-255,4320,176761,8,333559
21502,0.001998,172.31.36.0-255,66,176827,8,333559
21503,0.002019,172.253.118.0-255,6438,183265,8,333559
21504,0.002023,172.31.36.0-255,66,183331,8,333559
21505,0.002061,172.31.36.0-255,66,183397,8,333559
21506,0.002083,172.253.118.0-255,1484,184881,8,333559
21507,0.002127,172.253.118.0-255,2184,187065,8,333559
21508,0.002164,172.253.118.0-255,1484,188549,8,333559
21509,0.002167,172.253.118.0-255,1484,190033,8,333559
21510,0.002178,172.253.118.0-255,1484,191517,8,333559
21511,0.002186,172.253.118.0-255,5738,197255,8,333559
21512,0.00219,172.253.118.0-255,2902,200157,8,333559
21513,0.00221,172.253.118.0-255,5738,205895,8,333559
21514,0.002226,172.253.118.0-255,4320,210215,8,333559
21515,0.00225,172.253.118.0-255,2902,213117,8,333559
21516,0.008074,172.31.36.0-255,66,213183,8,333559
21517,0.010438,172.253.118.0-255,5738,218921,8,333559
21518,0.010451,172.31.36.0-255,66,218987,8,333559
21519,0.01281,172.253.118.0-255,5738,224725,8,333559
21520,0.01282,172.31.36.0-255,66,224791,8,333559
21521,0.015149,172.253.118.0-255,5738,230529,8,333559
21522,0.015159,172.31.36.0-255,66,230595,8,333559
21523,0.017517,172.253.118.0-255,5738,236333,8,333559
21524,0.017529,172.31.36.0-255,66,236399,8,333559
21525,0.019913,172.253.118.0-255,5738,242137,8,333559
21526,0.019925,172.31.36.0-255,66,242203,8,333559
21527,0.02228,172.253.118.0-255,5738,247941,8,333559
21528,0.022289,172.31.36.0-255,66,248007,8,333559
21529,0.024625,172.253.118.0-255,5738,253745,8,333559
21530,0.024633,172.31.36.0-255,66,253811,8,333559
21531,0.026983,172.253.118.0-255,5738,259549,8,333559
21532,0.02699,172.31.36.0-255,66,259615,8,333559
21533,0.029342,172.253.118.0-255,5738,265353,8,333559
21534,0.029354,172.31.36.0-255,66,265419,8,333559
21535,0.031741,172.253.118.0-255,5738,271157,8,333559
21536,0.031751,172.31.36.0-255,66,271223,8,333559
21537,0.034129,172.253.118.0-255,5738,276961,8,333559
21538,0.034139,172.31.36.0-255,66,277027,8,333559
21539,0.036495,172.253.118.0-255,5738,282765,8,333559
21540,0.036506,172.31.36.0-255,66,282831,8,333559
21541,0.038855,172.253.118.0-255,5738,288569,8,333559
21542,0.038863,172.31.36.0-255,66,288635,8,333559
21543,0.039803,172.31.36.0-255,172,288807,8,333559
21544,0.039834,172.31.36.0-255,1110,289917,8,333559
21545,0.03992,172.31.36.0-255,1514,291431,8,333559
21546,0.039922,172.31.36.0-255,1514,292945,8,333559
21547,0.039927,172.31.36.0-255,1514,294459,8,333559
21548,0.039929,172.31.36.0-255,1514,295973,8,333559
21549,0.039945,172.31.36.0-255,1231,297204,8,333559
21550,0.041201,172.253.118.0-255,5738,302942,8,333559
21551,0.041216,172.31.36.0-255,66,303008,8,333559
21552,0.041366,104.244.42.0-255,66,303074,8,333559
21553,0.041374,104.244.42.0-255,66,303140,8,333559
21554,0.041502,104.244.42.0-255,66,303206,8,333559
21555,0.041509,104.244.42.0-255,66,303272,8,333559
21556,0.042768,104.244.42.0-255,108,303380,8,333559
21557,0.042779,172.31.36.0-255,66,303446,8,333559
21558,0.043568,172.253.118.0-255,5738,309184,8,333559
21559,0.043573,172.31.36.0-255,66,309250,8,333559
21560,0.045921,172.253.118.0-255,5738,314988,8,333559
21561,0.045928,172.31.36.0-255,66,315054,8,333559
21562,0.048274,172.253.118.0-255,5738,320792,8,333559
21563,0.048282,172.31.36.0-255,66,320858,8,333559
21564,0.05065,172.253.118.0-255,5738,326596,8,333559
21565,0.050658,172.31.36.0-255,66,326662,8,333559
21566,0.053018,172.253.118.0-255,5738,332400,8,333559
21567,0.053025,172.31.36.0-255,66,332466,8,333559
21568,0.055363,172.253.118.0-255,856,333322,8,333559
21569,0.055509,172.31.36.0-255,66,333388,8,333559
21570,0.055551,172.31.36.0-255,105,333493,8,333559
21571,0.057851,172.253.118.0-255,66,333559,8,333559
21572,0.0,74.125.68.0-255,297,297,8,361719
21573,2.1e-05,172.31.36.0-255,66,363,8,361719
21574,2.8e-05,74.125.68.0-255,1484,1847,8,361719
21575,3.1e-05,172.31.36.0-255,66,1913,8,361719
21576,3.9e-05,74.125.68.0-255,4320,6233,8,361719
21577,4.2e-05,172.31.36.0-255,66,6299,8,361719
21578,4.8e-05,74.125.68.0-255,4320,10619,8,361719
21579,5.1e-05,172.31.36.0-255,66,10685,8,361719
21580,7.7e-05,74.125.68.0-255,3225,13910,8,361719
21581,8e-05,172.31.36.0-255,66,13976,8,361719
21582,8.7e-05,74.125.68.0-255,5738,19714,8,361719
21583,9e-05,172.31.36.0-255,66,19780,8,361719
21584,0.000116,74.125.68.0-255,2902,22682,8,361719
21585,0.000119,172.31.36.0-255,66,22748,8,361719
21586,0.000125,74.125.68.0-255,5738,28486,8,361719
21587,0.000127,172.31.36.0-255,66,28552,8,361719
21588,0.00015,172.31.36.0-255,66,28618,8,361719
21589,0.000179,74.125.68.0-255,7156,35774,8,361719
21590,0.000181,172.31.36.0-255,66,35840,8,361719
21591,0.000187,74.125.68.0-255,3602,39442,8,361719
21592,0.000189,172.31.36.0-255,66,39508,8,361719
21593,0.000206,74.125.68.0-255,7156,46664,8,361719
21594,0.000209,172.31.36.0-255,66,46730,8,361719
21595,0.000226,74.125.68.0-255,4320,51050,8,361719
21596,0.000228,172.31.36.0-255,66,51116,8,361719
21597,0.000257,74.125.68.0-255,5379,56495,8,361719
21598,0.000259,172.31.36.0-255,66,56561,8,361719
21599,0.000292,74.125.68.0-255,646,57207,8,361719
21600,0.000296,172.31.36.0-255,66,57273,8,361719
21601,0.000697,74.125.68.0-255,1484,58757,8,361719
21602,0.000703,172.31.36.0-255,66,58823,8,361719
21603,0.000708,74.125.68.0-255,1484,60307,8,361719
21604,0.000732,74.125.68.0-255,2902,63209,8,361719
21605,0.000735,172.31.36.0-255,66,63275,8,361719
21606,0.000742,74.125.68.0-255,4320,67595,8,361719
21607,0.000744,172.31.36.0-255,66,67661,8,361719
21608,0.000756,74.125.68.0-255,1484,69145,8,361719
21609,0.000762,74.125.68.0-255,4320,73465,8,361719
21610,0.000765,172.31.36.0-255,66,73531,8,361719
21611,0.000785,74.125.68.0-255,5738,79269,8,361719
21612,0.000787,172.31.36.0-255,66,79335,8,361719
21613,0.000801,74.125.68.0-255,1484,80819,8,361719
21614,0.000818,74.125.68.0-255,4320,85139,8,361719
21615,0.000821,172.31.36.0-255,66,85205,8,361719
21616,0.000834,74.125.68.0-255,1484,86689,8,361719
21617,0.000856,74.125.68.0-255,5020,91709,8,361719
21618,0.000859,172.31.36.0-255,66,91775,8,361719
21619,0.000986,74.125.68.0-255,1484,93259,8,361719
21620,0.000992,74.125.68.0-255,2902,96161,8,361719
21621,0.000995,172.31.36.0-255,66,96227,8,361719
21622,0.00102,74.125.68.0-255,4320,100547,8,361719
21623,0.001022,172.31.36.0-255,66,100613,8,361719
21624,0.001027,74.125.68.0-255,2902,103515,8,361719
21625,0.00103,172.31.36.0-255,66,103581,8,361719
21626,0.001043,74.125.68.0-255,2902,106483,8,361719
21627,0.001046,172.31.36.0-255,66,106549,8,361719
21628,0.001075,74.125.68.0-255,4320,110869,8,361719
21629,0.001078,172.31.36.0-255,66,110935,8,361719
21630,0.001102,74.125.68.0-255,4320,115255,8,361719
21631,0.001105,172.31.36.0-255,66,115321,8,361719
21632,0.001117,172.31.36.0-255,66,115387,8,361719
21633,0.001119,74.125.68.0-255,766,116153,8,361719
21634,0.001316,74.125.68.0-255,1484,117637,8,361719
21635,0.001321,172.31.36.0-255,66,117703,8,361719
21636,0.001336,74.125.68.0-255,2902,120605,8,361719
21637,0.001338,172.31.36.0-255,66,120671,8,361719
21638,0.00137,74.125.68.0-255,4320,124991,8,361719
21639,0.001374,172.31.36.0-255,66,125057,8,361719
21640,0.001377,74.125.68.0-255,1484,126541,8,361719
21641,0.001395,74.125.68.0-255,4320,130861,8,361719
21642,0.001397,172.31.36.0-255,66,130927,8,361719
21643,0.001417,74.125.68.0-255,1484,132411,8,361719
21644,0.00144,172.31.36.0-255,66,132477,8,361719
21645,0.00149,172.31.36.0-255,66,132543,8,361719
21646,0.001519,74.125.68.0-255,1484,134027,8,361719
21647,0.001547,74.125.68.0-255,2902,136929,8,361719
21648,0.001551,172.31.36.0-255,66,136995,8,361719
21649,0.001554,74.125.68.0-255,1484,138479,8,361719
21650,0.001576,74.125.68.0-255,4320,142799,8,361719
21651,0.001579,172.31.36.0-255,66,142865,8,361719
21652,0.001583,74.125.68.0-255,2902,145767,8,361719
21653,0.001586,172.31.36.0-255,66,145833,8,361719
21654,0.001618,172.31.36.0-255,66,145899,8,361719
21655,0.001653,172.31.36.0-255,66,145965,8,361719
21656,0.001655,74.125.68.0-255,766,146731,8,361719
21657,0.001747,74.125.68.0-255,1484,148215,8,361719
21658,0.001751,172.31.36.0-255,66,148281,8,361719
21659,0.001771,74.125.68.0-255,1484,149765,8,361719
21660,0.001814,74.125.68.0-255,2902,152667,8,361719
21661,0.001818,172.31.36.0-255,66,152733,8,361719
21662,0.001825,74.125.68.0-255,5738,158471,8,361719
21663,0.001827,172.31.36.0-255,66,158537,8,361719
21664,0.001833,74.125.68.0-255,5738,164275,8,361719
21665,0.001835,172.31.36.0-255,66,164341,8,361719
21666,0.00184,74.125.68.0-255,2902,167243,8,361719
21667,0.001843,172.31.36.0-255,66,167309,8,361719
21668,0.001866,74.125.68.0-255,4320,171629,8,361719
21669,0.001869,172.31.36.0-255,66,171695,8,361719
21670,0.001885,74.125.68.0-255,4320,176015,8,361719
21671,0.001888,172.31.36.0-255,66,176081,8,361719
21672,0.00191,74.125.68.0-255,5020,181101,8,361719
21673,0.001913,172.31.36.0-255,66,181167,8,361719
21674,0.001931,74.125.68.0-255,1484,182651,8,361719
21675,0.001949,74.125.68.0-255,2902,185553,8,361719
21676,0.001952,172.31.36.0-255,66,185619,8,361719
21677,0.001958,74.125.68.0-255,4320,189939,8,361719
21678,0.00196,172.31.36.0-255,66,190005,8,361719
21679,0.001971,74.125.68.0-255,1484,191489,8,361719
21680,0.001981,74.125.68.0-255,4320,195809,8,361719
21681,0.001983,172.31.36.0-255,66,195875,8,361719
21682,0.00199,74.125.68.0-255,5738,201613,8,361719
21683,0.001992,172.31.36.0-255,66,201679,8,361719
21684,0.002015,74.125.68.0-255,1484,203163,8,361719
21685,0.002039,172.31.36.0-255,66,203229,8,361719
21686,0.002043,74.125.68.0-255,2184,205413,8,361719
21687,0.002045,172.31.36.0-255,66,205479,8,361719
21688,0.002168,74.125.68.0-255,1484,206963,8,361719
21689,0.002189,74.125.68.0-255,2902,209865,8,361719
21690,0.002192,172.31.36.0-255,66,209931,8,361719
21691,0.002196,74.125.68.0-255,1484,211415,8,361719
21692,0.0022,74.125.68.0-255,2902,214317,8,361719
21693,0.002202,172.31.36.0-255,66,214383,8,361719
21694,0.002205,74.125.68.0-255,1484,215867,8,361719
21695,0.002233,74.125.68.0-255,4320,220187,8,361719
21696,0.002236,172.31.36.0-255,66,220253,8,361719
21697,0.002243,74.125.68.0-255,5738,225991,8,361719
21698,0.002245,172.31.36.0-255,66,226057,8,361719
21699,0.002272,74.125.68.0-255,4320,230377,8,361719
21700,0.002275,172.31.36.0-255,66,230443,8,361719
21701,0.0023,74.125.68.0-255,7156,237599,8,361719
21702,0.002303,172.31.36.0-255,66,237665,8,361719
21703,0.002321,74.125.68.0-255,2184,239849,8,361719
21704,0.002324,172.31.36.0-255,66,239915,8,361719
21705,0.004595,74.125.68.0-255,5738,245653,8,361719
21706,0.004607,172.31.36.0-255,66,245719,8,361719
21707,0.00691,74.125.68.0-255,5738,251457,8,361719
21708,0.006918,172.31.36.0-255,66,251523,8,361719
21709,0.009214,74.125.68.0-255,5738,257261,8,361719
21710,0.009221,172.31.36.0-255,66,257327,8,361719
21711,0.011511,74.125.68.0-255,5738,263065,8,361719
21712,0.011518,172.31.36.0-255,66,263131,8,361719
21713,0.01383,74.125.68.0-255,5738,268869,8,361719
21714,0.013838,172.31.36.0-255,66,268935,8,361719
21715,0.016128,74.125.68.0-255,5738,274673,8,361719
21716,0.016136,172.31.36.0-255,66,274739,8,361719
21717,0.018464,74.125.68.0-255,5738,280477,8,361719
21718,0.018472,172.31.36.0-255,66,280543,8,361719
21719,0.020775,74.125.68.0-255,5738,286281,8,361719
21720,0.020785,172.31.36.0-255,66,286347,8,361719
21721,0.023077,74.125.68.0-255,5738,292085,8,361719
21722,0.023085,172.31.36.0-255,66,292151,8,361719
21723,0.025374,74.125.68.0-255,5738,297889,8,361719
21724,0.025381,172.31.36.0-255,66,297955,8,361719
21725,0.027674,74.125.68.0-255,5738,303693,8,361719
21726,0.027683,172.31.36.0-255,66,303759,8,361719
21727,0.029981,74.125.68.0-255,5738,309497,8,361719
21728,0.029989,172.31.36.0-255,66,309563,8,361719
21729,0.032277,74.125.68.0-255,5738,315301,8,361719
21730,0.032284,172.31.36.0-255,66,315367,8,361719
21731,0.03457,74.125.68.0-255,5738,321105,8,361719
21732,0.034579,172.31.36.0-255,66,321171,8,361719
21733,0.036869,74.125.68.0-255,5738,326909,8,361719
21734,0.036879,172.31.36.0-255,66,326975,8,361719
21735,0.039174,74.125.68.0-255,5738,332713,8,361719
21736,0.039188,172.31.36.0-255,66,332779,8,361719
21737,0.040493,172.31.36.0-255,314,333093,8,361719
21738,0.040529,172.31.36.0-255,1111,334204,8,361719
21739,0.040594,172.31.36.0-255,1514,335718,8,361719
21740,0.040596,172.31.36.0-255,1514,337232,8,361719
21741,0.040601,172.31.36.0-255,1514,338746,8,361719
21742,0.040602,172.31.36.0-255,1514,340260,8,361719
21743,0.04062,172.31.36.0-255,1275,341535,8,361719
21744,0.041463,74.125.68.0-255,4320,345855,8,361719
21745,0.04147,172.31.36.0-255,66,345921,8,361719
21746,0.041491,74.125.68.0-255,1484,347405,8,361719
21747,0.042056,104.244.42.0-255,66,347471,8,361719
21748,0.042258,104.244.42.0-255,66,347537,8,361719
21749,0.042265,104.244.42.0-255,66,347603,8,361719
21750,0.042269,104.244.42.0-255,66,347669,8,361719
21751,0.043775,74.125.68.0-255,4320,351989,8,361719
21752,0.043783,172.31.36.0-255,66,352055,8,361719
21753,0.046076,74.125.68.0-255,5738,357793,8,361719
21754,0.046081,172.31.36.0-255,66,357859,8,361719
21755,0.04837,74.125.68.0-255,3623,361482,8,361719
21756,0.048378,172.31.36.0-255,66,361548,8,361719
21757,0.048534,172.31.36.0-255,105,361653,8,361719
21758,0.050784,74.125.68.0-255,66,361719,8,361719
21759,0.0,74.125.24.0-255,153,153,8,219977
21760,2.4e-05,172.31.36.0-255,66,219,8,219977
21761,3.1e-05,74.125.24.0-255,1484,1703,8,219977
21762,3.5e-05,172.31.36.0-255,66,1769,8,219977
21763,4.1e-05,74.125.24.0-255,2902,4671,8,219977
21764,4.3e-05,172.31.36.0-255,66,4737,8,219977
21765,5.1e-05,74.125.24.0-255,7156,11893,8,219977
21766,5.3e-05,172.31.36.0-255,66,11959,8,219977
21767,9e-05,172.31.36.0-255,66,12025,8,219977
21768,0.000131,74.125.24.0-255,6797,18822,8,219977
21769,0.000134,172.31.36.0-255,66,18888,8,219977
21770,0.000171,74.125.24.0-255,1484,20372,8,219977
21771,0.000174,172.31.36.0-255,66,20438,8,219977
21772,0.000179,74.125.24.0-255,2902,23340,8,219977
21773,0.000181,172.31.36.0-255,66,23406,8,219977
21774,0.000208,74.125.24.0-255,5738,29144,8,219977
21775,0.000211,172.31.36.0-255,66,29210,8,219977
21776,0.000244,172.31.36.0-255,66,29276,8,219977
21777,0.000248,74.125.24.0-255,2902,32178,8,219977
21778,0.000251,172.31.36.0-255,66,32244,8,219977
21779,0.000313,172.31.36.0-255,66,32310,8,219977
21780,0.000351,74.125.24.0-255,331,32641,8,219977
21781,0.000354,172.31.36.0-255,66,32707,8,219977
21782,0.000551,74.125.24.0-255,1484,34191,8,219977
21783,0.000556,172.31.36.0-255,66,34257,8,219977
21784,0.000562,74.125.24.0-255,2902,37159,8,219977
21785,0.000565,172.31.36.0-255,66,37225,8,219977
21786,0.000573,74.125.24.0-255,5738,42963,8,219977
21787,0.000576,172.31.36.0-255,66,43029,8,219977
21788,0.000603,74.125.24.0-255,2902,45931,8,219977
21789,0.000606,172.31.36.0-255,66,45997,8,219977
21790,0.000633,74.125.24.0-255,2902,48899,8,219977
21791,0.000636,172.31.36.0-255,66,48965,8,219977
21792,0.00065,172.31.36.0-255,66,49031,8,219977
21793,0.000657,74.125.24.0-255,5020,54051,8,219977
21794,0.000659,172.31.36.0-255,66,54117,8,219977
21795,0.000854,74.125.24.0-255,1484,55601,8,219977
21796,0.000861,74.125.24.0-255,2902,58503,8,219977
21797,0.000865,172.31.36.0-255,66,58569,8,219977
21798,0.00087,74.125.24.0-255,2902,61471,8,219977
21799,0.000872,172.31.36.0-255,66,61537,8,219977
21800,0.00089,74.125.24.0-255,2902,64439,8,219977
21801,0.000893,172.31.36.0-255,66,64505,8,219977
21802,0.000899,74.125.24.0-255,5738,70243,8,219977
21803,0.000901,172.31.36.0-255,66,70309,8,219977
21804,0.000905,74.125.24.0-255,1484,71793,8,219977
21805,0.000945,172.31.36.0-255,66,71859,8,219977
21806,0.000952,74.125.24.0-255,5020,76879,8,219977
21807,0.000955,172.31.36.0-255,66,76945,8,219977
21808,0.00098,74.125.24.0-255,5738,82683,8,219977
21809,0.000983,172.31.36.0-255,66,82749,8,219977
21810,0.00099,74.125.24.0-255,5738,88487,8,219977
21811,0.000992,172.31.36.0-255,66,88553,8,219977
21812,0.001009,74.125.24.0-255,1484,90037,8,219977
21813,0.001043,172.31.36.0-255,66,90103,8,219977
21814,0.001051,74.125.24.0-255,6438,96541,8,219977
21815,0.001053,172.31.36.0-255,66,96607,8,219977
21816,0.001105,74.125.24.0-255,1484,98091,8,219977
21817,0.001127,74.125.24.0-255,2902,100993,8,219977
21818,0.00113,172.31.36.0-255,66,101059,8,219977
21819,0.001138,74.125.24.0-255,5738,106797,8,219977
21820,0.001141,172.31.36.0-255,66,106863,8,219977
21821,0.001147,74.125.24.0-255,5738,112601,8,219977
21822,0.001149,172.31.36.0-255,66,112667,8,219977
21823,0.001185,74.125.24.0-255,7156,119823,8,219977
21824,0.001188,172.31.36.0-255,66,119889,8,219977
21825,0.001213,74.125.24.0-255,5738,125627,8,219977
21826,0.001219,74.125.24.0-255,5020,130647,8,219977
21827,0.001227,172.31.36.0-255,66,130713,8,219977
21828,0.001246,74.125.24.0-255,1484,132197,8,219977
21829,0.001289,172.31.36.0-255,66,132263,8,219977
21830,0.001326,172.31.36.0-255,66,132329,8,219977
21831,0.00136,74.125.24.0-255,4320,136649,8,219977
21832,0.00139,172.31.36.0-255,66,136715,8,219977
21833,0.001482,74.125.24.0-255,3602,140317,8,219977
21834,0.001484,74.125.24.0-255,1484,141801,8,219977
21835,0.001488,74.125.24.0-255,2902,144703,8,219977
21836,0.001493,74.125.24.0-255,5738,150441,8,219977
21837,0.001498,74.125.24.0-255,4320,154761,8,219977
21838,0.001502,172.31.36.0-255,66,154827,8,219977
21839,0.00151,172.31.36.0-255,66,154893,8,219977
21840,0.001536,74.125.24.0-255,7156,162049,8,219977
21841,0.00156,172.31.36.0-255,66,162115,8,219977
21842,0.001566,74.125.24.0-255,3602,165717,8,219977
21843,0.001576,172.31.36.0-255,66,165783,8,219977
21844,0.001602,74.125.24.0-255,1484,167267,8,219977
21845,0.001616,74.125.24.0-255,2902,170169,8,219977
21846,0.001631,172.31.36.0-255,66,170235,8,219977
21847,0.001642,74.125.24.0-255,5738,175973,8,219977
21848,0.001657,74.125.24.0-255,5738,181711,8,219977
21849,0.001659,172.31.36.0-255,66,181777,8,219977
21850,0.001683,74.125.24.0-255,7156,188933,8,219977
21851,0.001689,74.125.24.0-255,2902,191835,8,219977
21852,0.001696,172.31.36.0-255,66,191901,8,219977
21853,0.001741,74.125.24.0-255,1484,193385,8,219977
21854,0.001761,74.125.24.0-255,7156,200541,8,219977
21855,0.001764,74.125.24.0-255,1484,202025,8,219977
21856,0.001786,172.31.36.0-255,66,202091,8,219977
21857,0.001798,172.31.36.0-255,66,202157,8,219977
21858,0.001839,74.125.24.0-255,3602,205759,8,219977
21859,0.001846,172.31.36.0-255,66,205825,8,219977
21860,0.001896,172.31.36.0-255,66,205891,8,219977
21861,0.001953,172.31.36.0-255,66,205957,8,219977
21862,0.001958,74.125.24.0-255,3512,209469,8,219977
21863,0.001961,74.125.24.0-255,105,209574,8,219977
21864,0.001966,172.31.36.0-255,66,209640,8,219977
21865,0.010478,172.31.36.0-255,105,209745,8,219977
21866,0.012734,74.125.24.0-255,66,209811,8,219977
21867,0.028496,172.31.36.0-255,172,209983,8,219977
21868,0.028535,172.31.36.0-255,1111,211094,8,219977
21869,0.028605,172.31.36.0-255,1514,212608,8,219977
21870,0.028607,172.31.36.0-255,1514,214122,8,219977
21871,0.028612,172.31.36.0-255,1514,215636,8,219977
21872,0.028613,172.31.36.0-255,1514,217150,8,219977
21873,0.028633,172.31.36.0-255,1514,218664,8,219977
21874,0.028634,172.31.36.0-255,875,219539,8,219977
21875,0.03002,104.244.42.0-255,66,219605,8,219977
21876,0.030078,104.244.42.0-255,66,219671,8,219977
21877,0.030169,104.244.42.0-255,66,219737,8,219977
21878,0.030176,104.244.42.0-255,66,219803,8,219977
21879,0.045174,172.31.36.0-255,108,219911,8,219977
21880,0.046722,104.244.42.0-255,66,219977,8,219977
21881,0.0,104.244.42.0-255,66,66,8,66
21882,0.0,172.217.194.0-255,153,153,8,252542
21883,2e-05,172.31.36.0-255,66,219,8,252542
21884,2.7e-05,172.217.194.0-255,1484,1703,8,252542
21885,3.1e-05,172.31.36.0-255,66,1769,8,252542
21886,3.7e-05,172.217.194.0-255,2902,4671,8,252542
21887,4e-05,172.31.36.0-255,66,4737,8,252542
21888,4.7e-05,172.217.194.0-255,7156,11893,8,252542
21889,5e-05,172.31.36.0-255,66,11959,8,252542
21890,6.7e-05,172.31.36.0-255,66,12025,8,252542
21891,8.5e-05,172.217.194.0-255,730,12755,8,252542
21892,8.8e-05,172.31.36.0-255,66,12821,8,252542
21893,9.3e-05,172.217.194.0-255,2543,15364,8,252542
21894,9.5e-05,172.31.36.0-255,66,15430,8,252542
21895,0.000121,172.217.194.0-255,1484,16914,8,252542
21896,0.000123,172.31.36.0-255,66,16980,8,252542
21897,0.000128,172.217.194.0-255,2902,19882,8,252542
21898,0.000131,172.31.36.0-255,66,19948,8,252542
21899,0.000138,172.217.194.0-255,5738,25686,8,252542
21900,0.00014,172.31.36.0-255,66,25752,8,252542
21901,0.000174,172.31.36.0-255,66,25818,8,252542
21902,0.000188,172.31.36.0-255,66,25884,8,252542
21903,0.000207,172.217.194.0-255,1376,27260,8,252542
21904,0.000209,172.31.36.0-255,66,27326,8,252542
21905,0.000232,172.217.194.0-255,119,27445,8,252542
21906,0.000235,172.31.36.0-255,66,27511,8,252542
21907,0.000259,172.217.194.0-255,383,27894,8,252542
21908,0.000261,172.31.36.0-255,66,27960,8,252542
21909,0.000726,172.217.194.0-255,1484,29444,8,252542
21910,0.000732,172.31.36.0-255,66,29510,8,252542
21911,0.000738,172.217.194.0-255,2902,32412,8,252542
21912,0.00074,172.31.36.0-255,66,32478,8,252542
21913,0.000747,172.217.194.0-255,5738,38216,8,252542
21914,0.000749,172.31.36.0-255,66,38282,8,252542
21915,0.000782,172.31.36.0-255,66,38348,8,252542
21916,0.00079,172.217.194.0-255,5738,44086,8,252542
21917,0.000792,172.31.36.0-255,66,44152,8,252542
21918,0.000814,172.217.194.0-255,2902,47054,8,252542
21919,0.000819,172.31.36.0-255,66,47120,8,252542
21920,0.000836,172.217.194.0-255,2184,49304,8,252542
21921,0.000838,172.31.36.0-255,66,49370,8,252542
21922,0.001555,172.217.194.0-255,1484,50854,8,252542
21923,0.001564,172.217.194.0-255,2902,53756,8,252542
21924,0.001568,172.31.36.0-255,66,53822,8,252542
21925,0.001575,172.217.194.0-255,5738,59560,8,252542
21926,0.001576,172.31.36.0-255,66,59626,8,252542
21927,0.00158,172.217.194.0-255,1484,61110,8,252542
21928,0.001616,172.31.36.0-255,66,61176,8,252542
21929,0.001664,172.31.36.0-255,66,61242,8,252542
21930,0.001814,172.217.194.0-255,1484,62726,8,252542
21931,0.001823,172.217.194.0-255,2902,65628,8,252542
21932,0.001827,172.31.36.0-255,66,65694,8,252542
21933,0.001834,172.217.194.0-255,5738,71432,8,252542
21934,0.001836,172.31.36.0-255,66,71498,8,252542
21935,0.001874,172.31.36.0-255,66,71564,8,252542
21936,0.00189,172.217.194.0-255,5738,77302,8,252542
21937,0.001892,172.31.36.0-255,66,77368,8,252542
21938,0.001913,172.31.36.0-255,66,77434,8,252542
21939,0.004207,172.217.194.0-255,5738,83172,8,252542
21940,0.004212,172.31.36.0-255,66,83238,8,252542
21941,0.006472,172.217.194.0-255,5738,88976,8,252542
21942,0.006477,172.31.36.0-255,66,89042,8,252542
21943,0.008785,172.217.194.0-255,5738,94780,8,252542
21944,0.008793,172.31.36.0-255,66,94846,8,252542
21945,0.011103,172.217.194.0-255,5738,100584,8,252542
21946,0.011111,172.31.36.0-255,66,100650,8,252542
21947,0.013389,172.217.194.0-255,5738,106388,8,252542
21948,0.013397,172.31.36.0-255,66,106454,8,252542
21949,0.015702,172.217.194.0-255,5738,112192,8,252542
21950,0.015711,172.31.36.0-255,66,112258,8,252542
21951,0.018,172.217.194.0-255,5738,117996,8,252542
21952,0.018006,172.31.36.0-255,66,118062,8,252542
21953,0.020299,172.217.194.0-255,5738,123800,8,252542
21954,0.020307,172.31.36.0-255,66,123866,8,252542
21955,0.022589,172.217.194.0-255,5738,129604,8,252542
21956,0.022596,172.31.36.0-255,66,129670,8,252542
21957,0.024885,172.217.194.0-255,5738,135408,8,252542
21958,0.024895,172.31.36.0-255,66,135474,8,252542
21959,0.027177,172.217.194.0-255,5738,141212,8,252542
21960,0.027184,172.31.36.0-255,66,141278,8,252542
21961,0.029466,172.217.194.0-255,5738,147016,8,252542
21962,0.029473,172.31.36.0-255,66,147082,8,252542
21963,0.031767,172.217.194.0-255,5738,152820,8,252542
21964,0.031774,172.31.36.0-255,66,152886,8,252542
21965,0.031872,172.31.36.0-255,172,153058,8,252542
21966,0.031911,172.31.36.0-255,1111,154169,8,252542
21967,0.03203,172.31.36.0-255,1514,155683,8,252542
21968,0.032032,172.31.36.0-255,1514,157197,8,252542
21969,0.032034,172.31.36.0-255,1514,158711,8,252542
21970,0.03206,172.31.36.0-255,901,159612,8,252542
21971,0.033585,104.244.42.0-255,66,159678,8,252542
21972,0.034078,172.217.194.0-255,5738,165416,8,252542
21973,0.034083,172.31.36.0-255,66,165482,8,252542
21974,0.036389,172.217.194.0-255,5738,171220,8,252542
21975,0.036396,172.31.36.0-255,66,171286,8,252542
21976,0.03869,172.217.194.0-255,5738,177024,8,252542
21977,0.038697,172.31.36.0-255,66,177090,8,252542
21978,0.040988,172.217.194.0-255,5738,182828,8,252542
21979,0.040995,172.31.36.0-255,66,182894,8,252542
21980,0.043284,172.217.194.0-255,5738,188632,8,252542
21981,0.043292,172.31.36.0-255,66,188698,8,252542
21982,0.045587,172.217.194.0-255,5738,194436,8,252542
21983,0.045594,172.31.36.0-255,66,194502,8,252542
21984,0.047904,172.217.194.0-255,5738,200240,8,252542
21985,0.047911,172.31.36.0-255,66,200306,8,252542
21986,0.050212,172.217.194.0-255,5738,206044,8,252542
21987,0.050218,172.31.36.0-255,66,206110,8,252542
21988,0.052524,172.217.194.0-255,5738,211848,8,252542
21989,0.052532,172.31.36.0-255,66,211914,8,252542
21990,0.054876,172.217.194.0-255,5738,217652,8,252542
21991,0.054882,172.31.36.0-255,66,217718,8,252542
21992,0.057187,172.217.194.0-255,5738,223456,8,252542
21993,0.057193,172.31.36.0-255,66,223522,8,252542
21994,0.05951,172.217.194.0-255,5738,229260,8,252542
21995,0.059517,172.31.36.0-255,66,229326,8,252542
21996,0.061801,172.217.194.0-255,5738,235064,8,252542
21997,0.061807,172.31.36.0-255,66,235130,8,252542
21998,0.06412,172.217.194.0-255,5738,240868,8,252542
21999,0.064127,172.31.36.0-255,66,240934,8,252542
22000,0.06644,172.217.194.0-255,5738,246672,8,252542
22001,0.066447,172.31.36.0-255,66,246738,8,252542
22002,0.06874,172.217.194.0-255,5738,252476,8,252542
22003,0.068747,172.31.36.0-255,66,252542,8,252542
22004,0.0,74.125.68.0-255,153,153,8,237927
22005,2.4e-05,172.31.36.0-255,66,219,8,237927
22006,3.2e-05,74.125.68.0-255,1484,1703,8,237927
22007,3.7e-05,172.31.36.0-255,66,1769,8,237927
22008,4.3e-05,74.125.68.0-255,2902,4671,8,237927
22009,4.6e-05,172.31.36.0-255,66,4737,8,237927
22010,4.9e-05,74.125.68.0-255,1484,6221,8,237927
22011,5.2e-05,172.31.36.0-255,66,6287,8,237927
22012,5.7e-05,74.125.68.0-255,2902,9189,8,237927
22013,6e-05,172.31.36.0-255,66,9255,8,237927
22014,9.3e-05,74.125.68.0-255,6339,15594,8,237927
22015,9.6e-05,172.31.36.0-255,66,15660,8,237927
22016,0.000105,74.125.68.0-255,7156,22816,8,237927
22017,0.000107,172.31.36.0-255,66,22882,8,237927
22018,0.000135,74.125.68.0-255,5738,28620,8,237927
22019,0.000138,172.31.36.0-255,66,28686,8,237927
22020,0.000154,74.125.68.0-255,2543,31229,8,237927
22021,0.000157,172.31.36.0-255,66,31295,8,237927
22022,0.000318,74.125.68.0-255,1484,32779,8,237927
22023,0.000323,172.31.36.0-255,66,32845,8,237927
22024,0.000329,74.125.68.0-255,1484,34329,8,237927
22025,0.000332,172.31.36.0-255,66,34395,8,237927
22026,0.000335,74.125.68.0-255,1484,35879,8,237927
22027,0.000337,172.31.36.0-255,66,35945,8,237927
22028,0.00035,74.125.68.0-255,1484,37429,8,237927
22029,0.000353,172.31.36.0-255,66,37495,8,237927
22030,0.000358,74.125.68.0-255,2902,40397,8,237927
22031,0.00036,172.31.36.0-255,66,40463,8,237927
22032,0.000381,74.125.68.0-255,2902,43365,8,237927
22033,0.000383,172.31.36.0-255,66,43431,8,237927
22034,0.000396,74.125.68.0-255,2902,46333,8,237927
22035,0.000399,172.31.36.0-255,66,46399,8,237927
22036,0.000423,74.125.68.0-255,3961,50360,8,237927
22037,0.000426,172.31.36.0-255,66,50426,8,237927
22038,0.000433,74.125.68.0-255,7156,57582,8,237927
22039,0.000435,172.31.36.0-255,66,57648,8,237927
22040,0.000442,74.125.68.0-255,5738,63386,8,237927
22041,0.000445,172.31.36.0-255,66,63452,8,237927
22042,0.000459,74.125.68.0-255,1484,64936,8,237927
22043,0.000476,74.125.68.0-255,1399,66335,8,237927
22044,0.000478,172.31.36.0-255,66,66401,8,237927
22045,0.002085,74.125.68.0-255,132,66533,8,237927
22046,0.00212,172.31.36.0-255,66,66599,8,237927
22047,0.00279,74.125.68.0-255,4320,70919,8,237927
22048,0.002795,172.31.36.0-255,66,70985,8,237927
22049,0.004441,74.125.68.0-255,1484,72469,8,237927
22050,0.005132,74.125.68.0-255,4320,76789,8,237927
22051,0.005137,172.31.36.0-255,66,76855,8,237927
22052,0.007469,74.125.68.0-255,5738,82593,8,237927
22053,0.007477,172.31.36.0-255,66,82659,8,237927
22054,0.009805,74.125.68.0-255,5738,88397,8,237927
22055,0.009813,172.31.36.0-255,66,88463,8,237927
22056,0.012139,74.125.68.0-255,5738,94201,8,237927
22057,0.012148,172.31.36.0-255,66,94267,8,237927
22058,0.014471,74.125.68.0-255,5738,100005,8,237927
22059,0.014479,172.31.36.0-255,66,100071,8,237927
22060,0.016816,74.125.68.0-255,5738,105809,8,237927
22061,0.01683,172.31.36.0-255,66,105875,8,237927
22062,0.01916,74.125.68.0-255,5738,111613,8,237927
22063,0.01917,172.31.36.0-255,66,111679,8,237927
22064,0.021491,74.125.68.0-255,5738,117417,8,237927
22065,0.0215,172.31.36.0-255,66,117483,8,237927
22066,0.023832,74.125.68.0-255,5738,123221,8,237927
22067,0.023841,172.31.36.0-255,66,123287,8,237927
22068,0.026174,74.125.68.0-255,5738,129025,8,237927
22069,0.026182,172.31.36.0-255,66,129091,8,237927
22070,0.028519,74.125.68.0-255,5738,134829,8,237927
22071,0.028528,172.31.36.0-255,66,134895,8,237927
22072,0.03087,74.125.68.0-255,5738,140633,8,237927
22073,0.030879,172.31.36.0-255,66,140699,8,237927
22074,0.033205,74.125.68.0-255,5738,146437,8,237927
22075,0.033214,172.31.36.0-255,66,146503,8,237927
22076,0.035556,74.125.68.0-255,5738,152241,8,237927
22077,0.035564,172.31.36.0-255,66,152307,8,237927
22078,0.037567,172.31.36.0-255,172,152479,8,237927
22079,0.037602,172.31.36.0-255,1109,153588,8,237927
22080,0.037667,172.31.36.0-255,1514,155102,8,237927
22081,0.037669,172.31.36.0-255,1371,156473,8,237927
22082,0.037895,74.125.68.0-255,5738,162211,8,237927
22083,0.037901,172.31.36.0-255,66,162277,8,237927
22084,0.039116,104.244.42.0-255,66,162343,8,237927
22085,0.039191,104.244.42.0-255,66,162409,8,237927
22086,0.039195,104.244.42.0-255,66,162475,8,237927
22087,0.040241,74.125.68.0-255,5738,168213,8,237927
22088,0.040249,172.31.36.0-255,66,168279,8,237927
22089,0.042599,74.125.68.0-255,5738,174017,8,237927
22090,0.042606,172.31.36.0-255,66,174083,8,237927
22091,0.044933,74.125.68.0-255,5738,179821,8,237927
22092,0.044943,172.31.36.0-255,66,179887,8,237927
22093,0.047299,74.125.68.0-255,5738,185625,8,237927
22094,0.047305,172.31.36.0-255,66,185691,8,237927
22095,0.049655,74.125.68.0-255,5738,191429,8,237927
22096,0.049661,172.31.36.0-255,66,191495,8,237927
22097,0.052003,74.125.68.0-255,5738,197233,8,237927
22098,0.05201,172.31.36.0-255,66,197299,8,237927
22099,0.054346,74.125.68.0-255,5738,203037,8,237927
22100,0.054353,172.31.36.0-255,66,203103,8,237927
22101,0.056697,74.125.68.0-255,5738,208841,8,237927
22102,0.056704,172.31.36.0-255,66,208907,8,237927
22103,0.059042,74.125.68.0-255,5738,214645,8,237927
22104,0.059049,172.31.36.0-255,66,214711,8,237927
22105,0.061388,74.125.68.0-255,5738,220449,8,237927
22106,0.061395,172.31.36.0-255,66,220515,8,237927
22107,0.063756,74.125.68.0-255,5738,226253,8,237927
22108,0.063763,172.31.36.0-255,66,226319,8,237927
22109,0.066098,74.125.68.0-255,5738,232057,8,237927
22110,0.066105,172.31.36.0-255,66,232123,8,237927
22111,0.068441,74.125.68.0-255,5738,237861,8,237927
22112,0.068448,172.31.36.0-255,66,237927,8,237927
22113,0.0,74.125.68.0-255,146,146,8,354669
22114,3.6e-05,172.31.36.0-255,66,212,8,354669
22115,4.3e-05,74.125.68.0-255,1484,1696,8,354669
22116,4.8e-05,172.31.36.0-255,66,1762,8,354669
22117,6.3e-05,74.125.68.0-255,2902,4664,8,354669
22118,6.7e-05,172.31.36.0-255,66,4730,8,354669
22119,7.4e-05,74.125.68.0-255,4320,9050,8,354669
22120,7.6e-05,172.31.36.0-255,66,9116,8,354669
22121,0.000105,74.125.68.0-255,4320,13436,8,354669
22122,0.000108,172.31.36.0-255,66,13502,8,354669
22123,0.000133,74.125.68.0-255,618,14120,8,354669
22124,0.000137,172.31.36.0-255,66,14186,8,354669
22125,0.000143,74.125.68.0-255,5738,19924,8,354669
22126,0.000145,172.31.36.0-255,66,19990,8,354669
22127,0.000151,74.125.68.0-255,5738,25728,8,354669
22128,0.000154,172.31.36.0-255,66,25794,8,354669
22129,0.000225,74.125.68.0-255,5379,31173,8,354669
22130,0.000229,172.31.36.0-255,66,31239,8,354669
22131,0.000519,74.125.68.0-255,1484,32723,8,354669
22132,0.000525,172.31.36.0-255,66,32789,8,354669
22133,0.000531,74.125.68.0-255,2902,35691,8,354669
22134,0.000535,172.31.36.0-255,66,35757,8,354669
22135,0.000551,74.125.68.0-255,1484,37241,8,354669
22136,0.000554,172.31.36.0-255,66,37307,8,354669
22137,0.000565,74.125.68.0-255,2902,40209,8,354669
22138,0.000568,172.31.36.0-255,66,40275,8,354669
22139,0.000605,74.125.68.0-255,5738,46013,8,354669
22140,0.000609,74.125.68.0-255,2543,48556,8,354669
22141,0.000611,172.31.36.0-255,66,48622,8,354669
22142,0.000613,74.125.68.0-255,2902,51524,8,354669
22143,0.000614,172.31.36.0-255,66,51590,8,354669
22144,0.000617,172.31.36.0-255,66,51656,8,354669
22145,0.000649,74.125.68.0-255,7156,58812,8,354669
22146,0.000652,172.31.36.0-255,66,58878,8,354669
22147,0.000656,74.125.68.0-255,2902,61780,8,354669
22148,0.000659,172.31.36.0-255,66,61846,8,354669
22149,0.000683,74.125.68.0-255,1484,63330,8,354669
22150,0.000705,74.125.68.0-255,2870,66200,8,354669
22151,0.000713,172.31.36.0-255,66,66266,8,354669
22152,0.000825,74.125.68.0-255,1484,67750,8,354669
22153,0.00083,74.125.68.0-255,2902,70652,8,354669
22154,0.000834,172.31.36.0-255,66,70718,8,354669
22155,0.000864,74.125.68.0-255,4320,75038,8,354669
22156,0.00087,74.125.68.0-255,5738,80776,8,354669
22157,0.00088,172.31.36.0-255,66,80842,8,354669
22158,0.000892,74.125.68.0-255,4320,85162,8,354669
22159,0.000901,172.31.36.0-255,66,85228,8,354669
22160,0.000916,74.125.68.0-255,7156,92384,8,354669
22161,0.000921,74.125.68.0-255,4320,96704,8,354669
22162,0.000939,172.31.36.0-255,66,96770,8,354669
22163,0.000966,74.125.68.0-255,3602,100372,8,354669
22164,0.00097,172.31.36.0-255,66,100438,8,354669
22165,0.001008,74.125.68.0-255,1748,102186,8,354669
22166,0.001013,172.31.36.0-255,66,102252,8,354669
22167,0.001026,74.125.68.0-255,2902,105154,8,354669
22168,0.00104,172.31.36.0-255,66,105220,8,354669
22169,0.001048,74.125.68.0-255,4320,109540,8,354669
22170,0.001059,172.31.36.0-255,66,109606,8,354669
22171,0.001067,74.125.68.0-255,2902,112508,8,354669
22172,0.001073,172.31.36.0-255,66,112574,8,354669
22173,0.001076,74.125.68.0-255,2902,115476,8,354669
22174,0.001091,172.31.36.0-255,66,115542,8,354669
22175,0.001116,172.31.36.0-255,66,115608,8,354669
22176,0.001142,74.125.68.0-255,2902,118510,8,354669
22177,0.001149,74.125.68.0-255,5738,124248,8,354669
22178,0.001151,172.31.36.0-255,66,124314,8,354669
22179,0.001157,172.31.36.0-255,66,124380,8,354669
22180,0.001161,74.125.68.0-255,2184,126564,8,354669
22181,0.001172,172.31.36.0-255,66,126630,8,354669
22182,0.001481,74.125.68.0-255,1484,128114,8,354669
22183,0.001487,74.125.68.0-255,2902,131016,8,354669
22184,0.001491,172.31.36.0-255,66,131082,8,354669
22185,0.001518,74.125.68.0-255,5738,136820,8,354669
22186,0.001523,74.125.68.0-255,2902,139722,8,354669
22187,0.001528,74.125.68.0-255,4320,144042,8,354669
22188,0.001528,172.31.36.0-255,66,144108,8,354669
22189,0.001532,172.31.36.0-255,66,144174,8,354669
22190,0.001574,172.31.36.0-255,66,144240,8,354669
22191,0.001581,74.125.68.0-255,5738,149978,8,354669
22192,0.00159,172.31.36.0-255,66,150044,8,354669
22193,0.001626,74.125.68.0-255,2184,152228,8,354669
22194,0.001636,172.31.36.0-255,66,152294,8,354669
22195,0.001789,74.125.68.0-255,1484,153778,8,354669
22196,0.001807,74.125.68.0-255,2902,156680,8,354669
22197,0.001815,172.31.36.0-255,66,156746,8,354669
22198,0.001848,74.125.68.0-255,5738,162484,8,354669
22199,0.001853,74.125.68.0-255,2902,165386,8,354669
22200,0.001857,74.125.68.0-255,2902,168288,8,354669
22201,0.001864,172.31.36.0-255,66,168354,8,354669
22202,0.001872,74.125.68.0-255,7156,175510,8,354669
22203,0.001875,74.125.68.0-255,1484,176994,8,354669
22204,0.001879,172.31.36.0-255,66,177060,8,354669
22205,0.001922,172.31.36.0-255,66,177126,8,354669
22206,0.001997,74.125.68.0-255,1484,178610,8,354669
22207,0.002011,74.125.68.0-255,2902,181512,8,354669
22208,0.002015,172.31.36.0-255,66,181578,8,354669
22209,0.002048,74.125.68.0-255,5738,187316,8,354669
22210,0.002052,172.31.36.0-255,66,187382,8,354669
22211,0.002056,74.125.68.0-255,2902,190284,8,354669
22212,0.002059,172.31.36.0-255,66,190350,8,354669
22213,0.002062,74.125.68.0-255,4320,194670,8,354669
22214,0.002073,172.31.36.0-255,66,194736,8,354669
22215,0.002079,74.125.68.0-255,2902,197638,8,354669
22216,0.002085,172.31.36.0-255,66,197704,8,354669
22217,0.002102,74.125.68.0-255,2902,200606,8,354669
22218,0.002112,172.31.36.0-255,66,200672,8,354669
22219,0.002139,74.125.68.0-255,2184,202856,8,354669
22220,0.002148,172.31.36.0-255,66,202922,8,354669
22221,0.002156,74.125.68.0-255,2902,205824,8,354669
22222,0.002163,172.31.36.0-255,66,205890,8,354669
22223,0.002204,74.125.68.0-255,7156,213046,8,354669
22224,0.002208,172.31.36.0-255,66,213112,8,354669
22225,0.002238,74.125.68.0-255,2902,216014,8,354669
22226,0.00229,74.125.68.0-255,4320,220334,8,354669
22227,0.002317,74.125.68.0-255,1484,221818,8,354669
22228,0.002321,74.125.68.0-255,2902,224720,8,354669
22229,0.012086,74.125.68.0-255,1484,226204,8,354669
22230,0.013276,172.31.36.0-255,66,226270,8,354669
22231,0.015567,74.125.68.0-255,5738,232008,8,354669
22232,0.015574,172.31.36.0-255,66,232074,8,354669
22233,0.017845,74.125.68.0-255,5738,237812,8,354669
22234,0.017851,172.31.36.0-255,66,237878,8,354669
22235,0.020136,74.125.68.0-255,5738,243616,8,354669
22236,0.021317,172.31.36.0-255,66,243682,8,354669
22237,0.023596,74.125.68.0-255,5738,249420,8,354669
22238,0.023605,172.31.36.0-255,66,249486,8,354669
22239,0.025882,74.125.68.0-255,5738,255224,8,354669
22240,0.025889,172.31.36.0-255,66,255290,8,354669
22241,0.028167,74.125.68.0-255,5738,261028,8,354669
22242,0.028175,172.31.36.0-255,66,261094,8,354669
22243,0.030455,74.125.68.0-255,5738,266832,8,354669
22244,0.030462,172.31.36.0-255,66,266898,8,354669
22245,0.032733,74.125.68.0-255,5738,272636,8,354669
22246,0.032739,172.31.36.0-255,66,272702,8,354669
22247,0.035027,74.125.68.0-255,5738,278440,8,354669
22248,0.035035,172.31.36.0-255,66,278506,8,354669
22249,0.037313,74.125.68.0-255,5738,284244,8,354669
22250,0.03732,172.31.36.0-255,66,284310,8,354669
22251,0.0396,74.125.68.0-255,5738,290048,8,354669
22252,0.039608,172.31.36.0-255,66,290114,8,354669
22253,0.0419,74.125.68.0-255,5738,295852,8,354669
22254,0.041908,172.31.36.0-255,66,295918,8,354669
22255,0.044177,74.125.68.0-255,5738,301656,8,354669
22256,0.044183,172.31.36.0-255,66,301722,8,354669
22257,0.046467,74.125.68.0-255,5738,307460,8,354669
22258,0.046474,172.31.36.0-255,66,307526,8,354669
22259,0.048219,172.31.36.0-255,172,307698,8,354669
22260,0.048247,172.31.36.0-255,1111,308809,8,354669
22261,0.048285,172.31.36.0-255,1514,310323,8,354669
22262,0.048286,172.31.36.0-255,1028,311351,8,354669
22263,0.048749,74.125.68.0-255,5738,317089,8,354669
22264,0.048755,172.31.36.0-255,66,317155,8,354669
22265,0.049772,104.244.42.0-255,66,317221,8,354669
22266,0.049815,104.244.42.0-255,66,317287,8,354669
22267,0.049853,104.244.42.0-255,66,317353,8,354669
22268,0.051025,74.125.68.0-255,5738,323091,8,354669
22269,0.051031,172.31.36.0-255,66,323157,8,354669
22270,0.0533,74.125.68.0-255,1484,324641,8,354669
22271,0.053306,172.31.36.0-255,66,324707,8,354669
22272,0.05338,74.125.68.0-255,4320,329027,8,354669
22273,0.053414,172.31.36.0-255,66,329093,8,354669
22274,0.055573,74.125.68.0-255,1484,330577,8,354669
22275,0.055678,74.125.68.0-255,4320,334897,8,354669
22276,0.055685,172.31.36.0-255,66,334963,8,354669
22277,0.057958,74.125.68.0-255,5738,340701,8,354669
22278,0.058013,172.31.36.0-255,66,340767,8,354669
22279,0.060281,74.125.68.0-255,5738,346505,8,354669
22280,0.060287,172.31.36.0-255,66,346571,8,354669
22281,0.062545,74.125.68.0-255,5738,352309,8,354669
22282,0.06255,172.31.36.0-255,66,352375,8,354669
22283,0.064813,74.125.68.0-255,2057,354432,8,354669
22284,0.064818,172.31.36.0-255,66,354498,8,354669
22285,0.064963,172.31.36.0-255,105,354603,8,354669
22286,0.067194,74.125.68.0-255,66,354669,8,354669
22287,0.0,74.125.130.0-255,153,153,8,325079
22288,1.5e-05,172.31.36.0-255,66,219,8,325079
22289,2.3e-05,74.125.130.0-255,1484,1703,8,325079
22290,2.6e-05,172.31.36.0-255,66,1769,8,325079
22291,3.2e-05,74.125.130.0-255,2902,4671,8,325079
22292,3.5e-05,172.31.36.0-255,66,4737,8,325079
22293,3.8e-05,74.125.130.0-255,1484,6221,8,325079
22294,4.1e-05,172.31.36.0-255,66,6287,8,325079
22295,6.2e-05,74.125.130.0-255,4320,10607,8,325079
22296,6.5e-05,172.31.36.0-255,66,10673,8,325079
22297,7e-05,74.125.130.0-255,3421,14094,8,325079
22298,7.2e-05,172.31.36.0-255,66,14160,8,325079
22299,7.7e-05,74.125.130.0-255,4320,18480,8,325079
22300,7.9e-05,172.31.36.0-255,66,18546,8,325079
22301,0.000125,172.31.36.0-255,66,18612,8,325079
22302,0.000129,74.125.130.0-255,2543,21155,8,325079
22303,0.000131,172.31.36.0-255,66,21221,8,325079
22304,0.000333,74.125.130.0-255,1484,22705,8,325079
22305,0.000338,172.31.36.0-255,66,22771,8,325079
22306,0.000344,74.125.130.0-255,2902,25673,8,325079
22307,0.000346,172.31.36.0-255,66,25739,8,325079
22308,0.000349,74.125.130.0-255,1484,27223,8,325079
22309,0.000351,172.31.36.0-255,66,27289,8,325079
22310,0.000368,74.125.130.0-255,4320,31609,8,325079
22311,0.000371,172.31.36.0-255,66,31675,8,325079
22312,0.000375,74.125.130.0-255,2902,34577,8,325079
22313,0.000377,172.31.36.0-255,66,34643,8,325079
22314,0.000394,74.125.130.0-255,2902,37545,8,325079
22315,0.000398,172.31.36.0-255,66,37611,8,325079
22316,0.000427,74.125.130.0-255,7156,44767,8,325079
22317,0.000431,172.31.36.0-255,66,44833,8,325079
22318,0.000438,74.125.130.0-255,7156,51989,8,325079
22319,0.00044,172.31.36.0-255,66,52055,8,325079
22320,0.000463,74.125.130.0-255,3602,55657,8,325079
22321,0.000466,172.31.36.0-255,66,55723,8,325079
22322,0.000469,74.125.130.0-255,376,56099,8,325079
22323,0.000693,74.125.130.0-255,100,56199,8,325079
22324,0.000808,172.31.36.0-255,66,56265,8,325079
22325,0.000971,74.125.130.0-255,1484,57749,8,325079
22326,0.000993,74.125.130.0-255,2902,60651,8,325079
22327,0.000997,172.31.36.0-255,66,60717,8,325079
22328,0.001002,74.125.130.0-255,2902,63619,8,325079
22329,0.001005,172.31.36.0-255,66,63685,8,325079
22330,0.001019,74.125.130.0-255,2902,66587,8,325079
22331,0.001022,172.31.36.0-255,66,66653,8,325079
22332,0.001043,74.125.130.0-255,7156,73809,8,325079
22333,0.001046,172.31.36.0-255,66,73875,8,325079
22334,0.001067,74.125.130.0-255,4320,78195,8,325079
22335,0.00107,172.31.36.0-255,66,78261,8,325079
22336,0.001088,74.125.130.0-255,7156,85417,8,325079
22337,0.001091,172.31.36.0-255,66,85483,8,325079
22338,0.001112,74.125.130.0-255,2902,88385,8,325079
22339,0.001115,172.31.36.0-255,66,88451,8,325079
22340,0.001132,74.125.130.0-255,2184,90635,8,325079
22341,0.001135,172.31.36.0-255,66,90701,8,325079
22342,0.001843,74.125.130.0-255,1484,92185,8,325079
22343,0.001851,74.125.130.0-255,2902,95087,8,325079
22344,0.001855,172.31.36.0-255,66,95153,8,325079
22345,0.001878,74.125.130.0-255,5738,100891,8,325079
22346,0.00188,172.31.36.0-255,66,100957,8,325079
22347,0.001883,74.125.130.0-255,1484,102441,8,325079
22348,0.001903,74.125.130.0-255,5738,108179,8,325079
22349,0.001905,172.31.36.0-255,66,108245,8,325079
22350,0.001908,74.125.130.0-255,1484,109729,8,325079
22351,0.001927,74.125.130.0-255,7156,116885,8,325079
22352,0.001929,172.31.36.0-255,66,116951,8,325079
22353,0.001949,74.125.130.0-255,5738,122689,8,325079
22354,0.001951,172.31.36.0-255,66,122755,8,325079
22355,0.001963,74.125.130.0-255,2184,124939,8,325079
22356,0.001966,172.31.36.0-255,66,125005,8,325079
22357,0.002025,74.125.130.0-255,1484,126489,8,325079
22358,0.00204,74.125.130.0-255,2902,129391,8,325079
22359,0.002042,172.31.36.0-255,66,129457,8,325079
22360,0.002045,74.125.130.0-255,1484,130941,8,325079
22361,0.002061,74.125.130.0-255,4320,135261,8,325079
22362,0.002063,172.31.36.0-255,66,135327,8,325079
22363,0.002085,74.125.130.0-255,2902,138229,8,325079
22364,0.002086,172.31.36.0-255,66,138295,8,325079
22365,0.002101,74.125.130.0-255,2902,141197,8,325079
22366,0.002104,172.31.36.0-255,66,141263,8,325079
22367,0.002159,74.125.130.0-255,7156,148419,8,325079
22368,0.002162,172.31.36.0-255,66,148485,8,325079
22369,0.002171,172.31.36.0-255,66,148551,8,325079
22370,0.002185,74.125.130.0-255,2184,150735,8,325079
22371,0.002187,172.31.36.0-255,66,150801,8,325079
22372,0.002497,74.125.130.0-255,1484,152285,8,325079
22373,0.002511,74.125.130.0-255,2902,155187,8,325079
22374,0.002513,172.31.36.0-255,66,155253,8,325079
22375,0.002534,74.125.130.0-255,5738,160991,8,325079
22376,0.002536,172.31.36.0-255,66,161057,8,325079
22377,0.00254,74.125.130.0-255,4320,165377,8,325079
22378,0.002543,172.31.36.0-255,66,165443,8,325079
22379,0.002547,74.125.130.0-255,2902,168345,8,325079
22380,0.002549,172.31.36.0-255,66,168411,8,325079
22381,0.002567,74.125.130.0-255,2902,171313,8,325079
22382,0.002569,172.31.36.0-255,66,171379,8,325079
22383,0.002608,172.31.36.0-255,66,171445,8,325079
22384,0.002636,74.125.130.0-255,2184,173629,8,325079
22385,0.002638,172.31.36.0-255,66,173695,8,325079
22386,0.005219,74.125.130.0-255,1484,175179,8,325079
22387,0.005246,74.125.130.0-255,4320,179499,8,325079
22388,0.00525,172.31.36.0-255,66,179565,8,325079
22389,0.007869,74.125.130.0-255,5738,185303,8,325079
22390,0.007876,172.31.36.0-255,66,185369,8,325079
22391,0.010501,74.125.130.0-255,5738,191107,8,325079
22392,0.010509,172.31.36.0-255,66,191173,8,325079
22393,0.013133,74.125.130.0-255,5738,196911,8,325079
22394,0.01314,172.31.36.0-255,66,196977,8,325079
22395,0.015766,74.125.130.0-255,5738,202715,8,325079
22396,0.015779,172.31.36.0-255,66,202781,8,325079
22397,0.018402,74.125.130.0-255,5738,208519,8,325079
22398,0.018418,172.31.36.0-255,66,208585,8,325079
22399,0.021033,74.125.130.0-255,5738,214323,8,325079
22400,0.021046,172.31.36.0-255,66,214389,8,325079
22401,0.023684,74.125.130.0-255,5738,220127,8,325079
22402,0.023701,172.31.36.0-255,66,220193,8,325079
22403,0.026362,74.125.130.0-255,5738,225931,8,325079
22404,0.026375,172.31.36.0-255,66,225997,8,325079
22405,0.028991,74.125.130.0-255,4320,230317,8,325079
22406,0.028999,172.31.36.0-255,66,230383,8,325079
22407,0.029034,74.125.130.0-255,1484,231867,8,325079
22408,0.029721,172.31.36.0-255,172,232039,8,325079
22409,0.029751,172.31.36.0-255,1110,233149,8,325079
22410,0.029809,172.31.36.0-255,1514,234663,8,325079
22411,0.029811,172.31.36.0-255,1514,236177,8,325079
22412,0.029812,172.31.36.0-255,1514,237691,8,325079
22413,0.029813,172.31.36.0-255,1514,239205,8,325079
22414,0.029843,172.31.36.0-255,1514,240719,8,325079
22415,0.02985,172.31.36.0-255,876,241595,8,325079
22416,0.03127,104.244.42.0-255,66,241661,8,325079
22417,0.031369,104.244.42.0-255,66,241727,8,325079
22418,0.031374,104.244.42.0-255,66,241793,8,325079
22419,0.031539,104.244.42.0-255,66,241859,8,325079
22420,0.031616,74.125.130.0-255,4320,246179,8,325079
22421,0.031623,172.31.36.0-255,66,246245,8,325079
22422,0.032395,104.244.42.0-255,108,246353,8,325079
22423,0.032403,172.31.36.0-255,66,246419,8,325079
22424,0.034254,74.125.130.0-255,5738,252157,8,325079
22425,0.034261,172.31.36.0-255,66,252223,8,325079
22426,0.036886,74.125.130.0-255,5738,257961,8,325079
22427,0.036896,172.31.36.0-255,66,258027,8,325079
22428,0.039519,74.125.130.0-255,5738,263765,8,325079
22429,0.03953,172.31.36.0-255,66,263831,8,325079
22430,0.04192,172.31.36.0-255,108,263939,8,325079
22431,0.042144,74.125.130.0-255,4320,268259,8,325079
22432,0.04215,172.31.36.0-255,66,268325,8,325079
22433,0.042169,74.125.130.0-255,1484,269809,8,325079
22434,0.04478,74.125.130.0-255,4320,274129,8,325079
22435,0.044788,172.31.36.0-255,66,274195,8,325079
22436,0.04761,74.125.130.0-255,5738,279933,8,325079
22437,0.047621,172.31.36.0-255,66,279999,8,325079
22438,0.050256,74.125.130.0-255,5738,285737,8,325079
22439,0.050266,172.31.36.0-255,66,285803,8,325079
22440,0.052892,74.125.130.0-255,4320,290123,8,325079
22441,0.0529,172.31.36.0-255,66,290189,8,325079
22442,0.052933,74.125.130.0-255,1484,291673,8,325079
22443,0.055529,74.125.130.0-255,4320,295993,8,325079
22444,0.055538,172.31.36.0-255,66,296059,8,325079
22445,0.058164,74.125.130.0-255,5738,301797,8,325079
22446,0.058175,172.31.36.0-255,66,301863,8,325079
22447,0.060816,74.125.130.0-255,5738,307601,8,325079
22448,0.060824,172.31.36.0-255,66,307667,8,325079
22449,0.063437,74.125.130.0-255,5738,313405,8,325079
22450,0.063443,172.31.36.0-255,66,313471,8,325079
22451,0.066124,74.125.130.0-255,5738,319209,8,325079
22452,0.066133,172.31.36.0-255,66,319275,8,325079
22453,0.068757,74.125.130.0-255,5738,325013,8,325079
22454,0.068767,172.31.36.0-255,66,325079,8,325079
22455,0.0,172.217.194.0-255,153,153,8,234198
22456,3.7e-05,172.31.36.0-255,66,219,8,234198
22457,4.4e-05,172.217.194.0-255,1484,1703,8,234198
22458,4.8e-05,172.31.36.0-255,66,1769,8,234198
22459,5.3e-05,172.217.194.0-255,2902,4671,8,234198
22460,5.5e-05,172.31.36.0-255,66,4737,8,234198
22461,7.2e-05,172.217.194.0-255,7156,11893,8,234198
22462,7.4e-05,172.31.36.0-255,66,11959,8,234198
22463,8.6e-05,172.31.36.0-255,66,12025,8,234198
22464,0.000121,172.217.194.0-255,4878,16903,8,234198
22465,0.000124,172.31.36.0-255,66,16969,8,234198
22466,0.000129,172.217.194.0-255,3961,20930,8,234198
22467,0.000132,172.31.36.0-255,66,20996,8,234198
22468,0.000152,172.217.194.0-255,1484,22480,8,234198
22469,0.000155,172.31.36.0-255,66,22546,8,234198
22470,0.000164,172.217.194.0-255,2902,25448,8,234198
22471,0.000166,172.31.36.0-255,66,25514,8,234198
22472,0.000174,172.217.194.0-255,5738,31252,8,234198
22473,0.000176,172.31.36.0-255,66,31318,8,234198
22474,0.000222,172.31.36.0-255,66,31384,8,234198
22475,0.000275,172.217.194.0-255,2902,34286,8,234198
22476,0.000279,172.31.36.0-255,66,34352,8,234198
22477,0.00031,172.217.194.0-255,7101,41453,8,234198
22478,0.000314,172.31.36.0-255,66,41519,8,234198
22479,0.000397,172.217.194.0-255,383,41902,8,234198
22480,0.0004,172.31.36.0-255,66,41968,8,234198
22481,0.000852,172.217.194.0-255,1484,43452,8,234198
22482,0.000857,172.31.36.0-255,66,43518,8,234198
22483,0.000862,172.217.194.0-255,1484,45002,8,234198
22484,0.000864,172.31.36.0-255,66,45068,8,234198
22485,0.000881,172.217.194.0-255,1484,46552,8,234198
22486,0.000907,172.217.194.0-255,5738,52290,8,234198
22487,0.00091,172.31.36.0-255,66,52356,8,234198
22488,0.000915,172.217.194.0-255,2902,55258,8,234198
22489,0.000917,172.31.36.0-255,66,55324,8,234198
22490,0.000955,172.31.36.0-255,66,55390,8,234198
22491,0.000959,172.217.194.0-255,2902,58292,8,234198
22492,0.000961,172.31.36.0-255,66,58358,8,234198
22493,0.000995,172.31.36.0-255,66,58424,8,234198
22494,0.001932,172.217.194.0-255,1484,59908,8,234198
22495,0.001942,172.217.194.0-255,2902,62810,8,234198
22496,0.001946,172.31.36.0-255,66,62876,8,234198
22497,0.001953,172.217.194.0-255,5738,68614,8,234198
22498,0.001955,172.31.36.0-255,66,68680,8,234198
22499,0.001991,172.31.36.0-255,66,68746,8,234198
22500,0.002009,172.217.194.0-255,4320,73066,8,234198
22501,0.00201,172.31.36.0-255,66,73132,8,234198
22502,0.002041,172.31.36.0-255,66,73198,8,234198
22503,0.002073,172.31.36.0-255,66,73264,8,234198
22504,0.002076,172.217.194.0-255,1484,74748,8,234198
22505,0.002079,172.217.194.0-255,1484,76232,8,234198
22506,0.00208,172.31.36.0-255,66,76298,8,234198
22507,0.0021,172.217.194.0-255,2902,79200,8,234198
22508,0.002103,172.31.36.0-255,66,79266,8,234198
22509,0.002112,172.217.194.0-255,4320,83586,8,234198
22510,0.002114,172.31.36.0-255,66,83652,8,234198
22511,0.002118,172.217.194.0-255,1484,85136,8,234198
22512,0.002123,172.217.194.0-255,5738,90874,8,234198
22513,0.002125,172.31.36.0-255,66,90940,8,234198
22514,0.002157,172.217.194.0-255,6438,97378,8,234198
22515,0.002159,172.31.36.0-255,66,97444,8,234198
22516,0.002171,172.31.36.0-255,66,97510,8,234198
22517,0.002187,172.31.36.0-255,66,97576,8,234198
22518,0.002209,172.217.194.0-255,1484,99060,8,234198
22519,0.002217,172.217.194.0-255,2902,101962,8,234198
22520,0.00222,172.31.36.0-255,66,102028,8,234198
22521,0.002226,172.217.194.0-255,6438,108466,8,234198
22522,0.002228,172.31.36.0-255,66,108532,8,234198
22523,0.002414,172.217.194.0-255,1484,110016,8,234198
22524,0.002429,172.217.194.0-255,2902,112918,8,234198
22525,0.002431,172.31.36.0-255,66,112984,8,234198
22526,0.00246,172.217.194.0-255,5738,118722,8,234198
22527,0.002462,172.31.36.0-255,66,118788,8,234198
22528,0.002486,172.217.194.0-255,1484,120272,8,234198
22529,0.002489,172.217.194.0-255,1484,121756,8,234198
22530,0.002743,172.217.194.0-255,1484,123240,8,234198
22531,0.002747,172.217.194.0-255,2902,126142,8,234198
22532,0.002796,172.217.194.0-255,5738,131880,8,234198
22533,0.0028,172.217.194.0-255,2902,134782,8,234198
22534,0.002834,172.217.194.0-255,7156,141938,8,234198
22535,0.002902,172.217.194.0-255,4320,146258,8,234198
22536,0.002905,172.217.194.0-255,1484,147742,8,234198
22537,0.002908,172.31.36.0-255,78,147820,8,234198
22538,0.002911,172.217.194.0-255,1484,149304,8,234198
22539,0.002914,172.31.36.0-255,78,149382,8,234198
22540,0.00295,172.217.194.0-255,5738,155120,8,234198
22541,0.002971,172.217.194.0-255,7156,162276,8,234198
22542,0.002976,172.217.194.0-255,4320,166596,8,234198
22543,0.00298,172.217.194.0-255,2184,168780,8,234198
22544,0.002982,172.31.36.0-255,78,168858,8,234198
22545,0.002989,172.217.194.0-255,7156,176014,8,234198
22546,0.003014,172.217.194.0-255,1484,177498,8,234198
22547,0.003019,172.217.194.0-255,2902,180400,8,234198
22548,0.003032,172.217.194.0-255,1484,181884,8,234198
22549,0.003047,172.217.194.0-255,4320,186204,8,234198
22550,0.003083,172.217.194.0-255,2902,189106,8,234198
22551,0.003114,172.217.194.0-255,7156,196262,8,234198
22552,0.00313,172.217.194.0-255,5020,201282,8,234198
22553,0.003165,172.217.194.0-255,4320,205602,8,234198
22554,0.003207,172.217.194.0-255,7156,212758,8,234198
22555,0.003242,172.217.194.0-255,2902,215660,8,234198
22556,0.003256,172.217.194.0-255,5738,221398,8,234198
22557,0.00327,172.217.194.0-255,2184,223582,8,234198
22558,0.00328,172.217.194.0-255,105,223687,8,234198
22559,0.005875,172.31.36.0-255,66,223753,8,234198
22560,0.008288,172.31.36.0-255,105,223858,8,234198
22561,0.010272,172.217.194.0-255,66,223924,8,234198
22562,0.037328,172.31.36.0-255,172,224096,8,234198
22563,0.037357,172.31.36.0-255,1110,225206,8,234198
22564,0.037409,172.31.36.0-255,1514,226720,8,234198
22565,0.037411,172.31.36.0-255,1514,228234,8,234198
22566,0.037417,172.31.36.0-255,1514,229748,8,234198
22567,0.037418,172.31.36.0-255,1514,231262,8,234198
22568,0.037436,172.31.36.0-255,1514,232776,8,234198
22569,0.037438,172.31.36.0-255,876,233652,8,234198
22570,0.03887,104.244.42.0-255,66,233718,8,234198
22571,0.038993,104.244.42.0-255,66,233784,8,234198
22572,0.038997,104.244.42.0-255,66,233850,8,234198
22573,0.039002,104.244.42.0-255,66,233916,8,234198
22574,0.039621,104.244.42.0-255,108,234024,8,234198
22575,0.039632,172.31.36.0-255,66,234090,8,234198
22576,0.046162,172.31.36.0-255,108,234198,8,234198
22577,0.0,172.217.26.0-255,150,150,8,280151
22578,1.4e-05,172.31.36.0-255,66,216,8,280151
22579,5.3e-05,172.217.26.0-255,1484,1700,8,280151
22580,5.7e-05,172.31.36.0-255,66,1766,8,280151
22581,6.3e-05,172.217.26.0-255,2902,4668,8,280151
22582,6.6e-05,172.31.36.0-255,66,4734,8,280151
22583,7e-05,172.217.26.0-255,1484,6218,8,280151
22584,7.8e-05,172.31.36.0-255,66,6284,8,280151
22585,0.000102,172.217.26.0-255,4320,10604,8,280151
22586,0.000105,172.31.36.0-255,66,10670,8,280151
22587,0.000169,172.217.26.0-255,3466,14136,8,280151
22588,0.000173,172.31.36.0-255,66,14202,8,280151
22589,0.000229,172.217.26.0-255,5738,19940,8,280151
22590,0.000232,172.31.36.0-255,66,20006,8,280151
22591,0.000264,172.217.26.0-255,5738,25744,8,280151
22592,0.000267,172.31.36.0-255,66,25810,8,280151
22593,0.000408,172.217.26.0-255,4320,30130,8,280151
22594,0.000415,172.31.36.0-255,66,30196,8,280151
22595,0.000463,172.217.26.0-255,1125,31321,8,280151
22596,0.000466,172.31.36.0-255,66,31387,8,280151
22597,0.000509,172.31.36.0-255,66,31453,8,280151
22598,0.000545,172.31.36.0-255,66,31519,8,280151
22599,0.000811,172.31.36.0-255,66,31585,8,280151
22600,0.000962,172.217.26.0-255,2902,34487,8,280151
22601,0.000966,172.31.36.0-255,66,34553,8,280151
22602,0.000983,172.217.26.0-255,1410,35963,8,280151
22603,0.000985,172.31.36.0-255,66,36029,8,280151
22604,0.001015,172.217.26.0-255,392,36421,8,280151
22605,0.001018,172.31.36.0-255,66,36487,8,280151
22606,0.001109,172.217.26.0-255,1484,37971,8,280151
22607,0.001125,172.217.26.0-255,2902,40873,8,280151
22608,0.001136,172.31.36.0-255,66,40939,8,280151
22609,0.00117,172.217.26.0-255,2902,43841,8,280151
22610,0.001173,172.31.36.0-255,66,43907,8,280151
22611,0.001213,172.217.26.0-255,4320,48227,8,280151
22612,0.001267,172.217.26.0-255,1484,49711,8,280151
22613,0.001364,172.31.36.0-255,66,49777,8,280151
22614,0.00143,172.217.26.0-255,4320,54097,8,280151
22615,0.001436,172.31.36.0-255,66,54163,8,280151
22616,0.001447,172.217.26.0-255,5738,59901,8,280151
22617,0.001466,172.31.36.0-255,66,59967,8,280151
22618,0.001585,172.217.26.0-255,2543,62510,8,280151
22619,0.001589,172.31.36.0-255,66,62576,8,280151
22620,0.001653,172.217.26.0-255,2902,65478,8,280151
22621,0.001656,172.31.36.0-255,66,65544,8,280151
22622,0.00166,172.31.36.0-255,66,65610,8,280151
22623,0.001863,172.217.26.0-255,5738,71348,8,280151
22624,0.001868,172.31.36.0-255,66,71414,8,280151
22625,0.002159,172.217.26.0-255,5738,77152,8,280151
22626,0.002206,172.217.26.0-255,5020,82172,8,280151
22627,0.002557,172.217.26.0-255,2184,84356,8,280151
22628,0.005497,172.31.36.0-255,66,84422,8,280151
22629,0.007434,172.217.26.0-255,5738,90160,8,280151
22630,0.00744,172.31.36.0-255,66,90226,8,280151
22631,0.009374,172.217.26.0-255,5738,95964,8,280151
22632,0.009381,172.31.36.0-255,66,96030,8,280151
22633,0.011313,172.217.26.0-255,5738,101768,8,280151
22634,0.011321,172.31.36.0-255,66,101834,8,280151
22635,0.013241,172.217.26.0-255,5738,107572,8,280151
22636,0.013248,172.31.36.0-255,66,107638,8,280151
22637,0.015175,172.217.26.0-255,5738,113376,8,280151
22638,0.015183,172.31.36.0-255,66,113442,8,280151
22639,0.017117,172.217.26.0-255,5738,119180,8,280151
22640,0.017124,172.31.36.0-255,66,119246,8,280151
22641,0.019052,172.217.26.0-255,5738,124984,8,280151
22642,0.019061,172.31.36.0-255,66,125050,8,280151
22643,0.020983,172.217.26.0-255,5738,130788,8,280151
22644,0.02099,172.31.36.0-255,66,130854,8,280151
22645,0.022917,172.217.26.0-255,5738,136592,8,280151
22646,0.022925,172.31.36.0-255,66,136658,8,280151
22647,0.024853,172.217.26.0-255,5738,142396,8,280151
22648,0.024861,172.31.36.0-255,66,142462,8,280151
22649,0.026791,172.217.26.0-255,5738,148200,8,280151
22650,0.026799,172.31.36.0-255,66,148266,8,280151
22651,0.028743,172.217.26.0-255,5738,154004,8,280151
22652,0.028752,172.31.36.0-255,66,154070,8,280151
22653,0.030689,172.217.26.0-255,5738,159808,8,280151
22654,0.030697,172.31.36.0-255,66,159874,8,280151
22655,0.032622,172.217.26.0-255,5738,165612,8,280151
22656,0.03263,172.31.36.0-255,66,165678,8,280151
22657,0.034554,172.217.26.0-255,5738,171416,8,280151
22658,0.034562,172.31.36.0-255,66,171482,8,280151
22659,0.036493,172.217.26.0-255,5738,177220,8,280151
22660,0.036501,172.31.36.0-255,66,177286,8,280151
22661,0.038435,172.217.26.0-255,5738,183024,8,280151
22662,0.038442,172.31.36.0-255,66,183090,8,280151
22663,0.040376,172.217.26.0-255,5738,188828,8,280151
22664,0.040384,172.31.36.0-255,66,188894,8,280151
22665,0.041001,172.31.36.0-255,172,189066,8,280151
22666,0.041031,172.31.36.0-255,1113,190179,8,280151
22667,0.041099,172.31.36.0-255,1514,191693,8,280151
22668,0.041101,172.31.36.0-255,1026,192719,8,280151
22669,0.042323,172.217.26.0-255,5738,198457,8,280151
22670,0.042333,172.31.36.0-255,66,198523,8,280151
22671,0.042555,104.244.42.0-255,66,198589,8,280151
22672,0.04273,104.244.42.0-255,66,198655,8,280151
22673,0.042736,104.244.42.0-255,66,198721,8,280151
22674,0.043293,104.244.42.0-255,108,198829,8,280151
22675,0.043303,172.31.36.0-255,66,198895,8,280151
22676,0.044267,172.217.26.0-255,5738,204633,8,280151
22677,0.044273,172.31.36.0-255,66,204699,8,280151
22678,0.046207,172.217.26.0-255,5738,210437,8,280151
22679,0.046213,172.31.36.0-255,66,210503,8,280151
22680,0.048142,172.217.26.0-255,5738,216241,8,280151
22681,0.048149,172.31.36.0-255,66,216307,8,280151
22682,0.050075,172.217.26.0-255,5738,222045,8,280151
22683,0.050081,172.31.36.0-255,66,222111,8,280151
22684,0.052012,172.217.26.0-255,5738,227849,8,280151
22685,0.052017,172.31.36.0-255,66,227915,8,280151
22686,0.05395,172.217.26.0-255,5738,233653,8,280151
22687,0.053957,172.31.36.0-255,66,233719,8,280151
22688,0.055928,172.217.26.0-255,5738,239457,8,280151
22689,0.055935,172.31.36.0-255,66,239523,8,280151
22690,0.057868,172.217.26.0-255,5738,245261,8,280151
22691,0.057875,172.31.36.0-255,66,245327,8,280151
22692,0.059805,172.217.26.0-255,5738,251065,8,280151
22693,0.05981,172.31.36.0-255,66,251131,8,280151
22694,0.061757,172.217.26.0-255,5738,256869,8,280151
22695,0.061764,172.31.36.0-255,66,256935,8,280151
22696,0.063708,172.217.26.0-255,5738,262673,8,280151
22697,0.063713,172.31.36.0-255,66,262739,8,280151
22698,0.065642,172.217.26.0-255,5738,268477,8,280151
22699,0.065648,172.31.36.0-255,66,268543,8,280151
22700,0.067575,172.217.26.0-255,5738,274281,8,280151
22701,0.067581,172.31.36.0-255,66,274347,8,280151
22702,0.069516,172.217.26.0-255,5738,280085,8,280151
22703,0.069521,172.31.36.0-255,66,280151,8,280151
22704,0.0,172.217.194.0-255,143,143,8,227608
22705,3.3e-05,172.31.36.0-255,66,209,8,227608
22706,4.1e-05,172.217.194.0-255,1484,1693,8,227608
22707,4.6e-05,172.31.36.0-255,66,1759,8,227608
22708,5.1e-05,172.217.194.0-255,2902,4661,8,227608
22709,6.1e-05,172.31.36.0-255,66,4727,8,227608
22710,6.6e-05,172.217.194.0-255,4320,9047,8,227608
22711,7e-05,172.31.36.0-255,66,9113,8,227608
22712,7.6e-05,172.217.194.0-255,4901,14014,8,227608
22713,7.9e-05,172.31.36.0-255,66,14080,8,227608
22714,0.000161,172.217.194.0-255,1484,15564,8,227608
22715,0.000165,172.31.36.0-255,66,15630,8,227608
22716,0.000172,172.217.194.0-255,2902,18532,8,227608
22717,0.000174,172.31.36.0-255,66,18598,8,227608
22718,0.000187,172.217.194.0-255,5738,24336,8,227608
22719,0.000191,172.31.36.0-255,66,24402,8,227608
22720,0.000228,172.217.194.0-255,6797,31199,8,227608
22721,0.000231,172.31.36.0-255,66,31265,8,227608
22722,0.000239,172.217.194.0-255,7156,38421,8,227608
22723,0.000241,172.31.36.0-255,66,38487,8,227608
22724,0.000286,172.31.36.0-255,66,38553,8,227608
22725,0.000392,172.217.194.0-255,1484,40037,8,227608
22726,0.000395,172.31.36.0-255,66,40103,8,227608
22727,0.000401,172.217.194.0-255,2902,43005,8,227608
22728,0.000403,172.31.36.0-255,66,43071,8,227608
22729,0.000436,172.217.194.0-255,5738,48809,8,227608
22730,0.00044,172.31.36.0-255,66,48875,8,227608
22731,0.00047,172.217.194.0-255,4320,53195,8,227608
22732,0.000473,172.31.36.0-255,66,53261,8,227608
22733,0.000503,172.217.194.0-255,3123,56384,8,227608
22734,0.000507,172.31.36.0-255,66,56450,8,227608
22735,0.000533,172.217.194.0-255,4320,60770,8,227608
22736,0.000536,172.31.36.0-255,66,60836,8,227608
22737,0.000557,172.217.194.0-255,4320,65156,8,227608
22738,0.00056,172.31.36.0-255,66,65222,8,227608
22739,0.000567,172.217.194.0-255,5738,70960,8,227608
22740,0.000569,172.31.36.0-255,66,71026,8,227608
22741,0.000588,172.217.194.0-255,3602,74628,8,227608
22742,0.000589,172.31.36.0-255,66,74694,8,227608
22743,0.000592,172.31.36.0-255,66,74760,8,227608
22744,0.000834,172.217.194.0-255,1484,76244,8,227608
22745,0.000841,172.217.194.0-255,2902,79146,8,227608
22746,0.000845,172.31.36.0-255,66,79212,8,227608
22747,0.000852,172.217.194.0-255,5738,84950,8,227608
22748,0.000854,172.31.36.0-255,66,85016,8,227608
22749,0.000868,172.217.194.0-255,7156,92172,8,227608
22750,0.000872,172.31.36.0-255,66,92238,8,227608
22751,0.00092,172.31.36.0-255,66,92304,8,227608
22752,0.000925,172.217.194.0-255,2184,94488,8,227608
22753,0.000928,172.31.36.0-255,66,94554,8,227608
22754,0.001578,172.217.194.0-255,1484,96038,8,227608
22755,0.001597,172.217.194.0-255,2902,98940,8,227608
22756,0.001601,172.31.36.0-255,66,99006,8,227608
22757,0.00161,172.217.194.0-255,4320,103326,8,227608
22758,0.001612,172.31.36.0-255,66,103392,8,227608
22759,0.001643,172.217.194.0-255,1484,104876,8,227608
22760,0.001647,172.217.194.0-255,2902,107778,8,227608
22761,0.001649,172.31.36.0-255,66,107844,8,227608
22762,0.001661,172.31.36.0-255,66,107910,8,227608
22763,0.001689,172.217.194.0-255,1484,109394,8,227608
22764,0.001714,172.31.36.0-255,66,109460,8,227608
22765,0.001885,172.217.194.0-255,1484,110944,8,227608
22766,0.001892,172.217.194.0-255,2902,113846,8,227608
22767,0.001896,172.31.36.0-255,66,113912,8,227608
22768,0.001899,172.217.194.0-255,1484,115396,8,227608
22769,0.001926,172.217.194.0-255,4320,119716,8,227608
22770,0.001928,172.31.36.0-255,66,119782,8,227608
22771,0.001935,172.217.194.0-255,7156,126938,8,227608
22772,0.001938,172.31.36.0-255,66,127004,8,227608
22773,0.001969,172.31.36.0-255,66,127070,8,227608
22774,0.002052,172.31.36.0-255,66,127136,8,227608
22775,0.002069,172.31.36.0-255,66,127202,8,227608
22776,0.002081,172.31.36.0-255,66,127268,8,227608
22777,0.002114,172.31.36.0-255,66,127334,8,227608
22778,0.002117,172.217.194.0-255,2902,130236,8,227608
22779,0.002119,172.31.36.0-255,66,130302,8,227608
22780,0.002185,172.31.36.0-255,66,130368,8,227608
22781,0.002192,172.217.194.0-255,6438,136806,8,227608
22782,0.002194,172.31.36.0-255,66,136872,8,227608
22783,0.002197,172.217.194.0-255,1484,138356,8,227608
22784,0.002206,172.217.194.0-255,2902,141258,8,227608
22785,0.002209,172.31.36.0-255,66,141324,8,227608
22786,0.002215,172.217.194.0-255,5738,147062,8,227608
22787,0.002217,172.31.36.0-255,66,147128,8,227608
22788,0.002244,172.217.194.0-255,7156,154284,8,227608
22789,0.002251,172.31.36.0-255,66,154350,8,227608
22790,0.002256,172.217.194.0-255,2902,157252,8,227608
22791,0.002258,172.31.36.0-255,66,157318,8,227608
22792,0.002299,172.31.36.0-255,66,157384,8,227608
22793,0.002309,172.31.36.0-255,66,157450,8,227608
22794,0.002314,172.217.194.0-255,4320,161770,8,227608
22795,0.002316,172.31.36.0-255,66,161836,8,227608
22796,0.002348,172.217.194.0-255,5738,167574,8,227608
22797,0.002351,172.31.36.0-255,66,167640,8,227608
22798,0.002371,172.31.36.0-255,66,167706,8,227608
22799,0.002418,172.31.36.0-255,66,167772,8,227608
22800,0.004773,172.217.194.0-255,5738,173510,8,227608
22801,0.004777,172.31.36.0-255,66,173576,8,227608
22802,0.007153,172.217.194.0-255,5738,179314,8,227608
22803,0.007159,172.31.36.0-255,66,179380,8,227608
22804,0.009528,172.217.194.0-255,5738,185118,8,227608
22805,0.009535,172.31.36.0-255,66,185184,8,227608
22806,0.011915,172.217.194.0-255,5738,190922,8,227608
22807,0.011922,172.31.36.0-255,66,190988,8,227608
22808,0.014335,172.217.194.0-255,5738,196726,8,227608
22809,0.014345,172.31.36.0-255,66,196792,8,227608
22810,0.016699,172.217.194.0-255,5738,202530,8,227608
22811,0.016708,172.31.36.0-255,66,202596,8,227608
22812,0.019086,172.217.194.0-255,5738,208334,8,227608
22813,0.019093,172.31.36.0-255,66,208400,8,227608
22814,0.021459,172.217.194.0-255,5738,214138,8,227608
22815,0.021466,172.31.36.0-255,66,214204,8,227608
22816,0.023817,172.217.194.0-255,5738,219942,8,227608
22817,0.023824,172.31.36.0-255,66,220008,8,227608
22818,0.026208,172.217.194.0-255,5738,225746,8,227608
22819,0.026216,172.31.36.0-255,66,225812,8,227608
22820,0.028594,172.217.194.0-255,701,226513,8,227608
22821,0.028754,172.31.36.0-255,66,226579,8,227608
22822,0.028782,172.31.36.0-255,105,226684,8,227608
22823,0.031113,172.217.194.0-255,66,226750,8,227608
22824,0.033824,172.31.36.0-255,164,226914,8,227608
22825,0.033854,172.31.36.0-255,562,227476,8,227608
22826,0.035375,104.244.42.0-255,66,227542,8,227608
22827,0.035382,104.244.42.0-255,66,227608,8,227608
22828,0.0,74.125.24.0-255,153,153,8,266238
22829,2.4e-05,172.31.36.0-255,66,219,8,266238
22830,3.2e-05,74.125.24.0-255,1484,1703,8,266238
22831,3.7e-05,172.31.36.0-255,66,1769,8,266238
22832,5e-05,74.125.24.0-255,2902,4671,8,266238
22833,5.4e-05,172.31.36.0-255,66,4737,8,266238
22834,6.3e-05,74.125.24.0-255,7156,11893,8,266238
22835,6.5e-05,172.31.36.0-255,66,11959,8,266238
22836,7.1e-05,74.125.24.0-255,4320,16279,8,266238
22837,7.4e-05,172.31.36.0-255,66,16345,8,266238
22838,0.000109,74.125.24.0-255,6339,22684,8,266238
22839,0.000113,172.31.36.0-255,66,22750,8,266238
22840,0.000125,172.31.36.0-255,66,22816,8,266238
22841,0.000174,74.125.24.0-255,1484,24300,8,266238
22842,0.000176,172.31.36.0-255,66,24366,8,266238
22843,0.000213,74.125.24.0-255,2902,27268,8,266238
22844,0.000215,172.31.36.0-255,66,27334,8,266238
22845,0.000224,74.125.24.0-255,5738,33072,8,266238
22846,0.000226,172.31.36.0-255,66,33138,8,266238
22847,0.000236,74.125.24.0-255,4320,37458,8,266238
22848,0.000238,172.31.36.0-255,66,37524,8,266238
22849,0.000252,172.31.36.0-255,66,37590,8,266238
22850,0.000286,172.31.36.0-255,66,37656,8,266238
22851,0.000447,74.125.24.0-255,131,37787,8,266238
22852,0.000452,172.31.36.0-255,66,37853,8,266238
22853,0.000496,74.125.24.0-255,1484,39337,8,266238
22854,0.000499,172.31.36.0-255,66,39403,8,266238
22855,0.000504,74.125.24.0-255,2902,42305,8,266238
22856,0.000507,172.31.36.0-255,66,42371,8,266238
22857,0.000544,74.125.24.0-255,7156,49527,8,266238
22858,0.000551,74.125.24.0-255,4320,53847,8,266238
22859,0.000586,74.125.24.0-255,7156,61003,8,266238
22860,0.000606,74.125.24.0-255,5738,66741,8,266238
22861,0.000608,74.125.24.0-255,1484,68225,8,266238
22862,0.000617,172.31.36.0-255,66,68291,8,266238
22863,0.000626,74.125.24.0-255,2902,71193,8,266238
22864,0.000628,74.125.24.0-255,766,71959,8,266238
22865,0.000644,172.31.36.0-255,66,72025,8,266238
22866,0.000836,74.125.24.0-255,1484,73509,8,266238
22867,0.000842,74.125.24.0-255,2902,76411,8,266238
22868,0.000874,74.125.24.0-255,4320,80731,8,266238
22869,0.000888,74.125.24.0-255,1484,82215,8,266238
22870,0.000908,74.125.24.0-255,4320,86535,8,266238
22871,0.000914,74.125.24.0-255,4320,90855,8,266238
22872,0.000928,74.125.24.0-255,2902,93757,8,266238
22873,0.000964,74.125.24.0-255,5738,99495,8,266238
22874,0.000982,74.125.24.0-255,6438,105933,8,266238
22875,0.000985,74.125.24.0-255,346,106279,8,266238
22876,0.001021,74.125.24.0-255,1484,107763,8,266238
22877,0.001041,74.125.24.0-255,4320,112083,8,266238
22878,0.001052,74.125.24.0-255,1484,113567,8,266238
22879,0.001069,74.125.24.0-255,5738,119305,8,266238
22880,0.001086,74.125.24.0-255,4320,123625,8,266238
22881,0.001116,74.125.24.0-255,2902,126527,8,266238
22882,0.001128,74.125.24.0-255,2902,129429,8,266238
22883,0.001139,74.125.24.0-255,2184,131613,8,266238
22884,0.001835,74.125.24.0-255,1484,133097,8,266238
22885,0.001858,74.125.24.0-255,2902,135999,8,266238
22886,0.001876,74.125.24.0-255,4320,140319,8,266238
22887,0.00188,74.125.24.0-255,2902,143221,8,266238
22888,0.001901,74.125.24.0-255,5738,148959,8,266238
22889,0.001945,74.125.24.0-255,7156,156115,8,266238
22890,0.002004,74.125.24.0-255,1484,157599,8,266238
22891,0.002024,74.125.24.0-255,2902,160501,8,266238
22892,0.002026,74.125.24.0-255,1484,161985,8,266238
22893,0.002047,74.125.24.0-255,4320,166305,8,266238
22894,0.002059,172.31.36.0-255,66,166371,8,266238
22895,0.002083,74.125.24.0-255,1484,167855,8,266238
22896,0.002135,172.31.36.0-255,66,167921,8,266238
22897,0.002195,74.125.24.0-255,4320,172241,8,266238
22898,0.00223,172.31.36.0-255,66,172307,8,266238
22899,0.002297,74.125.24.0-255,5738,178045,8,266238
22900,0.002316,172.31.36.0-255,66,178111,8,266238
22901,0.002323,74.125.24.0-255,6438,184549,8,266238
22902,0.002352,172.31.36.0-255,66,184615,8,266238
22903,0.002363,74.125.24.0-255,2902,187517,8,266238
22904,0.002402,172.31.36.0-255,66,187583,8,266238
22905,0.002446,172.31.36.0-255,66,187649,8,266238
22906,0.004792,74.125.24.0-255,5738,193387,8,266238
22907,0.004798,172.31.36.0-255,66,193453,8,266238
22908,0.007112,74.125.24.0-255,5738,199191,8,266238
22909,0.016165,172.31.36.0-255,66,199257,8,266238
22910,0.01638,74.125.24.0-255,1484,200741,8,266238
22911,0.018504,74.125.24.0-255,4320,205061,8,266238
22912,0.018513,172.31.36.0-255,66,205127,8,266238
22913,0.020844,74.125.24.0-255,5738,210865,8,266238
22914,0.02089,172.31.36.0-255,66,210931,8,266238
22915,0.02322,74.125.24.0-255,5738,216669,8,266238
22916,0.023227,172.31.36.0-255,66,216735,8,266238
22917,0.025569,74.125.24.0-255,5738,222473,8,266238
22918,0.025576,172.31.36.0-255,66,222539,8,266238
22919,0.027925,74.125.24.0-255,5738,228277,8,266238
22920,0.027933,172.31.36.0-255,66,228343,8,266238
22921,0.03026,74.125.24.0-255,5738,234081,8,266238
22922,0.030268,172.31.36.0-255,66,234147,8,266238
22923,0.032598,74.125.24.0-255,5738,239885,8,266238
22924,0.032606,172.31.36.0-255,66,239951,8,266238
22925,0.034957,74.125.24.0-255,5738,245689,8,266238
22926,0.034965,172.31.36.0-255,66,245755,8,266238
22927,0.037304,74.125.24.0-255,5738,251493,8,266238
22928,0.037314,172.31.36.0-255,66,251559,8,266238
22929,0.039657,74.125.24.0-255,5609,257168,8,266238
22930,0.039671,172.31.36.0-255,66,257234,8,266238
22931,0.039993,172.31.36.0-255,105,257339,8,266238
22932,0.042318,74.125.24.0-255,66,257405,8,266238
22933,0.045839,172.31.36.0-255,172,257577,8,266238
22934,0.045872,172.31.36.0-255,1111,258688,8,266238
22935,0.045953,172.31.36.0-255,1514,260202,8,266238
22936,0.045955,172.31.36.0-255,1514,261716,8,266238
22937,0.04596,172.31.36.0-255,1514,263230,8,266238
22938,0.045961,172.31.36.0-255,1514,264744,8,266238
22939,0.046014,172.31.36.0-255,1230,265974,8,266238
22940,0.047385,104.244.42.0-255,66,266040,8,266238
22941,0.047426,104.244.42.0-255,66,266106,8,266238
22942,0.04757,104.244.42.0-255,66,266172,8,266238
22943,0.047577,104.244.42.0-255,66,266238,8,266238
22944,0.0,172.217.194.0-255,152,152,8,126684
22945,3e-05,172.31.36.0-255,66,218,8,126684
22946,3.7e-05,172.217.194.0-255,1484,1702,8,126684
22947,4.2e-05,172.31.36.0-255,66,1768,8,126684
22948,4.7e-05,172.217.194.0-255,2902,4670,8,126684
22949,5.1e-05,172.31.36.0-255,66,4736,8,126684
22950,5.4e-05,172.217.194.0-255,1484,6220,8,126684
22951,5.7e-05,172.31.36.0-255,66,6286,8,126684
22952,8.5e-05,172.217.194.0-255,5738,12024,8,126684
22953,8.8e-05,172.31.36.0-255,66,12090,8,126684
22954,0.000104,172.217.194.0-255,2054,14144,8,126684
22955,0.000106,172.31.36.0-255,66,14210,8,126684
22956,0.00012,172.217.194.0-255,5738,19948,8,126684
22957,0.000123,172.31.36.0-255,66,20014,8,126684
22958,0.000142,172.217.194.0-255,2902,22916,8,126684
22959,0.000144,172.31.36.0-255,66,22982,8,126684
22960,0.000159,172.217.194.0-255,4320,27302,8,126684
22961,0.000162,172.31.36.0-255,66,27368,8,126684
22962,0.000189,172.31.36.0-255,66,27434,8,126684
22963,0.000263,172.217.194.0-255,7156,34590,8,126684
22964,0.000266,172.31.36.0-255,66,34656,8,126684
22965,0.000285,172.217.194.0-255,2184,36840,8,126684
22966,0.000288,172.31.36.0-255,66,36906,8,126684
22967,0.000327,172.217.194.0-255,1484,38390,8,126684
22968,0.000332,172.217.194.0-255,2902,41292,8,126684
22969,0.000332,172.31.36.0-255,66,41358,8,126684
22970,0.000337,172.31.36.0-255,66,41424,8,126684
22971,0.000356,172.217.194.0-255,5738,47162,8,126684
22972,0.000359,172.31.36.0-255,66,47228,8,126684
22973,0.000394,172.217.194.0-255,1484,48712,8,126684
22974,0.000397,172.31.36.0-255,66,48778,8,126684
22975,0.000419,172.217.194.0-255,5700,54478,8,126684
22976,0.000422,172.31.36.0-255,66,54544,8,126684
22977,0.000677,172.217.194.0-255,1484,56028,8,126684
22978,0.000682,172.217.194.0-255,1484,57512,8,126684
22979,0.000686,172.31.36.0-255,66,57578,8,126684
22980,0.000706,172.217.194.0-255,1484,59062,8,126684
22981,0.000712,172.217.194.0-255,5738,64800,8,126684
22982,0.000715,172.31.36.0-255,66,64866,8,126684
22983,0.00074,172.217.194.0-255,2902,67768,8,126684
22984,0.000743,172.31.36.0-255,66,67834,8,126684
22985,0.000767,172.31.36.0-255,66,67900,8,126684
22986,0.000819,172.217.194.0-255,4320,72220,8,126684
22987,0.000823,172.31.36.0-255,66,72286,8,126684
22988,0.000841,172.217.194.0-255,2902,75188,8,126684
22989,0.000845,172.31.36.0-255,66,75254,8,126684
22990,0.00088,172.217.194.0-255,3602,78856,8,126684
22991,0.000884,172.31.36.0-255,66,78922,8,126684
22992,0.000906,172.217.194.0-255,4320,83242,8,126684
22993,0.000909,172.31.36.0-255,66,83308,8,126684
22994,0.000932,172.31.36.0-255,66,83374,8,126684
22995,0.000989,172.217.194.0-255,4320,87694,8,126684
22996,0.000993,172.31.36.0-255,66,87760,8,126684
22997,0.001013,172.217.194.0-255,4320,92080,8,126684
22998,0.001016,172.31.36.0-255,66,92146,8,126684
22999,0.001052,172.217.194.0-255,1484,93630,8,126684
23000,0.001085,172.31.36.0-255,66,93696,8,126684
23001,0.001105,172.217.194.0-255,6438,100134,8,126684
23002,0.001108,172.31.36.0-255,66,100200,8,126684
23003,0.001212,172.217.194.0-255,2902,103102,8,126684
23004,0.001218,172.31.36.0-255,66,103168,8,126684
23005,0.00126,172.31.36.0-255,66,103234,8,126684
23006,0.001279,172.217.194.0-255,3602,106836,8,126684
23007,0.001282,172.31.36.0-255,66,106902,8,126684
23008,0.001434,172.217.194.0-255,7156,114058,8,126684
23009,0.001439,172.31.36.0-255,66,114124,8,126684
23010,0.001469,172.31.36.0-255,66,114190,8,126684
23011,0.001563,172.217.194.0-255,4320,118510,8,126684
23012,0.001567,172.31.36.0-255,66,118576,8,126684
23013,0.00161,172.31.36.0-255,66,118642,8,126684
23014,0.001736,172.217.194.0-255,2902,121544,8,126684
23015,0.00174,172.31.36.0-255,66,121610,8,126684
23016,0.001814,172.31.36.0-255,66,121676,8,126684
23017,0.001865,172.31.36.0-255,66,121742,8,126684
23018,0.002089,172.31.36.0-255,66,121808,8,126684
23019,0.002146,172.31.36.0-255,66,121874,8,126684
23020,0.002336,172.31.36.0-255,66,121940,8,126684
23021,0.002373,172.31.36.0-255,66,122006,8,126684
23022,0.002428,172.31.36.0-255,66,122072,8,126684
23023,0.002802,172.31.36.0-255,66,122138,8,126684
23024,0.002837,172.31.36.0-255,66,122204,8,126684
23025,0.008188,172.31.36.0-255,105,122309,8,126684
23026,0.010427,172.217.194.0-255,66,122375,8,126684
23027,0.02916,172.31.36.0-255,193,122568,8,126684
23028,0.029199,172.31.36.0-255,1112,123680,8,126684
23029,0.029275,172.31.36.0-255,1514,125194,8,126684
23030,0.029277,172.31.36.0-255,1292,126486,8,126684
23031,0.030711,104.244.42.0-255,66,126552,8,126684
23032,0.030806,104.244.42.0-255,66,126618,8,126684
23033,0.030851,104.244.42.0-255,66,126684,8,126684
23034,0.0,74.125.130.0-255,431,431,8,91023
23035,1.5e-05,74.125.130.0-255,1484,1915,8,91023
23036,2.5e-05,172.31.36.0-255,66,1981,8,91023
23037,5.1e-05,74.125.130.0-255,4320,6301,8,91023
23038,5.6e-05,172.31.36.0-255,66,6367,8,91023
23039,0.000182,74.125.130.0-255,1484,7851,8,91023
23040,0.000242,74.125.130.0-255,2902,10753,8,91023
23041,0.000246,172.31.36.0-255,66,10819,8,91023
23042,0.000364,74.125.130.0-255,4320,15139,8,91023
23043,0.00037,172.31.36.0-255,66,15205,8,91023
23044,0.000383,74.125.130.0-255,2056,17261,8,91023
23045,0.000385,172.31.36.0-255,66,17327,8,91023
23046,0.000622,172.31.36.0-255,66,17393,8,91023
23047,0.000642,74.125.130.0-255,4320,21713,8,91023
23048,0.000815,172.31.36.0-255,66,21779,8,91023
23049,0.002093,172.31.36.0-255,66,21845,8,91023
23050,0.002113,74.125.130.0-255,4320,26165,8,91023
23051,0.002338,74.125.130.0-255,4320,30485,8,91023
23052,0.00251,74.125.130.0-255,4320,34805,8,91023
23053,0.003263,74.125.130.0-255,2902,37707,8,91023
23054,0.003298,74.125.130.0-255,1484,39191,8,91023
23055,0.003842,74.125.130.0-255,1484,40675,8,91023
23056,0.003859,74.125.130.0-255,5738,46413,8,91023
23057,0.004112,74.125.130.0-255,4320,50733,8,91023
23058,0.004129,74.125.130.0-255,7156,57889,8,91023
23059,0.004984,172.31.36.0-255,66,57955,8,91023
23060,0.005498,172.31.36.0-255,66,58021,8,91023
23061,0.007021,172.31.36.0-255,66,58087,8,91023
23062,0.007184,74.125.130.0-255,7156,65243,8,91023
23063,0.0072,74.125.130.0-255,1756,66999,8,91023
23064,0.007351,172.31.36.0-255,66,67065,8,91023
23065,0.00752,74.125.130.0-255,7156,74221,8,91023
23066,0.007526,172.31.36.0-255,66,74287,8,91023
23067,0.007556,172.31.36.0-255,66,74353,8,91023
23068,0.007651,172.31.36.0-255,66,74419,8,91023
23069,0.007697,172.31.36.0-255,66,74485,8,91023
23070,0.008243,74.125.130.0-255,7156,81641,8,91023
23071,0.008249,172.31.36.0-255,66,81707,8,91023
23072,0.008267,74.125.130.0-255,1690,83397,8,91023
23073,0.00827,172.31.36.0-255,66,83463,8,91023
23074,0.009403,172.31.36.0-255,66,83529,8,91023
23075,0.009444,172.31.36.0-255,66,83595,8,91023
23076,0.009633,172.31.36.0-255,66,83661,8,91023
23077,0.009666,172.31.36.0-255,66,83727,8,91023
23078,0.010217,172.31.36.0-255,66,83793,8,91023
23079,0.010265,172.31.36.0-255,66,83859,8,91023
23080,0.010938,172.31.36.0-255,66,83925,8,91023
23081,0.013119,172.31.36.0-255,66,83991,8,91023
23082,0.01483,172.31.36.0-255,105,84096,8,91023
23083,0.016828,74.125.130.0-255,66,84162,8,91023
23084,0.036421,172.31.36.0-255,172,84334,8,91023
23085,0.03645,172.31.36.0-255,1112,85446,8,91023
23086,0.036518,172.31.36.0-255,1514,86960,8,91023
23087,0.03652,172.31.36.0-255,1514,88474,8,91023
23088,0.036525,172.31.36.0-255,1514,89988,8,91023
23089,0.036527,172.31.36.0-255,771,90759,8,91023
23090,0.037981,104.244.42.0-255,66,90825,8,91023
23091,0.038061,104.244.42.0-255,66,90891,8,91023
23092,0.038096,104.244.42.0-255,66,90957,8,91023
23093,0.038099,104.244.42.0-255,66,91023,8,91023
23094,0.0,74.125.24.0-255,153,153,8,308528
23095,2.9e-05,172.31.36.0-255,66,219,8,308528
23096,3.5e-05,74.125.24.0-255,1484,1703,8,308528
23097,3.9e-05,172.31.36.0-255,66,1769,8,308528
23098,4.5e-05,74.125.24.0-255,2902,4671,8,308528
23099,4.8e-05,172.31.36.0-255,66,4737,8,308528
23100,6.4e-05,74.125.24.0-255,7156,11893,8,308528
23101,6.7e-05,172.31.36.0-255,66,11959,8,308528
23102,7.2e-05,74.125.24.0-255,4320,16279,8,308528
23103,7.4e-05,172.31.36.0-255,66,16345,8,308528
23104,0.000114,74.125.24.0-255,6358,22703,8,308528
23105,0.000117,172.31.36.0-255,66,22769,8,308528
23106,0.000125,74.125.24.0-255,7156,29925,8,308528
23107,0.000127,172.31.36.0-255,66,29991,8,308528
23108,0.000152,74.125.24.0-255,1125,31116,8,308528
23109,0.000155,172.31.36.0-255,66,31182,8,308528
23110,0.000183,74.125.24.0-255,1484,32666,8,308528
23111,0.000186,172.31.36.0-255,66,32732,8,308528
23112,0.00019,74.125.24.0-255,1484,34216,8,308528
23113,0.000192,172.31.36.0-255,66,34282,8,308528
23114,0.000213,74.125.24.0-255,1484,35766,8,308528
23115,0.000216,172.31.36.0-255,66,35832,8,308528
23116,0.000228,74.125.24.0-255,5738,41570,8,308528
23117,0.000231,172.31.36.0-255,66,41636,8,308528
23118,0.000238,74.125.24.0-255,6797,48433,8,308528
23119,0.000241,172.31.36.0-255,66,48499,8,308528
23120,0.000279,172.31.36.0-255,66,48565,8,308528
23121,0.000284,74.125.24.0-255,2816,51381,8,308528
23122,0.000286,172.31.36.0-255,66,51447,8,308528
23123,0.000459,74.125.24.0-255,134,51581,8,308528
23124,0.000464,172.31.36.0-255,66,51647,8,308528
23125,0.000483,74.125.24.0-255,346,51993,8,308528
23126,0.000703,74.125.24.0-255,1484,53477,8,308528
23127,0.000707,172.31.36.0-255,66,53543,8,308528
23128,0.000712,74.125.24.0-255,2902,56445,8,308528
23129,0.000714,172.31.36.0-255,66,56511,8,308528
23130,0.000728,74.125.24.0-255,5738,62249,8,308528
23131,0.000731,172.31.36.0-255,66,62315,8,308528
23132,0.000737,74.125.24.0-255,5738,68053,8,308528
23133,0.000739,172.31.36.0-255,66,68119,8,308528
23134,0.000788,172.31.36.0-255,66,68185,8,308528
23135,0.000794,74.125.24.0-255,5020,73205,8,308528
23136,0.000796,172.31.36.0-255,66,73271,8,308528
23137,0.001839,74.125.24.0-255,1484,74755,8,308528
23138,0.001851,74.125.24.0-255,2902,77657,8,308528
23139,0.001857,172.31.36.0-255,66,77723,8,308528
23140,0.001865,74.125.24.0-255,5738,83461,8,308528
23141,0.001867,172.31.36.0-255,66,83527,8,308528
23142,0.001897,74.125.24.0-255,5738,89265,8,308528
23143,0.001899,172.31.36.0-255,66,89331,8,308528
23144,0.001936,74.125.24.0-255,7156,96487,8,308528
23145,0.001938,172.31.36.0-255,66,96553,8,308528
23146,0.001945,74.125.24.0-255,5738,102291,8,308528
23147,0.001947,172.31.36.0-255,66,102357,8,308528
23148,0.001972,74.125.24.0-255,5020,107377,8,308528
23149,0.001974,172.31.36.0-255,66,107443,8,308528
23150,0.003897,74.125.24.0-255,5738,113181,8,308528
23151,0.003906,172.31.36.0-255,66,113247,8,308528
23152,0.005861,74.125.24.0-255,5738,118985,8,308528
23153,0.005869,172.31.36.0-255,66,119051,8,308528
23154,0.007826,74.125.24.0-255,5738,124789,8,308528
23155,0.007833,172.31.36.0-255,66,124855,8,308528
23156,0.0098,74.125.24.0-255,5738,130593,8,308528
23157,0.009811,172.31.36.0-255,66,130659,8,308528
23158,0.011772,74.125.24.0-255,5738,136397,8,308528
23159,0.011784,172.31.36.0-255,66,136463,8,308528
23160,0.013748,74.125.24.0-255,5738,142201,8,308528
23161,0.013764,172.31.36.0-255,66,142267,8,308528
23162,0.015726,74.125.24.0-255,5738,148005,8,308528
23163,0.01574,172.31.36.0-255,66,148071,8,308528
23164,0.017699,74.125.24.0-255,5738,153809,8,308528
23165,0.017712,172.31.36.0-255,66,153875,8,308528
23166,0.019666,74.125.24.0-255,5738,159613,8,308528
23167,0.019678,172.31.36.0-255,66,159679,8,308528
23168,0.021632,74.125.24.0-255,5738,165417,8,308528
23169,0.021644,172.31.36.0-255,66,165483,8,308528
23170,0.023606,74.125.24.0-255,5738,171221,8,308528
23171,0.023617,172.31.36.0-255,66,171287,8,308528
23172,0.025552,74.125.24.0-255,5738,177025,8,308528
23173,0.025561,172.31.36.0-255,66,177091,8,308528
23174,0.027487,74.125.24.0-255,5738,182829,8,308528
23175,0.027497,172.31.36.0-255,66,182895,8,308528
23176,0.028476,172.31.36.0-255,172,183067,8,308528
23177,0.028506,172.31.36.0-255,1111,184178,8,308528
23178,0.028545,172.31.36.0-255,1514,185692,8,308528
23179,0.028547,172.31.36.0-255,754,186446,8,308528
23180,0.029462,74.125.24.0-255,5738,192184,8,308528
23181,0.029472,172.31.36.0-255,66,192250,8,308528
23182,0.03,104.244.42.0-255,66,192316,8,308528
23183,0.030031,104.244.42.0-255,66,192382,8,308528
23184,0.030061,104.244.42.0-255,66,192448,8,308528
23185,0.031399,74.125.24.0-255,5738,198186,8,308528
23186,0.031407,172.31.36.0-255,66,198252,8,308528
23187,0.033344,74.125.24.0-255,5738,203990,8,308528
23188,0.033354,172.31.36.0-255,66,204056,8,308528
23189,0.035311,74.125.24.0-255,5738,209794,8,308528
23190,0.035318,172.31.36.0-255,66,209860,8,308528
23191,0.03725,74.125.24.0-255,5738,215598,8,308528
23192,0.037257,172.31.36.0-255,66,215664,8,308528
23193,0.039182,74.125.24.0-255,5738,221402,8,308528
23194,0.03919,172.31.36.0-255,66,221468,8,308528
23195,0.041198,74.125.24.0-255,5738,227206,8,308528
23196,0.041211,172.31.36.0-255,66,227272,8,308528
23197,0.043152,74.125.24.0-255,5738,233010,8,308528
23198,0.043161,172.31.36.0-255,66,233076,8,308528
23199,0.045114,74.125.24.0-255,5738,238814,8,308528
23200,0.045123,172.31.36.0-255,66,238880,8,308528
23201,0.04707,74.125.24.0-255,5738,244618,8,308528
23202,0.047077,172.31.36.0-255,66,244684,8,308528
23203,0.049028,74.125.24.0-255,5738,250422,8,308528
23204,0.049036,172.31.36.0-255,66,250488,8,308528
23205,0.050986,74.125.24.0-255,5738,256226,8,308528
23206,0.050994,172.31.36.0-255,66,256292,8,308528
23207,0.052939,74.125.24.0-255,5738,262030,8,308528
23208,0.05295,172.31.36.0-255,66,262096,8,308528
23209,0.054924,74.125.24.0-255,5738,267834,8,308528
23210,0.054931,172.31.36.0-255,66,267900,8,308528
23211,0.056885,74.125.24.0-255,5738,273638,8,308528
23212,0.056892,172.31.36.0-255,66,273704,8,308528
23213,0.058835,74.125.24.0-255,5738,279442,8,308528
23214,0.058843,172.31.36.0-255,66,279508,8,308528
23215,0.060798,74.125.24.0-255,5738,285246,8,308528
23216,0.060805,172.31.36.0-255,66,285312,8,308528
23217,0.0628,74.125.24.0-255,5738,291050,8,308528
23218,0.062806,172.31.36.0-255,66,291116,8,308528
23219,0.064757,74.125.24.0-255,5738,296854,8,308528
23220,0.064763,172.31.36.0-255,66,296920,8,308528
23221,0.066685,74.125.24.0-255,5738,302658,8,308528
23222,0.06669,172.31.36.0-255,66,302724,8,308528
23223,0.068609,74.125.24.0-255,5738,308462,8,308528
23224,0.068614,172.31.36.0-255,66,308528,8,308528
23225,0.0,74.125.24.0-255,152,152,8,333295
23226,2.2e-05,172.31.36.0-255,66,218,8,333295
23227,2.9e-05,74.125.24.0-255,1484,1702,8,333295
23228,3.3e-05,172.31.36.0-255,66,1768,8,333295
23229,3.9e-05,74.125.24.0-255,2902,4670,8,333295
23230,4.2e-05,172.31.36.0-255,66,4736,8,333295
23231,4.5e-05,74.125.24.0-255,1484,6220,8,333295
23232,4.7e-05,172.31.36.0-255,66,6286,8,333295
23233,5.5e-05,74.125.24.0-255,5738,12024,8,333295
23234,5.8e-05,172.31.36.0-255,66,12090,8,333295
23235,6.2e-05,74.125.24.0-255,2015,14105,8,333295
23236,6.5e-05,172.31.36.0-255,66,14171,8,333295
23237,0.000151,74.125.24.0-255,1484,15655,8,333295
23238,0.000155,172.31.36.0-255,66,15721,8,333295
23239,0.000158,74.125.24.0-255,1484,17205,8,333295
23240,0.00016,172.31.36.0-255,66,17271,8,333295
23241,0.000182,74.125.24.0-255,1484,18755,8,333295
23242,0.000185,172.31.36.0-255,66,18821,8,333295
23243,0.000192,74.125.24.0-255,5738,24559,8,333295
23244,0.000195,172.31.36.0-255,66,24625,8,333295
23245,0.000212,74.125.24.0-255,7156,31781,8,333295
23246,0.000214,172.31.36.0-255,66,31847,8,333295
23247,0.000232,74.125.24.0-255,6797,38644,8,333295
23248,0.000235,172.31.36.0-255,66,38710,8,333295
23249,0.000242,74.125.24.0-255,7156,45866,8,333295
23250,0.000245,172.31.36.0-255,66,45932,8,333295
23251,0.000284,172.31.36.0-255,66,45998,8,333295
23252,0.000313,172.31.36.0-255,66,46064,8,333295
23253,0.000315,74.125.24.0-255,396,46460,8,333295
23254,0.000317,172.31.36.0-255,66,46526,8,333295
23255,0.000353,74.125.24.0-255,109,46635,8,333295
23256,0.000481,74.125.24.0-255,1484,48119,8,333295
23257,0.000487,74.125.24.0-255,2902,51021,8,333295
23258,0.000508,74.125.24.0-255,5738,56759,8,333295
23259,0.000533,74.125.24.0-255,2902,59661,8,333295
23260,0.00054,172.31.36.0-255,66,59727,8,333295
23261,0.000583,74.125.24.0-255,4320,64047,8,333295
23262,0.000588,172.31.36.0-255,66,64113,8,333295
23263,0.000603,74.125.24.0-255,6708,70821,8,333295
23264,0.00063,172.31.36.0-255,66,70887,8,333295
23265,0.001112,74.125.24.0-255,1484,72371,8,333295
23266,0.001118,74.125.24.0-255,2902,75273,8,333295
23267,0.001121,172.31.36.0-255,66,75339,8,333295
23268,0.001148,74.125.24.0-255,5738,81077,8,333295
23269,0.001156,172.31.36.0-255,66,81143,8,333295
23270,0.001189,74.125.24.0-255,4320,85463,8,333295
23271,0.001212,74.125.24.0-255,766,86229,8,333295
23272,0.001217,172.31.36.0-255,66,86295,8,333295
23273,0.001717,74.125.24.0-255,1484,87779,8,333295
23274,0.001723,74.125.24.0-255,2902,90681,8,333295
23275,0.001727,172.31.36.0-255,66,90747,8,333295
23276,0.001734,74.125.24.0-255,5738,96485,8,333295
23277,0.001737,74.125.24.0-255,1484,97969,8,333295
23278,0.00175,74.125.24.0-255,1484,99453,8,333295
23279,0.001763,74.125.24.0-255,2902,102355,8,333295
23280,0.00177,172.31.36.0-255,66,102421,8,333295
23281,0.001782,74.125.24.0-255,7156,109577,8,333295
23282,0.001792,172.31.36.0-255,66,109643,8,333295
23283,0.001805,74.125.24.0-255,5738,115381,8,333295
23284,0.001821,74.125.24.0-255,5020,120401,8,333295
23285,0.001831,172.31.36.0-255,66,120467,8,333295
23286,0.00185,74.125.24.0-255,1484,121951,8,333295
23287,0.001866,74.125.24.0-255,2902,124853,8,333295
23288,0.001872,74.125.24.0-255,5738,130591,8,333295
23289,0.001877,172.31.36.0-255,66,130657,8,333295
23290,0.001888,74.125.24.0-255,4320,134977,8,333295
23291,0.001925,172.31.36.0-255,66,135043,8,333295
23292,0.001947,74.125.24.0-255,7156,142199,8,333295
23293,0.001962,74.125.24.0-255,3602,145801,8,333295
23294,0.001965,172.31.36.0-255,66,145867,8,333295
23295,0.00197,172.31.36.0-255,66,145933,8,333295
23296,0.001999,74.125.24.0-255,1484,147417,8,333295
23297,0.002004,74.125.24.0-255,2902,150319,8,333295
23298,0.002019,172.31.36.0-255,66,150385,8,333295
23299,0.002033,74.125.24.0-255,5738,156123,8,333295
23300,0.00205,74.125.24.0-255,7156,163279,8,333295
23301,0.002065,74.125.24.0-255,2902,166181,8,333295
23302,0.002068,172.31.36.0-255,66,166247,8,333295
23303,0.002073,172.31.36.0-255,66,166313,8,333295
23304,0.002102,74.125.24.0-255,5738,172051,8,333295
23305,0.002133,172.31.36.0-255,66,172117,8,333295
23306,0.002229,74.125.24.0-255,1484,173601,8,333295
23307,0.002233,74.125.24.0-255,2902,176503,8,333295
23308,0.002248,74.125.24.0-255,4320,180823,8,333295
23309,0.002265,74.125.24.0-255,1484,182307,8,333295
23310,0.002325,74.125.24.0-255,2902,185209,8,333295
23311,0.002336,74.125.24.0-255,766,185975,8,333295
23312,0.010238,172.31.36.0-255,66,186041,8,333295
23313,0.011339,74.125.24.0-255,1484,187525,8,333295
23314,0.012512,74.125.24.0-255,4320,191845,8,333295
23315,0.012523,172.31.36.0-255,66,191911,8,333295
23316,0.01478,74.125.24.0-255,5738,197649,8,333295
23317,0.014795,172.31.36.0-255,66,197715,8,333295
23318,0.017067,74.125.24.0-255,5738,203453,8,333295
23319,0.017075,172.31.36.0-255,66,203519,8,333295
23320,0.019331,74.125.24.0-255,5738,209257,8,333295
23321,0.019338,172.31.36.0-255,66,209323,8,333295
23322,0.021623,74.125.24.0-255,5738,215061,8,333295
23323,0.021631,172.31.36.0-255,66,215127,8,333295
23324,0.023893,74.125.24.0-255,5738,220865,8,333295
23325,0.0239,172.31.36.0-255,66,220931,8,333295
23326,0.02616,74.125.24.0-255,5738,226669,8,333295
23327,0.026171,172.31.36.0-255,66,226735,8,333295
23328,0.028443,74.125.24.0-255,5738,232473,8,333295
23329,0.02845,172.31.36.0-255,66,232539,8,333295
23330,0.030704,74.125.24.0-255,5738,238277,8,333295
23331,0.030712,172.31.36.0-255,66,238343,8,333295
23332,0.032979,74.125.24.0-255,5738,244081,8,333295
23333,0.032985,172.31.36.0-255,66,244147,8,333295
23334,0.035239,74.125.24.0-255,5738,249885,8,333295
23335,0.035247,172.31.36.0-255,66,249951,8,333295
23336,0.037519,74.125.24.0-255,5738,255689,8,333295
23337,0.037526,172.31.36.0-255,66,255755,8,333295
23338,0.039794,74.125.24.0-255,5738,261493,8,333295
23339,0.039802,172.31.36.0-255,66,261559,8,333295
23340,0.04205,74.125.24.0-255,5738,267297,8,333295
23341,0.042057,172.31.36.0-255,66,267363,8,333295
23342,0.044317,74.125.24.0-255,5738,273101,8,333295
23343,0.044326,172.31.36.0-255,66,273167,8,333295
23344,0.046617,74.125.24.0-255,5738,278905,8,333295
23345,0.046626,172.31.36.0-255,66,278971,8,333295
23346,0.048903,74.125.24.0-255,5738,284709,8,333295
23347,0.048916,172.31.36.0-255,66,284775,8,333295
23348,0.051174,74.125.24.0-255,5738,290513,8,333295
23349,0.051182,172.31.36.0-255,66,290579,8,333295
23350,0.051974,172.31.36.0-255,172,290751,8,333295
23351,0.052008,172.31.36.0-255,1111,291862,8,333295
23352,0.05208,172.31.36.0-255,1514,293376,8,333295
23353,0.052082,172.31.36.0-255,1369,294745,8,333295
23354,0.053439,74.125.24.0-255,5738,300483,8,333295
23355,0.053446,172.31.36.0-255,66,300549,8,333295
23356,0.053488,104.244.42.0-255,66,300615,8,333295
23357,0.053551,104.244.42.0-255,66,300681,8,333295
23358,0.053625,104.244.42.0-255,66,300747,8,333295
23359,0.05571,74.125.24.0-255,5738,306485,8,333295
23360,0.055716,172.31.36.0-255,66,306551,8,333295
23361,0.057977,74.125.24.0-255,5738,312289,8,333295
23362,0.057983,172.31.36.0-255,66,312355,8,333295
23363,0.060254,74.125.24.0-255,5738,318093,8,333295
23364,0.060261,172.31.36.0-255,66,318159,8,333295
23365,0.062529,74.125.24.0-255,5738,323897,8,333295
23366,0.062534,172.31.36.0-255,66,323963,8,333295
23367,0.064816,74.125.24.0-255,5738,329701,8,333295
23368,0.064822,172.31.36.0-255,66,329767,8,333295
23369,0.067101,74.125.24.0-255,3291,333058,8,333295
23370,0.067108,172.31.36.0-255,66,333124,8,333295
23371,0.067279,172.31.36.0-255,105,333229,8,333295
23372,0.069495,74.125.24.0-255,66,333295,8,333295
23373,0.0,74.125.68.0-255,165,165,8,361769
23374,1.2e-05,172.31.36.0-255,66,231,8,361769
23375,1.9e-05,74.125.68.0-255,1484,1715,8,361769
23376,2.3e-05,172.31.36.0-255,66,1781,8,361769
23377,2.9e-05,74.125.68.0-255,2902,4683,8,361769
23378,3.3e-05,172.31.36.0-255,66,4749,8,361769
23379,5.7e-05,74.125.68.0-255,5738,10487,8,361769
23380,6.1e-05,172.31.36.0-255,66,10553,8,361769
23381,7.4e-05,74.125.68.0-255,1484,12037,8,361769
23382,7.6e-05,172.31.36.0-255,66,12103,8,361769
23383,8.2e-05,74.125.68.0-255,4320,16423,8,361769
23384,8.5e-05,172.31.36.0-255,66,16489,8,361769
23385,0.00011,74.125.68.0-255,3504,19993,8,361769
23386,0.000113,172.31.36.0-255,66,20059,8,361769
23387,0.000123,172.31.36.0-255,66,20125,8,361769
23388,0.000145,74.125.68.0-255,1484,21609,8,361769
23389,0.000147,172.31.36.0-255,66,21675,8,361769
23390,0.000151,74.125.68.0-255,1125,22800,8,361769
23391,0.000153,172.31.36.0-255,66,22866,8,361769
23392,0.000175,74.125.68.0-255,1484,24350,8,361769
23393,0.000177,172.31.36.0-255,66,24416,8,361769
23394,0.0002,74.125.68.0-255,4320,28736,8,361769
23395,0.000202,172.31.36.0-255,66,28802,8,361769
23396,0.000206,74.125.68.0-255,2902,31704,8,361769
23397,0.000208,172.31.36.0-255,66,31770,8,361769
23398,0.000213,74.125.68.0-255,4320,36090,8,361769
23399,0.000215,172.31.36.0-255,66,36156,8,361769
23400,0.000261,74.125.68.0-255,3961,40117,8,361769
23401,0.000264,172.31.36.0-255,66,40183,8,361769
23402,0.000819,74.125.68.0-255,1484,41667,8,361769
23403,0.000824,172.31.36.0-255,66,41733,8,361769
23404,0.00083,74.125.68.0-255,2902,44635,8,361769
23405,0.000832,172.31.36.0-255,66,44701,8,361769
23406,0.000859,74.125.68.0-255,5738,50439,8,361769
23407,0.000862,172.31.36.0-255,66,50505,8,361769
23408,0.000867,74.125.68.0-255,2902,53407,8,361769
23409,0.000869,172.31.36.0-255,66,53473,8,361769
23410,0.000898,74.125.68.0-255,3961,57434,8,361769
23411,0.0009,172.31.36.0-255,66,57500,8,361769
23412,0.000927,74.125.68.0-255,1484,58984,8,361769
23413,0.000942,74.125.68.0-255,2902,61886,8,361769
23414,0.000946,172.31.36.0-255,66,61952,8,361769
23415,0.00097,74.125.68.0-255,5738,67690,8,361769
23416,0.000973,172.31.36.0-255,66,67756,8,361769
23417,0.000977,74.125.68.0-255,2902,70658,8,361769
23418,0.000979,172.31.36.0-255,66,70724,8,361769
23419,0.000985,74.125.68.0-255,3961,74685,8,361769
23420,0.000987,172.31.36.0-255,66,74751,8,361769
23421,0.001457,74.125.68.0-255,1484,76235,8,361769
23422,0.001468,74.125.68.0-255,2902,79137,8,361769
23423,0.001472,172.31.36.0-255,66,79203,8,361769
23424,0.001476,74.125.68.0-255,1484,80687,8,361769
23425,0.001498,74.125.68.0-255,1484,82171,8,361769
23426,0.0015,172.31.36.0-255,66,82237,8,361769
23427,0.00152,74.125.68.0-255,1484,83721,8,361769
23428,0.001527,74.125.68.0-255,5738,89459,8,361769
23429,0.001529,172.31.36.0-255,66,89525,8,361769
23430,0.001535,74.125.68.0-255,3961,93486,8,361769
23431,0.001537,172.31.36.0-255,66,93552,8,361769
23432,0.001543,74.125.68.0-255,4320,97872,8,361769
23433,0.001545,172.31.36.0-255,66,97938,8,361769
23434,0.001571,74.125.68.0-255,5738,103676,8,361769
23435,0.001573,172.31.36.0-255,66,103742,8,361769
23436,0.001597,74.125.68.0-255,4320,108062,8,361769
23437,0.0016,172.31.36.0-255,66,108128,8,361769
23438,0.001605,74.125.68.0-255,2902,111030,8,361769
23439,0.001607,172.31.36.0-255,66,111096,8,361769
23440,0.001624,74.125.68.0-255,1484,112580,8,361769
23441,0.001666,172.31.36.0-255,66,112646,8,361769
23442,0.001669,74.125.68.0-255,766,113412,8,361769
23443,0.00171,74.125.68.0-255,646,114058,8,361769
23444,0.001757,74.125.68.0-255,1484,115542,8,361769
23445,0.00176,172.31.36.0-255,66,115608,8,361769
23446,0.001767,74.125.68.0-255,4320,119928,8,361769
23447,0.001769,172.31.36.0-255,66,119994,8,361769
23448,0.001774,74.125.68.0-255,2902,122896,8,361769
23449,0.001776,172.31.36.0-255,66,122962,8,361769
23450,0.001803,74.125.68.0-255,5738,128700,8,361769
23451,0.001806,172.31.36.0-255,66,128766,8,361769
23452,0.001818,172.31.36.0-255,66,128832,8,361769
23453,0.00187,172.31.36.0-255,66,128898,8,361769
23454,0.001925,74.125.68.0-255,1484,130382,8,361769
23455,0.001948,74.125.68.0-255,2902,133284,8,361769
23456,0.001951,172.31.36.0-255,66,133350,8,361769
23457,0.001955,74.125.68.0-255,1484,134834,8,361769
23458,0.001975,74.125.68.0-255,4320,139154,8,361769
23459,0.001978,172.31.36.0-255,66,139220,8,361769
23460,0.001982,74.125.68.0-255,2902,142122,8,361769
23461,0.001984,172.31.36.0-255,66,142188,8,361769
23462,0.001987,74.125.68.0-255,1484,143672,8,361769
23463,0.002011,74.125.68.0-255,2902,146574,8,361769
23464,0.002013,172.31.36.0-255,66,146640,8,361769
23465,0.002016,74.125.68.0-255,1484,148124,8,361769
23466,0.002036,74.125.68.0-255,7156,155280,8,361769
23467,0.002038,172.31.36.0-255,66,155346,8,361769
23468,0.002043,74.125.68.0-255,2902,158248,8,361769
23469,0.002045,172.31.36.0-255,66,158314,8,361769
23470,0.002089,74.125.68.0-255,5020,163334,8,361769
23471,0.002092,172.31.36.0-255,66,163400,8,361769
23472,0.002127,74.125.68.0-255,4320,167720,8,361769
23473,0.002131,172.31.36.0-255,66,167786,8,361769
23474,0.002148,74.125.68.0-255,1484,169270,8,361769
23475,0.002155,74.125.68.0-255,5738,175008,8,361769
23476,0.002158,172.31.36.0-255,66,175074,8,361769
23477,0.002173,74.125.68.0-255,1484,176558,8,361769
23478,0.002196,74.125.68.0-255,5738,182296,8,361769
23479,0.002199,172.31.36.0-255,66,182362,8,361769
23480,0.002207,74.125.68.0-255,7156,189518,8,361769
23481,0.00221,172.31.36.0-255,66,189584,8,361769
23482,0.00224,74.125.68.0-255,4320,193904,8,361769
23483,0.002243,172.31.36.0-255,66,193970,8,361769
23484,0.002263,74.125.68.0-255,3602,197572,8,361769
23485,0.002267,172.31.36.0-255,66,197638,8,361769
23486,0.002278,172.31.36.0-255,66,197704,8,361769
23487,0.00232,172.31.36.0-255,66,197770,8,361769
23488,0.004601,74.125.68.0-255,5738,203508,8,361769
23489,0.004609,172.31.36.0-255,66,203574,8,361769
23490,0.006896,74.125.68.0-255,5738,209312,8,361769
23491,0.006903,172.31.36.0-255,66,209378,8,361769
23492,0.009185,74.125.68.0-255,5738,215116,8,361769
23493,0.009192,172.31.36.0-255,66,215182,8,361769
23494,0.011513,74.125.68.0-255,5738,220920,8,361769
23495,0.011521,172.31.36.0-255,66,220986,8,361769
23496,0.013813,74.125.68.0-255,5738,226724,8,361769
23497,0.013823,172.31.36.0-255,66,226790,8,361769
23498,0.01611,74.125.68.0-255,5738,232528,8,361769
23499,0.016118,172.31.36.0-255,66,232594,8,361769
23500,0.018395,74.125.68.0-255,5738,238332,8,361769
23501,0.018402,172.31.36.0-255,66,238398,8,361769
23502,0.020689,74.125.68.0-255,5738,244136,8,361769
23503,0.020697,172.31.36.0-255,66,244202,8,361769
23504,0.022995,74.125.68.0-255,5738,249940,8,361769
23505,0.023004,172.31.36.0-255,66,250006,8,361769
23506,0.025294,74.125.68.0-255,5738,255744,8,361769
23507,0.025306,172.31.36.0-255,66,255810,8,361769
23508,0.027597,74.125.68.0-255,5738,261548,8,361769
23509,0.027606,172.31.36.0-255,66,261614,8,361769
23510,0.029881,74.125.68.0-255,5738,267352,8,361769
23511,0.029888,172.31.36.0-255,66,267418,8,361769
23512,0.032188,74.125.68.0-255,5738,273156,8,361769
23513,0.032197,172.31.36.0-255,66,273222,8,361769
23514,0.034487,74.125.68.0-255,4320,277542,8,361769
23515,0.034498,172.31.36.0-255,66,277608,8,361769
23516,0.034517,74.125.68.0-255,1484,279092,8,361769
23517,0.036786,74.125.68.0-255,4320,283412,8,361769
23518,0.036797,172.31.36.0-255,66,283478,8,361769
23519,0.039102,74.125.68.0-255,5738,289216,8,361769
23520,0.039111,172.31.36.0-255,66,289282,8,361769
23521,0.041404,74.125.68.0-255,5738,295020,8,361769
23522,0.041413,172.31.36.0-255,66,295086,8,361769
23523,0.043715,74.125.68.0-255,5738,300824,8,361769
23524,0.043724,172.31.36.0-255,66,300890,8,361769
23525,0.044607,172.31.36.0-255,172,301062,8,361769
23526,0.044638,172.31.36.0-255,1111,302173,8,361769
23527,0.044698,172.31.36.0-255,571,302744,8,361769
23528,0.046005,74.125.68.0-255,5738,308482,8,361769
23529,0.046012,172.31.36.0-255,66,308548,8,361769
23530,0.04614,104.244.42.0-255,66,308614,8,361769
23531,0.046154,104.244.42.0-255,66,308680,8,361769
23532,0.046243,104.244.42.0-255,66,308746,8,361769
23533,0.048315,74.125.68.0-255,5738,314484,8,361769
23534,0.048322,172.31.36.0-255,66,314550,8,361769
23535,0.050617,74.125.68.0-255,5738,320288,8,361769
23536,0.050624,172.31.36.0-255,66,320354,8,361769
23537,0.052926,74.125.68.0-255,5738,326092,8,361769
23538,0.052932,172.31.36.0-255,66,326158,8,361769
23539,0.055225,74.125.68.0-255,5738,331896,8,361769
23540,0.055232,172.31.36.0-255,66,331962,8,361769
23541,0.057527,74.125.68.0-255,5738,337700,8,361769
23542,0.057533,172.31.36.0-255,66,337766,8,361769
23543,0.059834,74.125.68.0-255,5738,343504,8,361769
23544,0.059842,172.31.36.0-255,66,343570,8,361769
23545,0.062132,74.125.68.0-255,5738,349308,8,361769
23546,0.062139,172.31.36.0-255,66,349374,8,361769
23547,0.064463,74.125.68.0-255,5738,355112,8,361769
23548,0.064469,172.31.36.0-255,66,355178,8,361769
23549,0.066783,74.125.68.0-255,5738,360916,8,361769
23550,0.06679,172.31.36.0-255,66,360982,8,361769
23551,0.069056,74.125.68.0-255,616,361598,8,361769
23552,0.069197,172.31.36.0-255,66,361664,8,361769
23553,0.069234,172.31.36.0-255,105,361769,8,361769
23554,0.0,172.217.194.0-255,288,288,8,130042
23555,3.4e-05,172.31.36.0-255,66,354,8,130042
23556,4e-05,172.217.194.0-255,1484,1838,8,130042
23557,4.4e-05,172.31.36.0-255,66,1904,8,130042
23558,5e-05,172.217.194.0-255,4320,6224,8,130042
23559,6e-05,172.31.36.0-255,66,6290,8,130042
23560,7.1e-05,172.31.36.0-255,66,6356,8,130042
23561,8.3e-05,172.31.36.0-255,66,6422,8,130042
23562,0.0001,172.217.194.0-255,2902,9324,8,130042
23563,0.000103,172.31.36.0-255,66,9390,8,130042
23564,0.000113,172.217.194.0-255,3961,13351,8,130042
23565,0.000116,172.31.36.0-255,66,13417,8,130042
23566,0.000162,172.217.194.0-255,1484,14901,8,130042
23567,0.000165,172.31.36.0-255,66,14967,8,130042
23568,0.00017,172.217.194.0-255,2902,17869,8,130042
23569,0.000172,172.31.36.0-255,66,17935,8,130042
23570,0.000201,172.217.194.0-255,5738,23673,8,130042
23571,0.000208,172.31.36.0-255,66,23739,8,130042
23572,0.000219,172.31.36.0-255,66,23805,8,130042
23573,0.000311,172.31.36.0-255,66,23871,8,130042
23574,0.000341,172.217.194.0-255,2496,26367,8,130042
23575,0.000344,172.31.36.0-255,66,26433,8,130042
23576,0.000347,172.217.194.0-255,366,26799,8,130042
23577,0.000351,172.31.36.0-255,66,26865,8,130042
23578,0.000411,172.217.194.0-255,1484,28349,8,130042
23579,0.000415,172.31.36.0-255,66,28415,8,130042
23580,0.00042,172.217.194.0-255,2902,31317,8,130042
23581,0.000423,172.31.36.0-255,66,31383,8,130042
23582,0.000435,172.217.194.0-255,5738,37121,8,130042
23583,0.000438,172.31.36.0-255,66,37187,8,130042
23584,0.000441,172.217.194.0-255,1484,38671,8,130042
23585,0.000485,172.31.36.0-255,66,38737,8,130042
23586,0.000505,172.31.36.0-255,66,38803,8,130042
23587,0.000547,172.31.36.0-255,66,38869,8,130042
23588,0.000569,172.31.36.0-255,66,38935,8,130042
23589,0.000576,172.217.194.0-255,6438,45373,8,130042
23590,0.000579,172.31.36.0-255,66,45439,8,130042
23591,0.00062,172.217.194.0-255,7156,52595,8,130042
23592,0.000625,172.31.36.0-255,66,52661,8,130042
23593,0.000631,172.217.194.0-255,5738,58399,8,130042
23594,0.000636,172.31.36.0-255,66,58465,8,130042
23595,0.000659,172.217.194.0-255,5738,64203,8,130042
23596,0.000663,172.31.36.0-255,66,64269,8,130042
23597,0.000726,172.31.36.0-255,66,64335,8,130042
23598,0.000733,172.217.194.0-255,6438,70773,8,130042
23599,0.000736,172.31.36.0-255,66,70839,8,130042
23600,0.000996,172.217.194.0-255,1484,72323,8,130042
23601,0.001004,172.217.194.0-255,2902,75225,8,130042
23602,0.001009,172.31.36.0-255,66,75291,8,130042
23603,0.001016,172.217.194.0-255,5738,81029,8,130042
23604,0.001018,172.31.36.0-255,66,81095,8,130042
23605,0.001062,172.217.194.0-255,1484,82579,8,130042
23606,0.001096,172.217.194.0-255,4320,86899,8,130042
23607,0.0011,172.31.36.0-255,66,86965,8,130042
23608,0.001119,172.31.36.0-255,66,87031,8,130042
23609,0.001125,172.217.194.0-255,5020,92051,8,130042
23610,0.001127,172.31.36.0-255,66,92117,8,130042
23611,0.00118,172.217.194.0-255,1484,93601,8,130042
23612,0.001186,172.217.194.0-255,2902,96503,8,130042
23613,0.001189,172.31.36.0-255,66,96569,8,130042
23614,0.001192,172.217.194.0-255,1484,98053,8,130042
23615,0.001224,172.217.194.0-255,4320,102373,8,130042
23616,0.001229,172.31.36.0-255,66,102439,8,130042
23617,0.001248,172.31.36.0-255,66,102505,8,130042
23618,0.001254,172.217.194.0-255,5738,108243,8,130042
23619,0.001257,172.31.36.0-255,66,108309,8,130042
23620,0.001308,172.31.36.0-255,66,108375,8,130042
23621,0.001342,172.31.36.0-255,66,108441,8,130042
23622,0.00138,172.31.36.0-255,66,108507,8,130042
23623,0.001422,172.31.36.0-255,66,108573,8,130042
23624,0.001453,172.31.36.0-255,66,108639,8,130042
23625,0.00146,172.217.194.0-255,5738,114377,8,130042
23626,0.001462,172.31.36.0-255,66,114443,8,130042
23627,0.001514,172.217.194.0-255,5738,120181,8,130042
23628,0.001514,172.31.36.0-255,66,120247,8,130042
23629,0.001518,172.31.36.0-255,66,120313,8,130042
23630,0.001583,172.31.36.0-255,66,120379,8,130042
23631,0.001587,172.217.194.0-255,1484,121863,8,130042
23632,0.001613,172.31.36.0-255,66,121929,8,130042
23633,0.001616,172.217.194.0-255,105,122034,8,130042
23634,0.007839,172.31.36.0-255,66,122100,8,130042
23635,0.007882,172.31.36.0-255,105,122205,8,130042
23636,0.010219,172.217.194.0-255,66,122271,8,130042
23637,0.038139,172.31.36.0-255,172,122443,8,130042
23638,0.038176,172.31.36.0-255,1112,123555,8,130042
23639,0.038244,172.31.36.0-255,1514,125069,8,130042
23640,0.038246,172.31.36.0-255,1514,126583,8,130042
23641,0.038251,172.31.36.0-255,1514,128097,8,130042
23642,0.038253,172.31.36.0-255,1514,129611,8,130042
23643,0.03827,172.31.36.0-255,167,129778,8,130042
23644,0.039703,104.244.42.0-255,66,129844,8,130042
23645,0.039735,104.244.42.0-255,66,129910,8,130042
23646,0.039794,104.244.42.0-255,66,129976,8,130042
23647,0.039809,104.244.42.0-255,66,130042,8,130042
23648,0.0,74.125.24.0-255,153,153,8,219256
23649,2.4e-05,172.31.36.0-255,66,219,8,219256
23650,3.2e-05,74.125.24.0-255,1484,1703,8,219256
23651,3.7e-05,172.31.36.0-255,66,1769,8,219256
23652,4.3e-05,74.125.24.0-255,2902,4671,8,219256
23653,4.6e-05,172.31.36.0-255,66,4737,8,219256
23654,5.4e-05,74.125.24.0-255,7156,11893,8,219256
23655,5.7e-05,172.31.36.0-255,66,11959,8,219256
23656,7.1e-05,172.31.36.0-255,66,12025,8,219256
23657,0.000115,74.125.24.0-255,6797,18822,8,219256
23658,0.000118,172.31.36.0-255,66,18888,8,219256
23659,0.000153,74.125.24.0-255,1484,20372,8,219256
23660,0.000156,172.31.36.0-255,66,20438,8,219256
23661,0.00016,74.125.24.0-255,2902,23340,8,219256
23662,0.000162,172.31.36.0-255,66,23406,8,219256
23663,0.000169,74.125.24.0-255,4320,27726,8,219256
23664,0.000171,172.31.36.0-255,66,27792,8,219256
23665,0.000204,74.125.24.0-255,1484,29276,8,219256
23666,0.000206,172.31.36.0-255,66,29342,8,219256
23667,0.000218,172.31.36.0-255,66,29408,8,219256
23668,0.00023,172.31.36.0-255,66,29474,8,219256
23669,0.000259,74.125.24.0-255,4239,33713,8,219256
23670,0.000262,172.31.36.0-255,66,33779,8,219256
23671,0.000432,74.125.24.0-255,130,33909,8,219256
23672,0.000437,172.31.36.0-255,66,33975,8,219256
23673,0.000589,74.125.24.0-255,1484,35459,8,219256
23674,0.000594,172.31.36.0-255,66,35525,8,219256
23675,0.000599,74.125.24.0-255,2902,38427,8,219256
23676,0.000602,172.31.36.0-255,66,38493,8,219256
23677,0.000609,74.125.24.0-255,5738,44231,8,219256
23678,0.000611,172.31.36.0-255,66,44297,8,219256
23679,0.000645,172.31.36.0-255,66,44363,8,219256
23680,0.000666,74.125.24.0-255,3961,48324,8,219256
23681,0.000669,172.31.36.0-255,66,48390,8,219256
23682,0.00068,172.31.36.0-255,66,48456,8,219256
23683,0.000831,74.125.24.0-255,1484,49940,8,219256
23684,0.000837,74.125.24.0-255,1484,51424,8,219256
23685,0.00084,172.31.36.0-255,66,51490,8,219256
23686,0.000861,74.125.24.0-255,1484,52974,8,219256
23687,0.000868,74.125.24.0-255,5738,58712,8,219256
23688,0.00087,172.31.36.0-255,66,58778,8,219256
23689,0.000883,172.31.36.0-255,66,58844,8,219256
23690,0.000906,74.125.24.0-255,2902,61746,8,219256
23691,0.000909,172.31.36.0-255,66,61812,8,219256
23692,0.000923,172.31.36.0-255,66,61878,8,219256
23693,0.000959,74.125.24.0-255,5738,67616,8,219256
23694,0.000962,172.31.36.0-255,66,67682,8,219256
23695,0.000977,74.125.24.0-255,5738,73420,8,219256
23696,0.00098,172.31.36.0-255,66,73486,8,219256
23697,0.000983,74.125.24.0-255,1484,74970,8,219256
23698,0.001011,172.31.36.0-255,66,75036,8,219256
23699,0.001034,74.125.24.0-255,4320,79356,8,219256
23700,0.001037,172.31.36.0-255,66,79422,8,219256
23701,0.001044,74.125.24.0-255,6438,85860,8,219256
23702,0.001047,172.31.36.0-255,66,85926,8,219256
23703,0.001076,74.125.24.0-255,1484,87410,8,219256
23704,0.001082,74.125.24.0-255,2902,90312,8,219256
23705,0.001085,172.31.36.0-255,66,90378,8,219256
23706,0.001115,74.125.24.0-255,5738,96116,8,219256
23707,0.001119,172.31.36.0-255,66,96182,8,219256
23708,0.001122,74.125.24.0-255,1484,97666,8,219256
23709,0.001143,74.125.24.0-255,4320,101986,8,219256
23710,0.001146,172.31.36.0-255,66,102052,8,219256
23711,0.001161,172.31.36.0-255,66,102118,8,219256
23712,0.001167,74.125.24.0-255,5020,107138,8,219256
23713,0.00117,172.31.36.0-255,66,107204,8,219256
23714,0.001234,74.125.24.0-255,4320,111524,8,219256
23715,0.001238,172.31.36.0-255,66,111590,8,219256
23716,0.001259,74.125.24.0-255,1484,113074,8,219256
23717,0.001273,172.31.36.0-255,66,113140,8,219256
23718,0.001294,172.31.36.0-255,66,113206,8,219256
23719,0.001306,172.31.36.0-255,66,113272,8,219256
23720,0.001526,74.125.24.0-255,1484,114756,8,219256
23721,0.001534,74.125.24.0-255,1484,116240,8,219256
23722,0.001545,172.31.36.0-255,66,116306,8,219256
23723,0.001554,74.125.24.0-255,1484,117790,8,219256
23724,0.00156,74.125.24.0-255,5738,123528,8,219256
23725,0.001563,172.31.36.0-255,66,123594,8,219256
23726,0.001567,74.125.24.0-255,2902,126496,8,219256
23727,0.001569,172.31.36.0-255,66,126562,8,219256
23728,0.00161,172.31.36.0-255,66,126628,8,219256
23729,0.001623,172.31.36.0-255,66,126694,8,219256
23730,0.001659,74.125.24.0-255,1484,128178,8,219256
23731,0.001664,74.125.24.0-255,2902,131080,8,219256
23732,0.001666,172.31.36.0-255,66,131146,8,219256
23733,0.001673,74.125.24.0-255,5738,136884,8,219256
23734,0.001675,172.31.36.0-255,66,136950,8,219256
23735,0.001699,74.125.24.0-255,4320,141270,8,219256
23736,0.001701,172.31.36.0-255,66,141336,8,219256
23737,0.001731,172.31.36.0-255,66,141402,8,219256
23738,0.001743,172.31.36.0-255,66,141468,8,219256
23739,0.0018,74.125.24.0-255,1484,142952,8,219256
23740,0.001806,74.125.24.0-255,2902,145854,8,219256
23741,0.001809,172.31.36.0-255,66,145920,8,219256
23742,0.001828,74.125.24.0-255,5738,151658,8,219256
23743,0.001831,172.31.36.0-255,66,151724,8,219256
23744,0.00186,74.125.24.0-255,7156,158880,8,219256
23745,0.001862,172.31.36.0-255,66,158946,8,219256
23746,0.001888,74.125.24.0-255,5738,164684,8,219256
23747,0.001891,172.31.36.0-255,66,164750,8,219256
23748,0.001904,172.31.36.0-255,66,164816,8,219256
23749,0.001966,74.125.24.0-255,1484,166300,8,219256
23750,0.001982,74.125.24.0-255,2902,169202,8,219256
23751,0.001986,172.31.36.0-255,66,169268,8,219256
23752,0.00201,74.125.24.0-255,5738,175006,8,219256
23753,0.002014,172.31.36.0-255,66,175072,8,219256
23754,0.002018,74.125.24.0-255,2902,177974,8,219256
23755,0.00202,172.31.36.0-255,66,178040,8,219256
23756,0.002023,74.125.24.0-255,1484,179524,8,219256
23757,0.002045,74.125.24.0-255,5738,185262,8,219256
23758,0.002048,172.31.36.0-255,66,185328,8,219256
23759,0.002051,74.125.24.0-255,1484,186812,8,219256
23760,0.002073,74.125.24.0-255,5738,192550,8,219256
23761,0.002075,172.31.36.0-255,66,192616,8,219256
23762,0.002079,74.125.24.0-255,1484,194100,8,219256
23763,0.002096,74.125.24.0-255,2902,197002,8,219256
23764,0.002099,172.31.36.0-255,66,197068,8,219256
23765,0.002118,74.125.24.0-255,2184,199252,8,219256
23766,0.00212,172.31.36.0-255,66,199318,8,219256
23767,0.002197,74.125.24.0-255,1484,200802,8,219256
23768,0.002221,74.125.24.0-255,2902,203704,8,219256
23769,0.002224,172.31.36.0-255,66,203770,8,219256
23770,0.002231,74.125.24.0-255,5738,209508,8,219256
23771,0.002233,172.31.36.0-255,66,209574,8,219256
23772,0.002262,74.125.24.0-255,7156,216730,8,219256
23773,0.002265,172.31.36.0-255,66,216796,8,219256
23774,0.0023,172.31.36.0-255,66,216862,8,219256
23775,0.002303,74.125.24.0-255,105,216967,8,219256
23776,0.009848,172.31.36.0-255,66,217033,8,219256
23777,0.009894,172.31.36.0-255,105,217138,8,219256
23778,0.011807,74.125.24.0-255,66,217204,8,219256
23779,0.039994,172.31.36.0-255,172,217376,8,219256
23780,0.04003,172.31.36.0-255,1110,218486,8,219256
23781,0.040088,172.31.36.0-255,572,219058,8,219256
23782,0.041588,104.244.42.0-255,66,219124,8,219256
23783,0.041598,104.244.42.0-255,66,219190,8,219256
23784,0.041624,104.244.42.0-255,66,219256,8,219256
23785,0.0,74.125.24.0-255,152,152,8,176162
23786,3e-05,172.31.36.0-255,66,218,8,176162
23787,3.8e-05,74.125.24.0-255,1484,1702,8,176162
23788,4.3e-05,172.31.36.0-255,66,1768,8,176162
23789,4.7e-05,74.125.24.0-255,2902,4670,8,176162
23790,5e-05,172.31.36.0-255,66,4736,8,176162
23791,6.5e-05,74.125.24.0-255,7156,11892,8,176162
23792,6.8e-05,172.31.36.0-255,66,11958,8,176162
23793,7.4e-05,74.125.24.0-255,4845,16803,8,176162
23794,7.7e-05,172.31.36.0-255,66,16869,8,176162
23795,8.3e-05,74.125.24.0-255,5738,22607,8,176162
23796,8.6e-05,172.31.36.0-255,66,22673,8,176162
23797,0.000127,172.31.36.0-255,66,22739,8,176162
23798,0.000168,74.125.24.0-255,1484,24223,8,176162
23799,0.000171,172.31.36.0-255,66,24289,8,176162
23800,0.000177,74.125.24.0-255,2902,27191,8,176162
23801,0.00018,172.31.36.0-255,66,27257,8,176162
23802,0.000189,74.125.24.0-255,1484,28741,8,176162
23803,0.000192,172.31.36.0-255,66,28807,8,176162
23804,0.000222,74.125.24.0-255,4320,33127,8,176162
23805,0.000224,172.31.36.0-255,66,33193,8,176162
23806,0.000236,172.31.36.0-255,66,33259,8,176162
23807,0.000249,172.31.36.0-255,66,33325,8,176162
23808,0.000279,74.125.24.0-255,4232,37557,8,176162
23809,0.000288,172.31.36.0-255,66,37623,8,176162
23810,0.000315,74.125.24.0-255,137,37760,8,176162
23811,0.000318,172.31.36.0-255,66,37826,8,176162
23812,0.000444,74.125.24.0-255,1484,39310,8,176162
23813,0.000449,172.31.36.0-255,66,39376,8,176162
23814,0.000455,74.125.24.0-255,2902,42278,8,176162
23815,0.000457,172.31.36.0-255,66,42344,8,176162
23816,0.00049,74.125.24.0-255,5738,48082,8,176162
23817,0.000495,172.31.36.0-255,66,48148,8,176162
23818,0.00054,172.31.36.0-255,66,48214,8,176162
23819,0.000547,74.125.24.0-255,7156,55370,8,176162
23820,0.000551,172.31.36.0-255,66,55436,8,176162
23821,0.000583,74.125.24.0-255,2800,58236,8,176162
23822,0.000586,172.31.36.0-255,66,58302,8,176162
23823,0.000772,74.125.24.0-255,1484,59786,8,176162
23824,0.000819,74.125.24.0-255,2902,62688,8,176162
23825,0.000823,172.31.36.0-255,66,62754,8,176162
23826,0.000829,74.125.24.0-255,5738,68492,8,176162
23827,0.000831,172.31.36.0-255,66,68558,8,176162
23828,0.000849,172.31.36.0-255,66,68624,8,176162
23829,0.000861,172.31.36.0-255,66,68690,8,176162
23830,0.000866,74.125.24.0-255,2184,70874,8,176162
23831,0.000868,172.31.36.0-255,66,70940,8,176162
23832,0.00131,74.125.24.0-255,1484,72424,8,176162
23833,0.001314,74.125.24.0-255,1484,73908,8,176162
23834,0.001318,172.31.36.0-255,66,73974,8,176162
23835,0.001347,74.125.24.0-255,1484,75458,8,176162
23836,0.001355,74.125.24.0-255,5738,81196,8,176162
23837,0.001358,172.31.36.0-255,66,81262,8,176162
23838,0.001372,172.31.36.0-255,66,81328,8,176162
23839,0.001391,172.31.36.0-255,66,81394,8,176162
23840,0.001739,74.125.24.0-255,1484,82878,8,176162
23841,0.001749,74.125.24.0-255,2902,85780,8,176162
23842,0.001754,172.31.36.0-255,66,85846,8,176162
23843,0.001762,74.125.24.0-255,5738,91584,8,176162
23844,0.001764,172.31.36.0-255,66,91650,8,176162
23845,0.001783,74.125.24.0-255,1484,93134,8,176162
23846,0.001816,172.31.36.0-255,66,93200,8,176162
23847,0.00182,74.125.24.0-255,1484,94684,8,176162
23848,0.001823,74.125.24.0-255,1484,96168,8,176162
23849,0.001825,172.31.36.0-255,66,96234,8,176162
23850,0.001844,74.125.24.0-255,5738,101972,8,176162
23851,0.001847,172.31.36.0-255,66,102038,8,176162
23852,0.001876,74.125.24.0-255,2184,104222,8,176162
23853,0.00188,172.31.36.0-255,66,104288,8,176162
23854,0.00195,74.125.24.0-255,1484,105772,8,176162
23855,0.001955,74.125.24.0-255,2902,108674,8,176162
23856,0.001958,172.31.36.0-255,66,108740,8,176162
23857,0.001962,74.125.24.0-255,1484,110224,8,176162
23858,0.00199,74.125.24.0-255,4320,114544,8,176162
23859,0.001992,172.31.36.0-255,66,114610,8,176162
23860,0.001999,74.125.24.0-255,7156,121766,8,176162
23861,0.002002,172.31.36.0-255,66,121832,8,176162
23862,0.002006,74.125.24.0-255,2902,124734,8,176162
23863,0.002008,172.31.36.0-255,66,124800,8,176162
23864,0.00205,172.31.36.0-255,66,124866,8,176162
23865,0.002066,172.31.36.0-255,66,124932,8,176162
23866,0.002069,74.125.24.0-255,1484,126416,8,176162
23867,0.002113,172.31.36.0-255,66,126482,8,176162
23868,0.002125,172.31.36.0-255,66,126548,8,176162
23869,0.002128,74.125.24.0-255,1484,128032,8,176162
23870,0.002154,74.125.24.0-255,2902,130934,8,176162
23871,0.002157,172.31.36.0-255,66,131000,8,176162
23872,0.002168,74.125.24.0-255,5738,136738,8,176162
23873,0.002172,172.31.36.0-255,66,136804,8,176162
23874,0.002185,172.31.36.0-255,66,136870,8,176162
23875,0.002229,74.125.24.0-255,5738,142608,8,176162
23876,0.002233,172.31.36.0-255,66,142674,8,176162
23877,0.002265,74.125.24.0-255,4320,146994,8,176162
23878,0.002267,172.31.36.0-255,66,147060,8,176162
23879,0.002283,172.31.36.0-255,66,147126,8,176162
23880,0.002294,172.31.36.0-255,66,147192,8,176162
23881,0.0023,74.125.24.0-255,7156,154348,8,176162
23882,0.002303,172.31.36.0-255,66,154414,8,176162
23883,0.002335,172.31.36.0-255,66,154480,8,176162
23884,0.002357,172.31.36.0-255,66,154546,8,176162
23885,0.002371,74.125.24.0-255,1484,156030,8,176162
23886,0.002375,172.31.36.0-255,66,156096,8,176162
23887,0.002396,74.125.24.0-255,1484,157580,8,176162
23888,0.002398,172.31.36.0-255,66,157646,8,176162
23889,0.002432,172.31.36.0-255,66,157712,8,176162
23890,0.002435,74.125.24.0-255,1484,159196,8,176162
23891,0.002453,172.31.36.0-255,66,159262,8,176162
23892,0.002457,74.125.24.0-255,2902,162164,8,176162
23893,0.002458,172.31.36.0-255,66,162230,8,176162
23894,0.002461,74.125.24.0-255,1484,163714,8,176162
23895,0.002481,74.125.24.0-255,1484,165198,8,176162
23896,0.002483,172.31.36.0-255,66,165264,8,176162
23897,0.002505,74.125.24.0-255,1540,166804,8,176162
23898,0.002507,172.31.36.0-255,66,166870,8,176162
23899,0.002548,74.125.24.0-255,105,166975,8,176162
23900,0.008049,172.31.36.0-255,101,167076,8,176162
23901,0.009409,172.31.36.0-255,105,167181,8,176162
23902,0.010316,74.125.24.0-255,66,167247,8,176162
23903,0.011686,74.125.24.0-255,66,167313,8,176162
23904,0.036269,172.31.36.0-255,188,167501,8,176162
23905,0.0363,172.31.36.0-255,955,168456,8,176162
23906,0.036347,172.31.36.0-255,1514,169970,8,176162
23907,0.036349,172.31.36.0-255,1514,171484,8,176162
23908,0.036354,172.31.36.0-255,1514,172998,8,176162
23909,0.036356,172.31.36.0-255,1514,174512,8,176162
23910,0.036374,172.31.36.0-255,1386,175898,8,176162
23911,0.037796,104.244.42.0-255,66,175964,8,176162
23912,0.037867,104.244.42.0-255,66,176030,8,176162
23913,0.037884,104.244.42.0-255,66,176096,8,176162
23914,0.037887,104.244.42.0-255,66,176162,8,176162
23915,0.0,172.31.36.0-255,66,66,8,66
23916,0.0,172.31.36.0-255,180,180,8,12972
23917,3.2e-05,172.31.36.0-255,740,920,8,12972
23918,0.001559,104.244.42.0-255,66,986,8,12972
23919,0.00157,104.244.42.0-255,66,1052,8,12972
23920,0.004745,172.31.36.0-255,180,1232,8,12972
23921,0.004775,172.31.36.0-255,281,1513,8,12972
23922,0.00631,104.244.42.0-255,66,1579,8,12972
23923,0.006319,104.244.42.0-255,66,1645,8,12972
23924,0.047842,172.31.36.0-255,172,1817,8,12972
23925,0.047876,172.31.36.0-255,1133,2950,8,12972
23926,0.04796,172.31.36.0-255,1514,4464,8,12972
23927,0.047962,172.31.36.0-255,1514,5978,8,12972
23928,0.047963,172.31.36.0-255,1514,7492,8,12972
23929,0.047964,172.31.36.0-255,1514,9006,8,12972
23930,0.047995,172.31.36.0-255,1514,10520,8,12972
23931,0.047996,172.31.36.0-255,1514,12034,8,12972
23932,0.048002,172.31.36.0-255,608,12642,8,12972
23933,0.049378,104.244.42.0-255,66,12708,8,12972
23934,0.049478,104.244.42.0-255,66,12774,8,12972
23935,0.049527,104.244.42.0-255,66,12840,8,12972
23936,0.049579,104.244.42.0-255,66,12906,8,12972
23937,0.049583,104.244.42.0-255,66,12972,8,12972
23938,0.0,74.125.200.0-255,153,153,8,354322
23939,2e-05,172.31.36.0-255,66,219,8,354322
23940,2.7e-05,74.125.200.0-255,1484,1703,8,354322
23941,3.1e-05,172.31.36.0-255,66,1769,8,354322
23942,3.6e-05,74.125.200.0-255,2902,4671,8,354322
23943,3.9e-05,172.31.36.0-255,66,4737,8,354322
23944,4.3e-05,74.125.200.0-255,2902,7639,8,354322
23945,4.5e-05,172.31.36.0-255,66,7705,8,354322
23946,5.1e-05,74.125.200.0-255,4320,12025,8,354322
23947,5.3e-05,172.31.36.0-255,66,12091,8,354322
23948,9.8e-05,172.31.36.0-255,66,12157,8,354322
23949,0.000102,74.125.200.0-255,4320,16477,8,354322
23950,0.000104,172.31.36.0-255,66,16543,8,354322
23951,0.000153,74.125.200.0-255,4320,20863,8,354322
23952,0.000156,172.31.36.0-255,66,20929,8,354322
23953,0.000168,74.125.200.0-255,1125,22054,8,354322
23954,0.00017,172.31.36.0-255,66,22120,8,354322
23955,0.000234,74.125.200.0-255,1484,23604,8,354322
23956,0.000236,172.31.36.0-255,66,23670,8,354322
23957,0.00024,74.125.200.0-255,1484,25154,8,354322
23958,0.000241,172.31.36.0-255,66,25220,8,354322
23959,0.000244,74.125.200.0-255,1484,26704,8,354322
23960,0.000246,172.31.36.0-255,66,26770,8,354322
23961,0.000272,74.125.200.0-255,1484,28254,8,354322
23962,0.000275,172.31.36.0-255,66,28320,8,354322
23963,0.00028,74.125.200.0-255,5738,34058,8,354322
23964,0.000282,172.31.36.0-255,66,34124,8,354322
23965,0.000303,74.125.200.0-255,5379,39503,8,354322
23966,0.000305,172.31.36.0-255,66,39569,8,354322
23967,0.000345,74.125.200.0-255,5738,45307,8,354322
23968,0.000348,172.31.36.0-255,66,45373,8,354322
23969,0.000377,74.125.200.0-255,2902,48275,8,354322
23970,0.000379,172.31.36.0-255,66,48341,8,354322
23971,0.000401,74.125.200.0-255,4320,52661,8,354322
23972,0.000403,172.31.36.0-255,66,52727,8,354322
23973,0.000408,74.125.200.0-255,4242,56969,8,354322
23974,0.000409,172.31.36.0-255,66,57035,8,354322
23975,0.000425,74.125.200.0-255,375,57410,8,354322
23976,0.000525,74.125.200.0-255,1484,58894,8,354322
23977,0.000528,172.31.36.0-255,66,58960,8,354322
23978,0.000546,74.125.200.0-255,1484,60444,8,354322
23979,0.00055,74.125.200.0-255,1484,61928,8,354322
23980,0.000552,172.31.36.0-255,66,61994,8,354322
23981,0.000564,74.125.200.0-255,1484,63478,8,354322
23982,0.000581,74.125.200.0-255,5738,69216,8,354322
23983,0.000585,172.31.36.0-255,66,69282,8,354322
23984,0.000596,74.125.200.0-255,2902,72184,8,354322
23985,0.000598,172.31.36.0-255,66,72250,8,354322
23986,0.000618,74.125.200.0-255,4320,76570,8,354322
23987,0.00062,172.31.36.0-255,66,76636,8,354322
23988,0.00063,172.31.36.0-255,66,76702,8,354322
23989,0.000645,74.125.200.0-255,2902,79604,8,354322
23990,0.000647,172.31.36.0-255,66,79670,8,354322
23991,0.000663,74.125.200.0-255,3602,83272,8,354322
23992,0.000665,172.31.36.0-255,66,83338,8,354322
23993,0.000699,74.125.200.0-255,2902,86240,8,354322
23994,0.000701,172.31.36.0-255,66,86306,8,354322
23995,0.000714,74.125.200.0-255,1484,87790,8,354322
23996,0.00072,74.125.200.0-255,5738,93528,8,354322
23997,0.000722,172.31.36.0-255,66,93594,8,354322
23998,0.000737,74.125.200.0-255,1484,95078,8,354322
23999,0.00075,74.125.200.0-255,2902,97980,8,354322
24000,0.000752,172.31.36.0-255,66,98046,8,354322
24001,0.000779,74.125.200.0-255,7156,105202,8,354322
24002,0.000782,172.31.36.0-255,66,105268,8,354322
24003,0.000786,74.125.200.0-255,4320,109588,8,354322
24004,0.000788,172.31.36.0-255,66,109654,8,354322
24005,0.000803,74.125.200.0-255,4320,113974,8,354322
24006,0.000806,172.31.36.0-255,66,114040,8,354322
24007,0.000827,74.125.200.0-255,3602,117642,8,354322
24008,0.00083,172.31.36.0-255,66,117708,8,354322
24009,0.000849,74.125.200.0-255,1484,119192,8,354322
24010,0.000866,74.125.200.0-255,7156,126348,8,354322
24011,0.000869,172.31.36.0-255,66,126414,8,354322
24012,0.000873,74.125.200.0-255,4320,130734,8,354322
24013,0.000875,172.31.36.0-255,66,130800,8,354322
24014,0.000895,74.125.200.0-255,5738,136538,8,354322
24015,0.000899,172.31.36.0-255,66,136604,8,354322
24016,0.000913,74.125.200.0-255,5738,142342,8,354322
24017,0.000915,172.31.36.0-255,66,142408,8,354322
24018,0.000939,172.31.36.0-255,66,142474,8,354322
24019,0.000941,74.125.200.0-255,766,143240,8,354322
24020,0.000953,74.125.200.0-255,1484,144724,8,354322
24021,0.000956,172.31.36.0-255,66,144790,8,354322
24022,0.00098,74.125.200.0-255,4320,149110,8,354322
24023,0.000982,172.31.36.0-255,66,149176,8,354322
24024,0.000994,74.125.200.0-255,1484,150660,8,354322
24025,0.001007,74.125.200.0-255,2902,153562,8,354322
24026,0.001009,172.31.36.0-255,66,153628,8,354322
24027,0.001022,74.125.200.0-255,2902,156530,8,354322
24028,0.001024,172.31.36.0-255,66,156596,8,354322
24029,0.001034,172.31.36.0-255,66,156662,8,354322
24030,0.001051,74.125.200.0-255,1484,158146,8,354322
24031,0.001077,172.31.36.0-255,66,158212,8,354322
24032,0.001121,74.125.200.0-255,1484,159696,8,354322
24033,0.001125,74.125.200.0-255,2902,162598,8,354322
24034,0.001128,172.31.36.0-255,66,162664,8,354322
24035,0.001133,74.125.200.0-255,5738,168402,8,354322
24036,0.001135,172.31.36.0-255,66,168468,8,354322
24037,0.00117,172.31.36.0-255,66,168534,8,354322
24038,0.001185,74.125.200.0-255,5738,174272,8,354322
24039,0.001187,172.31.36.0-255,66,174338,8,354322
24040,0.001208,74.125.200.0-255,6438,180776,8,354322
24041,0.00121,172.31.36.0-255,66,180842,8,354322
24042,0.001309,74.125.200.0-255,1484,182326,8,354322
24043,0.001325,74.125.200.0-255,2902,185228,8,354322
24044,0.00133,172.31.36.0-255,66,185294,8,354322
24045,0.001344,74.125.200.0-255,5738,191032,8,354322
24046,0.001347,172.31.36.0-255,66,191098,8,354322
24047,0.001351,74.125.200.0-255,2902,194000,8,354322
24048,0.001353,172.31.36.0-255,66,194066,8,354322
24049,0.001382,74.125.200.0-255,4320,198386,8,354322
24050,0.001385,172.31.36.0-255,66,198452,8,354322
24051,0.001392,74.125.200.0-255,7156,205608,8,354322
24052,0.001393,172.31.36.0-255,66,205674,8,354322
24053,0.001409,74.125.200.0-255,1484,207158,8,354322
24054,0.001419,172.31.36.0-255,66,207224,8,354322
24055,0.001737,74.125.200.0-255,1484,208708,8,354322
24056,0.001742,74.125.200.0-255,2902,211610,8,354322
24057,0.001745,172.31.36.0-255,66,211676,8,354322
24058,0.001748,74.125.200.0-255,1484,213160,8,354322
24059,0.001763,74.125.200.0-255,1484,214644,8,354322
24060,0.001765,172.31.36.0-255,66,214710,8,354322
24061,0.001779,74.125.200.0-255,4320,219030,8,354322
24062,0.001782,172.31.36.0-255,66,219096,8,354322
24063,0.001803,74.125.200.0-255,5738,224834,8,354322
24064,0.001805,172.31.36.0-255,66,224900,8,354322
24065,0.001821,74.125.200.0-255,7156,232056,8,354322
24066,0.001823,172.31.36.0-255,66,232122,8,354322
24067,0.001828,74.125.200.0-255,4320,236442,8,354322
24068,0.00183,172.31.36.0-255,66,236508,8,354322
24069,0.001859,74.125.200.0-255,1484,237992,8,354322
24070,0.001872,74.125.200.0-255,3602,241594,8,354322
24071,0.001874,172.31.36.0-255,66,241660,8,354322
24072,0.001965,74.125.200.0-255,1484,243144,8,354322
24073,0.001969,74.125.200.0-255,1484,244628,8,354322
24074,0.001971,172.31.36.0-255,66,244694,8,354322
24075,0.001991,74.125.200.0-255,1484,246178,8,354322
24076,0.001997,74.125.200.0-255,5738,251916,8,354322
24077,0.001999,172.31.36.0-255,66,251982,8,354322
24078,0.002011,74.125.200.0-255,2902,254884,8,354322
24079,0.002013,172.31.36.0-255,66,254950,8,354322
24080,0.002031,74.125.200.0-255,2902,257852,8,354322
24081,0.002033,172.31.36.0-255,66,257918,8,354322
24082,0.002037,74.125.200.0-255,2902,260820,8,354322
24083,0.002039,172.31.36.0-255,66,260886,8,354322
24084,0.004046,74.125.200.0-255,5738,266624,8,354322
24085,0.004053,172.31.36.0-255,66,266690,8,354322
24086,0.006067,74.125.200.0-255,4320,271010,8,354322
24087,0.006069,172.31.36.0-255,66,271076,8,354322
24088,0.006087,74.125.200.0-255,1484,272560,8,354322
24089,0.00808,74.125.200.0-255,4320,276880,8,354322
24090,0.008087,172.31.36.0-255,66,276946,8,354322
24091,0.010103,74.125.200.0-255,5738,282684,8,354322
24092,0.01011,172.31.36.0-255,66,282750,8,354322
24093,0.012131,74.125.200.0-255,5738,288488,8,354322
24094,0.012139,172.31.36.0-255,66,288554,8,354322
24095,0.014163,74.125.200.0-255,5738,294292,8,354322
24096,0.014171,172.31.36.0-255,66,294358,8,354322
24097,0.01619,74.125.200.0-255,5738,300096,8,354322
24098,0.016197,172.31.36.0-255,66,300162,8,354322
24099,0.018221,74.125.200.0-255,5738,305900,8,354322
24100,0.018228,172.31.36.0-255,66,305966,8,354322
24101,0.020242,74.125.200.0-255,5738,311704,8,354322
24102,0.020251,172.31.36.0-255,66,311770,8,354322
24103,0.022277,74.125.200.0-255,5738,317508,8,354322
24104,0.022285,172.31.36.0-255,66,317574,8,354322
24105,0.024305,74.125.200.0-255,5738,323312,8,354322
24106,0.024313,172.31.36.0-255,66,323378,8,354322
24107,0.026375,74.125.200.0-255,5738,329116,8,354322
24108,0.026382,172.31.36.0-255,66,329182,8,354322
24109,0.028403,74.125.200.0-255,5738,334920,8,354322
24110,0.028411,172.31.36.0-255,66,334986,8,354322
24111,0.03044,74.125.200.0-255,5738,340724,8,354322
24112,0.03045,172.31.36.0-255,66,340790,8,354322
24113,0.032475,74.125.200.0-255,5738,346528,8,354322
24114,0.032483,172.31.36.0-255,66,346594,8,354322
24115,0.034503,74.125.200.0-255,5435,352029,8,354322
24116,0.034511,172.31.36.0-255,66,352095,8,354322
24117,0.034733,172.31.36.0-255,105,352200,8,354322
24118,0.036724,74.125.200.0-255,66,352266,8,354322
24119,0.042968,172.31.36.0-255,176,352442,8,354322
24120,0.043002,172.31.36.0-255,1110,353552,8,354322
24121,0.043079,172.31.36.0-255,572,354124,8,354322
24122,0.044517,104.244.42.0-255,66,354190,8,354322
24123,0.044526,104.244.42.0-255,66,354256,8,354322
24124,0.044577,104.244.42.0-255,66,354322,8,354322
24125,0.0,74.125.68.0-255,152,152,8,351171
24126,2.4e-05,172.31.36.0-255,66,218,8,351171
24127,3.1e-05,74.125.68.0-255,1484,1702,8,351171
24128,3.6e-05,172.31.36.0-255,66,1768,8,351171
24129,7.5e-05,74.125.68.0-255,2902,4670,8,351171
24130,7.8e-05,172.31.36.0-255,66,4736,8,351171
24131,8.2e-05,74.125.68.0-255,1484,6220,8,351171
24132,8.4e-05,172.31.36.0-255,66,6286,8,351171
24133,9.1e-05,74.125.68.0-255,5738,12024,8,351171
24134,9.5e-05,172.31.36.0-255,66,12090,8,351171
24135,9.8e-05,74.125.68.0-255,1484,13574,8,351171
24136,0.0001,172.31.36.0-255,66,13640,8,351171
24137,0.000126,74.125.68.0-255,585,14225,8,351171
24138,0.000128,172.31.36.0-255,66,14291,8,351171
24139,0.000157,74.125.68.0-255,1484,15775,8,351171
24140,0.00016,172.31.36.0-255,66,15841,8,351171
24141,0.000186,74.125.68.0-255,4320,20161,8,351171
24142,0.000189,172.31.36.0-255,66,20227,8,351171
24143,0.000194,74.125.68.0-255,2902,23129,8,351171
24144,0.000196,172.31.36.0-255,66,23195,8,351171
24145,0.000227,74.125.68.0-255,4320,27515,8,351171
24146,0.00023,172.31.36.0-255,66,27581,8,351171
24147,0.000233,74.125.68.0-255,1484,29065,8,351171
24148,0.000235,172.31.36.0-255,66,29131,8,351171
24149,0.000258,74.125.68.0-255,2543,31674,8,351171
24150,0.000264,172.31.36.0-255,66,31740,8,351171
24151,0.000316,74.125.68.0-255,1484,33224,8,351171
24152,0.000318,172.31.36.0-255,66,33290,8,351171
24153,0.000356,74.125.68.0-255,1484,34774,8,351171
24154,0.000359,172.31.36.0-255,66,34840,8,351171
24155,0.00039,74.125.68.0-255,2902,37742,8,351171
24156,0.000394,172.31.36.0-255,66,37808,8,351171
24157,0.000402,74.125.68.0-255,5738,43546,8,351171
24158,0.000405,172.31.36.0-255,66,43612,8,351171
24159,0.00044,74.125.68.0-255,6797,50409,8,351171
24160,0.000443,172.31.36.0-255,66,50475,8,351171
24161,0.00045,74.125.68.0-255,4320,54795,8,351171
24162,0.000452,172.31.36.0-255,66,54861,8,351171
24163,0.000484,74.125.68.0-255,5738,60599,8,351171
24164,0.000487,172.31.36.0-255,66,60665,8,351171
24165,0.00052,74.125.68.0-255,5734,66399,8,351171
24166,0.000522,172.31.36.0-255,66,66465,8,351171
24167,0.000525,74.125.68.0-255,332,66797,8,351171
24168,0.000769,74.125.68.0-255,1484,68281,8,351171
24169,0.000774,172.31.36.0-255,66,68347,8,351171
24170,0.00078,74.125.68.0-255,2902,71249,8,351171
24171,0.000783,172.31.36.0-255,66,71315,8,351171
24172,0.000786,74.125.68.0-255,1484,72799,8,351171
24173,0.000819,74.125.68.0-255,4320,77119,8,351171
24174,0.000823,172.31.36.0-255,66,77185,8,351171
24175,0.00083,74.125.68.0-255,7156,84341,8,351171
24176,0.000832,172.31.36.0-255,66,84407,8,351171
24177,0.000858,74.125.68.0-255,5738,90145,8,351171
24178,0.000861,172.31.36.0-255,66,90211,8,351171
24179,0.000892,74.125.68.0-255,5738,95949,8,351171
24180,0.000896,172.31.36.0-255,66,96015,8,351171
24181,0.000953,74.125.68.0-255,5020,101035,8,351171
24182,0.000969,172.31.36.0-255,66,101101,8,351171
24183,0.001406,74.125.68.0-255,1484,102585,8,351171
24184,0.001413,74.125.68.0-255,2902,105487,8,351171
24185,0.001416,172.31.36.0-255,66,105553,8,351171
24186,0.001475,74.125.68.0-255,5738,111291,8,351171
24187,0.001483,74.125.68.0-255,7156,118447,8,351171
24188,0.001489,172.31.36.0-255,66,118513,8,351171
24189,0.001497,172.31.36.0-255,66,118579,8,351171
24190,0.001529,172.31.36.0-255,66,118645,8,351171
24191,0.001556,74.125.68.0-255,2902,121547,8,351171
24192,0.001559,172.31.36.0-255,66,121613,8,351171
24193,0.001564,74.125.68.0-255,2184,123797,8,351171
24194,0.001566,172.31.36.0-255,66,123863,8,351171
24195,0.001606,74.125.68.0-255,1484,125347,8,351171
24196,0.001621,74.125.68.0-255,2902,128249,8,351171
24197,0.001624,172.31.36.0-255,66,128315,8,351171
24198,0.00163,74.125.68.0-255,4320,132635,8,351171
24199,0.001632,172.31.36.0-255,66,132701,8,351171
24200,0.001664,172.31.36.0-255,66,132767,8,351171
24201,0.001696,74.125.68.0-255,4320,137087,8,351171
24202,0.001698,172.31.36.0-255,66,137153,8,351171
24203,0.001705,74.125.68.0-255,5738,142891,8,351171
24204,0.001707,172.31.36.0-255,66,142957,8,351171
24205,0.001731,74.125.68.0-255,5738,148695,8,351171
24206,0.001751,74.125.68.0-255,766,149461,8,351171
24207,0.001771,172.31.36.0-255,66,149527,8,351171
24208,0.002178,74.125.68.0-255,1484,151011,8,351171
24209,0.002185,74.125.68.0-255,2902,153913,8,351171
24210,0.002189,172.31.36.0-255,66,153979,8,351171
24211,0.002195,74.125.68.0-255,2902,156881,8,351171
24212,0.002197,172.31.36.0-255,66,156947,8,351171
24213,0.002218,74.125.68.0-255,2902,159849,8,351171
24214,0.00222,172.31.36.0-255,66,159915,8,351171
24215,0.002231,74.125.68.0-255,5738,165653,8,351171
24216,0.002233,172.31.36.0-255,66,165719,8,351171
24217,0.002268,74.125.68.0-255,1484,167203,8,351171
24218,0.002281,172.31.36.0-255,66,167269,8,351171
24219,0.002285,74.125.68.0-255,2902,170171,8,351171
24220,0.002288,172.31.36.0-255,66,170237,8,351171
24221,0.002291,74.125.68.0-255,1484,171721,8,351171
24222,0.004523,74.125.68.0-255,4320,176041,8,351171
24223,0.00453,172.31.36.0-255,66,176107,8,351171
24224,0.006767,74.125.68.0-255,5738,181845,8,351171
24225,0.006771,172.31.36.0-255,66,181911,8,351171
24226,0.009027,74.125.68.0-255,5738,187649,8,351171
24227,0.009034,172.31.36.0-255,66,187715,8,351171
24228,0.011276,74.125.68.0-255,5738,193453,8,351171
24229,0.011284,172.31.36.0-255,66,193519,8,351171
24230,0.013517,74.125.68.0-255,5738,199257,8,351171
24231,0.013526,172.31.36.0-255,66,199323,8,351171
24232,0.015782,74.125.68.0-255,5738,205061,8,351171
24233,0.015792,172.31.36.0-255,66,205127,8,351171
24234,0.018031,74.125.68.0-255,5738,210865,8,351171
24235,0.018039,172.31.36.0-255,66,210931,8,351171
24236,0.02029,74.125.68.0-255,5738,216669,8,351171
24237,0.0203,172.31.36.0-255,66,216735,8,351171
24238,0.022536,74.125.68.0-255,5738,222473,8,351171
24239,0.022543,172.31.36.0-255,66,222539,8,351171
24240,0.024787,74.125.68.0-255,4320,226859,8,351171
24241,0.024795,172.31.36.0-255,66,226925,8,351171
24242,0.024823,74.125.68.0-255,1484,228409,8,351171
24243,0.027023,74.125.68.0-255,4320,232729,8,351171
24244,0.027031,172.31.36.0-255,66,232795,8,351171
24245,0.029269,74.125.68.0-255,5738,238533,8,351171
24246,0.029278,172.31.36.0-255,66,238599,8,351171
24247,0.031524,74.125.68.0-255,5738,244337,8,351171
24248,0.031536,172.31.36.0-255,66,244403,8,351171
24249,0.033789,74.125.68.0-255,5738,250141,8,351171
24250,0.033797,172.31.36.0-255,66,250207,8,351171
24251,0.036068,74.125.68.0-255,5738,255945,8,351171
24252,0.036075,172.31.36.0-255,66,256011,8,351171
24253,0.038149,172.31.36.0-255,172,256183,8,351171
24254,0.038181,172.31.36.0-255,1110,257293,8,351171
24255,0.038248,172.31.36.0-255,1514,258807,8,351171
24256,0.03825,172.31.36.0-255,1514,260321,8,351171
24257,0.038265,172.31.36.0-255,1514,261835,8,351171
24258,0.038271,172.31.36.0-255,1514,263349,8,351171
24259,0.038294,172.31.36.0-255,498,263847,8,351171
24260,0.038323,74.125.68.0-255,5738,269585,8,351171
24261,0.038327,172.31.36.0-255,66,269651,8,351171
24262,0.039678,104.244.42.0-255,66,269717,8,351171
24263,0.039721,104.244.42.0-255,66,269783,8,351171
24264,0.039828,104.244.42.0-255,66,269849,8,351171
24265,0.039834,104.244.42.0-255,66,269915,8,351171
24266,0.040564,74.125.68.0-255,5738,275653,8,351171
24267,0.040572,172.31.36.0-255,66,275719,8,351171
24268,0.042803,74.125.68.0-255,5738,281457,8,351171
24269,0.042811,172.31.36.0-255,66,281523,8,351171
24270,0.04505,74.125.68.0-255,5738,287261,8,351171
24271,0.045058,172.31.36.0-255,66,287327,8,351171
24272,0.047289,74.125.68.0-255,5738,293065,8,351171
24273,0.047297,172.31.36.0-255,66,293131,8,351171
24274,0.049538,74.125.68.0-255,5738,298869,8,351171
24275,0.049546,172.31.36.0-255,66,298935,8,351171
24276,0.051782,74.125.68.0-255,5738,304673,8,351171
24277,0.051794,172.31.36.0-255,66,304739,8,351171
24278,0.054028,74.125.68.0-255,5738,310477,8,351171
24279,0.054035,172.31.36.0-255,66,310543,8,351171
24280,0.05628,74.125.68.0-255,5738,316281,8,351171
24281,0.056287,172.31.36.0-255,66,316347,8,351171
24282,0.05854,74.125.68.0-255,5738,322085,8,351171
24283,0.058547,172.31.36.0-255,66,322151,8,351171
24284,0.060789,74.125.68.0-255,5738,327889,8,351171
24285,0.060797,172.31.36.0-255,66,327955,8,351171
24286,0.063062,74.125.68.0-255,5738,333693,8,351171
24287,0.063072,172.31.36.0-255,66,333759,8,351171
24288,0.065313,74.125.68.0-255,5738,339497,8,351171
24289,0.065319,172.31.36.0-255,66,339563,8,351171
24290,0.06755,74.125.68.0-255,5738,345301,8,351171
24291,0.067557,172.31.36.0-255,66,345367,8,351171
24292,0.069792,74.125.68.0-255,5738,351105,8,351171
24293,0.0698,172.31.36.0-255,66,351171,8,351171
24294,0.0,74.125.24.0-255,153,153,8,264474
24295,2.4e-05,172.31.36.0-255,66,219,8,264474
24296,3.1e-05,74.125.24.0-255,1484,1703,8,264474
24297,3.5e-05,172.31.36.0-255,66,1769,8,264474
24298,5.5e-05,74.125.24.0-255,2902,4671,8,264474
24299,5.8e-05,172.31.36.0-255,66,4737,8,264474
24300,6.5e-05,74.125.24.0-255,4320,9057,8,264474
24301,6.8e-05,172.31.36.0-255,66,9123,8,264474
24302,9e-05,74.125.24.0-255,1484,10607,8,264474
24303,9.3e-05,172.31.36.0-255,66,10673,8,264474
24304,0.000114,74.125.24.0-255,4320,14993,8,264474
24305,0.000117,172.31.36.0-255,66,15059,8,264474
24306,0.00016,74.125.24.0-255,2001,17060,8,264474
24307,0.000163,172.31.36.0-255,66,17126,8,264474
24308,0.000176,172.31.36.0-255,66,17192,8,264474
24309,0.000205,74.125.24.0-255,5379,22571,8,264474
24310,0.000208,172.31.36.0-255,66,22637,8,264474
24311,0.000811,74.125.24.0-255,1484,24121,8,264474
24312,0.000818,172.31.36.0-255,66,24187,8,264474
24313,0.000826,74.125.24.0-255,2902,27089,8,264474
24314,0.000828,172.31.36.0-255,66,27155,8,264474
24315,0.000835,74.125.24.0-255,5738,32893,8,264474
24316,0.000837,172.31.36.0-255,66,32959,8,264474
24317,0.000872,172.31.36.0-255,66,33025,8,264474
24318,0.00092,172.31.36.0-255,66,33091,8,264474
24319,0.000924,74.125.24.0-255,766,33857,8,264474
24320,0.000926,172.31.36.0-255,66,33923,8,264474
24321,0.001017,74.125.24.0-255,396,34319,8,264474
24322,0.00102,172.31.36.0-255,66,34385,8,264474
24323,0.001122,74.125.24.0-255,347,34732,8,264474
24324,0.0014,74.125.24.0-255,1484,36216,8,264474
24325,0.001408,74.125.24.0-255,2902,39118,8,264474
24326,0.001446,74.125.24.0-255,5738,44856,8,264474
24327,0.001496,74.125.24.0-255,2184,47040,8,264474
24328,0.001695,74.125.24.0-255,1484,48524,8,264474
24329,0.001702,74.125.24.0-255,2902,51426,8,264474
24330,0.00172,74.125.24.0-255,5738,57164,8,264474
24331,0.001745,74.125.24.0-255,2902,60066,8,264474
24332,0.001821,74.125.24.0-255,5020,65086,8,264474
24333,0.001826,74.125.24.0-255,4320,69406,8,264474
24334,0.001846,74.125.24.0-255,5738,75144,8,264474
24335,0.001879,74.125.24.0-255,4320,79464,8,264474
24336,0.001893,74.125.24.0-255,2184,81648,8,264474
24337,0.001931,74.125.24.0-255,5738,87386,8,264474
24338,0.001969,74.125.24.0-255,7156,94542,8,264474
24339,0.001989,74.125.24.0-255,6438,100980,8,264474
24340,0.002512,74.125.24.0-255,1484,102464,8,264474
24341,0.002526,74.125.24.0-255,2902,105366,8,264474
24342,0.002543,74.125.24.0-255,4320,109686,8,264474
24343,0.002559,74.125.24.0-255,1484,111170,8,264474
24344,0.002625,74.125.24.0-255,5020,116190,8,264474
24345,0.005193,172.31.36.0-255,66,116256,8,264474
24346,0.007821,74.125.24.0-255,5738,121994,8,264474
24347,0.007827,172.31.36.0-255,66,122060,8,264474
24348,0.010697,74.125.24.0-255,5738,127798,8,264474
24349,0.010706,172.31.36.0-255,66,127864,8,264474
24350,0.013412,74.125.24.0-255,5738,133602,8,264474
24351,0.013419,172.31.36.0-255,66,133668,8,264474
24352,0.015978,74.125.24.0-255,5738,139406,8,264474
24353,0.015985,172.31.36.0-255,66,139472,8,264474
24354,0.018571,74.125.24.0-255,5738,145210,8,264474
24355,0.018579,172.31.36.0-255,66,145276,8,264474
24356,0.021146,74.125.24.0-255,5738,151014,8,264474
24357,0.021153,172.31.36.0-255,66,151080,8,264474
24358,0.023739,74.125.24.0-255,5738,156818,8,264474
24359,0.023746,172.31.36.0-255,66,156884,8,264474
24360,0.026361,74.125.24.0-255,5738,162622,8,264474
24361,0.026373,172.31.36.0-255,66,162688,8,264474
24362,0.028999,74.125.24.0-255,5738,168426,8,264474
24363,0.029011,172.31.36.0-255,66,168492,8,264474
24364,0.031591,74.125.24.0-255,5738,174230,8,264474
24365,0.031598,172.31.36.0-255,66,174296,8,264474
24366,0.034148,74.125.24.0-255,5738,180034,8,264474
24367,0.034154,172.31.36.0-255,66,180100,8,264474
24368,0.035441,172.31.36.0-255,172,180272,8,264474
24369,0.035475,172.31.36.0-255,1110,181382,8,264474
24370,0.035536,172.31.36.0-255,1514,182896,8,264474
24371,0.035538,172.31.36.0-255,1514,184410,8,264474
24372,0.035543,172.31.36.0-255,1514,185924,8,264474
24373,0.035545,172.31.36.0-255,1514,187438,8,264474
24374,0.035568,172.31.36.0-255,1514,188952,8,264474
24375,0.035569,172.31.36.0-255,876,189828,8,264474
24376,0.036704,74.125.24.0-255,5738,195566,8,264474
24377,0.036711,172.31.36.0-255,66,195632,8,264474
24378,0.036995,104.244.42.0-255,66,195698,8,264474
24379,0.03702,104.244.42.0-255,66,195764,8,264474
24380,0.03711,104.244.42.0-255,66,195830,8,264474
24381,0.037116,104.244.42.0-255,66,195896,8,264474
24382,0.037778,104.244.42.0-255,108,196004,8,264474
24383,0.037789,172.31.36.0-255,66,196070,8,264474
24384,0.039333,74.125.24.0-255,5738,201808,8,264474
24385,0.039341,172.31.36.0-255,66,201874,8,264474
24386,0.041894,74.125.24.0-255,5738,207612,8,264474
24387,0.041903,172.31.36.0-255,66,207678,8,264474
24388,0.044492,74.125.24.0-255,4320,211998,8,264474
24389,0.0445,172.31.36.0-255,66,212064,8,264474
24390,0.044521,74.125.24.0-255,1484,213548,8,264474
24391,0.047107,74.125.24.0-255,4320,217868,8,264474
24392,0.047119,172.31.36.0-255,66,217934,8,264474
24393,0.049747,74.125.24.0-255,5738,223672,8,264474
24394,0.050217,172.31.36.0-255,66,223738,8,264474
24395,0.052836,74.125.24.0-255,5738,229476,8,264474
24396,0.052848,172.31.36.0-255,66,229542,8,264474
24397,0.055408,74.125.24.0-255,5738,235280,8,264474
24398,0.055415,172.31.36.0-255,66,235346,8,264474
24399,0.056233,172.31.36.0-255,108,235454,8,264474
24400,0.058004,74.125.24.0-255,5738,241192,8,264474
24401,0.058011,172.31.36.0-255,66,241258,8,264474
24402,0.060562,74.125.24.0-255,5738,246996,8,264474
24403,0.06057,172.31.36.0-255,66,247062,8,264474
24404,0.063116,74.125.24.0-255,5738,252800,8,264474
24405,0.063125,172.31.36.0-255,66,252866,8,264474
24406,0.065728,74.125.24.0-255,5738,258604,8,264474
24407,0.065738,172.31.36.0-255,66,258670,8,264474
24408,0.068278,74.125.24.0-255,5738,264408,8,264474
24409,0.068668,172.31.36.0-255,66,264474,8,264474
24410,0.0,172.217.194.0-255,152,152,8,259156
24411,1.7e-05,172.31.36.0-255,66,218,8,259156
24412,2.4e-05,172.217.194.0-255,1484,1702,8,259156
24413,3e-05,172.31.36.0-255,66,1768,8,259156
24414,3.7e-05,172.217.194.0-255,2902,4670,8,259156
24415,4.1e-05,172.31.36.0-255,66,4736,8,259156
24416,4.6e-05,172.217.194.0-255,2902,7638,8,259156
24417,4.9e-05,172.31.36.0-255,66,7704,8,259156
24418,8.7e-05,172.217.194.0-255,4320,12024,8,259156
24419,9.1e-05,172.31.36.0-255,66,12090,8,259156
24420,9.5e-05,172.217.194.0-255,2073,14163,8,259156
24421,9.9e-05,172.31.36.0-255,66,14229,8,259156
24422,0.000114,172.31.36.0-255,66,14295,8,259156
24423,0.000121,172.217.194.0-255,5379,19674,8,259156
24424,0.000124,172.31.36.0-255,66,19740,8,259156
24425,0.000139,172.217.194.0-255,1484,21224,8,259156
24426,0.000142,172.31.36.0-255,66,21290,8,259156
24427,0.000157,172.217.194.0-255,4320,25610,8,259156
24428,0.000164,172.31.36.0-255,66,25676,8,259156
24429,0.000176,172.31.36.0-255,66,25742,8,259156
24430,0.000205,172.217.194.0-255,2543,28285,8,259156
24431,0.000208,172.31.36.0-255,66,28351,8,259156
24432,0.000457,172.217.194.0-255,1484,29835,8,259156
24433,0.000463,172.31.36.0-255,66,29901,8,259156
24434,0.00047,172.217.194.0-255,2902,32803,8,259156
24435,0.000472,172.31.36.0-255,66,32869,8,259156
24436,0.000479,172.217.194.0-255,5738,38607,8,259156
24437,0.000486,172.31.36.0-255,66,38673,8,259156
24438,0.00053,172.217.194.0-255,5738,44411,8,259156
24439,0.000533,172.31.36.0-255,66,44477,8,259156
24440,0.000559,172.217.194.0-255,1125,45602,8,259156
24441,0.000567,172.217.194.0-255,7156,52758,8,259156
24442,0.000575,172.217.194.0-255,5738,58496,8,259156
24443,0.000587,172.217.194.0-255,2902,61398,8,259156
24444,0.000611,172.31.36.0-255,66,61464,8,259156
24445,0.000664,172.217.194.0-255,5020,66484,8,259156
24446,0.000681,172.31.36.0-255,66,66550,8,259156
24447,0.00074,172.217.194.0-255,1484,68034,8,259156
24448,0.000746,172.217.194.0-255,2902,70936,8,259156
24449,0.00076,172.31.36.0-255,66,71002,8,259156
24450,0.000768,172.217.194.0-255,5738,76740,8,259156
24451,0.000784,172.31.36.0-255,66,76806,8,259156
24452,0.000805,172.217.194.0-255,6683,83489,8,259156
24453,0.000826,172.31.36.0-255,66,83555,8,259156
24454,0.000962,172.217.194.0-255,1484,85039,8,259156
24455,0.000968,172.217.194.0-255,2902,87941,8,259156
24456,0.000979,172.31.36.0-255,66,88007,8,259156
24457,0.000998,172.217.194.0-255,5738,93745,8,259156
24458,0.001005,172.217.194.0-255,5738,99483,8,259156
24459,0.001032,172.217.194.0-255,7156,106639,8,259156
24460,0.001041,172.31.36.0-255,66,106705,8,259156
24461,0.001076,172.217.194.0-255,6920,113625,8,259156
24462,0.001104,172.31.36.0-255,66,113691,8,259156
24463,0.001712,172.217.194.0-255,1484,115175,8,259156
24464,0.001729,172.217.194.0-255,2902,118077,8,259156
24465,0.001733,172.31.36.0-255,66,118143,8,259156
24466,0.001758,172.217.194.0-255,5738,123881,8,259156
24467,0.001766,172.217.194.0-255,7156,131037,8,259156
24468,0.001779,172.217.194.0-255,1484,132521,8,259156
24469,0.001795,172.217.194.0-255,7156,139677,8,259156
24470,0.0018,172.31.36.0-255,66,139743,8,259156
24471,0.00182,172.217.194.0-255,5738,145481,8,259156
24472,0.001825,172.217.194.0-255,2184,147665,8,259156
24473,0.001844,172.31.36.0-255,66,147731,8,259156
24474,0.001909,172.217.194.0-255,1484,149215,8,259156
24475,0.001915,172.217.194.0-255,2902,152117,8,259156
24476,0.001924,172.31.36.0-255,66,152183,8,259156
24477,0.001951,172.217.194.0-255,5738,157921,8,259156
24478,0.001958,172.217.194.0-255,5738,163659,8,259156
24479,0.001965,172.217.194.0-255,7156,170815,8,259156
24480,0.002013,172.31.36.0-255,66,170881,8,259156
24481,0.002042,172.31.36.0-255,66,170947,8,259156
24482,0.002073,172.217.194.0-255,1484,172431,8,259156
24483,0.002078,172.217.194.0-255,2902,175333,8,259156
24484,0.002085,172.217.194.0-255,5738,181071,8,259156
24485,0.002133,172.217.194.0-255,2902,183973,8,259156
24486,0.002145,172.217.194.0-255,766,184739,8,259156
24487,0.002188,172.217.194.0-255,1484,186223,8,259156
24488,0.002202,172.217.194.0-255,4320,190543,8,259156
24489,0.002227,172.217.194.0-255,7156,197699,8,259156
24490,0.002252,172.217.194.0-255,1484,199183,8,259156
24491,0.002265,172.217.194.0-255,4320,203503,8,259156
24492,0.00231,172.217.194.0-255,7156,210659,8,259156
24493,0.002473,172.217.194.0-255,1484,212143,8,259156
24494,0.002487,172.217.194.0-255,1484,213627,8,259156
24495,0.00249,172.217.194.0-255,1484,215111,8,259156
24496,0.00251,172.217.194.0-255,2902,218013,8,259156
24497,0.002517,172.217.194.0-255,5738,223751,8,259156
24498,0.002529,172.217.194.0-255,4320,228071,8,259156
24499,0.002532,172.217.194.0-255,1484,229555,8,259156
24500,0.002584,172.217.194.0-255,6438,235993,8,259156
24501,0.003004,172.217.194.0-255,1484,237477,8,259156
24502,0.003013,172.217.194.0-255,2902,240379,8,259156
24503,0.003026,172.217.194.0-255,2902,243281,8,259156
24504,0.00304,172.217.194.0-255,2902,246183,8,259156
24505,0.003084,172.217.194.0-255,2902,249085,8,259156
24506,0.003138,172.217.194.0-255,1484,250569,8,259156
24507,0.00319,172.217.194.0-255,2902,253471,8,259156
24508,0.003195,172.217.194.0-255,3194,256665,8,259156
24509,0.003198,172.217.194.0-255,97,256762,8,259156
24510,0.003274,172.217.194.0-255,105,256867,8,259156
24511,0.008233,172.31.36.0-255,66,256933,8,259156
24512,0.011031,172.31.36.0-255,105,257038,8,259156
24513,0.013346,172.217.194.0-255,66,257104,8,259156
24514,0.037187,172.31.36.0-255,172,257276,8,259156
24515,0.037223,172.31.36.0-255,1111,258387,8,259156
24516,0.037277,172.31.36.0-255,571,258958,8,259156
24517,0.038745,104.244.42.0-255,66,259024,8,259156
24518,0.038781,104.244.42.0-255,66,259090,8,259156
24519,0.038834,104.244.42.0-255,66,259156,8,259156
24520,0.0,172.217.194.0-255,153,153,8,186414
24521,1.6e-05,172.31.36.0-255,66,219,8,186414
24522,2.3e-05,172.217.194.0-255,1484,1703,8,186414
24523,2.7e-05,172.31.36.0-255,66,1769,8,186414
24524,3.4e-05,172.217.194.0-255,2902,4671,8,186414
24525,4.5e-05,172.31.36.0-255,66,4737,8,186414
24526,5.3e-05,172.217.194.0-255,7156,11893,8,186414
24527,5.6e-05,172.31.36.0-255,66,11959,8,186414
24528,6.1e-05,172.217.194.0-255,2065,14024,8,186414
24529,6.4e-05,172.31.36.0-255,66,14090,8,186414
24530,0.000114,172.31.36.0-255,66,14156,8,186414
24531,0.000121,172.217.194.0-255,5379,19535,8,186414
24532,0.000124,172.31.36.0-255,66,19601,8,186414
24533,0.000264,172.217.194.0-255,1484,21085,8,186414
24534,0.000269,172.31.36.0-255,66,21151,8,186414
24535,0.000276,172.217.194.0-255,2902,24053,8,186414
24536,0.000278,172.31.36.0-255,66,24119,8,186414
24537,0.000304,172.217.194.0-255,5738,29857,8,186414
24538,0.000306,172.31.36.0-255,66,29923,8,186414
24539,0.000318,172.217.194.0-255,6797,36720,8,186414
24540,0.000321,172.31.36.0-255,66,36786,8,186414
24541,0.00037,172.31.36.0-255,66,36852,8,186414
24542,0.000374,172.217.194.0-255,2543,39395,8,186414
24543,0.000377,172.31.36.0-255,66,39461,8,186414
24544,0.00038,172.217.194.0-255,676,40137,8,186414
24545,0.000387,172.31.36.0-255,66,40203,8,186414
24546,0.00067,172.217.194.0-255,1484,41687,8,186414
24547,0.000676,172.31.36.0-255,66,41753,8,186414
24548,0.000682,172.217.194.0-255,2902,44655,8,186414
24549,0.000684,172.31.36.0-255,66,44721,8,186414
24550,0.000695,172.217.194.0-255,5738,50459,8,186414
24551,0.000697,172.31.36.0-255,66,50525,8,186414
24552,0.000704,172.217.194.0-255,4320,54845,8,186414
24553,0.000706,172.31.36.0-255,66,54911,8,186414
24554,0.00074,172.217.194.0-255,2902,57813,8,186414
24555,0.000743,172.31.36.0-255,66,57879,8,186414
24556,0.000764,172.31.36.0-255,66,57945,8,186414
24557,0.000768,172.217.194.0-255,2184,60129,8,186414
24558,0.00077,172.31.36.0-255,66,60195,8,186414
24559,0.001,172.217.194.0-255,1484,61679,8,186414
24560,0.001007,172.217.194.0-255,2902,64581,8,186414
24561,0.00101,172.31.36.0-255,66,64647,8,186414
24562,0.001017,172.217.194.0-255,5738,70385,8,186414
24563,0.001019,172.31.36.0-255,66,70451,8,186414
24564,0.001058,172.31.36.0-255,66,70517,8,186414
24565,0.001075,172.31.36.0-255,66,70583,8,186414
24566,0.001151,172.31.36.0-255,66,70649,8,186414
24567,0.001168,172.31.36.0-255,66,70715,8,186414
24568,0.001184,172.31.36.0-255,66,70781,8,186414
24569,0.001454,172.217.194.0-255,1484,72265,8,186414
24570,0.001457,172.217.194.0-255,1484,73749,8,186414
24571,0.001469,172.31.36.0-255,66,73815,8,186414
24572,0.001473,172.217.194.0-255,1484,75299,8,186414
24573,0.00148,172.217.194.0-255,5738,81037,8,186414
24574,0.001482,172.31.36.0-255,66,81103,8,186414
24575,0.001493,172.217.194.0-255,4320,85423,8,186414
24576,0.001496,172.31.36.0-255,66,85489,8,186414
24577,0.001538,172.31.36.0-255,66,85555,8,186414
24578,0.001551,172.31.36.0-255,66,85621,8,186414
24579,0.001556,172.217.194.0-255,2902,88523,8,186414
24580,0.001558,172.31.36.0-255,66,88589,8,186414
24581,0.001588,172.217.194.0-255,2902,91491,8,186414
24582,0.001594,172.31.36.0-255,66,91557,8,186414
24583,0.001603,172.217.194.0-255,7156,98713,8,186414
24584,0.001606,172.31.36.0-255,66,98779,8,186414
24585,0.00162,172.31.36.0-255,66,98845,8,186414
24586,0.001628,172.217.194.0-255,6438,105283,8,186414
24587,0.00163,172.31.36.0-255,66,105349,8,186414
24588,0.001817,172.217.194.0-255,1484,106833,8,186414
24589,0.001825,172.217.194.0-255,2902,109735,8,186414
24590,0.001829,172.31.36.0-255,66,109801,8,186414
24591,0.001836,172.217.194.0-255,5738,115539,8,186414
24592,0.001838,172.31.36.0-255,66,115605,8,186414
24593,0.001859,172.217.194.0-255,1484,117089,8,186414
24594,0.001917,172.31.36.0-255,66,117155,8,186414
24595,0.00193,172.31.36.0-255,66,117221,8,186414
24596,0.001943,172.217.194.0-255,6438,123659,8,186414
24597,0.001945,172.31.36.0-255,66,123725,8,186414
24598,0.001948,172.217.194.0-255,1484,125209,8,186414
24599,0.001981,172.217.194.0-255,5738,130947,8,186414
24600,0.001984,172.31.36.0-255,66,131013,8,186414
24601,0.001989,172.217.194.0-255,4320,135333,8,186414
24602,0.001991,172.31.36.0-255,66,135399,8,186414
24603,0.001996,172.217.194.0-255,4320,139719,8,186414
24604,0.001999,172.31.36.0-255,66,139785,8,186414
24605,0.002029,172.217.194.0-255,1484,141269,8,186414
24606,0.002046,172.31.36.0-255,66,141335,8,186414
24607,0.002051,172.217.194.0-255,3602,144937,8,186414
24608,0.002053,172.31.36.0-255,66,145003,8,186414
24609,0.0021,172.31.36.0-255,66,145069,8,186414
24610,0.002129,172.217.194.0-255,7156,152225,8,186414
24611,0.002131,172.31.36.0-255,66,152291,8,186414
24612,0.00215,172.31.36.0-255,66,152357,8,186414
24613,0.002155,172.217.194.0-255,4320,156677,8,186414
24614,0.002157,172.31.36.0-255,66,156743,8,186414
24615,0.002164,172.217.194.0-255,5738,162481,8,186414
24616,0.002166,172.31.36.0-255,66,162547,8,186414
24617,0.00218,172.31.36.0-255,66,162613,8,186414
24618,0.002185,172.217.194.0-255,4320,166933,8,186414
24619,0.002187,172.31.36.0-255,66,166999,8,186414
24620,0.002227,172.31.36.0-255,66,167065,8,186414
24621,0.002233,172.217.194.0-255,5738,172803,8,186414
24622,0.002235,172.31.36.0-255,66,172869,8,186414
24623,0.002274,172.217.194.0-255,7156,180025,8,186414
24624,0.002277,172.31.36.0-255,66,180091,8,186414
24625,0.002293,172.31.36.0-255,66,180157,8,186414
24626,0.002329,172.31.36.0-255,66,180223,8,186414
24627,0.002355,172.217.194.0-255,4983,185206,8,186414
24628,0.002358,172.31.36.0-255,66,185272,8,186414
24629,0.002362,172.217.194.0-255,105,185377,8,186414
24630,0.010078,172.31.36.0-255,66,185443,8,186414
24631,0.010123,172.31.36.0-255,105,185548,8,186414
24632,0.012616,172.217.194.0-255,66,185614,8,186414
24633,0.03894,172.31.36.0-255,172,185786,8,186414
24634,0.038969,172.31.36.0-255,562,186348,8,186414
24635,0.041129,104.244.42.0-255,66,186414,8,186414
24636,0.0,74.125.24.0-255,153,153,8,273195
24637,3.5e-05,172.31.36.0-255,66,219,8,273195
24638,4.2e-05,74.125.24.0-255,1484,1703,8,273195
24639,4.8e-05,172.31.36.0-255,66,1769,8,273195
24640,6e-05,74.125.24.0-255,2902,4671,8,273195
24641,6.3e-05,172.31.36.0-255,66,4737,8,273195
24642,7e-05,74.125.24.0-255,7156,11893,8,273195
24643,7.3e-05,172.31.36.0-255,66,11959,8,273195
24644,7.7e-05,74.125.24.0-255,2104,14063,8,273195
24645,7.9e-05,172.31.36.0-255,66,14129,8,273195
24646,0.000122,74.125.24.0-255,1484,15613,8,273195
24647,0.000125,172.31.36.0-255,66,15679,8,273195
24648,0.000129,74.125.24.0-255,1484,17163,8,273195
24649,0.000131,172.31.36.0-255,66,17229,8,273195
24650,0.000157,74.125.24.0-255,1484,18713,8,273195
24651,0.00016,172.31.36.0-255,66,18779,8,273195
24652,0.000166,74.125.24.0-255,5738,24517,8,273195
24653,0.000168,172.31.36.0-255,66,24583,8,273195
24654,0.00018,74.125.24.0-255,5738,30321,8,273195
24655,0.000182,172.31.36.0-255,66,30387,8,273195
24656,0.000212,74.125.24.0-255,1125,31512,8,273195
24657,0.000216,172.31.36.0-255,66,31578,8,273195
24658,0.000623,74.125.24.0-255,1484,33062,8,273195
24659,0.000627,172.31.36.0-255,66,33128,8,273195
24660,0.000636,74.125.24.0-255,2902,36030,8,273195
24661,0.000639,172.31.36.0-255,66,36096,8,273195
24662,0.000652,74.125.24.0-255,5738,41834,8,273195
24663,0.000654,172.31.36.0-255,66,41900,8,273195
24664,0.000686,74.125.24.0-255,6797,48697,8,273195
24665,0.000688,172.31.36.0-255,66,48763,8,273195
24666,0.000693,74.125.24.0-255,2902,51665,8,273195
24667,0.000695,172.31.36.0-255,66,51731,8,273195
24668,0.000726,74.125.24.0-255,4320,56051,8,273195
24669,0.00073,172.31.36.0-255,66,56117,8,273195
24670,0.000735,74.125.24.0-255,2902,59019,8,273195
24671,0.000737,172.31.36.0-255,66,59085,8,273195
24672,0.000778,74.125.24.0-255,6797,65882,8,273195
24673,0.000784,172.31.36.0-255,66,65948,8,273195
24674,0.000787,74.125.24.0-255,393,66341,8,273195
24675,0.001493,74.125.24.0-255,349,66690,8,273195
24676,0.00161,74.125.24.0-255,1484,68174,8,273195
24677,0.001615,172.31.36.0-255,66,68240,8,273195
24678,0.001636,74.125.24.0-255,2902,71142,8,273195
24679,0.001638,172.31.36.0-255,66,71208,8,273195
24680,0.001645,74.125.24.0-255,5738,76946,8,273195
24681,0.001648,172.31.36.0-255,66,77012,8,273195
24682,0.001654,74.125.24.0-255,5738,82750,8,273195
24683,0.001656,172.31.36.0-255,66,82816,8,273195
24684,0.001683,74.125.24.0-255,2902,85718,8,273195
24685,0.001685,172.31.36.0-255,66,85784,8,273195
24686,0.00171,74.125.24.0-255,5738,91522,8,273195
24687,0.001713,172.31.36.0-255,66,91588,8,273195
24688,0.001739,74.125.24.0-255,7156,98744,8,273195
24689,0.001742,172.31.36.0-255,66,98810,8,273195
24690,0.001765,74.125.24.0-255,2184,100994,8,273195
24691,0.001767,172.31.36.0-255,66,101060,8,273195
24692,0.004013,74.125.24.0-255,1484,102544,8,273195
24693,0.004027,74.125.24.0-255,4320,106864,8,273195
24694,0.00403,172.31.36.0-255,66,106930,8,273195
24695,0.006381,74.125.24.0-255,5738,112668,8,273195
24696,0.006388,172.31.36.0-255,66,112734,8,273195
24697,0.008713,74.125.24.0-255,5738,118472,8,273195
24698,0.00872,172.31.36.0-255,66,118538,8,273195
24699,0.011022,74.125.24.0-255,5738,124276,8,273195
24700,0.011034,172.31.36.0-255,66,124342,8,273195
24701,0.013302,74.125.24.0-255,5738,130080,8,273195
24702,0.013311,172.31.36.0-255,66,130146,8,273195
24703,0.015656,74.125.24.0-255,5738,135884,8,273195
24704,0.015667,172.31.36.0-255,66,135950,8,273195
24705,0.018004,74.125.24.0-255,5738,141688,8,273195
24706,0.018011,172.31.36.0-255,66,141754,8,273195
24707,0.020311,74.125.24.0-255,5738,147492,8,273195
24708,0.020319,172.31.36.0-255,66,147558,8,273195
24709,0.022655,74.125.24.0-255,5738,153296,8,273195
24710,0.022665,172.31.36.0-255,66,153362,8,273195
24711,0.024976,74.125.24.0-255,5738,159100,8,273195
24712,0.024983,172.31.36.0-255,66,159166,8,273195
24713,0.025776,172.31.36.0-255,176,159342,8,273195
24714,0.025805,172.31.36.0-255,1111,160453,8,273195
24715,0.025868,172.31.36.0-255,1514,161967,8,273195
24716,0.025889,172.31.36.0-255,754,162721,8,273195
24717,0.02731,74.125.24.0-255,5738,168459,8,273195
24718,0.027317,172.31.36.0-255,66,168525,8,273195
24719,0.027329,104.244.42.0-255,66,168591,8,273195
24720,0.027354,104.244.42.0-255,66,168657,8,273195
24721,0.027428,104.244.42.0-255,66,168723,8,273195
24722,0.029616,74.125.24.0-255,5738,174461,8,273195
24723,0.029623,172.31.36.0-255,66,174527,8,273195
24724,0.031961,74.125.24.0-255,5738,180265,8,273195
24725,0.031968,172.31.36.0-255,66,180331,8,273195
24726,0.034271,74.125.24.0-255,5738,186069,8,273195
24727,0.034278,172.31.36.0-255,66,186135,8,273195
24728,0.036607,74.125.24.0-255,5738,191873,8,273195
24729,0.036614,172.31.36.0-255,66,191939,8,273195
24730,0.038954,74.125.24.0-255,5738,197677,8,273195
24731,0.038961,172.31.36.0-255,66,197743,8,273195
24732,0.041273,74.125.24.0-255,5738,203481,8,273195
24733,0.041282,172.31.36.0-255,66,203547,8,273195
24734,0.043598,74.125.24.0-255,5738,209285,8,273195
24735,0.043604,172.31.36.0-255,66,209351,8,273195
24736,0.045876,74.125.24.0-255,5738,215089,8,273195
24737,0.045885,172.31.36.0-255,66,215155,8,273195
24738,0.048252,74.125.24.0-255,5738,220893,8,273195
24739,0.048259,172.31.36.0-255,66,220959,8,273195
24740,0.050548,74.125.24.0-255,5738,226697,8,273195
24741,0.050554,172.31.36.0-255,66,226763,8,273195
24742,0.052922,74.125.24.0-255,5738,232501,8,273195
24743,0.05293,172.31.36.0-255,66,232567,8,273195
24744,0.055275,74.125.24.0-255,5738,238305,8,273195
24745,0.055282,172.31.36.0-255,66,238371,8,273195
24746,0.057605,74.125.24.0-255,5738,244109,8,273195
24747,0.057612,172.31.36.0-255,66,244175,8,273195
24748,0.059871,74.125.24.0-255,5738,249913,8,273195
24749,0.059878,172.31.36.0-255,66,249979,8,273195
24750,0.062204,74.125.24.0-255,5738,255717,8,273195
24751,0.062211,172.31.36.0-255,66,255783,8,273195
24752,0.06452,74.125.24.0-255,5738,261521,8,273195
24753,0.064527,172.31.36.0-255,66,261587,8,273195
24754,0.066819,74.125.24.0-255,5738,267325,8,273195
24755,0.066825,172.31.36.0-255,66,267391,8,273195
24756,0.069111,74.125.24.0-255,5738,273129,8,273195
24757,0.069117,172.31.36.0-255,66,273195,8,273195
24758,0.0,74.125.68.0-255,143,143,8,368731
24759,3.4e-05,172.31.36.0-255,66,209,8,368731
24760,4.1e-05,74.125.68.0-255,1484,1693,8,368731
24761,4.6e-05,172.31.36.0-255,66,1759,8,368731
24762,5.1e-05,74.125.68.0-255,2902,4661,8,368731
24763,5.4e-05,172.31.36.0-255,66,4727,8,368731
24764,6e-05,74.125.68.0-255,5738,10465,8,368731
24765,6.3e-05,172.31.36.0-255,66,10531,8,368731
24766,7e-05,74.125.68.0-255,6274,16805,8,368731
24767,7.2e-05,172.31.36.0-255,66,16871,8,368731
24768,7.5e-05,74.125.68.0-255,1484,18355,8,368731
24769,7.7e-05,172.31.36.0-255,66,18421,8,368731
24770,0.000107,74.125.68.0-255,7156,25577,8,368731
24771,0.00011,172.31.36.0-255,66,25643,8,368731
24772,0.000137,74.125.68.0-255,2902,28545,8,368731
24773,0.00014,172.31.36.0-255,66,28611,8,368731
24774,0.000159,74.125.68.0-255,2543,31154,8,368731
24775,0.000161,172.31.36.0-255,66,31220,8,368731
24776,0.000334,74.125.68.0-255,1484,32704,8,368731
24777,0.000339,172.31.36.0-255,66,32770,8,368731
24778,0.00036,74.125.68.0-255,2902,35672,8,368731
24779,0.000364,172.31.36.0-255,66,35738,8,368731
24780,0.000367,74.125.68.0-255,1484,37222,8,368731
24781,0.000369,172.31.36.0-255,66,37288,8,368731
24782,0.000387,74.125.68.0-255,4320,41608,8,368731
24783,0.000391,172.31.36.0-255,66,41674,8,368731
24784,0.000394,74.125.68.0-255,1484,43158,8,368731
24785,0.000396,172.31.36.0-255,66,43224,8,368731
24786,0.000433,74.125.68.0-255,5738,48962,8,368731
24787,0.000439,172.31.36.0-255,66,49028,8,368731
24788,0.000452,74.125.68.0-255,3961,52989,8,368731
24789,0.000456,172.31.36.0-255,66,53055,8,368731
24790,0.000461,74.125.68.0-255,4320,57375,8,368731
24791,0.000463,172.31.36.0-255,66,57441,8,368731
24792,0.000498,74.125.68.0-255,5738,63179,8,368731
24793,0.000501,172.31.36.0-255,66,63245,8,368731
24794,0.000518,74.125.68.0-255,2543,65788,8,368731
24795,0.000521,172.31.36.0-255,66,65854,8,368731
24796,0.000554,74.125.68.0-255,646,66500,8,368731
24797,0.000815,172.31.36.0-255,66,66566,8,368731
24798,0.000837,74.125.68.0-255,1484,68050,8,368731
24799,0.000849,74.125.68.0-255,1484,69534,8,368731
24800,0.000854,172.31.36.0-255,66,69600,8,368731
24801,0.000869,74.125.68.0-255,1484,71084,8,368731
24802,0.000872,74.125.68.0-255,1484,72568,8,368731
24803,0.000874,172.31.36.0-255,66,72634,8,368731
24804,0.000879,74.125.68.0-255,2902,75536,8,368731
24805,0.000882,172.31.36.0-255,66,75602,8,368731
24806,0.000914,74.125.68.0-255,4320,79922,8,368731
24807,0.000917,172.31.36.0-255,66,79988,8,368731
24808,0.000939,74.125.68.0-255,1484,81472,8,368731
24809,0.000944,74.125.68.0-255,2902,84374,8,368731
24810,0.000946,172.31.36.0-255,66,84440,8,368731
24811,0.000951,74.125.68.0-255,4320,88760,8,368731
24812,0.000953,172.31.36.0-255,66,88826,8,368731
24813,0.000981,74.125.68.0-255,2902,91728,8,368731
24814,0.000984,172.31.36.0-255,66,91794,8,368731
24815,0.001003,74.125.68.0-255,5738,97532,8,368731
24816,0.001006,172.31.36.0-255,66,97598,8,368731
24817,0.00101,74.125.68.0-255,3602,101200,8,368731
24818,0.001013,172.31.36.0-255,66,101266,8,368731
24819,0.001168,74.125.68.0-255,1484,102750,8,368731
24820,0.001191,74.125.68.0-255,2902,105652,8,368731
24821,0.001194,172.31.36.0-255,66,105718,8,368731
24822,0.00122,74.125.68.0-255,4320,110038,8,368731
24823,0.001222,172.31.36.0-255,66,110104,8,368731
24824,0.001236,74.125.68.0-255,1484,111588,8,368731
24825,0.00124,74.125.68.0-255,2902,114490,8,368731
24826,0.001242,172.31.36.0-255,66,114556,8,368731
24827,0.001248,74.125.68.0-255,4320,118876,8,368731
24828,0.00125,172.31.36.0-255,66,118942,8,368731
24829,0.001268,74.125.68.0-255,5738,124680,8,368731
24830,0.001272,172.31.36.0-255,66,124746,8,368731
24831,0.001288,74.125.68.0-255,2902,127648,8,368731
24832,0.001291,172.31.36.0-255,66,127714,8,368731
24833,0.001296,74.125.68.0-255,4320,132034,8,368731
24834,0.001298,172.31.36.0-255,66,132100,8,368731
24835,0.001332,74.125.68.0-255,2902,135002,8,368731
24836,0.001335,172.31.36.0-255,66,135068,8,368731
24837,0.001352,74.125.68.0-255,766,135834,8,368731
24838,0.001733,74.125.68.0-255,1484,137318,8,368731
24839,0.001739,172.31.36.0-255,66,137384,8,368731
24840,0.001745,74.125.68.0-255,2902,140286,8,368731
24841,0.001747,172.31.36.0-255,66,140352,8,368731
24842,0.001752,74.125.68.0-255,4320,144672,8,368731
24843,0.001755,172.31.36.0-255,66,144738,8,368731
24844,0.001772,74.125.68.0-255,1484,146222,8,368731
24845,0.001777,74.125.68.0-255,2902,149124,8,368731
24846,0.001778,172.31.36.0-255,66,149190,8,368731
24847,0.001783,74.125.68.0-255,2902,152092,8,368731
24848,0.001785,172.31.36.0-255,66,152158,8,368731
24849,0.001804,74.125.68.0-255,1484,153642,8,368731
24850,0.00181,74.125.68.0-255,4320,157962,8,368731
24851,0.001813,172.31.36.0-255,66,158028,8,368731
24852,0.001832,74.125.68.0-255,4320,162348,8,368731
24853,0.001834,172.31.36.0-255,66,162414,8,368731
24854,0.001864,74.125.68.0-255,2902,165316,8,368731
24855,0.001867,172.31.36.0-255,66,165382,8,368731
24856,0.001889,74.125.68.0-255,5020,170402,8,368731
24857,0.001891,172.31.36.0-255,66,170468,8,368731
24858,0.003931,74.125.68.0-255,4320,174788,8,368731
24859,0.003934,172.31.36.0-255,66,174854,8,368731
24860,0.003947,74.125.68.0-255,1484,176338,8,368731
24861,0.005966,74.125.68.0-255,4320,180658,8,368731
24862,0.005972,172.31.36.0-255,66,180724,8,368731
24863,0.008026,74.125.68.0-255,5738,186462,8,368731
24864,0.008035,172.31.36.0-255,66,186528,8,368731
24865,0.010093,74.125.68.0-255,5738,192266,8,368731
24866,0.010101,172.31.36.0-255,66,192332,8,368731
24867,0.012147,74.125.68.0-255,5738,198070,8,368731
24868,0.012158,172.31.36.0-255,66,198136,8,368731
24869,0.014211,74.125.68.0-255,5738,203874,8,368731
24870,0.014225,172.31.36.0-255,66,203940,8,368731
24871,0.016258,74.125.68.0-255,5738,209678,8,368731
24872,0.016267,172.31.36.0-255,66,209744,8,368731
24873,0.018323,74.125.68.0-255,5738,215482,8,368731
24874,0.018331,172.31.36.0-255,66,215548,8,368731
24875,0.02038,74.125.68.0-255,5738,221286,8,368731
24876,0.02039,172.31.36.0-255,66,221352,8,368731
24877,0.022435,74.125.68.0-255,5738,227090,8,368731
24878,0.022444,172.31.36.0-255,66,227156,8,368731
24879,0.024484,74.125.68.0-255,5738,232894,8,368731
24880,0.024493,172.31.36.0-255,66,232960,8,368731
24881,0.025344,172.31.36.0-255,172,233132,8,368731
24882,0.025372,172.31.36.0-255,1112,234244,8,368731
24883,0.025428,172.31.36.0-255,1514,235758,8,368731
24884,0.02543,172.31.36.0-255,1514,237272,8,368731
24885,0.025436,172.31.36.0-255,1514,238786,8,368731
24886,0.025437,172.31.36.0-255,771,239557,8,368731
24887,0.02653,74.125.68.0-255,2902,242459,8,368731
24888,0.026535,172.31.36.0-255,66,242525,8,368731
24889,0.026565,74.125.68.0-255,2902,245427,8,368731
24890,0.026568,172.31.36.0-255,66,245493,8,368731
24891,0.02694,104.244.42.0-255,66,245559,8,368731
24892,0.026946,104.244.42.0-255,66,245625,8,368731
24893,0.027042,104.244.42.0-255,66,245691,8,368731
24894,0.027045,104.244.42.0-255,66,245757,8,368731
24895,0.028559,74.125.68.0-255,2902,248659,8,368731
24896,0.028562,172.31.36.0-255,66,248725,8,368731
24897,0.028613,74.125.68.0-255,2902,251627,8,368731
24898,0.028616,172.31.36.0-255,66,251693,8,368731
24899,0.030596,74.125.68.0-255,2902,254595,8,368731
24900,0.030601,172.31.36.0-255,66,254661,8,368731
24901,0.030643,74.125.68.0-255,2902,257563,8,368731
24902,0.030647,172.31.36.0-255,66,257629,8,368731
24903,0.032639,74.125.68.0-255,2902,260531,8,368731
24904,0.032645,172.31.36.0-255,66,260597,8,368731
24905,0.03268,74.125.68.0-255,2902,263499,8,368731
24906,0.032683,172.31.36.0-255,66,263565,8,368731
24907,0.034687,74.125.68.0-255,2902,266467,8,368731
24908,0.034693,172.31.36.0-255,66,266533,8,368731
24909,0.034729,74.125.68.0-255,2902,269435,8,368731
24910,0.034732,172.31.36.0-255,66,269501,8,368731
24911,0.036731,74.125.68.0-255,2902,272403,8,368731
24912,0.036736,172.31.36.0-255,66,272469,8,368731
24913,0.036771,74.125.68.0-255,2902,275371,8,368731
24914,0.036775,172.31.36.0-255,66,275437,8,368731
24915,0.038756,74.125.68.0-255,2902,278339,8,368731
24916,0.038762,172.31.36.0-255,66,278405,8,368731
24917,0.038835,74.125.68.0-255,2902,281307,8,368731
24918,0.03884,172.31.36.0-255,66,281373,8,368731
24919,0.040796,74.125.68.0-255,2902,284275,8,368731
24920,0.040802,172.31.36.0-255,66,284341,8,368731
24921,0.040861,74.125.68.0-255,2902,287243,8,368731
24922,0.040865,172.31.36.0-255,66,287309,8,368731
24923,0.042835,74.125.68.0-255,2902,290211,8,368731
24924,0.042856,172.31.36.0-255,66,290277,8,368731
24925,0.042891,74.125.68.0-255,2902,293179,8,368731
24926,0.042896,172.31.36.0-255,66,293245,8,368731
24927,0.044901,74.125.68.0-255,2902,296147,8,368731
24928,0.044906,172.31.36.0-255,66,296213,8,368731
24929,0.04494,74.125.68.0-255,2902,299115,8,368731
24930,0.044943,172.31.36.0-255,66,299181,8,368731
24931,0.046934,74.125.68.0-255,2902,302083,8,368731
24932,0.046941,172.31.36.0-255,66,302149,8,368731
24933,0.046962,74.125.68.0-255,2902,305051,8,368731
24934,0.046965,172.31.36.0-255,66,305117,8,368731
24935,0.048969,74.125.68.0-255,1484,306601,8,368731
24936,0.049,74.125.68.0-255,4320,310921,8,368731
24937,0.049005,172.31.36.0-255,66,310987,8,368731
24938,0.051045,74.125.68.0-255,4320,315307,8,368731
24939,0.05105,172.31.36.0-255,66,315373,8,368731
24940,0.051079,74.125.68.0-255,1484,316857,8,368731
24941,0.053081,74.125.68.0-255,4320,321177,8,368731
24942,0.053086,172.31.36.0-255,66,321243,8,368731
24943,0.05512,74.125.68.0-255,2902,324145,8,368731
24944,0.055127,172.31.36.0-255,66,324211,8,368731
24945,0.05515,74.125.68.0-255,2902,327113,8,368731
24946,0.055153,172.31.36.0-255,66,327179,8,368731
24947,0.057159,74.125.68.0-255,2902,330081,8,368731
24948,0.057165,172.31.36.0-255,66,330147,8,368731
24949,0.0572,74.125.68.0-255,2902,333049,8,368731
24950,0.057203,172.31.36.0-255,66,333115,8,368731
24951,0.059187,74.125.68.0-255,2902,336017,8,368731
24952,0.059193,172.31.36.0-255,66,336083,8,368731
24953,0.059227,74.125.68.0-255,2902,338985,8,368731
24954,0.05923,172.31.36.0-255,66,339051,8,368731
24955,0.061217,74.125.68.0-255,2902,341953,8,368731
24956,0.061222,172.31.36.0-255,66,342019,8,368731
24957,0.061251,74.125.68.0-255,2902,344921,8,368731
24958,0.061254,172.31.36.0-255,66,344987,8,368731
24959,0.063247,74.125.68.0-255,2902,347889,8,368731
24960,0.063253,172.31.36.0-255,66,347955,8,368731
24961,0.063281,74.125.68.0-255,2902,350857,8,368731
24962,0.063284,172.31.36.0-255,66,350923,8,368731
24963,0.065292,74.125.68.0-255,2902,353825,8,368731
24964,0.065297,172.31.36.0-255,66,353891,8,368731
24965,0.06533,74.125.68.0-255,2902,356793,8,368731
24966,0.065334,172.31.36.0-255,66,356859,8,368731
24967,0.067328,74.125.68.0-255,2902,359761,8,368731
24968,0.067333,172.31.36.0-255,66,359827,8,368731
24969,0.067367,74.125.68.0-255,2902,362729,8,368731
24970,0.06737,172.31.36.0-255,66,362795,8,368731
24971,0.069363,74.125.68.0-255,2902,365697,8,368731
24972,0.069368,172.31.36.0-255,66,365763,8,368731
24973,0.069401,74.125.68.0-255,2902,368665,8,368731
24974,0.069405,172.31.36.0-255,66,368731,8,368731
24975,0.0,172.217.194.0-255,146,146,8,222465
24976,3.6e-05,172.31.36.0-255,66,212,8,222465
24977,4.4e-05,172.217.194.0-255,1484,1696,8,222465
24978,4.9e-05,172.31.36.0-255,66,1762,8,222465
24979,6.2e-05,172.217.194.0-255,2902,4664,8,222465
24980,6.6e-05,172.31.36.0-255,66,4730,8,222465
24981,7.4e-05,172.217.194.0-255,7156,11886,8,222465
24982,7.6e-05,172.31.36.0-255,66,11952,8,222465
24983,8.7e-05,172.31.36.0-255,66,12018,8,222465
24984,0.000138,172.31.36.0-255,66,12084,8,222465
24985,0.000207,172.217.194.0-255,1484,13568,8,222465
24986,0.000212,172.31.36.0-255,66,13634,8,222465
24987,0.000216,172.217.194.0-255,2902,16536,8,222465
24988,0.000219,172.31.36.0-255,66,16602,8,222465
24989,0.000232,172.217.194.0-255,5738,22340,8,222465
24990,0.000235,172.31.36.0-255,66,22406,8,222465
24991,0.000238,172.217.194.0-255,1484,23890,8,222465
24992,0.00024,172.31.36.0-255,66,23956,8,222465
24993,0.000278,172.217.194.0-255,5379,29335,8,222465
24994,0.000281,172.31.36.0-255,66,29401,8,222465
24995,0.000287,172.217.194.0-255,4320,33721,8,222465
24996,0.000288,172.31.36.0-255,66,33787,8,222465
24997,0.000334,172.31.36.0-255,66,33853,8,222465
24998,0.000339,172.217.194.0-255,2795,36648,8,222465
24999,0.000341,172.31.36.0-255,66,36714,8,222465
25000,0.000343,172.217.194.0-255,121,36835,8,222465
25001,0.000352,172.31.36.0-255,66,36901,8,222465
25002,0.000383,172.217.194.0-255,1484,38385,8,222465
25003,0.000387,172.217.194.0-255,2902,41287,8,222465
25004,0.000389,172.31.36.0-255,66,41353,8,222465
25005,0.000389,172.217.194.0-255,1484,42837,8,222465
25006,0.000393,172.31.36.0-255,66,42903,8,222465
25007,0.000396,172.31.36.0-255,66,42969,8,222465
25008,0.000416,172.217.194.0-255,2902,45871,8,222465
25009,0.000419,172.31.36.0-255,66,45937,8,222465
25010,0.000445,172.217.194.0-255,5738,51675,8,222465
25011,0.000454,172.31.36.0-255,66,51741,8,222465
25012,0.00046,172.217.194.0-255,5738,57479,8,222465
25013,0.000462,172.31.36.0-255,66,57545,8,222465
25014,0.000494,172.217.194.0-255,1125,58670,8,222465
25015,0.000498,172.31.36.0-255,66,58736,8,222465
25016,0.000505,172.217.194.0-255,7156,65892,8,222465
25017,0.000507,172.31.36.0-255,66,65958,8,222465
25018,0.000519,172.217.194.0-255,5379,71337,8,222465
25019,0.000522,172.31.36.0-255,66,71403,8,222465
25020,0.000656,172.217.194.0-255,1484,72887,8,222465
25021,0.000661,172.31.36.0-255,66,72953,8,222465
25022,0.00069,172.217.194.0-255,2902,75855,8,222465
25023,0.000693,172.31.36.0-255,66,75921,8,222465
25024,0.0007,172.217.194.0-255,5738,81659,8,222465
25025,0.000702,172.31.36.0-255,66,81725,8,222465
25026,0.000729,172.217.194.0-255,7156,88881,8,222465
25027,0.000732,172.31.36.0-255,66,88947,8,222465
25028,0.000761,172.217.194.0-255,5738,94685,8,222465
25029,0.000764,172.31.36.0-255,66,94751,8,222465
25030,0.00077,172.217.194.0-255,4320,99071,8,222465
25031,0.000772,172.31.36.0-255,66,99137,8,222465
25032,0.000785,172.217.194.0-255,6438,105575,8,222465
25033,0.000787,172.31.36.0-255,66,105641,8,222465
25034,0.00082,172.217.194.0-255,7156,112797,8,222465
25035,0.000823,172.31.36.0-255,66,112863,8,222465
25036,0.00083,172.217.194.0-255,7156,120019,8,222465
25037,0.000833,172.31.36.0-255,66,120085,8,222465
25038,0.000889,172.31.36.0-255,66,120151,8,222465
25039,0.000931,172.217.194.0-255,5738,125889,8,222465
25040,0.000935,172.31.36.0-255,66,125955,8,222465
25041,0.000956,172.31.36.0-255,66,126021,8,222465
25042,0.000971,172.31.36.0-255,66,126087,8,222465
25043,0.000982,172.31.36.0-255,66,126153,8,222465
25044,0.000992,172.31.36.0-255,66,126219,8,222465
25045,0.00102,172.217.194.0-255,3694,129913,8,222465
25046,0.001028,172.31.36.0-255,66,129979,8,222465
25047,0.001041,172.31.36.0-255,66,130045,8,222465
25048,0.001045,172.217.194.0-255,3961,134006,8,222465
25049,0.001047,172.31.36.0-255,66,134072,8,222465
25050,0.001094,172.217.194.0-255,1484,135556,8,222465
25051,0.0011,172.217.194.0-255,2902,138458,8,222465
25052,0.001103,172.31.36.0-255,66,138524,8,222465
25053,0.001134,172.217.194.0-255,5738,144262,8,222465
25054,0.001139,172.31.36.0-255,66,144328,8,222465
25055,0.001141,172.217.194.0-255,7156,151484,8,222465
25056,0.001143,172.31.36.0-255,66,151550,8,222465
25057,0.001185,172.217.194.0-255,5738,157288,8,222465
25058,0.00119,172.31.36.0-255,66,157354,8,222465
25059,0.001197,172.31.36.0-255,66,157420,8,222465
25060,0.00152,172.217.194.0-255,1484,158904,8,222465
25061,0.00155,172.217.194.0-255,2902,161806,8,222465
25062,0.001555,172.31.36.0-255,66,161872,8,222465
25063,0.001562,172.217.194.0-255,5738,167610,8,222465
25064,0.001565,172.31.36.0-255,66,167676,8,222465
25065,0.001588,172.217.194.0-255,2902,170578,8,222465
25066,0.001592,172.31.36.0-255,66,170644,8,222465
25067,0.001628,172.217.194.0-255,3961,174605,8,222465
25068,0.001632,172.31.36.0-255,66,174671,8,222465
25069,0.001635,172.217.194.0-255,1484,176155,8,222465
25070,0.001654,172.217.194.0-255,2902,179057,8,222465
25071,0.001658,172.31.36.0-255,66,179123,8,222465
25072,0.001664,172.217.194.0-255,5738,184861,8,222465
25073,0.001667,172.31.36.0-255,66,184927,8,222465
25074,0.00167,172.217.194.0-255,1484,186411,8,222465
25075,0.001715,172.31.36.0-255,66,186477,8,222465
25076,0.001751,172.31.36.0-255,66,186543,8,222465
25077,0.002096,172.217.194.0-255,1484,188027,8,222465
25078,0.002103,172.217.194.0-255,2902,190929,8,222465
25079,0.002109,172.31.36.0-255,66,190995,8,222465
25080,0.002123,172.217.194.0-255,1484,192479,8,222465
25081,0.002152,172.217.194.0-255,4320,196799,8,222465
25082,0.002156,172.31.36.0-255,66,196865,8,222465
25083,0.002159,172.217.194.0-255,1484,198349,8,222465
25084,0.002166,172.217.194.0-255,7156,205505,8,222465
25085,0.002168,172.31.36.0-255,66,205571,8,222465
25086,0.002184,172.217.194.0-255,1484,207055,8,222465
25087,0.002257,172.31.36.0-255,66,207121,8,222465
25088,0.002277,172.217.194.0-255,1484,208605,8,222465
25089,0.002279,172.31.36.0-255,66,208671,8,222465
25090,0.00232,172.31.36.0-255,66,208737,8,222465
25091,0.002352,172.217.194.0-255,2902,211639,8,222465
25092,0.002356,172.31.36.0-255,66,211705,8,222465
25093,0.00238,172.31.36.0-255,66,211771,8,222465
25094,0.002393,172.31.36.0-255,66,211837,8,222465
25095,0.002396,172.217.194.0-255,105,211942,8,222465
25096,0.004283,172.31.36.0-255,66,212008,8,222465
25097,0.004322,172.31.36.0-255,105,212113,8,222465
25098,0.006657,172.217.194.0-255,66,212179,8,222465
25099,0.03978,172.31.36.0-255,172,212351,8,222465
25100,0.039807,172.31.36.0-255,1111,213462,8,222465
25101,0.039864,172.31.36.0-255,1514,214976,8,222465
25102,0.039866,172.31.36.0-255,1514,216490,8,222465
25103,0.039871,172.31.36.0-255,1514,218004,8,222465
25104,0.039873,172.31.36.0-255,1514,219518,8,222465
25105,0.039892,172.31.36.0-255,1514,221032,8,222465
25106,0.039894,172.31.36.0-255,995,222027,8,222465
25107,0.041363,104.244.42.0-255,66,222093,8,222465
25108,0.041376,104.244.42.0-255,66,222159,8,222465
25109,0.041458,104.244.42.0-255,66,222225,8,222465
25110,0.041465,104.244.42.0-255,66,222291,8,222465
25111,0.045589,172.31.36.0-255,108,222399,8,222465
25112,0.047174,104.244.42.0-255,66,222465,8,222465
25113,0.0,74.125.68.0-255,298,298,8,370479
25114,2.6e-05,172.31.36.0-255,66,364,8,370479
25115,3.2e-05,74.125.68.0-255,1484,1848,8,370479
25116,3.6e-05,172.31.36.0-255,66,1914,8,370479
25117,4.8e-05,74.125.68.0-255,1484,3398,8,370479
25118,5e-05,172.31.36.0-255,66,3464,8,370479
25119,8.9e-05,74.125.68.0-255,1484,4948,8,370479
25120,9.2e-05,172.31.36.0-255,66,5014,8,370479
25121,0.000106,74.125.68.0-255,1484,6498,8,370479
25122,0.000108,172.31.36.0-255,66,6564,8,370479
25123,0.000115,74.125.68.0-255,5738,12302,8,370479
25124,0.000118,172.31.36.0-255,66,12368,8,370479
25125,0.000148,74.125.68.0-255,6086,18454,8,370479
25126,0.000152,172.31.36.0-255,66,18520,8,370479
25127,0.000156,74.125.68.0-255,2902,21422,8,370479
25128,0.000158,172.31.36.0-255,66,21488,8,370479
25129,0.000176,74.125.68.0-255,4320,25808,8,370479
25130,0.000181,172.31.36.0-255,66,25874,8,370479
25131,0.000207,74.125.68.0-255,4320,30194,8,370479
25132,0.00021,172.31.36.0-255,66,30260,8,370479
25133,0.000228,74.125.68.0-255,1125,31385,8,370479
25134,0.00023,172.31.36.0-255,66,31451,8,370479
25135,0.000312,74.125.68.0-255,1484,32935,8,370479
25136,0.000316,172.31.36.0-255,66,33001,8,370479
25137,0.000323,74.125.68.0-255,2902,35903,8,370479
25138,0.000326,172.31.36.0-255,66,35969,8,370479
25139,0.000348,74.125.68.0-255,4320,40289,8,370479
25140,0.000351,172.31.36.0-255,66,40355,8,370479
25141,0.000356,74.125.68.0-255,2902,43257,8,370479
25142,0.000358,172.31.36.0-255,66,43323,8,370479
25143,0.000374,74.125.68.0-255,2902,46225,8,370479
25144,0.000377,172.31.36.0-255,66,46291,8,370479
25145,0.000396,74.125.68.0-255,2902,49193,8,370479
25146,0.000399,172.31.36.0-255,66,49259,8,370479
25147,0.00043,74.125.68.0-255,6797,56056,8,370479
25148,0.000431,172.31.36.0-255,101,56157,8,370479
25149,0.000438,172.31.36.0-255,66,56223,8,370479
25150,0.000441,172.31.36.0-255,66,56289,8,370479
25151,0.000444,74.125.68.0-255,112,56401,8,370479
25152,0.000535,74.125.68.0-255,1484,57885,8,370479
25153,0.000538,172.31.36.0-255,66,57951,8,370479
25154,0.000542,74.125.68.0-255,1484,59435,8,370479
25155,0.000545,74.125.68.0-255,1484,60919,8,370479
25156,0.000547,172.31.36.0-255,66,60985,8,370479
25157,0.000566,74.125.68.0-255,1484,62469,8,370479
25158,0.000572,74.125.68.0-255,5738,68207,8,370479
25159,0.000575,172.31.36.0-255,66,68273,8,370479
25160,0.000599,74.125.68.0-255,2902,71175,8,370479
25161,0.000601,172.31.36.0-255,66,71241,8,370479
25162,0.000627,74.125.68.0-255,7156,78397,8,370479
25163,0.00063,172.31.36.0-255,66,78463,8,370479
25164,0.000644,172.31.36.0-255,66,78529,8,370479
25165,0.000647,74.125.68.0-255,1031,79560,8,370479
25166,0.001154,74.125.68.0-255,1484,81044,8,370479
25167,0.001159,172.31.36.0-255,66,81110,8,370479
25168,0.001167,74.125.68.0-255,2902,84012,8,370479
25169,0.001169,172.31.36.0-255,66,84078,8,370479
25170,0.00119,74.125.68.0-255,1484,85562,8,370479
25171,0.001207,74.125.68.0-255,4320,89882,8,370479
25172,0.00121,172.31.36.0-255,66,89948,8,370479
25173,0.001214,74.125.68.0-255,1484,91432,8,370479
25174,0.001217,74.125.68.0-255,2902,94334,8,370479
25175,0.001219,172.31.36.0-255,66,94400,8,370479
25176,0.001241,74.125.68.0-255,5738,100138,8,370479
25177,0.001243,172.31.36.0-255,66,100204,8,370479
25178,0.00127,172.31.36.0-255,66,100270,8,370479
25179,0.001304,74.125.68.0-255,3602,103872,8,370479
25180,0.001306,172.31.36.0-255,66,103938,8,370479
25181,0.001402,74.125.68.0-255,1484,105422,8,370479
25182,0.001406,74.125.68.0-255,1484,106906,8,370479
25183,0.001409,172.31.36.0-255,66,106972,8,370479
25184,0.001425,74.125.68.0-255,1484,108456,8,370479
25185,0.001442,74.125.68.0-255,1484,109940,8,370479
25186,0.001444,172.31.36.0-255,66,110006,8,370479
25187,0.001469,74.125.68.0-255,4320,114326,8,370479
25188,0.001471,172.31.36.0-255,66,114392,8,370479
25189,0.001477,74.125.68.0-255,5738,120130,8,370479
25190,0.001478,172.31.36.0-255,66,120196,8,370479
25191,0.001483,74.125.68.0-255,4320,124516,8,370479
25192,0.001485,172.31.36.0-255,66,124582,8,370479
25193,0.001508,74.125.68.0-255,2902,127484,8,370479
25194,0.00151,172.31.36.0-255,66,127550,8,370479
25195,0.001515,74.125.68.0-255,4320,131870,8,370479
25196,0.001516,172.31.36.0-255,66,131936,8,370479
25197,0.001532,74.125.68.0-255,6438,138374,8,370479
25198,0.001534,172.31.36.0-255,66,138440,8,370479
25199,0.001623,74.125.68.0-255,1484,139924,8,370479
25200,0.001628,74.125.68.0-255,2902,142826,8,370479
25201,0.001631,172.31.36.0-255,66,142892,8,370479
25202,0.001654,74.125.68.0-255,5738,148630,8,370479
25203,0.001658,172.31.36.0-255,66,148696,8,370479
25204,0.001662,74.125.68.0-255,2902,151598,8,370479
25205,0.001665,172.31.36.0-255,66,151664,8,370479
25206,0.001691,74.125.68.0-255,4320,155984,8,370479
25207,0.001695,172.31.36.0-255,66,156050,8,370479
25208,0.00171,74.125.68.0-255,5738,161788,8,370479
25209,0.001713,172.31.36.0-255,66,161854,8,370479
25210,0.001746,74.125.68.0-255,2902,164756,8,370479
25211,0.001749,172.31.36.0-255,66,164822,8,370479
25212,0.001769,74.125.68.0-255,7156,171978,8,370479
25213,0.001771,172.31.36.0-255,66,172044,8,370479
25214,0.001774,74.125.68.0-255,766,172810,8,370479
25215,0.002385,74.125.68.0-255,66,172876,8,370479
25216,0.003759,74.125.68.0-255,4320,177196,8,370479
25217,0.003765,172.31.36.0-255,66,177262,8,370479
25218,0.00576,74.125.68.0-255,5738,183000,8,370479
25219,0.005763,172.31.36.0-255,66,183066,8,370479
25220,0.00777,74.125.68.0-255,5738,188804,8,370479
25221,0.007777,172.31.36.0-255,66,188870,8,370479
25222,0.009794,74.125.68.0-255,5738,194608,8,370479
25223,0.009803,172.31.36.0-255,66,194674,8,370479
25224,0.011834,74.125.68.0-255,5738,200412,8,370479
25225,0.011843,172.31.36.0-255,66,200478,8,370479
25226,0.013857,74.125.68.0-255,5738,206216,8,370479
25227,0.013867,172.31.36.0-255,66,206282,8,370479
25228,0.015868,74.125.68.0-255,5738,212020,8,370479
25229,0.01588,172.31.36.0-255,66,212086,8,370479
25230,0.017872,74.125.68.0-255,5738,217824,8,370479
25231,0.017881,172.31.36.0-255,66,217890,8,370479
25232,0.019893,74.125.68.0-255,5738,223628,8,370479
25233,0.019901,172.31.36.0-255,66,223694,8,370479
25234,0.021889,74.125.68.0-255,5738,229432,8,370479
25235,0.021896,172.31.36.0-255,66,229498,8,370479
25236,0.023895,74.125.68.0-255,5738,235236,8,370479
25237,0.023903,172.31.36.0-255,66,235302,8,370479
25238,0.025902,74.125.68.0-255,5738,241040,8,370479
25239,0.025911,172.31.36.0-255,66,241106,8,370479
25240,0.027336,172.31.36.0-255,172,241278,8,370479
25241,0.027367,172.31.36.0-255,1112,242390,8,370479
25242,0.027409,172.31.36.0-255,1514,243904,8,370479
25243,0.027411,172.31.36.0-255,1514,245418,8,370479
25244,0.027417,172.31.36.0-255,1514,246932,8,370479
25245,0.027418,172.31.36.0-255,771,247703,8,370479
25246,0.02791,74.125.68.0-255,5738,253441,8,370479
25247,0.027916,172.31.36.0-255,66,253507,8,370479
25248,0.028914,104.244.42.0-255,66,253573,8,370479
25249,0.028921,104.244.42.0-255,66,253639,8,370479
25250,0.028948,104.244.42.0-255,66,253705,8,370479
25251,0.028951,104.244.42.0-255,66,253771,8,370479
25252,0.029902,74.125.68.0-255,4320,258091,8,370479
25253,0.029906,172.31.36.0-255,66,258157,8,370479
25254,0.029933,74.125.68.0-255,1484,259641,8,370479
25255,0.031889,74.125.68.0-255,2902,262543,8,370479
25256,0.031895,172.31.36.0-255,66,262609,8,370479
25257,0.031924,74.125.68.0-255,1484,264093,8,370479
25258,0.033885,74.125.68.0-255,4320,268413,8,370479
25259,0.03389,172.31.36.0-255,66,268479,8,370479
25260,0.035874,74.125.68.0-255,4320,272799,8,370479
25261,0.03588,172.31.36.0-255,66,272865,8,370479
25262,0.035911,74.125.68.0-255,1484,274349,8,370479
25263,0.037871,74.125.68.0-255,4320,278669,8,370479
25264,0.037876,172.31.36.0-255,66,278735,8,370479
25265,0.03987,74.125.68.0-255,5738,284473,8,370479
25266,0.039876,172.31.36.0-255,66,284539,8,370479
25267,0.04187,74.125.68.0-255,5738,290277,8,370479
25268,0.041877,172.31.36.0-255,66,290343,8,370479
25269,0.043882,74.125.68.0-255,4320,294663,8,370479
25270,0.043889,172.31.36.0-255,66,294729,8,370479
25271,0.043906,74.125.68.0-255,1484,296213,8,370479
25272,0.045865,74.125.68.0-255,2902,299115,8,370479
25273,0.045871,172.31.36.0-255,66,299181,8,370479
25274,0.045903,74.125.68.0-255,1484,300665,8,370479
25275,0.047862,74.125.68.0-255,1484,302149,8,370479
25276,0.047868,172.31.36.0-255,66,302215,8,370479
25277,0.047896,74.125.68.0-255,2902,305117,8,370479
25278,0.047899,172.31.36.0-255,66,305183,8,370479
25279,0.049861,74.125.68.0-255,2902,308085,8,370479
25280,0.049866,172.31.36.0-255,66,308151,8,370479
25281,0.049901,74.125.68.0-255,2902,311053,8,370479
25282,0.049904,172.31.36.0-255,66,311119,8,370479
25283,0.051873,74.125.68.0-255,2902,314021,8,370479
25284,0.051878,172.31.36.0-255,66,314087,8,370479
25285,0.051906,74.125.68.0-255,2902,316989,8,370479
25286,0.051909,172.31.36.0-255,66,317055,8,370479
25287,0.053868,74.125.68.0-255,2902,319957,8,370479
25288,0.053873,172.31.36.0-255,66,320023,8,370479
25289,0.053908,74.125.68.0-255,2902,322925,8,370479
25290,0.053911,172.31.36.0-255,66,322991,8,370479
25291,0.055867,74.125.68.0-255,2902,325893,8,370479
25292,0.055874,172.31.36.0-255,66,325959,8,370479
25293,0.055904,74.125.68.0-255,2902,328861,8,370479
25294,0.055907,172.31.36.0-255,66,328927,8,370479
25295,0.057869,74.125.68.0-255,2902,331829,8,370479
25296,0.057875,172.31.36.0-255,66,331895,8,370479
25297,0.057896,74.125.68.0-255,2902,334797,8,370479
25298,0.057899,172.31.36.0-255,66,334863,8,370479
25299,0.059859,74.125.68.0-255,2902,337765,8,370479
25300,0.059864,172.31.36.0-255,66,337831,8,370479
25301,0.059895,74.125.68.0-255,2902,340733,8,370479
25302,0.059898,172.31.36.0-255,66,340799,8,370479
25303,0.061861,74.125.68.0-255,2902,343701,8,370479
25304,0.061867,172.31.36.0-255,66,343767,8,370479
25305,0.061902,74.125.68.0-255,2902,346669,8,370479
25306,0.061905,172.31.36.0-255,66,346735,8,370479
25307,0.063844,74.125.68.0-255,2902,349637,8,370479
25308,0.063849,172.31.36.0-255,66,349703,8,370479
25309,0.063913,74.125.68.0-255,2902,352605,8,370479
25310,0.063917,172.31.36.0-255,66,352671,8,370479
25311,0.06583,74.125.68.0-255,2902,355573,8,370479
25312,0.065836,172.31.36.0-255,66,355639,8,370479
25313,0.065905,74.125.68.0-255,2902,358541,8,370479
25314,0.06591,172.31.36.0-255,66,358607,8,370479
25315,0.067812,74.125.68.0-255,2902,361509,8,370479
25316,0.067817,172.31.36.0-255,66,361575,8,370479
25317,0.067885,74.125.68.0-255,2902,364477,8,370479
25318,0.06789,172.31.36.0-255,66,364543,8,370479
25319,0.069801,74.125.68.0-255,2902,367445,8,370479
25320,0.069806,172.31.36.0-255,66,367511,8,370479
25321,0.069872,74.125.68.0-255,2902,370413,8,370479
25322,0.069876,172.31.36.0-255,66,370479,8,370479
25323,0.0,74.125.68.0-255,154,154,8,141448
25324,2.9e-05,172.31.36.0-255,66,220,8,141448
25325,3.6e-05,74.125.68.0-255,1484,1704,8,141448
25326,4.1e-05,172.31.36.0-255,66,1770,8,141448
25327,5.7e-05,74.125.68.0-255,2902,4672,8,141448
25328,6.1e-05,172.31.36.0-255,66,4738,8,141448
25329,6.6e-05,74.125.68.0-255,2902,7640,8,141448
25330,6.8e-05,172.31.36.0-255,66,7706,8,141448
25331,8.5e-05,74.125.68.0-255,1484,9190,8,141448
25332,9.2e-05,172.31.36.0-255,66,9256,8,141448
25333,0.000164,74.125.68.0-255,4853,14109,8,141448
25334,0.000167,172.31.36.0-255,66,14175,8,141448
25335,0.000262,74.125.68.0-255,5738,19913,8,141448
25336,0.000267,172.31.36.0-255,66,19979,8,141448
25337,0.000379,74.125.68.0-255,1484,21463,8,141448
25338,0.000382,172.31.36.0-255,66,21529,8,141448
25339,0.000404,74.125.68.0-255,2902,24431,8,141448
25340,0.000407,172.31.36.0-255,66,24497,8,141448
25341,0.000433,74.125.68.0-255,5738,30235,8,141448
25342,0.000436,172.31.36.0-255,66,30301,8,141448
25343,0.000568,74.125.68.0-255,1125,31426,8,141448
25344,0.000572,172.31.36.0-255,66,31492,8,141448
25345,0.000599,74.125.68.0-255,1484,32976,8,141448
25346,0.000602,172.31.36.0-255,66,33042,8,141448
25347,0.000627,74.125.68.0-255,5738,38780,8,141448
25348,0.00063,172.31.36.0-255,66,38846,8,141448
25349,0.000651,74.125.68.0-255,7156,46002,8,141448
25350,0.000654,172.31.36.0-255,66,46068,8,141448
25351,0.000898,74.125.68.0-255,2543,48611,8,141448
25352,0.000903,172.31.36.0-255,66,48677,8,141448
25353,0.001015,74.125.68.0-255,1484,50161,8,141448
25354,0.001019,172.31.36.0-255,66,50227,8,141448
25355,0.001045,74.125.68.0-255,1484,51711,8,141448
25356,0.001051,74.125.68.0-255,2902,54613,8,141448
25357,0.001053,172.31.36.0-255,66,54679,8,141448
25358,0.001114,74.125.68.0-255,4320,58999,8,141448
25359,0.001117,172.31.36.0-255,66,59065,8,141448
25360,0.001135,74.125.68.0-255,1484,60549,8,141448
25361,0.001225,74.125.68.0-255,1484,62033,8,141448
25362,0.001231,172.31.36.0-255,66,62099,8,141448
25363,0.001251,74.125.68.0-255,3961,66060,8,141448
25364,0.001253,172.31.36.0-255,66,66126,8,141448
25365,0.001347,74.125.68.0-255,5738,71864,8,141448
25366,0.001353,172.31.36.0-255,66,71930,8,141448
25367,0.001476,74.125.68.0-255,4320,76250,8,141448
25368,0.001482,172.31.36.0-255,66,76316,8,141448
25369,0.001509,172.31.36.0-255,66,76382,8,141448
25370,0.001752,172.31.36.0-255,66,76448,8,141448
25371,0.001782,74.125.68.0-255,2184,78632,8,141448
25372,0.001785,172.31.36.0-255,66,78698,8,141448
25373,0.002035,74.125.68.0-255,1484,80182,8,141448
25374,0.002077,172.31.36.0-255,66,80248,8,141448
25375,0.002096,74.125.68.0-255,5738,85986,8,141448
25376,0.002098,172.31.36.0-255,66,86052,8,141448
25377,0.002655,74.125.68.0-255,1484,87536,8,141448
25378,0.00267,74.125.68.0-255,2184,89720,8,141448
25379,0.002672,172.31.36.0-255,66,89786,8,141448
25380,0.002719,74.125.68.0-255,4320,94106,8,141448
25381,0.002721,172.31.36.0-255,66,94172,8,141448
25382,0.002744,172.31.36.0-255,66,94238,8,141448
25383,0.002794,172.31.36.0-255,66,94304,8,141448
25384,0.00341,74.125.68.0-255,4320,98624,8,141448
25385,0.003414,172.31.36.0-255,66,98690,8,141448
25386,0.003449,172.31.36.0-255,66,98756,8,141448
25387,0.003864,74.125.68.0-255,2902,101658,8,141448
25388,0.003867,172.31.36.0-255,66,101724,8,141448
25389,0.003948,74.125.68.0-255,7156,108880,8,141448
25390,0.00399,74.125.68.0-255,1466,110346,8,141448
25391,0.004299,172.31.36.0-255,66,110412,8,141448
25392,0.004801,74.125.68.0-255,1484,111896,8,141448
25393,0.004898,172.31.36.0-255,66,111962,8,141448
25394,0.004942,172.31.36.0-255,66,112028,8,141448
25395,0.005468,172.31.36.0-255,66,112094,8,141448
25396,0.005529,172.31.36.0-255,66,112160,8,141448
25397,0.006437,74.125.68.0-255,7156,119316,8,141448
25398,0.006443,172.31.36.0-255,66,119382,8,141448
25399,0.00648,74.125.68.0-255,7156,126538,8,141448
25400,0.006485,172.31.36.0-255,66,126604,8,141448
25401,0.006742,172.31.36.0-255,66,126670,8,141448
25402,0.006801,172.31.36.0-255,66,126736,8,141448
25403,0.007728,74.125.68.0-255,4320,131056,8,141448
25404,0.007733,172.31.36.0-255,66,131122,8,141448
25405,0.007768,172.31.36.0-255,66,131188,8,141448
25406,0.007986,74.125.68.0-255,4320,135508,8,141448
25407,0.007988,172.31.36.0-255,66,135574,8,141448
25408,0.008013,172.31.36.0-255,66,135640,8,141448
25409,0.008039,74.125.68.0-255,4771,140411,8,141448
25410,0.008042,172.31.36.0-255,66,140477,8,141448
25411,0.009154,172.31.36.0-255,105,140582,8,141448
25412,0.011368,74.125.68.0-255,66,140648,8,141448
25413,0.039283,172.31.36.0-255,172,140820,8,141448
25414,0.039317,172.31.36.0-255,562,141382,8,141448
25415,0.041495,104.244.42.0-255,66,141448,8,141448
25416,0.0,74.125.24.0-255,373,373,8,186828
25417,2.3e-05,172.31.36.0-255,66,439,8,186828
25418,3e-05,74.125.24.0-255,1484,1923,8,186828
25419,3.3e-05,172.31.36.0-255,66,1989,8,186828
25420,5.1e-05,74.125.24.0-255,1484,3473,8,186828
25421,5.4e-05,172.31.36.0-255,66,3539,8,186828
25422,7.4e-05,74.125.24.0-255,2902,6441,8,186828
25423,7.8e-05,172.31.36.0-255,66,6507,8,186828
25424,0.000256,172.31.36.0-255,66,6573,8,186828
25425,0.000583,74.125.24.0-255,7156,13729,8,186828
25426,0.000589,172.31.36.0-255,66,13795,8,186828
25427,0.000618,74.125.24.0-255,7156,20951,8,186828
25428,0.000622,172.31.36.0-255,66,21017,8,186828
25429,0.001236,74.125.24.0-255,2543,23560,8,186828
25430,0.001242,172.31.36.0-255,66,23626,8,186828
25431,0.002603,74.125.24.0-255,1696,25322,8,186828
25432,0.00261,172.31.36.0-255,66,25388,8,186828
25433,0.003771,74.125.24.0-255,2902,28290,8,186828
25434,0.003776,172.31.36.0-255,66,28356,8,186828
25435,0.005114,74.125.24.0-255,2902,31258,8,186828
25436,0.005118,172.31.36.0-255,66,31324,8,186828
25437,0.006311,74.125.24.0-255,2902,34226,8,186828
25438,0.006316,172.31.36.0-255,66,34292,8,186828
25439,0.007684,74.125.24.0-255,2902,37194,8,186828
25440,0.007691,172.31.36.0-255,66,37260,8,186828
25441,0.008848,74.125.24.0-255,1272,38532,8,186828
25442,0.008855,172.31.36.0-255,66,38598,8,186828
25443,0.008876,74.125.24.0-255,1484,40082,8,186828
25444,0.00888,172.31.36.0-255,66,40148,8,186828
25445,0.01025,74.125.24.0-255,2902,43050,8,186828
25446,0.010257,172.31.36.0-255,66,43116,8,186828
25447,0.01139,74.125.24.0-255,1484,44600,8,186828
25448,0.011398,172.31.36.0-255,66,44666,8,186828
25449,0.011419,74.125.24.0-255,1484,46150,8,186828
25450,0.011424,172.31.36.0-255,66,46216,8,186828
25451,0.012827,74.125.24.0-255,2902,49118,8,186828
25452,0.012834,172.31.36.0-255,66,49184,8,186828
25453,0.013956,74.125.24.0-255,1484,50668,8,186828
25454,0.013963,172.31.36.0-255,66,50734,8,186828
25455,0.013985,74.125.24.0-255,1484,52218,8,186828
25456,0.013988,172.31.36.0-255,66,52284,8,186828
25457,0.015405,74.125.24.0-255,1484,53768,8,186828
25458,0.015411,172.31.36.0-255,66,53834,8,186828
25459,0.015433,74.125.24.0-255,1484,55318,8,186828
25460,0.015436,172.31.36.0-255,66,55384,8,186828
25461,0.016542,74.125.24.0-255,2902,58286,8,186828
25462,0.016548,172.31.36.0-255,66,58352,8,186828
25463,0.017964,74.125.24.0-255,1484,59836,8,186828
25464,0.017972,172.31.36.0-255,66,59902,8,186828
25465,0.019112,74.125.24.0-255,4320,64222,8,186828
25466,0.019119,172.31.36.0-255,66,64288,8,186828
25467,0.020526,74.125.24.0-255,1484,65772,8,186828
25468,0.020533,172.31.36.0-255,66,65838,8,186828
25469,0.02165,74.125.24.0-255,2902,68740,8,186828
25470,0.021657,172.31.36.0-255,66,68806,8,186828
25471,0.021701,74.125.24.0-255,1484,70290,8,186828
25472,0.023099,74.125.24.0-255,1484,71774,8,186828
25473,0.023106,172.31.36.0-255,66,71840,8,186828
25474,0.024186,74.125.24.0-255,2902,74742,8,186828
25475,0.024192,172.31.36.0-255,66,74808,8,186828
25476,0.025451,172.31.36.0-255,172,74980,8,186828
25477,0.025495,172.31.36.0-255,1110,76090,8,186828
25478,0.025591,172.31.36.0-255,1514,77604,8,186828
25479,0.025593,172.31.36.0-255,1514,79118,8,186828
25480,0.025598,172.31.36.0-255,1514,80632,8,186828
25481,0.025599,172.31.36.0-255,1514,82146,8,186828
25482,0.025655,74.125.24.0-255,2902,85048,8,186828
25483,0.02566,172.31.36.0-255,66,85114,8,186828
25484,0.025672,172.31.36.0-255,1230,86344,8,186828
25485,0.026755,74.125.24.0-255,2902,89246,8,186828
25486,0.026761,172.31.36.0-255,66,89312,8,186828
25487,0.026986,104.244.42.0-255,66,89378,8,186828
25488,0.027021,104.244.42.0-255,66,89444,8,186828
25489,0.027133,104.244.42.0-255,66,89510,8,186828
25490,0.027178,104.244.42.0-255,66,89576,8,186828
25491,0.027238,104.244.42.0-255,66,89642,8,186828
25492,0.028209,74.125.24.0-255,2902,92544,8,186828
25493,0.028212,172.31.36.0-255,66,92610,8,186828
25494,0.029315,74.125.24.0-255,2902,95512,8,186828
25495,0.02932,172.31.36.0-255,66,95578,8,186828
25496,0.030767,74.125.24.0-255,2902,98480,8,186828
25497,0.030774,172.31.36.0-255,66,98546,8,186828
25498,0.031904,74.125.24.0-255,2902,101448,8,186828
25499,0.03191,172.31.36.0-255,66,101514,8,186828
25500,0.033315,74.125.24.0-255,2902,104416,8,186828
25501,0.033322,172.31.36.0-255,66,104482,8,186828
25502,0.034424,74.125.24.0-255,2902,107384,8,186828
25503,0.034432,172.31.36.0-255,66,107450,8,186828
25504,0.035863,74.125.24.0-255,2902,110352,8,186828
25505,0.035869,172.31.36.0-255,66,110418,8,186828
25506,0.036969,74.125.24.0-255,2902,113320,8,186828
25507,0.036974,172.31.36.0-255,66,113386,8,186828
25508,0.038397,74.125.24.0-255,1484,114870,8,186828
25509,0.038402,172.31.36.0-255,66,114936,8,186828
25510,0.039518,74.125.24.0-255,4320,119256,8,186828
25511,0.039523,172.31.36.0-255,66,119322,8,186828
25512,0.040927,74.125.24.0-255,1484,120806,8,186828
25513,0.040932,172.31.36.0-255,66,120872,8,186828
25514,0.042052,74.125.24.0-255,4320,125192,8,186828
25515,0.042057,172.31.36.0-255,66,125258,8,186828
25516,0.043485,74.125.24.0-255,1484,126742,8,186828
25517,0.04349,172.31.36.0-255,66,126808,8,186828
25518,0.0446,74.125.24.0-255,4320,131128,8,186828
25519,0.044605,172.31.36.0-255,66,131194,8,186828
25520,0.046032,74.125.24.0-255,1484,132678,8,186828
25521,0.046037,172.31.36.0-255,66,132744,8,186828
25522,0.047123,74.125.24.0-255,4320,137064,8,186828
25523,0.047129,172.31.36.0-255,66,137130,8,186828
25524,0.048579,74.125.24.0-255,1484,138614,8,186828
25525,0.048585,172.31.36.0-255,66,138680,8,186828
25526,0.049652,74.125.24.0-255,4320,143000,8,186828
25527,0.049658,172.31.36.0-255,66,143066,8,186828
25528,0.051102,74.125.24.0-255,1484,144550,8,186828
25529,0.051109,172.31.36.0-255,66,144616,8,186828
25530,0.052203,74.125.24.0-255,4320,148936,8,186828
25531,0.052209,172.31.36.0-255,66,149002,8,186828
25532,0.053666,74.125.24.0-255,1484,150486,8,186828
25533,0.053679,172.31.36.0-255,66,150552,8,186828
25534,0.054737,74.125.24.0-255,4320,154872,8,186828
25535,0.054743,172.31.36.0-255,66,154938,8,186828
25536,0.056202,74.125.24.0-255,1484,156422,8,186828
25537,0.056207,172.31.36.0-255,66,156488,8,186828
25538,0.057281,74.125.24.0-255,2902,159390,8,186828
25539,0.057286,172.31.36.0-255,66,159456,8,186828
25540,0.057331,74.125.24.0-255,1484,160940,8,186828
25541,0.057335,172.31.36.0-255,66,161006,8,186828
25542,0.058725,74.125.24.0-255,1484,162490,8,186828
25543,0.05873,172.31.36.0-255,66,162556,8,186828
25544,0.059826,74.125.24.0-255,2902,165458,8,186828
25545,0.059832,172.31.36.0-255,66,165524,8,186828
25546,0.059873,74.125.24.0-255,1484,167008,8,186828
25547,0.059877,172.31.36.0-255,66,167074,8,186828
25548,0.06128,74.125.24.0-255,1484,168558,8,186828
25549,0.0613,172.31.36.0-255,66,168624,8,186828
25550,0.062347,74.125.24.0-255,2902,171526,8,186828
25551,0.062352,172.31.36.0-255,66,171592,8,186828
25552,0.062397,74.125.24.0-255,1484,173076,8,186828
25553,0.062402,172.31.36.0-255,66,173142,8,186828
25554,0.063835,74.125.24.0-255,1484,174626,8,186828
25555,0.063841,172.31.36.0-255,66,174692,8,186828
25556,0.064915,74.125.24.0-255,2902,177594,8,186828
25557,0.064921,172.31.36.0-255,66,177660,8,186828
25558,0.064958,74.125.24.0-255,1484,179144,8,186828
25559,0.064961,172.31.36.0-255,66,179210,8,186828
25560,0.066379,74.125.24.0-255,1484,180694,8,186828
25561,0.066385,172.31.36.0-255,66,180760,8,186828
25562,0.067469,74.125.24.0-255,2902,183662,8,186828
25563,0.067476,172.31.36.0-255,66,183728,8,186828
25564,0.067517,74.125.24.0-255,1484,185212,8,186828
25565,0.06752,172.31.36.0-255,66,185278,8,186828
25566,0.068944,74.125.24.0-255,1484,186762,8,186828
25567,0.068951,172.31.36.0-255,66,186828,8,186828
25568,0.0,74.125.24.0-255,153,153,8,315208
25569,2.3e-05,172.31.36.0-255,66,219,8,315208
25570,2.9e-05,74.125.24.0-255,1484,1703,8,315208
25571,3.3e-05,172.31.36.0-255,66,1769,8,315208
25572,3.8e-05,74.125.24.0-255,2902,4671,8,315208
25573,4.1e-05,172.31.36.0-255,66,4737,8,315208
25574,5.5e-05,74.125.24.0-255,4320,9057,8,315208
25575,5.7e-05,172.31.36.0-255,66,9123,8,315208
25576,6.2e-05,74.125.24.0-255,4850,13973,8,315208
25577,6.5e-05,172.31.36.0-255,66,14039,8,315208
25578,0.00011,172.31.36.0-255,66,14105,8,315208
25579,0.000115,74.125.24.0-255,5379,19484,8,315208
25580,0.000117,172.31.36.0-255,66,19550,8,315208
25581,0.000159,74.125.24.0-255,1484,21034,8,315208
25582,0.000161,172.31.36.0-255,66,21100,8,315208
25583,0.000166,74.125.24.0-255,2902,24002,8,315208
25584,0.000168,172.31.36.0-255,66,24068,8,315208
25585,0.000174,74.125.24.0-255,5738,29806,8,315208
25586,0.00018,172.31.36.0-255,66,29872,8,315208
25587,0.000213,74.125.24.0-255,5738,35610,8,315208
25588,0.000216,172.31.36.0-255,66,35676,8,315208
25589,0.000237,74.125.24.0-255,1125,36801,8,315208
25590,0.000239,172.31.36.0-255,66,36867,8,315208
25591,0.000454,74.125.24.0-255,1484,38351,8,315208
25592,0.000459,172.31.36.0-255,66,38417,8,315208
25593,0.000463,74.125.24.0-255,1484,39901,8,315208
25594,0.000465,172.31.36.0-255,66,39967,8,315208
25595,0.000509,74.125.24.0-255,1484,41451,8,315208
25596,0.000514,74.125.24.0-255,5738,47189,8,315208
25597,0.000517,74.125.24.0-255,2902,50091,8,315208
25598,0.000522,172.31.36.0-255,66,50157,8,315208
25599,0.000525,172.31.36.0-255,66,50223,8,315208
25600,0.000528,172.31.36.0-255,66,50289,8,315208
25601,0.00055,74.125.24.0-255,3961,54250,8,315208
25602,0.000553,172.31.36.0-255,66,54316,8,315208
25603,0.000581,74.125.24.0-255,647,54963,8,315208
25604,0.000868,74.125.24.0-255,1484,56447,8,315208
25605,0.000873,74.125.24.0-255,2902,59349,8,315208
25606,0.000878,172.31.36.0-255,66,59415,8,315208
25607,0.000882,172.31.36.0-255,66,59481,8,315208
25608,0.000912,74.125.24.0-255,5738,65219,8,315208
25609,0.000916,172.31.36.0-255,66,65285,8,315208
25610,0.000922,74.125.24.0-255,4320,69605,8,315208
25611,0.000924,172.31.36.0-255,66,69671,8,315208
25612,0.000936,172.31.36.0-255,66,69737,8,315208
25613,0.000961,74.125.24.0-255,1484,71221,8,315208
25614,0.000979,74.125.24.0-255,6438,77659,8,315208
25615,0.000982,172.31.36.0-255,66,77725,8,315208
25616,0.001062,74.125.24.0-255,1484,79209,8,315208
25617,0.001075,74.125.24.0-255,2902,82111,8,315208
25618,0.001078,172.31.36.0-255,66,82177,8,315208
25619,0.001081,74.125.24.0-255,1484,83661,8,315208
25620,0.001105,74.125.24.0-255,4320,87981,8,315208
25621,0.001108,172.31.36.0-255,66,88047,8,315208
25622,0.001114,74.125.24.0-255,5738,93785,8,315208
25623,0.001116,172.31.36.0-255,66,93851,8,315208
25624,0.001121,74.125.24.0-255,4320,98171,8,315208
25625,0.001123,172.31.36.0-255,66,98237,8,315208
25626,0.00116,172.31.36.0-255,66,98303,8,315208
25627,0.001166,74.125.24.0-255,5020,103323,8,315208
25628,0.001169,172.31.36.0-255,66,103389,8,315208
25629,0.001194,74.125.24.0-255,1484,104873,8,315208
25630,0.001206,74.125.24.0-255,2902,107775,8,315208
25631,0.001209,172.31.36.0-255,66,107841,8,315208
25632,0.001275,74.125.24.0-255,5738,113579,8,315208
25633,0.001287,172.31.36.0-255,66,113645,8,315208
25634,0.001294,172.31.36.0-255,66,113711,8,315208
25635,0.00131,172.31.36.0-255,66,113777,8,315208
25636,0.001329,74.125.24.0-255,1484,115261,8,315208
25637,0.001334,74.125.24.0-255,1634,116895,8,315208
25638,0.001336,172.31.36.0-255,66,116961,8,315208
25639,0.001367,172.31.36.0-255,66,117027,8,315208
25640,0.001389,74.125.24.0-255,2902,119929,8,315208
25641,0.001393,74.125.24.0-255,4320,124249,8,315208
25642,0.001398,172.31.36.0-255,66,124315,8,315208
25643,0.001401,172.31.36.0-255,66,124381,8,315208
25644,0.001423,172.31.36.0-255,66,124447,8,315208
25645,0.001428,74.125.24.0-255,4320,128767,8,315208
25646,0.001431,172.31.36.0-255,66,128833,8,315208
25647,0.001454,74.125.24.0-255,2184,131017,8,315208
25648,0.001457,172.31.36.0-255,66,131083,8,315208
25649,0.001612,74.125.24.0-255,1484,132567,8,315208
25650,0.001632,74.125.24.0-255,2902,135469,8,315208
25651,0.001636,172.31.36.0-255,66,135535,8,315208
25652,0.001641,74.125.24.0-255,2902,138437,8,315208
25653,0.001643,172.31.36.0-255,66,138503,8,315208
25654,0.001678,74.125.24.0-255,2902,141405,8,315208
25655,0.001682,172.31.36.0-255,66,141471,8,315208
25656,0.001688,74.125.24.0-255,4320,145791,8,315208
25657,0.00169,172.31.36.0-255,66,145857,8,315208
25658,0.001697,74.125.24.0-255,7156,153013,8,315208
25659,0.001699,172.31.36.0-255,66,153079,8,315208
25660,0.001736,74.125.24.0-255,4320,157399,8,315208
25661,0.001749,172.31.36.0-255,66,157465,8,315208
25662,0.001757,172.31.36.0-255,66,157531,8,315208
25663,0.001802,74.125.24.0-255,1484,159015,8,315208
25664,0.001814,74.125.24.0-255,1484,160499,8,315208
25665,0.001817,172.31.36.0-255,66,160565,8,315208
25666,0.001845,74.125.24.0-255,1484,162049,8,315208
25667,0.001853,74.125.24.0-255,5738,167787,8,315208
25668,0.001856,172.31.36.0-255,66,167853,8,315208
25669,0.001874,172.31.36.0-255,66,167919,8,315208
25670,0.001917,74.125.24.0-255,2902,170821,8,315208
25671,0.001921,172.31.36.0-255,66,170887,8,315208
25672,0.001958,172.31.36.0-255,66,170953,8,315208
25673,0.002232,74.125.24.0-255,1484,172437,8,315208
25674,0.002239,74.125.24.0-255,2902,175339,8,315208
25675,0.002243,172.31.36.0-255,66,175405,8,315208
25676,0.002266,74.125.24.0-255,5738,181143,8,315208
25677,0.00227,172.31.36.0-255,66,181209,8,315208
25678,0.002273,74.125.24.0-255,1484,182693,8,315208
25679,0.002302,74.125.24.0-255,5738,188431,8,315208
25680,0.002305,172.31.36.0-255,66,188497,8,315208
25681,0.002338,74.125.24.0-255,2902,191399,8,315208
25682,0.002342,172.31.36.0-255,66,191465,8,315208
25683,0.002349,74.125.24.0-255,5738,197203,8,315208
25684,0.002351,172.31.36.0-255,66,197269,8,315208
25685,0.002385,172.31.36.0-255,66,197335,8,315208
25686,0.004759,74.125.24.0-255,5738,203073,8,315208
25687,0.004776,172.31.36.0-255,66,203139,8,315208
25688,0.007127,74.125.24.0-255,5738,208877,8,315208
25689,0.007134,172.31.36.0-255,66,208943,8,315208
25690,0.009506,74.125.24.0-255,5738,214681,8,315208
25691,0.009513,172.31.36.0-255,66,214747,8,315208
25692,0.011873,74.125.24.0-255,5738,220485,8,315208
25693,0.011882,172.31.36.0-255,66,220551,8,315208
25694,0.014228,74.125.24.0-255,5738,226289,8,315208
25695,0.014239,172.31.36.0-255,66,226355,8,315208
25696,0.016597,74.125.24.0-255,5738,232093,8,315208
25697,0.016605,172.31.36.0-255,66,232159,8,315208
25698,0.018947,74.125.24.0-255,5738,237897,8,315208
25699,0.018956,172.31.36.0-255,66,237963,8,315208
25700,0.02129,74.125.24.0-255,5738,243701,8,315208
25701,0.021299,172.31.36.0-255,66,243767,8,315208
25702,0.021735,172.31.36.0-255,101,243868,8,315208
25703,0.023639,74.125.24.0-255,5738,249606,8,315208
25704,0.023646,172.31.36.0-255,66,249672,8,315208
25705,0.024051,74.125.24.0-255,66,249738,8,315208
25706,0.025997,74.125.24.0-255,5738,255476,8,315208
25707,0.026006,172.31.36.0-255,66,255542,8,315208
25708,0.028348,74.125.24.0-255,5738,261280,8,315208
25709,0.028375,172.31.36.0-255,66,261346,8,315208
25710,0.03076,74.125.24.0-255,5738,267084,8,315208
25711,0.030772,172.31.36.0-255,66,267150,8,315208
25712,0.03182,172.31.36.0-255,172,267322,8,315208
25713,0.031868,172.31.36.0-255,1113,268435,8,315208
25714,0.031948,172.31.36.0-255,1514,269949,8,315208
25715,0.031951,172.31.36.0-255,1514,271463,8,315208
25716,0.031955,172.31.36.0-255,1514,272977,8,315208
25717,0.031956,172.31.36.0-255,770,273747,8,315208
25718,0.033143,74.125.24.0-255,5738,279485,8,315208
25719,0.03315,172.31.36.0-255,66,279551,8,315208
25720,0.033359,104.244.42.0-255,66,279617,8,315208
25721,0.033413,104.244.42.0-255,66,279683,8,315208
25722,0.033505,104.244.42.0-255,66,279749,8,315208
25723,0.033511,104.244.42.0-255,66,279815,8,315208
25724,0.035505,74.125.24.0-255,5738,285553,8,315208
25725,0.035512,172.31.36.0-255,66,285619,8,315208
25726,0.037884,74.125.24.0-255,5738,291357,8,315208
25727,0.037894,172.31.36.0-255,66,291423,8,315208
25728,0.040247,74.125.24.0-255,5738,297161,8,315208
25729,0.040254,172.31.36.0-255,66,297227,8,315208
25730,0.042586,74.125.24.0-255,4320,301547,8,315208
25731,0.042591,172.31.36.0-255,66,301613,8,315208
25732,0.042629,74.125.24.0-255,1484,303097,8,315208
25733,0.044919,74.125.24.0-255,4320,307417,8,315208
25734,0.044925,172.31.36.0-255,66,307483,8,315208
25735,0.047306,74.125.24.0-255,2902,310385,8,315208
25736,0.047312,172.31.36.0-255,66,310451,8,315208
25737,0.047342,74.125.24.0-255,2902,313353,8,315208
25738,0.047347,172.31.36.0-255,66,313419,8,315208
25739,0.049667,74.125.24.0-255,1552,314971,8,315208
25740,0.049673,172.31.36.0-255,66,315037,8,315208
25741,0.049842,172.31.36.0-255,105,315142,8,315208
25742,0.056567,74.125.24.0-255,66,315208,8,315208
25743,0.0,74.125.24.0-255,153,153,8,253284
25744,2.2e-05,172.31.36.0-255,66,219,8,253284
25745,2.9e-05,74.125.24.0-255,1484,1703,8,253284
25746,3.4e-05,172.31.36.0-255,66,1769,8,253284
25747,4e-05,74.125.24.0-255,2902,4671,8,253284
25748,4.3e-05,172.31.36.0-255,66,4737,8,253284
25749,5.2e-05,74.125.24.0-255,7156,11893,8,253284
25750,5.6e-05,172.31.36.0-255,66,11959,8,253284
25751,6e-05,74.125.24.0-255,2027,13986,8,253284
25752,6.2e-05,172.31.36.0-255,66,14052,8,253284
25753,9.2e-05,74.125.24.0-255,5738,19790,8,253284
25754,9.5e-05,172.31.36.0-255,66,19856,8,253284
25755,0.000116,74.125.24.0-255,5738,25594,8,253284
25756,0.000119,172.31.36.0-255,66,25660,8,253284
25757,0.000141,74.125.24.0-255,4320,29980,8,253284
25758,0.000144,172.31.36.0-255,66,30046,8,253284
25759,0.000165,74.125.24.0-255,2543,32589,8,253284
25760,0.000168,172.31.36.0-255,66,32655,8,253284
25761,0.000175,74.125.24.0-255,7156,39811,8,253284
25762,0.000178,172.31.36.0-255,66,39877,8,253284
25763,0.000181,74.125.24.0-255,1484,41361,8,253284
25764,0.000183,172.31.36.0-255,66,41427,8,253284
25765,0.000213,74.125.24.0-255,6797,48224,8,253284
25766,0.000216,172.31.36.0-255,66,48290,8,253284
25767,0.000245,74.125.24.0-255,1484,49774,8,253284
25768,0.000247,172.31.36.0-255,66,49840,8,253284
25769,0.000252,74.125.24.0-255,2902,52742,8,253284
25770,0.000254,172.31.36.0-255,66,52808,8,253284
25771,0.00026,74.125.24.0-255,4320,57128,8,253284
25772,0.000262,172.31.36.0-255,66,57194,8,253284
25773,0.000281,74.125.24.0-255,1484,58678,8,253284
25774,0.000283,172.31.36.0-255,66,58744,8,253284
25775,0.000433,74.125.24.0-255,1484,60228,8,253284
25776,0.00044,74.125.24.0-255,2902,63130,8,253284
25777,0.00046,74.125.24.0-255,5738,68868,8,253284
25778,0.000522,74.125.24.0-255,5738,74606,8,253284
25779,0.000536,74.125.24.0-255,2543,77149,8,253284
25780,0.000563,74.125.24.0-255,6797,83946,8,253284
25781,0.000625,172.31.36.0-255,66,84012,8,253284
25782,0.000967,74.125.24.0-255,1484,85496,8,253284
25783,0.000975,74.125.24.0-255,2902,88398,8,253284
25784,0.000978,74.125.24.0-255,1484,89882,8,253284
25785,0.000993,74.125.24.0-255,4320,94202,8,253284
25786,0.001005,172.31.36.0-255,66,94268,8,253284
25787,0.001013,74.125.24.0-255,5738,100006,8,253284
25788,0.001015,74.125.24.0-255,1484,101490,8,253284
25789,0.001038,172.31.36.0-255,66,101556,8,253284
25790,0.001061,74.125.24.0-255,4470,106026,8,253284
25791,0.001073,172.31.36.0-255,66,106092,8,253284
25792,0.001156,74.125.24.0-255,1484,107576,8,253284
25793,0.001162,74.125.24.0-255,2902,110478,8,253284
25794,0.001179,74.125.24.0-255,5738,116216,8,253284
25795,0.001194,74.125.24.0-255,4320,120536,8,253284
25796,0.001197,172.31.36.0-255,66,120602,8,253284
25797,0.001218,74.125.24.0-255,7156,127758,8,253284
25798,0.001222,172.31.36.0-255,66,127824,8,253284
25799,0.001257,74.125.24.0-255,3602,131426,8,253284
25800,0.001273,172.31.36.0-255,66,131492,8,253284
25801,0.001379,74.125.24.0-255,1484,132976,8,253284
25802,0.001397,74.125.24.0-255,2902,135878,8,253284
25803,0.001413,74.125.24.0-255,4320,140198,8,253284
25804,0.001419,172.31.36.0-255,66,140264,8,253284
25805,0.001436,74.125.24.0-255,1484,141748,8,253284
25806,0.001444,74.125.24.0-255,7156,148904,8,253284
25807,0.001468,74.125.24.0-255,2902,151806,8,253284
25808,0.001471,74.125.24.0-255,2184,153990,8,253284
25809,0.00148,172.31.36.0-255,66,154056,8,253284
25810,0.00158,74.125.24.0-255,1484,155540,8,253284
25811,0.001587,74.125.24.0-255,2902,158442,8,253284
25812,0.001593,74.125.24.0-255,5738,164180,8,253284
25813,0.001611,172.31.36.0-255,66,164246,8,253284
25814,0.001664,74.125.24.0-255,5738,169984,8,253284
25815,0.001682,74.125.24.0-255,5020,175004,8,253284
25816,0.001691,172.31.36.0-255,66,175070,8,253284
25817,0.001759,74.125.24.0-255,1484,176554,8,253284
25818,0.001777,74.125.24.0-255,2902,179456,8,253284
25819,0.00178,74.125.24.0-255,1484,180940,8,253284
25820,0.001795,74.125.24.0-255,4320,185260,8,253284
25821,0.001809,172.31.36.0-255,66,185326,8,253284
25822,0.001835,74.125.24.0-255,7156,192482,8,253284
25823,0.001873,172.31.36.0-255,66,192548,8,253284
25824,0.001883,74.125.24.0-255,3602,196150,8,253284
25825,0.001906,172.31.36.0-255,66,196216,8,253284
25826,0.002354,74.125.24.0-255,1484,197700,8,253284
25827,0.00236,74.125.24.0-255,2902,200602,8,253284
25828,0.002364,172.31.36.0-255,66,200668,8,253284
25829,0.002372,74.125.24.0-255,5738,206406,8,253284
25830,0.002374,74.125.24.0-255,1484,207890,8,253284
25831,0.002386,74.125.24.0-255,1484,209374,8,253284
25832,0.002405,74.125.24.0-255,7156,216530,8,253284
25833,0.002413,172.31.36.0-255,66,216596,8,253284
25834,0.002419,172.31.36.0-255,66,216662,8,253284
25835,0.002436,74.125.24.0-255,5738,222400,8,253284
25836,0.002451,172.31.36.0-255,66,222466,8,253284
25837,0.002465,172.31.36.0-255,66,222532,8,253284
25838,0.002533,74.125.24.0-255,1484,224016,8,253284
25839,0.002538,74.125.24.0-255,2902,226918,8,253284
25840,0.002544,74.125.24.0-255,4320,231238,8,253284
25841,0.002559,74.125.24.0-255,1484,232722,8,253284
25842,0.002565,74.125.24.0-255,4320,237042,8,253284
25843,0.002572,172.31.36.0-255,66,237108,8,253284
25844,0.002611,74.125.24.0-255,1484,238592,8,253284
25845,0.002626,172.31.36.0-255,66,238658,8,253284
25846,0.002641,74.125.24.0-255,2902,241560,8,253284
25847,0.00267,172.31.36.0-255,66,241626,8,253284
25848,0.002693,74.125.24.0-255,2184,243810,8,253284
25849,0.002758,172.31.36.0-255,66,243876,8,253284
25850,0.002763,172.31.36.0-255,66,243942,8,253284
25851,0.002803,172.31.36.0-255,66,244008,8,253284
25852,0.002811,74.125.24.0-255,105,244113,8,253284
25853,0.002967,172.31.36.0-255,101,244214,8,253284
25854,0.005276,74.125.24.0-255,66,244280,8,253284
25855,0.011087,172.31.36.0-255,105,244385,8,253284
25856,0.013399,74.125.24.0-255,66,244451,8,253284
25857,0.040223,172.31.36.0-255,172,244623,8,253284
25858,0.040258,172.31.36.0-255,1112,245735,8,253284
25859,0.040326,172.31.36.0-255,1514,247249,8,253284
25860,0.040328,172.31.36.0-255,1514,248763,8,253284
25861,0.040333,172.31.36.0-255,1514,250277,8,253284
25862,0.040334,172.31.36.0-255,1514,251791,8,253284
25863,0.040352,172.31.36.0-255,1229,253020,8,253284
25864,0.041745,104.244.42.0-255,66,253086,8,253284
25865,0.041849,104.244.42.0-255,66,253152,8,253284
25866,0.041893,104.244.42.0-255,66,253218,8,253284
25867,0.041896,104.244.42.0-255,66,253284,8,253284
25868,0.0,172.217.194.0-255,152,152,8,186522
25869,1.6e-05,172.31.36.0-255,66,218,8,186522
25870,2.3e-05,172.217.194.0-255,1484,1702,8,186522
25871,2.8e-05,172.31.36.0-255,66,1768,8,186522
25872,4.2e-05,172.217.194.0-255,2902,4670,8,186522
25873,4.6e-05,172.31.36.0-255,66,4736,8,186522
25874,5.2e-05,172.217.194.0-255,5738,10474,8,186522
25875,5.5e-05,172.31.36.0-255,66,10540,8,186522
25876,6.2e-05,172.217.194.0-255,5738,16278,8,186522
25877,6.4e-05,172.31.36.0-255,66,16344,8,186522
25878,8.3e-05,172.217.194.0-255,4924,21268,8,186522
25879,9e-05,172.31.36.0-255,66,21334,8,186522
25880,9.9e-05,172.217.194.0-255,7156,28490,8,186522
25881,0.000101,172.31.36.0-255,66,28556,8,186522
25882,0.00013,172.217.194.0-255,2543,31099,8,186522
25883,0.000133,172.31.36.0-255,66,31165,8,186522
25884,0.000175,172.217.194.0-255,1484,32649,8,186522
25885,0.000177,172.31.36.0-255,66,32715,8,186522
25886,0.000207,172.217.194.0-255,2902,35617,8,186522
25887,0.00021,172.31.36.0-255,66,35683,8,186522
25888,0.000216,172.217.194.0-255,5738,41421,8,186522
25889,0.000218,172.31.36.0-255,66,41487,8,186522
25890,0.00026,172.31.36.0-255,66,41553,8,186522
25891,0.000273,172.31.36.0-255,66,41619,8,186522
25892,0.000275,172.217.194.0-255,344,41963,8,186522
25893,0.000277,172.31.36.0-255,66,42029,8,186522
25894,0.000364,172.217.194.0-255,117,42146,8,186522
25895,0.000368,172.31.36.0-255,66,42212,8,186522
25896,0.000371,172.217.194.0-255,378,42590,8,186522
25897,0.000373,172.31.36.0-255,66,42656,8,186522
25898,0.000544,172.217.194.0-255,1484,44140,8,186522
25899,0.000551,172.217.194.0-255,2902,47042,8,186522
25900,0.000554,172.31.36.0-255,66,47108,8,186522
25901,0.000562,172.217.194.0-255,5738,52846,8,186522
25902,0.000564,172.31.36.0-255,66,52912,8,186522
25903,0.000601,172.31.36.0-255,66,52978,8,186522
25904,0.000607,172.217.194.0-255,4320,57298,8,186522
25905,0.00061,172.31.36.0-255,66,57364,8,186522
25906,0.000635,172.217.194.0-255,4320,61684,8,186522
25907,0.000639,172.31.36.0-255,66,61750,8,186522
25908,0.000643,172.217.194.0-255,2184,63934,8,186522
25909,0.000645,172.31.36.0-255,66,64000,8,186522
25910,0.001096,172.217.194.0-255,1484,65484,8,186522
25911,0.001102,172.217.194.0-255,2902,68386,8,186522
25912,0.001104,172.217.194.0-255,1484,69870,8,186522
25913,0.001111,172.31.36.0-255,66,69936,8,186522
25914,0.001123,172.217.194.0-255,4320,74256,8,186522
25915,0.001125,172.31.36.0-255,66,74322,8,186522
25916,0.001168,172.31.36.0-255,66,74388,8,186522
25917,0.001181,172.31.36.0-255,66,74454,8,186522
25918,0.001591,172.217.194.0-255,1484,75938,8,186522
25919,0.00161,172.217.194.0-255,2902,78840,8,186522
25920,0.001613,172.31.36.0-255,66,78906,8,186522
25921,0.001621,172.217.194.0-255,5738,84644,8,186522
25922,0.001623,172.31.36.0-255,66,84710,8,186522
25923,0.00165,172.217.194.0-255,5738,90448,8,186522
25924,0.001653,172.31.36.0-255,66,90514,8,186522
25925,0.001687,172.217.194.0-255,7156,97670,8,186522
25926,0.001695,172.217.194.0-255,7156,104826,8,186522
25927,0.0017,172.31.36.0-255,66,104892,8,186522
25928,0.001708,172.31.36.0-255,66,104958,8,186522
25929,0.001713,172.217.194.0-255,3602,108560,8,186522
25930,0.00172,172.31.36.0-255,66,108626,8,186522
25931,0.002064,172.217.194.0-255,1484,110110,8,186522
25932,0.00207,172.217.194.0-255,2902,113012,8,186522
25933,0.002074,172.31.36.0-255,66,113078,8,186522
25934,0.002109,172.217.194.0-255,5738,118816,8,186522
25935,0.002124,172.31.36.0-255,66,118882,8,186522
25936,0.002127,172.31.36.0-255,66,118948,8,186522
25937,0.002138,172.217.194.0-255,1484,120432,8,186522
25938,0.002155,172.31.36.0-255,66,120498,8,186522
25939,0.002158,172.217.194.0-255,766,121264,8,186522
25940,0.002438,172.217.194.0-255,1484,122748,8,186522
25941,0.002443,172.31.36.0-255,66,122814,8,186522
25942,0.002449,172.217.194.0-255,2902,125716,8,186522
25943,0.002451,172.31.36.0-255,66,125782,8,186522
25944,0.002455,172.217.194.0-255,1484,127266,8,186522
25945,0.00247,172.31.36.0-255,66,127332,8,186522
25946,0.002537,172.31.36.0-255,66,127398,8,186522
25947,0.00255,172.31.36.0-255,66,127464,8,186522
25948,0.002555,172.217.194.0-255,4320,131784,8,186522
25949,0.002557,172.31.36.0-255,66,131850,8,186522
25950,0.00259,172.217.194.0-255,1484,133334,8,186522
25951,0.002601,172.217.194.0-255,7156,140490,8,186522
25952,0.002604,172.31.36.0-255,66,140556,8,186522
25953,0.002607,172.217.194.0-255,1484,142040,8,186522
25954,0.00262,172.31.36.0-255,66,142106,8,186522
25955,0.002624,172.217.194.0-255,1484,143590,8,186522
25956,0.002663,172.31.36.0-255,66,143656,8,186522
25957,0.002675,172.31.36.0-255,66,143722,8,186522
25958,0.002707,172.217.194.0-255,5738,149460,8,186522
25959,0.00271,172.31.36.0-255,66,149526,8,186522
25960,0.002745,172.31.36.0-255,66,149592,8,186522
25961,0.002748,172.217.194.0-255,1484,151076,8,186522
25962,0.002751,172.31.36.0-255,78,151154,8,186522
25963,0.002766,172.31.36.0-255,78,151232,8,186522
25964,0.002794,172.217.194.0-255,3602,154834,8,186522
25965,0.002797,172.31.36.0-255,66,154900,8,186522
25966,0.002808,172.31.36.0-255,66,154966,8,186522
25967,0.002813,172.217.194.0-255,5738,160704,8,186522
25968,0.002816,172.31.36.0-255,66,160770,8,186522
25969,0.002833,172.31.36.0-255,66,160836,8,186522
25970,0.002836,172.217.194.0-255,1484,162320,8,186522
25971,0.002838,172.217.194.0-255,1484,163804,8,186522
25972,0.00284,172.31.36.0-255,66,163870,8,186522
25973,0.002843,172.217.194.0-255,1484,165354,8,186522
25974,0.002927,172.31.36.0-255,66,165420,8,186522
25975,0.00295,172.217.194.0-255,1484,166904,8,186522
25976,0.002955,172.217.194.0-255,3602,170506,8,186522
25977,0.002958,172.31.36.0-255,66,170572,8,186522
25978,0.00296,172.217.194.0-255,1484,172056,8,186522
25979,0.002965,172.217.194.0-255,2902,174958,8,186522
25980,0.002967,172.31.36.0-255,66,175024,8,186522
25981,0.002973,172.217.194.0-255,5738,180762,8,186522
25982,0.002976,172.31.36.0-255,66,180828,8,186522
25983,0.002979,172.217.194.0-255,1065,181893,8,186522
25984,0.002981,172.217.194.0-255,105,181998,8,186522
25985,0.007839,172.31.36.0-255,66,182064,8,186522
25986,0.007882,172.31.36.0-255,105,182169,8,186522
25987,0.010195,172.217.194.0-255,66,182235,8,186522
25988,0.040007,172.31.36.0-255,171,182406,8,186522
25989,0.04004,172.31.36.0-255,1136,183542,8,186522
25990,0.040105,172.31.36.0-255,1514,185056,8,186522
25991,0.040107,172.31.36.0-255,1268,186324,8,186522
25992,0.041563,104.244.42.0-255,66,186390,8,186522
25993,0.041613,104.244.42.0-255,66,186456,8,186522
25994,0.041662,104.244.42.0-255,66,186522,8,186522
25995,0.0,172.217.194.0-255,155,155,8,262967
25996,3.2e-05,172.31.36.0-255,66,221,8,262967
25997,3.9e-05,172.217.194.0-255,1484,1705,8,262967
25998,4.4e-05,172.31.36.0-255,66,1771,8,262967
25999,4.9e-05,172.217.194.0-255,2902,4673,8,262967
26000,5.1e-05,172.31.36.0-255,66,4739,8,262967
26001,5.7e-05,172.217.194.0-255,7156,11895,8,262967
26002,6.1e-05,172.31.36.0-255,66,11961,8,262967
26003,6.4e-05,172.217.194.0-255,1484,13445,8,262967
26004,6.6e-05,172.31.36.0-255,66,13511,8,262967
26005,0.000113,172.31.36.0-255,66,13577,8,262967
26006,0.000118,172.217.194.0-255,3961,17538,8,262967
26007,0.000121,172.31.36.0-255,66,17604,8,262967
26008,0.000124,172.217.194.0-255,1484,19088,8,262967
26009,0.000127,172.31.36.0-255,66,19154,8,262967
26010,0.000151,172.217.194.0-255,2902,22056,8,262967
26011,0.000154,172.31.36.0-255,66,22122,8,262967
26012,0.000157,172.217.194.0-255,1484,23606,8,262967
26013,0.000158,172.31.36.0-255,66,23672,8,262967
26014,0.00018,172.217.194.0-255,4320,27992,8,262967
26015,0.000183,172.31.36.0-255,66,28058,8,262967
26016,0.000193,172.31.36.0-255,66,28124,8,262967
26017,0.00023,172.31.36.0-255,66,28190,8,262967
26018,0.000402,172.217.194.0-255,647,28837,8,262967
26019,0.000406,172.31.36.0-255,66,28903,8,262967
26020,0.000893,172.217.194.0-255,1484,30387,8,262967
26021,0.000899,172.31.36.0-255,66,30453,8,262967
26022,0.000907,172.217.194.0-255,2902,33355,8,262967
26023,0.00091,172.31.36.0-255,66,33421,8,262967
26024,0.000916,172.217.194.0-255,4320,37741,8,262967
26025,0.000918,172.31.36.0-255,66,37807,8,262967
26026,0.000936,172.217.194.0-255,1484,39291,8,262967
26027,0.00095,172.31.36.0-255,66,39357,8,262967
26028,0.000973,172.217.194.0-255,4320,43677,8,262967
26029,0.000976,172.31.36.0-255,66,43743,8,262967
26030,0.000995,172.217.194.0-255,1484,45227,8,262967
26031,0.001023,172.31.36.0-255,66,45293,8,262967
26032,0.001361,172.217.194.0-255,1484,46777,8,262967
26033,0.001368,172.217.194.0-255,2902,49679,8,262967
26034,0.001374,172.31.36.0-255,66,49745,8,262967
26035,0.001381,172.217.194.0-255,5738,55483,8,262967
26036,0.001384,172.31.36.0-255,66,55549,8,262967
26037,0.001415,172.31.36.0-255,66,55615,8,262967
26038,0.001421,172.217.194.0-255,5738,61353,8,262967
26039,0.001424,172.31.36.0-255,66,61419,8,262967
26040,0.001438,172.217.194.0-255,2902,64321,8,262967
26041,0.00144,172.31.36.0-255,66,64387,8,262967
26042,0.001459,172.217.194.0-255,2184,66571,8,262967
26043,0.001461,172.31.36.0-255,66,66637,8,262967
26044,0.002126,172.217.194.0-255,1484,68121,8,262967
26045,0.002142,172.217.194.0-255,2902,71023,8,262967
26046,0.002146,172.31.36.0-255,66,71089,8,262967
26047,0.002168,172.217.194.0-255,5738,76827,8,262967
26048,0.002171,172.31.36.0-255,66,76893,8,262967
26049,0.002192,172.217.194.0-255,7156,84049,8,262967
26050,0.002211,172.217.194.0-255,4320,88369,8,262967
26051,0.002233,172.217.194.0-255,7156,95525,8,262967
26052,0.002246,172.217.194.0-255,2902,98427,8,262967
26053,0.002249,172.217.194.0-255,2184,100611,8,262967
26054,0.004817,172.31.36.0-255,66,100677,8,262967
26055,0.007097,172.217.194.0-255,2902,103579,8,262967
26056,0.007104,172.31.36.0-255,66,103645,8,262967
26057,0.007139,172.217.194.0-255,2902,106547,8,262967
26058,0.007142,172.31.36.0-255,66,106613,8,262967
26059,0.00938,172.217.194.0-255,2902,109515,8,262967
26060,0.009387,172.31.36.0-255,66,109581,8,262967
26061,0.00941,172.217.194.0-255,2902,112483,8,262967
26062,0.009413,172.31.36.0-255,66,112549,8,262967
26063,0.011656,172.217.194.0-255,5738,118287,8,262967
26064,0.011663,172.31.36.0-255,66,118353,8,262967
26065,0.013927,172.217.194.0-255,5738,124091,8,262967
26066,0.013935,172.31.36.0-255,66,124157,8,262967
26067,0.016186,172.217.194.0-255,5738,129895,8,262967
26068,0.016195,172.31.36.0-255,66,129961,8,262967
26069,0.018444,172.217.194.0-255,5738,135699,8,262967
26070,0.018451,172.31.36.0-255,66,135765,8,262967
26071,0.020689,172.217.194.0-255,5738,141503,8,262967
26072,0.020696,172.31.36.0-255,66,141569,8,262967
26073,0.02294,172.217.194.0-255,5738,147307,8,262967
26074,0.022947,172.31.36.0-255,66,147373,8,262967
26075,0.025222,172.217.194.0-255,5738,153111,8,262967
26076,0.025229,172.31.36.0-255,66,153177,8,262967
26077,0.027531,172.217.194.0-255,5738,158915,8,262967
26078,0.027539,172.31.36.0-255,66,158981,8,262967
26079,0.029826,172.217.194.0-255,5738,164719,8,262967
26080,0.029833,172.31.36.0-255,66,164785,8,262967
26081,0.032094,172.217.194.0-255,5738,170523,8,262967
26082,0.032102,172.31.36.0-255,66,170589,8,262967
26083,0.034058,172.31.36.0-255,172,170761,8,262967
26084,0.034086,172.31.36.0-255,562,171323,8,262967
26085,0.03437,172.217.194.0-255,5738,177061,8,262967
26086,0.034376,172.31.36.0-255,66,177127,8,262967
26087,0.035623,104.244.42.0-255,66,177193,8,262967
26088,0.035654,104.244.42.0-255,66,177259,8,262967
26089,0.03661,172.217.194.0-255,5738,182997,8,262967
26090,0.036615,172.31.36.0-255,66,183063,8,262967
26091,0.038895,172.217.194.0-255,5738,188801,8,262967
26092,0.038901,172.31.36.0-255,66,188867,8,262967
26093,0.041151,172.217.194.0-255,5738,194605,8,262967
26094,0.041172,172.31.36.0-255,66,194671,8,262967
26095,0.043435,172.217.194.0-255,4320,198991,8,262967
26096,0.043441,172.31.36.0-255,66,199057,8,262967
26097,0.043473,172.217.194.0-255,1484,200541,8,262967
26098,0.045711,172.217.194.0-255,4320,204861,8,262967
26099,0.045716,172.31.36.0-255,66,204927,8,262967
26100,0.047978,172.217.194.0-255,5738,210665,8,262967
26101,0.047984,172.31.36.0-255,66,210731,8,262967
26102,0.050249,172.217.194.0-255,5738,216469,8,262967
26103,0.050254,172.31.36.0-255,66,216535,8,262967
26104,0.052517,172.217.194.0-255,5738,222273,8,262967
26105,0.052523,172.31.36.0-255,66,222339,8,262967
26106,0.054788,172.217.194.0-255,5738,228077,8,262967
26107,0.054794,172.31.36.0-255,66,228143,8,262967
26108,0.057073,172.217.194.0-255,5738,233881,8,262967
26109,0.057078,172.31.36.0-255,66,233947,8,262967
26110,0.059363,172.217.194.0-255,5738,239685,8,262967
26111,0.05937,172.31.36.0-255,66,239751,8,262967
26112,0.06164,172.217.194.0-255,5738,245489,8,262967
26113,0.061645,172.31.36.0-255,66,245555,8,262967
26114,0.063891,172.217.194.0-255,5738,251293,8,262967
26115,0.063896,172.31.36.0-255,66,251359,8,262967
26116,0.06614,172.217.194.0-255,5738,257097,8,262967
26117,0.066146,172.31.36.0-255,66,257163,8,262967
26118,0.068418,172.217.194.0-255,5738,262901,8,262967
26119,0.068423,172.31.36.0-255,66,262967,8,262967
26120,0.0,172.253.118.0-255,153,153,8,265140
26121,2.5e-05,172.31.36.0-255,66,219,8,265140
26122,3.2e-05,172.253.118.0-255,1484,1703,8,265140
26123,3.7e-05,172.31.36.0-255,66,1769,8,265140
26124,4.3e-05,172.253.118.0-255,2902,4671,8,265140
26125,4.5e-05,172.31.36.0-255,66,4737,8,265140
26126,4.9e-05,172.253.118.0-255,1484,6221,8,265140
26127,5.1e-05,172.31.36.0-255,66,6287,8,265140
26128,7.7e-05,172.253.118.0-255,2902,9189,8,265140
26129,7.9e-05,172.31.36.0-255,66,9255,8,265140
26130,9.5e-05,172.253.118.0-255,2902,12157,8,265140
26131,9.7e-05,172.31.36.0-255,66,12223,8,265140
26132,0.000119,172.253.118.0-255,2053,14276,8,265140
26133,0.000121,172.31.36.0-255,66,14342,8,265140
26134,0.000244,172.253.118.0-255,1484,15826,8,265140
26135,0.000249,172.31.36.0-255,66,15892,8,265140
26136,0.000254,172.253.118.0-255,2902,18794,8,265140
26137,0.000257,172.31.36.0-255,66,18860,8,265140
26138,0.000263,172.253.118.0-255,5738,24598,8,265140
26139,0.000265,172.31.36.0-255,66,24664,8,265140
26140,0.000271,172.253.118.0-255,4320,28984,8,265140
26141,0.000273,172.31.36.0-255,66,29050,8,265140
26142,0.000316,172.253.118.0-255,2543,31593,8,265140
26143,0.000318,172.31.36.0-255,66,31659,8,265140
26144,0.000801,172.253.118.0-255,1484,33143,8,265140
26145,0.000807,172.31.36.0-255,66,33209,8,265140
26146,0.000816,172.253.118.0-255,2902,36111,8,265140
26147,0.000819,172.31.36.0-255,66,36177,8,265140
26148,0.000822,172.253.118.0-255,1484,37661,8,265140
26149,0.000824,172.31.36.0-255,66,37727,8,265140
26150,0.000858,172.253.118.0-255,4320,42047,8,265140
26151,0.000861,172.31.36.0-255,66,42113,8,265140
26152,0.000869,172.253.118.0-255,6797,48910,8,265140
26153,0.000871,172.31.36.0-255,66,48976,8,265140
26154,0.000898,172.253.118.0-255,1484,50460,8,265140
26155,0.000914,172.253.118.0-255,2902,53362,8,265140
26156,0.000917,172.31.36.0-255,66,53428,8,265140
26157,0.000939,172.253.118.0-255,5738,59166,8,265140
26158,0.000942,172.31.36.0-255,66,59232,8,265140
26159,0.000983,172.253.118.0-255,4320,63552,8,265140
26160,0.000987,172.31.36.0-255,66,63618,8,265140
26161,0.001005,172.253.118.0-255,2543,66161,8,265140
26162,0.001009,172.31.36.0-255,66,66227,8,265140
26163,0.002017,172.253.118.0-255,645,66872,8,265140
26164,0.002219,172.253.118.0-255,1484,68356,8,265140
26165,0.002223,172.31.36.0-255,66,68422,8,265140
26166,0.00223,172.253.118.0-255,2902,71324,8,265140
26167,0.002233,172.31.36.0-255,66,71390,8,265140
26168,0.002261,172.253.118.0-255,5738,77128,8,265140
26169,0.002263,172.31.36.0-255,66,77194,8,265140
26170,0.002268,172.253.118.0-255,2902,80096,8,265140
26171,0.00227,172.31.36.0-255,66,80162,8,265140
26172,0.00229,172.253.118.0-255,7156,87318,8,265140
26173,0.002293,172.31.36.0-255,66,87384,8,265140
26174,0.002314,172.31.36.0-255,66,87450,8,265140
26175,0.002336,172.253.118.0-255,5020,92470,8,265140
26176,0.002338,172.31.36.0-255,66,92536,8,265140
26177,0.004623,172.253.118.0-255,5738,98274,8,265140
26178,0.004629,172.31.36.0-255,66,98340,8,265140
26179,0.006912,172.253.118.0-255,5738,104078,8,265140
26180,0.006918,172.31.36.0-255,66,104144,8,265140
26181,0.009251,172.253.118.0-255,5738,109882,8,265140
26182,0.00926,172.31.36.0-255,66,109948,8,265140
26183,0.011545,172.253.118.0-255,5738,115686,8,265140
26184,0.011553,172.31.36.0-255,66,115752,8,265140
26185,0.013862,172.253.118.0-255,5738,121490,8,265140
26186,0.01387,172.31.36.0-255,66,121556,8,265140
26187,0.016154,172.253.118.0-255,5738,127294,8,265140
26188,0.016163,172.31.36.0-255,66,127360,8,265140
26189,0.018481,172.253.118.0-255,5738,133098,8,265140
26190,0.018492,172.31.36.0-255,66,133164,8,265140
26191,0.020837,172.253.118.0-255,5738,138902,8,265140
26192,0.020845,172.31.36.0-255,66,138968,8,265140
26193,0.023167,172.253.118.0-255,5738,144706,8,265140
26194,0.023177,172.31.36.0-255,66,144772,8,265140
26195,0.025483,172.253.118.0-255,5738,150510,8,265140
26196,0.025489,172.31.36.0-255,66,150576,8,265140
26197,0.025936,172.31.36.0-255,172,150748,8,265140
26198,0.025967,172.31.36.0-255,1112,151860,8,265140
26199,0.026033,172.31.36.0-255,1514,153374,8,265140
26200,0.026035,172.31.36.0-255,1292,154666,8,265140
26201,0.027485,104.244.42.0-255,66,154732,8,265140
26202,0.027572,104.244.42.0-255,66,154798,8,265140
26203,0.027621,104.244.42.0-255,66,154864,8,265140
26204,0.027785,172.253.118.0-255,5738,160602,8,265140
26205,0.027792,172.31.36.0-255,66,160668,8,265140
26206,0.030122,172.253.118.0-255,5738,166406,8,265140
26207,0.030129,172.31.36.0-255,66,166472,8,265140
26208,0.032433,172.253.118.0-255,5738,172210,8,265140
26209,0.032438,172.31.36.0-255,66,172276,8,265140
26210,0.034738,172.253.118.0-255,5738,178014,8,265140
26211,0.034745,172.31.36.0-255,66,178080,8,265140
26212,0.03706,172.253.118.0-255,5738,183818,8,265140
26213,0.037067,172.31.36.0-255,66,183884,8,265140
26214,0.039378,172.253.118.0-255,5738,189622,8,265140
26215,0.039387,172.31.36.0-255,66,189688,8,265140
26216,0.041683,172.253.118.0-255,5738,195426,8,265140
26217,0.04169,172.31.36.0-255,66,195492,8,265140
26218,0.044,172.253.118.0-255,5738,201230,8,265140
26219,0.044006,172.31.36.0-255,66,201296,8,265140
26220,0.046318,172.253.118.0-255,5738,207034,8,265140
26221,0.046325,172.31.36.0-255,66,207100,8,265140
26222,0.048652,172.253.118.0-255,5738,212838,8,265140
26223,0.048658,172.31.36.0-255,66,212904,8,265140
26224,0.050967,172.253.118.0-255,5738,218642,8,265140
26225,0.050975,172.31.36.0-255,66,218708,8,265140
26226,0.053282,172.253.118.0-255,5738,224446,8,265140
26227,0.053289,172.31.36.0-255,66,224512,8,265140
26228,0.055605,172.253.118.0-255,5738,230250,8,265140
26229,0.055612,172.31.36.0-255,66,230316,8,265140
26230,0.057925,172.253.118.0-255,5738,236054,8,265140
26231,0.057932,172.31.36.0-255,66,236120,8,265140
26232,0.060249,172.253.118.0-255,5738,241858,8,265140
26233,0.060256,172.31.36.0-255,66,241924,8,265140
26234,0.062549,172.253.118.0-255,5738,247662,8,265140
26235,0.062555,172.31.36.0-255,66,247728,8,265140
26236,0.064859,172.253.118.0-255,5738,253466,8,265140
26237,0.064865,172.31.36.0-255,66,253532,8,265140
26238,0.067167,172.253.118.0-255,5738,259270,8,265140
26239,0.067174,172.31.36.0-255,66,259336,8,265140
26240,0.069492,172.253.118.0-255,5738,265074,8,265140
26241,0.069499,172.31.36.0-255,66,265140,8,265140
26242,0.0,172.217.194.0-255,153,153,8,186693
26243,3e-05,172.31.36.0-255,66,219,8,186693
26244,3.8e-05,172.217.194.0-255,1484,1703,8,186693
26245,4.2e-05,172.31.36.0-255,66,1769,8,186693
26246,4.6e-05,172.217.194.0-255,2902,4671,8,186693
26247,4.8e-05,172.31.36.0-255,66,4737,8,186693
26248,6.3e-05,172.217.194.0-255,7156,11893,8,186693
26249,6.5e-05,172.31.36.0-255,66,11959,8,186693
26250,6.8e-05,172.217.194.0-255,1994,13953,8,186693
26251,7.1e-05,172.31.36.0-255,66,14019,8,186693
26252,8.1e-05,172.31.36.0-255,66,14085,8,186693
26253,0.000121,172.217.194.0-255,5379,19464,8,186693
26254,0.000125,172.31.36.0-255,66,19530,8,186693
26255,0.00015,172.217.194.0-255,1484,21014,8,186693
26256,0.000153,172.31.36.0-255,66,21080,8,186693
26257,0.000156,172.217.194.0-255,1484,22564,8,186693
26258,0.000158,172.31.36.0-255,66,22630,8,186693
26259,0.000184,172.217.194.0-255,1484,24114,8,186693
26260,0.000187,172.31.36.0-255,66,24180,8,186693
26261,0.000194,172.217.194.0-255,5738,29918,8,186693
26262,0.000197,172.31.36.0-255,66,29984,8,186693
26263,0.000218,172.31.36.0-255,66,30050,8,186693
26264,0.00023,172.31.36.0-255,66,30116,8,186693
26265,0.000233,172.217.194.0-255,365,30481,8,186693
26266,0.000235,172.31.36.0-255,66,30547,8,186693
26267,0.000292,172.217.194.0-255,1484,32031,8,186693
26268,0.000295,172.31.36.0-255,66,32097,8,186693
26269,0.0003,172.217.194.0-255,2902,34999,8,186693
26270,0.000304,172.31.36.0-255,66,35065,8,186693
26271,0.000341,172.217.194.0-255,1484,36549,8,186693
26272,0.000349,172.217.194.0-255,7156,43705,8,186693
26273,0.000354,172.217.194.0-255,5738,49443,8,186693
26274,0.000355,172.31.36.0-255,66,49509,8,186693
26275,0.000359,172.31.36.0-255,66,49575,8,186693
26276,0.0004,172.31.36.0-255,66,49641,8,186693
26277,0.000405,172.217.194.0-255,3961,53602,8,186693
26278,0.000407,172.31.36.0-255,66,53668,8,186693
26279,0.00069,172.217.194.0-255,1484,55152,8,186693
26280,0.000698,172.217.194.0-255,2902,58054,8,186693
26281,0.000701,172.31.36.0-255,66,58120,8,186693
26282,0.000738,172.217.194.0-255,1484,59604,8,186693
26283,0.000759,172.217.194.0-255,4320,63924,8,186693
26284,0.000762,172.31.36.0-255,66,63990,8,186693
26285,0.000775,172.31.36.0-255,66,64056,8,186693
26286,0.00079,172.31.36.0-255,66,64122,8,186693
26287,0.000819,172.217.194.0-255,2184,66306,8,186693
26288,0.000822,172.31.36.0-255,66,66372,8,186693
26289,0.000951,172.217.194.0-255,1484,67856,8,186693
26290,0.000955,172.217.194.0-255,1484,69340,8,186693
26291,0.000958,172.31.36.0-255,66,69406,8,186693
26292,0.000978,172.217.194.0-255,1484,70890,8,186693
26293,0.000984,172.217.194.0-255,5738,76628,8,186693
26294,0.000987,172.31.36.0-255,66,76694,8,186693
26295,0.001027,172.31.36.0-255,66,76760,8,186693
26296,0.00106,172.31.36.0-255,66,76826,8,186693
26297,0.001086,172.217.194.0-255,2184,79010,8,186693
26298,0.001089,172.31.36.0-255,66,79076,8,186693
26299,0.001536,172.217.194.0-255,1484,80560,8,186693
26300,0.001542,172.217.194.0-255,2902,83462,8,186693
26301,0.001547,172.31.36.0-255,66,83528,8,186693
26302,0.001555,172.217.194.0-255,2902,86430,8,186693
26303,0.001558,172.31.36.0-255,66,86496,8,186693
26304,0.001585,172.217.194.0-255,2902,89398,8,186693
26305,0.001589,172.31.36.0-255,66,89464,8,186693
26306,0.001601,172.31.36.0-255,66,89530,8,186693
26307,0.001615,172.217.194.0-255,4320,93850,8,186693
26308,0.001622,172.31.36.0-255,66,93916,8,186693
26309,0.001643,172.217.194.0-255,7156,101072,8,186693
26310,0.001647,172.31.36.0-255,66,101138,8,186693
26311,0.001651,172.217.194.0-255,2184,103322,8,186693
26312,0.001654,172.31.36.0-255,66,103388,8,186693
26313,0.001886,172.217.194.0-255,1484,104872,8,186693
26314,0.001892,172.217.194.0-255,2902,107774,8,186693
26315,0.001895,172.31.36.0-255,66,107840,8,186693
26316,0.001924,172.217.194.0-255,5738,113578,8,186693
26317,0.001927,172.31.36.0-255,66,113644,8,186693
26318,0.001956,172.31.36.0-255,66,113710,8,186693
26319,0.00196,172.217.194.0-255,2902,116612,8,186693
26320,0.001962,172.31.36.0-255,66,116678,8,186693
26321,0.002006,172.31.36.0-255,66,116744,8,186693
26322,0.002027,172.31.36.0-255,66,116810,8,186693
26323,0.002078,172.31.36.0-255,66,116876,8,186693
26324,0.002102,172.217.194.0-255,2184,119060,8,186693
26325,0.002105,172.31.36.0-255,66,119126,8,186693
26326,0.002127,172.217.194.0-255,1484,120610,8,186693
26327,0.002132,172.217.194.0-255,2902,123512,8,186693
26328,0.002135,172.31.36.0-255,66,123578,8,186693
26329,0.002141,172.217.194.0-255,5738,129316,8,186693
26330,0.002143,172.31.36.0-255,66,129382,8,186693
26331,0.002221,172.31.36.0-255,66,129448,8,186693
26332,0.002244,172.217.194.0-255,2902,132350,8,186693
26333,0.002246,172.31.36.0-255,66,132416,8,186693
26334,0.002259,172.31.36.0-255,66,132482,8,186693
26335,0.002272,172.31.36.0-255,66,132548,8,186693
26336,0.002289,172.31.36.0-255,66,132614,8,186693
26337,0.002327,172.217.194.0-255,4320,136934,8,186693
26338,0.002331,172.31.36.0-255,66,137000,8,186693
26339,0.002361,172.31.36.0-255,66,137066,8,186693
26340,0.002388,172.217.194.0-255,5020,142086,8,186693
26341,0.002392,172.31.36.0-255,66,142152,8,186693
26342,0.002394,172.217.194.0-255,1484,143636,8,186693
26343,0.002397,172.31.36.0-255,78,143714,8,186693
26344,0.002421,172.31.36.0-255,66,143780,8,186693
26345,0.004712,172.217.194.0-255,5738,149518,8,186693
26346,0.004719,172.31.36.0-255,66,149584,8,186693
26347,0.006993,172.217.194.0-255,4320,153904,8,186693
26348,0.006999,172.31.36.0-255,66,153970,8,186693
26349,0.007027,172.217.194.0-255,1484,155454,8,186693
26350,0.009281,172.217.194.0-255,4320,159774,8,186693
26351,0.009288,172.31.36.0-255,66,159840,8,186693
26352,0.011579,172.217.194.0-255,5738,165578,8,186693
26353,0.011587,172.31.36.0-255,66,165644,8,186693
26354,0.013879,172.217.194.0-255,5738,171382,8,186693
26355,0.013886,172.31.36.0-255,66,171448,8,186693
26356,0.016205,172.217.194.0-255,5738,177186,8,186693
26357,0.016215,172.31.36.0-255,66,177252,8,186693
26358,0.01853,172.217.194.0-255,5165,182417,8,186693
26359,0.018539,172.31.36.0-255,66,182483,8,186693
26360,0.018773,172.31.36.0-255,105,182588,8,186693
26361,0.021018,172.217.194.0-255,66,182654,8,186693
26362,0.057013,172.31.36.0-255,188,182842,8,186693
26363,0.057047,172.31.36.0-255,955,183797,8,186693
26364,0.057113,172.31.36.0-255,1514,185311,8,186693
26365,0.057115,172.31.36.0-255,1184,186495,8,186693
26366,0.058622,104.244.42.0-255,66,186561,8,186693
26367,0.058636,104.244.42.0-255,66,186627,8,186693
26368,0.058713,104.244.42.0-255,66,186693,8,186693
26369,0.0,74.125.24.0-255,152,152,8,277919
26370,3.3e-05,172.31.36.0-255,66,218,8,277919
26371,4.1e-05,74.125.24.0-255,1484,1702,8,277919
26372,4.6e-05,172.31.36.0-255,66,1768,8,277919
26373,4.9e-05,74.125.24.0-255,1484,3252,8,277919
26374,5.1e-05,172.31.36.0-255,66,3318,8,277919
26375,5.8e-05,74.125.24.0-255,4320,7638,8,277919
26376,6e-05,172.31.36.0-255,66,7704,8,277919
26377,9.2e-05,74.125.24.0-255,2902,10606,8,277919
26378,9.6e-05,172.31.36.0-255,66,10672,8,277919
26379,0.000124,172.31.36.0-255,66,10738,8,277919
26380,0.000127,74.125.24.0-255,1484,12222,8,277919
26381,0.000129,172.31.36.0-255,66,12288,8,277919
26382,0.000149,74.125.24.0-255,4320,16608,8,277919
26383,0.000151,172.31.36.0-255,66,16674,8,277919
26384,0.000182,172.31.36.0-255,66,16740,8,277919
26385,0.000189,74.125.24.0-255,5738,22478,8,277919
26386,0.000191,172.31.36.0-255,66,22544,8,277919
26387,0.000241,172.31.36.0-255,66,22610,8,277919
26388,0.000505,74.125.24.0-255,1484,24094,8,277919
26389,0.000511,172.31.36.0-255,66,24160,8,277919
26390,0.000531,74.125.24.0-255,2902,27062,8,277919
26391,0.000534,172.31.36.0-255,66,27128,8,277919
26392,0.000557,74.125.24.0-255,5738,32866,8,277919
26393,0.000561,172.31.36.0-255,66,32932,8,277919
26394,0.000568,74.125.24.0-255,7072,40004,8,277919
26395,0.000572,172.31.36.0-255,66,40070,8,277919
26396,0.000586,74.125.24.0-255,131,40201,8,277919
26397,0.000589,172.31.36.0-255,66,40267,8,277919
26398,0.000947,74.125.24.0-255,1484,41751,8,277919
26399,0.000957,74.125.24.0-255,2902,44653,8,277919
26400,0.000961,172.31.36.0-255,66,44719,8,277919
26401,0.000967,74.125.24.0-255,2902,47621,8,277919
26402,0.000987,74.125.24.0-255,7156,54777,8,277919
26403,0.001003,74.125.24.0-255,1484,56261,8,277919
26404,0.001045,74.125.24.0-255,3602,59863,8,277919
26405,0.001619,74.125.24.0-255,1484,61347,8,277919
26406,0.001627,74.125.24.0-255,2902,64249,8,277919
26407,0.001645,74.125.24.0-255,5738,69987,8,277919
26408,0.001676,74.125.24.0-255,1484,71471,8,277919
26409,0.00177,74.125.24.0-255,4320,75791,8,277919
26410,0.00192,74.125.24.0-255,1484,77275,8,277919
26411,0.001938,74.125.24.0-255,2902,80177,8,277919
26412,0.001942,74.125.24.0-255,2902,83079,8,277919
26413,0.001953,74.125.24.0-255,2902,85981,8,277919
26414,0.001966,74.125.24.0-255,4320,90301,8,277919
26415,0.001996,74.125.24.0-255,4320,94621,8,277919
26416,0.006742,172.31.36.0-255,66,94687,8,277919
26417,0.008712,74.125.24.0-255,5738,100425,8,277919
26418,0.008719,172.31.36.0-255,66,100491,8,277919
26419,0.010664,74.125.24.0-255,5738,106229,8,277919
26420,0.011201,172.31.36.0-255,66,106295,8,277919
26421,0.013162,74.125.24.0-255,5738,112033,8,277919
26422,0.013169,172.31.36.0-255,66,112099,8,277919
26423,0.015135,74.125.24.0-255,5738,117837,8,277919
26424,0.015191,172.31.36.0-255,66,117903,8,277919
26425,0.017133,74.125.24.0-255,5738,123641,8,277919
26426,0.01714,172.31.36.0-255,66,123707,8,277919
26427,0.019079,74.125.24.0-255,5738,129445,8,277919
26428,0.019089,172.31.36.0-255,66,129511,8,277919
26429,0.021048,74.125.24.0-255,5738,135249,8,277919
26430,0.021057,172.31.36.0-255,66,135315,8,277919
26431,0.023004,74.125.24.0-255,5738,141053,8,277919
26432,0.023012,172.31.36.0-255,66,141119,8,277919
26433,0.024946,74.125.24.0-255,5738,146857,8,277919
26434,0.024954,172.31.36.0-255,66,146923,8,277919
26435,0.026936,74.125.24.0-255,2902,149825,8,277919
26436,0.026943,172.31.36.0-255,66,149891,8,277919
26437,0.026977,74.125.24.0-255,2902,152793,8,277919
26438,0.026998,172.31.36.0-255,66,152859,8,277919
26439,0.028895,74.125.24.0-255,2902,155761,8,277919
26440,0.028902,172.31.36.0-255,66,155827,8,277919
26441,0.028936,74.125.24.0-255,2902,158729,8,277919
26442,0.030376,172.31.36.0-255,66,158795,8,277919
26443,0.030858,74.125.24.0-255,2902,161697,8,277919
26444,0.030864,172.31.36.0-255,66,161763,8,277919
26445,0.032324,74.125.24.0-255,2902,164665,8,277919
26446,0.032333,172.31.36.0-255,66,164731,8,277919
26447,0.032801,74.125.24.0-255,2902,167633,8,277919
26448,0.032807,172.31.36.0-255,66,167699,8,277919
26449,0.034283,74.125.24.0-255,2902,170601,8,277919
26450,0.03429,172.31.36.0-255,66,170667,8,277919
26451,0.03474,74.125.24.0-255,2902,173569,8,277919
26452,0.034746,172.31.36.0-255,66,173635,8,277919
26453,0.036233,74.125.24.0-255,2902,176537,8,277919
26454,0.036239,172.31.36.0-255,66,176603,8,277919
26455,0.036688,74.125.24.0-255,2902,179505,8,277919
26456,0.036694,172.31.36.0-255,66,179571,8,277919
26457,0.038177,74.125.24.0-255,2902,182473,8,277919
26458,0.038184,172.31.36.0-255,66,182539,8,277919
26459,0.038635,74.125.24.0-255,2902,185441,8,277919
26460,0.038642,172.31.36.0-255,66,185507,8,277919
26461,0.040134,74.125.24.0-255,2902,188409,8,277919
26462,0.040138,172.31.36.0-255,66,188475,8,277919
26463,0.040575,74.125.24.0-255,2902,191377,8,277919
26464,0.040583,172.31.36.0-255,66,191443,8,277919
26465,0.040851,172.31.36.0-255,172,191615,8,277919
26466,0.040878,172.31.36.0-255,562,192177,8,277919
26467,0.042065,74.125.24.0-255,2902,195079,8,277919
26468,0.042072,172.31.36.0-255,66,195145,8,277919
26469,0.042415,104.244.42.0-255,66,195211,8,277919
26470,0.042423,104.244.42.0-255,66,195277,8,277919
26471,0.042498,74.125.24.0-255,2902,198179,8,277919
26472,0.042503,172.31.36.0-255,66,198245,8,277919
26473,0.044024,74.125.24.0-255,2902,201147,8,277919
26474,0.044031,172.31.36.0-255,66,201213,8,277919
26475,0.044445,74.125.24.0-255,2902,204115,8,277919
26476,0.044451,172.31.36.0-255,66,204181,8,277919
26477,0.045974,74.125.24.0-255,2902,207083,8,277919
26478,0.045979,172.31.36.0-255,66,207149,8,277919
26479,0.046398,74.125.24.0-255,2902,210051,8,277919
26480,0.046403,172.31.36.0-255,66,210117,8,277919
26481,0.047934,74.125.24.0-255,2902,213019,8,277919
26482,0.04794,172.31.36.0-255,66,213085,8,277919
26483,0.048352,74.125.24.0-255,2902,215987,8,277919
26484,0.048357,172.31.36.0-255,66,216053,8,277919
26485,0.049878,74.125.24.0-255,2902,218955,8,277919
26486,0.049883,172.31.36.0-255,66,219021,8,277919
26487,0.05029,74.125.24.0-255,2902,221923,8,277919
26488,0.050295,172.31.36.0-255,66,221989,8,277919
26489,0.051868,74.125.24.0-255,2902,224891,8,277919
26490,0.051874,172.31.36.0-255,66,224957,8,277919
26491,0.052232,74.125.24.0-255,2902,227859,8,277919
26492,0.052237,172.31.36.0-255,66,227925,8,277919
26493,0.053814,74.125.24.0-255,2902,230827,8,277919
26494,0.05382,172.31.36.0-255,66,230893,8,277919
26495,0.054171,74.125.24.0-255,2902,233795,8,277919
26496,0.054176,172.31.36.0-255,66,233861,8,277919
26497,0.055771,74.125.24.0-255,2902,236763,8,277919
26498,0.055776,172.31.36.0-255,66,236829,8,277919
26499,0.056116,74.125.24.0-255,2902,239731,8,277919
26500,0.056121,172.31.36.0-255,66,239797,8,277919
26501,0.057699,74.125.24.0-255,2902,242699,8,277919
26502,0.057704,172.31.36.0-255,66,242765,8,277919
26503,0.058056,74.125.24.0-255,2902,245667,8,277919
26504,0.058062,172.31.36.0-255,66,245733,8,277919
26505,0.059657,74.125.24.0-255,2902,248635,8,277919
26506,0.059662,172.31.36.0-255,66,248701,8,277919
26507,0.059999,74.125.24.0-255,2902,251603,8,277919
26508,0.060005,172.31.36.0-255,66,251669,8,277919
26509,0.061626,74.125.24.0-255,2902,254571,8,277919
26510,0.061633,172.31.36.0-255,66,254637,8,277919
26511,0.061973,74.125.24.0-255,2902,257539,8,277919
26512,0.063592,74.125.24.0-255,2902,260441,8,277919
26513,0.064079,172.31.36.0-255,66,260507,8,277919
26514,0.066018,74.125.24.0-255,5738,266245,8,277919
26515,0.066024,172.31.36.0-255,66,266311,8,277919
26516,0.067967,74.125.24.0-255,5738,272049,8,277919
26517,0.067973,172.31.36.0-255,66,272115,8,277919
26518,0.069889,74.125.24.0-255,5738,277853,8,277919
26519,0.069894,172.31.36.0-255,66,277919,8,277919
26520,0.0,74.125.200.0-255,151,151,8,336742
26521,2e-05,172.31.36.0-255,66,217,8,336742
26522,2.8e-05,74.125.200.0-255,1484,1701,8,336742
26523,3.2e-05,172.31.36.0-255,66,1767,8,336742
26524,3.9e-05,74.125.200.0-255,2902,4669,8,336742
26525,5.1e-05,172.31.36.0-255,66,4735,8,336742
26526,5.7e-05,74.125.200.0-255,4320,9055,8,336742
26527,6e-05,172.31.36.0-255,66,9121,8,336742
26528,0.000101,74.125.200.0-255,4868,13989,8,336742
26529,0.000105,172.31.36.0-255,66,14055,8,336742
26530,0.000191,74.125.200.0-255,1484,15539,8,336742
26531,0.000194,172.31.36.0-255,66,15605,8,336742
26532,0.000199,74.125.200.0-255,1484,17089,8,336742
26533,0.000201,172.31.36.0-255,66,17155,8,336742
26534,0.000223,74.125.200.0-255,1484,18639,8,336742
26535,0.000225,172.31.36.0-255,66,18705,8,336742
26536,0.000236,74.125.200.0-255,5738,24443,8,336742
26537,0.000239,172.31.36.0-255,66,24509,8,336742
26538,0.000247,74.125.200.0-255,6797,31306,8,336742
26539,0.000249,172.31.36.0-255,66,31372,8,336742
26540,0.000283,74.125.200.0-255,7156,38528,8,336742
26541,0.000286,172.31.36.0-255,66,38594,8,336742
26542,0.000317,172.31.36.0-255,66,38660,8,336742
26543,0.000367,172.31.36.0-255,66,38726,8,336742
26544,0.000386,74.125.200.0-255,1484,40210,8,336742
26545,0.000389,172.31.36.0-255,66,40276,8,336742
26546,0.000419,74.125.200.0-255,6438,46714,8,336742
26547,0.000422,172.31.36.0-255,66,46780,8,336742
26548,0.000425,74.125.200.0-255,400,47180,8,336742
26549,0.000427,172.31.36.0-255,66,47246,8,336742
26550,0.000455,74.125.200.0-255,111,47357,8,336742
26551,0.000611,74.125.200.0-255,1484,48841,8,336742
26552,0.00062,172.31.36.0-255,66,48907,8,336742
26553,0.000632,74.125.200.0-255,2902,51809,8,336742
26554,0.00064,74.125.200.0-255,2902,54711,8,336742
26555,0.000649,74.125.200.0-255,7156,61867,8,336742
26556,0.000686,74.125.200.0-255,4320,66187,8,336742
26557,0.000744,172.31.36.0-255,66,66253,8,336742
26558,0.000749,172.31.36.0-255,66,66319,8,336742
26559,0.000769,74.125.200.0-255,1484,67803,8,336742
26560,0.000776,74.125.200.0-255,3602,71405,8,336742
26561,0.000798,172.31.36.0-255,66,71471,8,336742
26562,0.001345,74.125.200.0-255,1484,72955,8,336742
26563,0.001367,74.125.200.0-255,2902,75857,8,336742
26564,0.001371,172.31.36.0-255,66,75923,8,336742
26565,0.001377,74.125.200.0-255,5738,81661,8,336742
26566,0.001378,172.31.36.0-255,66,81727,8,336742
26567,0.001382,74.125.200.0-255,2902,84629,8,336742
26568,0.001393,172.31.36.0-255,66,84695,8,336742
26569,0.001406,74.125.200.0-255,1484,86179,8,336742
26570,0.001412,74.125.200.0-255,5738,91917,8,336742
26571,0.001416,172.31.36.0-255,66,91983,8,336742
26572,0.001429,74.125.200.0-255,1484,93467,8,336742
26573,0.001463,74.125.200.0-255,2184,95651,8,336742
26574,0.001475,172.31.36.0-255,66,95717,8,336742
26575,0.001504,74.125.200.0-255,1484,97201,8,336742
26576,0.001531,74.125.200.0-255,2902,100103,8,336742
26577,0.001537,74.125.200.0-255,5738,105841,8,336742
26578,0.001541,74.125.200.0-255,2902,108743,8,336742
26579,0.001547,172.31.36.0-255,66,108809,8,336742
26580,0.001579,172.31.36.0-255,66,108875,8,336742
26581,0.001594,74.125.200.0-255,2902,111777,8,336742
26582,0.001611,172.31.36.0-255,66,111843,8,336742
26583,0.00164,172.31.36.0-255,66,111909,8,336742
26584,0.001666,74.125.200.0-255,1484,113393,8,336742
26585,0.001681,74.125.200.0-255,2902,116295,8,336742
26586,0.001684,74.125.200.0-255,1484,117779,8,336742
26587,0.001689,172.31.36.0-255,66,117845,8,336742
26588,0.001712,74.125.200.0-255,2902,120747,8,336742
26589,0.001718,74.125.200.0-255,5738,126485,8,336742
26590,0.001724,172.31.36.0-255,66,126551,8,336742
26591,0.001762,172.31.36.0-255,66,126617,8,336742
26592,0.001792,74.125.200.0-255,766,127383,8,336742
26593,0.001821,172.31.36.0-255,66,127449,8,336742
26594,0.002025,74.125.200.0-255,1484,128933,8,336742
26595,0.002031,74.125.200.0-255,2902,131835,8,336742
26596,0.002034,172.31.36.0-255,66,131901,8,336742
26597,0.002038,74.125.200.0-255,1484,133385,8,336742
26598,0.00206,74.125.200.0-255,1484,134869,8,336742
26599,0.002065,74.125.200.0-255,4320,139189,8,336742
26600,0.002075,172.31.36.0-255,66,139255,8,336742
26601,0.002099,74.125.200.0-255,2902,142157,8,336742
26602,0.002113,74.125.200.0-255,4320,146477,8,336742
26603,0.002128,172.31.36.0-255,66,146543,8,336742
26604,0.002159,74.125.200.0-255,6438,152981,8,336742
26605,0.002184,172.31.36.0-255,66,153047,8,336742
26606,0.002272,74.125.200.0-255,1484,154531,8,336742
26607,0.002278,74.125.200.0-255,2902,157433,8,336742
26608,0.00228,172.31.36.0-255,66,157499,8,336742
26609,0.002306,74.125.200.0-255,4320,161819,8,336742
26610,0.002309,74.125.200.0-255,1484,163303,8,336742
26611,0.002334,74.125.200.0-255,4320,167623,8,336742
26612,0.002344,74.125.200.0-255,4320,171943,8,336742
26613,0.005799,172.31.36.0-255,66,172009,8,336742
26614,0.008114,74.125.200.0-255,5738,177747,8,336742
26615,0.008121,172.31.36.0-255,66,177813,8,336742
26616,0.010436,74.125.200.0-255,5738,183551,8,336742
26617,0.010444,172.31.36.0-255,66,183617,8,336742
26618,0.012755,74.125.200.0-255,5738,189355,8,336742
26619,0.012762,172.31.36.0-255,66,189421,8,336742
26620,0.015122,74.125.200.0-255,5738,195159,8,336742
26621,0.015131,172.31.36.0-255,66,195225,8,336742
26622,0.017453,74.125.200.0-255,5738,200963,8,336742
26623,0.017461,172.31.36.0-255,66,201029,8,336742
26624,0.01978,74.125.200.0-255,5738,206767,8,336742
26625,0.01979,172.31.36.0-255,66,206833,8,336742
26626,0.022102,74.125.200.0-255,5738,212571,8,336742
26627,0.02211,172.31.36.0-255,66,212637,8,336742
26628,0.024427,74.125.200.0-255,5738,218375,8,336742
26629,0.024434,172.31.36.0-255,66,218441,8,336742
26630,0.02676,74.125.200.0-255,5738,224179,8,336742
26631,0.026768,172.31.36.0-255,66,224245,8,336742
26632,0.029089,74.125.200.0-255,5738,229983,8,336742
26633,0.029096,172.31.36.0-255,66,230049,8,336742
26634,0.031419,74.125.200.0-255,5738,235787,8,336742
26635,0.031429,172.31.36.0-255,66,235853,8,336742
26636,0.033758,74.125.200.0-255,5738,241591,8,336742
26637,0.033766,172.31.36.0-255,66,241657,8,336742
26638,0.036086,74.125.200.0-255,5738,247395,8,336742
26639,0.036095,172.31.36.0-255,66,247461,8,336742
26640,0.038417,74.125.200.0-255,5738,253199,8,336742
26641,0.038424,172.31.36.0-255,66,253265,8,336742
26642,0.038909,172.31.36.0-255,172,253437,8,336742
26643,0.038942,172.31.36.0-255,1110,254547,8,336742
26644,0.039011,172.31.36.0-255,1514,256061,8,336742
26645,0.039038,172.31.36.0-255,1514,257575,8,336742
26646,0.039042,172.31.36.0-255,1514,259089,8,336742
26647,0.039058,172.31.36.0-255,1514,260603,8,336742
26648,0.03906,172.31.36.0-255,183,260786,8,336742
26649,0.040422,104.244.42.0-255,66,260852,8,336742
26650,0.040452,104.244.42.0-255,66,260918,8,336742
26651,0.040555,104.244.42.0-255,66,260984,8,336742
26652,0.040623,104.244.42.0-255,66,261050,8,336742
26653,0.040628,104.244.42.0-255,66,261116,8,336742
26654,0.040751,74.125.200.0-255,5738,266854,8,336742
26655,0.040761,172.31.36.0-255,66,266920,8,336742
26656,0.041194,104.244.42.0-255,108,267028,8,336742
26657,0.041204,172.31.36.0-255,66,267094,8,336742
26658,0.043078,74.125.200.0-255,5738,272832,8,336742
26659,0.043085,172.31.36.0-255,66,272898,8,336742
26660,0.045403,74.125.200.0-255,5738,278636,8,336742
26661,0.045411,172.31.36.0-255,66,278702,8,336742
26662,0.047726,74.125.200.0-255,5738,284440,8,336742
26663,0.047733,172.31.36.0-255,66,284506,8,336742
26664,0.050046,74.125.200.0-255,5738,290244,8,336742
26665,0.050053,172.31.36.0-255,66,290310,8,336742
26666,0.052399,74.125.200.0-255,5738,296048,8,336742
26667,0.052406,172.31.36.0-255,66,296114,8,336742
26668,0.05474,74.125.200.0-255,5738,301852,8,336742
26669,0.054747,172.31.36.0-255,66,301918,8,336742
26670,0.057077,74.125.200.0-255,5738,307656,8,336742
26671,0.057084,172.31.36.0-255,66,307722,8,336742
26672,0.05941,74.125.200.0-255,5738,313460,8,336742
26673,0.059417,172.31.36.0-255,66,313526,8,336742
26674,0.061743,74.125.200.0-255,5738,319264,8,336742
26675,0.06175,172.31.36.0-255,66,319330,8,336742
26676,0.064073,74.125.200.0-255,5738,325068,8,336742
26677,0.06408,172.31.36.0-255,66,325134,8,336742
26678,0.066395,74.125.200.0-255,5738,330872,8,336742
26679,0.066402,172.31.36.0-255,66,330938,8,336742
26680,0.068716,74.125.200.0-255,5738,336676,8,336742
26681,0.068723,172.31.36.0-255,66,336742,8,336742
26682,0.0,74.125.24.0-255,152,152,8,296908
26683,3.2e-05,172.31.36.0-255,66,218,8,296908
26684,3.9e-05,74.125.24.0-255,1484,1702,8,296908
26685,4.3e-05,172.31.36.0-255,66,1768,8,296908
26686,4.8e-05,74.125.24.0-255,2902,4670,8,296908
26687,5.2e-05,172.31.36.0-255,66,4736,8,296908
26688,5.9e-05,74.125.24.0-255,7156,11892,8,296908
26689,6.2e-05,172.31.36.0-255,66,11958,8,296908
26690,8.1e-05,74.125.24.0-255,1484,13442,8,296908
26691,8.6e-05,172.31.36.0-255,66,13508,8,296908
26692,0.0001,74.125.24.0-255,6362,19870,8,296908
26693,0.000104,172.31.36.0-255,66,19936,8,296908
26694,0.000109,74.125.24.0-255,2902,22838,8,296908
26695,0.000111,172.31.36.0-255,66,22904,8,296908
26696,0.00014,172.31.36.0-255,66,22970,8,296908
26697,0.000253,74.125.24.0-255,1484,24454,8,296908
26698,0.000256,172.31.36.0-255,66,24520,8,296908
26699,0.000261,74.125.24.0-255,2902,27422,8,296908
26700,0.000263,172.31.36.0-255,66,27488,8,296908
26701,0.000284,74.125.24.0-255,5738,33226,8,296908
26702,0.000287,172.31.36.0-255,66,33292,8,296908
26703,0.00033,172.31.36.0-255,66,33358,8,296908
26704,0.000341,172.31.36.0-255,66,33424,8,296908
26705,0.000378,74.125.24.0-255,1436,34860,8,296908
26706,0.000381,172.31.36.0-255,66,34926,8,296908
26707,0.000399,74.125.24.0-255,375,35301,8,296908
26708,0.000401,172.31.36.0-255,66,35367,8,296908
26709,0.00063,74.125.24.0-255,1484,36851,8,296908
26710,0.000635,172.31.36.0-255,66,36917,8,296908
26711,0.000641,74.125.24.0-255,2902,39819,8,296908
26712,0.000643,172.31.36.0-255,66,39885,8,296908
26713,0.000648,74.125.24.0-255,4320,44205,8,296908
26714,0.000651,172.31.36.0-255,66,44271,8,296908
26715,0.000666,74.125.24.0-255,1484,45755,8,296908
26716,0.000671,74.125.24.0-255,1484,47239,8,296908
26717,0.000673,172.31.36.0-255,66,47305,8,296908
26718,0.000707,172.31.36.0-255,66,47371,8,296908
26719,0.000712,74.125.24.0-255,2902,50273,8,296908
26720,0.000714,172.31.36.0-255,66,50339,8,296908
26721,0.000733,74.125.24.0-255,4320,54659,8,296908
26722,0.000735,172.31.36.0-255,66,54725,8,296908
26723,0.000759,74.125.24.0-255,1484,56209,8,296908
26724,0.000772,74.125.24.0-255,2184,58393,8,296908
26725,0.000776,172.31.36.0-255,66,58459,8,296908
26726,0.001136,74.125.24.0-255,1484,59943,8,296908
26727,0.001141,74.125.24.0-255,2902,62845,8,296908
26728,0.001145,172.31.36.0-255,66,62911,8,296908
26729,0.001168,74.125.24.0-255,5738,68649,8,296908
26730,0.001171,172.31.36.0-255,66,68715,8,296908
26731,0.001188,74.125.24.0-255,2902,71617,8,296908
26732,0.001191,172.31.36.0-255,66,71683,8,296908
26733,0.001224,172.31.36.0-255,66,71749,8,296908
26734,0.001272,172.31.36.0-255,66,71815,8,296908
26735,0.002005,74.125.24.0-255,1484,73299,8,296908
26736,0.002017,74.125.24.0-255,2902,76201,8,296908
26737,0.002022,172.31.36.0-255,66,76267,8,296908
26738,0.002029,74.125.24.0-255,5738,82005,8,296908
26739,0.002031,172.31.36.0-255,66,82071,8,296908
26740,0.002069,172.31.36.0-255,66,82137,8,296908
26741,0.002077,74.125.24.0-255,7156,89293,8,296908
26742,0.002079,172.31.36.0-255,66,89359,8,296908
26743,0.002102,74.125.24.0-255,3602,92961,8,296908
26744,0.002104,172.31.36.0-255,66,93027,8,296908
26745,0.002109,74.125.24.0-255,4320,97347,8,296908
26746,0.002111,172.31.36.0-255,66,97413,8,296908
26747,0.00213,74.125.24.0-255,2902,100315,8,296908
26748,0.002132,172.31.36.0-255,66,100381,8,296908
26749,0.002154,74.125.24.0-255,7156,107537,8,296908
26750,0.002155,172.31.36.0-255,66,107603,8,296908
26751,0.002165,172.31.36.0-255,66,107669,8,296908
26752,0.002179,74.125.24.0-255,4320,111989,8,296908
26753,0.002181,172.31.36.0-255,66,112055,8,296908
26754,0.002201,74.125.24.0-255,1484,113539,8,296908
26755,0.002223,74.125.24.0-255,5020,118559,8,296908
26756,0.002225,172.31.36.0-255,66,118625,8,296908
26757,0.002239,74.125.24.0-255,5738,124363,8,296908
26758,0.002242,172.31.36.0-255,66,124429,8,296908
26759,0.002267,74.125.24.0-255,1484,125913,8,296908
26760,0.002276,172.31.36.0-255,66,125979,8,296908
26761,0.002302,74.125.24.0-255,2902,128881,8,296908
26762,0.002304,172.31.36.0-255,66,128947,8,296908
26763,0.002336,172.31.36.0-255,66,129013,8,296908
26764,0.002338,74.125.24.0-255,766,129779,8,296908
26765,0.00243,74.125.24.0-255,1484,131263,8,296908
26766,0.002433,172.31.36.0-255,66,131329,8,296908
26767,0.002437,74.125.24.0-255,2902,134231,8,296908
26768,0.002439,172.31.36.0-255,66,134297,8,296908
26769,0.002452,74.125.24.0-255,5738,140035,8,296908
26770,0.002514,74.125.24.0-255,7156,147191,8,296908
26771,0.002529,74.125.24.0-255,2184,149375,8,296908
26772,0.007973,172.31.36.0-255,66,149441,8,296908
26773,0.010503,74.125.24.0-255,5738,155179,8,296908
26774,0.010512,172.31.36.0-255,66,155245,8,296908
26775,0.013036,74.125.24.0-255,5738,160983,8,296908
26776,0.013044,172.31.36.0-255,66,161049,8,296908
26777,0.01559,74.125.24.0-255,5738,166787,8,296908
26778,0.015598,172.31.36.0-255,66,166853,8,296908
26779,0.018129,74.125.24.0-255,5738,172591,8,296908
26780,0.018137,172.31.36.0-255,66,172657,8,296908
26781,0.020644,74.125.24.0-255,5738,178395,8,296908
26782,0.02065,172.31.36.0-255,66,178461,8,296908
26783,0.023173,74.125.24.0-255,5738,184199,8,296908
26784,0.023197,172.31.36.0-255,66,184265,8,296908
26785,0.025268,172.31.36.0-255,172,184437,8,296908
26786,0.025297,172.31.36.0-255,1111,185548,8,296908
26787,0.025333,172.31.36.0-255,1514,187062,8,296908
26788,0.025335,172.31.36.0-255,1514,188576,8,296908
26789,0.025336,172.31.36.0-255,1514,190090,8,296908
26790,0.025337,172.31.36.0-255,1514,191604,8,296908
26791,0.025365,172.31.36.0-255,1358,192962,8,296908
26792,0.025707,74.125.24.0-255,4320,197282,8,296908
26793,0.025713,172.31.36.0-255,66,197348,8,296908
26794,0.025745,74.125.24.0-255,1484,198832,8,296908
26795,0.027024,104.244.42.0-255,66,198898,8,296908
26796,0.028223,74.125.24.0-255,2902,201800,8,296908
26797,0.028227,172.31.36.0-255,66,201866,8,296908
26798,0.028254,74.125.24.0-255,1484,203350,8,296908
26799,0.030764,74.125.24.0-255,4320,207670,8,296908
26800,0.030769,172.31.36.0-255,66,207736,8,296908
26801,0.033285,74.125.24.0-255,2902,210638,8,296908
26802,0.03329,172.31.36.0-255,66,210704,8,296908
26803,0.033315,74.125.24.0-255,2902,213606,8,296908
26804,0.033318,172.31.36.0-255,66,213672,8,296908
26805,0.03582,74.125.24.0-255,2902,216574,8,296908
26806,0.035826,172.31.36.0-255,66,216640,8,296908
26807,0.035855,74.125.24.0-255,2902,219542,8,296908
26808,0.035858,172.31.36.0-255,66,219608,8,296908
26809,0.038334,74.125.24.0-255,2902,222510,8,296908
26810,0.038339,172.31.36.0-255,66,222576,8,296908
26811,0.038372,74.125.24.0-255,2902,225478,8,296908
26812,0.038376,172.31.36.0-255,66,225544,8,296908
26813,0.040855,74.125.24.0-255,2902,228446,8,296908
26814,0.040859,172.31.36.0-255,66,228512,8,296908
26815,0.040897,74.125.24.0-255,2902,231414,8,296908
26816,0.040901,172.31.36.0-255,66,231480,8,296908
26817,0.043378,74.125.24.0-255,2902,234382,8,296908
26818,0.043382,172.31.36.0-255,66,234448,8,296908
26819,0.043423,74.125.24.0-255,2902,237350,8,296908
26820,0.043426,172.31.36.0-255,66,237416,8,296908
26821,0.0459,74.125.24.0-255,2902,240318,8,296908
26822,0.045905,172.31.36.0-255,66,240384,8,296908
26823,0.045952,74.125.24.0-255,2902,243286,8,296908
26824,0.045956,172.31.36.0-255,66,243352,8,296908
26825,0.04843,74.125.24.0-255,2902,246254,8,296908
26826,0.048434,172.31.36.0-255,66,246320,8,296908
26827,0.048458,74.125.24.0-255,1484,247804,8,296908
26828,0.048469,74.125.24.0-255,1484,249288,8,296908
26829,0.048471,172.31.36.0-255,66,249354,8,296908
26830,0.050965,74.125.24.0-255,2902,252256,8,296908
26831,0.05097,172.31.36.0-255,66,252322,8,296908
26832,0.051004,74.125.24.0-255,2902,255224,8,296908
26833,0.051008,172.31.36.0-255,66,255290,8,296908
26834,0.053474,74.125.24.0-255,2902,258192,8,296908
26835,0.053479,172.31.36.0-255,66,258258,8,296908
26836,0.053535,74.125.24.0-255,2902,261160,8,296908
26837,0.05354,172.31.36.0-255,66,261226,8,296908
26838,0.056006,74.125.24.0-255,2902,264128,8,296908
26839,0.05601,172.31.36.0-255,66,264194,8,296908
26840,0.056057,74.125.24.0-255,2902,267096,8,296908
26841,0.056061,172.31.36.0-255,66,267162,8,296908
26842,0.058544,74.125.24.0-255,2902,270064,8,296908
26843,0.058548,172.31.36.0-255,66,270130,8,296908
26844,0.058605,74.125.24.0-255,2902,273032,8,296908
26845,0.058611,172.31.36.0-255,66,273098,8,296908
26846,0.061039,74.125.24.0-255,2902,276000,8,296908
26847,0.061044,172.31.36.0-255,66,276066,8,296908
26848,0.061164,74.125.24.0-255,2902,278968,8,296908
26849,0.06117,172.31.36.0-255,66,279034,8,296908
26850,0.063568,74.125.24.0-255,2902,281936,8,296908
26851,0.063573,172.31.36.0-255,66,282002,8,296908
26852,0.063675,74.125.24.0-255,2902,284904,8,296908
26853,0.06368,172.31.36.0-255,66,284970,8,296908
26854,0.066086,74.125.24.0-255,2902,287872,8,296908
26855,0.06609,172.31.36.0-255,66,287938,8,296908
26856,0.066181,74.125.24.0-255,2902,290840,8,296908
26857,0.066185,172.31.36.0-255,66,290906,8,296908
26858,0.068595,74.125.24.0-255,2902,293808,8,296908
26859,0.0686,172.31.36.0-255,66,293874,8,296908
26860,0.068633,104.244.42.0-255,66,293940,8,296908
26861,0.068697,74.125.24.0-255,2902,296842,8,296908
26862,0.0687,172.31.36.0-255,66,296908,8,296908
26863,0.0,74.125.24.0-255,146,146,8,256863
26864,3.4e-05,172.31.36.0-255,66,212,8,256863
26865,4.1e-05,74.125.24.0-255,1484,1696,8,256863
26866,4.5e-05,172.31.36.0-255,66,1762,8,256863
26867,5.1e-05,74.125.24.0-255,2902,4664,8,256863
26868,5.5e-05,172.31.36.0-255,66,4730,8,256863
26869,5.8e-05,74.125.24.0-255,1484,6214,8,256863
26870,6e-05,172.31.36.0-255,66,6280,8,256863
26871,9e-05,74.125.24.0-255,1484,7764,8,256863
26872,9.2e-05,172.31.36.0-255,66,7830,8,256863
26873,0.000115,74.125.24.0-255,6294,14124,8,256863
26874,0.000118,172.31.36.0-255,66,14190,8,256863
26875,0.000137,74.125.24.0-255,2902,17092,8,256863
26876,0.00014,172.31.36.0-255,66,17158,8,256863
26877,0.000159,74.125.24.0-255,1484,18642,8,256863
26878,0.000161,172.31.36.0-255,66,18708,8,256863
26879,0.000167,74.125.24.0-255,5738,24446,8,256863
26880,0.000171,172.31.36.0-255,66,24512,8,256863
26881,0.000184,74.125.24.0-255,1484,25996,8,256863
26882,0.000186,172.31.36.0-255,66,26062,8,256863
26883,0.000204,74.125.24.0-255,5379,31441,8,256863
26884,0.000207,172.31.36.0-255,66,31507,8,256863
26885,0.000484,74.125.24.0-255,1484,32991,8,256863
26886,0.000488,172.31.36.0-255,66,33057,8,256863
26887,0.000494,74.125.24.0-255,2902,35959,8,256863
26888,0.000496,172.31.36.0-255,66,36025,8,256863
26889,0.000528,74.125.24.0-255,5738,41763,8,256863
26890,0.000531,172.31.36.0-255,66,41829,8,256863
26891,0.000547,74.125.24.0-255,5738,47567,8,256863
26892,0.00055,172.31.36.0-255,66,47633,8,256863
26893,0.000581,172.31.36.0-255,66,47699,8,256863
26894,0.000599,74.125.24.0-255,1484,49183,8,256863
26895,0.000633,172.31.36.0-255,66,49249,8,256863
26896,0.001202,74.125.24.0-255,411,49660,8,256863
26897,0.001356,74.125.24.0-255,1484,51144,8,256863
26898,0.001362,172.31.36.0-255,66,51210,8,256863
26899,0.001372,74.125.24.0-255,2902,54112,8,256863
26900,0.001375,172.31.36.0-255,66,54178,8,256863
26901,0.00138,74.125.24.0-255,4320,58498,8,256863
26902,0.001382,172.31.36.0-255,66,58564,8,256863
26903,0.001406,74.125.24.0-255,1484,60048,8,256863
26904,0.00144,172.31.36.0-255,66,60114,8,256863
26905,0.001458,74.125.24.0-255,2902,63016,8,256863
26906,0.00146,172.31.36.0-255,66,63082,8,256863
26907,0.001467,74.125.24.0-255,7156,70238,8,256863
26908,0.001469,172.31.36.0-255,66,70304,8,256863
26909,0.001474,74.125.24.0-255,3602,73906,8,256863
26910,0.001476,172.31.36.0-255,66,73972,8,256863
26911,0.001743,74.125.24.0-255,333,74305,8,256863
26912,0.002038,74.125.24.0-255,1484,75789,8,256863
26913,0.002043,172.31.36.0-255,66,75855,8,256863
26914,0.002063,74.125.24.0-255,2902,78757,8,256863
26915,0.002065,172.31.36.0-255,66,78823,8,256863
26916,0.002069,74.125.24.0-255,1484,80307,8,256863
26917,0.002089,74.125.24.0-255,2902,83209,8,256863
26918,0.002092,172.31.36.0-255,66,83275,8,256863
26919,0.002097,74.125.24.0-255,2902,86177,8,256863
26920,0.002099,172.31.36.0-255,66,86243,8,256863
26921,0.002119,74.125.24.0-255,5738,91981,8,256863
26922,0.002121,172.31.36.0-255,66,92047,8,256863
26923,0.002137,74.125.24.0-255,4320,96367,8,256863
26924,0.002139,172.31.36.0-255,66,96433,8,256863
26925,0.002172,172.31.36.0-255,66,96499,8,256863
26926,0.004549,74.125.24.0-255,5738,102237,8,256863
26927,0.004555,172.31.36.0-255,66,102303,8,256863
26928,0.006944,74.125.24.0-255,5738,108041,8,256863
26929,0.006952,172.31.36.0-255,66,108107,8,256863
26930,0.009359,74.125.24.0-255,5738,113845,8,256863
26931,0.009369,172.31.36.0-255,66,113911,8,256863
26932,0.01178,74.125.24.0-255,5738,119649,8,256863
26933,0.011788,172.31.36.0-255,66,119715,8,256863
26934,0.01418,74.125.24.0-255,5738,125453,8,256863
26935,0.014189,172.31.36.0-255,66,125519,8,256863
26936,0.016581,74.125.24.0-255,5738,131257,8,256863
26937,0.016592,172.31.36.0-255,66,131323,8,256863
26938,0.018969,74.125.24.0-255,5738,137061,8,256863
26939,0.018984,172.31.36.0-255,66,137127,8,256863
26940,0.021389,74.125.24.0-255,5738,142865,8,256863
26941,0.021405,172.31.36.0-255,66,142931,8,256863
26942,0.023071,172.31.36.0-255,166,143097,8,256863
26943,0.023122,172.31.36.0-255,1136,144233,8,256863
26944,0.0232,172.31.36.0-255,1514,145747,8,256863
26945,0.023203,172.31.36.0-255,1268,147015,8,256863
26946,0.023791,74.125.24.0-255,5738,152753,8,256863
26947,0.023801,172.31.36.0-255,66,152819,8,256863
26948,0.024663,104.244.42.0-255,66,152885,8,256863
26949,0.024712,104.244.42.0-255,66,152951,8,256863
26950,0.024771,104.244.42.0-255,66,153017,8,256863
26951,0.026186,74.125.24.0-255,5738,158755,8,256863
26952,0.026191,172.31.36.0-255,66,158821,8,256863
26953,0.028555,74.125.24.0-255,4320,163141,8,256863
26954,0.028561,172.31.36.0-255,66,163207,8,256863
26955,0.028591,74.125.24.0-255,1484,164691,8,256863
26956,0.030896,74.125.24.0-255,2902,167593,8,256863
26957,0.030901,172.31.36.0-255,66,167659,8,256863
26958,0.033226,74.125.24.0-255,4320,171979,8,256863
26959,0.033231,172.31.36.0-255,66,172045,8,256863
26960,0.033261,74.125.24.0-255,1484,173529,8,256863
26961,0.035608,74.125.24.0-255,4320,177849,8,256863
26962,0.035613,172.31.36.0-255,66,177915,8,256863
26963,0.037982,74.125.24.0-255,4320,182235,8,256863
26964,0.037987,172.31.36.0-255,66,182301,8,256863
26965,0.038017,74.125.24.0-255,1484,183785,8,256863
26966,0.040337,74.125.24.0-255,4320,188105,8,256863
26967,0.040344,172.31.36.0-255,66,188171,8,256863
26968,0.042716,74.125.24.0-255,2902,191073,8,256863
26969,0.042722,172.31.36.0-255,66,191139,8,256863
26970,0.042755,74.125.24.0-255,2902,194041,8,256863
26971,0.042759,172.31.36.0-255,66,194107,8,256863
26972,0.045102,74.125.24.0-255,5738,199845,8,256863
26973,0.045115,172.31.36.0-255,66,199911,8,256863
26974,0.0475,74.125.24.0-255,5738,205649,8,256863
26975,0.047511,172.31.36.0-255,66,205715,8,256863
26976,0.049873,74.125.24.0-255,5738,211453,8,256863
26977,0.049879,172.31.36.0-255,66,211519,8,256863
26978,0.05223,74.125.24.0-255,5738,217257,8,256863
26979,0.052238,172.31.36.0-255,66,217323,8,256863
26980,0.054592,74.125.24.0-255,5738,223061,8,256863
26981,0.054599,172.31.36.0-255,66,223127,8,256863
26982,0.056946,74.125.24.0-255,5738,228865,8,256863
26983,0.056953,172.31.36.0-255,66,228931,8,256863
26984,0.059292,74.125.24.0-255,2902,231833,8,256863
26985,0.059297,172.31.36.0-255,66,231899,8,256863
26986,0.059332,74.125.24.0-255,2902,234801,8,256863
26987,0.059335,172.31.36.0-255,66,234867,8,256863
26988,0.061717,74.125.24.0-255,5738,240605,8,256863
26989,0.061724,172.31.36.0-255,66,240671,8,256863
26990,0.064085,74.125.24.0-255,4320,244991,8,256863
26991,0.064091,172.31.36.0-255,66,245057,8,256863
26992,0.064128,74.125.24.0-255,1484,246541,8,256863
26993,0.066458,74.125.24.0-255,1484,248025,8,256863
26994,0.066464,172.31.36.0-255,66,248091,8,256863
26995,0.066494,74.125.24.0-255,2902,250993,8,256863
26996,0.066497,172.31.36.0-255,66,251059,8,256863
26997,0.068821,74.125.24.0-255,5738,256797,8,256863
26998,0.068827,172.31.36.0-255,66,256863,8,256863
26999,0.0,172.217.194.0-255,153,153,8,336862
27000,1.4e-05,172.31.36.0-255,66,219,8,336862
27001,2e-05,172.217.194.0-255,1484,1703,8,336862
27002,2.6e-05,172.31.36.0-255,66,1769,8,336862
27003,2.9e-05,172.217.194.0-255,1484,3253,8,336862
27004,3.2e-05,172.31.36.0-255,66,3319,8,336862
27005,5.8e-05,172.217.194.0-255,1484,4803,8,336862
27006,6.1e-05,172.31.36.0-255,66,4869,8,336862
27007,6.8e-05,172.217.194.0-255,4320,9189,8,336862
27008,7e-05,172.31.36.0-255,66,9255,8,336862
27009,7.5e-05,172.217.194.0-255,2902,12157,8,336862
27010,7.7e-05,172.31.36.0-255,66,12223,8,336862
27011,0.000104,172.217.194.0-255,6313,18536,8,336862
27012,0.000107,172.31.36.0-255,66,18602,8,336862
27013,0.000131,172.217.194.0-255,5738,24340,8,336862
27014,0.000135,172.31.36.0-255,66,24406,8,336862
27015,0.000153,172.217.194.0-255,2902,27308,8,336862
27016,0.000155,172.31.36.0-255,66,27374,8,336862
27017,0.00016,172.217.194.0-255,3961,31335,8,336862
27018,0.000162,172.31.36.0-255,66,31401,8,336862
27019,0.000198,172.217.194.0-255,1484,32885,8,336862
27020,0.000201,172.31.36.0-255,66,32951,8,336862
27021,0.000222,172.217.194.0-255,2902,35853,8,336862
27022,0.000225,172.31.36.0-255,66,35919,8,336862
27023,0.000232,172.217.194.0-255,5738,41657,8,336862
27024,0.000234,172.31.36.0-255,66,41723,8,336862
27025,0.000251,172.217.194.0-255,2902,44625,8,336862
27026,0.000254,172.31.36.0-255,66,44691,8,336862
27027,0.000272,172.217.194.0-255,3961,48652,8,336862
27028,0.000275,172.31.36.0-255,66,48718,8,336862
27029,0.000283,172.217.194.0-255,7156,55874,8,336862
27030,0.000285,172.31.36.0-255,66,55940,8,336862
27031,0.000304,172.217.194.0-255,4320,60260,8,336862
27032,0.000319,172.217.194.0-255,5627,65887,8,336862
27033,0.000474,172.31.36.0-255,66,65953,8,336862
27034,0.001325,172.217.194.0-255,121,66074,8,336862
27035,0.001354,172.217.194.0-255,1484,67558,8,336862
27036,0.001358,172.31.36.0-255,66,67624,8,336862
27037,0.001365,172.217.194.0-255,2902,70526,8,336862
27038,0.001381,172.217.194.0-255,5738,76264,8,336862
27039,0.001402,172.217.194.0-255,4320,80584,8,336862
27040,0.001427,172.217.194.0-255,7156,87740,8,336862
27041,0.001439,172.217.194.0-255,1484,89224,8,336862
27042,0.00146,172.217.194.0-255,4320,93544,8,336862
27043,0.001477,172.217.194.0-255,1484,95028,8,336862
27044,0.001495,172.217.194.0-255,5020,100048,8,336862
27045,0.001514,172.217.194.0-255,1484,101532,8,336862
27046,0.001519,172.217.194.0-255,2902,104434,8,336862
27047,0.00154,172.217.194.0-255,5738,110172,8,336862
27048,0.001545,172.217.194.0-255,4320,114492,8,336862
27049,0.001562,172.217.194.0-255,4320,118812,8,336862
27050,0.001569,172.217.194.0-255,7156,125968,8,336862
27051,0.001596,172.217.194.0-255,4320,130288,8,336862
27052,0.001672,172.217.194.0-255,5020,135308,8,336862
27053,0.002118,172.217.194.0-255,1484,136792,8,336862
27054,0.002127,172.217.194.0-255,2902,139694,8,336862
27055,0.002142,172.217.194.0-255,1484,141178,8,336862
27056,0.002147,172.217.194.0-255,2902,144080,8,336862
27057,0.002151,172.217.194.0-255,1484,145564,8,336862
27058,0.002168,172.217.194.0-255,4320,149884,8,336862
27059,0.002205,172.217.194.0-255,2902,152786,8,336862
27060,0.002239,172.217.194.0-255,6438,159224,8,336862
27061,0.002265,172.217.194.0-255,1484,160708,8,336862
27062,0.00227,172.217.194.0-255,2902,163610,8,336862
27063,0.002318,172.217.194.0-255,2902,166512,8,336862
27064,0.003548,172.31.36.0-255,66,166578,8,336862
27065,0.005811,172.217.194.0-255,5738,172316,8,336862
27066,0.005818,172.31.36.0-255,66,172382,8,336862
27067,0.008141,172.217.194.0-255,5738,178120,8,336862
27068,0.008146,172.31.36.0-255,66,178186,8,336862
27069,0.01042,172.217.194.0-255,5738,183924,8,336862
27070,0.010427,172.31.36.0-255,66,183990,8,336862
27071,0.012664,172.217.194.0-255,5738,189728,8,336862
27072,0.012671,172.31.36.0-255,66,189794,8,336862
27073,0.014929,172.217.194.0-255,5738,195532,8,336862
27074,0.015656,172.31.36.0-255,66,195598,8,336862
27075,0.017919,172.217.194.0-255,5738,201336,8,336862
27076,0.017927,172.31.36.0-255,66,201402,8,336862
27077,0.020174,172.217.194.0-255,5738,207140,8,336862
27078,0.020184,172.31.36.0-255,66,207206,8,336862
27079,0.022423,172.217.194.0-255,5738,212944,8,336862
27080,0.022432,172.31.36.0-255,66,213010,8,336862
27081,0.024691,172.217.194.0-255,5738,218748,8,336862
27082,0.0247,172.31.36.0-255,66,218814,8,336862
27083,0.026964,172.217.194.0-255,5738,224552,8,336862
27084,0.026971,172.31.36.0-255,66,224618,8,336862
27085,0.029224,172.217.194.0-255,5738,230356,8,336862
27086,0.029232,172.31.36.0-255,66,230422,8,336862
27087,0.031465,172.217.194.0-255,5738,236160,8,336862
27088,0.031473,172.31.36.0-255,66,236226,8,336862
27089,0.03373,172.217.194.0-255,5738,241964,8,336862
27090,0.033738,172.31.36.0-255,66,242030,8,336862
27091,0.035982,172.217.194.0-255,5738,247768,8,336862
27092,0.035989,172.31.36.0-255,66,247834,8,336862
27093,0.038237,172.217.194.0-255,5738,253572,8,336862
27094,0.038246,172.31.36.0-255,66,253638,8,336862
27095,0.04055,172.217.194.0-255,5738,259376,8,336862
27096,0.040557,172.31.36.0-255,66,259442,8,336862
27097,0.041832,172.31.36.0-255,172,259614,8,336862
27098,0.041866,172.31.36.0-255,1112,260726,8,336862
27099,0.041938,172.31.36.0-255,1514,262240,8,336862
27100,0.04194,172.31.36.0-255,1514,263754,8,336862
27101,0.041947,172.31.36.0-255,1514,265268,8,336862
27102,0.041948,172.31.36.0-255,1514,266782,8,336862
27103,0.04198,172.31.36.0-255,168,266950,8,336862
27104,0.042829,172.217.194.0-255,5738,272688,8,336862
27105,0.042836,172.31.36.0-255,66,272754,8,336862
27106,0.043371,104.244.42.0-255,66,272820,8,336862
27107,0.043466,104.244.42.0-255,66,272886,8,336862
27108,0.043567,104.244.42.0-255,66,272952,8,336862
27109,0.043572,104.244.42.0-255,66,273018,8,336862
27110,0.045072,172.217.194.0-255,5738,278756,8,336862
27111,0.045079,172.31.36.0-255,66,278822,8,336862
27112,0.04733,172.217.194.0-255,5738,284560,8,336862
27113,0.047553,172.31.36.0-255,66,284626,8,336862
27114,0.049817,172.217.194.0-255,5738,290364,8,336862
27115,0.049825,172.31.36.0-255,66,290430,8,336862
27116,0.052124,172.217.194.0-255,5738,296168,8,336862
27117,0.052131,172.31.36.0-255,66,296234,8,336862
27118,0.054392,172.217.194.0-255,5738,301972,8,336862
27119,0.054399,172.31.36.0-255,66,302038,8,336862
27120,0.056667,172.217.194.0-255,5738,307776,8,336862
27121,0.056673,172.31.36.0-255,66,307842,8,336862
27122,0.058919,172.217.194.0-255,5738,313580,8,336862
27123,0.058926,172.31.36.0-255,66,313646,8,336862
27124,0.061202,172.217.194.0-255,5738,319384,8,336862
27125,0.061209,172.31.36.0-255,66,319450,8,336862
27126,0.063485,172.217.194.0-255,5738,325188,8,336862
27127,0.063492,172.31.36.0-255,66,325254,8,336862
27128,0.06579,172.217.194.0-255,5738,330992,8,336862
27129,0.065796,172.31.36.0-255,66,331058,8,336862
27130,0.06806,172.217.194.0-255,5738,336796,8,336862
27131,0.068065,172.31.36.0-255,66,336862,8,336862
27132,0.0,172.217.194.0-255,297,297,8,192334
27133,2.8e-05,172.31.36.0-255,66,363,8,192334
27134,3.5e-05,172.217.194.0-255,1484,1847,8,192334
27135,3.9e-05,172.31.36.0-255,66,1913,8,192334
27136,4.5e-05,172.217.194.0-255,4320,6233,8,192334
27137,4.7e-05,172.31.36.0-255,66,6299,8,192334
27138,5.5e-05,172.217.194.0-255,7156,13455,8,192334
27139,5.7e-05,172.31.36.0-255,66,13521,8,192334
27140,7.1e-05,172.217.194.0-255,1484,15005,8,192334
27141,7.3e-05,172.31.36.0-255,66,15071,8,192334
27142,0.000105,172.31.36.0-255,66,15137,8,192334
27143,0.000108,172.217.194.0-255,1125,16262,8,192334
27144,0.000111,172.31.36.0-255,66,16328,8,192334
27145,0.00024,172.217.194.0-255,1484,17812,8,192334
27146,0.000244,172.31.36.0-255,66,17878,8,192334
27147,0.000251,172.217.194.0-255,2902,20780,8,192334
27148,0.000253,172.31.36.0-255,66,20846,8,192334
27149,0.000257,172.217.194.0-255,1484,22330,8,192334
27150,0.000259,172.31.36.0-255,66,22396,8,192334
27151,0.000274,172.217.194.0-255,4320,26716,8,192334
27152,0.000279,172.31.36.0-255,66,26782,8,192334
27153,0.000339,172.31.36.0-255,66,26848,8,192334
27154,0.00035,172.31.36.0-255,66,26914,8,192334
27155,0.000359,172.217.194.0-255,7086,34000,8,192334
27156,0.000363,172.31.36.0-255,66,34066,8,192334
27157,0.000386,172.217.194.0-255,366,34432,8,192334
27158,0.000389,172.31.36.0-255,66,34498,8,192334
27159,0.000604,172.217.194.0-255,1484,35982,8,192334
27160,0.000611,172.31.36.0-255,66,36048,8,192334
27161,0.000616,172.217.194.0-255,1484,37532,8,192334
27162,0.000634,172.217.194.0-255,1484,39016,8,192334
27163,0.000637,172.31.36.0-255,66,39082,8,192334
27164,0.000644,172.217.194.0-255,5738,44820,8,192334
27165,0.000649,172.217.194.0-255,4320,49140,8,192334
27166,0.000649,172.31.36.0-255,66,49206,8,192334
27167,0.000653,172.31.36.0-255,66,49272,8,192334
27168,0.00067,172.217.194.0-255,5738,55010,8,192334
27169,0.000673,172.31.36.0-255,66,55076,8,192334
27170,0.000713,172.31.36.0-255,66,55142,8,192334
27171,0.000716,172.217.194.0-255,2184,57326,8,192334
27172,0.000719,172.31.36.0-255,66,57392,8,192334
27173,0.00083,172.217.194.0-255,1484,58876,8,192334
27174,0.000837,172.217.194.0-255,2902,61778,8,192334
27175,0.00084,172.31.36.0-255,66,61844,8,192334
27176,0.000866,172.217.194.0-255,5738,67582,8,192334
27177,0.000869,172.31.36.0-255,66,67648,8,192334
27178,0.000875,172.217.194.0-255,4320,71968,8,192334
27179,0.000877,172.31.36.0-255,66,72034,8,192334
27180,0.000901,172.31.36.0-255,66,72100,8,192334
27181,0.00094,172.31.36.0-255,66,72166,8,192334
27182,0.000958,172.217.194.0-255,2184,74350,8,192334
27183,0.000961,172.31.36.0-255,66,74416,8,192334
27184,0.001021,172.217.194.0-255,1484,75900,8,192334
27185,0.001034,172.217.194.0-255,2902,78802,8,192334
27186,0.001038,172.31.36.0-255,66,78868,8,192334
27187,0.001045,172.217.194.0-255,5738,84606,8,192334
27188,0.001047,172.31.36.0-255,66,84672,8,192334
27189,0.00105,172.217.194.0-255,1484,86156,8,192334
27190,0.001084,172.31.36.0-255,66,86222,8,192334
27191,0.001102,172.217.194.0-255,2902,89124,8,192334
27192,0.001105,172.31.36.0-255,66,89190,8,192334
27193,0.001143,172.31.36.0-255,66,89256,8,192334
27194,0.001159,172.31.36.0-255,66,89322,8,192334
27195,0.001165,172.217.194.0-255,5738,95060,8,192334
27196,0.001168,172.31.36.0-255,66,95126,8,192334
27197,0.001201,172.217.194.0-255,5020,100146,8,192334
27198,0.001204,172.31.36.0-255,66,100212,8,192334
27199,0.00156,172.217.194.0-255,1484,101696,8,192334
27200,0.001566,172.217.194.0-255,2902,104598,8,192334
27201,0.001569,172.31.36.0-255,66,104664,8,192334
27202,0.001575,172.217.194.0-255,4320,108984,8,192334
27203,0.001577,172.31.36.0-255,66,109050,8,192334
27204,0.001591,172.217.194.0-255,1484,110534,8,192334
27205,0.001599,172.217.194.0-255,7156,117690,8,192334
27206,0.001602,172.31.36.0-255,66,117756,8,192334
27207,0.001624,172.217.194.0-255,5738,123494,8,192334
27208,0.001626,172.31.36.0-255,66,123560,8,192334
27209,0.001633,172.217.194.0-255,7156,130716,8,192334
27210,0.001636,172.31.36.0-255,66,130782,8,192334
27211,0.001654,172.217.194.0-255,3602,134384,8,192334
27212,0.001657,172.31.36.0-255,66,134450,8,192334
27213,0.001825,172.217.194.0-255,1484,135934,8,192334
27214,0.001846,172.217.194.0-255,2902,138836,8,192334
27215,0.001849,172.217.194.0-255,1484,140320,8,192334
27216,0.001852,172.31.36.0-255,66,140386,8,192334
27217,0.001875,172.217.194.0-255,4320,144706,8,192334
27218,0.001878,172.31.36.0-255,66,144772,8,192334
27219,0.001881,172.217.194.0-255,1484,146256,8,192334
27220,0.001898,172.31.36.0-255,66,146322,8,192334
27221,0.001926,172.31.36.0-255,66,146388,8,192334
27222,0.001947,172.217.194.0-255,3602,149990,8,192334
27223,0.00195,172.31.36.0-255,66,150056,8,192334
27224,0.001972,172.217.194.0-255,1484,151540,8,192334
27225,0.001976,172.217.194.0-255,1484,153024,8,192334
27226,0.001978,172.31.36.0-255,66,153090,8,192334
27227,0.002002,172.217.194.0-255,1484,154574,8,192334
27228,0.002009,172.217.194.0-255,5738,160312,8,192334
27229,0.002011,172.31.36.0-255,66,160378,8,192334
27230,0.002025,172.31.36.0-255,66,160444,8,192334
27231,0.002054,172.217.194.0-255,1484,161928,8,192334
27232,0.002067,172.31.36.0-255,66,161994,8,192334
27233,0.002085,172.217.194.0-255,5738,167732,8,192334
27234,0.002089,172.31.36.0-255,66,167798,8,192334
27235,0.002114,172.217.194.0-255,2184,169982,8,192334
27236,0.002118,172.31.36.0-255,66,170048,8,192334
27237,0.002128,172.31.36.0-255,66,170114,8,192334
27238,0.002178,172.31.36.0-255,66,170180,8,192334
27239,0.002217,172.31.36.0-255,66,170246,8,192334
27240,0.002233,172.31.36.0-255,66,170312,8,192334
27241,0.002236,172.217.194.0-255,1484,171796,8,192334
27242,0.002248,172.31.36.0-255,66,171862,8,192334
27243,0.002266,172.217.194.0-255,2184,174046,8,192334
27244,0.00227,172.31.36.0-255,66,174112,8,192334
27245,0.002309,172.31.36.0-255,66,174178,8,192334
27246,0.002321,172.31.36.0-255,66,174244,8,192334
27247,0.002348,172.217.194.0-255,5738,179982,8,192334
27248,0.002351,172.31.36.0-255,66,180048,8,192334
27249,0.002356,172.217.194.0-255,3602,183650,8,192334
27250,0.002358,172.31.36.0-255,66,183716,8,192334
27251,0.004619,172.217.194.0-255,5738,189454,8,192334
27252,0.004627,172.31.36.0-255,66,189520,8,192334
27253,0.006883,172.217.194.0-255,1711,191231,8,192334
27254,0.006889,172.31.36.0-255,66,191297,8,192334
27255,0.007038,172.31.36.0-255,105,191402,8,192334
27256,0.00928,172.217.194.0-255,66,191468,8,192334
27257,0.035366,172.31.36.0-255,172,191640,8,192334
27258,0.03543,172.31.36.0-255,562,192202,8,192334
27259,0.036924,104.244.42.0-255,66,192268,8,192334
27260,0.036971,104.244.42.0-255,66,192334,8,192334
27261,0.0,74.125.24.0-255,153,153,8,307376
27262,2.1e-05,172.31.36.0-255,66,219,8,307376
27263,2.9e-05,74.125.24.0-255,1484,1703,8,307376
27264,3.3e-05,172.31.36.0-255,66,1769,8,307376
27265,4.7e-05,74.125.24.0-255,2902,4671,8,307376
27266,5e-05,172.31.36.0-255,66,4737,8,307376
27267,5.7e-05,74.125.24.0-255,5738,10475,8,307376
27268,6.1e-05,172.31.36.0-255,66,10541,8,307376
27269,6.7e-05,74.125.24.0-255,3436,13977,8,307376
27270,7.1e-05,172.31.36.0-255,66,14043,8,307376
27271,0.000145,74.125.24.0-255,1484,15527,8,307376
27272,0.00015,172.31.36.0-255,66,15593,8,307376
27273,0.000154,74.125.24.0-255,1484,17077,8,307376
27274,0.000156,172.31.36.0-255,66,17143,8,307376
27275,0.000189,74.125.24.0-255,1484,18627,8,307376
27276,0.000196,172.31.36.0-255,66,18693,8,307376
27277,0.000203,74.125.24.0-255,5738,24431,8,307376
27278,0.000205,172.31.36.0-255,66,24497,8,307376
27279,0.000213,74.125.24.0-255,6797,31294,8,307376
27280,0.000215,172.31.36.0-255,66,31360,8,307376
27281,0.000221,74.125.24.0-255,4320,35680,8,307376
27282,0.000223,172.31.36.0-255,66,35746,8,307376
27283,0.000258,74.125.24.0-255,2902,38648,8,307376
27284,0.000261,172.31.36.0-255,66,38714,8,307376
27285,0.000273,172.31.36.0-255,66,38780,8,307376
27286,0.000305,74.125.24.0-255,2902,41682,8,307376
27287,0.000307,172.31.36.0-255,66,41748,8,307376
27288,0.000329,74.125.24.0-255,5738,47486,8,307376
27289,0.000332,172.31.36.0-255,66,47552,8,307376
27290,0.000368,74.125.24.0-255,1484,49036,8,307376
27291,0.000371,172.31.36.0-255,66,49102,8,307376
27292,0.000403,74.125.24.0-255,7131,56233,8,307376
27293,0.000407,74.125.24.0-255,110,56343,8,307376
27294,0.000544,74.125.24.0-255,1484,57827,8,307376
27295,0.000551,74.125.24.0-255,2902,60729,8,307376
27296,0.000557,74.125.24.0-255,5738,66467,8,307376
27297,0.000587,74.125.24.0-255,5738,72205,8,307376
27298,0.000619,172.31.36.0-255,66,72271,8,307376
27299,0.000652,74.125.24.0-255,7156,79427,8,307376
27300,0.000666,74.125.24.0-255,2543,81970,8,307376
27301,0.000676,172.31.36.0-255,66,82036,8,307376
27302,0.000707,74.125.24.0-255,330,82366,8,307376
27303,0.000811,74.125.24.0-255,1484,83850,8,307376
27304,0.000815,74.125.24.0-255,2902,86752,8,307376
27305,0.00082,172.31.36.0-255,66,86818,8,307376
27306,0.000827,74.125.24.0-255,1484,88302,8,307376
27307,0.000852,74.125.24.0-255,4320,92622,8,307376
27308,0.000867,74.125.24.0-255,4320,96942,8,307376
27309,0.000883,172.31.36.0-255,66,97008,8,307376
27310,0.000889,74.125.24.0-255,5738,102746,8,307376
27311,0.000906,172.31.36.0-255,66,102812,8,307376
27312,0.00091,74.125.24.0-255,766,103578,8,307376
27313,0.001181,74.125.24.0-255,1484,105062,8,307376
27314,0.001184,172.31.36.0-255,66,105128,8,307376
27315,0.001189,74.125.24.0-255,2902,108030,8,307376
27316,0.001193,172.31.36.0-255,66,108096,8,307376
27317,0.001208,74.125.24.0-255,5738,113834,8,307376
27318,0.001253,74.125.24.0-255,2902,116736,8,307376
27319,0.001257,172.31.36.0-255,66,116802,8,307376
27320,0.001261,172.31.36.0-255,66,116868,8,307376
27321,0.001304,172.31.36.0-255,66,116934,8,307376
27322,0.001664,74.125.24.0-255,1484,118418,8,307376
27323,0.001671,74.125.24.0-255,2902,121320,8,307376
27324,0.001674,172.31.36.0-255,66,121386,8,307376
27325,0.001715,74.125.24.0-255,2902,124288,8,307376
27326,0.001731,74.125.24.0-255,2902,127190,8,307376
27327,0.001753,172.31.36.0-255,66,127256,8,307376
27328,0.001768,172.31.36.0-255,66,127322,8,307376
27329,0.001778,74.125.24.0-255,2184,129506,8,307376
27330,0.001803,172.31.36.0-255,66,129572,8,307376
27331,0.001839,74.125.24.0-255,1484,131056,8,307376
27332,0.001843,74.125.24.0-255,2902,133958,8,307376
27333,0.001863,172.31.36.0-255,66,134024,8,307376
27334,0.001873,74.125.24.0-255,5738,139762,8,307376
27335,0.001885,172.31.36.0-255,66,139828,8,307376
27336,0.00193,74.125.24.0-255,1484,141312,8,307376
27337,0.001932,172.31.36.0-255,66,141378,8,307376
27338,0.001988,74.125.24.0-255,5738,147116,8,307376
27339,0.001998,172.31.36.0-255,66,147182,8,307376
27340,0.002041,74.125.24.0-255,4320,151502,8,307376
27341,0.002055,74.125.24.0-255,3602,155104,8,307376
27342,0.002063,172.31.36.0-255,66,155170,8,307376
27343,0.004115,74.125.24.0-255,5738,160908,8,307376
27344,0.004121,172.31.36.0-255,66,160974,8,307376
27345,0.00617,74.125.24.0-255,1484,162458,8,307376
27346,0.006188,74.125.24.0-255,4320,166778,8,307376
27347,0.00619,172.31.36.0-255,66,166844,8,307376
27348,0.008262,74.125.24.0-255,2902,169746,8,307376
27349,0.008268,172.31.36.0-255,66,169812,8,307376
27350,0.008299,74.125.24.0-255,2902,172714,8,307376
27351,0.008302,172.31.36.0-255,66,172780,8,307376
27352,0.010329,74.125.24.0-255,2902,175682,8,307376
27353,0.010336,172.31.36.0-255,66,175748,8,307376
27354,0.010359,74.125.24.0-255,2902,178650,8,307376
27355,0.010363,172.31.36.0-255,66,178716,8,307376
27356,0.012399,74.125.24.0-255,5738,184454,8,307376
27357,0.012407,172.31.36.0-255,66,184520,8,307376
27358,0.014451,74.125.24.0-255,5738,190258,8,307376
27359,0.014459,172.31.36.0-255,66,190324,8,307376
27360,0.016497,74.125.24.0-255,5738,196062,8,307376
27361,0.016505,172.31.36.0-255,66,196128,8,307376
27362,0.018584,74.125.24.0-255,5738,201866,8,307376
27363,0.018594,172.31.36.0-255,66,201932,8,307376
27364,0.020633,74.125.24.0-255,5738,207670,8,307376
27365,0.020641,172.31.36.0-255,66,207736,8,307376
27366,0.022722,74.125.24.0-255,5738,213474,8,307376
27367,0.022729,172.31.36.0-255,66,213540,8,307376
27368,0.024793,74.125.24.0-255,5738,219278,8,307376
27369,0.024803,172.31.36.0-255,66,219344,8,307376
27370,0.026851,74.125.24.0-255,5738,225082,8,307376
27371,0.026859,172.31.36.0-255,66,225148,8,307376
27372,0.028962,74.125.24.0-255,5738,230886,8,307376
27373,0.028969,172.31.36.0-255,66,230952,8,307376
27374,0.031018,74.125.24.0-255,5738,236690,8,307376
27375,0.031026,172.31.36.0-255,66,236756,8,307376
27376,0.033098,74.125.24.0-255,5738,242494,8,307376
27377,0.033107,172.31.36.0-255,66,242560,8,307376
27378,0.035205,74.125.24.0-255,5738,248298,8,307376
27379,0.035212,172.31.36.0-255,66,248364,8,307376
27380,0.037303,74.125.24.0-255,5738,254102,8,307376
27381,0.037311,172.31.36.0-255,66,254168,8,307376
27382,0.03937,74.125.24.0-255,5738,259906,8,307376
27383,0.039378,172.31.36.0-255,66,259972,8,307376
27384,0.039567,172.31.36.0-255,172,260144,8,307376
27385,0.039626,172.31.36.0-255,1112,261256,8,307376
27386,0.039775,172.31.36.0-255,1514,262770,8,307376
27387,0.039778,172.31.36.0-255,1514,264284,8,307376
27388,0.039785,172.31.36.0-255,1514,265798,8,307376
27389,0.039786,172.31.36.0-255,1514,267312,8,307376
27390,0.039807,172.31.36.0-255,167,267479,8,307376
27391,0.041117,104.244.42.0-255,66,267545,8,307376
27392,0.04116,104.244.42.0-255,66,267611,8,307376
27393,0.041363,104.244.42.0-255,66,267677,8,307376
27394,0.041369,104.244.42.0-255,66,267743,8,307376
27395,0.041414,74.125.24.0-255,5738,273481,8,307376
27396,0.041419,172.31.36.0-255,66,273547,8,307376
27397,0.04347,74.125.24.0-255,5738,279285,8,307376
27398,0.043479,172.31.36.0-255,66,279351,8,307376
27399,0.045556,74.125.24.0-255,5738,285089,8,307376
27400,0.045562,172.31.36.0-255,66,285155,8,307376
27401,0.047617,74.125.24.0-255,5738,290893,8,307376
27402,0.047624,172.31.36.0-255,66,290959,8,307376
27403,0.049706,74.125.24.0-255,5738,296697,8,307376
27404,0.049713,172.31.36.0-255,66,296763,8,307376
27405,0.051788,74.125.24.0-255,5738,302501,8,307376
27406,0.051794,172.31.36.0-255,66,302567,8,307376
27407,0.053874,74.125.24.0-255,4572,307139,8,307376
27408,0.053881,172.31.36.0-255,66,307205,8,307376
27409,0.054083,172.31.36.0-255,105,307310,8,307376
27410,0.056105,74.125.24.0-255,66,307376,8,307376
27411,0.0,172.217.194.0-255,156,156,8,163066
27412,2.7e-05,172.31.36.0-255,66,222,8,163066
27413,3.4e-05,172.217.194.0-255,1484,1706,8,163066
27414,3.8e-05,172.31.36.0-255,66,1772,8,163066
27415,4.3e-05,172.217.194.0-255,2902,4674,8,163066
27416,4.6e-05,172.31.36.0-255,66,4740,8,163066
27417,6.2e-05,172.217.194.0-255,7156,11896,8,163066
27418,6.5e-05,172.31.36.0-255,66,11962,8,163066
27419,6.9e-05,172.217.194.0-255,2039,14001,8,163066
27420,7.1e-05,172.31.36.0-255,66,14067,8,163066
27421,0.000128,172.217.194.0-255,1484,15551,8,163066
27422,0.000132,172.31.36.0-255,66,15617,8,163066
27423,0.000137,172.217.194.0-255,2902,18519,8,163066
27424,0.00014,172.31.36.0-255,66,18585,8,163066
27425,0.000151,172.217.194.0-255,5738,24323,8,163066
27426,0.000153,172.31.36.0-255,66,24389,8,163066
27427,0.00018,172.217.194.0-255,7156,31545,8,163066
27428,0.000183,172.31.36.0-255,66,31611,8,163066
27429,0.000209,172.217.194.0-255,1125,32736,8,163066
27430,0.000217,172.31.36.0-255,66,32802,8,163066
27431,0.000229,172.31.36.0-255,66,32868,8,163066
27432,0.000232,172.217.194.0-255,2902,35770,8,163066
27433,0.000234,172.31.36.0-255,66,35836,8,163066
27434,0.000271,172.217.194.0-255,3961,39797,8,163066
27435,0.000275,172.31.36.0-255,66,39863,8,163066
27436,0.000282,172.217.194.0-255,7156,47019,8,163066
27437,0.000284,172.31.36.0-255,66,47085,8,163066
27438,0.000303,172.31.36.0-255,66,47151,8,163066
27439,0.000401,172.217.194.0-255,646,47797,8,163066
27440,0.000405,172.31.36.0-255,66,47863,8,163066
27441,0.000824,172.217.194.0-255,1484,49347,8,163066
27442,0.000833,172.217.194.0-255,2902,52249,8,163066
27443,0.000837,172.31.36.0-255,66,52315,8,163066
27444,0.000873,172.217.194.0-255,5738,58053,8,163066
27445,0.000877,172.31.36.0-255,66,58119,8,163066
27446,0.000899,172.31.36.0-255,66,58185,8,163066
27447,0.000929,172.31.36.0-255,66,58251,8,163066
27448,0.001137,172.217.194.0-255,1484,59735,8,163066
27449,0.001145,172.217.194.0-255,2902,62637,8,163066
27450,0.001148,172.31.36.0-255,66,62703,8,163066
27451,0.001153,172.217.194.0-255,2902,65605,8,163066
27452,0.001156,172.31.36.0-255,66,65671,8,163066
27453,0.001187,172.217.194.0-255,2902,68573,8,163066
27454,0.00119,172.31.36.0-255,66,68639,8,163066
27455,0.001204,172.31.36.0-255,66,68705,8,163066
27456,0.001221,172.31.36.0-255,66,68771,8,163066
27457,0.001276,172.217.194.0-255,766,69537,8,163066
27458,0.001291,172.217.194.0-255,1484,71021,8,163066
27459,0.001294,172.31.36.0-255,66,71087,8,163066
27460,0.001299,172.217.194.0-255,2902,73989,8,163066
27461,0.001302,172.31.36.0-255,66,74055,8,163066
27462,0.001332,172.217.194.0-255,5738,79793,8,163066
27463,0.001336,172.31.36.0-255,66,79859,8,163066
27464,0.001391,172.31.36.0-255,66,79925,8,163066
27465,0.001399,172.217.194.0-255,7156,87081,8,163066
27466,0.001401,172.31.36.0-255,66,87147,8,163066
27467,0.001431,172.217.194.0-255,3602,90749,8,163066
27468,0.001434,172.31.36.0-255,66,90815,8,163066
27469,0.001492,172.217.194.0-255,1484,92299,8,163066
27470,0.001497,172.217.194.0-255,1484,93783,8,163066
27471,0.0015,172.31.36.0-255,66,93849,8,163066
27472,0.001531,172.217.194.0-255,1484,95333,8,163066
27473,0.001537,172.217.194.0-255,5738,101071,8,163066
27474,0.001539,172.31.36.0-255,66,101137,8,163066
27475,0.001577,172.31.36.0-255,66,101203,8,163066
27476,0.001592,172.31.36.0-255,66,101269,8,163066
27477,0.001627,172.31.36.0-255,66,101335,8,163066
27478,0.001665,172.31.36.0-255,66,101401,8,163066
27479,0.001667,172.217.194.0-255,1484,102885,8,163066
27480,0.001704,172.31.36.0-255,66,102951,8,163066
27481,0.001716,172.31.36.0-255,66,103017,8,163066
27482,0.001752,172.217.194.0-255,2902,105919,8,163066
27483,0.001754,172.31.36.0-255,66,105985,8,163066
27484,0.001776,172.31.36.0-255,66,106051,8,163066
27485,0.001787,172.31.36.0-255,66,106117,8,163066
27486,0.00185,172.31.36.0-255,66,106183,8,163066
27487,0.001853,172.217.194.0-255,1484,107667,8,163066
27488,0.001857,172.217.194.0-255,2902,110569,8,163066
27489,0.001859,172.31.36.0-255,66,110635,8,163066
27490,0.001865,172.217.194.0-255,5738,116373,8,163066
27491,0.001867,172.31.36.0-255,66,116439,8,163066
27492,0.001885,172.31.36.0-255,66,116505,8,163066
27493,0.001895,172.31.36.0-255,66,116571,8,163066
27494,0.001957,172.217.194.0-255,766,117337,8,163066
27495,0.00196,172.217.194.0-255,1484,118821,8,163066
27496,0.001962,172.31.36.0-255,66,118887,8,163066
27497,0.001968,172.217.194.0-255,4320,123207,8,163066
27498,0.00197,172.31.36.0-255,66,123273,8,163066
27499,0.001975,172.217.194.0-255,4320,127593,8,163066
27500,0.001977,172.31.36.0-255,66,127659,8,163066
27501,0.001997,172.217.194.0-255,5738,133397,8,163066
27502,0.001999,172.31.36.0-255,66,133463,8,163066
27503,0.002014,172.31.36.0-255,66,133529,8,163066
27504,0.002017,172.217.194.0-255,1484,135013,8,163066
27505,0.00204,172.217.194.0-255,5020,140033,8,163066
27506,0.002042,172.31.36.0-255,66,140099,8,163066
27507,0.002053,172.217.194.0-255,7156,147255,8,163066
27508,0.002055,172.31.36.0-255,66,147321,8,163066
27509,0.00206,172.217.194.0-255,4320,151641,8,163066
27510,0.002062,172.31.36.0-255,66,151707,8,163066
27511,0.002102,172.31.36.0-255,66,151773,8,163066
27512,0.002119,172.31.36.0-255,66,151839,8,163066
27513,0.004148,172.217.194.0-255,5738,157577,8,163066
27514,0.004154,172.31.36.0-255,66,157643,8,163066
27515,0.006194,172.217.194.0-255,3130,160773,8,163066
27516,0.006199,172.31.36.0-255,66,160839,8,163066
27517,0.007634,172.31.36.0-255,105,160944,8,163066
27518,0.009646,172.217.194.0-255,66,161010,8,163066
27519,0.036153,172.31.36.0-255,176,161186,8,163066
27520,0.036185,172.31.36.0-255,1111,162297,8,163066
27521,0.036215,172.31.36.0-255,571,162868,8,163066
27522,0.037706,104.244.42.0-255,66,162934,8,163066
27523,0.037831,104.244.42.0-255,66,163000,8,163066
27524,0.037834,104.244.42.0-255,66,163066,8,163066
27525,0.0,74.125.68.0-255,146,146,8,287714
27526,2.3e-05,172.31.36.0-255,66,212,8,287714
27527,3.1e-05,74.125.68.0-255,1484,1696,8,287714
27528,3.5e-05,172.31.36.0-255,66,1762,8,287714
27529,4.9e-05,74.125.68.0-255,2902,4664,8,287714
27530,5.2e-05,172.31.36.0-255,66,4730,8,287714
27531,5.8e-05,74.125.68.0-255,4320,9050,8,287714
27532,6.1e-05,172.31.36.0-255,66,9116,8,287714
27533,6.6e-05,74.125.68.0-255,2902,12018,8,287714
27534,6.9e-05,172.31.36.0-255,66,12084,8,287714
27535,0.000112,74.125.68.0-255,6307,18391,8,287714
27536,0.000116,172.31.36.0-255,66,18457,8,287714
27537,0.000119,74.125.68.0-255,1484,19941,8,287714
27538,0.000122,172.31.36.0-255,66,20007,8,287714
27539,0.000156,74.125.68.0-255,5738,25745,8,287714
27540,0.000158,172.31.36.0-255,66,25811,8,287714
27541,0.000184,74.125.68.0-255,5379,31190,8,287714
27542,0.000187,172.31.36.0-255,66,31256,8,287714
27543,0.000383,74.125.68.0-255,1484,32740,8,287714
27544,0.00039,172.31.36.0-255,66,32806,8,287714
27545,0.000396,74.125.68.0-255,2902,35708,8,287714
27546,0.000398,172.31.36.0-255,66,35774,8,287714
27547,0.000433,74.125.68.0-255,4320,40094,8,287714
27548,0.000437,172.31.36.0-255,66,40160,8,287714
27549,0.000442,74.125.68.0-255,2902,43062,8,287714
27550,0.000444,172.31.36.0-255,66,43128,8,287714
27551,0.000468,74.125.68.0-255,2902,46030,8,287714
27552,0.000472,172.31.36.0-255,66,46096,8,287714
27553,0.00048,74.125.68.0-255,5738,51834,8,287714
27554,0.000483,172.31.36.0-255,66,51900,8,287714
27555,0.00052,74.125.68.0-255,5738,57638,8,287714
27556,0.000524,172.31.36.0-255,66,57704,8,287714
27557,0.000547,74.125.68.0-255,1484,59188,8,287714
27558,0.000577,74.125.68.0-255,2902,62090,8,287714
27559,0.00058,172.31.36.0-255,66,62156,8,287714
27560,0.000608,74.125.68.0-255,2902,65058,8,287714
27561,0.00061,172.31.36.0-255,66,65124,8,287714
27562,0.000614,74.125.68.0-255,766,65890,8,287714
27563,0.000774,74.125.68.0-255,397,66287,8,287714
27564,0.000814,74.125.68.0-255,113,66400,8,287714
27565,0.001351,172.31.36.0-255,66,66466,8,287714
27566,0.001809,74.125.68.0-255,1484,67950,8,287714
27567,0.001828,74.125.68.0-255,1484,69434,8,287714
27568,0.001832,172.31.36.0-255,66,69500,8,287714
27569,0.001858,74.125.68.0-255,1484,70984,8,287714
27570,0.001863,74.125.68.0-255,4320,75304,8,287714
27571,0.001865,172.31.36.0-255,66,75370,8,287714
27572,0.001888,74.125.68.0-255,1484,76854,8,287714
27573,0.001902,74.125.68.0-255,2902,79756,8,287714
27574,0.001904,172.31.36.0-255,66,79822,8,287714
27575,0.001949,74.125.68.0-255,2902,82724,8,287714
27576,0.001951,172.31.36.0-255,66,82790,8,287714
27577,0.001988,74.125.68.0-255,1484,84274,8,287714
27578,0.001992,74.125.68.0-255,2902,87176,8,287714
27579,0.001994,172.31.36.0-255,66,87242,8,287714
27580,0.003895,74.125.68.0-255,1484,88726,8,287714
27581,0.00394,74.125.68.0-255,4320,93046,8,287714
27582,0.003946,172.31.36.0-255,66,93112,8,287714
27583,0.00591,74.125.68.0-255,5738,98850,8,287714
27584,0.005917,172.31.36.0-255,66,98916,8,287714
27585,0.007872,74.125.68.0-255,5738,104654,8,287714
27586,0.00788,172.31.36.0-255,66,104720,8,287714
27587,0.009824,74.125.68.0-255,5738,110458,8,287714
27588,0.009832,172.31.36.0-255,66,110524,8,287714
27589,0.011782,74.125.68.0-255,5738,116262,8,287714
27590,0.011795,172.31.36.0-255,66,116328,8,287714
27591,0.013751,74.125.68.0-255,5738,122066,8,287714
27592,0.01376,172.31.36.0-255,66,122132,8,287714
27593,0.0158,74.125.68.0-255,5738,127870,8,287714
27594,0.015818,172.31.36.0-255,66,127936,8,287714
27595,0.017776,74.125.68.0-255,5738,133674,8,287714
27596,0.017787,172.31.36.0-255,66,133740,8,287714
27597,0.019747,74.125.68.0-255,5738,139478,8,287714
27598,0.019755,172.31.36.0-255,66,139544,8,287714
27599,0.021729,74.125.68.0-255,5738,145282,8,287714
27600,0.021737,172.31.36.0-255,66,145348,8,287714
27601,0.023693,74.125.68.0-255,5738,151086,8,287714
27602,0.0237,172.31.36.0-255,66,151152,8,287714
27603,0.025649,74.125.68.0-255,5738,156890,8,287714
27604,0.025656,172.31.36.0-255,66,156956,8,287714
27605,0.026124,172.31.36.0-255,172,157128,8,287714
27606,0.026153,172.31.36.0-255,1112,158240,8,287714
27607,0.026201,172.31.36.0-255,1514,159754,8,287714
27608,0.026203,172.31.36.0-255,1294,161048,8,287714
27609,0.027599,74.125.68.0-255,5738,166786,8,287714
27610,0.027606,172.31.36.0-255,66,166852,8,287714
27611,0.027654,104.244.42.0-255,66,166918,8,287714
27612,0.027709,104.244.42.0-255,66,166984,8,287714
27613,0.027758,104.244.42.0-255,66,167050,8,287714
27614,0.029547,74.125.68.0-255,5738,172788,8,287714
27615,0.029552,172.31.36.0-255,66,172854,8,287714
27616,0.031501,74.125.68.0-255,5738,178592,8,287714
27617,0.031506,172.31.36.0-255,66,178658,8,287714
27618,0.033442,74.125.68.0-255,5738,184396,8,287714
27619,0.033448,172.31.36.0-255,66,184462,8,287714
27620,0.035383,74.125.68.0-255,4320,188782,8,287714
27621,0.035389,172.31.36.0-255,66,188848,8,287714
27622,0.03542,74.125.68.0-255,1484,190332,8,287714
27623,0.03733,74.125.68.0-255,4320,194652,8,287714
27624,0.037336,172.31.36.0-255,66,194718,8,287714
27625,0.03927,74.125.68.0-255,5738,200456,8,287714
27626,0.039276,172.31.36.0-255,66,200522,8,287714
27627,0.041218,74.125.68.0-255,5738,206260,8,287714
27628,0.041224,172.31.36.0-255,66,206326,8,287714
27629,0.043177,74.125.68.0-255,5738,212064,8,287714
27630,0.043183,172.31.36.0-255,66,212130,8,287714
27631,0.045128,74.125.68.0-255,5738,217868,8,287714
27632,0.045134,172.31.36.0-255,66,217934,8,287714
27633,0.047086,74.125.68.0-255,5738,223672,8,287714
27634,0.047096,172.31.36.0-255,66,223738,8,287714
27635,0.04905,74.125.68.0-255,5738,229476,8,287714
27636,0.049055,172.31.36.0-255,66,229542,8,287714
27637,0.050996,74.125.68.0-255,5738,235280,8,287714
27638,0.051001,172.31.36.0-255,66,235346,8,287714
27639,0.05296,74.125.68.0-255,5738,241084,8,287714
27640,0.052965,172.31.36.0-255,66,241150,8,287714
27641,0.054911,74.125.68.0-255,5738,246888,8,287714
27642,0.054916,172.31.36.0-255,66,246954,8,287714
27643,0.056887,74.125.68.0-255,5738,252692,8,287714
27644,0.056894,172.31.36.0-255,66,252758,8,287714
27645,0.058871,74.125.68.0-255,5738,258496,8,287714
27646,0.058877,172.31.36.0-255,66,258562,8,287714
27647,0.060821,74.125.68.0-255,5738,264300,8,287714
27648,0.060828,172.31.36.0-255,66,264366,8,287714
27649,0.062774,74.125.68.0-255,5738,270104,8,287714
27650,0.06278,172.31.36.0-255,66,270170,8,287714
27651,0.06472,74.125.68.0-255,5738,275908,8,287714
27652,0.064726,172.31.36.0-255,66,275974,8,287714
27653,0.066669,74.125.68.0-255,5738,281712,8,287714
27654,0.066675,172.31.36.0-255,66,281778,8,287714
27655,0.068619,74.125.68.0-255,2902,284680,8,287714
27656,0.068624,172.31.36.0-255,66,284746,8,287714
27657,0.068658,74.125.68.0-255,2902,287648,8,287714
27658,0.068662,172.31.36.0-255,66,287714,8,287714
27659,0.0,74.125.130.0-255,296,296,8,358326
27660,2.5e-05,172.31.36.0-255,66,362,8,358326
27661,3.2e-05,74.125.130.0-255,1484,1846,8,358326
27662,3.6e-05,172.31.36.0-255,66,1912,8,358326
27663,4.2e-05,74.125.130.0-255,4320,6232,8,358326
27664,4.5e-05,172.31.36.0-255,66,6298,8,358326
27665,4.8e-05,74.125.130.0-255,1484,7782,8,358326
27666,5.1e-05,172.31.36.0-255,66,7848,8,358326
27667,5.5e-05,74.125.130.0-255,1484,9332,8,358326
27668,5.7e-05,172.31.36.0-255,66,9398,8,358326
27669,8.3e-05,74.125.130.0-255,1484,10882,8,358326
27670,8.6e-05,172.31.36.0-255,66,10948,8,358326
27671,9.3e-05,74.125.130.0-255,4683,15631,8,358326
27672,9.5e-05,172.31.36.0-255,66,15697,8,358326
27673,9.8e-05,74.125.130.0-255,1484,17181,8,358326
27674,0.0001,172.31.36.0-255,66,17247,8,358326
27675,0.000127,74.125.130.0-255,4320,21567,8,358326
27676,0.00013,172.31.36.0-255,66,21633,8,358326
27677,0.000161,172.31.36.0-255,66,21699,8,358326
27678,0.000277,74.125.130.0-255,1484,23183,8,358326
27679,0.000281,172.31.36.0-255,66,23249,8,358326
27680,0.000287,74.125.130.0-255,2902,26151,8,358326
27681,0.000289,172.31.36.0-255,66,26217,8,358326
27682,0.000319,74.125.130.0-255,4320,30537,8,358326
27683,0.000323,172.31.36.0-255,66,30603,8,358326
27684,0.00033,74.125.130.0-255,5738,36341,8,358326
27685,0.000332,172.31.36.0-255,66,36407,8,358326
27686,0.000353,74.125.130.0-255,2902,39309,8,358326
27687,0.000356,172.31.36.0-255,66,39375,8,358326
27688,0.000359,74.125.130.0-255,1484,40859,8,358326
27689,0.000362,172.31.36.0-255,66,40925,8,358326
27690,0.000368,74.125.130.0-255,2902,43827,8,358326
27691,0.000384,74.125.130.0-255,1484,45311,8,358326
27692,0.000397,74.125.130.0-255,2902,48213,8,358326
27693,0.000403,74.125.130.0-255,5738,53951,8,358326
27694,0.000444,74.125.130.0-255,2184,56135,8,358326
27695,0.000495,74.125.130.0-255,376,56511,8,358326
27696,0.00052,74.125.130.0-255,367,56878,8,358326
27697,0.000562,172.31.36.0-255,66,56944,8,358326
27698,0.000606,74.125.130.0-255,1484,58428,8,358326
27699,0.000625,74.125.130.0-255,2902,61330,8,358326
27700,0.000641,74.125.130.0-255,4320,65650,8,358326
27701,0.000669,74.125.130.0-255,5738,71388,8,358326
27702,0.000693,74.125.130.0-255,4320,75708,8,358326
27703,0.000715,74.125.130.0-255,4320,80028,8,358326
27704,0.000718,74.125.130.0-255,1484,81512,8,358326
27705,0.000744,74.125.130.0-255,766,82278,8,358326
27706,0.000861,172.31.36.0-255,66,82344,8,358326
27707,0.001203,74.125.130.0-255,1484,83828,8,358326
27708,0.001224,74.125.130.0-255,2902,86730,8,358326
27709,0.001241,172.31.36.0-255,66,86796,8,358326
27710,0.001252,74.125.130.0-255,5738,92534,8,358326
27711,0.001257,74.125.130.0-255,2902,95436,8,358326
27712,0.001268,172.31.36.0-255,66,95502,8,358326
27713,0.001295,74.125.130.0-255,2902,98404,8,358326
27714,0.001299,172.31.36.0-255,66,98470,8,358326
27715,0.001324,74.125.130.0-255,7156,105626,8,358326
27716,0.001359,172.31.36.0-255,66,105692,8,358326
27717,0.001388,172.31.36.0-255,66,105758,8,358326
27718,0.001434,74.125.130.0-255,1484,107242,8,358326
27719,0.00144,74.125.130.0-255,2902,110144,8,358326
27720,0.001444,74.125.130.0-255,2902,113046,8,358326
27721,0.001461,172.31.36.0-255,66,113112,8,358326
27722,0.001472,74.125.130.0-255,2902,116014,8,358326
27723,0.001479,74.125.130.0-255,7156,123170,8,358326
27724,0.001503,74.125.130.0-255,4320,127490,8,358326
27725,0.00153,74.125.130.0-255,5738,133228,8,358326
27726,0.001545,172.31.36.0-255,66,133294,8,358326
27727,0.001548,74.125.130.0-255,1484,134778,8,358326
27728,0.00157,74.125.130.0-255,5020,139798,8,358326
27729,0.001578,172.31.36.0-255,66,139864,8,358326
27730,0.001595,74.125.130.0-255,7156,147020,8,358326
27731,0.001612,172.31.36.0-255,66,147086,8,358326
27732,0.001619,74.125.130.0-255,5738,152824,8,358326
27733,0.001626,74.125.130.0-255,7156,159980,8,358326
27734,0.001638,172.31.36.0-255,66,160046,8,358326
27735,0.001665,74.125.130.0-255,7156,167202,8,358326
27736,0.001671,172.31.36.0-255,66,167268,8,358326
27737,0.001703,74.125.130.0-255,1484,168752,8,358326
27738,0.001722,74.125.130.0-255,2902,171654,8,358326
27739,0.001739,172.31.36.0-255,66,171720,8,358326
27740,0.00175,74.125.130.0-255,2184,173904,8,358326
27741,0.001768,172.31.36.0-255,66,173970,8,358326
27742,0.001839,74.125.130.0-255,1484,175454,8,358326
27743,0.001858,74.125.130.0-255,2902,178356,8,358326
27744,0.00187,172.31.36.0-255,66,178422,8,358326
27745,0.001888,74.125.130.0-255,5738,184160,8,358326
27746,0.001909,74.125.130.0-255,1484,185644,8,358326
27747,0.001912,172.31.36.0-255,66,185710,8,358326
27748,0.001961,74.125.130.0-255,1484,187194,8,358326
27749,0.001966,172.31.36.0-255,66,187260,8,358326
27750,0.002003,74.125.130.0-255,1484,188744,8,358326
27751,0.002035,74.125.130.0-255,2902,191646,8,358326
27752,0.002053,74.125.130.0-255,1484,193130,8,358326
27753,0.002061,172.31.36.0-255,66,193196,8,358326
27754,0.002102,74.125.130.0-255,2902,196098,8,358326
27755,0.002115,74.125.130.0-255,4320,200418,8,358326
27756,0.002123,172.31.36.0-255,66,200484,8,358326
27757,0.00216,74.125.130.0-255,2902,203386,8,358326
27758,0.002169,172.31.36.0-255,66,203452,8,358326
27759,0.002181,74.125.130.0-255,5020,208472,8,358326
27760,0.002206,172.31.36.0-255,66,208538,8,358326
27761,0.002299,74.125.130.0-255,1484,210022,8,358326
27762,0.002314,74.125.130.0-255,2902,212924,8,358326
27763,0.002317,172.31.36.0-255,66,212990,8,358326
27764,0.002334,74.125.130.0-255,1484,214474,8,358326
27765,0.002351,74.125.130.0-255,2902,217376,8,358326
27766,0.002364,172.31.36.0-255,66,217442,8,358326
27767,0.002379,74.125.130.0-255,5738,223180,8,358326
27768,0.002387,74.125.130.0-255,1484,224664,8,358326
27769,0.00239,74.125.130.0-255,1484,226148,8,358326
27770,0.002393,74.125.130.0-255,1484,227632,8,358326
27771,0.002411,74.125.130.0-255,1484,229116,8,358326
27772,0.002424,172.31.36.0-255,66,229182,8,358326
27773,0.002433,172.31.36.0-255,78,229260,8,358326
27774,0.002439,74.125.130.0-255,3602,232862,8,358326
27775,0.002448,172.31.36.0-255,66,232928,8,358326
27776,0.002636,74.125.130.0-255,1484,234412,8,358326
27777,0.002641,74.125.130.0-255,2902,237314,8,358326
27778,0.002644,172.31.36.0-255,66,237380,8,358326
27779,0.002649,74.125.130.0-255,2902,240282,8,358326
27780,0.002665,74.125.130.0-255,1484,241766,8,358326
27781,0.002678,74.125.130.0-255,2902,244668,8,358326
27782,0.00268,172.31.36.0-255,66,244734,8,358326
27783,0.002686,172.31.36.0-255,66,244800,8,358326
27784,0.002702,74.125.130.0-255,4320,249120,8,358326
27785,0.002718,74.125.130.0-255,4320,253440,8,358326
27786,0.002726,74.125.130.0-255,7156,260596,8,358326
27787,0.002735,172.31.36.0-255,66,260662,8,358326
27788,0.00277,74.125.130.0-255,6438,267100,8,358326
27789,0.002791,172.31.36.0-255,66,267166,8,358326
27790,0.003118,74.125.130.0-255,1484,268650,8,358326
27791,0.003159,74.125.130.0-255,1484,270134,8,358326
27792,0.003162,172.31.36.0-255,66,270200,8,358326
27793,0.003168,74.125.130.0-255,4320,274520,8,358326
27794,0.003186,74.125.130.0-255,4320,278840,8,358326
27795,0.003197,74.125.130.0-255,1484,280324,8,358326
27796,0.003211,74.125.130.0-255,2902,283226,8,358326
27797,0.003215,172.31.36.0-255,66,283292,8,358326
27798,0.00322,172.31.36.0-255,66,283358,8,358326
27799,0.00323,74.125.130.0-255,4320,287678,8,358326
27800,0.003252,74.125.130.0-255,2902,290580,8,358326
27801,0.003265,172.31.36.0-255,66,290646,8,358326
27802,0.003275,172.31.36.0-255,66,290712,8,358326
27803,0.003278,74.125.130.0-255,1484,292196,8,358326
27804,0.003291,74.125.130.0-255,2902,295098,8,358326
27805,0.003316,74.125.130.0-255,5738,300836,8,358326
27806,0.003318,74.125.130.0-255,1484,302320,8,358326
27807,0.003321,74.125.130.0-255,1484,303804,8,358326
27808,0.003324,172.31.36.0-255,66,303870,8,358326
27809,0.003334,74.125.130.0-255,1484,305354,8,358326
27810,0.003339,172.31.36.0-255,66,305420,8,358326
27811,0.003348,74.125.130.0-255,2902,308322,8,358326
27812,0.003359,74.125.130.0-255,2902,311224,8,358326
27813,0.003377,172.31.36.0-255,66,311290,8,358326
27814,0.003393,74.125.130.0-255,2902,314192,8,358326
27815,0.003406,74.125.130.0-255,2902,317094,8,358326
27816,0.00342,74.125.130.0-255,5738,322832,8,358326
27817,0.003427,74.125.130.0-255,4320,327152,8,358326
27818,0.003448,74.125.130.0-255,2184,329336,8,358326
27819,0.003456,74.125.130.0-255,7156,336492,8,358326
27820,0.003458,74.125.130.0-255,1484,337976,8,358326
27821,0.003461,172.31.36.0-255,66,338042,8,358326
27822,0.003469,172.31.36.0-255,66,338108,8,358326
27823,0.003508,172.31.36.0-255,66,338174,8,358326
27824,0.003519,74.125.130.0-255,4320,342494,8,358326
27825,0.003535,74.125.130.0-255,5020,347514,8,358326
27826,0.003537,74.125.130.0-255,1484,348998,8,358326
27827,0.003555,74.125.130.0-255,2902,351900,8,358326
27828,0.00356,74.125.130.0-255,1654,353554,8,358326
27829,0.003573,172.31.36.0-255,66,353620,8,358326
27830,0.00364,74.125.130.0-255,105,353725,8,358326
27831,0.005403,172.31.36.0-255,66,353791,8,358326
27832,0.013593,172.31.36.0-255,105,353896,8,358326
27833,0.015878,74.125.130.0-255,66,353962,8,358326
27834,0.045372,172.31.36.0-255,172,354134,8,358326
27835,0.045407,172.31.36.0-255,1109,355243,8,358326
27836,0.045549,172.31.36.0-255,1514,356757,8,358326
27837,0.045551,172.31.36.0-255,1371,358128,8,358326
27838,0.046925,104.244.42.0-255,66,358194,8,358326
27839,0.046958,104.244.42.0-255,66,358260,8,358326
27840,0.047131,104.244.42.0-255,66,358326,8,358326
27841,0.0,74.125.24.0-255,153,153,8,284918
27842,3e-05,172.31.36.0-255,66,219,8,284918
27843,3.7e-05,74.125.24.0-255,1484,1703,8,284918
27844,4.1e-05,172.31.36.0-255,66,1769,8,284918
27845,4.6e-05,74.125.24.0-255,2902,4671,8,284918
27846,4.9e-05,172.31.36.0-255,66,4737,8,284918
27847,8.3e-05,74.125.24.0-255,4320,9057,8,284918
27848,8.6e-05,172.31.36.0-255,66,9123,8,284918
27849,0.000102,74.125.24.0-255,1484,10607,8,284918
27850,0.000105,172.31.36.0-255,66,10673,8,284918
27851,0.00011,74.125.24.0-255,3449,14122,8,284918
27852,0.000112,172.31.36.0-255,66,14188,8,284918
27853,0.000218,74.125.24.0-255,1484,15672,8,284918
27854,0.000222,172.31.36.0-255,66,15738,8,284918
27855,0.000229,74.125.24.0-255,2902,18640,8,284918
27856,0.000232,172.31.36.0-255,66,18706,8,284918
27857,0.000236,74.125.24.0-255,1484,20190,8,284918
27858,0.000238,172.31.36.0-255,66,20256,8,284918
27859,0.00026,74.125.24.0-255,1484,21740,8,284918
27860,0.000262,172.31.36.0-255,66,21806,8,284918
27861,0.00028,74.125.24.0-255,4320,26126,8,284918
27862,0.000283,172.31.36.0-255,66,26192,8,284918
27863,0.000287,74.125.24.0-255,1484,27676,8,284918
27864,0.000289,172.31.36.0-255,66,27742,8,284918
27865,0.000317,74.125.24.0-255,3961,31703,8,284918
27866,0.00032,172.31.36.0-255,66,31769,8,284918
27867,0.000335,74.125.24.0-255,4320,36089,8,284918
27868,0.000339,172.31.36.0-255,66,36155,8,284918
27869,0.000367,74.125.24.0-255,7156,43311,8,284918
27870,0.000371,172.31.36.0-255,66,43377,8,284918
27871,0.000378,74.125.24.0-255,5379,48756,8,284918
27872,0.000381,172.31.36.0-255,66,48822,8,284918
27873,0.000436,74.125.24.0-255,1484,50306,8,284918
27874,0.000439,74.125.24.0-255,1484,51790,8,284918
27875,0.000445,172.31.36.0-255,66,51856,8,284918
27876,0.000454,74.125.24.0-255,1484,53340,8,284918
27877,0.000469,74.125.24.0-255,2902,56242,8,284918
27878,0.000475,172.31.36.0-255,66,56308,8,284918
27879,0.000489,74.125.24.0-255,2902,59210,8,284918
27880,0.000493,172.31.36.0-255,66,59276,8,284918
27881,0.000513,74.125.24.0-255,6797,66073,8,284918
27882,0.000522,172.31.36.0-255,66,66139,8,284918
27883,0.000528,74.125.24.0-255,677,66816,8,284918
27884,0.000619,74.125.24.0-255,1484,68300,8,284918
27885,0.000626,172.31.36.0-255,66,68366,8,284918
27886,0.000635,74.125.24.0-255,2902,71268,8,284918
27887,0.000646,172.31.36.0-255,66,71334,8,284918
27888,0.000655,74.125.24.0-255,1484,72818,8,284918
27889,0.00066,74.125.24.0-255,2902,75720,8,284918
27890,0.000662,74.125.24.0-255,1484,77204,8,284918
27891,0.000665,172.31.36.0-255,66,77270,8,284918
27892,0.000685,74.125.24.0-255,4320,81590,8,284918
27893,0.000694,172.31.36.0-255,66,81656,8,284918
27894,0.000698,74.125.24.0-255,2543,84199,8,284918
27895,0.000708,172.31.36.0-255,66,84265,8,284918
27896,0.000842,74.125.24.0-255,1484,85749,8,284918
27897,0.000886,74.125.24.0-255,2902,88651,8,284918
27898,0.00089,172.31.36.0-255,66,88717,8,284918
27899,0.000896,74.125.24.0-255,4320,93037,8,284918
27900,0.000906,172.31.36.0-255,66,93103,8,284918
27901,0.000922,172.31.36.0-255,66,93169,8,284918
27902,0.001146,74.125.24.0-255,1484,94653,8,284918
27903,0.001163,74.125.24.0-255,2902,97555,8,284918
27904,0.001167,172.31.36.0-255,66,97621,8,284918
27905,0.001189,74.125.24.0-255,5738,103359,8,284918
27906,0.0012,172.31.36.0-255,66,103425,8,284918
27907,0.001215,74.125.24.0-255,2902,106327,8,284918
27908,0.001222,172.31.36.0-255,66,106393,8,284918
27909,0.001241,74.125.24.0-255,7156,113549,8,284918
27910,0.001248,172.31.36.0-255,66,113615,8,284918
27911,0.001256,74.125.24.0-255,2184,115799,8,284918
27912,0.001265,172.31.36.0-255,66,115865,8,284918
27913,0.001376,74.125.24.0-255,1484,117349,8,284918
27914,0.00138,74.125.24.0-255,1484,118833,8,284918
27915,0.001384,172.31.36.0-255,66,118899,8,284918
27916,0.001402,74.125.24.0-255,1484,120383,8,284918
27917,0.001409,74.125.24.0-255,5738,126121,8,284918
27918,0.001418,74.125.24.0-255,1484,127605,8,284918
27919,0.001423,172.31.36.0-255,66,127671,8,284918
27920,0.00143,74.125.24.0-255,2902,130573,8,284918
27921,0.001437,172.31.36.0-255,66,130639,8,284918
27922,0.001459,74.125.24.0-255,7156,137795,8,284918
27923,0.001467,172.31.36.0-255,66,137861,8,284918
27924,0.00148,172.31.36.0-255,66,137927,8,284918
27925,0.001629,74.125.24.0-255,1484,139411,8,284918
27926,0.001644,74.125.24.0-255,2902,142313,8,284918
27927,0.001648,74.125.24.0-255,2902,145215,8,284918
27928,0.001649,172.31.36.0-255,66,145281,8,284918
27929,0.001664,172.31.36.0-255,66,145347,8,284918
27930,0.00167,74.125.24.0-255,2902,148249,8,284918
27931,0.001675,74.125.24.0-255,4320,152569,8,284918
27932,0.001681,172.31.36.0-255,66,152635,8,284918
27933,0.001707,74.125.24.0-255,5738,158373,8,284918
27934,0.001715,74.125.24.0-255,5738,164111,8,284918
27935,0.001717,172.31.36.0-255,66,164177,8,284918
27936,0.00172,74.125.24.0-255,4320,168497,8,284918
27937,0.001722,172.31.36.0-255,66,168563,8,284918
27938,0.001736,172.31.36.0-255,66,168629,8,284918
27939,0.001737,74.125.24.0-255,2902,171531,8,284918
27940,0.001741,74.125.24.0-255,766,172297,8,284918
27941,0.001749,172.31.36.0-255,66,172363,8,284918
27942,0.002002,74.125.24.0-255,1484,173847,8,284918
27943,0.002007,74.125.24.0-255,2902,176749,8,284918
27944,0.002011,172.31.36.0-255,66,176815,8,284918
27945,0.002015,74.125.24.0-255,1484,178299,8,284918
27946,0.002053,74.125.24.0-255,7156,185455,8,284918
27947,0.002061,172.31.36.0-255,66,185521,8,284918
27948,0.002069,74.125.24.0-255,1484,187005,8,284918
27949,0.002076,74.125.24.0-255,7156,194161,8,284918
27950,0.002092,74.125.24.0-255,1484,195645,8,284918
27951,0.002097,172.31.36.0-255,66,195711,8,284918
27952,0.002114,74.125.24.0-255,766,196477,8,284918
27953,0.002122,172.31.36.0-255,66,196543,8,284918
27954,0.002131,74.125.24.0-255,2902,199445,8,284918
27955,0.002136,172.31.36.0-255,66,199511,8,284918
27956,0.002149,74.125.24.0-255,5738,205249,8,284918
27957,0.002153,172.31.36.0-255,66,205315,8,284918
27958,0.002189,74.125.24.0-255,4320,209635,8,284918
27959,0.002212,74.125.24.0-255,5738,215373,8,284918
27960,0.002249,74.125.24.0-255,6438,221811,8,284918
27961,0.002253,74.125.24.0-255,1484,223295,8,284918
27962,0.002299,74.125.24.0-255,1484,224779,8,284918
27963,0.002303,74.125.24.0-255,1484,226263,8,284918
27964,0.002306,74.125.24.0-255,1484,227747,8,284918
27965,0.002321,74.125.24.0-255,2902,230649,8,284918
27966,0.002325,74.125.24.0-255,1484,232133,8,284918
27967,0.002336,74.125.24.0-255,2902,235035,8,284918
27968,0.002356,74.125.24.0-255,2902,237937,8,284918
27969,0.002376,74.125.24.0-255,7156,245093,8,284918
27970,0.002379,74.125.24.0-255,1484,246577,8,284918
27971,0.002423,74.125.24.0-255,2902,249479,8,284918
27972,0.002468,74.125.24.0-255,2902,252381,8,284918
27973,0.002516,74.125.24.0-255,1484,253865,8,284918
27974,0.002538,74.125.24.0-255,4320,258185,8,284918
27975,0.002585,74.125.24.0-255,2902,261087,8,284918
27976,0.002602,74.125.24.0-255,7156,268243,8,284918
27977,0.002627,74.125.24.0-255,2902,271145,8,284918
27978,0.002639,74.125.24.0-255,2902,274047,8,284918
27979,0.002683,74.125.24.0-255,2902,276949,8,284918
27980,0.002698,74.125.24.0-255,1484,278433,8,284918
27981,0.002717,74.125.24.0-255,3235,281668,8,284918
27982,0.002763,74.125.24.0-255,105,281773,8,284918
27983,0.00874,172.31.36.0-255,66,281839,8,284918
27984,0.010237,172.31.36.0-255,105,281944,8,284918
27985,0.01223,74.125.24.0-255,66,282010,8,284918
27986,0.030085,172.31.36.0-255,172,282182,8,284918
27987,0.03014,172.31.36.0-255,1110,283292,8,284918
27988,0.030164,172.31.36.0-255,1428,284720,8,284918
27989,0.03163,104.244.42.0-255,66,284786,8,284918
27990,0.031674,104.244.42.0-255,66,284852,8,284918
27991,0.031732,104.244.42.0-255,66,284918,8,284918
27992,0.0,74.125.24.0-255,153,153,8,284428
27993,2.3e-05,172.31.36.0-255,66,219,8,284428
27994,3e-05,74.125.24.0-255,1484,1703,8,284428
27995,3.4e-05,172.31.36.0-255,66,1769,8,284428
27996,3.9e-05,74.125.24.0-255,2902,4671,8,284428
27997,4.2e-05,172.31.36.0-255,66,4737,8,284428
27998,4.9e-05,74.125.24.0-255,7156,11893,8,284428
27999,5.3e-05,172.31.36.0-255,66,11959,8,284428
28000,8.9e-05,74.125.24.0-255,2123,14082,8,284428
28001,9.1e-05,172.31.36.0-255,66,14148,8,284428
28002,0.000161,74.125.24.0-255,1484,15632,8,284428
28003,0.000164,172.31.36.0-255,66,15698,8,284428
28004,0.000169,74.125.24.0-255,2902,18600,8,284428
28005,0.000171,172.31.36.0-255,66,18666,8,284428
28006,0.00019,74.125.24.0-255,5738,24404,8,284428
28007,0.000192,172.31.36.0-255,66,24470,8,284428
28008,0.000224,74.125.24.0-255,4320,28790,8,284428
28009,0.000226,172.31.36.0-255,66,28856,8,284428
28010,0.000245,74.125.24.0-255,2543,31399,8,284428
28011,0.000247,172.31.36.0-255,66,31465,8,284428
28012,0.000399,74.125.24.0-255,1484,32949,8,284428
28013,0.000404,172.31.36.0-255,66,33015,8,284428
28014,0.000409,74.125.24.0-255,2902,35917,8,284428
28015,0.000411,172.31.36.0-255,66,35983,8,284428
28016,0.000427,74.125.24.0-255,4320,40303,8,284428
28017,0.000431,172.31.36.0-255,66,40369,8,284428
28018,0.000445,74.125.24.0-255,1484,41853,8,284428
28019,0.000447,172.31.36.0-255,66,41919,8,284428
28020,0.000492,172.31.36.0-255,66,41985,8,284428
28021,0.000506,172.31.36.0-255,66,42051,8,284428
28022,0.000509,74.125.24.0-255,138,42189,8,284428
28023,0.000535,74.125.24.0-255,350,42539,8,284428
28024,0.001026,172.31.36.0-255,66,42605,8,284428
28025,0.001059,74.125.24.0-255,1484,44089,8,284428
28026,0.001063,74.125.24.0-255,1484,45573,8,284428
28027,0.001076,74.125.24.0-255,1484,47057,8,284428
28028,0.001079,74.125.24.0-255,1484,48541,8,284428
28029,0.001092,74.125.24.0-255,4320,52861,8,284428
28030,0.001097,74.125.24.0-255,4320,57181,8,284428
28031,0.001151,74.125.24.0-255,5738,62919,8,284428
28032,0.001169,74.125.24.0-255,2184,65103,8,284428
28033,0.001177,172.31.36.0-255,66,65169,8,284428
28034,0.001655,74.125.24.0-255,1484,66653,8,284428
28035,0.001665,74.125.24.0-255,2902,69555,8,284428
28036,0.00167,172.31.36.0-255,66,69621,8,284428
28037,0.001678,74.125.24.0-255,5738,75359,8,284428
28038,0.001713,74.125.24.0-255,5738,81097,8,284428
28039,0.001729,74.125.24.0-255,2902,83999,8,284428
28040,0.001755,74.125.24.0-255,2184,86183,8,284428
28041,0.001879,74.125.24.0-255,1484,87667,8,284428
28042,0.001886,74.125.24.0-255,2902,90569,8,284428
28043,0.00189,74.125.24.0-255,2902,93471,8,284428
28044,0.00191,74.125.24.0-255,2902,96373,8,284428
28045,0.001926,74.125.24.0-255,4320,100693,8,284428
28046,0.00194,74.125.24.0-255,2902,103595,8,284428
28047,0.001953,74.125.24.0-255,2902,106497,8,284428
28048,0.00198,74.125.24.0-255,2902,109399,8,284428
28049,0.004317,172.31.36.0-255,66,109465,8,284428
28050,0.006404,74.125.24.0-255,5738,115203,8,284428
28051,0.006411,172.31.36.0-255,66,115269,8,284428
28052,0.008459,74.125.24.0-255,5738,121007,8,284428
28053,0.008653,172.31.36.0-255,66,121073,8,284428
28054,0.010743,74.125.24.0-255,5738,126811,8,284428
28055,0.010751,172.31.36.0-255,66,126877,8,284428
28056,0.012785,74.125.24.0-255,5738,132615,8,284428
28057,0.014297,172.31.36.0-255,66,132681,8,284428
28058,0.016415,74.125.24.0-255,5738,138419,8,284428
28059,0.016424,172.31.36.0-255,66,138485,8,284428
28060,0.018471,74.125.24.0-255,5738,144223,8,284428
28061,0.018478,172.31.36.0-255,66,144289,8,284428
28062,0.020537,74.125.24.0-255,5738,150027,8,284428
28063,0.020542,172.31.36.0-255,66,150093,8,284428
28064,0.022572,74.125.24.0-255,5738,155831,8,284428
28065,0.022578,172.31.36.0-255,66,155897,8,284428
28066,0.024661,74.125.24.0-255,5738,161635,8,284428
28067,0.024668,172.31.36.0-255,66,161701,8,284428
28068,0.025733,172.31.36.0-255,164,161865,8,284428
28069,0.025775,172.31.36.0-255,613,162478,8,284428
28070,0.026764,74.125.24.0-255,5738,168216,8,284428
28071,0.02677,172.31.36.0-255,66,168282,8,284428
28072,0.02796,104.244.42.0-255,66,168348,8,284428
28073,0.02884,74.125.24.0-255,5738,174086,8,284428
28074,0.028847,172.31.36.0-255,66,174152,8,284428
28075,0.030938,74.125.24.0-255,5738,179890,8,284428
28076,0.030948,172.31.36.0-255,66,179956,8,284428
28077,0.032988,74.125.24.0-255,5738,185694,8,284428
28078,0.032995,172.31.36.0-255,66,185760,8,284428
28079,0.035063,74.125.24.0-255,5738,191498,8,284428
28080,0.035069,172.31.36.0-255,66,191564,8,284428
28081,0.037149,74.125.24.0-255,5738,197302,8,284428
28082,0.037156,172.31.36.0-255,66,197368,8,284428
28083,0.039199,74.125.24.0-255,5738,203106,8,284428
28084,0.039208,172.31.36.0-255,66,203172,8,284428
28085,0.041239,74.125.24.0-255,5738,208910,8,284428
28086,0.041246,172.31.36.0-255,66,208976,8,284428
28087,0.0433,74.125.24.0-255,5738,214714,8,284428
28088,0.043307,172.31.36.0-255,66,214780,8,284428
28089,0.045385,74.125.24.0-255,5738,220518,8,284428
28090,0.045392,172.31.36.0-255,66,220584,8,284428
28091,0.047479,74.125.24.0-255,5738,226322,8,284428
28092,0.047494,172.31.36.0-255,66,226388,8,284428
28093,0.049572,74.125.24.0-255,5738,232126,8,284428
28094,0.049578,172.31.36.0-255,66,232192,8,284428
28095,0.051615,74.125.24.0-255,5738,237930,8,284428
28096,0.051626,172.31.36.0-255,66,237996,8,284428
28097,0.053684,74.125.24.0-255,5738,243734,8,284428
28098,0.053692,172.31.36.0-255,66,243800,8,284428
28099,0.055777,74.125.24.0-255,5738,249538,8,284428
28100,0.055784,172.31.36.0-255,66,249604,8,284428
28101,0.057807,74.125.24.0-255,5738,255342,8,284428
28102,0.057815,172.31.36.0-255,66,255408,8,284428
28103,0.059866,74.125.24.0-255,5738,261146,8,284428
28104,0.059873,172.31.36.0-255,66,261212,8,284428
28105,0.061918,74.125.24.0-255,5738,266950,8,284428
28106,0.061925,172.31.36.0-255,66,267016,8,284428
28107,0.063988,74.125.24.0-255,5738,272754,8,284428
28108,0.063998,172.31.36.0-255,66,272820,8,284428
28109,0.066082,74.125.24.0-255,5738,278558,8,284428
28110,0.066089,172.31.36.0-255,66,278624,8,284428
28111,0.06813,74.125.24.0-255,5738,284362,8,284428
28112,0.068136,172.31.36.0-255,66,284428,8,284428
28113,0.0,74.125.24.0-255,143,143,8,343611
28114,2.3e-05,172.31.36.0-255,66,209,8,343611
28115,2.9e-05,74.125.24.0-255,1484,1693,8,343611
28116,3.4e-05,172.31.36.0-255,66,1759,8,343611
28117,3.9e-05,74.125.24.0-255,2902,4661,8,343611
28118,5.1e-05,172.31.36.0-255,66,4727,8,343611
28119,5.5e-05,74.125.24.0-255,2902,7629,8,343611
28120,5.8e-05,172.31.36.0-255,66,7695,8,343611
28121,9.5e-05,74.125.24.0-255,6256,13951,8,343611
28122,9.8e-05,172.31.36.0-255,66,14017,8,343611
28123,0.000217,74.125.24.0-255,1484,15501,8,343611
28124,0.00022,172.31.36.0-255,66,15567,8,343611
28125,0.000249,74.125.24.0-255,2902,18469,8,343611
28126,0.000252,172.31.36.0-255,66,18535,8,343611
28127,0.000283,74.125.24.0-255,5738,24273,8,343611
28128,0.000285,172.31.36.0-255,66,24339,8,343611
28129,0.00029,74.125.24.0-255,4320,28659,8,343611
28130,0.000292,172.31.36.0-255,66,28725,8,343611
28131,0.000334,74.125.24.0-255,1484,30209,8,343611
28132,0.000337,172.31.36.0-255,66,30275,8,343611
28133,0.000371,172.31.36.0-255,66,30341,8,343611
28134,0.000401,172.31.36.0-255,66,30407,8,343611
28135,0.000463,74.125.24.0-255,1484,31891,8,343611
28136,0.000467,172.31.36.0-255,66,31957,8,343611
28137,0.000472,74.125.24.0-255,2902,34859,8,343611
28138,0.000474,172.31.36.0-255,66,34925,8,343611
28139,0.000503,74.125.24.0-255,2902,37827,8,343611
28140,0.000506,172.31.36.0-255,66,37893,8,343611
28141,0.000516,74.125.24.0-255,4320,42213,8,343611
28142,0.000519,172.31.36.0-255,66,42279,8,343611
28143,0.000554,74.125.24.0-255,5679,47958,8,343611
28144,0.000557,172.31.36.0-255,66,48024,8,343611
28145,0.000617,74.125.24.0-255,377,48401,8,343611
28146,0.000838,74.125.24.0-255,1484,49885,8,343611
28147,0.000842,172.31.36.0-255,66,49951,8,343611
28148,0.000847,74.125.24.0-255,2902,52853,8,343611
28149,0.000849,172.31.36.0-255,66,52919,8,343611
28150,0.000855,74.125.24.0-255,5738,58657,8,343611
28151,0.000857,172.31.36.0-255,66,58723,8,343611
28152,0.000891,74.125.24.0-255,7156,65879,8,343611
28153,0.000893,172.31.36.0-255,66,65945,8,343611
28154,0.000926,74.125.24.0-255,6797,72742,8,343611
28155,0.000932,74.125.24.0-255,4320,77062,8,343611
28156,0.000938,172.31.36.0-255,66,77128,8,343611
28157,0.000946,172.31.36.0-255,66,77194,8,343611
28158,0.000952,74.125.24.0-255,5379,82573,8,343611
28159,0.00096,172.31.36.0-255,66,82639,8,343611
28160,0.001355,74.125.24.0-255,1484,84123,8,343611
28161,0.001362,74.125.24.0-255,2902,87025,8,343611
28162,0.001365,172.31.36.0-255,66,87091,8,343611
28163,0.001397,74.125.24.0-255,5738,92829,8,343611
28164,0.001401,172.31.36.0-255,66,92895,8,343611
28165,0.001404,74.125.24.0-255,1484,94379,8,343611
28166,0.00142,172.31.36.0-255,66,94445,8,343611
28167,0.001489,172.31.36.0-255,66,94511,8,343611
28168,0.001634,74.125.24.0-255,1484,95995,8,343611
28169,0.001639,74.125.24.0-255,2902,98897,8,343611
28170,0.001643,172.31.36.0-255,66,98963,8,343611
28171,0.00168,74.125.24.0-255,5738,104701,8,343611
28172,0.001684,172.31.36.0-255,66,104767,8,343611
28173,0.001694,172.31.36.0-255,66,104833,8,343611
28174,0.001729,74.125.24.0-255,4320,109153,8,343611
28175,0.001733,172.31.36.0-255,66,109219,8,343611
28176,0.001738,74.125.24.0-255,5738,114957,8,343611
28177,0.00174,172.31.36.0-255,66,115023,8,343611
28178,0.001745,74.125.24.0-255,5020,120043,8,343611
28179,0.001747,172.31.36.0-255,66,120109,8,343611
28180,0.002033,74.125.24.0-255,1484,121593,8,343611
28181,0.002056,74.125.24.0-255,2902,124495,8,343611
28182,0.002067,172.31.36.0-255,66,124561,8,343611
28183,0.002073,74.125.24.0-255,4320,128881,8,343611
28184,0.002075,172.31.36.0-255,66,128947,8,343611
28185,0.002115,74.125.24.0-255,5738,134685,8,343611
28186,0.002119,172.31.36.0-255,66,134751,8,343611
28187,0.002151,74.125.24.0-255,2902,137653,8,343611
28188,0.002155,172.31.36.0-255,66,137719,8,343611
28189,0.002161,74.125.24.0-255,5738,143457,8,343611
28190,0.002163,172.31.36.0-255,66,143523,8,343611
28191,0.002196,74.125.24.0-255,7156,150679,8,343611
28192,0.0022,172.31.36.0-255,66,150745,8,343611
28193,0.002205,74.125.24.0-255,3602,154347,8,343611
28194,0.002206,172.31.36.0-255,66,154413,8,343611
28195,0.002266,74.125.24.0-255,1484,155897,8,343611
28196,0.002272,74.125.24.0-255,2902,158799,8,343611
28197,0.002275,172.31.36.0-255,66,158865,8,343611
28198,0.002281,74.125.24.0-255,5738,164603,8,343611
28199,0.002283,172.31.36.0-255,66,164669,8,343611
28200,0.0023,172.31.36.0-255,66,164735,8,343611
28201,0.002313,172.31.36.0-255,66,164801,8,343611
28202,0.002356,74.125.24.0-255,5020,169821,8,343611
28203,0.002361,172.31.36.0-255,66,169887,8,343611
28204,0.002372,172.31.36.0-255,66,169953,8,343611
28205,0.002375,74.125.24.0-255,1484,171437,8,343611
28206,0.004678,74.125.24.0-255,4320,175757,8,343611
28207,0.00469,172.31.36.0-255,66,175823,8,343611
28208,0.006982,74.125.24.0-255,5738,181561,8,343611
28209,0.006987,172.31.36.0-255,66,181627,8,343611
28210,0.009293,74.125.24.0-255,5738,187365,8,343611
28211,0.0093,172.31.36.0-255,66,187431,8,343611
28212,0.011655,74.125.24.0-255,5738,193169,8,343611
28213,0.011665,172.31.36.0-255,66,193235,8,343611
28214,0.013951,74.125.24.0-255,5738,198973,8,343611
28215,0.013958,172.31.36.0-255,66,199039,8,343611
28216,0.01628,74.125.24.0-255,5738,204777,8,343611
28217,0.016287,172.31.36.0-255,66,204843,8,343611
28218,0.018558,74.125.24.0-255,5738,210581,8,343611
28219,0.018566,172.31.36.0-255,66,210647,8,343611
28220,0.020857,74.125.24.0-255,5738,216385,8,343611
28221,0.020864,172.31.36.0-255,66,216451,8,343611
28222,0.023177,74.125.24.0-255,5738,222189,8,343611
28223,0.023184,172.31.36.0-255,66,222255,8,343611
28224,0.025545,74.125.24.0-255,5738,227993,8,343611
28225,0.025555,172.31.36.0-255,66,228059,8,343611
28226,0.027871,74.125.24.0-255,5738,233797,8,343611
28227,0.027878,172.31.36.0-255,66,233863,8,343611
28228,0.030195,74.125.24.0-255,5738,239601,8,343611
28229,0.030204,172.31.36.0-255,66,239667,8,343611
28230,0.031208,172.31.36.0-255,172,239839,8,343611
28231,0.031242,172.31.36.0-255,1111,240950,8,343611
28232,0.031309,172.31.36.0-255,1514,242464,8,343611
28233,0.031311,172.31.36.0-255,1514,243978,8,343611
28234,0.031312,172.31.36.0-255,1514,245492,8,343611
28235,0.031317,172.31.36.0-255,1514,247006,8,343611
28236,0.031318,172.31.36.0-255,1275,248281,8,343611
28237,0.032494,74.125.24.0-255,5738,254019,8,343611
28238,0.0325,172.31.36.0-255,66,254085,8,343611
28239,0.032735,104.244.42.0-255,66,254151,8,343611
28240,0.032762,104.244.42.0-255,66,254217,8,343611
28241,0.032858,104.244.42.0-255,66,254283,8,343611
28242,0.032862,104.244.42.0-255,66,254349,8,343611
28243,0.034791,74.125.24.0-255,5738,260087,8,343611
28244,0.034801,172.31.36.0-255,66,260153,8,343611
28245,0.037087,74.125.24.0-255,5738,265891,8,343611
28246,0.037092,172.31.36.0-255,66,265957,8,343611
28247,0.039387,74.125.24.0-255,5738,271695,8,343611
28248,0.039395,172.31.36.0-255,66,271761,8,343611
28249,0.041669,74.125.24.0-255,5738,277499,8,343611
28250,0.041692,172.31.36.0-255,66,277565,8,343611
28251,0.044,74.125.24.0-255,5738,283303,8,343611
28252,0.044005,172.31.36.0-255,66,283369,8,343611
28253,0.046311,74.125.24.0-255,5738,289107,8,343611
28254,0.046317,172.31.36.0-255,66,289173,8,343611
28255,0.04859,74.125.24.0-255,5738,294911,8,343611
28256,0.048597,172.31.36.0-255,66,294977,8,343611
28257,0.050872,74.125.24.0-255,4320,299297,8,343611
28258,0.050878,172.31.36.0-255,66,299363,8,343611
28259,0.050909,74.125.24.0-255,1484,300847,8,343611
28260,0.053162,74.125.24.0-255,4320,305167,8,343611
28261,0.053169,172.31.36.0-255,66,305233,8,343611
28262,0.055482,74.125.24.0-255,5738,310971,8,343611
28263,0.055489,172.31.36.0-255,66,311037,8,343611
28264,0.05779,74.125.24.0-255,5738,316775,8,343611
28265,0.0578,172.31.36.0-255,66,316841,8,343611
28266,0.060102,74.125.24.0-255,5738,322579,8,343611
28267,0.060107,172.31.36.0-255,66,322645,8,343611
28268,0.062415,74.125.24.0-255,5738,328383,8,343611
28269,0.06242,172.31.36.0-255,66,328449,8,343611
28270,0.064707,74.125.24.0-255,5738,334187,8,343611
28271,0.064712,172.31.36.0-255,66,334253,8,343611
28272,0.067001,74.125.24.0-255,5738,339991,8,343611
28273,0.067006,172.31.36.0-255,66,340057,8,343611
28274,0.069275,74.125.24.0-255,3383,343440,8,343611
28275,0.069281,172.31.36.0-255,66,343506,8,343611
28276,0.069455,172.31.36.0-255,105,343611,8,343611
28277,0.0,172.217.194.0-255,153,153,8,318461
28278,3.2e-05,172.31.36.0-255,66,219,8,318461
28279,4e-05,172.217.194.0-255,1484,1703,8,318461
28280,4.4e-05,172.31.36.0-255,66,1769,8,318461
28281,4.9e-05,172.217.194.0-255,2902,4671,8,318461
28282,5.2e-05,172.31.36.0-255,66,4737,8,318461
28283,5.8e-05,172.217.194.0-255,7156,11893,8,318461
28284,6.2e-05,172.31.36.0-255,66,11959,8,318461
28285,6.5e-05,172.217.194.0-255,1484,13443,8,318461
28286,6.7e-05,172.31.36.0-255,66,13509,8,318461
28287,0.000104,172.217.194.0-255,4888,18397,8,318461
28288,0.000108,172.31.36.0-255,66,18463,8,318461
28289,0.000114,172.217.194.0-255,5738,24201,8,318461
28290,0.000117,172.31.36.0-255,66,24267,8,318461
28291,0.000147,172.217.194.0-255,6797,31064,8,318461
28292,0.000151,172.31.36.0-255,66,31130,8,318461
28293,0.000285,172.217.194.0-255,1484,32614,8,318461
28294,0.000289,172.31.36.0-255,66,32680,8,318461
28295,0.000296,172.217.194.0-255,2902,35582,8,318461
28296,0.000298,172.31.36.0-255,66,35648,8,318461
28297,0.000303,172.217.194.0-255,2902,38550,8,318461
28298,0.000305,172.31.36.0-255,66,38616,8,318461
28299,0.000331,172.217.194.0-255,2902,41518,8,318461
28300,0.000334,172.31.36.0-255,66,41584,8,318461
28301,0.000345,172.31.36.0-255,66,41650,8,318461
28302,0.000356,172.31.36.0-255,66,41716,8,318461
28303,0.000396,172.217.194.0-255,7077,48793,8,318461
28304,0.0004,172.31.36.0-255,66,48859,8,318461
28305,0.000461,172.217.194.0-255,120,48979,8,318461
28306,0.000464,172.31.36.0-255,66,49045,8,318461
28307,0.000492,172.217.194.0-255,375,49420,8,318461
28308,0.00075,172.31.36.0-255,66,49486,8,318461
28309,0.000811,172.217.194.0-255,1484,50970,8,318461
28310,0.00082,172.217.194.0-255,2902,53872,8,318461
28311,0.000824,172.31.36.0-255,66,53938,8,318461
28312,0.000831,172.217.194.0-255,5738,59676,8,318461
28313,0.000833,172.31.36.0-255,66,59742,8,318461
28314,0.000869,172.31.36.0-255,66,59808,8,318461
28315,0.000896,172.31.36.0-255,66,59874,8,318461
28316,0.000929,172.217.194.0-255,766,60640,8,318461
28317,0.001073,172.217.194.0-255,1484,62124,8,318461
28318,0.001077,172.31.36.0-255,66,62190,8,318461
28319,0.001084,172.217.194.0-255,2902,65092,8,318461
28320,0.001086,172.31.36.0-255,66,65158,8,318461
28321,0.001091,172.217.194.0-255,2902,68060,8,318461
28322,0.001093,172.31.36.0-255,66,68126,8,318461
28323,0.001119,172.217.194.0-255,2902,71028,8,318461
28324,0.001121,172.31.36.0-255,66,71094,8,318461
28325,0.001134,172.31.36.0-255,66,71160,8,318461
28326,0.001138,172.217.194.0-255,2902,74062,8,318461
28327,0.00114,172.31.36.0-255,66,74128,8,318461
28328,0.001175,172.31.36.0-255,66,74194,8,318461
28329,0.001745,172.217.194.0-255,1484,75678,8,318461
28330,0.001752,172.217.194.0-255,2902,78580,8,318461
28331,0.001757,172.31.36.0-255,66,78646,8,318461
28332,0.001764,172.217.194.0-255,5738,84384,8,318461
28333,0.001766,172.31.36.0-255,66,84450,8,318461
28334,0.001798,172.217.194.0-255,7156,91606,8,318461
28335,0.0018,172.31.36.0-255,66,91672,8,318461
28336,0.001825,172.217.194.0-255,5738,97410,8,318461
28337,0.001827,172.31.36.0-255,66,97476,8,318461
28338,0.001837,172.31.36.0-255,66,97542,8,318461
28339,0.001854,172.217.194.0-255,766,98308,8,318461
28340,0.001916,172.217.194.0-255,1484,99792,8,318461
28341,0.001918,172.31.36.0-255,66,99858,8,318461
28342,0.001923,172.217.194.0-255,2902,102760,8,318461
28343,0.001925,172.31.36.0-255,66,102826,8,318461
28344,0.001958,172.217.194.0-255,5738,108564,8,318461
28345,0.001961,172.31.36.0-255,66,108630,8,318461
28346,0.001965,172.217.194.0-255,2902,111532,8,318461
28347,0.001967,172.31.36.0-255,66,111598,8,318461
28348,0.00198,172.217.194.0-255,2902,114500,8,318461
28349,0.001983,172.31.36.0-255,66,114566,8,318461
28350,0.001987,172.217.194.0-255,2902,117468,8,318461
28351,0.001989,172.31.36.0-255,66,117534,8,318461
28352,0.002006,172.217.194.0-255,7156,124690,8,318461
28353,0.002008,172.31.36.0-255,66,124756,8,318461
28354,0.002022,172.217.194.0-255,2902,127658,8,318461
28355,0.002024,172.31.36.0-255,66,127724,8,318461
28356,0.00203,172.217.194.0-255,5020,132744,8,318461
28357,0.002033,172.31.36.0-255,66,132810,8,318461
28358,0.002195,172.217.194.0-255,1484,134294,8,318461
28359,0.002218,172.217.194.0-255,2902,137196,8,318461
28360,0.00222,172.31.36.0-255,66,137262,8,318461
28361,0.002227,172.217.194.0-255,5738,143000,8,318461
28362,0.002229,172.31.36.0-255,66,143066,8,318461
28363,0.002261,172.31.36.0-255,66,143132,8,318461
28364,0.002287,172.31.36.0-255,66,143198,8,318461
28365,0.004549,172.217.194.0-255,1484,144682,8,318461
28366,0.004563,172.217.194.0-255,4320,149002,8,318461
28367,0.004565,172.31.36.0-255,66,149068,8,318461
28368,0.006862,172.217.194.0-255,5738,154806,8,318461
28369,0.006868,172.31.36.0-255,66,154872,8,318461
28370,0.009159,172.217.194.0-255,5738,160610,8,318461
28371,0.009167,172.31.36.0-255,66,160676,8,318461
28372,0.011439,172.217.194.0-255,5738,166414,8,318461
28373,0.01145,172.31.36.0-255,66,166480,8,318461
28374,0.013703,172.217.194.0-255,5738,172218,8,318461
28375,0.013712,172.31.36.0-255,66,172284,8,318461
28376,0.015986,172.217.194.0-255,5738,178022,8,318461
28377,0.015994,172.31.36.0-255,66,178088,8,318461
28378,0.018276,172.217.194.0-255,5738,183826,8,318461
28379,0.018289,172.31.36.0-255,66,183892,8,318461
28380,0.020566,172.217.194.0-255,5738,189630,8,318461
28381,0.020574,172.31.36.0-255,66,189696,8,318461
28382,0.022859,172.217.194.0-255,5738,195434,8,318461
28383,0.022866,172.31.36.0-255,66,195500,8,318461
28384,0.025151,172.217.194.0-255,5738,201238,8,318461
28385,0.025158,172.31.36.0-255,66,201304,8,318461
28386,0.027425,172.217.194.0-255,5738,207042,8,318461
28387,0.027433,172.31.36.0-255,66,207108,8,318461
28388,0.029722,172.217.194.0-255,4320,211428,8,318461
28389,0.029728,172.31.36.0-255,66,211494,8,318461
28390,0.029741,172.217.194.0-255,1484,212978,8,318461
28391,0.029747,172.31.36.0-255,172,213150,8,318461
28392,0.02977,172.31.36.0-255,1112,214262,8,318461
28393,0.029818,172.31.36.0-255,1514,215776,8,318461
28394,0.029819,172.31.36.0-255,1514,217290,8,318461
28395,0.029824,172.31.36.0-255,1514,218804,8,318461
28396,0.029825,172.31.36.0-255,1514,220318,8,318461
28397,0.029845,172.31.36.0-255,167,220485,8,318461
28398,0.031248,104.244.42.0-255,66,220551,8,318461
28399,0.031327,104.244.42.0-255,66,220617,8,318461
28400,0.031383,104.244.42.0-255,66,220683,8,318461
28401,0.031385,104.244.42.0-255,66,220749,8,318461
28402,0.031994,172.217.194.0-255,4320,225069,8,318461
28403,0.031997,172.31.36.0-255,66,225135,8,318461
28404,0.034296,172.217.194.0-255,5738,230873,8,318461
28405,0.034303,172.31.36.0-255,66,230939,8,318461
28406,0.036574,172.217.194.0-255,5738,236677,8,318461
28407,0.03658,172.31.36.0-255,66,236743,8,318461
28408,0.038858,172.217.194.0-255,5738,242481,8,318461
28409,0.038865,172.31.36.0-255,66,242547,8,318461
28410,0.041131,172.217.194.0-255,5738,248285,8,318461
28411,0.041137,172.31.36.0-255,66,248351,8,318461
28412,0.043395,172.217.194.0-255,5738,254089,8,318461
28413,0.043401,172.31.36.0-255,66,254155,8,318461
28414,0.045696,172.217.194.0-255,5738,259893,8,318461
28415,0.045703,172.31.36.0-255,66,259959,8,318461
28416,0.047967,172.217.194.0-255,5738,265697,8,318461
28417,0.047972,172.31.36.0-255,66,265763,8,318461
28418,0.050229,172.217.194.0-255,2902,268665,8,318461
28419,0.050235,172.31.36.0-255,66,268731,8,318461
28420,0.050265,172.217.194.0-255,2902,271633,8,318461
28421,0.050268,172.31.36.0-255,66,271699,8,318461
28422,0.052506,172.217.194.0-255,2902,274601,8,318461
28423,0.052512,172.31.36.0-255,66,274667,8,318461
28424,0.052542,172.217.194.0-255,2902,277569,8,318461
28425,0.052545,172.31.36.0-255,66,277635,8,318461
28426,0.054792,172.217.194.0-255,2902,280537,8,318461
28427,0.054797,172.31.36.0-255,66,280603,8,318461
28428,0.054833,172.217.194.0-255,2902,283505,8,318461
28429,0.054835,172.31.36.0-255,66,283571,8,318461
28430,0.057049,172.217.194.0-255,1484,285055,8,318461
28431,0.057107,172.217.194.0-255,4320,289375,8,318461
28432,0.057113,172.31.36.0-255,66,289441,8,318461
28433,0.059403,172.217.194.0-255,5738,295179,8,318461
28434,0.059409,172.31.36.0-255,66,295245,8,318461
28435,0.061697,172.217.194.0-255,5738,300983,8,318461
28436,0.061703,172.31.36.0-255,66,301049,8,318461
28437,0.063984,172.217.194.0-255,5738,306787,8,318461
28438,0.06399,172.31.36.0-255,66,306853,8,318461
28439,0.066256,172.217.194.0-255,5738,312591,8,318461
28440,0.066261,172.31.36.0-255,66,312657,8,318461
28441,0.068537,172.217.194.0-255,5738,318395,8,318461
28442,0.068543,172.31.36.0-255,66,318461,8,318461
28443,0.0,172.217.194.0-255,153,153,8,252612
28444,3.1e-05,172.31.36.0-255,66,219,8,252612
28445,3.8e-05,172.217.194.0-255,1484,1703,8,252612
28446,4.2e-05,172.31.36.0-255,66,1769,8,252612
28447,4.6e-05,172.217.194.0-255,2902,4671,8,252612
28448,4.8e-05,172.31.36.0-255,66,4737,8,252612
28449,5.4e-05,172.217.194.0-255,4320,9057,8,252612
28450,5.6e-05,172.31.36.0-255,66,9123,8,252612
28451,8.7e-05,172.31.36.0-255,66,9189,8,252612
28452,9.2e-05,172.217.194.0-255,2902,12091,8,252612
28453,9.4e-05,172.31.36.0-255,66,12157,8,252612
28454,0.000111,172.217.194.0-255,5738,17895,8,252612
28455,0.000113,172.31.36.0-255,66,17961,8,252612
28456,0.000128,172.217.194.0-255,4320,22281,8,252612
28457,0.00013,172.31.36.0-255,66,22347,8,252612
28458,0.000169,172.31.36.0-255,66,22413,8,252612
28459,0.000171,172.217.194.0-255,766,23179,8,252612
28460,0.000173,172.31.36.0-255,66,23245,8,252612
28461,0.000198,172.217.194.0-255,1484,24729,8,252612
28462,0.0002,172.31.36.0-255,66,24795,8,252612
28463,0.000216,172.31.36.0-255,66,24861,8,252612
28464,0.000232,172.217.194.0-255,4320,29181,8,252612
28465,0.000234,172.31.36.0-255,66,29247,8,252612
28466,0.000258,172.217.194.0-255,2798,32045,8,252612
28467,0.000261,172.31.36.0-255,66,32111,8,252612
28468,0.000576,172.217.194.0-255,118,32229,8,252612
28469,0.00058,172.31.36.0-255,66,32295,8,252612
28470,0.00061,172.217.194.0-255,1484,33779,8,252612
28471,0.000613,172.31.36.0-255,66,33845,8,252612
28472,0.000636,172.217.194.0-255,2902,36747,8,252612
28473,0.000639,172.31.36.0-255,66,36813,8,252612
28474,0.000646,172.217.194.0-255,7156,43969,8,252612
28475,0.000648,172.31.36.0-255,66,44035,8,252612
28476,0.000652,172.217.194.0-255,2902,46937,8,252612
28477,0.000656,172.31.36.0-255,66,47003,8,252612
28478,0.00067,172.217.194.0-255,2902,49905,8,252612
28479,0.000672,172.31.36.0-255,66,49971,8,252612
28480,0.000677,172.217.194.0-255,4320,54291,8,252612
28481,0.000679,172.31.36.0-255,66,54357,8,252612
28482,0.00071,172.31.36.0-255,66,54423,8,252612
28483,0.000714,172.217.194.0-255,2184,56607,8,252612
28484,0.000717,172.31.36.0-255,66,56673,8,252612
28485,0.000719,172.217.194.0-255,379,57052,8,252612
28486,0.00094,172.31.36.0-255,66,57118,8,252612
28487,0.002199,172.217.194.0-255,1484,58602,8,252612
28488,0.002224,172.217.194.0-255,2902,61504,8,252612
28489,0.002227,172.31.36.0-255,66,61570,8,252612
28490,0.002234,172.217.194.0-255,5738,67308,8,252612
28491,0.002235,172.31.36.0-255,66,67374,8,252612
28492,0.002239,172.217.194.0-255,4320,71694,8,252612
28493,0.002241,172.31.36.0-255,66,71760,8,252612
28494,0.002245,172.217.194.0-255,4320,76080,8,252612
28495,0.002247,172.31.36.0-255,66,76146,8,252612
28496,0.002275,172.217.194.0-255,7156,83302,8,252612
28497,0.002277,172.31.36.0-255,66,83368,8,252612
28498,0.002281,172.217.194.0-255,2902,86270,8,252612
28499,0.002282,172.31.36.0-255,66,86336,8,252612
28500,0.002297,172.217.194.0-255,5020,91356,8,252612
28501,0.002298,172.31.36.0-255,66,91422,8,252612
28502,0.004845,172.217.194.0-255,5738,97160,8,252612
28503,0.004848,172.31.36.0-255,66,97226,8,252612
28504,0.007385,172.217.194.0-255,5738,102964,8,252612
28505,0.007391,172.31.36.0-255,66,103030,8,252612
28506,0.009924,172.217.194.0-255,5738,108768,8,252612
28507,0.009933,172.31.36.0-255,66,108834,8,252612
28508,0.012472,172.217.194.0-255,5738,114572,8,252612
28509,0.012481,172.31.36.0-255,66,114638,8,252612
28510,0.014986,172.217.194.0-255,5738,120376,8,252612
28511,0.014994,172.31.36.0-255,66,120442,8,252612
28512,0.017526,172.217.194.0-255,5738,126180,8,252612
28513,0.017542,172.31.36.0-255,66,126246,8,252612
28514,0.020082,172.217.194.0-255,5738,131984,8,252612
28515,0.02009,172.31.36.0-255,66,132050,8,252612
28516,0.02263,172.217.194.0-255,5738,137788,8,252612
28517,0.022639,172.31.36.0-255,66,137854,8,252612
28518,0.025197,172.217.194.0-255,5738,143592,8,252612
28519,0.025206,172.31.36.0-255,66,143658,8,252612
28520,0.027365,172.31.36.0-255,172,143830,8,252612
28521,0.027394,172.31.36.0-255,1111,144941,8,252612
28522,0.027447,172.31.36.0-255,1514,146455,8,252612
28523,0.027449,172.31.36.0-255,1514,147969,8,252612
28524,0.027455,172.31.36.0-255,1514,149483,8,252612
28525,0.027457,172.31.36.0-255,1514,150997,8,252612
28526,0.027477,172.31.36.0-255,1514,152511,8,252612
28527,0.027478,172.31.36.0-255,995,153506,8,252612
28528,0.0277,172.217.194.0-255,5738,159244,8,252612
28529,0.027707,172.31.36.0-255,66,159310,8,252612
28530,0.028921,104.244.42.0-255,66,159376,8,252612
28531,0.028958,104.244.42.0-255,66,159442,8,252612
28532,0.029005,104.244.42.0-255,66,159508,8,252612
28533,0.029054,104.244.42.0-255,66,159574,8,252612
28534,0.030268,172.217.194.0-255,5738,165312,8,252612
28535,0.030275,172.31.36.0-255,66,165378,8,252612
28536,0.032779,172.217.194.0-255,5738,171116,8,252612
28537,0.032787,172.31.36.0-255,66,171182,8,252612
28538,0.035351,172.217.194.0-255,5738,176920,8,252612
28539,0.03536,172.31.36.0-255,66,176986,8,252612
28540,0.037892,172.217.194.0-255,5738,182724,8,252612
28541,0.037905,172.31.36.0-255,66,182790,8,252612
28542,0.040441,172.217.194.0-255,5738,188528,8,252612
28543,0.040449,172.31.36.0-255,66,188594,8,252612
28544,0.04061,172.31.36.0-255,108,188702,8,252612
28545,0.042169,104.244.42.0-255,66,188768,8,252612
28546,0.04298,172.217.194.0-255,5738,194506,8,252612
28547,0.042993,172.31.36.0-255,66,194572,8,252612
28548,0.045519,172.217.194.0-255,5738,200310,8,252612
28549,0.045529,172.31.36.0-255,66,200376,8,252612
28550,0.048041,172.217.194.0-255,5738,206114,8,252612
28551,0.04805,172.31.36.0-255,66,206180,8,252612
28552,0.050591,172.217.194.0-255,5738,211918,8,252612
28553,0.050607,172.31.36.0-255,66,211984,8,252612
28554,0.053164,172.217.194.0-255,5738,217722,8,252612
28555,0.053186,172.31.36.0-255,66,217788,8,252612
28556,0.055737,172.217.194.0-255,5738,223526,8,252612
28557,0.055755,172.31.36.0-255,66,223592,8,252612
28558,0.058276,172.217.194.0-255,5738,229330,8,252612
28559,0.058296,172.31.36.0-255,66,229396,8,252612
28560,0.06083,172.217.194.0-255,5738,235134,8,252612
28561,0.060839,172.31.36.0-255,66,235200,8,252612
28562,0.063336,172.217.194.0-255,5738,240938,8,252612
28563,0.063344,172.31.36.0-255,66,241004,8,252612
28564,0.065859,172.217.194.0-255,5738,246742,8,252612
28565,0.065863,172.31.36.0-255,66,246808,8,252612
28566,0.068387,172.217.194.0-255,5738,252546,8,252612
28567,0.068394,172.31.36.0-255,66,252612,8,252612
28568,0.0,172.217.194.0-255,146,146,8,205303
28569,3.1e-05,172.31.36.0-255,66,212,8,205303
28570,4e-05,172.217.194.0-255,1484,1696,8,205303
28571,4.4e-05,172.31.36.0-255,66,1762,8,205303
28572,5.8e-05,172.217.194.0-255,2902,4664,8,205303
28573,6.1e-05,172.31.36.0-255,66,4730,8,205303
28574,8.4e-05,172.217.194.0-255,7156,11886,8,205303
28575,8.7e-05,172.31.36.0-255,66,11952,8,205303
28576,9.1e-05,172.217.194.0-255,2017,13969,8,205303
28577,9.5e-05,172.31.36.0-255,66,14035,8,205303
28578,9.9e-05,172.217.194.0-255,2902,16937,8,205303
28579,0.000102,172.31.36.0-255,66,17003,8,205303
28580,0.000124,172.217.194.0-255,7156,24159,8,205303
28581,0.000132,172.31.36.0-255,66,24225,8,205303
28582,0.000169,172.31.36.0-255,66,24291,8,205303
28583,0.000175,172.217.194.0-255,5738,30029,8,205303
28584,0.000177,172.31.36.0-255,66,30095,8,205303
28585,0.000206,172.217.194.0-255,5379,35474,8,205303
28586,0.000209,172.31.36.0-255,66,35540,8,205303
28587,0.000227,172.217.194.0-255,7156,42696,8,205303
28588,0.00023,172.31.36.0-255,66,42762,8,205303
28589,0.000259,172.31.36.0-255,66,42828,8,205303
28590,0.000263,172.217.194.0-255,1438,44266,8,205303
28591,0.000265,172.31.36.0-255,66,44332,8,205303
28592,0.000305,172.217.194.0-255,100,44432,8,205303
28593,0.000309,172.31.36.0-255,66,44498,8,205303
28594,0.000338,172.217.194.0-255,362,44860,8,205303
28595,0.000342,172.31.36.0-255,66,44926,8,205303
28596,0.00051,172.217.194.0-255,1484,46410,8,205303
28597,0.000515,172.31.36.0-255,66,46476,8,205303
28598,0.000521,172.217.194.0-255,2902,49378,8,205303
28599,0.000523,172.31.36.0-255,66,49444,8,205303
28600,0.000535,172.217.194.0-255,5738,55182,8,205303
28601,0.000538,172.31.36.0-255,66,55248,8,205303
28602,0.000546,172.217.194.0-255,5738,60986,8,205303
28603,0.000563,172.31.36.0-255,66,61052,8,205303
28604,0.000581,172.217.194.0-255,7156,68208,8,205303
28605,0.000594,172.31.36.0-255,66,68274,8,205303
28606,0.000599,172.31.36.0-255,66,68340,8,205303
28607,0.000773,172.217.194.0-255,1484,69824,8,205303
28608,0.000779,172.217.194.0-255,2902,72726,8,205303
28609,0.000782,172.31.36.0-255,66,72792,8,205303
28610,0.00079,172.217.194.0-255,5738,78530,8,205303
28611,0.000797,172.31.36.0-255,66,78596,8,205303
28612,0.000834,172.31.36.0-255,66,78662,8,205303
28613,0.000836,172.217.194.0-255,2902,81564,8,205303
28614,0.000855,172.31.36.0-255,66,81630,8,205303
28615,0.00088,172.217.194.0-255,5738,87368,8,205303
28616,0.000886,172.31.36.0-255,66,87434,8,205303
28617,0.000911,172.217.194.0-255,5020,92454,8,205303
28618,0.00092,172.31.36.0-255,66,92520,8,205303
28619,0.001105,172.217.194.0-255,1484,94004,8,205303
28620,0.001109,172.217.194.0-255,1484,95488,8,205303
28621,0.001112,172.31.36.0-255,66,95554,8,205303
28622,0.001142,172.217.194.0-255,1484,97038,8,205303
28623,0.001149,172.217.194.0-255,5738,102776,8,205303
28624,0.001152,172.31.36.0-255,66,102842,8,205303
28625,0.00116,172.217.194.0-255,5738,108580,8,205303
28626,0.001171,172.31.36.0-255,66,108646,8,205303
28627,0.001176,172.31.36.0-255,66,108712,8,205303
28628,0.001194,172.217.194.0-255,1484,110196,8,205303
28629,0.001201,172.217.194.0-255,5020,115216,8,205303
28630,0.001207,172.217.194.0-255,5738,120954,8,205303
28631,0.001211,172.31.36.0-255,66,121020,8,205303
28632,0.001272,172.31.36.0-255,66,121086,8,205303
28633,0.001287,172.31.36.0-255,66,121152,8,205303
28634,0.001325,172.217.194.0-255,1484,122636,8,205303
28635,0.001331,172.217.194.0-255,2902,125538,8,205303
28636,0.001334,172.217.194.0-255,1484,127022,8,205303
28637,0.001348,172.31.36.0-255,66,127088,8,205303
28638,0.001348,172.217.194.0-255,4320,131408,8,205303
28639,0.001351,172.217.194.0-255,1484,132892,8,205303
28640,0.001352,172.31.36.0-255,66,132958,8,205303
28641,0.001383,172.217.194.0-255,7156,140114,8,205303
28642,0.001387,172.31.36.0-255,66,140180,8,205303
28643,0.001419,172.217.194.0-255,5738,145918,8,205303
28644,0.001429,172.31.36.0-255,66,145984,8,205303
28645,0.001451,172.31.36.0-255,66,146050,8,205303
28646,0.00167,172.217.194.0-255,1484,147534,8,205303
28647,0.001687,172.217.194.0-255,2902,150436,8,205303
28648,0.00169,172.31.36.0-255,66,150502,8,205303
28649,0.001698,172.217.194.0-255,5738,156240,8,205303
28650,0.001705,172.31.36.0-255,66,156306,8,205303
28651,0.001739,172.31.36.0-255,66,156372,8,205303
28652,0.001758,172.31.36.0-255,66,156438,8,205303
28653,0.001776,172.217.194.0-255,5020,161458,8,205303
28654,0.001789,172.31.36.0-255,66,161524,8,205303
28655,0.001927,172.217.194.0-255,1484,163008,8,205303
28656,0.001934,172.217.194.0-255,2902,165910,8,205303
28657,0.001938,172.31.36.0-255,66,165976,8,205303
28658,0.001945,172.217.194.0-255,5738,171714,8,205303
28659,0.001955,172.31.36.0-255,66,171780,8,205303
28660,0.001979,172.31.36.0-255,66,171846,8,205303
28661,0.001993,172.217.194.0-255,4320,176166,8,205303
28662,0.001996,172.217.194.0-255,1484,177650,8,205303
28663,0.001997,172.31.36.0-255,66,177716,8,205303
28664,0.002036,172.31.36.0-255,66,177782,8,205303
28665,0.002099,172.31.36.0-255,66,177848,8,205303
28666,0.002129,172.217.194.0-255,3602,181450,8,205303
28667,0.002134,172.31.36.0-255,66,181516,8,205303
28668,0.002152,172.31.36.0-255,66,181582,8,205303
28669,0.002166,172.31.36.0-255,66,181648,8,205303
28670,0.002179,172.217.194.0-255,1484,183132,8,205303
28671,0.002185,172.217.194.0-255,7156,190288,8,205303
28672,0.00219,172.31.36.0-255,66,190354,8,205303
28673,0.002194,172.31.36.0-255,66,190420,8,205303
28674,0.002251,172.31.36.0-255,66,190486,8,205303
28675,0.00226,172.217.194.0-255,6637,197123,8,205303
28676,0.002265,172.31.36.0-255,66,197189,8,205303
28677,0.002276,172.217.194.0-255,105,197294,8,205303
28678,0.009059,172.31.36.0-255,66,197360,8,205303
28679,0.009087,172.31.36.0-255,105,197465,8,205303
28680,0.011308,172.217.194.0-255,66,197531,8,205303
28681,0.040461,172.31.36.0-255,172,197703,8,205303
28682,0.040493,172.31.36.0-255,1112,198815,8,205303
28683,0.040563,172.31.36.0-255,1514,200329,8,205303
28684,0.040585,172.31.36.0-255,1514,201843,8,205303
28685,0.040589,172.31.36.0-255,1514,203357,8,205303
28686,0.040605,172.31.36.0-255,1514,204871,8,205303
28687,0.040608,172.31.36.0-255,168,205039,8,205303
28688,0.041934,104.244.42.0-255,66,205105,8,205303
28689,0.041956,104.244.42.0-255,66,205171,8,205303
28690,0.042071,104.244.42.0-255,66,205237,8,205303
28691,0.042075,104.244.42.0-255,66,205303,8,205303
28692,0.0,74.125.24.0-255,156,156,8,263258
28693,1.9e-05,172.31.36.0-255,66,222,8,263258
28694,2.6e-05,74.125.24.0-255,1484,1706,8,263258
28695,3.1e-05,172.31.36.0-255,66,1772,8,263258
28696,3.7e-05,74.125.24.0-255,2902,4674,8,263258
28697,4.2e-05,172.31.36.0-255,66,4740,8,263258
28698,4.8e-05,74.125.24.0-255,4320,9060,8,263258
28699,5e-05,172.31.36.0-255,66,9126,8,263258
28700,8.6e-05,74.125.24.0-255,4898,14024,8,263258
28701,9e-05,172.31.36.0-255,66,14090,8,263258
28702,0.000116,74.125.24.0-255,5738,19828,8,263258
28703,0.000119,172.31.36.0-255,66,19894,8,263258
28704,0.000146,172.31.36.0-255,66,19960,8,263258
28705,0.000215,74.125.24.0-255,1484,21444,8,263258
28706,0.000219,172.31.36.0-255,66,21510,8,263258
28707,0.000232,74.125.24.0-255,1484,22994,8,263258
28708,0.000235,172.31.36.0-255,66,23060,8,263258
28709,0.000255,74.125.24.0-255,1484,24544,8,263258
28710,0.000258,172.31.36.0-255,66,24610,8,263258
28711,0.000264,74.125.24.0-255,4320,28930,8,263258
28712,0.000267,172.31.36.0-255,66,28996,8,263258
28713,0.000281,74.125.24.0-255,1484,30480,8,263258
28714,0.000283,172.31.36.0-255,66,30546,8,263258
28715,0.000291,74.125.24.0-255,6797,37343,8,263258
28716,0.000294,172.31.36.0-255,66,37409,8,263258
28717,0.000321,74.125.24.0-255,4320,41729,8,263258
28718,0.000324,172.31.36.0-255,66,41795,8,263258
28719,0.00035,172.31.36.0-255,66,41861,8,263258
28720,0.000354,74.125.24.0-255,2821,44682,8,263258
28721,0.000356,172.31.36.0-255,66,44748,8,263258
28722,0.000396,74.125.24.0-255,131,44879,8,263258
28723,0.000508,74.125.24.0-255,1484,46363,8,263258
28724,0.000513,172.31.36.0-255,66,46429,8,263258
28725,0.000517,74.125.24.0-255,2902,49331,8,263258
28726,0.00052,172.31.36.0-255,66,49397,8,263258
28727,0.000523,74.125.24.0-255,1484,50881,8,263258
28728,0.000545,74.125.24.0-255,4320,55201,8,263258
28729,0.000548,172.31.36.0-255,66,55267,8,263258
28730,0.000557,74.125.24.0-255,6797,62064,8,263258
28731,0.000559,172.31.36.0-255,66,62130,8,263258
28732,0.000562,74.125.24.0-255,1484,63614,8,263258
28733,0.000599,172.31.36.0-255,66,63680,8,263258
28734,0.000603,74.125.24.0-255,2543,66223,8,263258
28735,0.000605,172.31.36.0-255,66,66289,8,263258
28736,0.000608,74.125.24.0-255,344,66633,8,263258
28737,0.001317,172.31.36.0-255,66,66699,8,263258
28738,0.001535,74.125.24.0-255,1484,68183,8,263258
28739,0.001544,74.125.24.0-255,2902,71085,8,263258
28740,0.001548,172.31.36.0-255,66,71151,8,263258
28741,0.001557,74.125.24.0-255,5738,76889,8,263258
28742,0.001558,172.31.36.0-255,66,76955,8,263258
28743,0.001595,172.31.36.0-255,66,77021,8,263258
28744,0.001626,172.31.36.0-255,66,77087,8,263258
28745,0.002127,74.125.24.0-255,1484,78571,8,263258
28746,0.002143,74.125.24.0-255,2902,81473,8,263258
28747,0.002147,172.31.36.0-255,66,81539,8,263258
28748,0.002152,74.125.24.0-255,2902,84441,8,263258
28749,0.002154,172.31.36.0-255,66,84507,8,263258
28750,0.002172,74.125.24.0-255,7156,91663,8,263258
28751,0.002174,172.31.36.0-255,66,91729,8,263258
28752,0.002185,74.125.24.0-255,1484,93213,8,263258
28753,0.002218,172.31.36.0-255,66,93279,8,263258
28754,0.002224,74.125.24.0-255,3602,96881,8,263258
28755,0.002226,172.31.36.0-255,66,96947,8,263258
28756,0.002302,74.125.24.0-255,1484,98431,8,263258
28757,0.002309,74.125.24.0-255,2902,101333,8,263258
28758,0.002312,172.31.36.0-255,66,101399,8,263258
28759,0.002319,74.125.24.0-255,5738,107137,8,263258
28760,0.002321,172.31.36.0-255,66,107203,8,263258
28761,0.002325,74.125.24.0-255,2902,110105,8,263258
28762,0.002327,172.31.36.0-255,66,110171,8,263258
28763,0.002365,172.31.36.0-255,66,110237,8,263258
28764,0.002378,172.31.36.0-255,66,110303,8,263258
28765,0.004931,74.125.24.0-255,5738,116041,8,263258
28766,0.004937,172.31.36.0-255,66,116107,8,263258
28767,0.007492,74.125.24.0-255,5738,121845,8,263258
28768,0.007496,172.31.36.0-255,66,121911,8,263258
28769,0.01005,74.125.24.0-255,5738,127649,8,263258
28770,0.010057,172.31.36.0-255,66,127715,8,263258
28771,0.012615,74.125.24.0-255,5738,133453,8,263258
28772,0.012623,172.31.36.0-255,66,133519,8,263258
28773,0.015169,74.125.24.0-255,5738,139257,8,263258
28774,0.015177,172.31.36.0-255,66,139323,8,263258
28775,0.017741,74.125.24.0-255,5738,145061,8,263258
28776,0.017747,172.31.36.0-255,66,145127,8,263258
28777,0.020317,74.125.24.0-255,5738,150865,8,263258
28778,0.020325,172.31.36.0-255,66,150931,8,263258
28779,0.022935,74.125.24.0-255,5738,156669,8,263258
28780,0.022944,172.31.36.0-255,66,156735,8,263258
28781,0.025495,74.125.24.0-255,5738,162473,8,263258
28782,0.025502,172.31.36.0-255,66,162539,8,263258
28783,0.02806,74.125.24.0-255,5738,168277,8,263258
28784,0.028068,172.31.36.0-255,66,168343,8,263258
28785,0.030619,74.125.24.0-255,5738,174081,8,263258
28786,0.030628,172.31.36.0-255,66,174147,8,263258
28787,0.033188,74.125.24.0-255,5738,179885,8,263258
28788,0.033196,172.31.36.0-255,66,179951,8,263258
28789,0.034513,172.31.36.0-255,172,180123,8,263258
28790,0.034554,172.31.36.0-255,1112,181235,8,263258
28791,0.034639,172.31.36.0-255,569,181804,8,263258
28792,0.035758,74.125.24.0-255,5738,187542,8,263258
28793,0.035766,172.31.36.0-255,66,187608,8,263258
28794,0.03606,104.244.42.0-255,66,187674,8,263258
28795,0.036068,104.244.42.0-255,66,187740,8,263258
28796,0.036119,104.244.42.0-255,66,187806,8,263258
28797,0.038334,74.125.24.0-255,5738,193544,8,263258
28798,0.038341,172.31.36.0-255,66,193610,8,263258
28799,0.04091,74.125.24.0-255,5738,199348,8,263258
28800,0.040915,172.31.36.0-255,66,199414,8,263258
28801,0.04347,74.125.24.0-255,5738,205152,8,263258
28802,0.043478,172.31.36.0-255,66,205218,8,263258
28803,0.046043,74.125.24.0-255,5738,210956,8,263258
28804,0.04605,172.31.36.0-255,66,211022,8,263258
28805,0.048608,74.125.24.0-255,5738,216760,8,263258
28806,0.048614,172.31.36.0-255,66,216826,8,263258
28807,0.051177,74.125.24.0-255,5738,222564,8,263258
28808,0.051183,172.31.36.0-255,66,222630,8,263258
28809,0.053739,74.125.24.0-255,5738,228368,8,263258
28810,0.053745,172.31.36.0-255,66,228434,8,263258
28811,0.056303,74.125.24.0-255,5738,234172,8,263258
28812,0.05631,172.31.36.0-255,66,234238,8,263258
28813,0.058851,74.125.24.0-255,5738,239976,8,263258
28814,0.058856,172.31.36.0-255,66,240042,8,263258
28815,0.06141,74.125.24.0-255,5738,245780,8,263258
28816,0.061416,172.31.36.0-255,66,245846,8,263258
28817,0.063972,74.125.24.0-255,5738,251584,8,263258
28818,0.063978,172.31.36.0-255,66,251650,8,263258
28819,0.066524,74.125.24.0-255,5738,257388,8,263258
28820,0.066531,172.31.36.0-255,66,257454,8,263258
28821,0.069098,74.125.24.0-255,5738,263192,8,263258
28822,0.069105,172.31.36.0-255,66,263258,8,263258
28823,0.0,74.125.24.0-255,153,153,8,314605
28824,3.4e-05,172.31.36.0-255,66,219,8,314605
28825,4.1e-05,74.125.24.0-255,1484,1703,8,314605
28826,4.5e-05,172.31.36.0-255,66,1769,8,314605
28827,5e-05,74.125.24.0-255,2902,4671,8,314605
28828,5.2e-05,172.31.36.0-255,66,4737,8,314605
28829,5.9e-05,74.125.24.0-255,7156,11893,8,314605
28830,6.2e-05,172.31.36.0-255,66,11959,8,314605
28831,6.6e-05,74.125.24.0-255,1968,13927,8,314605
28832,6.8e-05,172.31.36.0-255,66,13993,8,314605
28833,0.000124,74.125.24.0-255,1484,15477,8,314605
28834,0.000127,172.31.36.0-255,66,15543,8,314605
28835,0.000132,74.125.24.0-255,2902,18445,8,314605
28836,0.000134,172.31.36.0-255,66,18511,8,314605
28837,0.00016,74.125.24.0-255,5738,24249,8,314605
28838,0.000163,172.31.36.0-255,66,24315,8,314605
28839,0.000166,74.125.24.0-255,1484,25799,8,314605
28840,0.000168,172.31.36.0-255,66,25865,8,314605
28841,0.000191,74.125.24.0-255,5379,31244,8,314605
28842,0.000195,172.31.36.0-255,66,31310,8,314605
28843,0.00024,74.125.24.0-255,1484,32794,8,314605
28844,0.000243,172.31.36.0-255,66,32860,8,314605
28845,0.000249,74.125.24.0-255,2902,35762,8,314605
28846,0.000251,172.31.36.0-255,66,35828,8,314605
28847,0.000283,74.125.24.0-255,5738,41566,8,314605
28848,0.000286,172.31.36.0-255,66,41632,8,314605
28849,0.000291,74.125.24.0-255,4320,45952,8,314605
28850,0.000293,172.31.36.0-255,66,46018,8,314605
28851,0.000319,172.31.36.0-255,66,46084,8,314605
28852,0.000327,74.125.24.0-255,7111,53195,8,314605
28853,0.00033,172.31.36.0-255,66,53261,8,314605
28854,0.000352,74.125.24.0-255,375,53636,8,314605
28855,0.00062,74.125.24.0-255,1484,55120,8,314605
28856,0.000624,172.31.36.0-255,66,55186,8,314605
28857,0.00063,74.125.24.0-255,2902,58088,8,314605
28858,0.000632,172.31.36.0-255,66,58154,8,314605
28859,0.000648,74.125.24.0-255,5738,63892,8,314605
28860,0.000651,172.31.36.0-255,66,63958,8,314605
28861,0.000685,172.31.36.0-255,66,64024,8,314605
28862,0.000689,172.31.36.0-255,66,64090,8,314605
28863,0.000725,74.125.24.0-255,2184,66274,8,314605
28864,0.000729,172.31.36.0-255,66,66340,8,314605
28865,0.000982,74.125.24.0-255,1484,67824,8,314605
28866,0.000988,74.125.24.0-255,2902,70726,8,314605
28867,0.000991,172.31.36.0-255,66,70792,8,314605
28868,0.001023,74.125.24.0-255,4320,75112,8,314605
28869,0.001026,172.31.36.0-255,66,75178,8,314605
28870,0.00105,74.125.24.0-255,1484,76662,8,314605
28871,0.001064,172.31.36.0-255,66,76728,8,314605
28872,0.001075,172.31.36.0-255,66,76794,8,314605
28873,0.001078,74.125.24.0-255,766,77560,8,314605
28874,0.001216,74.125.24.0-255,1484,79044,8,314605
28875,0.001222,172.31.36.0-255,66,79110,8,314605
28876,0.001226,74.125.24.0-255,2902,82012,8,314605
28877,0.001228,172.31.36.0-255,66,82078,8,314605
28878,0.001235,74.125.24.0-255,5738,87816,8,314605
28879,0.001239,172.31.36.0-255,66,87882,8,314605
28880,0.001277,172.31.36.0-255,66,87948,8,314605
28881,0.001282,74.125.24.0-255,2902,90850,8,314605
28882,0.001284,172.31.36.0-255,66,90916,8,314605
28883,0.001307,172.31.36.0-255,66,90982,8,314605
28884,0.001591,74.125.24.0-255,1484,92466,8,314605
28885,0.001596,74.125.24.0-255,2902,95368,8,314605
28886,0.0016,172.31.36.0-255,66,95434,8,314605
28887,0.001604,74.125.24.0-255,1484,96918,8,314605
28888,0.001623,74.125.24.0-255,4320,101238,8,314605
28889,0.001627,172.31.36.0-255,66,101304,8,314605
28890,0.001637,172.31.36.0-255,66,101370,8,314605
28891,0.001661,74.125.24.0-255,4320,105690,8,314605
28892,0.001664,172.31.36.0-255,66,105756,8,314605
28893,0.001671,74.125.24.0-255,7156,112912,8,314605
28894,0.001673,172.31.36.0-255,66,112978,8,314605
28895,0.00169,74.125.24.0-255,3602,116580,8,314605
28896,0.001692,172.31.36.0-255,66,116646,8,314605
28897,0.003625,74.125.24.0-255,4320,120966,8,314605
28898,0.003632,172.31.36.0-255,66,121032,8,314605
28899,0.003649,74.125.24.0-255,1484,122516,8,314605
28900,0.005578,74.125.24.0-255,4320,126836,8,314605
28901,0.005584,172.31.36.0-255,66,126902,8,314605
28902,0.007534,74.125.24.0-255,4320,131222,8,314605
28903,0.007537,172.31.36.0-255,66,131288,8,314605
28904,0.00755,74.125.24.0-255,1484,132772,8,314605
28905,0.00947,74.125.24.0-255,4320,137092,8,314605
28906,0.009477,172.31.36.0-255,66,137158,8,314605
28907,0.011603,74.125.24.0-255,5738,142896,8,314605
28908,0.011664,172.31.36.0-255,66,142962,8,314605
28909,0.01362,74.125.24.0-255,5738,148700,8,314605
28910,0.013627,172.31.36.0-255,66,148766,8,314605
28911,0.015582,74.125.24.0-255,5738,154504,8,314605
28912,0.015589,172.31.36.0-255,66,154570,8,314605
28913,0.015711,172.31.36.0-255,101,154671,8,314605
28914,0.017527,74.125.24.0-255,5738,160409,8,314605
28915,0.017537,172.31.36.0-255,66,160475,8,314605
28916,0.017599,74.125.24.0-255,66,160541,8,314605
28917,0.019474,74.125.24.0-255,5738,166279,8,314605
28918,0.019481,172.31.36.0-255,66,166345,8,314605
28919,0.021433,74.125.24.0-255,5738,172083,8,314605
28920,0.02144,172.31.36.0-255,66,172149,8,314605
28921,0.02341,74.125.24.0-255,5738,177887,8,314605
28922,0.023417,172.31.36.0-255,66,177953,8,314605
28923,0.025386,74.125.24.0-255,5738,183691,8,314605
28924,0.025397,172.31.36.0-255,66,183757,8,314605
28925,0.02735,74.125.24.0-255,5738,189495,8,314605
28926,0.02736,172.31.36.0-255,66,189561,8,314605
28927,0.029327,74.125.24.0-255,5738,195299,8,314605
28928,0.029334,172.31.36.0-255,66,195365,8,314605
28929,0.031298,74.125.24.0-255,5738,201103,8,314605
28930,0.031305,172.31.36.0-255,66,201169,8,314605
28931,0.033266,74.125.24.0-255,5738,206907,8,314605
28932,0.033274,172.31.36.0-255,66,206973,8,314605
28933,0.0352,74.125.24.0-255,5738,212711,8,314605
28934,0.035207,172.31.36.0-255,66,212777,8,314605
28935,0.03717,74.125.24.0-255,5738,218515,8,314605
28936,0.037177,172.31.36.0-255,66,218581,8,314605
28937,0.039183,74.125.24.0-255,5738,224319,8,314605
28938,0.039191,172.31.36.0-255,66,224385,8,314605
28939,0.041152,74.125.24.0-255,5738,230123,8,314605
28940,0.04116,172.31.36.0-255,66,230189,8,314605
28941,0.043104,74.125.24.0-255,5738,235927,8,314605
28942,0.043112,172.31.36.0-255,66,235993,8,314605
28943,0.045042,74.125.24.0-255,5738,241731,8,314605
28944,0.045049,172.31.36.0-255,66,241797,8,314605
28945,0.046988,74.125.24.0-255,5738,247535,8,314605
28946,0.046998,172.31.36.0-255,66,247601,8,314605
28947,0.048937,74.125.24.0-255,5738,253339,8,314605
28948,0.048944,172.31.36.0-255,66,253405,8,314605
28949,0.049136,172.31.36.0-255,188,253593,8,314605
28950,0.049163,172.31.36.0-255,955,254548,8,314605
28951,0.049213,172.31.36.0-255,1514,256062,8,314605
28952,0.049215,172.31.36.0-255,1514,257576,8,314605
28953,0.049238,172.31.36.0-255,77,257653,8,314605
28954,0.050669,104.244.42.0-255,66,257719,8,314605
28955,0.05085,104.244.42.0-255,66,257785,8,314605
28956,0.050856,104.244.42.0-255,66,257851,8,314605
28957,0.050859,104.244.42.0-255,66,257917,8,314605
28958,0.050891,74.125.24.0-255,5738,263655,8,314605
28959,0.050897,172.31.36.0-255,66,263721,8,314605
28960,0.052845,74.125.24.0-255,5738,269459,8,314605
28961,0.05285,172.31.36.0-255,66,269525,8,314605
28962,0.054809,74.125.24.0-255,5738,275263,8,314605
28963,0.054815,172.31.36.0-255,66,275329,8,314605
28964,0.056754,74.125.24.0-255,5738,281067,8,314605
28965,0.056759,172.31.36.0-255,66,281133,8,314605
28966,0.058725,74.125.24.0-255,5738,286871,8,314605
28967,0.058729,172.31.36.0-255,66,286937,8,314605
28968,0.060663,74.125.24.0-255,5738,292675,8,314605
28969,0.060668,172.31.36.0-255,66,292741,8,314605
28970,0.062621,74.125.24.0-255,5738,298479,8,314605
28971,0.062626,172.31.36.0-255,66,298545,8,314605
28972,0.064587,74.125.24.0-255,4320,302865,8,314605
28973,0.064591,172.31.36.0-255,66,302931,8,314605
28974,0.064614,74.125.24.0-255,1484,304415,8,314605
28975,0.066554,74.125.24.0-255,4320,308735,8,314605
28976,0.066559,172.31.36.0-255,66,308801,8,314605
28977,0.068499,74.125.24.0-255,5738,314539,8,314605
28978,0.068505,172.31.36.0-255,66,314605,8,314605
28979,0.0,74.125.24.0-255,153,153,8,296835
28980,2.4e-05,172.31.36.0-255,66,219,8,296835
28981,3.1e-05,74.125.24.0-255,1484,1703,8,296835
28982,3.7e-05,172.31.36.0-255,66,1769,8,296835
28983,4.2e-05,74.125.24.0-255,2902,4671,8,296835
28984,4.6e-05,172.31.36.0-255,66,4737,8,296835
28985,5.1e-05,74.125.24.0-255,2902,7639,8,296835
28986,5.4e-05,172.31.36.0-255,66,7705,8,296835
28987,6.1e-05,74.125.24.0-255,4320,12025,8,296835
28988,6.4e-05,172.31.36.0-255,66,12091,8,296835
28989,0.000114,74.125.24.0-255,1484,13575,8,296835
28990,0.000117,172.31.36.0-255,66,13641,8,296835
28991,0.000147,172.31.36.0-255,66,13707,8,296835
28992,0.000159,172.31.36.0-255,66,13773,8,296835
28993,0.000186,74.125.24.0-255,4320,18093,8,296835
28994,0.000189,172.31.36.0-255,66,18159,8,296835
28995,0.000213,74.125.24.0-255,5738,23897,8,296835
28996,0.000216,172.31.36.0-255,66,23963,8,296835
28997,0.000233,74.125.24.0-255,1484,25447,8,296835
28998,0.000235,172.31.36.0-255,66,25513,8,296835
28999,0.000251,74.125.24.0-255,5020,30533,8,296835
29000,0.000254,172.31.36.0-255,66,30599,8,296835
29001,0.000434,74.125.24.0-255,1484,32083,8,296835
29002,0.000439,172.31.36.0-255,66,32149,8,296835
29003,0.000444,74.125.24.0-255,1484,33633,8,296835
29004,0.000446,172.31.36.0-255,66,33699,8,296835
29005,0.000462,74.125.24.0-255,1484,35183,8,296835
29006,0.000465,172.31.36.0-255,66,35249,8,296835
29007,0.000472,74.125.24.0-255,5738,40987,8,296835
29008,0.000474,172.31.36.0-255,66,41053,8,296835
29009,0.000505,74.125.24.0-255,7067,48120,8,296835
29010,0.000508,172.31.36.0-255,66,48186,8,296835
29011,0.000511,74.125.24.0-255,135,48321,8,296835
29012,0.000674,74.125.24.0-255,1484,49805,8,296835
29013,0.000678,172.31.36.0-255,66,49871,8,296835
29014,0.000685,74.125.24.0-255,2902,52773,8,296835
29015,0.000688,172.31.36.0-255,66,52839,8,296835
29016,0.000693,74.125.24.0-255,4320,57159,8,296835
29017,0.000696,172.31.36.0-255,66,57225,8,296835
29018,0.000714,74.125.24.0-255,1484,58709,8,296835
29019,0.000725,172.31.36.0-255,66,58775,8,296835
29020,0.000743,74.125.24.0-255,2902,61677,8,296835
29021,0.000745,172.31.36.0-255,66,61743,8,296835
29022,0.00076,74.125.24.0-255,2902,64645,8,296835
29023,0.000764,172.31.36.0-255,66,64711,8,296835
29024,0.000795,172.31.36.0-255,66,64777,8,296835
29025,0.000811,74.125.24.0-255,1484,66261,8,296835
29026,0.000832,74.125.24.0-255,2902,69163,8,296835
29027,0.000835,172.31.36.0-255,66,69229,8,296835
29028,0.000841,74.125.24.0-255,4320,73549,8,296835
29029,0.000843,172.31.36.0-255,66,73615,8,296835
29030,0.000855,74.125.24.0-255,1484,75099,8,296835
29031,0.000863,74.125.24.0-255,7156,82255,8,296835
29032,0.000865,172.31.36.0-255,66,82321,8,296835
29033,0.000896,74.125.24.0-255,5738,88059,8,296835
29034,0.000899,172.31.36.0-255,66,88125,8,296835
29035,0.000904,74.125.24.0-255,2902,91027,8,296835
29036,0.000906,172.31.36.0-255,66,91093,8,296835
29037,0.000913,74.125.24.0-255,7156,98249,8,296835
29038,0.000916,172.31.36.0-255,66,98315,8,296835
29039,0.000932,74.125.24.0-255,766,99081,8,296835
29040,0.001422,74.125.24.0-255,1484,100565,8,296835
29041,0.001427,172.31.36.0-255,66,100631,8,296835
29042,0.001433,74.125.24.0-255,2902,103533,8,296835
29043,0.001435,172.31.36.0-255,66,103599,8,296835
29044,0.001441,74.125.24.0-255,4320,107919,8,296835
29045,0.001443,172.31.36.0-255,66,107985,8,296835
29046,0.001471,74.125.24.0-255,1484,109469,8,296835
29047,0.001485,172.31.36.0-255,66,109535,8,296835
29048,0.001495,172.31.36.0-255,66,109601,8,296835
29049,0.001513,74.125.24.0-255,2184,111785,8,296835
29050,0.001515,172.31.36.0-255,66,111851,8,296835
29051,0.001537,74.125.24.0-255,2902,114753,8,296835
29052,0.00154,172.31.36.0-255,66,114819,8,296835
29053,0.001548,74.125.24.0-255,7156,121975,8,296835
29054,0.00155,172.31.36.0-255,66,122041,8,296835
29055,0.001565,74.125.24.0-255,2902,124943,8,296835
29056,0.001568,172.31.36.0-255,66,125009,8,296835
29057,0.001589,172.31.36.0-255,66,125075,8,296835
29058,0.001611,74.125.24.0-255,2902,127977,8,296835
29059,0.001614,172.31.36.0-255,66,128043,8,296835
29060,0.001617,74.125.24.0-255,1484,129527,8,296835
29061,0.00164,74.125.24.0-255,6438,135965,8,296835
29062,0.001642,172.31.36.0-255,66,136031,8,296835
29063,0.001681,172.31.36.0-255,66,136097,8,296835
29064,0.001685,74.125.24.0-255,2902,138999,8,296835
29065,0.001687,172.31.36.0-255,66,139065,8,296835
29066,0.001727,172.31.36.0-255,66,139131,8,296835
29067,0.001767,74.125.24.0-255,5738,144869,8,296835
29068,0.00177,172.31.36.0-255,66,144935,8,296835
29069,0.00179,74.125.24.0-255,3602,148537,8,296835
29070,0.001793,172.31.36.0-255,66,148603,8,296835
29071,0.001798,74.125.24.0-255,4320,152923,8,296835
29072,0.001801,172.31.36.0-255,66,152989,8,296835
29073,0.001807,74.125.24.0-255,5738,158727,8,296835
29074,0.00181,172.31.36.0-255,66,158793,8,296835
29075,0.001828,172.31.36.0-255,66,158859,8,296835
29076,0.001836,74.125.24.0-255,7156,166015,8,296835
29077,0.001838,172.31.36.0-255,66,166081,8,296835
29078,0.001857,74.125.24.0-255,2902,168983,8,296835
29079,0.00186,172.31.36.0-255,66,169049,8,296835
29080,0.001886,74.125.24.0-255,2184,171233,8,296835
29081,0.001891,172.31.36.0-255,66,171299,8,296835
29082,0.00197,74.125.24.0-255,1484,172783,8,296835
29083,0.001973,74.125.24.0-255,1484,174267,8,296835
29084,0.001979,172.31.36.0-255,66,174333,8,296835
29085,0.001987,74.125.24.0-255,1484,175817,8,296835
29086,0.001992,74.125.24.0-255,2902,178719,8,296835
29087,0.001995,172.31.36.0-255,66,178785,8,296835
29088,0.002017,74.125.24.0-255,2902,181687,8,296835
29089,0.002024,74.125.24.0-255,5738,187425,8,296835
29090,0.002028,172.31.36.0-255,66,187491,8,296835
29091,0.002032,172.31.36.0-255,66,187557,8,296835
29092,0.002052,74.125.24.0-255,7156,194713,8,296835
29093,0.002055,172.31.36.0-255,66,194779,8,296835
29094,0.002061,74.125.24.0-255,5738,200517,8,296835
29095,0.002063,172.31.36.0-255,66,200583,8,296835
29096,0.002104,74.125.24.0-255,5020,205603,8,296835
29097,0.002108,172.31.36.0-255,66,205669,8,296835
29098,0.002111,74.125.24.0-255,1484,207153,8,296835
29099,0.002114,74.125.24.0-255,1484,208637,8,296835
29100,0.002116,172.31.36.0-255,66,208703,8,296835
29101,0.002129,74.125.24.0-255,1484,210187,8,296835
29102,0.002145,74.125.24.0-255,5738,215925,8,296835
29103,0.002147,172.31.36.0-255,66,215991,8,296835
29104,0.002164,74.125.24.0-255,1484,217475,8,296835
29105,0.002183,74.125.24.0-255,5738,223213,8,296835
29106,0.002186,172.31.36.0-255,66,223279,8,296835
29107,0.002208,74.125.24.0-255,5738,229017,8,296835
29108,0.002211,172.31.36.0-255,66,229083,8,296835
29109,0.002224,172.31.36.0-255,66,229149,8,296835
29110,0.002276,74.125.24.0-255,1484,230633,8,296835
29111,0.002306,74.125.24.0-255,2902,233535,8,296835
29112,0.002308,172.31.36.0-255,66,233601,8,296835
29113,0.002315,74.125.24.0-255,5738,239339,8,296835
29114,0.002318,172.31.36.0-255,66,239405,8,296835
29115,0.002322,74.125.24.0-255,2902,242307,8,296835
29116,0.002325,172.31.36.0-255,66,242373,8,296835
29117,0.002337,172.31.36.0-255,66,242439,8,296835
29118,0.002344,74.125.24.0-255,7156,249595,8,296835
29119,0.002347,172.31.36.0-255,66,249661,8,296835
29120,0.002373,74.125.24.0-255,3602,253263,8,296835
29121,0.002375,172.31.36.0-255,66,253329,8,296835
29122,0.004726,74.125.24.0-255,5738,259067,8,296835
29123,0.004735,172.31.36.0-255,66,259133,8,296835
29124,0.007109,74.125.24.0-255,4320,263453,8,296835
29125,0.007112,172.31.36.0-255,66,263519,8,296835
29126,0.007144,74.125.24.0-255,1484,265003,8,296835
29127,0.009451,74.125.24.0-255,4320,269323,8,296835
29128,0.009458,172.31.36.0-255,66,269389,8,296835
29129,0.011846,74.125.24.0-255,5738,275127,8,296835
29130,0.011854,172.31.36.0-255,66,275193,8,296835
29131,0.014236,74.125.24.0-255,5738,280931,8,296835
29132,0.014245,172.31.36.0-255,66,280997,8,296835
29133,0.016594,74.125.24.0-255,5738,286735,8,296835
29134,0.016603,172.31.36.0-255,66,286801,8,296835
29135,0.018959,74.125.24.0-255,5738,292539,8,296835
29136,0.018968,172.31.36.0-255,66,292605,8,296835
29137,0.021291,74.125.24.0-255,1003,293608,8,296835
29138,0.023151,172.31.36.0-255,66,293674,8,296835
29139,0.023189,172.31.36.0-255,105,293779,8,296835
29140,0.025523,74.125.24.0-255,66,293845,8,296835
29141,0.036358,172.31.36.0-255,188,294033,8,296835
29142,0.036392,172.31.36.0-255,955,294988,8,296835
29143,0.036459,172.31.36.0-255,1514,296502,8,296835
29144,0.036461,172.31.36.0-255,135,296637,8,296835
29145,0.03791,104.244.42.0-255,66,296703,8,296835
29146,0.03796,104.244.42.0-255,66,296769,8,296835
29147,0.038094,104.244.42.0-255,66,296835,8,296835
29148,0.0,172.217.194.0-255,153,153,8,292349
29149,1.4e-05,172.31.36.0-255,66,219,8,292349
29150,4.4e-05,172.217.194.0-255,1484,1703,8,292349
29151,5.1e-05,172.31.36.0-255,66,1769,8,292349
29152,5.6e-05,172.217.194.0-255,2902,4671,8,292349
29153,5.9e-05,172.31.36.0-255,66,4737,8,292349
29154,6.5e-05,172.217.194.0-255,5738,10475,8,292349
29155,6.8e-05,172.31.36.0-255,66,10541,8,292349
29156,9.7e-05,172.217.194.0-255,1484,12025,8,292349
29157,0.000102,172.31.36.0-255,66,12091,8,292349
29158,0.000107,172.217.194.0-255,2073,14164,8,292349
29159,0.000109,172.31.36.0-255,66,14230,8,292349
29160,0.000442,172.217.194.0-255,1484,15714,8,292349
29161,0.000449,172.31.36.0-255,66,15780,8,292349
29162,0.000456,172.217.194.0-255,2902,18682,8,292349
29163,0.000459,172.31.36.0-255,66,18748,8,292349
29164,0.000471,172.217.194.0-255,5738,24486,8,292349
29165,0.000474,172.31.36.0-255,66,24552,8,292349
29166,0.000511,172.217.194.0-255,6797,31349,8,292349
29167,0.000514,172.31.36.0-255,66,31415,8,292349
29168,0.000584,172.217.194.0-255,1484,32899,8,292349
29169,0.000589,172.31.36.0-255,66,32965,8,292349
29170,0.000595,172.217.194.0-255,2902,35867,8,292349
29171,0.000597,172.31.36.0-255,66,35933,8,292349
29172,0.000607,172.217.194.0-255,2902,38835,8,292349
29173,0.00061,172.31.36.0-255,66,38901,8,292349
29174,0.000643,172.217.194.0-255,2902,41803,8,292349
29175,0.000647,172.31.36.0-255,66,41869,8,292349
29176,0.000663,172.31.36.0-255,66,41935,8,292349
29177,0.000674,172.31.36.0-255,66,42001,8,292349
29178,0.000677,172.217.194.0-255,364,42365,8,292349
29179,0.000844,172.217.194.0-255,379,42744,8,292349
29180,0.001132,172.31.36.0-255,66,42810,8,292349
29181,0.001166,172.217.194.0-255,1484,44294,8,292349
29182,0.001171,172.217.194.0-255,2902,47196,8,292349
29183,0.001176,172.31.36.0-255,66,47262,8,292349
29184,0.00119,172.217.194.0-255,5738,53000,8,292349
29185,0.001197,172.31.36.0-255,66,53066,8,292349
29186,0.001236,172.31.36.0-255,66,53132,8,292349
29187,0.001271,172.31.36.0-255,66,53198,8,292349
29188,0.001388,172.217.194.0-255,1484,54682,8,292349
29189,0.001393,172.217.194.0-255,2902,57584,8,292349
29190,0.001397,172.31.36.0-255,66,57650,8,292349
29191,0.001402,172.217.194.0-255,2902,60552,8,292349
29192,0.001404,172.31.36.0-255,66,60618,8,292349
29193,0.001424,172.217.194.0-255,2902,63520,8,292349
29194,0.001426,172.31.36.0-255,66,63586,8,292349
29195,0.001429,172.217.194.0-255,1484,65070,8,292349
29196,0.001439,172.31.36.0-255,66,65136,8,292349
29197,0.001465,172.217.194.0-255,5738,70874,8,292349
29198,0.001467,172.31.36.0-255,66,70940,8,292349
29199,0.0015,172.31.36.0-255,66,71006,8,292349
29200,0.00153,172.217.194.0-255,7156,78162,8,292349
29201,0.001533,172.31.36.0-255,66,78228,8,292349
29202,0.001543,172.31.36.0-255,66,78294,8,292349
29203,0.001554,172.217.194.0-255,5738,84032,8,292349
29204,0.001556,172.31.36.0-255,66,84098,8,292349
29205,0.001596,172.31.36.0-255,66,84164,8,292349
29206,0.001598,172.217.194.0-255,766,84930,8,292349
29207,0.001641,172.217.194.0-255,1484,86414,8,292349
29208,0.001644,172.217.194.0-255,1484,87898,8,292349
29209,0.001649,172.31.36.0-255,66,87964,8,292349
29210,0.001658,172.217.194.0-255,1484,89448,8,292349
29211,0.001661,172.31.36.0-255,66,89514,8,292349
29212,0.001672,172.217.194.0-255,4320,93834,8,292349
29213,0.001676,172.31.36.0-255,66,93900,8,292349
29214,0.001682,172.217.194.0-255,5738,99638,8,292349
29215,0.001684,172.31.36.0-255,66,99704,8,292349
29216,0.001687,172.217.194.0-255,1484,101188,8,292349
29217,0.001727,172.31.36.0-255,66,101254,8,292349
29218,0.001737,172.31.36.0-255,66,101320,8,292349
29219,0.001825,172.217.194.0-255,1484,102804,8,292349
29220,0.001831,172.217.194.0-255,2902,105706,8,292349
29221,0.001834,172.31.36.0-255,66,105772,8,292349
29222,0.001839,172.217.194.0-255,1484,107256,8,292349
29223,0.001868,172.217.194.0-255,4320,111576,8,292349
29224,0.001871,172.31.36.0-255,66,111642,8,292349
29225,0.001884,172.31.36.0-255,66,111708,8,292349
29226,0.001913,172.217.194.0-255,1484,113192,8,292349
29227,0.001927,172.31.36.0-255,66,113258,8,292349
29228,0.00193,172.217.194.0-255,766,114024,8,292349
29229,0.001992,172.217.194.0-255,1484,115508,8,292349
29230,0.001997,172.31.36.0-255,66,115574,8,292349
29231,0.002003,172.217.194.0-255,2902,118476,8,292349
29232,0.002005,172.31.36.0-255,66,118542,8,292349
29233,0.002016,172.217.194.0-255,5738,124280,8,292349
29234,0.002019,172.31.36.0-255,66,124346,8,292349
29235,0.002054,172.217.194.0-255,5738,130084,8,292349
29236,0.002057,172.31.36.0-255,66,130150,8,292349
29237,0.002096,172.217.194.0-255,7156,137306,8,292349
29238,0.0021,172.31.36.0-255,66,137372,8,292349
29239,0.002112,172.31.36.0-255,66,137438,8,292349
29240,0.002115,172.217.194.0-255,766,138204,8,292349
29241,0.003713,172.31.36.0-255,66,138270,8,292349
29242,0.004438,172.217.194.0-255,4320,142590,8,292349
29243,0.004444,172.31.36.0-255,66,142656,8,292349
29244,0.00604,172.217.194.0-255,1484,144140,8,292349
29245,0.006799,172.217.194.0-255,4320,148460,8,292349
29246,0.006803,172.31.36.0-255,66,148526,8,292349
29247,0.009131,172.217.194.0-255,5738,154264,8,292349
29248,0.009138,172.31.36.0-255,66,154330,8,292349
29249,0.01147,172.217.194.0-255,5738,160068,8,292349
29250,0.011477,172.31.36.0-255,66,160134,8,292349
29251,0.013857,172.217.194.0-255,5738,165872,8,292349
29252,0.013864,172.31.36.0-255,66,165938,8,292349
29253,0.016221,172.217.194.0-255,5738,171676,8,292349
29254,0.016227,172.31.36.0-255,66,171742,8,292349
29255,0.018553,172.217.194.0-255,5738,177480,8,292349
29256,0.018561,172.31.36.0-255,66,177546,8,292349
29257,0.020867,172.217.194.0-255,5738,183284,8,292349
29258,0.020874,172.31.36.0-255,66,183350,8,292349
29259,0.023207,172.217.194.0-255,5738,189088,8,292349
29260,0.023215,172.31.36.0-255,66,189154,8,292349
29261,0.02553,172.217.194.0-255,5738,194892,8,292349
29262,0.025536,172.31.36.0-255,66,194958,8,292349
29263,0.027886,172.217.194.0-255,5738,200696,8,292349
29264,0.027893,172.31.36.0-255,66,200762,8,292349
29265,0.030234,172.217.194.0-255,5738,206500,8,292349
29266,0.030242,172.31.36.0-255,66,206566,8,292349
29267,0.032569,172.217.194.0-255,5738,212304,8,292349
29268,0.032577,172.31.36.0-255,66,212370,8,292349
29269,0.033774,172.31.36.0-255,172,212542,8,292349
29270,0.033859,172.31.36.0-255,1111,213653,8,292349
29271,0.034126,172.31.36.0-255,1514,215167,8,292349
29272,0.034129,172.31.36.0-255,1514,216681,8,292349
29273,0.03413,172.31.36.0-255,1514,218195,8,292349
29274,0.034135,172.31.36.0-255,1514,219709,8,292349
29275,0.034136,172.31.36.0-255,1514,221223,8,292349
29276,0.034137,172.31.36.0-255,636,221859,8,292349
29277,0.034872,172.217.194.0-255,5738,227597,8,292349
29278,0.034879,172.31.36.0-255,66,227663,8,292349
29279,0.035311,104.244.42.0-255,66,227729,8,292349
29280,0.035389,104.244.42.0-255,66,227795,8,292349
29281,0.035675,104.244.42.0-255,66,227861,8,292349
29282,0.03568,104.244.42.0-255,66,227927,8,292349
29283,0.037194,172.217.194.0-255,4320,232247,8,292349
29284,0.037199,172.31.36.0-255,66,232313,8,292349
29285,0.037228,172.217.194.0-255,1484,233797,8,292349
29286,0.039544,172.217.194.0-255,4320,238117,8,292349
29287,0.039549,172.31.36.0-255,66,238183,8,292349
29288,0.041865,172.217.194.0-255,5738,243921,8,292349
29289,0.041871,172.31.36.0-255,66,243987,8,292349
29290,0.044195,172.217.194.0-255,5738,249725,8,292349
29291,0.044201,172.31.36.0-255,66,249791,8,292349
29292,0.046547,172.217.194.0-255,5738,255529,8,292349
29293,0.046552,172.31.36.0-255,66,255595,8,292349
29294,0.048888,172.217.194.0-255,5738,261333,8,292349
29295,0.048894,172.31.36.0-255,66,261399,8,292349
29296,0.051252,172.217.194.0-255,5738,267137,8,292349
29297,0.051255,172.31.36.0-255,66,267203,8,292349
29298,0.053624,172.217.194.0-255,2902,270105,8,292349
29299,0.053632,172.31.36.0-255,66,270171,8,292349
29300,0.053669,172.217.194.0-255,2902,273073,8,292349
29301,0.053673,172.31.36.0-255,66,273139,8,292349
29302,0.055933,172.217.194.0-255,2902,276041,8,292349
29303,0.055937,172.31.36.0-255,66,276107,8,292349
29304,0.055982,172.217.194.0-255,2902,279009,8,292349
29305,0.055985,172.31.36.0-255,66,279075,8,292349
29306,0.058314,172.217.194.0-255,5738,284813,8,292349
29307,0.058319,172.31.36.0-255,66,284879,8,292349
29308,0.060657,172.217.194.0-255,5738,290617,8,292349
29309,0.060662,172.31.36.0-255,66,290683,8,292349
29310,0.062982,172.217.194.0-255,1429,292112,8,292349
29311,0.063133,172.31.36.0-255,66,292178,8,292349
29312,0.063161,172.31.36.0-255,105,292283,8,292349
29313,0.065418,172.217.194.0-255,66,292349,8,292349
29314,0.0,74.125.200.0-255,153,153,8,393382
29315,2.8e-05,172.31.36.0-255,66,219,8,393382
29316,3.5e-05,74.125.200.0-255,1484,1703,8,393382
29317,4e-05,172.31.36.0-255,66,1769,8,393382
29318,4.4e-05,74.125.200.0-255,2902,4671,8,393382
29319,4.7e-05,172.31.36.0-255,66,4737,8,393382
29320,7.2e-05,74.125.200.0-255,4320,9057,8,393382
29321,7.4e-05,172.31.36.0-255,66,9123,8,393382
29322,9.5e-05,74.125.200.0-255,4856,13979,8,393382
29323,9.9e-05,172.31.36.0-255,66,14045,8,393382
29324,0.000153,74.125.200.0-255,1484,15529,8,393382
29325,0.000157,172.31.36.0-255,66,15595,8,393382
29326,0.000162,74.125.200.0-255,2902,18497,8,393382
29327,0.000164,172.31.36.0-255,66,18563,8,393382
29328,0.000178,74.125.200.0-255,2902,21465,8,393382
29329,0.000181,172.31.36.0-255,66,21531,8,393382
29330,0.000186,74.125.200.0-255,1484,23015,8,393382
29331,0.000188,172.31.36.0-255,66,23081,8,393382
29332,0.00021,74.125.200.0-255,2902,25983,8,393382
29333,0.000213,172.31.36.0-255,66,26049,8,393382
29334,0.000243,74.125.200.0-255,5379,31428,8,393382
29335,0.000247,172.31.36.0-255,66,31494,8,393382
29336,0.00032,74.125.200.0-255,1484,32978,8,393382
29337,0.000324,172.31.36.0-255,66,33044,8,393382
29338,0.000342,74.125.200.0-255,2902,35946,8,393382
29339,0.000345,172.31.36.0-255,66,36012,8,393382
29340,0.000367,74.125.200.0-255,5738,41750,8,393382
29341,0.00037,172.31.36.0-255,66,41816,8,393382
29342,0.000384,74.125.200.0-255,4320,46136,8,393382
29343,0.000387,172.31.36.0-255,66,46202,8,393382
29344,0.000421,74.125.200.0-255,2543,48745,8,393382
29345,0.000427,172.31.36.0-255,66,48811,8,393382
29346,0.000429,74.125.200.0-255,7156,55967,8,393382
29347,0.000431,172.31.36.0-255,66,56033,8,393382
29348,0.000435,74.125.200.0-255,2902,58935,8,393382
29349,0.000437,172.31.36.0-255,66,59001,8,393382
29350,0.000456,74.125.200.0-255,7103,66104,8,393382
29351,0.000459,172.31.36.0-255,66,66170,8,393382
29352,0.000478,74.125.200.0-255,115,66285,8,393382
29353,0.000632,74.125.200.0-255,1484,67769,8,393382
29354,0.000636,172.31.36.0-255,66,67835,8,393382
29355,0.000641,74.125.200.0-255,2902,70737,8,393382
29356,0.000644,172.31.36.0-255,66,70803,8,393382
29357,0.000658,74.125.200.0-255,2902,73705,8,393382
29358,0.000661,172.31.36.0-255,66,73771,8,393382
29359,0.000683,74.125.200.0-255,2902,76673,8,393382
29360,0.000686,74.125.200.0-255,2902,79575,8,393382
29361,0.000687,172.31.36.0-255,66,79641,8,393382
29362,0.000691,172.31.36.0-255,66,79707,8,393382
29363,0.000713,74.125.200.0-255,6797,86504,8,393382
29364,0.000716,172.31.36.0-255,66,86570,8,393382
29365,0.000727,172.31.36.0-255,66,86636,8,393382
29366,0.000746,74.125.200.0-255,3961,90597,8,393382
29367,0.000749,172.31.36.0-255,66,90663,8,393382
29368,0.000761,74.125.200.0-255,331,90994,8,393382
29369,0.001024,74.125.200.0-255,1484,92478,8,393382
29370,0.001028,172.31.36.0-255,66,92544,8,393382
29371,0.001031,74.125.200.0-255,1484,94028,8,393382
29372,0.001047,74.125.200.0-255,1484,95512,8,393382
29373,0.00105,74.125.200.0-255,2902,98414,8,393382
29374,0.00105,172.31.36.0-255,66,98480,8,393382
29375,0.001054,172.31.36.0-255,66,98546,8,393382
29376,0.001061,74.125.200.0-255,2902,101448,8,393382
29377,0.001063,172.31.36.0-255,66,101514,8,393382
29378,0.001082,74.125.200.0-255,4320,105834,8,393382
29379,0.001084,172.31.36.0-255,66,105900,8,393382
29380,0.001117,172.31.36.0-255,66,105966,8,393382
29381,0.001123,74.125.200.0-255,5738,111704,8,393382
29382,0.001124,172.31.36.0-255,66,111770,8,393382
29383,0.001166,74.125.200.0-255,4471,116241,8,393382
29384,0.001169,172.31.36.0-255,66,116307,8,393382
29385,0.001222,74.125.200.0-255,1484,117791,8,393382
29386,0.00124,74.125.200.0-255,1484,119275,8,393382
29387,0.001243,172.31.36.0-255,66,119341,8,393382
29388,0.001259,74.125.200.0-255,1484,120825,8,393382
29389,0.001261,74.125.200.0-255,1484,122309,8,393382
29390,0.001263,172.31.36.0-255,66,122375,8,393382
29391,0.00128,74.125.200.0-255,2902,125277,8,393382
29392,0.001283,172.31.36.0-255,66,125343,8,393382
29393,0.001286,74.125.200.0-255,2902,128245,8,393382
29394,0.001288,172.31.36.0-255,66,128311,8,393382
29395,0.001308,74.125.200.0-255,2902,131213,8,393382
29396,0.00131,172.31.36.0-255,66,131279,8,393382
29397,0.001313,74.125.200.0-255,1484,132763,8,393382
29398,0.001328,74.125.200.0-255,2902,135665,8,393382
29399,0.00133,172.31.36.0-255,66,135731,8,393382
29400,0.001364,74.125.200.0-255,4320,140051,8,393382
29401,0.001367,172.31.36.0-255,66,140117,8,393382
29402,0.001385,74.125.200.0-255,1484,141601,8,393382
29403,0.001391,74.125.200.0-255,5738,147339,8,393382
29404,0.001392,172.31.36.0-255,66,147405,8,393382
29405,0.00141,74.125.200.0-255,3602,151007,8,393382
29406,0.001412,172.31.36.0-255,66,151073,8,393382
29407,0.001717,74.125.200.0-255,1484,152557,8,393382
29408,0.001725,74.125.200.0-255,2902,155459,8,393382
29409,0.001728,172.31.36.0-255,66,155525,8,393382
29410,0.001732,74.125.200.0-255,1484,157009,8,393382
29411,0.001751,74.125.200.0-255,4320,161329,8,393382
29412,0.001753,172.31.36.0-255,66,161395,8,393382
29413,0.001757,74.125.200.0-255,1484,162879,8,393382
29414,0.001787,172.31.36.0-255,66,162945,8,393382
29415,0.001807,74.125.200.0-255,4320,167265,8,393382
29416,0.001809,172.31.36.0-255,66,167331,8,393382
29417,0.001824,74.125.200.0-255,2902,170233,8,393382
29418,0.001826,172.31.36.0-255,66,170299,8,393382
29419,0.001859,74.125.200.0-255,4320,174619,8,393382
29420,0.001862,172.31.36.0-255,66,174685,8,393382
29421,0.001881,74.125.200.0-255,2184,176869,8,393382
29422,0.001884,172.31.36.0-255,66,176935,8,393382
29423,0.001903,74.125.200.0-255,4320,181255,8,393382
29424,0.001906,172.31.36.0-255,66,181321,8,393382
29425,0.001925,74.125.200.0-255,2902,184223,8,393382
29426,0.001928,172.31.36.0-255,66,184289,8,393382
29427,0.001934,74.125.200.0-255,4320,188609,8,393382
29428,0.001936,172.31.36.0-255,66,188675,8,393382
29429,0.001955,74.125.200.0-255,4320,192995,8,393382
29430,0.001957,172.31.36.0-255,66,193061,8,393382
29431,0.001962,74.125.200.0-255,2902,195963,8,393382
29432,0.001963,172.31.36.0-255,66,196029,8,393382
29433,0.001989,172.31.36.0-255,66,196095,8,393382
29434,0.002013,74.125.200.0-255,4320,200415,8,393382
29435,0.002015,172.31.36.0-255,66,200481,8,393382
29436,0.002034,74.125.200.0-255,2184,202665,8,393382
29437,0.002037,172.31.36.0-255,66,202731,8,393382
29438,0.002182,74.125.200.0-255,1484,204215,8,393382
29439,0.002189,74.125.200.0-255,2902,207117,8,393382
29440,0.002193,172.31.36.0-255,66,207183,8,393382
29441,0.002199,74.125.200.0-255,2902,210085,8,393382
29442,0.002202,172.31.36.0-255,66,210151,8,393382
29443,0.002228,74.125.200.0-255,2902,213053,8,393382
29444,0.002232,172.31.36.0-255,66,213119,8,393382
29445,0.00224,74.125.200.0-255,2902,216021,8,393382
29446,0.002242,172.31.36.0-255,66,216087,8,393382
29447,0.002247,74.125.200.0-255,4320,220407,8,393382
29448,0.002249,172.31.36.0-255,66,220473,8,393382
29449,0.002257,74.125.200.0-255,7156,227629,8,393382
29450,0.002259,172.31.36.0-255,66,227695,8,393382
29451,0.004468,74.125.200.0-255,5738,233433,8,393382
29452,0.004476,172.31.36.0-255,66,233499,8,393382
29453,0.006689,74.125.200.0-255,5738,239237,8,393382
29454,0.006695,172.31.36.0-255,66,239303,8,393382
29455,0.008902,74.125.200.0-255,2902,242205,8,393382
29456,0.008904,172.31.36.0-255,66,242271,8,393382
29457,0.008923,74.125.200.0-255,2902,245173,8,393382
29458,0.008925,172.31.36.0-255,66,245239,8,393382
29459,0.011121,74.125.200.0-255,5738,250977,8,393382
29460,0.011128,172.31.36.0-255,66,251043,8,393382
29461,0.013371,74.125.200.0-255,5738,256781,8,393382
29462,0.013379,172.31.36.0-255,66,256847,8,393382
29463,0.015592,74.125.200.0-255,5738,262585,8,393382
29464,0.015599,172.31.36.0-255,66,262651,8,393382
29465,0.017814,74.125.200.0-255,5738,268389,8,393382
29466,0.017821,172.31.36.0-255,66,268455,8,393382
29467,0.020041,74.125.200.0-255,5738,274193,8,393382
29468,0.020047,172.31.36.0-255,66,274259,8,393382
29469,0.022264,74.125.200.0-255,5738,279997,8,393382
29470,0.022272,172.31.36.0-255,66,280063,8,393382
29471,0.024497,74.125.200.0-255,5738,285801,8,393382
29472,0.024504,172.31.36.0-255,66,285867,8,393382
29473,0.026725,74.125.200.0-255,2902,288769,8,393382
29474,0.026733,172.31.36.0-255,66,288835,8,393382
29475,0.026771,74.125.200.0-255,2902,291737,8,393382
29476,0.026774,172.31.36.0-255,66,291803,8,393382
29477,0.028947,74.125.200.0-255,2902,294705,8,393382
29478,0.028955,172.31.36.0-255,66,294771,8,393382
29479,0.028988,74.125.200.0-255,2902,297673,8,393382
29480,0.028991,172.31.36.0-255,66,297739,8,393382
29481,0.031167,74.125.200.0-255,2902,300641,8,393382
29482,0.031174,172.31.36.0-255,66,300707,8,393382
29483,0.031209,74.125.200.0-255,2902,303609,8,393382
29484,0.031212,172.31.36.0-255,66,303675,8,393382
29485,0.03339,74.125.200.0-255,2902,306577,8,393382
29486,0.033397,172.31.36.0-255,66,306643,8,393382
29487,0.033473,74.125.200.0-255,2902,309545,8,393382
29488,0.033478,172.31.36.0-255,66,309611,8,393382
29489,0.035615,74.125.200.0-255,2902,312513,8,393382
29490,0.035623,172.31.36.0-255,66,312579,8,393382
29491,0.035686,74.125.200.0-255,2902,315481,8,393382
29492,0.035691,172.31.36.0-255,66,315547,8,393382
29493,0.037838,74.125.200.0-255,2902,318449,8,393382
29494,0.037846,172.31.36.0-255,66,318515,8,393382
29495,0.037902,74.125.200.0-255,2902,321417,8,393382
29496,0.037908,172.31.36.0-255,66,321483,8,393382
29497,0.040065,74.125.200.0-255,2902,324385,8,393382
29498,0.040071,172.31.36.0-255,66,324451,8,393382
29499,0.040134,74.125.200.0-255,2902,327353,8,393382
29500,0.040138,172.31.36.0-255,66,327419,8,393382
29501,0.042277,74.125.200.0-255,2902,330321,8,393382
29502,0.042303,172.31.36.0-255,66,330387,8,393382
29503,0.042348,74.125.200.0-255,2902,333289,8,393382
29504,0.042353,172.31.36.0-255,66,333355,8,393382
29505,0.04453,74.125.200.0-255,2902,336257,8,393382
29506,0.044539,172.31.36.0-255,66,336323,8,393382
29507,0.044574,74.125.200.0-255,2902,339225,8,393382
29508,0.044577,172.31.36.0-255,66,339291,8,393382
29509,0.046748,74.125.200.0-255,2902,342193,8,393382
29510,0.046755,172.31.36.0-255,66,342259,8,393382
29511,0.046802,74.125.200.0-255,2902,345161,8,393382
29512,0.046807,172.31.36.0-255,66,345227,8,393382
29513,0.046821,172.31.36.0-255,172,345399,8,393382
29514,0.046846,172.31.36.0-255,1112,346511,8,393382
29515,0.046975,172.31.36.0-255,1514,348025,8,393382
29516,0.046977,172.31.36.0-255,1514,349539,8,393382
29517,0.046978,172.31.36.0-255,1514,351053,8,393382
29518,0.046979,172.31.36.0-255,771,351824,8,393382
29519,0.0484,104.244.42.0-255,66,351890,8,393382
29520,0.048409,104.244.42.0-255,66,351956,8,393382
29521,0.048541,104.244.42.0-255,66,352022,8,393382
29522,0.048546,104.244.42.0-255,66,352088,8,393382
29523,0.04896,74.125.200.0-255,2902,354990,8,393382
29524,0.048964,172.31.36.0-255,66,355056,8,393382
29525,0.049005,74.125.200.0-255,2902,357958,8,393382
29526,0.049008,172.31.36.0-255,66,358024,8,393382
29527,0.051169,74.125.200.0-255,2902,360926,8,393382
29528,0.051174,172.31.36.0-255,66,360992,8,393382
29529,0.051203,74.125.200.0-255,1484,362476,8,393382
29530,0.05122,74.125.200.0-255,1484,363960,8,393382
29531,0.051223,172.31.36.0-255,66,364026,8,393382
29532,0.053385,74.125.200.0-255,2902,366928,8,393382
29533,0.053391,172.31.36.0-255,66,366994,8,393382
29534,0.053428,74.125.200.0-255,2902,369896,8,393382
29535,0.053431,172.31.36.0-255,66,369962,8,393382
29536,0.055604,74.125.200.0-255,2902,372864,8,393382
29537,0.055611,172.31.36.0-255,66,372930,8,393382
29538,0.055631,74.125.200.0-255,2902,375832,8,393382
29539,0.055634,172.31.36.0-255,66,375898,8,393382
29540,0.057808,74.125.200.0-255,2902,378800,8,393382
29541,0.057814,172.31.36.0-255,66,378866,8,393382
29542,0.057843,74.125.200.0-255,2902,381768,8,393382
29543,0.057846,172.31.36.0-255,66,381834,8,393382
29544,0.060022,74.125.200.0-255,2902,384736,8,393382
29545,0.060027,172.31.36.0-255,66,384802,8,393382
29546,0.060056,74.125.200.0-255,2902,387704,8,393382
29547,0.060059,172.31.36.0-255,66,387770,8,393382
29548,0.062239,74.125.200.0-255,2902,390672,8,393382
29549,0.062245,172.31.36.0-255,66,390738,8,393382
29550,0.062278,74.125.200.0-255,2407,393145,8,393382
29551,0.062281,172.31.36.0-255,66,393211,8,393382
29552,0.062456,172.31.36.0-255,105,393316,8,393382
29553,0.064657,74.125.200.0-255,66,393382,8,393382
29554,0.0,172.217.194.0-255,153,153,8,291735
29555,3.1e-05,172.31.36.0-255,66,219,8,291735
29556,3.7e-05,172.217.194.0-255,1484,1703,8,291735
29557,4.1e-05,172.31.36.0-255,66,1769,8,291735
29558,4.5e-05,172.217.194.0-255,2902,4671,8,291735
29559,4.7e-05,172.31.36.0-255,66,4737,8,291735
29560,6e-05,172.217.194.0-255,2902,7639,8,291735
29561,6.2e-05,172.31.36.0-255,66,7705,8,291735
29562,8.2e-05,172.217.194.0-255,4320,12025,8,291735
29563,8.4e-05,172.31.36.0-255,66,12091,8,291735
29564,8.7e-05,172.217.194.0-255,1948,14039,8,291735
29565,9e-05,172.31.36.0-255,66,14105,8,291735
29566,0.000165,172.217.194.0-255,1484,15589,8,291735
29567,0.000168,172.31.36.0-255,66,15655,8,291735
29568,0.000182,172.217.194.0-255,2902,18557,8,291735
29569,0.000185,172.31.36.0-255,66,18623,8,291735
29570,0.000211,172.217.194.0-255,5738,24361,8,291735
29571,0.000213,172.31.36.0-255,66,24427,8,291735
29572,0.00023,172.217.194.0-255,5738,30165,8,291735
29573,0.000232,172.31.36.0-255,66,30231,8,291735
29574,0.000251,172.217.194.0-255,1125,31356,8,291735
29575,0.000254,172.31.36.0-255,66,31422,8,291735
29576,0.000272,172.217.194.0-255,4320,35742,8,291735
29577,0.000275,172.31.36.0-255,66,35808,8,291735
29578,0.000296,172.217.194.0-255,2902,38710,8,291735
29579,0.000299,172.31.36.0-255,66,38776,8,291735
29580,0.000305,172.217.194.0-255,7156,45932,8,291735
29581,0.000307,172.31.36.0-255,66,45998,8,291735
29582,0.000332,172.217.194.0-255,2543,48541,8,291735
29583,0.000335,172.31.36.0-255,66,48607,8,291735
29584,0.000665,172.217.194.0-255,1484,50091,8,291735
29585,0.00067,172.31.36.0-255,66,50157,8,291735
29586,0.000678,172.217.194.0-255,2902,53059,8,291735
29587,0.00068,172.31.36.0-255,66,53125,8,291735
29588,0.000685,172.217.194.0-255,4320,57445,8,291735
29589,0.000687,172.31.36.0-255,66,57511,8,291735
29590,0.00069,172.217.194.0-255,1484,58995,8,291735
29591,0.000719,172.217.194.0-255,4320,63315,8,291735
29592,0.000721,172.31.36.0-255,66,63381,8,291735
29593,0.00074,172.217.194.0-255,2543,65924,8,291735
29594,0.000742,172.31.36.0-255,66,65990,8,291735
29595,0.000777,172.217.194.0-255,2902,68892,8,291735
29596,0.000779,172.31.36.0-255,66,68958,8,291735
29597,0.000784,172.217.194.0-255,2902,71860,8,291735
29598,0.000785,172.31.36.0-255,66,71926,8,291735
29599,0.000808,172.217.194.0-255,7156,79082,8,291735
29600,0.00081,172.31.36.0-255,66,79148,8,291735
29601,0.000845,172.217.194.0-255,7156,86304,8,291735
29602,0.000848,172.31.36.0-255,66,86370,8,291735
29603,0.000871,172.31.36.0-255,66,86436,8,291735
29604,0.000876,172.217.194.0-255,3961,90397,8,291735
29605,0.000879,172.31.36.0-255,66,90463,8,291735
29606,0.000918,172.217.194.0-255,1484,91947,8,291735
29607,0.000924,172.217.194.0-255,2902,94849,8,291735
29608,0.000927,172.31.36.0-255,66,94915,8,291735
29609,0.000932,172.217.194.0-255,5738,100653,8,291735
29610,0.000934,172.31.36.0-255,66,100719,8,291735
29611,0.000967,172.31.36.0-255,66,100785,8,291735
29612,0.000997,172.217.194.0-255,1484,102269,8,291735
29613,0.001009,172.217.194.0-255,4320,106589,8,291735
29614,0.001013,172.31.36.0-255,66,106655,8,291735
29615,0.001036,172.217.194.0-255,6438,113093,8,291735
29616,0.001039,172.31.36.0-255,66,113159,8,291735
29617,0.001411,172.217.194.0-255,1484,114643,8,291735
29618,0.001425,172.217.194.0-255,2902,117545,8,291735
29619,0.001428,172.31.36.0-255,66,117611,8,291735
29620,0.001451,172.217.194.0-255,5738,123349,8,291735
29621,0.001454,172.31.36.0-255,66,123415,8,291735
29622,0.001458,172.217.194.0-255,4320,127735,8,291735
29623,0.00146,172.31.36.0-255,66,127801,8,291735
29624,0.001483,172.31.36.0-255,66,127867,8,291735
29625,0.001487,172.217.194.0-255,2902,130769,8,291735
29626,0.001489,172.31.36.0-255,66,130835,8,291735
29627,0.001517,172.31.36.0-255,66,130901,8,291735
29628,0.001627,172.217.194.0-255,1484,132385,8,291735
29629,0.001629,172.217.194.0-255,1484,133869,8,291735
29630,0.001631,172.31.36.0-255,66,133935,8,291735
29631,0.001645,172.217.194.0-255,1484,135419,8,291735
29632,0.001658,172.217.194.0-255,4320,139739,8,291735
29633,0.00166,172.31.36.0-255,66,139805,8,291735
29634,0.001676,172.217.194.0-255,1484,141289,8,291735
29635,0.00168,172.217.194.0-255,2902,144191,8,291735
29636,0.001682,172.31.36.0-255,66,144257,8,291735
29637,0.001697,172.217.194.0-255,7156,151413,8,291735
29638,0.001699,172.31.36.0-255,66,151479,8,291735
29639,0.00172,172.217.194.0-255,2902,154381,8,291735
29640,0.001721,172.31.36.0-255,66,154447,8,291735
29641,0.00173,172.31.36.0-255,66,154513,8,291735
29642,0.001734,172.217.194.0-255,2184,156697,8,291735
29643,0.001736,172.31.36.0-255,66,156763,8,291735
29644,0.001769,172.217.194.0-255,2902,159665,8,291735
29645,0.001771,172.31.36.0-255,66,159731,8,291735
29646,0.001791,172.217.194.0-255,2902,162633,8,291735
29647,0.001793,172.31.36.0-255,66,162699,8,291735
29648,0.001823,172.217.194.0-255,7156,169855,8,291735
29649,0.001825,172.31.36.0-255,66,169921,8,291735
29650,0.00184,172.217.194.0-255,2902,172823,8,291735
29651,0.001842,172.31.36.0-255,66,172889,8,291735
29652,0.001865,172.31.36.0-255,66,172955,8,291735
29653,0.001903,172.217.194.0-255,5020,177975,8,291735
29654,0.001905,172.31.36.0-255,66,178041,8,291735
29655,0.001973,172.217.194.0-255,1484,179525,8,291735
29656,0.001996,172.217.194.0-255,1484,181009,8,291735
29657,0.001998,172.31.36.0-255,66,181075,8,291735
29658,0.002015,172.217.194.0-255,1484,182559,8,291735
29659,0.00202,172.217.194.0-255,5738,188297,8,291735
29660,0.002022,172.31.36.0-255,66,188363,8,291735
29661,0.002047,172.217.194.0-255,2902,191265,8,291735
29662,0.002049,172.31.36.0-255,66,191331,8,291735
29663,0.002076,172.31.36.0-255,66,191397,8,291735
29664,0.002082,172.217.194.0-255,7156,198553,8,291735
29665,0.002084,172.31.36.0-255,66,198619,8,291735
29666,0.002097,172.217.194.0-255,5020,203639,8,291735
29667,0.002099,172.31.36.0-255,66,203705,8,291735
29668,0.002157,172.217.194.0-255,1484,205189,8,291735
29669,0.002172,172.217.194.0-255,1484,206673,8,291735
29670,0.002174,172.31.36.0-255,66,206739,8,291735
29671,0.002193,172.217.194.0-255,1484,208223,8,291735
29672,0.002198,172.217.194.0-255,5738,213961,8,291735
29673,0.0022,172.31.36.0-255,66,214027,8,291735
29674,0.002232,172.217.194.0-255,2902,216929,8,291735
29675,0.002234,172.31.36.0-255,66,216995,8,291735
29676,0.002259,172.217.194.0-255,2902,219897,8,291735
29677,0.002261,172.31.36.0-255,66,219963,8,291735
29678,0.002274,172.31.36.0-255,66,220029,8,291735
29679,0.002276,172.217.194.0-255,766,220795,8,291735
29680,0.002316,172.217.194.0-255,1484,222279,8,291735
29681,0.002318,172.31.36.0-255,66,222345,8,291735
29682,0.002334,172.217.194.0-255,2902,225247,8,291735
29683,0.002336,172.31.36.0-255,66,225313,8,291735
29684,0.002349,172.217.194.0-255,1484,226797,8,291735
29685,0.002367,172.217.194.0-255,4320,231117,8,291735
29686,0.002369,172.31.36.0-255,66,231183,8,291735
29687,0.002373,172.217.194.0-255,2902,234085,8,291735
29688,0.002375,172.31.36.0-255,66,234151,8,291735
29689,0.002394,172.217.194.0-255,7156,241307,8,291735
29690,0.002397,172.31.36.0-255,66,241373,8,291735
29691,0.002407,172.217.194.0-255,2902,244275,8,291735
29692,0.002409,172.31.36.0-255,66,244341,8,291735
29693,0.002422,172.217.194.0-255,4320,248661,8,291735
29694,0.002424,172.31.36.0-255,66,248727,8,291735
29695,0.002443,172.217.194.0-255,5738,254465,8,291735
29696,0.002445,172.31.36.0-255,66,254531,8,291735
29697,0.00247,172.217.194.0-255,4320,258851,8,291735
29698,0.002471,172.31.36.0-255,66,258917,8,291735
29699,0.00249,172.217.194.0-255,7156,266073,8,291735
29700,0.002492,172.31.36.0-255,66,266139,8,291735
29701,0.002516,172.217.194.0-255,2184,268323,8,291735
29702,0.002518,172.31.36.0-255,66,268389,8,291735
29703,0.002528,172.31.36.0-255,66,268455,8,291735
29704,0.002551,172.217.194.0-255,2902,271357,8,291735
29705,0.002553,172.31.36.0-255,66,271423,8,291735
29706,0.002558,172.217.194.0-255,6438,277861,8,291735
29707,0.00256,172.31.36.0-255,66,277927,8,291735
29708,0.002605,172.217.194.0-255,2902,280829,8,291735
29709,0.002607,172.31.36.0-255,66,280895,8,291735
29710,0.002642,172.31.36.0-255,66,280961,8,291735
29711,0.002644,172.217.194.0-255,1484,282445,8,291735
29712,0.00266,172.31.36.0-255,66,282511,8,291735
29713,0.005207,172.217.194.0-255,105,282616,8,291735
29714,0.008349,172.31.36.0-255,66,282682,8,291735
29715,0.008377,172.31.36.0-255,105,282787,8,291735
29716,0.010945,172.217.194.0-255,66,282853,8,291735
29717,0.03371,172.31.36.0-255,176,283029,8,291735
29718,0.033746,172.31.36.0-255,1111,284140,8,291735
29719,0.033784,172.31.36.0-255,1514,285654,8,291735
29720,0.033786,172.31.36.0-255,1514,287168,8,291735
29721,0.033792,172.31.36.0-255,1514,288682,8,291735
29722,0.033793,172.31.36.0-255,1514,290196,8,291735
29723,0.033851,172.31.36.0-255,1275,291471,8,291735
29724,0.035263,104.244.42.0-255,66,291537,8,291735
29725,0.035272,104.244.42.0-255,66,291603,8,291735
29726,0.035383,104.244.42.0-255,66,291669,8,291735
29727,0.035419,104.244.42.0-255,66,291735,8,291735
29728,0.0,172.217.194.0-255,153,153,8,255084
29729,3.5e-05,172.31.36.0-255,66,219,8,255084
29730,4.1e-05,172.217.194.0-255,1484,1703,8,255084
29731,4.5e-05,172.31.36.0-255,66,1769,8,255084
29732,4.8e-05,172.217.194.0-255,1484,3253,8,255084
29733,5.1e-05,172.31.36.0-255,66,3319,8,255084
29734,7.7e-05,172.217.194.0-255,1484,4803,8,255084
29735,8e-05,172.31.36.0-255,66,4869,8,255084
29736,0.000114,172.217.194.0-255,5738,10607,8,255084
29737,0.000117,172.31.36.0-255,66,10673,8,255084
29738,0.000151,172.217.194.0-255,4883,15556,8,255084
29739,0.000154,172.31.36.0-255,66,15622,8,255084
29740,0.00021,172.217.194.0-255,2902,18524,8,255084
29741,0.000213,172.31.36.0-255,66,18590,8,255084
29742,0.00024,172.217.194.0-255,2902,21492,8,255084
29743,0.000243,172.31.36.0-255,66,21558,8,255084
29744,0.000289,172.217.194.0-255,2902,24460,8,255084
29745,0.000293,172.31.36.0-255,66,24526,8,255084
29746,0.000326,172.217.194.0-255,5738,30264,8,255084
29747,0.000329,172.31.36.0-255,66,30330,8,255084
29748,0.000416,172.217.194.0-255,4320,34650,8,255084
29749,0.000421,172.31.36.0-255,66,34716,8,255084
29750,0.000459,172.31.36.0-255,66,34782,8,255084
29751,0.00064,172.217.194.0-255,5738,40520,8,255084
29752,0.000645,172.31.36.0-255,66,40586,8,255084
29753,0.000672,172.31.36.0-255,66,40652,8,255084
29754,0.000851,172.217.194.0-255,4279,44931,8,255084
29755,0.000856,172.31.36.0-255,66,44997,8,255084
29756,0.000899,172.217.194.0-255,5738,50735,8,255084
29757,0.000902,172.31.36.0-255,66,50801,8,255084
29758,0.00093,172.31.36.0-255,66,50867,8,255084
29759,0.001137,172.217.194.0-255,2902,53769,8,255084
29760,0.001142,172.31.36.0-255,66,53835,8,255084
29761,0.00161,172.217.194.0-255,1484,55319,8,255084
29762,0.001616,172.217.194.0-255,1484,56803,8,255084
29763,0.001629,172.217.194.0-255,1484,58287,8,255084
29764,0.001676,172.217.194.0-255,5738,64025,8,255084
29765,0.001754,172.217.194.0-255,5738,69763,8,255084
29766,0.001778,172.217.194.0-255,7156,76919,8,255084
29767,0.001921,172.217.194.0-255,2902,79821,8,255084
29768,0.002072,172.217.194.0-255,5738,85559,8,255084
29769,0.002156,172.217.194.0-255,4320,89879,8,255084
29770,0.002546,172.217.194.0-255,2902,92781,8,255084
29771,0.002581,172.217.194.0-255,1484,94265,8,255084
29772,0.002596,172.217.194.0-255,1484,95749,8,255084
29773,0.002606,172.217.194.0-255,1484,97233,8,255084
29774,0.002619,172.217.194.0-255,4320,101553,8,255084
29775,0.003143,172.217.194.0-255,4320,105873,8,255084
29776,0.003156,172.217.194.0-255,5738,111611,8,255084
29777,0.003236,172.217.194.0-255,5020,116631,8,255084
29778,0.003556,172.31.36.0-255,66,116697,8,255084
29779,0.005941,172.217.194.0-255,5738,122435,8,255084
29780,0.005947,172.31.36.0-255,66,122501,8,255084
29781,0.008336,172.217.194.0-255,5738,128239,8,255084
29782,0.008341,172.31.36.0-255,66,128305,8,255084
29783,0.010721,172.217.194.0-255,5738,134043,8,255084
29784,0.010728,172.31.36.0-255,66,134109,8,255084
29785,0.013123,172.217.194.0-255,5738,139847,8,255084
29786,0.013132,172.31.36.0-255,66,139913,8,255084
29787,0.015481,172.217.194.0-255,5738,145651,8,255084
29788,0.015489,172.31.36.0-255,66,145717,8,255084
29789,0.017875,172.217.194.0-255,5738,151455,8,255084
29790,0.017882,172.31.36.0-255,66,151521,8,255084
29791,0.02023,172.217.194.0-255,2902,154423,8,255084
29792,0.020246,172.217.194.0-255,2902,157325,8,255084
29793,0.021009,172.31.36.0-255,66,157391,8,255084
29794,0.023398,172.217.194.0-255,5738,163129,8,255084
29795,0.023405,172.31.36.0-255,66,163195,8,255084
29796,0.02577,172.217.194.0-255,5738,168933,8,255084
29797,0.025776,172.31.36.0-255,66,168999,8,255084
29798,0.028152,172.217.194.0-255,5738,174737,8,255084
29799,0.028161,172.31.36.0-255,66,174803,8,255084
29800,0.030546,172.217.194.0-255,5738,180541,8,255084
29801,0.030554,172.31.36.0-255,66,180607,8,255084
29802,0.032912,172.217.194.0-255,5738,186345,8,255084
29803,0.032919,172.31.36.0-255,66,186411,8,255084
29804,0.035334,172.217.194.0-255,5738,192149,8,255084
29805,0.035343,172.31.36.0-255,66,192215,8,255084
29806,0.037437,172.31.36.0-255,193,192408,8,255084
29807,0.037469,172.31.36.0-255,1112,193520,8,255084
29808,0.037509,172.31.36.0-255,1514,195034,8,255084
29809,0.03751,172.31.36.0-255,1292,196326,8,255084
29810,0.0377,172.217.194.0-255,5738,202064,8,255084
29811,0.037706,172.31.36.0-255,66,202130,8,255084
29812,0.039012,104.244.42.0-255,66,202196,8,255084
29813,0.039031,104.244.42.0-255,66,202262,8,255084
29814,0.039133,104.244.42.0-255,66,202328,8,255084
29815,0.04008,172.217.194.0-255,5738,208066,8,255084
29816,0.040087,172.31.36.0-255,66,208132,8,255084
29817,0.042469,172.217.194.0-255,5738,213870,8,255084
29818,0.042474,172.31.36.0-255,66,213936,8,255084
29819,0.044883,172.217.194.0-255,5738,219674,8,255084
29820,0.044889,172.31.36.0-255,66,219740,8,255084
29821,0.047239,172.217.194.0-255,5738,225478,8,255084
29822,0.047244,172.31.36.0-255,66,225544,8,255084
29823,0.04965,172.217.194.0-255,5738,231282,8,255084
29824,0.049656,172.31.36.0-255,66,231348,8,255084
29825,0.052015,172.217.194.0-255,5738,237086,8,255084
29826,0.05202,172.31.36.0-255,66,237152,8,255084
29827,0.054393,172.217.194.0-255,5738,242890,8,255084
29828,0.054398,172.31.36.0-255,66,242956,8,255084
29829,0.056761,172.217.194.0-255,5738,248694,8,255084
29830,0.056767,172.31.36.0-255,66,248760,8,255084
29831,0.059122,172.217.194.0-255,5738,254498,8,255084
29832,0.059145,172.31.36.0-255,66,254564,8,255084
29833,0.061472,172.217.194.0-255,283,254847,8,255084
29834,0.06161,172.31.36.0-255,66,254913,8,255084
29835,0.061637,172.31.36.0-255,105,255018,8,255084
29836,0.063963,172.217.194.0-255,66,255084,8,255084
29837,0.0,172.217.194.0-255,143,143,8,321538
29838,2.2e-05,172.31.36.0-255,66,209,8,321538
29839,2.9e-05,172.217.194.0-255,1484,1693,8,321538
29840,3.2e-05,172.31.36.0-255,66,1759,8,321538
29841,3.7e-05,172.217.194.0-255,2902,4661,8,321538
29842,3.9e-05,172.31.36.0-255,66,4727,8,321538
29843,4.5e-05,172.217.194.0-255,5738,10465,8,321538
29844,4.7e-05,172.31.36.0-255,66,10531,8,321538
29845,5.2e-05,172.217.194.0-255,4320,14851,8,321538
29846,5.5e-05,172.31.36.0-255,66,14917,8,321538
29847,7.4e-05,172.217.194.0-255,2050,16967,8,321538
29848,7.6e-05,172.31.36.0-255,66,17033,8,321538
29849,7.8e-05,172.217.194.0-255,1484,18517,8,321538
29850,8e-05,172.31.36.0-255,66,18583,8,321538
29851,0.000105,172.31.36.0-255,66,18649,8,321538
29852,0.000128,172.217.194.0-255,1484,20133,8,321538
29853,0.00013,172.31.36.0-255,66,20199,8,321538
29854,0.000143,172.217.194.0-255,2543,22742,8,321538
29855,0.000145,172.31.36.0-255,66,22808,8,321538
29856,0.000178,172.217.194.0-255,1484,24292,8,321538
29857,0.00018,172.31.36.0-255,66,24358,8,321538
29858,0.000184,172.217.194.0-255,2902,27260,8,321538
29859,0.000186,172.31.36.0-255,66,27326,8,321538
29860,0.000224,172.217.194.0-255,5738,33064,8,321538
29861,0.000227,172.31.36.0-255,66,33130,8,321538
29862,0.000231,172.217.194.0-255,4320,37450,8,321538
29863,0.000233,172.31.36.0-255,66,37516,8,321538
29864,0.000254,172.31.36.0-255,66,37582,8,321538
29865,0.000311,172.31.36.0-255,66,37648,8,321538
29866,0.000329,172.217.194.0-255,116,37764,8,321538
29867,0.00037,172.217.194.0-255,383,38147,8,321538
29868,0.000522,172.217.194.0-255,1484,39631,8,321538
29869,0.000527,172.31.36.0-255,66,39697,8,321538
29870,0.000533,172.217.194.0-255,2902,42599,8,321538
29871,0.000535,172.31.36.0-255,66,42665,8,321538
29872,0.000563,172.217.194.0-255,2902,45567,8,321538
29873,0.000567,172.31.36.0-255,66,45633,8,321538
29874,0.000573,172.217.194.0-255,7156,52789,8,321538
29875,0.000575,172.31.36.0-255,66,52855,8,321538
29876,0.000611,172.31.36.0-255,66,52921,8,321538
29877,0.000635,172.217.194.0-255,5379,58300,8,321538
29878,0.000638,172.31.36.0-255,66,58366,8,321538
29879,0.000642,172.217.194.0-255,2543,60909,8,321538
29880,0.000644,172.31.36.0-255,66,60975,8,321538
29881,0.000664,172.217.194.0-255,1484,62459,8,321538
29882,0.000691,172.217.194.0-255,2902,65361,8,321538
29883,0.000694,172.31.36.0-255,66,65427,8,321538
29884,0.000699,172.217.194.0-255,4320,69747,8,321538
29885,0.000702,172.31.36.0-255,66,69813,8,321538
29886,0.000716,172.217.194.0-255,1484,71297,8,321538
29887,0.000721,172.217.194.0-255,4320,75617,8,321538
29888,0.000724,172.31.36.0-255,66,75683,8,321538
29889,0.000744,172.217.194.0-255,2902,78585,8,321538
29890,0.000747,172.31.36.0-255,66,78651,8,321538
29891,0.000757,172.31.36.0-255,66,78717,8,321538
29892,0.000778,172.217.194.0-255,5738,84455,8,321538
29893,0.00078,172.31.36.0-255,66,84521,8,321538
29894,0.000785,172.217.194.0-255,2184,86705,8,321538
29895,0.000787,172.31.36.0-255,66,86771,8,321538
29896,0.000812,172.217.194.0-255,2902,89673,8,321538
29897,0.000814,172.31.36.0-255,66,89739,8,321538
29898,0.000818,172.217.194.0-255,1484,91223,8,321538
29899,0.000832,172.217.194.0-255,2902,94125,8,321538
29900,0.000836,172.31.36.0-255,66,94191,8,321538
29901,0.000846,172.31.36.0-255,66,94257,8,321538
29902,0.000879,172.31.36.0-255,66,94323,8,321538
29903,0.000906,172.31.36.0-255,66,94389,8,321538
29904,0.00103,172.217.194.0-255,1484,95873,8,321538
29905,0.001037,172.217.194.0-255,2902,98775,8,321538
29906,0.00104,172.31.36.0-255,66,98841,8,321538
29907,0.001048,172.217.194.0-255,5738,104579,8,321538
29908,0.00105,172.31.36.0-255,66,104645,8,321538
29909,0.001087,172.31.36.0-255,66,104711,8,321538
29910,0.001126,172.217.194.0-255,5738,110449,8,321538
29911,0.001131,172.31.36.0-255,66,110515,8,321538
29912,0.001154,172.31.36.0-255,66,110581,8,321538
29913,0.001664,172.217.194.0-255,1484,112065,8,321538
29914,0.001672,172.217.194.0-255,2902,114967,8,321538
29915,0.001676,172.31.36.0-255,66,115033,8,321538
29916,0.001683,172.217.194.0-255,5738,120771,8,321538
29917,0.001685,172.31.36.0-255,66,120837,8,321538
29918,0.001732,172.31.36.0-255,66,120903,8,321538
29919,0.001774,172.217.194.0-255,5738,126641,8,321538
29920,0.001777,172.31.36.0-255,66,126707,8,321538
29921,0.001795,172.217.194.0-255,5020,131727,8,321538
29922,0.001798,172.31.36.0-255,66,131793,8,321538
29923,0.003893,172.217.194.0-255,5738,137531,8,321538
29924,0.003898,172.31.36.0-255,66,137597,8,321538
29925,0.00598,172.217.194.0-255,5738,143335,8,321538
29926,0.005985,172.31.36.0-255,66,143401,8,321538
29927,0.008076,172.217.194.0-255,5738,149139,8,321538
29928,0.008084,172.31.36.0-255,66,149205,8,321538
29929,0.010169,172.217.194.0-255,5738,154943,8,321538
29930,0.010175,172.31.36.0-255,66,155009,8,321538
29931,0.012266,172.217.194.0-255,5738,160747,8,321538
29932,0.012274,172.31.36.0-255,66,160813,8,321538
29933,0.014362,172.217.194.0-255,5738,166551,8,321538
29934,0.014372,172.31.36.0-255,66,166617,8,321538
29935,0.016429,172.217.194.0-255,5738,172355,8,321538
29936,0.016442,172.31.36.0-255,66,172421,8,321538
29937,0.01853,172.217.194.0-255,5738,178159,8,321538
29938,0.018535,172.31.36.0-255,66,178225,8,321538
29939,0.020624,172.217.194.0-255,4320,182545,8,321538
29940,0.020629,172.31.36.0-255,66,182611,8,321538
29941,0.020648,172.217.194.0-255,1484,184095,8,321538
29942,0.022702,172.217.194.0-255,4320,188415,8,321538
29943,0.022708,172.31.36.0-255,66,188481,8,321538
29944,0.024785,172.217.194.0-255,5738,194219,8,321538
29945,0.02479,172.31.36.0-255,66,194285,8,321538
29946,0.026882,172.217.194.0-255,5738,200023,8,321538
29947,0.026889,172.31.36.0-255,66,200089,8,321538
29948,0.028961,172.217.194.0-255,5738,205827,8,321538
29949,0.028969,172.31.36.0-255,66,205893,8,321538
29950,0.030695,172.31.36.0-255,172,206065,8,321538
29951,0.030726,172.31.36.0-255,1110,207175,8,321538
29952,0.030778,172.31.36.0-255,1514,208689,8,321538
29953,0.03078,172.31.36.0-255,1514,210203,8,321538
29954,0.030784,172.31.36.0-255,1514,211717,8,321538
29955,0.030786,172.31.36.0-255,1514,213231,8,321538
29956,0.030805,172.31.36.0-255,1514,214745,8,321538
29957,0.030806,172.31.36.0-255,996,215741,8,321538
29958,0.031051,172.217.194.0-255,5738,221479,8,321538
29959,0.031057,172.31.36.0-255,66,221545,8,321538
29960,0.03223,104.244.42.0-255,66,221611,8,321538
29961,0.03231,104.244.42.0-255,66,221677,8,321538
29962,0.032332,104.244.42.0-255,66,221743,8,321538
29963,0.032411,104.244.42.0-255,66,221809,8,321538
29964,0.032419,104.244.42.0-255,66,221875,8,321538
29965,0.03312,172.217.194.0-255,5738,227613,8,321538
29966,0.033127,172.31.36.0-255,66,227679,8,321538
29967,0.035206,172.217.194.0-255,5738,233417,8,321538
29968,0.035217,172.31.36.0-255,66,233483,8,321538
29969,0.037295,172.217.194.0-255,5738,239221,8,321538
29970,0.037306,172.31.36.0-255,66,239287,8,321538
29971,0.039392,172.217.194.0-255,5738,245025,8,321538
29972,0.039398,172.31.36.0-255,66,245091,8,321538
29973,0.040896,172.31.36.0-255,108,245199,8,321538
29974,0.041464,172.217.194.0-255,5738,250937,8,321538
29975,0.041472,172.31.36.0-255,66,251003,8,321538
29976,0.042436,104.244.42.0-255,66,251069,8,321538
29977,0.043917,172.217.194.0-255,5738,256807,8,321538
29978,0.043973,172.31.36.0-255,66,256873,8,321538
29979,0.0461,172.217.194.0-255,5738,262611,8,321538
29980,0.046107,172.31.36.0-255,66,262677,8,321538
29981,0.048165,172.217.194.0-255,5738,268415,8,321538
29982,0.048173,172.31.36.0-255,66,268481,8,321538
29983,0.050245,172.217.194.0-255,5738,274219,8,321538
29984,0.050253,172.31.36.0-255,66,274285,8,321538
29985,0.052317,172.217.194.0-255,4320,278605,8,321538
29986,0.052324,172.31.36.0-255,66,278671,8,321538
29987,0.052357,172.217.194.0-255,1484,280155,8,321538
29988,0.054399,172.217.194.0-255,4320,284475,8,321538
29989,0.054406,172.31.36.0-255,66,284541,8,321538
29990,0.056479,172.217.194.0-255,4320,288861,8,321538
29991,0.056484,172.31.36.0-255,66,288927,8,321538
29992,0.056503,172.217.194.0-255,1484,290411,8,321538
29993,0.05856,172.217.194.0-255,4320,294731,8,321538
29994,0.058566,172.31.36.0-255,66,294797,8,321538
29995,0.060639,172.217.194.0-255,5738,300535,8,321538
29996,0.060646,172.31.36.0-255,66,300601,8,321538
29997,0.062747,172.217.194.0-255,5738,306339,8,321538
29998,0.062755,172.31.36.0-255,66,306405,8,321538
29999,0.064834,172.217.194.0-255,5738,312143,8,321538
30000,0.064843,172.31.36.0-255,66,312209,8,321538
30001,0.066946,172.217.194.0-255,5738,317947,8,321538
30002,0.066954,172.31.36.0-255,66,318013,8,321538
30003,0.069028,172.217.194.0-255,3093,321106,8,321538
30004,0.069035,172.31.36.0-255,66,321172,8,321538
30005,0.069222,172.31.36.0-255,105,321277,8,321538
30006,0.06925,172.31.36.0-255,105,321382,8,321538
30007,0.069476,172.31.36.0-255,90,321472,8,321538
30008,0.069486,172.31.36.0-255,66,321538,8,321538
30009,0.0,172.217.194.0-255,146,146,8,292983
30010,1.5e-05,172.31.36.0-255,66,212,8,292983
30011,2.2e-05,172.217.194.0-255,1484,1696,8,292983
30012,2.7e-05,172.31.36.0-255,66,1762,8,292983
30013,3.3e-05,172.217.194.0-255,2902,4664,8,292983
30014,3.6e-05,172.31.36.0-255,66,4730,8,292983
30015,4.2e-05,172.217.194.0-255,4320,9050,8,292983
30016,4.4e-05,172.31.36.0-255,66,9116,8,292983
30017,7.4e-05,172.217.194.0-255,1484,10600,8,292983
30018,7.7e-05,172.31.36.0-255,66,10666,8,292983
30019,9.2e-05,172.217.194.0-255,3491,14157,8,292983
30020,9.5e-05,172.31.36.0-255,66,14223,8,292983
30021,0.00022,172.217.194.0-255,1484,15707,8,292983
30022,0.000224,172.31.36.0-255,66,15773,8,292983
30023,0.000243,172.217.194.0-255,2902,18675,8,292983
30024,0.000246,172.31.36.0-255,66,18741,8,292983
30025,0.000253,172.217.194.0-255,5738,24479,8,292983
30026,0.000256,172.31.36.0-255,66,24545,8,292983
30027,0.000283,172.217.194.0-255,4320,28865,8,292983
30028,0.000286,172.31.36.0-255,66,28931,8,292983
30029,0.00032,172.217.194.0-255,2543,31474,8,292983
30030,0.000322,172.31.36.0-255,66,31540,8,292983
30031,0.000384,172.217.194.0-255,1484,33024,8,292983
30032,0.000387,172.31.36.0-255,66,33090,8,292983
30033,0.000393,172.217.194.0-255,2902,35992,8,292983
30034,0.000395,172.31.36.0-255,66,36058,8,292983
30035,0.000421,172.217.194.0-255,5738,41796,8,292983
30036,0.000424,172.31.36.0-255,66,41862,8,292983
30037,0.000429,172.217.194.0-255,2902,44764,8,292983
30038,0.00043,172.31.36.0-255,66,44830,8,292983
30039,0.000441,172.217.194.0-255,1484,46314,8,292983
30040,0.000444,172.31.36.0-255,66,46380,8,292983
30041,0.000462,172.217.194.0-255,7156,53536,8,292983
30042,0.000464,172.31.36.0-255,66,53602,8,292983
30043,0.00049,172.217.194.0-255,5379,58981,8,292983
30044,0.000493,172.31.36.0-255,66,59047,8,292983
30045,0.000498,172.217.194.0-255,2902,61949,8,292983
30046,0.0005,172.31.36.0-255,66,62015,8,292983
30047,0.000515,172.217.194.0-255,4216,66231,8,292983
30048,0.000518,172.31.36.0-255,66,66297,8,292983
30049,0.000522,172.217.194.0-255,117,66414,8,292983
30050,0.000524,172.31.36.0-255,66,66480,8,292983
30051,0.000543,172.217.194.0-255,379,66859,8,292983
30052,0.000546,172.31.36.0-255,66,66925,8,292983
30053,0.000896,172.217.194.0-255,1484,68409,8,292983
30054,0.000901,172.31.36.0-255,66,68475,8,292983
30055,0.000907,172.217.194.0-255,2902,71377,8,292983
30056,0.000909,172.31.36.0-255,66,71443,8,292983
30057,0.000915,172.217.194.0-255,2902,74345,8,292983
30058,0.000917,172.31.36.0-255,66,74411,8,292983
30059,0.000931,172.217.194.0-255,2902,77313,8,292983
30060,0.000933,172.31.36.0-255,66,77379,8,292983
30061,0.00094,172.217.194.0-255,5738,83117,8,292983
30062,0.000942,172.31.36.0-255,66,83183,8,292983
30063,0.000966,172.217.194.0-255,7156,90339,8,292983
30064,0.000968,172.31.36.0-255,66,90405,8,292983
30065,0.000991,172.217.194.0-255,5738,96143,8,292983
30066,0.000994,172.31.36.0-255,66,96209,8,292983
30067,0.001023,172.217.194.0-255,5020,101229,8,292983
30068,0.001025,172.31.36.0-255,66,101295,8,292983
30069,0.001167,172.217.194.0-255,1484,102779,8,292983
30070,0.001171,172.31.36.0-255,66,102845,8,292983
30071,0.001175,172.217.194.0-255,1484,104329,8,292983
30072,0.001188,172.217.194.0-255,1484,105813,8,292983
30073,0.00119,172.31.36.0-255,66,105879,8,292983
30074,0.001197,172.217.194.0-255,4320,110199,8,292983
30075,0.001199,172.31.36.0-255,66,110265,8,292983
30076,0.001214,172.217.194.0-255,1484,111749,8,292983
30077,0.001232,172.217.194.0-255,2902,114651,8,292983
30078,0.001234,172.31.36.0-255,66,114717,8,292983
30079,0.001271,172.31.36.0-255,66,114783,8,292983
30080,0.001281,172.31.36.0-255,66,114849,8,292983
30081,0.001303,172.217.194.0-255,2184,117033,8,292983
30082,0.001306,172.31.36.0-255,66,117099,8,292983
30083,0.001326,172.217.194.0-255,2902,120001,8,292983
30084,0.001329,172.31.36.0-255,66,120067,8,292983
30085,0.001333,172.217.194.0-255,2902,122969,8,292983
30086,0.001335,172.31.36.0-255,66,123035,8,292983
30087,0.001353,172.217.194.0-255,4320,127355,8,292983
30088,0.001355,172.31.36.0-255,66,127421,8,292983
30089,0.001362,172.217.194.0-255,5738,133159,8,292983
30090,0.001364,172.31.36.0-255,66,133225,8,292983
30091,0.001382,172.217.194.0-255,2902,136127,8,292983
30092,0.001384,172.31.36.0-255,66,136193,8,292983
30093,0.0014,172.217.194.0-255,1484,137677,8,292983
30094,0.001434,172.31.36.0-255,66,137743,8,292983
30095,0.001445,172.217.194.0-255,5020,142763,8,292983
30096,0.001448,172.31.36.0-255,66,142829,8,292983
30097,0.00148,172.217.194.0-255,4320,147149,8,292983
30098,0.001483,172.31.36.0-255,66,147215,8,292983
30099,0.001516,172.31.36.0-255,66,147281,8,292983
30100,0.001534,172.217.194.0-255,1484,148765,8,292983
30101,0.001554,172.217.194.0-255,7156,155921,8,292983
30102,0.001557,172.31.36.0-255,66,155987,8,292983
30103,0.001575,172.217.194.0-255,1484,157471,8,292983
30104,0.001597,172.31.36.0-255,66,157537,8,292983
30105,0.001659,172.31.36.0-255,66,157603,8,292983
30106,0.001709,172.217.194.0-255,5738,163341,8,292983
30107,0.001713,172.31.36.0-255,66,163407,8,292983
30108,0.001741,172.31.36.0-255,66,163473,8,292983
30109,0.001806,172.217.194.0-255,1484,164957,8,292983
30110,0.001811,172.217.194.0-255,2902,167859,8,292983
30111,0.001814,172.31.36.0-255,66,167925,8,292983
30112,0.001839,172.217.194.0-255,5738,173663,8,292983
30113,0.001842,172.31.36.0-255,66,173729,8,292983
30114,0.001868,172.31.36.0-255,66,173795,8,292983
30115,0.001886,172.217.194.0-255,4320,178115,8,292983
30116,0.001889,172.31.36.0-255,66,178181,8,292983
30117,0.001922,172.31.36.0-255,66,178247,8,292983
30118,0.001938,172.217.194.0-255,1484,179731,8,292983
30119,0.002001,172.31.36.0-255,66,179797,8,292983
30120,0.002062,172.217.194.0-255,1484,181281,8,292983
30121,0.002081,172.217.194.0-255,4320,185601,8,292983
30122,0.002086,172.31.36.0-255,66,185667,8,292983
30123,0.002108,172.217.194.0-255,6438,192105,8,292983
30124,0.002127,172.31.36.0-255,66,192171,8,292983
30125,0.002206,172.217.194.0-255,1484,193655,8,292983
30126,0.002213,172.217.194.0-255,2902,196557,8,292983
30127,0.002218,172.217.194.0-255,4320,200877,8,292983
30128,0.002223,172.217.194.0-255,2902,203779,8,292983
30129,0.002229,172.31.36.0-255,66,203845,8,292983
30130,0.002248,172.217.194.0-255,5738,209583,8,292983
30131,0.002286,172.31.36.0-255,66,209649,8,292983
30132,0.002305,172.31.36.0-255,66,209715,8,292983
30133,0.004818,172.217.194.0-255,5738,215453,8,292983
30134,0.004826,172.31.36.0-255,66,215519,8,292983
30135,0.007329,172.217.194.0-255,4320,219839,8,292983
30136,0.007336,172.31.36.0-255,66,219905,8,292983
30137,0.007356,172.217.194.0-255,1484,221389,8,292983
30138,0.009862,172.217.194.0-255,4320,225709,8,292983
30139,0.009869,172.31.36.0-255,66,225775,8,292983
30140,0.012406,172.217.194.0-255,4320,230095,8,292983
30141,0.012414,172.31.36.0-255,66,230161,8,292983
30142,0.012434,172.217.194.0-255,1484,231645,8,292983
30143,0.014938,172.217.194.0-255,4320,235965,8,292983
30144,0.014947,172.31.36.0-255,66,236031,8,292983
30145,0.017455,172.217.194.0-255,5738,241769,8,292983
30146,0.017464,172.31.36.0-255,66,241835,8,292983
30147,0.020007,172.217.194.0-255,5738,247573,8,292983
30148,0.020014,172.31.36.0-255,66,247639,8,292983
30149,0.022562,172.217.194.0-255,5738,253377,8,292983
30150,0.022571,172.31.36.0-255,66,253443,8,292983
30151,0.025152,172.217.194.0-255,5738,259181,8,292983
30152,0.025159,172.31.36.0-255,66,259247,8,292983
30153,0.027665,172.217.194.0-255,5738,264985,8,292983
30154,0.027677,172.31.36.0-255,66,265051,8,292983
30155,0.030243,172.217.194.0-255,5738,270789,8,292983
30156,0.030251,172.31.36.0-255,66,270855,8,292983
30157,0.032784,172.217.194.0-255,5738,276593,8,292983
30158,0.032792,172.31.36.0-255,66,276659,8,292983
30159,0.035326,172.217.194.0-255,5738,282397,8,292983
30160,0.035335,172.31.36.0-255,66,282463,8,292983
30161,0.037842,172.217.194.0-255,3247,285710,8,292983
30162,0.037851,172.31.36.0-255,66,285776,8,292983
30163,0.038058,172.31.36.0-255,105,285881,8,292983
30164,0.040538,172.217.194.0-255,66,285947,8,292983
30165,0.048742,172.31.36.0-255,172,286119,8,292983
30166,0.048774,172.31.36.0-255,1111,287230,8,292983
30167,0.048858,172.31.36.0-255,1514,288744,8,292983
30168,0.04886,172.31.36.0-255,1514,290258,8,292983
30169,0.048862,172.31.36.0-255,1514,291772,8,292983
30170,0.048889,172.31.36.0-255,773,292545,8,292983
30171,0.050319,104.244.42.0-255,66,292611,8,292983
30172,0.050349,104.244.42.0-255,66,292677,8,292983
30173,0.050436,104.244.42.0-255,66,292743,8,292983
30174,0.05045,104.244.42.0-255,66,292809,8,292983
30175,0.051052,104.244.42.0-255,108,292917,8,292983
30176,0.051057,172.31.36.0-255,66,292983,8,292983
30177,0.0,172.217.194.0-255,153,153,8,211676
30178,2.1e-05,172.31.36.0-255,66,219,8,211676
30179,2.8e-05,172.217.194.0-255,1484,1703,8,211676
30180,3.2e-05,172.31.36.0-255,66,1769,8,211676
30181,3.8e-05,172.217.194.0-255,2902,4671,8,211676
30182,4.1e-05,172.31.36.0-255,66,4737,8,211676
30183,4.4e-05,172.217.194.0-255,1484,6221,8,211676
30184,4.7e-05,172.31.36.0-255,66,6287,8,211676
30185,8.2e-05,172.31.36.0-255,66,6353,8,211676
30186,8.9e-05,172.217.194.0-255,5738,12091,8,211676
30187,9.1e-05,172.31.36.0-255,66,12157,8,211676
30188,0.000115,172.217.194.0-255,2902,15059,8,211676
30189,0.000117,172.31.36.0-255,66,15125,8,211676
30190,0.000133,172.217.194.0-255,4320,19445,8,211676
30191,0.000135,172.31.36.0-255,66,19511,8,211676
30192,0.000157,172.217.194.0-255,2543,22054,8,211676
30193,0.000159,172.31.36.0-255,66,22120,8,211676
30194,0.000201,172.217.194.0-255,1484,23604,8,211676
30195,0.000204,172.31.36.0-255,66,23670,8,211676
30196,0.000226,172.217.194.0-255,2902,26572,8,211676
30197,0.000229,172.31.36.0-255,66,26638,8,211676
30198,0.000234,172.217.194.0-255,5738,32376,8,211676
30199,0.000236,172.31.36.0-255,66,32442,8,211676
30200,0.000283,172.31.36.0-255,66,32508,8,211676
30201,0.000289,172.217.194.0-255,5738,38246,8,211676
30202,0.000291,172.31.36.0-255,66,38312,8,211676
30203,0.000331,172.217.194.0-255,5366,43678,8,211676
30204,0.000334,172.31.36.0-255,66,43744,8,211676
30205,0.000411,172.217.194.0-255,1484,45228,8,211676
30206,0.000413,172.31.36.0-255,66,45294,8,211676
30207,0.000433,172.217.194.0-255,2902,48196,8,211676
30208,0.000436,172.31.36.0-255,66,48262,8,211676
30209,0.000461,172.217.194.0-255,1484,49746,8,211676
30210,0.000478,172.217.194.0-255,4320,54066,8,211676
30211,0.00048,172.31.36.0-255,66,54132,8,211676
30212,0.000499,172.217.194.0-255,5738,59870,8,211676
30213,0.000501,172.31.36.0-255,66,59936,8,211676
30214,0.000522,172.217.194.0-255,7156,67092,8,211676
30215,0.000525,172.31.36.0-255,66,67158,8,211676
30216,0.000527,172.217.194.0-255,1484,68642,8,211676
30217,0.00056,172.31.36.0-255,66,68708,8,211676
30218,0.000771,172.217.194.0-255,1484,70192,8,211676
30219,0.000777,172.217.194.0-255,2902,73094,8,211676
30220,0.00078,172.31.36.0-255,66,73160,8,211676
30221,0.000787,172.217.194.0-255,5738,78898,8,211676
30222,0.000788,172.31.36.0-255,66,78964,8,211676
30223,0.000805,172.217.194.0-255,7156,86120,8,211676
30224,0.000808,172.31.36.0-255,66,86186,8,211676
30225,0.000866,172.31.36.0-255,66,86252,8,211676
30226,0.000878,172.217.194.0-255,1484,87736,8,211676
30227,0.000882,172.217.194.0-255,2184,89920,8,211676
30228,0.000884,172.31.36.0-255,66,89986,8,211676
30229,0.000897,172.217.194.0-255,1484,91470,8,211676
30230,0.000924,172.217.194.0-255,2902,94372,8,211676
30231,0.000927,172.31.36.0-255,66,94438,8,211676
30232,0.000931,172.217.194.0-255,2902,97340,8,211676
30233,0.000933,172.31.36.0-255,66,97406,8,211676
30234,0.000947,172.217.194.0-255,2902,100308,8,211676
30235,0.00095,172.31.36.0-255,66,100374,8,211676
30236,0.000955,172.217.194.0-255,5738,106112,8,211676
30237,0.000957,172.31.36.0-255,66,106178,8,211676
30238,0.000963,172.217.194.0-255,5738,111916,8,211676
30239,0.000965,172.31.36.0-255,66,111982,8,211676
30240,0.000977,172.217.194.0-255,1484,113466,8,211676
30241,0.001002,172.217.194.0-255,5738,119204,8,211676
30242,0.001005,172.31.36.0-255,66,119270,8,211676
30243,0.001029,172.217.194.0-255,5020,124290,8,211676
30244,0.001032,172.31.36.0-255,66,124356,8,211676
30245,0.001043,172.31.36.0-255,66,124422,8,211676
30246,0.001086,172.31.36.0-255,66,124488,8,211676
30247,0.001192,172.217.194.0-255,1484,125972,8,211676
30248,0.001196,172.217.194.0-255,1484,127456,8,211676
30249,0.001201,172.31.36.0-255,66,127522,8,211676
30250,0.001209,172.217.194.0-255,1484,129006,8,211676
30251,0.001239,172.217.194.0-255,4320,133326,8,211676
30252,0.001248,172.31.36.0-255,66,133392,8,211676
30253,0.001254,172.217.194.0-255,1484,134876,8,211676
30254,0.001257,172.217.194.0-255,1484,136360,8,211676
30255,0.001261,172.31.36.0-255,66,136426,8,211676
30256,0.001279,172.217.194.0-255,1484,137910,8,211676
30257,0.001317,172.31.36.0-255,66,137976,8,211676
30258,0.001544,172.217.194.0-255,1484,139460,8,211676
30259,0.001551,172.217.194.0-255,2902,142362,8,211676
30260,0.001554,172.31.36.0-255,66,142428,8,211676
30261,0.001558,172.217.194.0-255,1484,143912,8,211676
30262,0.001579,172.217.194.0-255,4320,148232,8,211676
30263,0.001594,172.31.36.0-255,66,148298,8,211676
30264,0.001605,172.217.194.0-255,4320,152618,8,211676
30265,0.001648,172.217.194.0-255,766,153384,8,211676
30266,0.00166,172.31.36.0-255,66,153450,8,211676
30267,0.001677,172.217.194.0-255,1484,154934,8,211676
30268,0.001696,172.217.194.0-255,4320,159254,8,211676
30269,0.001701,172.217.194.0-255,2902,162156,8,211676
30270,0.00172,172.217.194.0-255,7156,169312,8,211676
30271,0.001733,172.31.36.0-255,66,169378,8,211676
30272,0.00176,172.217.194.0-255,2184,171562,8,211676
30273,0.001764,172.31.36.0-255,66,171628,8,211676
30274,0.001838,172.31.36.0-255,66,171694,8,211676
30275,0.00188,172.31.36.0-255,66,171760,8,211676
30276,0.001913,172.217.194.0-255,1484,173244,8,211676
30277,0.001932,172.217.194.0-255,2902,176146,8,211676
30278,0.001936,172.217.194.0-255,1484,177630,8,211676
30279,0.001941,172.31.36.0-255,66,177696,8,211676
30280,0.001953,172.217.194.0-255,4320,182016,8,211676
30281,0.001958,172.217.194.0-255,1484,183500,8,211676
30282,0.001972,172.217.194.0-255,2902,186402,8,211676
30283,0.001982,172.31.36.0-255,66,186468,8,211676
30284,0.002008,172.217.194.0-255,7156,193624,8,211676
30285,0.002019,172.31.36.0-255,66,193690,8,211676
30286,0.00204,172.217.194.0-255,2902,196592,8,211676
30287,0.002053,172.31.36.0-255,66,196658,8,211676
30288,0.00208,172.31.36.0-255,66,196724,8,211676
30289,0.002088,172.217.194.0-255,1484,198208,8,211676
30290,0.002116,172.217.194.0-255,7156,205364,8,211676
30291,0.002123,172.31.36.0-255,66,205430,8,211676
30292,0.002149,172.217.194.0-255,1373,206803,8,211676
30293,0.002158,172.217.194.0-255,105,206908,8,211676
30294,0.002173,172.31.36.0-255,66,206974,8,211676
30295,0.003967,172.31.36.0-255,101,207075,8,211676
30296,0.004305,172.31.36.0-255,105,207180,8,211676
30297,0.006495,172.217.194.0-255,66,207246,8,211676
30298,0.006826,172.217.194.0-255,66,207312,8,211676
30299,0.044155,172.31.36.0-255,172,207484,8,211676
30300,0.044188,172.31.36.0-255,1109,208593,8,211676
30301,0.044269,172.31.36.0-255,1514,210107,8,211676
30302,0.044271,172.31.36.0-255,1371,211478,8,211676
30303,0.045724,104.244.42.0-255,66,211544,8,211676
30304,0.045758,104.244.42.0-255,66,211610,8,211676
30305,0.045809,104.244.42.0-255,66,211676,8,211676
30306,0.0,74.125.24.0-255,298,298,8,191815
30307,2.4e-05,172.31.36.0-255,66,364,8,191815
30308,3.3e-05,74.125.24.0-255,1484,1848,8,191815
30309,3.7e-05,172.31.36.0-255,66,1914,8,191815
30310,5.3e-05,74.125.24.0-255,4320,6234,8,191815
30311,5.5e-05,172.31.36.0-255,66,6300,8,191815
30312,6.3e-05,74.125.24.0-255,7156,13456,8,191815
30313,6.6e-05,172.31.36.0-255,66,13522,8,191815
30314,0.0001,172.31.36.0-255,66,13588,8,191815
30315,0.000103,74.125.24.0-255,1484,15072,8,191815
30316,0.000105,172.31.36.0-255,66,15138,8,191815
30317,0.000148,74.125.24.0-255,4320,19458,8,191815
30318,0.00015,172.31.36.0-255,66,19524,8,191815
30319,0.000176,74.125.24.0-255,3961,23485,8,191815
30320,0.00018,172.31.36.0-255,66,23551,8,191815
30321,0.000246,74.125.24.0-255,1484,25035,8,191815
30322,0.000249,172.31.36.0-255,66,25101,8,191815
30323,0.000276,74.125.24.0-255,2902,28003,8,191815
30324,0.000279,172.31.36.0-255,66,28069,8,191815
30325,0.000285,74.125.24.0-255,5738,33807,8,191815
30326,0.000287,172.31.36.0-255,66,33873,8,191815
30327,0.000293,74.125.24.0-255,4320,38193,8,191815
30328,0.000296,172.31.36.0-255,66,38259,8,191815
30329,0.00031,74.125.24.0-255,1484,39743,8,191815
30330,0.000312,172.31.36.0-255,66,39809,8,191815
30331,0.000325,74.125.24.0-255,7156,46965,8,191815
30332,0.000328,172.31.36.0-255,66,47031,8,191815
30333,0.000333,74.125.24.0-255,2902,49933,8,191815
30334,0.000336,172.31.36.0-255,66,49999,8,191815
30335,0.000378,172.31.36.0-255,66,50065,8,191815
30336,0.000409,74.125.24.0-255,422,50487,8,191815
30337,0.000538,74.125.24.0-255,1484,51971,8,191815
30338,0.000543,172.31.36.0-255,66,52037,8,191815
30339,0.000549,74.125.24.0-255,2902,54939,8,191815
30340,0.000551,172.31.36.0-255,66,55005,8,191815
30341,0.000556,74.125.24.0-255,2902,57907,8,191815
30342,0.000558,172.31.36.0-255,66,57973,8,191815
30343,0.000588,74.125.24.0-255,2902,60875,8,191815
30344,0.00059,172.31.36.0-255,66,60941,8,191815
30345,0.000609,172.31.36.0-255,66,61007,8,191815
30346,0.000651,74.125.24.0-255,7156,68163,8,191815
30347,0.000654,172.31.36.0-255,66,68229,8,191815
30348,0.000674,74.125.24.0-255,3602,71831,8,191815
30349,0.000677,172.31.36.0-255,66,71897,8,191815
30350,0.00164,74.125.24.0-255,1484,73381,8,191815
30351,0.001651,74.125.24.0-255,2902,76283,8,191815
30352,0.001656,172.31.36.0-255,66,76349,8,191815
30353,0.001664,74.125.24.0-255,5738,82087,8,191815
30354,0.001666,172.31.36.0-255,66,82153,8,191815
30355,0.001704,172.31.36.0-255,66,82219,8,191815
30356,0.001708,74.125.24.0-255,1484,83703,8,191815
30357,0.001745,172.31.36.0-255,66,83769,8,191815
30358,0.001889,74.125.24.0-255,1484,85253,8,191815
30359,0.001894,74.125.24.0-255,1484,86737,8,191815
30360,0.001897,172.31.36.0-255,66,86803,8,191815
30361,0.001909,74.125.24.0-255,1484,88287,8,191815
30362,0.00192,74.125.24.0-255,5738,94025,8,191815
30363,0.001922,172.31.36.0-255,66,94091,8,191815
30364,0.001966,172.31.36.0-255,66,94157,8,191815
30365,0.001985,172.31.36.0-255,66,94223,8,191815
30366,0.00204,172.31.36.0-255,66,94289,8,191815
30367,0.002085,172.31.36.0-255,66,94355,8,191815
30368,0.00211,74.125.24.0-255,1484,95839,8,191815
30369,0.002115,74.125.24.0-255,2902,98741,8,191815
30370,0.002119,172.31.36.0-255,66,98807,8,191815
30371,0.002189,74.125.24.0-255,5738,104545,8,191815
30372,0.002192,172.31.36.0-255,66,104611,8,191815
30373,0.002211,172.31.36.0-255,66,104677,8,191815
30374,0.002224,172.31.36.0-255,66,104743,8,191815
30375,0.002227,74.125.24.0-255,766,105509,8,191815
30376,0.002231,74.125.24.0-255,1484,106993,8,191815
30377,0.002233,172.31.36.0-255,66,107059,8,191815
30378,0.002239,74.125.24.0-255,4320,111379,8,191815
30379,0.002241,172.31.36.0-255,66,111445,8,191815
30380,0.002248,74.125.24.0-255,5738,117183,8,191815
30381,0.002251,172.31.36.0-255,66,117249,8,191815
30382,0.002284,74.125.24.0-255,4320,121569,8,191815
30383,0.002286,172.31.36.0-255,66,121635,8,191815
30384,0.002402,74.125.24.0-255,766,122401,8,191815
30385,0.002406,74.125.24.0-255,1484,123885,8,191815
30386,0.002423,74.125.24.0-255,4320,128205,8,191815
30387,0.002473,74.125.24.0-255,6438,134643,8,191815
30388,0.00249,74.125.24.0-255,1484,136127,8,191815
30389,0.002502,74.125.24.0-255,2902,139029,8,191815
30390,0.002516,74.125.24.0-255,2902,141931,8,191815
30391,0.002539,74.125.24.0-255,7156,149087,8,191815
30392,0.002563,74.125.24.0-255,2902,151989,8,191815
30393,0.002582,74.125.24.0-255,7156,159145,8,191815
30394,0.002607,74.125.24.0-255,5738,164883,8,191815
30395,0.002614,74.125.24.0-255,5020,169903,8,191815
30396,0.00262,74.125.24.0-255,5738,175641,8,191815
30397,0.002641,74.125.24.0-255,7156,182797,8,191815
30398,0.002679,74.125.24.0-255,4320,187117,8,191815
30399,0.009672,172.31.36.0-255,66,187183,8,191815
30400,0.012332,74.125.24.0-255,3529,190712,8,191815
30401,0.012345,172.31.36.0-255,66,190778,8,191815
30402,0.01253,172.31.36.0-255,105,190883,8,191815
30403,0.015136,74.125.24.0-255,66,190949,8,191815
30404,0.04563,172.31.36.0-255,172,191121,8,191815
30405,0.045666,172.31.36.0-255,562,191683,8,191815
30406,0.047202,104.244.42.0-255,66,191749,8,191815
30407,0.047231,104.244.42.0-255,66,191815,8,191815
30408,0.0,74.125.24.0-255,150,150,8,284726
30409,2.9e-05,172.31.36.0-255,66,216,8,284726
30410,3.6e-05,74.125.24.0-255,1484,1700,8,284726
30411,4.1e-05,172.31.36.0-255,66,1766,8,284726
30412,4.6e-05,74.125.24.0-255,2902,4668,8,284726
30413,4.8e-05,172.31.36.0-255,66,4734,8,284726
30414,5.2e-05,74.125.24.0-255,2902,7636,8,284726
30415,5.4e-05,172.31.36.0-255,66,7702,8,284726
30416,6.5e-05,172.31.36.0-255,66,7768,8,284726
30417,9.6e-05,172.31.36.0-255,66,7834,8,284726
30418,0.000123,172.31.36.0-255,66,7900,8,284726
30419,0.000141,74.125.24.0-255,1484,9384,8,284726
30420,0.000143,172.31.36.0-255,66,9450,8,284726
30421,0.000171,172.31.36.0-255,66,9516,8,284726
30422,0.000192,74.125.24.0-255,5020,14536,8,284726
30423,0.000195,172.31.36.0-255,66,14602,8,284726
30424,0.000212,74.125.24.0-255,1484,16086,8,284726
30425,0.000216,172.31.36.0-255,66,16152,8,284726
30426,0.000245,172.31.36.0-255,66,16218,8,284726
30427,0.00027,74.125.24.0-255,4320,20538,8,284726
30428,0.000272,172.31.36.0-255,66,20604,8,284726
30429,0.000275,74.125.24.0-255,1401,22005,8,284726
30430,0.000277,172.31.36.0-255,66,22071,8,284726
30431,0.001021,74.125.24.0-255,380,22451,8,284726
30432,0.001027,172.31.36.0-255,66,22517,8,284726
30433,0.001203,74.125.24.0-255,1484,24001,8,284726
30434,0.001208,172.31.36.0-255,66,24067,8,284726
30435,0.001214,74.125.24.0-255,2902,26969,8,284726
30436,0.001216,172.31.36.0-255,66,27035,8,284726
30437,0.001252,74.125.24.0-255,5738,32773,8,284726
30438,0.001254,172.31.36.0-255,66,32839,8,284726
30439,0.001294,172.31.36.0-255,66,32905,8,284726
30440,0.001326,74.125.24.0-255,4320,37225,8,284726
30441,0.001329,172.31.36.0-255,66,37291,8,284726
30442,0.00136,172.31.36.0-255,66,37357,8,284726
30443,0.001631,74.125.24.0-255,1484,38841,8,284726
30444,0.001651,74.125.24.0-255,1484,40325,8,284726
30445,0.001654,172.31.36.0-255,66,40391,8,284726
30446,0.001671,74.125.24.0-255,1484,41875,8,284726
30447,0.001677,74.125.24.0-255,4320,46195,8,284726
30448,0.001678,172.31.36.0-255,66,46261,8,284726
30449,0.001694,74.125.24.0-255,1484,47745,8,284726
30450,0.0017,74.125.24.0-255,5738,53483,8,284726
30451,0.001703,172.31.36.0-255,66,53549,8,284726
30452,0.00172,74.125.24.0-255,2902,56451,8,284726
30453,0.001722,172.31.36.0-255,66,56517,8,284726
30454,0.001787,74.125.24.0-255,2902,59419,8,284726
30455,0.00179,172.31.36.0-255,66,59485,8,284726
30456,0.001819,172.31.36.0-255,66,59551,8,284726
30457,0.001844,172.31.36.0-255,66,59617,8,284726
30458,0.001851,74.125.24.0-255,5738,65355,8,284726
30459,0.001853,172.31.36.0-255,66,65421,8,284726
30460,0.001867,74.125.24.0-255,5738,71159,8,284726
30461,0.00187,172.31.36.0-255,66,71225,8,284726
30462,0.001886,74.125.24.0-255,2902,74127,8,284726
30463,0.001888,172.31.36.0-255,66,74193,8,284726
30464,0.001912,172.31.36.0-255,66,74259,8,284726
30465,0.001936,74.125.24.0-255,2184,76443,8,284726
30466,0.001938,172.31.36.0-255,66,76509,8,284726
30467,0.00195,172.31.36.0-255,66,76575,8,284726
30468,0.001972,74.125.24.0-255,2902,79477,8,284726
30469,0.001974,172.31.36.0-255,66,79543,8,284726
30470,0.001987,172.31.36.0-255,66,79609,8,284726
30471,0.002016,74.125.24.0-255,2184,81793,8,284726
30472,0.002018,172.31.36.0-255,66,81859,8,284726
30473,0.00206,74.125.24.0-255,1484,83343,8,284726
30474,0.002073,74.125.24.0-255,2902,86245,8,284726
30475,0.002075,172.31.36.0-255,66,86311,8,284726
30476,0.002078,74.125.24.0-255,1484,87795,8,284726
30477,0.002096,74.125.24.0-255,4320,92115,8,284726
30478,0.002098,172.31.36.0-255,66,92181,8,284726
30479,0.002112,74.125.24.0-255,4320,96501,8,284726
30480,0.002115,172.31.36.0-255,66,96567,8,284726
30481,0.00214,74.125.24.0-255,5738,102305,8,284726
30482,0.002142,172.31.36.0-255,66,102371,8,284726
30483,0.002154,172.31.36.0-255,66,102437,8,284726
30484,0.002177,74.125.24.0-255,2184,104621,8,284726
30485,0.002179,172.31.36.0-255,66,104687,8,284726
30486,0.002286,74.125.24.0-255,1484,106171,8,284726
30487,0.002305,74.125.24.0-255,1484,107655,8,284726
30488,0.002307,172.31.36.0-255,66,107721,8,284726
30489,0.00232,74.125.24.0-255,1484,109205,8,284726
30490,0.002324,74.125.24.0-255,2902,112107,8,284726
30491,0.002326,172.31.36.0-255,66,112173,8,284726
30492,0.002348,74.125.24.0-255,2902,115075,8,284726
30493,0.002351,172.31.36.0-255,66,115141,8,284726
30494,0.002381,74.125.24.0-255,7156,122297,8,284726
30495,0.002384,172.31.36.0-255,66,122363,8,284726
30496,0.0024,74.125.24.0-255,5738,128101,8,284726
30497,0.002404,172.31.36.0-255,66,128167,8,284726
30498,0.002409,74.125.24.0-255,4320,132487,8,284726
30499,0.002411,172.31.36.0-255,66,132553,8,284726
30500,0.002431,74.125.24.0-255,1484,134037,8,284726
30501,0.002442,74.125.24.0-255,2902,136939,8,284726
30502,0.002445,172.31.36.0-255,66,137005,8,284726
30503,0.002462,74.125.24.0-255,2184,139189,8,284726
30504,0.002464,172.31.36.0-255,66,139255,8,284726
30505,0.00248,74.125.24.0-255,1484,140739,8,284726
30506,0.0025,74.125.24.0-255,2902,143641,8,284726
30507,0.002503,172.31.36.0-255,66,143707,8,284726
30508,0.002558,74.125.24.0-255,5738,149445,8,284726
30509,0.002562,172.31.36.0-255,66,149511,8,284726
30510,0.002568,74.125.24.0-255,5738,155249,8,284726
30511,0.00257,172.31.36.0-255,66,155315,8,284726
30512,0.002585,74.125.24.0-255,4320,159635,8,284726
30513,0.002587,172.31.36.0-255,66,159701,8,284726
30514,0.002594,74.125.24.0-255,5738,165439,8,284726
30515,0.002596,172.31.36.0-255,66,165505,8,284726
30516,0.002612,74.125.24.0-255,5738,171243,8,284726
30517,0.002615,172.31.36.0-255,66,171309,8,284726
30518,0.00262,74.125.24.0-255,3602,174911,8,284726
30519,0.002622,172.31.36.0-255,66,174977,8,284726
30520,0.002626,74.125.24.0-255,2902,177879,8,284726
30521,0.002628,172.31.36.0-255,66,177945,8,284726
30522,0.002644,74.125.24.0-255,1484,179429,8,284726
30523,0.002662,74.125.24.0-255,5738,185167,8,284726
30524,0.002665,172.31.36.0-255,66,185233,8,284726
30525,0.002686,74.125.24.0-255,4320,189553,8,284726
30526,0.002689,172.31.36.0-255,66,189619,8,284726
30527,0.002696,74.125.24.0-255,7156,196775,8,284726
30528,0.002698,172.31.36.0-255,66,196841,8,284726
30529,0.002702,74.125.24.0-255,2902,199743,8,284726
30530,0.002703,172.31.36.0-255,66,199809,8,284726
30531,0.002731,74.125.24.0-255,5738,205547,8,284726
30532,0.002734,172.31.36.0-255,66,205613,8,284726
30533,0.002763,74.125.24.0-255,5020,210633,8,284726
30534,0.002767,172.31.36.0-255,66,210699,8,284726
30535,0.002773,74.125.24.0-255,5738,216437,8,284726
30536,0.002775,172.31.36.0-255,66,216503,8,284726
30537,0.002779,74.125.24.0-255,2902,219405,8,284726
30538,0.002781,172.31.36.0-255,66,219471,8,284726
30539,0.00281,172.31.36.0-255,66,219537,8,284726
30540,0.002831,74.125.24.0-255,1484,221021,8,284726
30541,0.002837,74.125.24.0-255,4320,225341,8,284726
30542,0.002839,172.31.36.0-255,66,225407,8,284726
30543,0.002868,74.125.24.0-255,1484,226891,8,284726
30544,0.002871,172.31.36.0-255,78,226969,8,284726
30545,0.002877,74.125.24.0-255,4320,231289,8,284726
30546,0.002879,172.31.36.0-255,78,231367,8,284726
30547,0.002895,74.125.24.0-255,7156,238523,8,284726
30548,0.002898,172.31.36.0-255,78,238601,8,284726
30549,0.00291,74.125.24.0-255,766,239367,8,284726
30550,0.002913,172.31.36.0-255,66,239433,8,284726
30551,0.005249,74.125.24.0-255,4320,243753,8,284726
30552,0.00526,172.31.36.0-255,66,243819,8,284726
30553,0.005278,74.125.24.0-255,1484,245303,8,284726
30554,0.00729,74.125.24.0-255,4320,249623,8,284726
30555,0.007295,172.31.36.0-255,66,249689,8,284726
30556,0.009291,74.125.24.0-255,5738,255427,8,284726
30557,0.009296,172.31.36.0-255,66,255493,8,284726
30558,0.0113,74.125.24.0-255,5738,261231,8,284726
30559,0.01131,172.31.36.0-255,66,261297,8,284726
30560,0.013454,74.125.24.0-255,5738,267035,8,284726
30561,0.013462,172.31.36.0-255,66,267101,8,284726
30562,0.015595,74.125.24.0-255,5738,272839,8,284726
30563,0.015609,172.31.36.0-255,66,272905,8,284726
30564,0.0176,74.125.24.0-255,2959,275864,8,284726
30565,0.017615,172.31.36.0-255,66,275930,8,284726
30566,0.01821,172.31.36.0-255,105,276035,8,284726
30567,0.018239,172.31.36.0-255,105,276140,8,284726
30568,0.018506,172.31.36.0-255,90,276230,8,284726
30569,0.018517,172.31.36.0-255,66,276296,8,284726
30570,0.020187,74.125.24.0-255,66,276362,8,284726
30571,0.020195,74.125.24.0-255,66,276428,8,284726
30572,0.020468,74.125.24.0-255,66,276494,8,284726
30573,0.020499,74.125.24.0-255,66,276560,8,284726
30574,0.020504,172.31.36.0-255,66,276626,8,284726
30575,0.037377,172.31.36.0-255,172,276798,8,284726
30576,0.037404,172.31.36.0-255,1110,277908,8,284726
30577,0.037455,172.31.36.0-255,1514,279422,8,284726
30578,0.037456,172.31.36.0-255,1514,280936,8,284726
30579,0.037462,172.31.36.0-255,1514,282450,8,284726
30580,0.037463,172.31.36.0-255,1514,283964,8,284726
30581,0.037482,172.31.36.0-255,498,284462,8,284726
30582,0.038928,104.244.42.0-255,66,284528,8,284726
30583,0.038956,104.244.42.0-255,66,284594,8,284726
30584,0.039007,104.244.42.0-255,66,284660,8,284726
30585,0.039011,104.244.42.0-255,66,284726,8,284726
30586,0.0,172.217.194.0-255,152,152,8,376810
30587,2.8e-05,172.31.36.0-255,66,218,8,376810
30588,3.5e-05,172.217.194.0-255,1484,1702,8,376810
30589,3.9e-05,172.31.36.0-255,66,1768,8,376810
30590,4.5e-05,172.217.194.0-255,2902,4670,8,376810
30591,4.7e-05,172.31.36.0-255,66,4736,8,376810
30592,5.4e-05,172.217.194.0-255,7156,11892,8,376810
30593,5.6e-05,172.31.36.0-255,66,11958,8,376810
30594,5.9e-05,172.217.194.0-255,1484,13442,8,376810
30595,6.2e-05,172.31.36.0-255,66,13508,8,376810
30596,8.1e-05,172.217.194.0-255,626,14134,8,376810
30597,8.3e-05,172.31.36.0-255,66,14200,8,376810
30598,0.000148,172.217.194.0-255,1484,15684,8,376810
30599,0.000151,172.31.36.0-255,66,15750,8,376810
30600,0.000155,172.217.194.0-255,1484,17234,8,376810
30601,0.000157,172.31.36.0-255,66,17300,8,376810
30602,0.000167,172.217.194.0-255,1484,18784,8,376810
30603,0.00017,172.31.36.0-255,66,18850,8,376810
30604,0.000178,172.217.194.0-255,5738,24588,8,376810
30605,0.000181,172.31.36.0-255,66,24654,8,376810
30606,0.000234,172.217.194.0-255,6797,31451,8,376810
30607,0.000237,172.31.36.0-255,66,31517,8,376810
30608,0.000283,172.217.194.0-255,1484,33001,8,376810
30609,0.000286,172.31.36.0-255,66,33067,8,376810
30610,0.000301,172.217.194.0-255,2902,35969,8,376810
30611,0.000304,172.31.36.0-255,66,36035,8,376810
30612,0.000309,172.217.194.0-255,2902,38937,8,376810
30613,0.000312,172.31.36.0-255,66,39003,8,376810
30614,0.000335,172.217.194.0-255,2902,41905,8,376810
30615,0.000339,172.31.36.0-255,66,41971,8,376810
30616,0.000343,172.217.194.0-255,2902,44873,8,376810
30617,0.000345,172.31.36.0-255,66,44939,8,376810
30618,0.00036,172.217.194.0-255,4320,49259,8,376810
30619,0.000374,172.31.36.0-255,66,49325,8,376810
30620,0.000382,172.217.194.0-255,6797,56122,8,376810
30621,0.000389,172.217.194.0-255,5738,61860,8,376810
30622,0.000394,172.31.36.0-255,66,61926,8,376810
30623,0.000426,172.217.194.0-255,4241,66167,8,376810
30624,0.000436,172.31.36.0-255,66,66233,8,376810
30625,0.000452,172.217.194.0-255,397,66630,8,376810
30626,0.000609,172.217.194.0-255,1484,68114,8,376810
30627,0.000625,172.31.36.0-255,66,68180,8,376810
30628,0.000626,172.217.194.0-255,2902,71082,8,376810
30629,0.000628,172.217.194.0-255,1484,72566,8,376810
30630,0.000631,172.31.36.0-255,66,72632,8,376810
30631,0.00065,172.217.194.0-255,4320,76952,8,376810
30632,0.00066,172.31.36.0-255,66,77018,8,376810
30633,0.000697,172.31.36.0-255,66,77084,8,376810
30634,0.000729,172.217.194.0-255,5738,82822,8,376810
30635,0.000743,172.31.36.0-255,66,82888,8,376810
30636,0.000748,172.217.194.0-255,5020,87908,8,376810
30637,0.000751,172.31.36.0-255,66,87974,8,376810
30638,0.000943,172.217.194.0-255,1484,89458,8,376810
30639,0.000958,172.217.194.0-255,2902,92360,8,376810
30640,0.000962,172.31.36.0-255,66,92426,8,376810
30641,0.000973,172.217.194.0-255,1484,93910,8,376810
30642,0.000991,172.217.194.0-255,4320,98230,8,376810
30643,0.001001,172.31.36.0-255,66,98296,8,376810
30644,0.001011,172.217.194.0-255,4320,102616,8,376810
30645,0.001015,172.31.36.0-255,66,102682,8,376810
30646,0.001026,172.217.194.0-255,5738,108420,8,376810
30647,0.001031,172.31.36.0-255,66,108486,8,376810
30648,0.001074,172.31.36.0-255,66,108552,8,376810
30649,0.001079,172.217.194.0-255,2184,110736,8,376810
30650,0.001091,172.31.36.0-255,66,110802,8,376810
30651,0.001375,172.217.194.0-255,1484,112286,8,376810
30652,0.00138,172.217.194.0-255,2902,115188,8,376810
30653,0.001383,172.31.36.0-255,66,115254,8,376810
30654,0.001391,172.217.194.0-255,5738,120992,8,376810
30655,0.0014,172.31.36.0-255,66,121058,8,376810
30656,0.001405,172.31.36.0-255,66,121124,8,376810
30657,0.001451,172.217.194.0-255,7156,128280,8,376810
30658,0.001461,172.31.36.0-255,66,128346,8,376810
30659,0.001486,172.217.194.0-255,2902,131248,8,376810
30660,0.001496,172.31.36.0-255,66,131314,8,376810
30661,0.001506,172.217.194.0-255,2902,134216,8,376810
30662,0.001509,172.31.36.0-255,66,134282,8,376810
30663,0.001516,172.217.194.0-255,7156,141438,8,376810
30664,0.00152,172.217.194.0-255,2902,144340,8,376810
30665,0.001524,172.31.36.0-255,66,144406,8,376810
30666,0.00155,172.31.36.0-255,66,144472,8,376810
30667,0.001563,172.217.194.0-255,1484,145956,8,376810
30668,0.001571,172.217.194.0-255,6438,152394,8,376810
30669,0.001575,172.31.36.0-255,66,152460,8,376810
30670,0.001908,172.217.194.0-255,1484,153944,8,376810
30671,0.001937,172.217.194.0-255,2902,156846,8,376810
30672,0.001942,172.31.36.0-255,66,156912,8,376810
30673,0.001953,172.217.194.0-255,1484,158396,8,376810
30674,0.001966,172.217.194.0-255,2902,161298,8,376810
30675,0.001979,172.217.194.0-255,4320,165618,8,376810
30676,0.001984,172.31.36.0-255,66,165684,8,376810
30677,0.001997,172.217.194.0-255,1484,167168,8,376810
30678,0.002013,172.217.194.0-255,7156,174324,8,376810
30679,0.002016,172.31.36.0-255,66,174390,8,376810
30680,0.002036,172.217.194.0-255,4320,178710,8,376810
30681,0.002043,172.31.36.0-255,66,178776,8,376810
30682,0.002076,172.217.194.0-255,5738,184514,8,376810
30683,0.00208,172.31.36.0-255,66,184580,8,376810
30684,0.002095,172.217.194.0-255,2184,186764,8,376810
30685,0.002105,172.31.36.0-255,66,186830,8,376810
30686,0.002211,172.217.194.0-255,1484,188314,8,376810
30687,0.002229,172.217.194.0-255,2902,191216,8,376810
30688,0.002232,172.31.36.0-255,66,191282,8,376810
30689,0.002261,172.217.194.0-255,5738,197020,8,376810
30690,0.002265,172.217.194.0-255,2902,199922,8,376810
30691,0.002275,172.31.36.0-255,66,199988,8,376810
30692,0.002296,172.217.194.0-255,7156,207144,8,376810
30693,0.002303,172.31.36.0-255,66,207210,8,376810
30694,0.002315,172.217.194.0-255,2902,210112,8,376810
30695,0.002322,172.217.194.0-255,7156,217268,8,376810
30696,0.002328,172.31.36.0-255,66,217334,8,376810
30697,0.002338,172.217.194.0-255,1484,218818,8,376810
30698,0.002353,172.217.194.0-255,4320,223138,8,376810
30699,0.002358,172.31.36.0-255,66,223204,8,376810
30700,0.002377,172.217.194.0-255,2184,225388,8,376810
30701,0.00238,172.217.194.0-255,1484,226872,8,376810
30702,0.002385,172.217.194.0-255,4320,231192,8,376810
30703,0.002385,172.31.36.0-255,66,231258,8,376810
30704,0.002389,172.31.36.0-255,66,231324,8,376810
30705,0.004664,172.217.194.0-255,1484,232808,8,376810
30706,0.004707,172.217.194.0-255,1484,234292,8,376810
30707,0.004711,172.31.36.0-255,66,234358,8,376810
30708,0.004733,172.217.194.0-255,2902,237260,8,376810
30709,0.005822,172.31.36.0-255,66,237326,8,376810
30710,0.007027,172.217.194.0-255,2902,240228,8,376810
30711,0.007032,172.31.36.0-255,66,240294,8,376810
30712,0.008105,172.217.194.0-255,2902,243196,8,376810
30713,0.008713,172.31.36.0-255,66,243262,8,376810
30714,0.009353,172.217.194.0-255,2902,246164,8,376810
30715,0.00936,172.31.36.0-255,66,246230,8,376810
30716,0.01105,172.217.194.0-255,2902,249132,8,376810
30717,0.011069,172.31.36.0-255,66,249198,8,376810
30718,0.011704,172.217.194.0-255,2902,252100,8,376810
30719,0.011712,172.31.36.0-255,66,252166,8,376810
30720,0.013427,172.217.194.0-255,2902,255068,8,376810
30721,0.013436,172.31.36.0-255,66,255134,8,376810
30722,0.014038,172.217.194.0-255,2902,258036,8,376810
30723,0.014045,172.31.36.0-255,66,258102,8,376810
30724,0.0158,172.217.194.0-255,2902,261004,8,376810
30725,0.015808,172.31.36.0-255,66,261070,8,376810
30726,0.016359,172.217.194.0-255,2902,263972,8,376810
30727,0.016366,172.31.36.0-255,66,264038,8,376810
30728,0.018162,172.217.194.0-255,2902,266940,8,376810
30729,0.01817,172.31.36.0-255,66,267006,8,376810
30730,0.018681,172.217.194.0-255,2902,269908,8,376810
30731,0.020486,172.217.194.0-255,2902,272810,8,376810
30732,0.021859,172.31.36.0-255,66,272876,8,376810
30733,0.024202,172.217.194.0-255,5738,278614,8,376810
30734,0.024219,172.31.36.0-255,66,278680,8,376810
30735,0.026518,172.217.194.0-255,5738,284418,8,376810
30736,0.026528,172.31.36.0-255,66,284484,8,376810
30737,0.028825,172.217.194.0-255,5738,290222,8,376810
30738,0.028834,172.31.36.0-255,66,290288,8,376810
30739,0.031033,172.31.36.0-255,172,290460,8,376810
30740,0.031067,172.31.36.0-255,1110,291570,8,376810
30741,0.031129,172.31.36.0-255,1514,293084,8,376810
30742,0.031132,172.31.36.0-255,1514,294598,8,376810
30743,0.031137,172.31.36.0-255,1514,296112,8,376810
30744,0.031138,172.31.36.0-255,1514,297626,8,376810
30745,0.03114,172.217.194.0-255,5738,303364,8,376810
30746,0.031145,172.31.36.0-255,66,303430,8,376810
30747,0.031181,172.31.36.0-255,1514,304944,8,376810
30748,0.031183,172.31.36.0-255,996,305940,8,376810
30749,0.032646,104.244.42.0-255,66,306006,8,376810
30750,0.032675,104.244.42.0-255,66,306072,8,376810
30751,0.032722,104.244.42.0-255,66,306138,8,376810
30752,0.032765,104.244.42.0-255,66,306204,8,376810
30753,0.033472,172.217.194.0-255,5738,311942,8,376810
30754,0.033482,172.31.36.0-255,66,312008,8,376810
30755,0.035795,172.217.194.0-255,5738,317746,8,376810
30756,0.03581,172.31.36.0-255,66,317812,8,376810
30757,0.038136,172.217.194.0-255,5738,323550,8,376810
30758,0.038144,172.31.36.0-255,66,323616,8,376810
30759,0.039407,172.31.36.0-255,108,323724,8,376810
30760,0.040464,172.217.194.0-255,5738,329462,8,376810
30761,0.040474,172.31.36.0-255,66,329528,8,376810
30762,0.040931,104.244.42.0-255,66,329594,8,376810
30763,0.042777,172.217.194.0-255,5738,335332,8,376810
30764,0.042786,172.31.36.0-255,66,335398,8,376810
30765,0.04511,172.217.194.0-255,5738,341136,8,376810
30766,0.045122,172.31.36.0-255,66,341202,8,376810
30767,0.04745,172.217.194.0-255,5738,346940,8,376810
30768,0.047467,172.31.36.0-255,66,347006,8,376810
30769,0.049827,172.217.194.0-255,5738,352744,8,376810
30770,0.049842,172.31.36.0-255,66,352810,8,376810
30771,0.052157,172.217.194.0-255,5738,358548,8,376810
30772,0.052166,172.31.36.0-255,66,358614,8,376810
30773,0.054475,172.217.194.0-255,5738,364352,8,376810
30774,0.054489,172.31.36.0-255,66,364418,8,376810
30775,0.056821,172.217.194.0-255,5738,370156,8,376810
30776,0.056826,172.31.36.0-255,66,370222,8,376810
30777,0.059148,172.217.194.0-255,2902,373124,8,376810
30778,0.059169,172.31.36.0-255,66,373190,8,376810
30779,0.05919,172.217.194.0-255,2902,376092,8,376810
30780,0.059198,172.31.36.0-255,66,376158,8,376810
30781,0.061493,172.217.194.0-255,415,376573,8,376810
30782,0.061755,172.31.36.0-255,66,376639,8,376810
30783,0.061802,172.31.36.0-255,105,376744,8,376810
30784,0.064093,172.217.194.0-255,66,376810,8,376810
30785,0.0,172.217.194.0-255,153,153,8,155478
30786,2.5e-05,172.31.36.0-255,66,219,8,155478
30787,3.3e-05,172.217.194.0-255,1484,1703,8,155478
30788,3.7e-05,172.31.36.0-255,66,1769,8,155478
30789,4.2e-05,172.217.194.0-255,2902,4671,8,155478
30790,4.5e-05,172.31.36.0-255,66,4737,8,155478
30791,6.8e-05,172.217.194.0-255,4320,9057,8,155478
30792,7.2e-05,172.31.36.0-255,66,9123,8,155478
30793,9.2e-05,172.217.194.0-255,2902,12025,8,155478
30794,9.5e-05,172.31.36.0-255,66,12091,8,155478
30795,9.9e-05,172.217.194.0-255,2112,14203,8,155478
30796,0.000102,172.31.36.0-255,66,14269,8,155478
30797,0.000139,172.217.194.0-255,1484,15753,8,155478
30798,0.000142,172.31.36.0-255,66,15819,8,155478
30799,0.000147,172.217.194.0-255,2902,18721,8,155478
30800,0.000149,172.31.36.0-255,66,18787,8,155478
30801,0.000152,172.217.194.0-255,1484,20271,8,155478
30802,0.000154,172.31.36.0-255,66,20337,8,155478
30803,0.000177,172.217.194.0-255,4320,24657,8,155478
30804,0.00018,172.31.36.0-255,66,24723,8,155478
30805,0.000187,172.217.194.0-255,6797,31520,8,155478
30806,0.000189,172.31.36.0-255,66,31586,8,155478
30807,0.00021,172.217.194.0-255,1484,33070,8,155478
30808,0.000212,172.31.36.0-255,66,33136,8,155478
30809,0.000242,172.31.36.0-255,66,33202,8,155478
30810,0.000253,172.31.36.0-255,66,33268,8,155478
30811,0.00027,172.217.194.0-255,7156,40424,8,155478
30812,0.000272,172.31.36.0-255,66,40490,8,155478
30813,0.000278,172.217.194.0-255,3602,44092,8,155478
30814,0.00028,172.31.36.0-255,66,44158,8,155478
30815,0.000296,172.217.194.0-255,380,44538,8,155478
30816,0.000375,172.217.194.0-255,1484,46022,8,155478
30817,0.000379,172.31.36.0-255,66,46088,8,155478
30818,0.000384,172.217.194.0-255,2902,48990,8,155478
30819,0.000387,172.31.36.0-255,66,49056,8,155478
30820,0.000392,172.217.194.0-255,4320,53376,8,155478
30821,0.000395,172.31.36.0-255,66,53442,8,155478
30822,0.000422,172.217.194.0-255,1484,54926,8,155478
30823,0.000436,172.31.36.0-255,66,54992,8,155478
30824,0.000448,172.31.36.0-255,66,55058,8,155478
30825,0.000461,172.217.194.0-255,1064,56122,8,155478
30826,0.000765,172.217.194.0-255,1484,57606,8,155478
30827,0.00077,172.31.36.0-255,66,57672,8,155478
30828,0.000777,172.217.194.0-255,2902,60574,8,155478
30829,0.00078,172.31.36.0-255,66,60640,8,155478
30830,0.000786,172.217.194.0-255,5738,66378,8,155478
30831,0.000789,172.31.36.0-255,66,66444,8,155478
30832,0.000836,172.217.194.0-255,7156,73600,8,155478
30833,0.000847,172.31.36.0-255,66,73666,8,155478
30834,0.000851,172.31.36.0-255,66,73732,8,155478
30835,0.000856,172.217.194.0-255,3602,77334,8,155478
30836,0.000858,172.31.36.0-255,66,77400,8,155478
30837,0.000877,172.217.194.0-255,4320,81720,8,155478
30838,0.00088,172.31.36.0-255,66,81786,8,155478
30839,0.000908,172.217.194.0-255,2902,84688,8,155478
30840,0.000911,172.31.36.0-255,66,84754,8,155478
30841,0.000922,172.31.36.0-255,66,84820,8,155478
30842,0.00094,172.31.36.0-255,66,84886,8,155478
30843,0.000943,172.217.194.0-255,766,85652,8,155478
30844,0.000979,172.217.194.0-255,2902,88554,8,155478
30845,0.000983,172.31.36.0-255,66,88620,8,155478
30846,0.000988,172.217.194.0-255,2902,91522,8,155478
30847,0.000991,172.31.36.0-255,66,91588,8,155478
30848,0.001015,172.217.194.0-255,1484,93072,8,155478
30849,0.001028,172.31.36.0-255,66,93138,8,155478
30850,0.001084,172.31.36.0-255,66,93204,8,155478
30851,0.001104,172.31.36.0-255,66,93270,8,155478
30852,0.001107,172.217.194.0-255,1484,94754,8,155478
30853,0.001111,172.217.194.0-255,2902,97656,8,155478
30854,0.001114,172.31.36.0-255,66,97722,8,155478
30855,0.00112,172.217.194.0-255,5738,103460,8,155478
30856,0.001123,172.31.36.0-255,66,103526,8,155478
30857,0.001135,172.31.36.0-255,66,103592,8,155478
30858,0.00116,172.217.194.0-255,2902,106494,8,155478
30859,0.001163,172.31.36.0-255,66,106560,8,155478
30860,0.001166,172.217.194.0-255,1484,108044,8,155478
30861,0.001211,172.31.36.0-255,66,108110,8,155478
30862,0.001231,172.217.194.0-255,5738,113848,8,155478
30863,0.001234,172.31.36.0-255,66,113914,8,155478
30864,0.001253,172.217.194.0-255,4320,118234,8,155478
30865,0.001256,172.31.36.0-255,66,118300,8,155478
30866,0.001275,172.31.36.0-255,66,118366,8,155478
30867,0.001313,172.31.36.0-255,66,118432,8,155478
30868,0.001343,172.217.194.0-255,3602,122034,8,155478
30869,0.001374,172.31.36.0-255,66,122100,8,155478
30870,0.001393,172.217.194.0-255,2902,125002,8,155478
30871,0.001399,172.217.194.0-255,4320,129322,8,155478
30872,0.001402,172.217.194.0-255,1484,130806,8,155478
30873,0.00141,172.31.36.0-255,66,130872,8,155478
30874,0.001433,172.217.194.0-255,7156,138028,8,155478
30875,0.001436,172.217.194.0-255,1484,139512,8,155478
30876,0.001443,172.31.36.0-255,66,139578,8,155478
30877,0.001483,172.31.36.0-255,66,139644,8,155478
30878,0.001511,172.217.194.0-255,2902,142546,8,155478
30879,0.001579,172.217.194.0-255,2902,145448,8,155478
30880,0.001677,172.217.194.0-255,4629,150077,8,155478
30881,0.001681,172.217.194.0-255,105,150182,8,155478
30882,0.005591,172.31.36.0-255,66,150248,8,155478
30883,0.008472,172.31.36.0-255,105,150353,8,155478
30884,0.010761,172.217.194.0-255,66,150419,8,155478
30885,0.038927,172.31.36.0-255,172,150591,8,155478
30886,0.038967,172.31.36.0-255,1111,151702,8,155478
30887,0.039034,172.31.36.0-255,1514,153216,8,155478
30888,0.039036,172.31.36.0-255,1514,154730,8,155478
30889,0.039037,172.31.36.0-255,484,155214,8,155478
30890,0.040419,104.244.42.0-255,66,155280,8,155478
30891,0.040447,104.244.42.0-255,66,155346,8,155478
30892,0.040529,104.244.42.0-255,66,155412,8,155478
30893,0.040532,104.244.42.0-255,66,155478,8,155478
30894,0.0,74.125.24.0-255,153,153,8,303160
30895,2.2e-05,172.31.36.0-255,66,219,8,303160
30896,3e-05,74.125.24.0-255,1484,1703,8,303160
30897,3.4e-05,172.31.36.0-255,66,1769,8,303160
30898,4e-05,74.125.24.0-255,2902,4671,8,303160
30899,4.3e-05,172.31.36.0-255,66,4737,8,303160
30900,5.1e-05,74.125.24.0-255,5738,10475,8,303160
30901,5.4e-05,172.31.36.0-255,66,10541,8,303160
30902,9.2e-05,74.125.24.0-255,3484,14025,8,303160
30903,9.5e-05,172.31.36.0-255,66,14091,8,303160
30904,0.000101,74.125.24.0-255,4320,18411,8,303160
30905,0.000104,172.31.36.0-255,66,18477,8,303160
30906,0.000111,74.125.24.0-255,5738,24215,8,303160
30907,0.000113,172.31.36.0-255,66,24281,8,303160
30908,0.000137,74.125.24.0-255,4320,28601,8,303160
30909,0.00014,172.31.36.0-255,66,28667,8,303160
30910,0.000144,74.125.24.0-255,2543,31210,8,303160
30911,0.000147,172.31.36.0-255,66,31276,8,303160
30912,0.000233,74.125.24.0-255,1484,32760,8,303160
30913,0.000236,172.31.36.0-255,66,32826,8,303160
30914,0.00024,74.125.24.0-255,1484,34310,8,303160
30915,0.000243,172.31.36.0-255,66,34376,8,303160
30916,0.000255,74.125.24.0-255,1484,35860,8,303160
30917,0.000257,172.31.36.0-255,66,35926,8,303160
30918,0.000262,74.125.24.0-255,2902,38828,8,303160
30919,0.000265,172.31.36.0-255,66,38894,8,303160
30920,0.000291,74.125.24.0-255,2902,41796,8,303160
30921,0.000293,172.31.36.0-255,66,41862,8,303160
30922,0.000299,74.125.24.0-255,4320,46182,8,303160
30923,0.000302,172.31.36.0-255,66,46248,8,303160
30924,0.00032,74.125.24.0-255,7156,53404,8,303160
30925,0.000323,172.31.36.0-255,66,53470,8,303160
30926,0.00035,74.125.24.0-255,5379,58849,8,303160
30927,0.000357,74.125.24.0-255,4320,63169,8,303160
30928,0.000375,74.125.24.0-255,2543,65712,8,303160
30929,0.000378,74.125.24.0-255,398,66110,8,303160
30930,0.000491,172.31.36.0-255,66,66176,8,303160
30931,0.000569,74.125.24.0-255,111,66287,8,303160
30932,0.000581,74.125.24.0-255,330,66617,8,303160
30933,0.001036,172.31.36.0-255,66,66683,8,303160
30934,0.001113,74.125.24.0-255,1484,68167,8,303160
30935,0.001122,74.125.24.0-255,2902,71069,8,303160
30936,0.001146,74.125.24.0-255,5738,76807,8,303160
30937,0.001165,74.125.24.0-255,1484,78291,8,303160
30938,0.001202,74.125.24.0-255,4320,82611,8,303160
30939,0.001221,74.125.24.0-255,7156,89767,8,303160
30940,0.001764,74.125.24.0-255,1484,91251,8,303160
30941,0.001772,74.125.24.0-255,2902,94153,8,303160
30942,0.001793,74.125.24.0-255,5738,99891,8,303160
30943,0.001823,74.125.24.0-255,2902,102793,8,303160
30944,0.001878,74.125.24.0-255,4320,107113,8,303160
30945,0.001892,74.125.24.0-255,6438,113551,8,303160
30946,0.002025,74.125.24.0-255,1484,115035,8,303160
30947,0.00203,74.125.24.0-255,2902,117937,8,303160
30948,0.002036,74.125.24.0-255,4320,122257,8,303160
30949,0.002051,74.125.24.0-255,1484,123741,8,303160
30950,0.002063,74.125.24.0-255,1484,125225,8,303160
30951,0.004997,172.31.36.0-255,66,125291,8,303160
30952,0.007105,74.125.24.0-255,5738,131029,8,303160
30953,0.007113,172.31.36.0-255,66,131095,8,303160
30954,0.009189,74.125.24.0-255,5738,136833,8,303160
30955,0.009198,172.31.36.0-255,66,136899,8,303160
30956,0.011309,74.125.24.0-255,5738,142637,8,303160
30957,0.011318,172.31.36.0-255,66,142703,8,303160
30958,0.013394,74.125.24.0-255,5738,148441,8,303160
30959,0.013402,172.31.36.0-255,66,148507,8,303160
30960,0.015466,74.125.24.0-255,5738,154245,8,303160
30961,0.015475,172.31.36.0-255,66,154311,8,303160
30962,0.017557,74.125.24.0-255,5738,160049,8,303160
30963,0.017566,172.31.36.0-255,66,160115,8,303160
30964,0.019649,74.125.24.0-255,5738,165853,8,303160
30965,0.019658,172.31.36.0-255,66,165919,8,303160
30966,0.021748,74.125.24.0-255,5738,171657,8,303160
30967,0.021756,172.31.36.0-255,66,171723,8,303160
30968,0.023806,74.125.24.0-255,5738,177461,8,303160
30969,0.023815,172.31.36.0-255,66,177527,8,303160
30970,0.025915,74.125.24.0-255,5738,183265,8,303160
30971,0.025924,172.31.36.0-255,66,183331,8,303160
30972,0.028007,74.125.24.0-255,5738,189069,8,303160
30973,0.028014,172.31.36.0-255,66,189135,8,303160
30974,0.028763,172.31.36.0-255,172,189307,8,303160
30975,0.028796,172.31.36.0-255,1111,190418,8,303160
30976,0.028871,172.31.36.0-255,1514,191932,8,303160
30977,0.028873,172.31.36.0-255,754,192686,8,303160
30978,0.03012,74.125.24.0-255,5738,198424,8,303160
30979,0.030127,172.31.36.0-255,66,198490,8,303160
30980,0.03031,104.244.42.0-255,66,198556,8,303160
30981,0.030363,104.244.42.0-255,66,198622,8,303160
30982,0.03046,104.244.42.0-255,66,198688,8,303160
30983,0.03219,74.125.24.0-255,5738,204426,8,303160
30984,0.032197,172.31.36.0-255,66,204492,8,303160
30985,0.034271,74.125.24.0-255,5738,210230,8,303160
30986,0.034278,172.31.36.0-255,66,210296,8,303160
30987,0.036371,74.125.24.0-255,5738,216034,8,303160
30988,0.036378,172.31.36.0-255,66,216100,8,303160
30989,0.038441,74.125.24.0-255,5738,221838,8,303160
30990,0.038451,172.31.36.0-255,66,221904,8,303160
30991,0.040529,74.125.24.0-255,5738,227642,8,303160
30992,0.040538,172.31.36.0-255,66,227708,8,303160
30993,0.04268,74.125.24.0-255,5738,233446,8,303160
30994,0.042687,172.31.36.0-255,66,233512,8,303160
30995,0.044773,74.125.24.0-255,5738,239250,8,303160
30996,0.044779,172.31.36.0-255,66,239316,8,303160
30997,0.046922,74.125.24.0-255,5738,245054,8,303160
30998,0.046928,172.31.36.0-255,66,245120,8,303160
30999,0.049005,74.125.24.0-255,5738,250858,8,303160
31000,0.049011,172.31.36.0-255,66,250924,8,303160
31001,0.051072,74.125.24.0-255,5738,256662,8,303160
31002,0.051078,172.31.36.0-255,66,256728,8,303160
31003,0.053182,74.125.24.0-255,5738,262466,8,303160
31004,0.053189,172.31.36.0-255,66,262532,8,303160
31005,0.055563,74.125.24.0-255,5738,268270,8,303160
31006,0.05557,172.31.36.0-255,66,268336,8,303160
31007,0.057633,74.125.24.0-255,5738,274074,8,303160
31008,0.057641,172.31.36.0-255,66,274140,8,303160
31009,0.059719,74.125.24.0-255,5738,279878,8,303160
31010,0.059726,172.31.36.0-255,66,279944,8,303160
31011,0.061817,74.125.24.0-255,5738,285682,8,303160
31012,0.061824,172.31.36.0-255,66,285748,8,303160
31013,0.063904,74.125.24.0-255,5738,291486,8,303160
31014,0.063911,172.31.36.0-255,66,291552,8,303160
31015,0.065992,74.125.24.0-255,5738,297290,8,303160
31016,0.065999,172.31.36.0-255,66,297356,8,303160
31017,0.068108,74.125.24.0-255,5738,303094,8,303160
31018,0.068115,172.31.36.0-255,66,303160,8,303160
31019,0.0,74.125.24.0-255,153,153,8,280031
31020,1.4e-05,172.31.36.0-255,66,219,8,280031
31021,3.5e-05,74.125.24.0-255,1484,1703,8,280031
31022,3.9e-05,172.31.36.0-255,66,1769,8,280031
31023,4.4e-05,74.125.24.0-255,2902,4671,8,280031
31024,4.6e-05,172.31.36.0-255,66,4737,8,280031
31025,7.5e-05,74.125.24.0-255,5738,10475,8,280031
31026,7.8e-05,172.31.36.0-255,66,10541,8,280031
31027,9e-05,74.125.24.0-255,1484,12025,8,280031
31028,9.2e-05,172.31.36.0-255,66,12091,8,280031
31029,0.000111,172.31.36.0-255,66,12157,8,280031
31030,0.000138,74.125.24.0-255,7156,19313,8,280031
31031,0.000141,172.31.36.0-255,66,19379,8,280031
31032,0.000156,74.125.24.0-255,4320,23699,8,280031
31033,0.000158,172.31.36.0-255,66,23765,8,280031
31034,0.000163,74.125.24.0-255,4320,28085,8,280031
31035,0.000165,172.31.36.0-255,66,28151,8,280031
31036,0.000199,172.31.36.0-255,66,28217,8,280031
31037,0.000225,172.31.36.0-255,66,28283,8,280031
31038,0.000248,74.125.24.0-255,5738,34021,8,280031
31039,0.00025,172.31.36.0-255,66,34087,8,280031
31040,0.000253,74.125.24.0-255,1437,35524,8,280031
31041,0.000255,172.31.36.0-255,66,35590,8,280031
31042,0.000345,74.125.24.0-255,110,35700,8,280031
31043,0.000348,172.31.36.0-255,66,35766,8,280031
31044,0.000556,74.125.24.0-255,1484,37250,8,280031
31045,0.00056,172.31.36.0-255,66,37316,8,280031
31046,0.000565,74.125.24.0-255,2902,40218,8,280031
31047,0.000567,172.31.36.0-255,66,40284,8,280031
31048,0.000572,74.125.24.0-255,2902,43186,8,280031
31049,0.000592,74.125.24.0-255,2902,46088,8,280031
31050,0.000597,172.31.36.0-255,66,46154,8,280031
31051,0.00064,172.31.36.0-255,66,46220,8,280031
31052,0.001843,74.125.24.0-255,1484,47704,8,280031
31053,0.001852,74.125.24.0-255,2902,50606,8,280031
31054,0.001857,172.31.36.0-255,66,50672,8,280031
31055,0.001882,74.125.24.0-255,4320,54992,8,280031
31056,0.001885,172.31.36.0-255,66,55058,8,280031
31057,0.0019,74.125.24.0-255,1484,56542,8,280031
31058,0.001915,74.125.24.0-255,5738,62280,8,280031
31059,0.001917,172.31.36.0-255,66,62346,8,280031
31060,0.001933,74.125.24.0-255,7156,69502,8,280031
31061,0.001935,172.31.36.0-255,66,69568,8,280031
31062,0.001975,172.31.36.0-255,66,69634,8,280031
31063,0.001986,74.125.24.0-255,2184,71818,8,280031
31064,0.001988,172.31.36.0-255,66,71884,8,280031
31065,0.00212,74.125.24.0-255,1484,73368,8,280031
31066,0.002123,74.125.24.0-255,1484,74852,8,280031
31067,0.002125,172.31.36.0-255,66,74918,8,280031
31068,0.002139,74.125.24.0-255,1484,76402,8,280031
31069,0.002142,74.125.24.0-255,2902,79304,8,280031
31070,0.002144,172.31.36.0-255,66,79370,8,280031
31071,0.002156,74.125.24.0-255,2902,82272,8,280031
31072,0.002168,74.125.24.0-255,4320,86592,8,280031
31073,0.002184,74.125.24.0-255,5738,92330,8,280031
31074,0.002189,74.125.24.0-255,4320,96650,8,280031
31075,0.002211,74.125.24.0-255,7156,103806,8,280031
31076,0.002225,74.125.24.0-255,5738,109544,8,280031
31077,0.002243,74.125.24.0-255,6438,115982,8,280031
31078,0.002262,74.125.24.0-255,1484,117466,8,280031
31079,0.005992,172.31.36.0-255,66,117532,8,280031
31080,0.00831,74.125.24.0-255,5738,123270,8,280031
31081,0.008317,172.31.36.0-255,66,123336,8,280031
31082,0.01064,74.125.24.0-255,5738,129074,8,280031
31083,0.010648,172.31.36.0-255,66,129140,8,280031
31084,0.012938,74.125.24.0-255,5738,134878,8,280031
31085,0.012953,172.31.36.0-255,66,134944,8,280031
31086,0.015266,74.125.24.0-255,5738,140682,8,280031
31087,0.015278,172.31.36.0-255,66,140748,8,280031
31088,0.017552,74.125.24.0-255,5738,146486,8,280031
31089,0.017565,172.31.36.0-255,66,146552,8,280031
31090,0.01986,74.125.24.0-255,5738,152290,8,280031
31091,0.019871,172.31.36.0-255,66,152356,8,280031
31092,0.022136,74.125.24.0-255,5738,158094,8,280031
31093,0.022146,172.31.36.0-255,66,158160,8,280031
31094,0.024442,74.125.24.0-255,5738,163898,8,280031
31095,0.024449,172.31.36.0-255,66,163964,8,280031
31096,0.026708,74.125.24.0-255,5738,169702,8,280031
31097,0.026718,172.31.36.0-255,66,169768,8,280031
31098,0.029003,74.125.24.0-255,5738,175506,8,280031
31099,0.029011,172.31.36.0-255,66,175572,8,280031
31100,0.031312,74.125.24.0-255,5738,181310,8,280031
31101,0.03132,172.31.36.0-255,66,181376,8,280031
31102,0.033627,74.125.24.0-255,5738,187114,8,280031
31103,0.033636,172.31.36.0-255,66,187180,8,280031
31104,0.035911,74.125.24.0-255,5738,192918,8,280031
31105,0.035922,172.31.36.0-255,66,192984,8,280031
31106,0.038188,74.125.24.0-255,5738,198722,8,280031
31107,0.038197,172.31.36.0-255,66,198788,8,280031
31108,0.040516,74.125.24.0-255,5738,204526,8,280031
31109,0.040528,172.31.36.0-255,66,204592,8,280031
31110,0.042839,74.125.24.0-255,5738,210330,8,280031
31111,0.04285,172.31.36.0-255,66,210396,8,280031
31112,0.045115,74.125.24.0-255,5738,216134,8,280031
31113,0.045122,172.31.36.0-255,66,216200,8,280031
31114,0.04562,172.31.36.0-255,172,216372,8,280031
31115,0.04565,172.31.36.0-255,1111,217483,8,280031
31116,0.045704,172.31.36.0-255,1514,218997,8,280031
31117,0.045705,172.31.36.0-255,1514,220511,8,280031
31118,0.045732,172.31.36.0-255,1049,221560,8,280031
31119,0.047158,104.244.42.0-255,66,221626,8,280031
31120,0.047197,104.244.42.0-255,66,221692,8,280031
31121,0.047249,104.244.42.0-255,66,221758,8,280031
31122,0.047253,104.244.42.0-255,66,221824,8,280031
31123,0.047425,74.125.24.0-255,5738,227562,8,280031
31124,0.047431,172.31.36.0-255,66,227628,8,280031
31125,0.049728,74.125.24.0-255,5738,233366,8,280031
31126,0.049734,172.31.36.0-255,66,233432,8,280031
31127,0.052046,74.125.24.0-255,5738,239170,8,280031
31128,0.052052,172.31.36.0-255,66,239236,8,280031
31129,0.054358,74.125.24.0-255,5738,244974,8,280031
31130,0.054366,172.31.36.0-255,66,245040,8,280031
31131,0.054509,172.31.36.0-255,101,245141,8,280031
31132,0.056665,74.125.24.0-255,5738,250879,8,280031
31133,0.05667,172.31.36.0-255,66,250945,8,280031
31134,0.05675,74.125.24.0-255,66,251011,8,280031
31135,0.058977,74.125.24.0-255,5738,256749,8,280031
31136,0.058989,172.31.36.0-255,66,256815,8,280031
31137,0.061298,74.125.24.0-255,5738,262553,8,280031
31138,0.061306,172.31.36.0-255,66,262619,8,280031
31139,0.063626,74.125.24.0-255,5738,268357,8,280031
31140,0.063634,172.31.36.0-255,66,268423,8,280031
31141,0.065991,74.125.24.0-255,5738,274161,8,280031
31142,0.065998,172.31.36.0-255,66,274227,8,280031
31143,0.06829,74.125.24.0-255,5738,279965,8,280031
31144,0.068297,172.31.36.0-255,66,280031,8,280031
31145,0.0,74.125.24.0-255,150,150,8,289120
31146,3.1e-05,172.31.36.0-255,66,216,8,289120
31147,4e-05,74.125.24.0-255,1484,1700,8,289120
31148,4.5e-05,172.31.36.0-255,66,1766,8,289120
31149,5e-05,74.125.24.0-255,2902,4668,8,289120
31150,5.2e-05,172.31.36.0-255,66,4734,8,289120
31151,5.9e-05,74.125.24.0-255,7156,11890,8,289120
31152,6.1e-05,172.31.36.0-255,66,11956,8,289120
31153,8e-05,74.125.24.0-255,2065,14021,8,289120
31154,8.2e-05,172.31.36.0-255,66,14087,8,289120
31155,0.000294,74.125.24.0-255,1484,15571,8,289120
31156,0.000299,172.31.36.0-255,66,15637,8,289120
31157,0.000305,74.125.24.0-255,2902,18539,8,289120
31158,0.000308,74.125.24.0-255,1484,20023,8,289120
31159,0.00031,172.31.36.0-255,66,20089,8,289120
31160,0.000314,172.31.36.0-255,66,20155,8,289120
31161,0.000321,74.125.24.0-255,4320,24475,8,289120
31162,0.000324,172.31.36.0-255,66,24541,8,289120
31163,0.000371,74.125.24.0-255,6797,31338,8,289120
31164,0.000374,172.31.36.0-255,66,31404,8,289120
31165,0.000444,74.125.24.0-255,1484,32888,8,289120
31166,0.000448,172.31.36.0-255,66,32954,8,289120
31167,0.000454,74.125.24.0-255,2902,35856,8,289120
31168,0.000456,172.31.36.0-255,66,35922,8,289120
31169,0.000476,74.125.24.0-255,2902,38824,8,289120
31170,0.000479,172.31.36.0-255,66,38890,8,289120
31171,0.000484,74.125.24.0-255,4320,43210,8,289120
31172,0.000486,172.31.36.0-255,66,43276,8,289120
31173,0.000515,74.125.24.0-255,1484,44760,8,289120
31174,0.000518,172.31.36.0-255,66,44826,8,289120
31175,0.000539,74.125.24.0-255,3961,48787,8,289120
31176,0.000542,172.31.36.0-255,66,48853,8,289120
31177,0.001321,74.125.24.0-255,1484,50337,8,289120
31178,0.001333,74.125.24.0-255,2902,53239,8,289120
31179,0.001337,172.31.36.0-255,66,53305,8,289120
31180,0.001344,74.125.24.0-255,5738,59043,8,289120
31181,0.001346,172.31.36.0-255,66,59109,8,289120
31182,0.001381,74.125.24.0-255,2902,62011,8,289120
31183,0.001383,172.31.36.0-255,66,62077,8,289120
31184,0.001399,74.125.24.0-255,4295,66372,8,289120
31185,0.001401,172.31.36.0-255,66,66438,8,289120
31186,0.001424,74.125.24.0-255,1484,67922,8,289120
31187,0.001441,74.125.24.0-255,5738,73660,8,289120
31188,0.001442,172.31.36.0-255,66,73726,8,289120
31189,0.001448,74.125.24.0-255,5738,79464,8,289120
31190,0.00145,172.31.36.0-255,66,79530,8,289120
31191,0.001462,74.125.24.0-255,2902,82432,8,289120
31192,0.001464,172.31.36.0-255,66,82498,8,289120
31193,0.001506,172.31.36.0-255,66,82564,8,289120
31194,0.001521,74.125.24.0-255,1484,84048,8,289120
31195,0.001523,74.125.24.0-255,766,84814,8,289120
31196,0.001525,172.31.36.0-255,66,84880,8,289120
31197,0.001528,74.125.24.0-255,343,85223,8,289120
31198,0.001622,74.125.24.0-255,1484,86707,8,289120
31199,0.001624,172.31.36.0-255,66,86773,8,289120
31200,0.001634,74.125.24.0-255,1484,88257,8,289120
31201,0.001651,74.125.24.0-255,1484,89741,8,289120
31202,0.001654,172.31.36.0-255,66,89807,8,289120
31203,0.001659,74.125.24.0-255,5738,95545,8,289120
31204,0.001661,172.31.36.0-255,66,95611,8,289120
31205,0.001701,172.31.36.0-255,66,95677,8,289120
31206,0.001711,172.31.36.0-255,66,95743,8,289120
31207,0.001742,74.125.24.0-255,2184,97927,8,289120
31208,0.001744,172.31.36.0-255,66,97993,8,289120
31209,0.003725,74.125.24.0-255,2902,100895,8,289120
31210,0.003728,172.31.36.0-255,66,100961,8,289120
31211,0.003794,74.125.24.0-255,2902,103863,8,289120
31212,0.003796,172.31.36.0-255,66,103929,8,289120
31213,0.00574,74.125.24.0-255,2902,106831,8,289120
31214,0.005746,172.31.36.0-255,66,106897,8,289120
31215,0.005826,74.125.24.0-255,2902,109799,8,289120
31216,0.00583,172.31.36.0-255,66,109865,8,289120
31217,0.007766,74.125.24.0-255,2902,112767,8,289120
31218,0.007773,172.31.36.0-255,66,112833,8,289120
31219,0.007853,74.125.24.0-255,2902,115735,8,289120
31220,0.007858,172.31.36.0-255,66,115801,8,289120
31221,0.009783,74.125.24.0-255,2902,118703,8,289120
31222,0.00979,172.31.36.0-255,66,118769,8,289120
31223,0.009859,74.125.24.0-255,2902,121671,8,289120
31224,0.009864,172.31.36.0-255,66,121737,8,289120
31225,0.01184,74.125.24.0-255,2902,124639,8,289120
31226,0.011847,172.31.36.0-255,66,124705,8,289120
31227,0.01192,74.125.24.0-255,2902,127607,8,289120
31228,0.011925,172.31.36.0-255,66,127673,8,289120
31229,0.013917,74.125.24.0-255,2902,130575,8,289120
31230,0.013925,172.31.36.0-255,66,130641,8,289120
31231,0.013969,74.125.24.0-255,2902,133543,8,289120
31232,0.013972,172.31.36.0-255,66,133609,8,289120
31233,0.015966,74.125.24.0-255,2902,136511,8,289120
31234,0.015973,172.31.36.0-255,66,136577,8,289120
31235,0.016039,74.125.24.0-255,2902,139479,8,289120
31236,0.016044,172.31.36.0-255,66,139545,8,289120
31237,0.01802,74.125.24.0-255,2902,142447,8,289120
31238,0.018027,172.31.36.0-255,66,142513,8,289120
31239,0.018068,74.125.24.0-255,2902,145415,8,289120
31240,0.018072,172.31.36.0-255,66,145481,8,289120
31241,0.020102,74.125.24.0-255,5738,151219,8,289120
31242,0.020109,172.31.36.0-255,66,151285,8,289120
31243,0.022124,74.125.24.0-255,5738,157023,8,289120
31244,0.022131,172.31.36.0-255,66,157089,8,289120
31245,0.024151,74.125.24.0-255,5738,162827,8,289120
31246,0.024157,172.31.36.0-255,66,162893,8,289120
31247,0.025018,172.31.36.0-255,172,163065,8,289120
31248,0.025052,172.31.36.0-255,1111,164176,8,289120
31249,0.025085,172.31.36.0-255,1514,165690,8,289120
31250,0.025087,172.31.36.0-255,754,166444,8,289120
31251,0.026245,74.125.24.0-255,4320,170764,8,289120
31252,0.026267,172.31.36.0-255,66,170830,8,289120
31253,0.026294,74.125.24.0-255,1484,172314,8,289120
31254,0.026582,104.244.42.0-255,66,172380,8,289120
31255,0.026621,104.244.42.0-255,66,172446,8,289120
31256,0.026674,104.244.42.0-255,66,172512,8,289120
31257,0.028325,74.125.24.0-255,4320,176832,8,289120
31258,0.02833,172.31.36.0-255,66,176898,8,289120
31259,0.030364,74.125.24.0-255,5738,182636,8,289120
31260,0.030369,172.31.36.0-255,66,182702,8,289120
31261,0.032418,74.125.24.0-255,5738,188440,8,289120
31262,0.032423,172.31.36.0-255,66,188506,8,289120
31263,0.034437,74.125.24.0-255,5738,194244,8,289120
31264,0.034442,172.31.36.0-255,66,194310,8,289120
31265,0.036491,74.125.24.0-255,5738,200048,8,289120
31266,0.036497,172.31.36.0-255,66,200114,8,289120
31267,0.03851,74.125.24.0-255,4320,204434,8,289120
31268,0.038515,172.31.36.0-255,66,204500,8,289120
31269,0.038541,74.125.24.0-255,1484,205984,8,289120
31270,0.040562,74.125.24.0-255,4320,210304,8,289120
31271,0.040567,172.31.36.0-255,66,210370,8,289120
31272,0.042615,74.125.24.0-255,5738,216108,8,289120
31273,0.042621,172.31.36.0-255,66,216174,8,289120
31274,0.044658,74.125.24.0-255,5738,221912,8,289120
31275,0.044663,172.31.36.0-255,66,221978,8,289120
31276,0.046677,74.125.24.0-255,2902,224880,8,289120
31277,0.046682,172.31.36.0-255,66,224946,8,289120
31278,0.046716,74.125.24.0-255,2902,227848,8,289120
31279,0.046719,172.31.36.0-255,66,227914,8,289120
31280,0.048728,74.125.24.0-255,5738,233652,8,289120
31281,0.048733,172.31.36.0-255,66,233718,8,289120
31282,0.050758,74.125.24.0-255,5738,239456,8,289120
31283,0.050763,172.31.36.0-255,66,239522,8,289120
31284,0.052775,74.125.24.0-255,4320,243842,8,289120
31285,0.05278,172.31.36.0-255,66,243908,8,289120
31286,0.052808,74.125.24.0-255,1484,245392,8,289120
31287,0.054815,74.125.24.0-255,4320,249712,8,289120
31288,0.054822,172.31.36.0-255,66,249778,8,289120
31289,0.056871,74.125.24.0-255,5738,255516,8,289120
31290,0.056876,172.31.36.0-255,66,255582,8,289120
31291,0.058935,74.125.24.0-255,5738,261320,8,289120
31292,0.05894,172.31.36.0-255,66,261386,8,289120
31293,0.060989,74.125.24.0-255,5738,267124,8,289120
31294,0.060995,172.31.36.0-255,66,267190,8,289120
31295,0.063049,74.125.24.0-255,5738,272928,8,289120
31296,0.063055,172.31.36.0-255,66,272994,8,289120
31297,0.065089,74.125.24.0-255,5738,278732,8,289120
31298,0.065095,172.31.36.0-255,66,278798,8,289120
31299,0.06711,74.125.24.0-255,4320,283118,8,289120
31300,0.067115,172.31.36.0-255,66,283184,8,289120
31301,0.067146,74.125.24.0-255,1484,284668,8,289120
31302,0.069163,74.125.24.0-255,2902,287570,8,289120
31303,0.069169,172.31.36.0-255,66,287636,8,289120
31304,0.069198,74.125.24.0-255,1484,289120,8,289120
31305,0.0,172.253.118.0-255,153,153,8,269884
31306,3.4e-05,172.31.36.0-255,66,219,8,269884
31307,4e-05,172.253.118.0-255,1484,1703,8,269884
31308,4.5e-05,172.31.36.0-255,66,1769,8,269884
31309,5e-05,172.253.118.0-255,2902,4671,8,269884
31310,5.3e-05,172.31.36.0-255,66,4737,8,269884
31311,6e-05,172.253.118.0-255,7156,11893,8,269884
31312,6.2e-05,172.31.36.0-255,66,11959,8,269884
31313,6.6e-05,172.253.118.0-255,1484,13443,8,269884
31314,6.8e-05,172.31.36.0-255,66,13509,8,269884
31315,9.5e-05,172.31.36.0-255,66,13575,8,269884
31316,0.0001,172.253.118.0-255,2902,16477,8,269884
31317,0.000102,172.31.36.0-255,66,16543,8,269884
31318,0.000124,172.253.118.0-255,3961,20504,8,269884
31319,0.000128,172.31.36.0-255,66,20570,8,269884
31320,0.0002,172.253.118.0-255,1484,22054,8,269884
31321,0.000204,172.31.36.0-255,66,22120,8,269884
31322,0.000223,172.253.118.0-255,2902,25022,8,269884
31323,0.000226,172.31.36.0-255,66,25088,8,269884
31324,0.000233,172.253.118.0-255,5738,30826,8,269884
31325,0.000235,172.31.36.0-255,66,30892,8,269884
31326,0.000237,172.253.118.0-255,1484,32376,8,269884
31327,0.000239,172.31.36.0-255,66,32442,8,269884
31328,0.000256,172.253.118.0-255,2902,35344,8,269884
31329,0.000259,172.31.36.0-255,66,35410,8,269884
31330,0.000297,172.31.36.0-255,66,35476,8,269884
31331,0.000309,172.31.36.0-255,66,35542,8,269884
31332,0.000466,172.253.118.0-255,375,35917,8,269884
31333,0.00047,172.31.36.0-255,66,35983,8,269884
31334,0.000647,172.253.118.0-255,1484,37467,8,269884
31335,0.000662,172.253.118.0-255,2902,40369,8,269884
31336,0.000665,172.31.36.0-255,66,40435,8,269884
31337,0.000672,172.253.118.0-255,5738,46173,8,269884
31338,0.000674,172.31.36.0-255,66,46239,8,269884
31339,0.000692,172.253.118.0-255,1484,47723,8,269884
31340,0.000714,172.31.36.0-255,66,47789,8,269884
31341,0.000722,172.253.118.0-255,5738,53527,8,269884
31342,0.000724,172.31.36.0-255,66,53593,8,269884
31343,0.000738,172.253.118.0-255,1484,55077,8,269884
31344,0.000757,172.253.118.0-255,3602,58679,8,269884
31345,0.00076,172.31.36.0-255,66,58745,8,269884
31346,0.001445,172.253.118.0-255,1484,60229,8,269884
31347,0.001458,172.253.118.0-255,2902,63131,8,269884
31348,0.001462,172.31.36.0-255,66,63197,8,269884
31349,0.001471,172.253.118.0-255,5738,68935,8,269884
31350,0.001473,172.31.36.0-255,66,69001,8,269884
31351,0.001477,172.253.118.0-255,2902,71903,8,269884
31352,0.00148,172.31.36.0-255,66,71969,8,269884
31353,0.001516,172.253.118.0-255,4320,76289,8,269884
31354,0.00152,172.31.36.0-255,66,76355,8,269884
31355,0.001535,172.31.36.0-255,66,76421,8,269884
31356,0.001539,172.253.118.0-255,2184,78605,8,269884
31357,0.001541,172.31.36.0-255,66,78671,8,269884
31358,0.003555,172.253.118.0-255,5738,84409,8,269884
31359,0.003562,172.31.36.0-255,66,84475,8,269884
31360,0.005593,172.253.118.0-255,5738,90213,8,269884
31361,0.005599,172.31.36.0-255,66,90279,8,269884
31362,0.007634,172.253.118.0-255,5738,96017,8,269884
31363,0.00764,172.31.36.0-255,66,96083,8,269884
31364,0.009702,172.253.118.0-255,5738,101821,8,269884
31365,0.009712,172.31.36.0-255,66,101887,8,269884
31366,0.011779,172.253.118.0-255,5738,107625,8,269884
31367,0.011788,172.31.36.0-255,66,107691,8,269884
31368,0.013813,172.253.118.0-255,5738,113429,8,269884
31369,0.013821,172.31.36.0-255,66,113495,8,269884
31370,0.01585,172.253.118.0-255,5738,119233,8,269884
31371,0.015858,172.31.36.0-255,66,119299,8,269884
31372,0.017906,172.253.118.0-255,5738,125037,8,269884
31373,0.01792,172.31.36.0-255,66,125103,8,269884
31374,0.019961,172.253.118.0-255,5738,130841,8,269884
31375,0.019969,172.31.36.0-255,66,130907,8,269884
31376,0.021993,172.253.118.0-255,5738,136645,8,269884
31377,0.022001,172.31.36.0-255,66,136711,8,269884
31378,0.024046,172.253.118.0-255,5738,142449,8,269884
31379,0.024054,172.31.36.0-255,66,142515,8,269884
31380,0.026083,172.253.118.0-255,5738,148253,8,269884
31381,0.026092,172.31.36.0-255,66,148319,8,269884
31382,0.0271,172.31.36.0-255,172,148491,8,269884
31383,0.027129,172.31.36.0-255,562,149053,8,269884
31384,0.028111,172.253.118.0-255,5738,154791,8,269884
31385,0.028117,172.31.36.0-255,66,154857,8,269884
31386,0.028582,104.244.42.0-255,66,154923,8,269884
31387,0.028608,104.244.42.0-255,66,154989,8,269884
31388,0.03012,172.253.118.0-255,1484,156473,8,269884
31389,0.030152,172.253.118.0-255,4320,160793,8,269884
31390,0.030156,172.31.36.0-255,66,160859,8,269884
31391,0.032173,172.253.118.0-255,5738,166597,8,269884
31392,0.032178,172.31.36.0-255,66,166663,8,269884
31393,0.034235,172.253.118.0-255,5738,172401,8,269884
31394,0.034241,172.31.36.0-255,66,172467,8,269884
31395,0.036255,172.253.118.0-255,5738,178205,8,269884
31396,0.036261,172.31.36.0-255,66,178271,8,269884
31397,0.038301,172.253.118.0-255,5738,184009,8,269884
31398,0.038306,172.31.36.0-255,66,184075,8,269884
31399,0.040321,172.253.118.0-255,5738,189813,8,269884
31400,0.040326,172.31.36.0-255,66,189879,8,269884
31401,0.042375,172.253.118.0-255,5738,195617,8,269884
31402,0.04238,172.31.36.0-255,66,195683,8,269884
31403,0.044413,172.253.118.0-255,5738,201421,8,269884
31404,0.044419,172.31.36.0-255,66,201487,8,269884
31405,0.046444,172.253.118.0-255,5738,207225,8,269884
31406,0.046449,172.31.36.0-255,66,207291,8,269884
31407,0.048474,172.253.118.0-255,5738,213029,8,269884
31408,0.048481,172.31.36.0-255,66,213095,8,269884
31409,0.050515,172.253.118.0-255,5738,218833,8,269884
31410,0.050521,172.31.36.0-255,66,218899,8,269884
31411,0.052539,172.253.118.0-255,5738,224637,8,269884
31412,0.052544,172.31.36.0-255,66,224703,8,269884
31413,0.054598,172.253.118.0-255,5738,230441,8,269884
31414,0.054606,172.31.36.0-255,66,230507,8,269884
31415,0.056629,172.253.118.0-255,5738,236245,8,269884
31416,0.056632,172.31.36.0-255,66,236311,8,269884
31417,0.058664,172.253.118.0-255,5738,242049,8,269884
31418,0.05867,172.31.36.0-255,66,242115,8,269884
31419,0.060688,172.253.118.0-255,5738,247853,8,269884
31420,0.060693,172.31.36.0-255,66,247919,8,269884
31421,0.062713,172.253.118.0-255,5738,253657,8,269884
31422,0.062718,172.31.36.0-255,66,253723,8,269884
31423,0.064731,172.253.118.0-255,4320,258043,8,269884
31424,0.064736,172.31.36.0-255,66,258109,8,269884
31425,0.064766,172.253.118.0-255,1484,259593,8,269884
31426,0.066765,172.253.118.0-255,4320,263913,8,269884
31427,0.06677,172.31.36.0-255,66,263979,8,269884
31428,0.06879,172.253.118.0-255,5738,269717,8,269884
31429,0.068796,172.31.36.0-255,66,269783,8,269884
31430,0.068915,172.31.36.0-255,101,269884,8,269884
31431,0.0,74.125.24.0-255,153,153,8,182611
31432,2.6e-05,172.31.36.0-255,66,219,8,182611
31433,3.3e-05,74.125.24.0-255,1484,1703,8,182611
31434,3.8e-05,172.31.36.0-255,66,1769,8,182611
31435,4.4e-05,74.125.24.0-255,2902,4671,8,182611
31436,4.8e-05,172.31.36.0-255,66,4737,8,182611
31437,5.3e-05,74.125.24.0-255,2902,7639,8,182611
31438,5.7e-05,172.31.36.0-255,66,7705,8,182611
31439,7.2e-05,172.31.36.0-255,66,7771,8,182611
31440,8.8e-05,172.31.36.0-255,66,7837,8,182611
31441,0.000114,74.125.24.0-255,1484,9321,8,182611
31442,0.000116,172.31.36.0-255,66,9387,8,182611
31443,0.000122,74.125.24.0-255,2902,12289,8,182611
31444,0.000124,172.31.36.0-255,66,12355,8,182611
31445,0.00013,74.125.24.0-255,4320,16675,8,182611
31446,0.000132,172.31.36.0-255,66,16741,8,182611
31447,0.00015,74.125.24.0-255,1484,18225,8,182611
31448,0.000152,172.31.36.0-255,66,18291,8,182611
31449,0.000184,74.125.24.0-255,6797,25088,8,182611
31450,0.000186,172.31.36.0-255,66,25154,8,182611
31451,0.000207,74.125.24.0-255,7156,32310,8,182611
31452,0.00021,172.31.36.0-255,66,32376,8,182611
31453,0.000213,74.125.24.0-255,1484,33860,8,182611
31454,0.000215,172.31.36.0-255,66,33926,8,182611
31455,0.000244,172.31.36.0-255,66,33992,8,182611
31456,0.000246,74.125.24.0-255,361,34353,8,182611
31457,0.000248,172.31.36.0-255,66,34419,8,182611
31458,0.000252,74.125.24.0-255,381,34800,8,182611
31459,0.000254,172.31.36.0-255,66,34866,8,182611
31460,0.000381,74.125.24.0-255,1484,36350,8,182611
31461,0.000399,74.125.24.0-255,2902,39252,8,182611
31462,0.000403,172.31.36.0-255,66,39318,8,182611
31463,0.00041,74.125.24.0-255,5738,45056,8,182611
31464,0.000412,172.31.36.0-255,66,45122,8,182611
31465,0.000424,74.125.24.0-255,1484,46606,8,182611
31466,0.000443,74.125.24.0-255,5379,51985,8,182611
31467,0.000445,172.31.36.0-255,66,52051,8,182611
31468,0.000462,74.125.24.0-255,1484,53535,8,182611
31469,0.000477,74.125.24.0-255,4320,57855,8,182611
31470,0.00048,172.31.36.0-255,66,57921,8,182611
31471,0.000505,172.31.36.0-255,66,57987,8,182611
31472,0.00051,74.125.24.0-255,2543,60530,8,182611
31473,0.000512,172.31.36.0-255,66,60596,8,182611
31474,0.000685,74.125.24.0-255,1484,62080,8,182611
31475,0.000703,74.125.24.0-255,2902,64982,8,182611
31476,0.000707,172.31.36.0-255,66,65048,8,182611
31477,0.000715,74.125.24.0-255,5738,70786,8,182611
31478,0.000717,172.31.36.0-255,66,70852,8,182611
31479,0.000759,172.31.36.0-255,66,70918,8,182611
31480,0.000813,172.31.36.0-255,66,70984,8,182611
31481,0.000828,74.125.24.0-255,1484,72468,8,182611
31482,0.000831,74.125.24.0-255,1484,73952,8,182611
31483,0.000835,172.31.36.0-255,66,74018,8,182611
31484,0.000844,74.125.24.0-255,1484,75502,8,182611
31485,0.000847,74.125.24.0-255,1484,76986,8,182611
31486,0.000849,172.31.36.0-255,66,77052,8,182611
31487,0.000877,74.125.24.0-255,4320,81372,8,182611
31488,0.00088,172.31.36.0-255,66,81438,8,182611
31489,0.000894,172.31.36.0-255,66,81504,8,182611
31490,0.000918,74.125.24.0-255,1484,82988,8,182611
31491,0.000926,74.125.24.0-255,7156,90144,8,182611
31492,0.000929,172.31.36.0-255,66,90210,8,182611
31493,0.000945,74.125.24.0-255,3602,93812,8,182611
31494,0.000948,172.31.36.0-255,66,93878,8,182611
31495,0.001094,74.125.24.0-255,1484,95362,8,182611
31496,0.00111,74.125.24.0-255,2902,98264,8,182611
31497,0.001114,172.31.36.0-255,66,98330,8,182611
31498,0.001121,74.125.24.0-255,5738,104068,8,182611
31499,0.001123,172.31.36.0-255,66,104134,8,182611
31500,0.001161,172.31.36.0-255,66,104200,8,182611
31501,0.001199,74.125.24.0-255,2902,107102,8,182611
31502,0.001202,172.31.36.0-255,66,107168,8,182611
31503,0.001227,172.31.36.0-255,66,107234,8,182611
31504,0.001486,74.125.24.0-255,1484,108718,8,182611
31505,0.001491,74.125.24.0-255,2902,111620,8,182611
31506,0.001498,172.31.36.0-255,66,111686,8,182611
31507,0.00151,74.125.24.0-255,5738,117424,8,182611
31508,0.001513,172.31.36.0-255,66,117490,8,182611
31509,0.001535,74.125.24.0-255,4320,121810,8,182611
31510,0.001538,172.31.36.0-255,66,121876,8,182611
31511,0.001556,74.125.24.0-255,1484,123360,8,182611
31512,0.001564,74.125.24.0-255,7156,130516,8,182611
31513,0.001567,172.31.36.0-255,66,130582,8,182611
31514,0.001584,74.125.24.0-255,1484,132066,8,182611
31515,0.001609,172.31.36.0-255,66,132132,8,182611
31516,0.001744,74.125.24.0-255,1484,133616,8,182611
31517,0.00175,74.125.24.0-255,2902,136518,8,182611
31518,0.001753,172.31.36.0-255,66,136584,8,182611
31519,0.001759,74.125.24.0-255,2902,139486,8,182611
31520,0.001761,172.31.36.0-255,66,139552,8,182611
31521,0.001777,74.125.24.0-255,2902,142454,8,182611
31522,0.00178,172.31.36.0-255,66,142520,8,182611
31523,0.001784,74.125.24.0-255,2902,145422,8,182611
31524,0.001788,172.31.36.0-255,66,145488,8,182611
31525,0.001843,172.31.36.0-255,66,145554,8,182611
31526,0.001847,172.31.36.0-255,66,145620,8,182611
31527,0.001869,172.31.36.0-255,66,145686,8,182611
31528,0.00191,172.31.36.0-255,66,145752,8,182611
31529,0.001924,172.31.36.0-255,66,145818,8,182611
31530,0.001993,172.31.36.0-255,66,145884,8,182611
31531,0.002017,74.125.24.0-255,4320,150204,8,182611
31532,0.002024,74.125.24.0-255,6438,156642,8,182611
31533,0.00203,74.125.24.0-255,7156,163798,8,182611
31534,0.002046,172.31.36.0-255,66,163864,8,182611
31535,0.002055,172.31.36.0-255,66,163930,8,182611
31536,0.002059,172.31.36.0-255,66,163996,8,182611
31537,0.002062,172.31.36.0-255,66,164062,8,182611
31538,0.002068,74.125.24.0-255,2902,166964,8,182611
31539,0.002071,172.31.36.0-255,66,167030,8,182611
31540,0.002087,172.31.36.0-255,66,167096,8,182611
31541,0.00211,74.125.24.0-255,3602,170698,8,182611
31542,0.002142,74.125.24.0-255,7156,177854,8,182611
31543,0.002147,172.31.36.0-255,66,177920,8,182611
31544,0.002169,172.31.36.0-255,66,177986,8,182611
31545,0.0022,74.125.24.0-255,105,178091,8,182611
31546,0.004635,172.31.36.0-255,66,178157,8,182611
31547,0.004671,172.31.36.0-255,105,178262,8,182611
31548,0.007168,74.125.24.0-255,66,178328,8,182611
31549,0.034053,172.31.36.0-255,167,178495,8,182611
31550,0.034089,172.31.36.0-255,1112,179607,8,182611
31551,0.03415,172.31.36.0-255,1514,181121,8,182611
31552,0.034152,172.31.36.0-255,1292,182413,8,182611
31553,0.035635,104.244.42.0-255,66,182479,8,182611
31554,0.035792,104.244.42.0-255,66,182545,8,182611
31555,0.035795,104.244.42.0-255,66,182611,8,182611
31556,0.0,172.217.194.0-255,145,145,8,218343
31557,2.8e-05,172.31.36.0-255,66,211,8,218343
31558,3.5e-05,172.217.194.0-255,1484,1695,8,218343
31559,3.9e-05,172.31.36.0-255,66,1761,8,218343
31560,5.3e-05,172.217.194.0-255,2902,4663,8,218343
31561,5.6e-05,172.31.36.0-255,66,4729,8,218343
31562,6e-05,172.217.194.0-255,2902,7631,8,218343
31563,6.3e-05,172.31.36.0-255,66,7697,8,218343
31564,6.7e-05,172.217.194.0-255,1484,9181,8,218343
31565,6.9e-05,172.31.36.0-255,66,9247,8,218343
31566,0.000111,172.31.36.0-255,66,9313,8,218343
31567,0.000125,172.31.36.0-255,66,9379,8,218343
31568,0.000166,172.217.194.0-255,1484,10863,8,218343
31569,0.000169,172.31.36.0-255,66,10929,8,218343
31570,0.000175,172.217.194.0-255,2902,13831,8,218343
31571,0.000177,172.31.36.0-255,66,13897,8,218343
31572,0.000188,172.217.194.0-255,5738,19635,8,218343
31573,0.000191,172.31.36.0-255,66,19701,8,218343
31574,0.000204,172.31.36.0-255,66,19767,8,218343
31575,0.00027,172.217.194.0-255,7156,26923,8,218343
31576,0.000276,172.31.36.0-255,66,26989,8,218343
31577,0.000306,172.217.194.0-255,7048,34037,8,218343
31578,0.00031,172.31.36.0-255,66,34103,8,218343
31579,0.000339,172.217.194.0-255,7156,41259,8,218343
31580,0.000343,172.31.36.0-255,66,41325,8,218343
31581,0.000377,172.217.194.0-255,7156,48481,8,218343
31582,0.000381,172.31.36.0-255,66,48547,8,218343
31583,0.000399,172.31.36.0-255,66,48613,8,218343
31584,0.000404,172.217.194.0-255,4320,52933,8,218343
31585,0.000407,172.31.36.0-255,66,52999,8,218343
31586,0.000432,172.217.194.0-255,5020,58019,8,218343
31587,0.000441,172.31.36.0-255,66,58085,8,218343
31588,0.000454,172.31.36.0-255,66,58151,8,218343
31589,0.000466,172.31.36.0-255,66,58217,8,218343
31590,0.0005,172.217.194.0-255,5738,63955,8,218343
31591,0.000503,172.31.36.0-255,66,64021,8,218343
31592,0.000516,172.31.36.0-255,66,64087,8,218343
31593,0.000525,172.217.194.0-255,1484,65571,8,218343
31594,0.000556,172.217.194.0-255,7156,72727,8,218343
31595,0.00056,172.31.36.0-255,66,72793,8,218343
31596,0.000579,172.31.36.0-255,66,72859,8,218343
31597,0.000609,172.217.194.0-255,4320,77179,8,218343
31598,0.000612,172.31.36.0-255,66,77245,8,218343
31599,0.000657,172.31.36.0-255,66,77311,8,218343
31600,0.000664,172.217.194.0-255,5379,82690,8,218343
31601,0.000666,172.31.36.0-255,66,82756,8,218343
31602,0.00071,172.217.194.0-255,1484,84240,8,218343
31603,0.000729,172.217.194.0-255,2902,87142,8,218343
31604,0.000733,172.31.36.0-255,66,87208,8,218343
31605,0.000739,172.217.194.0-255,4320,91528,8,218343
31606,0.000741,172.31.36.0-255,66,91594,8,218343
31607,0.000756,172.217.194.0-255,1484,93078,8,218343
31608,0.000774,172.31.36.0-255,66,93144,8,218343
31609,0.000807,172.217.194.0-255,7156,100300,8,218343
31610,0.000812,172.31.36.0-255,66,100366,8,218343
31611,0.000831,172.217.194.0-255,6438,106804,8,218343
31612,0.000835,172.31.36.0-255,66,106870,8,218343
31613,0.001365,172.217.194.0-255,1484,108354,8,218343
31614,0.001371,172.217.194.0-255,2902,111256,8,218343
31615,0.001374,172.31.36.0-255,66,111322,8,218343
31616,0.001406,172.217.194.0-255,5738,117060,8,218343
31617,0.001409,172.31.36.0-255,66,117126,8,218343
31618,0.00143,172.31.36.0-255,66,117192,8,218343
31619,0.001515,172.31.36.0-255,66,117258,8,218343
31620,0.001537,172.31.36.0-255,66,117324,8,218343
31621,0.001559,172.31.36.0-255,66,117390,8,218343
31622,0.001728,172.217.194.0-255,1484,118874,8,218343
31623,0.001734,172.217.194.0-255,2902,121776,8,218343
31624,0.001739,172.31.36.0-255,66,121842,8,218343
31625,0.001767,172.217.194.0-255,5738,127580,8,218343
31626,0.001771,172.31.36.0-255,66,127646,8,218343
31627,0.001778,172.217.194.0-255,7156,134802,8,218343
31628,0.001781,172.31.36.0-255,66,134868,8,218343
31629,0.001787,172.217.194.0-255,5738,140606,8,218343
31630,0.001789,172.31.36.0-255,66,140672,8,218343
31631,0.00183,172.31.36.0-255,66,140738,8,218343
31632,0.001835,172.217.194.0-255,2184,142922,8,218343
31633,0.001838,172.31.36.0-255,66,142988,8,218343
31634,0.001873,172.217.194.0-255,1484,144472,8,218343
31635,0.001877,172.217.194.0-255,1484,145956,8,218343
31636,0.00188,172.31.36.0-255,66,146022,8,218343
31637,0.001915,172.217.194.0-255,1484,147506,8,218343
31638,0.001922,172.217.194.0-255,5738,153244,8,218343
31639,0.001926,172.31.36.0-255,66,153310,8,218343
31640,0.001931,172.217.194.0-255,2902,156212,8,218343
31641,0.001934,172.31.36.0-255,66,156278,8,218343
31642,0.001939,172.217.194.0-255,4320,160598,8,218343
31643,0.001947,172.31.36.0-255,66,160664,8,218343
31644,0.001957,172.31.36.0-255,66,160730,8,218343
31645,0.001961,172.217.194.0-255,1484,162214,8,218343
31646,0.001995,172.217.194.0-255,6438,168652,8,218343
31647,0.001999,172.31.36.0-255,66,168718,8,218343
31648,0.002005,172.217.194.0-255,4320,173038,8,218343
31649,0.002007,172.31.36.0-255,66,173104,8,218343
31650,0.002041,172.217.194.0-255,4320,177424,8,218343
31651,0.002045,172.31.36.0-255,66,177490,8,218343
31652,0.002051,172.217.194.0-255,4320,181810,8,218343
31653,0.002053,172.31.36.0-255,66,181876,8,218343
31654,0.002074,172.31.36.0-255,66,181942,8,218343
31655,0.002077,172.217.194.0-255,1484,183426,8,218343
31656,0.002668,172.31.36.0-255,101,183527,8,218343
31657,0.004058,172.217.194.0-255,4320,187847,8,218343
31658,0.004064,172.31.36.0-255,66,187913,8,218343
31659,0.004672,172.217.194.0-255,1484,189397,8,218343
31660,0.006084,172.217.194.0-255,4320,193717,8,218343
31661,0.006091,172.31.36.0-255,66,193783,8,218343
31662,0.008096,172.217.194.0-255,5738,199521,8,218343
31663,0.008102,172.31.36.0-255,66,199587,8,218343
31664,0.010119,172.217.194.0-255,5738,205325,8,218343
31665,0.010124,172.31.36.0-255,66,205391,8,218343
31666,0.012139,172.217.194.0-255,5738,211129,8,218343
31667,0.012145,172.31.36.0-255,66,211195,8,218343
31668,0.014155,172.217.194.0-255,2230,213425,8,218343
31669,0.014162,172.31.36.0-255,66,213491,8,218343
31670,0.014337,172.31.36.0-255,105,213596,8,218343
31671,0.014364,172.31.36.0-255,105,213701,8,218343
31672,0.014608,172.31.36.0-255,90,213791,8,218343
31673,0.014618,172.31.36.0-255,66,213857,8,218343
31674,0.016338,172.217.194.0-255,66,213923,8,218343
31675,0.016581,172.217.194.0-255,66,213989,8,218343
31676,0.01659,172.31.36.0-255,66,214055,8,218343
31677,0.031553,172.31.36.0-255,172,214227,8,218343
31678,0.031584,172.31.36.0-255,1112,215339,8,218343
31679,0.031629,172.31.36.0-255,1514,216853,8,218343
31680,0.031631,172.31.36.0-255,1292,218145,8,218343
31681,0.033099,104.244.42.0-255,66,218211,8,218343
31682,0.033144,104.244.42.0-255,66,218277,8,218343
31683,0.033193,104.244.42.0-255,66,218343,8,218343
31684,0.0,74.125.68.0-255,291,291,8,364336
31685,2.3e-05,172.31.36.0-255,66,357,8,364336
31686,3.1e-05,74.125.68.0-255,1484,1841,8,364336
31687,3.5e-05,172.31.36.0-255,66,1907,8,364336
31688,4.2e-05,74.125.68.0-255,4320,6227,8,364336
31689,4.5e-05,172.31.36.0-255,66,6293,8,364336
31690,5e-05,74.125.68.0-255,2902,9195,8,364336
31691,5.2e-05,172.31.36.0-255,66,9261,8,364336
31692,7.2e-05,74.125.68.0-255,1484,10745,8,364336
31693,7.5e-05,172.31.36.0-255,66,10811,8,364336
31694,9.4e-05,74.125.68.0-255,3234,14045,8,364336
31695,9.7e-05,172.31.36.0-255,66,14111,8,364336
31696,0.000182,74.125.68.0-255,1484,15595,8,364336
31697,0.000185,172.31.36.0-255,66,15661,8,364336
31698,0.000225,74.125.68.0-255,1484,17145,8,364336
31699,0.000228,172.31.36.0-255,66,17211,8,364336
31700,0.000243,74.125.68.0-255,2902,20113,8,364336
31701,0.000246,172.31.36.0-255,66,20179,8,364336
31702,0.000249,74.125.68.0-255,1484,21663,8,364336
31703,0.000251,172.31.36.0-255,66,21729,8,364336
31704,0.000277,74.125.68.0-255,4320,26049,8,364336
31705,0.000279,172.31.36.0-255,66,26115,8,364336
31706,0.000286,74.125.68.0-255,5379,31494,8,364336
31707,0.000289,172.31.36.0-255,66,31560,8,364336
31708,0.000317,74.125.68.0-255,5738,37298,8,364336
31709,0.00032,172.31.36.0-255,66,37364,8,364336
31710,0.000366,172.31.36.0-255,66,37430,8,364336
31711,0.000373,74.125.68.0-255,5738,43168,8,364336
31712,0.000375,172.31.36.0-255,66,43234,8,364336
31713,0.000404,74.125.68.0-255,7156,50390,8,364336
31714,0.000407,172.31.36.0-255,66,50456,8,364336
31715,0.000412,74.125.68.0-255,3602,54058,8,364336
31716,0.000414,172.31.36.0-255,66,54124,8,364336
31717,0.000434,74.125.68.0-255,394,54518,8,364336
31718,0.000437,172.31.36.0-255,66,54584,8,364336
31719,0.000549,74.125.68.0-255,349,54933,8,364336
31720,0.000554,172.31.36.0-255,66,54999,8,364336
31721,0.001165,74.125.68.0-255,1484,56483,8,364336
31722,0.001171,172.31.36.0-255,66,56549,8,364336
31723,0.001178,74.125.68.0-255,1484,58033,8,364336
31724,0.00118,172.31.36.0-255,66,58099,8,364336
31725,0.001211,74.125.68.0-255,2902,61001,8,364336
31726,0.001213,172.31.36.0-255,66,61067,8,364336
31727,0.001219,74.125.68.0-255,5738,66805,8,364336
31728,0.001222,172.31.36.0-255,66,66871,8,364336
31729,0.001226,74.125.68.0-255,2902,69773,8,364336
31730,0.001228,172.31.36.0-255,66,69839,8,364336
31731,0.001267,74.125.68.0-255,3961,73800,8,364336
31732,0.00127,172.31.36.0-255,66,73866,8,364336
31733,0.001291,74.125.68.0-255,4320,78186,8,364336
31734,0.001293,172.31.36.0-255,66,78252,8,364336
31735,0.001314,74.125.68.0-255,4320,82572,8,364336
31736,0.001316,172.31.36.0-255,66,82638,8,364336
31737,0.001339,74.125.68.0-255,5738,88376,8,364336
31738,0.001341,172.31.36.0-255,66,88442,8,364336
31739,0.001367,74.125.68.0-255,1484,89926,8,364336
31740,0.001369,172.31.36.0-255,66,89992,8,364336
31741,0.001396,74.125.68.0-255,1484,91476,8,364336
31742,0.001399,172.31.36.0-255,66,91542,8,364336
31743,0.001421,74.125.68.0-255,2902,94444,8,364336
31744,0.001424,172.31.36.0-255,66,94510,8,364336
31745,0.001427,74.125.68.0-255,1484,95994,8,364336
31746,0.001429,172.31.36.0-255,66,96060,8,364336
31747,0.001454,74.125.68.0-255,2902,98962,8,364336
31748,0.001456,172.31.36.0-255,66,99028,8,364336
31749,0.001463,74.125.68.0-255,5738,104766,8,364336
31750,0.001465,172.31.36.0-255,66,104832,8,364336
31751,0.001484,74.125.68.0-255,1484,106316,8,364336
31752,0.001487,172.31.36.0-255,66,106382,8,364336
31753,0.001527,74.125.68.0-255,766,107148,8,364336
31754,0.00153,172.31.36.0-255,66,107214,8,364336
31755,0.001758,74.125.68.0-255,1484,108698,8,364336
31756,0.001764,172.31.36.0-255,66,108764,8,364336
31757,0.00177,74.125.68.0-255,2902,111666,8,364336
31758,0.001773,172.31.36.0-255,66,111732,8,364336
31759,0.001779,74.125.68.0-255,4320,116052,8,364336
31760,0.001781,172.31.36.0-255,66,116118,8,364336
31761,0.001788,74.125.68.0-255,5738,121856,8,364336
31762,0.001789,172.31.36.0-255,66,121922,8,364336
31763,0.001796,74.125.68.0-255,5738,127660,8,364336
31764,0.001799,172.31.36.0-255,66,127726,8,364336
31765,0.00182,74.125.68.0-255,3961,131687,8,364336
31766,0.001823,172.31.36.0-255,66,131753,8,364336
31767,0.00183,74.125.68.0-255,5738,137491,8,364336
31768,0.001832,172.31.36.0-255,66,137557,8,364336
31769,0.001848,74.125.68.0-255,4320,141877,8,364336
31770,0.001851,172.31.36.0-255,66,141943,8,364336
31771,0.001857,74.125.68.0-255,4320,146263,8,364336
31772,0.001858,172.31.36.0-255,66,146329,8,364336
31773,0.001866,74.125.68.0-255,5738,152067,8,364336
31774,0.001868,172.31.36.0-255,66,152133,8,364336
31775,0.001913,74.125.68.0-255,6438,158571,8,364336
31776,0.001988,74.125.68.0-255,1484,160055,8,364336
31777,0.001994,74.125.68.0-255,2902,162957,8,364336
31778,0.002007,74.125.68.0-255,1484,164441,8,364336
31779,0.002022,74.125.68.0-255,4320,168761,8,364336
31780,0.002038,74.125.68.0-255,2902,171663,8,364336
31781,0.004775,172.31.36.0-255,66,171729,8,364336
31782,0.006781,74.125.68.0-255,5738,177467,8,364336
31783,0.006789,172.31.36.0-255,66,177533,8,364336
31784,0.008799,74.125.68.0-255,4320,181853,8,364336
31785,0.008805,172.31.36.0-255,66,181919,8,364336
31786,0.008822,74.125.68.0-255,1484,183403,8,364336
31787,0.008824,172.31.36.0-255,66,183469,8,364336
31788,0.010809,74.125.68.0-255,5738,189207,8,364336
31789,0.010817,172.31.36.0-255,66,189273,8,364336
31790,0.012816,74.125.68.0-255,5738,195011,8,364336
31791,0.012825,172.31.36.0-255,66,195077,8,364336
31792,0.014834,74.125.68.0-255,5738,200815,8,364336
31793,0.014843,172.31.36.0-255,66,200881,8,364336
31794,0.016868,74.125.68.0-255,5738,206619,8,364336
31795,0.016883,172.31.36.0-255,66,206685,8,364336
31796,0.018948,74.125.68.0-255,5738,212423,8,364336
31797,0.018963,172.31.36.0-255,66,212489,8,364336
31798,0.020986,74.125.68.0-255,5738,218227,8,364336
31799,0.021001,172.31.36.0-255,66,218293,8,364336
31800,0.023025,74.125.68.0-255,5738,224031,8,364336
31801,0.023037,172.31.36.0-255,66,224097,8,364336
31802,0.02504,74.125.68.0-255,5738,229835,8,364336
31803,0.025052,172.31.36.0-255,66,229901,8,364336
31804,0.027058,74.125.68.0-255,5738,235639,8,364336
31805,0.027066,172.31.36.0-255,66,235705,8,364336
31806,0.029085,74.125.68.0-255,5738,241443,8,364336
31807,0.029099,172.31.36.0-255,66,241509,8,364336
31808,0.031109,74.125.68.0-255,5738,247247,8,364336
31809,0.031118,172.31.36.0-255,66,247313,8,364336
31810,0.033115,74.125.68.0-255,5738,253051,8,364336
31811,0.033124,172.31.36.0-255,66,253117,8,364336
31812,0.035151,74.125.68.0-255,5738,258855,8,364336
31813,0.035163,172.31.36.0-255,66,258921,8,364336
31814,0.037188,74.125.68.0-255,5738,264659,8,364336
31815,0.0372,172.31.36.0-255,66,264725,8,364336
31816,0.039236,74.125.68.0-255,5738,270463,8,364336
31817,0.03925,172.31.36.0-255,66,270529,8,364336
31818,0.041274,74.125.68.0-255,5738,276267,8,364336
31819,0.041286,172.31.36.0-255,66,276333,8,364336
31820,0.043299,74.125.68.0-255,5738,282071,8,364336
31821,0.043313,172.31.36.0-255,66,282137,8,364336
31822,0.045337,74.125.68.0-255,5738,287875,8,364336
31823,0.045349,172.31.36.0-255,66,287941,8,364336
31824,0.047281,172.31.36.0-255,188,288129,8,364336
31825,0.047331,172.31.36.0-255,955,289084,8,364336
31826,0.047347,74.125.68.0-255,5738,294822,8,364336
31827,0.047355,172.31.36.0-255,66,294888,8,364336
31828,0.047451,172.31.36.0-255,1514,296402,8,364336
31829,0.047453,172.31.36.0-255,1514,297916,8,364336
31830,0.047458,172.31.36.0-255,1514,299430,8,364336
31831,0.047459,172.31.36.0-255,534,299964,8,364336
31832,0.048839,104.244.42.0-255,66,300030,8,364336
31833,0.048849,104.244.42.0-255,66,300096,8,364336
31834,0.049048,104.244.42.0-255,66,300162,8,364336
31835,0.049055,104.244.42.0-255,66,300228,8,364336
31836,0.049369,74.125.68.0-255,5738,305966,8,364336
31837,0.049377,172.31.36.0-255,66,306032,8,364336
31838,0.05138,74.125.68.0-255,5738,311770,8,364336
31839,0.05139,172.31.36.0-255,66,311836,8,364336
31840,0.053402,74.125.68.0-255,5738,317574,8,364336
31841,0.053411,172.31.36.0-255,66,317640,8,364336
31842,0.055418,74.125.68.0-255,5738,323378,8,364336
31843,0.055425,172.31.36.0-255,66,323444,8,364336
31844,0.057443,74.125.68.0-255,5738,329182,8,364336
31845,0.057453,172.31.36.0-255,66,329248,8,364336
31846,0.05945,74.125.68.0-255,5738,334986,8,364336
31847,0.059455,172.31.36.0-255,66,335052,8,364336
31848,0.061456,74.125.68.0-255,5738,340790,8,364336
31849,0.061461,172.31.36.0-255,66,340856,8,364336
31850,0.063458,74.125.68.0-255,5738,346594,8,364336
31851,0.063464,172.31.36.0-255,66,346660,8,364336
31852,0.065465,74.125.68.0-255,5738,352398,8,364336
31853,0.06547,172.31.36.0-255,66,352464,8,364336
31854,0.067484,74.125.68.0-255,2902,355366,8,364336
31855,0.06749,172.31.36.0-255,66,355432,8,364336
31856,0.067521,74.125.68.0-255,2902,358334,8,364336
31857,0.067541,172.31.36.0-255,66,358400,8,364336
31858,0.069494,74.125.68.0-255,2902,361302,8,364336
31859,0.069499,172.31.36.0-255,66,361368,8,364336
31860,0.069537,74.125.68.0-255,2902,364270,8,364336
31861,0.069553,172.31.36.0-255,66,364336,8,364336
31862,0.0,74.125.24.0-255,152,152,8,328108
31863,1.7e-05,172.31.36.0-255,66,218,8,328108
31864,2.5e-05,74.125.24.0-255,1484,1702,8,328108
31865,2.9e-05,172.31.36.0-255,66,1768,8,328108
31866,3.4e-05,74.125.24.0-255,2902,4670,8,328108
31867,3.8e-05,172.31.36.0-255,66,4736,8,328108
31868,4.6e-05,74.125.24.0-255,7156,11892,8,328108
31869,4.9e-05,172.31.36.0-255,66,11958,8,328108
31870,5.3e-05,74.125.24.0-255,2066,14024,8,328108
31871,5.5e-05,172.31.36.0-255,66,14090,8,328108
31872,0.000135,74.125.24.0-255,1484,15574,8,328108
31873,0.00014,74.125.24.0-255,2902,18476,8,328108
31874,0.000145,172.31.36.0-255,66,18542,8,328108
31875,0.000149,172.31.36.0-255,66,18608,8,328108
31876,0.000157,74.125.24.0-255,1484,20092,8,328108
31877,0.000159,172.31.36.0-255,66,20158,8,328108
31878,0.000185,74.125.24.0-255,2902,23060,8,328108
31879,0.000188,172.31.36.0-255,66,23126,8,328108
31880,0.000234,172.31.36.0-255,66,23192,8,328108
31881,0.00024,74.125.24.0-255,4320,27512,8,328108
31882,0.000242,172.31.36.0-255,66,27578,8,328108
31883,0.000267,74.125.24.0-255,2902,30480,8,328108
31884,0.00027,172.31.36.0-255,66,30546,8,328108
31885,0.000299,172.31.36.0-255,66,30612,8,328108
31886,0.000311,74.125.24.0-255,1484,32096,8,328108
31887,0.000313,172.31.36.0-255,66,32162,8,328108
31888,0.000318,74.125.24.0-255,2902,35064,8,328108
31889,0.00032,172.31.36.0-255,66,35130,8,328108
31890,0.000324,74.125.24.0-255,1484,36614,8,328108
31891,0.000325,172.31.36.0-255,66,36680,8,328108
31892,0.000347,74.125.24.0-255,4320,41000,8,328108
31893,0.000374,74.125.24.0-255,7124,48124,8,328108
31894,0.00049,172.31.36.0-255,66,48190,8,328108
31895,0.000578,74.125.24.0-255,349,48539,8,328108
31896,0.000606,74.125.24.0-255,1484,50023,8,328108
31897,0.000614,172.31.36.0-255,66,50089,8,328108
31898,0.000625,74.125.24.0-255,4320,54409,8,328108
31899,0.000632,172.31.36.0-255,66,54475,8,328108
31900,0.000663,172.31.36.0-255,66,54541,8,328108
31901,0.000714,74.125.24.0-255,1125,55666,8,328108
31902,0.000802,74.125.24.0-255,1484,57150,8,328108
31903,0.000816,74.125.24.0-255,2902,60052,8,328108
31904,0.00082,172.31.36.0-255,66,60118,8,328108
31905,0.000829,172.31.36.0-255,66,60184,8,328108
31906,0.000838,74.125.24.0-255,1484,61668,8,328108
31907,0.000857,74.125.24.0-255,4320,65988,8,328108
31908,0.00086,74.125.24.0-255,1484,67472,8,328108
31909,0.000865,74.125.24.0-255,2902,70374,8,328108
31910,0.000872,172.31.36.0-255,66,70440,8,328108
31911,0.000918,74.125.24.0-255,2543,72983,8,328108
31912,0.00093,172.31.36.0-255,66,73049,8,328108
31913,0.001427,74.125.24.0-255,1484,74533,8,328108
31914,0.001443,74.125.24.0-255,2902,77435,8,328108
31915,0.001446,172.31.36.0-255,66,77501,8,328108
31916,0.00147,74.125.24.0-255,5738,83239,8,328108
31917,0.001472,74.125.24.0-255,1484,84723,8,328108
31918,0.001485,74.125.24.0-255,2902,87625,8,328108
31919,0.001497,172.31.36.0-255,66,87691,8,328108
31920,0.001523,74.125.24.0-255,5738,93429,8,328108
31921,0.001537,74.125.24.0-255,2184,95613,8,328108
31922,0.001544,172.31.36.0-255,66,95679,8,328108
31923,0.00165,74.125.24.0-255,1484,97163,8,328108
31924,0.001656,74.125.24.0-255,2902,100065,8,328108
31925,0.001659,172.31.36.0-255,66,100131,8,328108
31926,0.001682,74.125.24.0-255,5738,105869,8,328108
31927,0.001687,172.31.36.0-255,66,105935,8,328108
31928,0.00171,74.125.24.0-255,7156,113091,8,328108
31929,0.001725,74.125.24.0-255,2902,115993,8,328108
31930,0.001736,74.125.24.0-255,1484,117477,8,328108
31931,0.001741,172.31.36.0-255,66,117543,8,328108
31932,0.001798,172.31.36.0-255,66,117609,8,328108
31933,0.001855,74.125.24.0-255,766,118375,8,328108
31934,0.001861,172.31.36.0-255,66,118441,8,328108
31935,0.001913,74.125.24.0-255,1484,119925,8,328108
31936,0.001919,74.125.24.0-255,2902,122827,8,328108
31937,0.001944,172.31.36.0-255,66,122893,8,328108
31938,0.001954,74.125.24.0-255,2902,125795,8,328108
31939,0.001963,172.31.36.0-255,66,125861,8,328108
31940,0.001968,74.125.24.0-255,2902,128763,8,328108
31941,0.001972,74.125.24.0-255,2902,131665,8,328108
31942,0.001984,74.125.24.0-255,4320,135985,8,328108
31943,0.001997,74.125.24.0-255,1484,137469,8,328108
31944,0.002013,74.125.24.0-255,5738,143207,8,328108
31945,0.002025,172.31.36.0-255,66,143273,8,328108
31946,0.00203,74.125.24.0-255,2902,146175,8,328108
31947,0.002035,172.31.36.0-255,66,146241,8,328108
31948,0.002052,74.125.24.0-255,4320,150561,8,328108
31949,0.002055,74.125.24.0-255,2184,152745,8,328108
31950,0.002083,172.31.36.0-255,66,152811,8,328108
31951,0.002269,74.125.24.0-255,1484,154295,8,328108
31952,0.002275,74.125.24.0-255,2902,157197,8,328108
31953,0.002278,172.31.36.0-255,66,157263,8,328108
31954,0.0023,74.125.24.0-255,5738,163001,8,328108
31955,0.00231,74.125.24.0-255,1484,164485,8,328108
31956,0.002321,74.125.24.0-255,1484,165969,8,328108
31957,0.00233,74.125.24.0-255,1484,167453,8,328108
31958,0.002345,74.125.24.0-255,1484,168937,8,328108
31959,0.006031,172.31.36.0-255,66,169003,8,328108
31960,0.008318,74.125.24.0-255,5738,174741,8,328108
31961,0.008324,172.31.36.0-255,66,174807,8,328108
31962,0.010663,74.125.24.0-255,5738,180545,8,328108
31963,0.010672,172.31.36.0-255,66,180611,8,328108
31964,0.012972,74.125.24.0-255,5738,186349,8,328108
31965,0.012981,172.31.36.0-255,66,186415,8,328108
31966,0.015307,74.125.24.0-255,5738,192153,8,328108
31967,0.015314,172.31.36.0-255,66,192219,8,328108
31968,0.017608,74.125.24.0-255,5738,197957,8,328108
31969,0.017617,172.31.36.0-255,66,198023,8,328108
31970,0.019929,74.125.24.0-255,5738,203761,8,328108
31971,0.019936,172.31.36.0-255,66,203827,8,328108
31972,0.022274,74.125.24.0-255,5738,209565,8,328108
31973,0.022285,172.31.36.0-255,66,209631,8,328108
31974,0.024629,74.125.24.0-255,5738,215369,8,328108
31975,0.024639,172.31.36.0-255,66,215435,8,328108
31976,0.026965,74.125.24.0-255,4320,219755,8,328108
31977,0.026974,172.31.36.0-255,66,219821,8,328108
31978,0.026994,74.125.24.0-255,1484,221305,8,328108
31979,0.029246,74.125.24.0-255,4320,225625,8,328108
31980,0.029254,172.31.36.0-255,66,225691,8,328108
31981,0.030548,172.31.36.0-255,172,225863,8,328108
31982,0.030581,172.31.36.0-255,1111,226974,8,328108
31983,0.030641,172.31.36.0-255,1514,228488,8,328108
31984,0.030642,172.31.36.0-255,754,229242,8,328108
31985,0.031569,74.125.24.0-255,5738,234980,8,328108
31986,0.031613,172.31.36.0-255,66,235046,8,328108
31987,0.032067,104.244.42.0-255,66,235112,8,328108
31988,0.03234,104.244.42.0-255,66,235178,8,328108
31989,0.032367,104.244.42.0-255,66,235244,8,328108
31990,0.03391,74.125.24.0-255,5738,240982,8,328108
31991,0.033917,172.31.36.0-255,66,241048,8,328108
31992,0.036215,74.125.24.0-255,5738,246786,8,328108
31993,0.036221,172.31.36.0-255,66,246852,8,328108
31994,0.038525,74.125.24.0-255,5738,252590,8,328108
31995,0.038532,172.31.36.0-255,66,252656,8,328108
31996,0.040864,74.125.24.0-255,5738,258394,8,328108
31997,0.040871,172.31.36.0-255,66,258460,8,328108
31998,0.043227,74.125.24.0-255,5738,264198,8,328108
31999,0.043234,172.31.36.0-255,66,264264,8,328108
32000,0.045515,74.125.24.0-255,5738,270002,8,328108
32001,0.045521,172.31.36.0-255,66,270068,8,328108
32002,0.047809,74.125.24.0-255,5738,275806,8,328108
32003,0.047816,172.31.36.0-255,66,275872,8,328108
32004,0.050115,74.125.24.0-255,5738,281610,8,328108
32005,0.050121,172.31.36.0-255,66,281676,8,328108
32006,0.052421,74.125.24.0-255,5738,287414,8,328108
32007,0.052428,172.31.36.0-255,66,287480,8,328108
32008,0.054747,74.125.24.0-255,5738,293218,8,328108
32009,0.054755,172.31.36.0-255,66,293284,8,328108
32010,0.057056,74.125.24.0-255,5738,299022,8,328108
32011,0.057063,172.31.36.0-255,66,299088,8,328108
32012,0.059386,74.125.24.0-255,5738,304826,8,328108
32013,0.059392,172.31.36.0-255,66,304892,8,328108
32014,0.061727,74.125.24.0-255,5738,310630,8,328108
32015,0.061734,172.31.36.0-255,66,310696,8,328108
32016,0.064048,74.125.24.0-255,5738,316434,8,328108
32017,0.064055,172.31.36.0-255,66,316500,8,328108
32018,0.066351,74.125.24.0-255,5738,322238,8,328108
32019,0.066357,172.31.36.0-255,66,322304,8,328108
32020,0.068686,74.125.24.0-255,5738,328042,8,328108
32021,0.068692,172.31.36.0-255,66,328108,8,328108
32022,0.0,74.125.68.0-255,158,158,8,260278
32023,3.9e-05,172.31.36.0-255,66,224,8,260278
32024,4.6e-05,74.125.68.0-255,1484,1708,8,260278
32025,5.2e-05,172.31.36.0-255,66,1774,8,260278
32026,6.6e-05,74.125.68.0-255,2902,4676,8,260278
32027,6.9e-05,172.31.36.0-255,66,4742,8,260278
32028,7.5e-05,74.125.68.0-255,5738,10480,8,260278
32029,7.9e-05,172.31.36.0-255,66,10546,8,260278
32030,8.4e-05,74.125.68.0-255,3485,14031,8,260278
32031,8.7e-05,172.31.36.0-255,66,14097,8,260278
32032,9.2e-05,74.125.68.0-255,4320,18417,8,260278
32033,9.5e-05,172.31.36.0-255,66,18483,8,260278
32034,9.9e-05,74.125.68.0-255,2902,21385,8,260278
32035,0.000101,172.31.36.0-255,66,21451,8,260278
32036,0.000136,74.125.68.0-255,7156,28607,8,260278
32037,0.000145,172.31.36.0-255,66,28673,8,260278
32038,0.000175,74.125.68.0-255,1484,30157,8,260278
32039,0.000177,172.31.36.0-255,66,30223,8,260278
32040,0.000181,74.125.68.0-255,1125,31348,8,260278
32041,0.000183,172.31.36.0-255,66,31414,8,260278
32042,0.000203,74.125.68.0-255,1484,32898,8,260278
32043,0.000205,172.31.36.0-255,66,32964,8,260278
32044,0.000215,74.125.68.0-255,2902,35866,8,260278
32045,0.000218,172.31.36.0-255,66,35932,8,260278
32046,0.000264,74.125.68.0-255,5738,41670,8,260278
32047,0.000268,172.31.36.0-255,66,41736,8,260278
32048,0.000273,74.125.68.0-255,2902,44638,8,260278
32049,0.000275,172.31.36.0-255,66,44704,8,260278
32050,0.000298,74.125.68.0-255,3961,48665,8,260278
32051,0.000307,172.31.36.0-255,66,48731,8,260278
32052,0.00098,74.125.68.0-255,1484,50215,8,260278
32053,0.000985,172.31.36.0-255,66,50281,8,260278
32054,0.000993,74.125.68.0-255,2902,53183,8,260278
32055,0.000995,172.31.36.0-255,66,53249,8,260278
32056,0.001006,74.125.68.0-255,5738,58987,8,260278
32057,0.001009,172.31.36.0-255,66,59053,8,260278
32058,0.001042,74.125.68.0-255,6797,65850,8,260278
32059,0.001045,172.31.36.0-255,66,65916,8,260278
32060,0.001048,74.125.68.0-255,646,66562,8,260278
32061,0.002156,74.125.68.0-255,1484,68046,8,260278
32062,0.002164,172.31.36.0-255,66,68112,8,260278
32063,0.002168,74.125.68.0-255,1484,69596,8,260278
32064,0.002195,74.125.68.0-255,2902,72498,8,260278
32065,0.002197,172.31.36.0-255,66,72564,8,260278
32066,0.002227,74.125.68.0-255,5738,78302,8,260278
32067,0.002229,172.31.36.0-255,66,78368,8,260278
32068,0.002232,74.125.68.0-255,1484,79852,8,260278
32069,0.002236,74.125.68.0-255,2902,82754,8,260278
32070,0.002238,172.31.36.0-255,66,82820,8,260278
32071,0.002272,74.125.68.0-255,1484,84304,8,260278
32072,0.002287,74.125.68.0-255,2902,87206,8,260278
32073,0.002289,172.31.36.0-255,66,87272,8,260278
32074,0.004479,74.125.68.0-255,1484,88756,8,260278
32075,0.004546,74.125.68.0-255,4320,93076,8,260278
32076,0.004551,172.31.36.0-255,66,93142,8,260278
32077,0.006805,74.125.68.0-255,2902,96044,8,260278
32078,0.006811,172.31.36.0-255,66,96110,8,260278
32079,0.006845,74.125.68.0-255,2902,99012,8,260278
32080,0.006849,172.31.36.0-255,66,99078,8,260278
32081,0.009079,74.125.68.0-255,2902,101980,8,260278
32082,0.009092,172.31.36.0-255,66,102046,8,260278
32083,0.009128,74.125.68.0-255,2902,104948,8,260278
32084,0.009132,172.31.36.0-255,66,105014,8,260278
32085,0.011373,74.125.68.0-255,2902,107916,8,260278
32086,0.011385,172.31.36.0-255,66,107982,8,260278
32087,0.011429,74.125.68.0-255,2902,110884,8,260278
32088,0.011433,172.31.36.0-255,66,110950,8,260278
32089,0.013653,74.125.68.0-255,2902,113852,8,260278
32090,0.013669,172.31.36.0-255,66,113918,8,260278
32091,0.013717,74.125.68.0-255,2902,116820,8,260278
32092,0.013722,172.31.36.0-255,66,116886,8,260278
32093,0.015947,74.125.68.0-255,2902,119788,8,260278
32094,0.015971,172.31.36.0-255,66,119854,8,260278
32095,0.01603,74.125.68.0-255,2902,122756,8,260278
32096,0.016033,172.31.36.0-255,66,122822,8,260278
32097,0.018246,74.125.68.0-255,2902,125724,8,260278
32098,0.018265,172.31.36.0-255,66,125790,8,260278
32099,0.018314,74.125.68.0-255,2902,128692,8,260278
32100,0.018318,172.31.36.0-255,66,128758,8,260278
32101,0.020535,74.125.68.0-255,2902,131660,8,260278
32102,0.020547,172.31.36.0-255,66,131726,8,260278
32103,0.020591,74.125.68.0-255,2902,134628,8,260278
32104,0.020613,172.31.36.0-255,66,134694,8,260278
32105,0.022842,74.125.68.0-255,2902,137596,8,260278
32106,0.02286,172.31.36.0-255,66,137662,8,260278
32107,0.022913,74.125.68.0-255,2902,140564,8,260278
32108,0.022917,172.31.36.0-255,66,140630,8,260278
32109,0.025137,74.125.68.0-255,2902,143532,8,260278
32110,0.025152,172.31.36.0-255,66,143598,8,260278
32111,0.025202,74.125.68.0-255,2902,146500,8,260278
32112,0.025206,172.31.36.0-255,66,146566,8,260278
32113,0.027007,172.31.36.0-255,172,146738,8,260278
32114,0.027035,172.31.36.0-255,1110,147848,8,260278
32115,0.027081,172.31.36.0-255,1428,149276,8,260278
32116,0.027409,74.125.68.0-255,2902,152178,8,260278
32117,0.027419,172.31.36.0-255,66,152244,8,260278
32118,0.027449,74.125.68.0-255,2902,155146,8,260278
32119,0.027453,172.31.36.0-255,66,155212,8,260278
32120,0.028575,104.244.42.0-255,66,155278,8,260278
32121,0.028615,104.244.42.0-255,66,155344,8,260278
32122,0.028665,104.244.42.0-255,66,155410,8,260278
32123,0.029687,74.125.68.0-255,2902,158312,8,260278
32124,0.029698,172.31.36.0-255,66,158378,8,260278
32125,0.029737,74.125.68.0-255,2902,161280,8,260278
32126,0.029741,172.31.36.0-255,66,161346,8,260278
32127,0.031958,74.125.68.0-255,2902,164248,8,260278
32128,0.031967,172.31.36.0-255,66,164314,8,260278
32129,0.032001,74.125.68.0-255,2902,167216,8,260278
32130,0.032004,172.31.36.0-255,66,167282,8,260278
32131,0.034204,74.125.68.0-255,2902,170184,8,260278
32132,0.03421,172.31.36.0-255,66,170250,8,260278
32133,0.034245,74.125.68.0-255,2902,173152,8,260278
32134,0.034248,172.31.36.0-255,66,173218,8,260278
32135,0.036494,74.125.68.0-255,5738,178956,8,260278
32136,0.036504,172.31.36.0-255,66,179022,8,260278
32137,0.038769,74.125.68.0-255,5738,184760,8,260278
32138,0.038781,172.31.36.0-255,66,184826,8,260278
32139,0.041037,74.125.68.0-255,5738,190564,8,260278
32140,0.04106,172.31.36.0-255,66,190630,8,260278
32141,0.043319,74.125.68.0-255,5738,196368,8,260278
32142,0.04333,172.31.36.0-255,66,196434,8,260278
32143,0.045596,74.125.68.0-255,5738,202172,8,260278
32144,0.045609,172.31.36.0-255,66,202238,8,260278
32145,0.047872,74.125.68.0-255,5738,207976,8,260278
32146,0.047879,172.31.36.0-255,66,208042,8,260278
32147,0.050291,74.125.68.0-255,5738,213780,8,260278
32148,0.050298,172.31.36.0-255,66,213846,8,260278
32149,0.052558,74.125.68.0-255,5738,219584,8,260278
32150,0.052564,172.31.36.0-255,66,219650,8,260278
32151,0.054825,74.125.68.0-255,5738,225388,8,260278
32152,0.054836,172.31.36.0-255,66,225454,8,260278
32153,0.0571,74.125.68.0-255,5738,231192,8,260278
32154,0.05711,172.31.36.0-255,66,231258,8,260278
32155,0.059374,74.125.68.0-255,5738,236996,8,260278
32156,0.059382,172.31.36.0-255,66,237062,8,260278
32157,0.061642,74.125.68.0-255,5738,242800,8,260278
32158,0.061653,172.31.36.0-255,66,242866,8,260278
32159,0.063969,74.125.68.0-255,5738,248604,8,260278
32160,0.063978,172.31.36.0-255,66,248670,8,260278
32161,0.066252,74.125.68.0-255,5738,254408,8,260278
32162,0.066263,172.31.36.0-255,66,254474,8,260278
32163,0.068539,74.125.68.0-255,5738,260212,8,260278
32164,0.068554,172.31.36.0-255,66,260278,8,260278
32165,0.0,172.217.160.0-255,153,153,8,324266
32166,2.4e-05,172.31.36.0-255,66,219,8,324266
32167,3.3e-05,172.217.160.0-255,1484,1703,8,324266
32168,3.7e-05,172.31.36.0-255,66,1769,8,324266
32169,4.3e-05,172.217.160.0-255,2902,4671,8,324266
32170,4.7e-05,172.31.36.0-255,66,4737,8,324266
32171,5.4e-05,172.217.160.0-255,5738,10475,8,324266
32172,5.8e-05,172.31.36.0-255,66,10541,8,324266
32173,9.4e-05,172.217.160.0-255,3510,14051,8,324266
32174,9.7e-05,172.31.36.0-255,66,14117,8,324266
32175,0.000104,172.217.160.0-255,4320,18437,8,324266
32176,0.000106,172.31.36.0-255,66,18503,8,324266
32177,0.000151,172.217.160.0-255,2902,21405,8,324266
32178,0.000153,172.31.36.0-255,66,21471,8,324266
32179,0.000177,172.217.160.0-255,7156,28627,8,324266
32180,0.00018,172.31.36.0-255,66,28693,8,324266
32181,0.000184,172.217.160.0-255,2543,31236,8,324266
32182,0.000186,172.31.36.0-255,66,31302,8,324266
32183,0.000204,172.217.160.0-255,1484,32786,8,324266
32184,0.000206,172.31.36.0-255,66,32852,8,324266
32185,0.00021,172.217.160.0-255,1484,34336,8,324266
32186,0.000212,172.31.36.0-255,66,34402,8,324266
32187,0.000234,172.217.160.0-255,1484,35886,8,324266
32188,0.000236,172.31.36.0-255,66,35952,8,324266
32189,0.000242,172.217.160.0-255,5738,41690,8,324266
32190,0.000244,172.31.36.0-255,66,41756,8,324266
32191,0.000282,172.31.36.0-255,66,41822,8,324266
32192,0.000294,172.31.36.0-255,66,41888,8,324266
32193,0.000299,172.217.160.0-255,3961,45849,8,324266
32194,0.000302,172.31.36.0-255,66,45915,8,324266
32195,0.000368,172.217.160.0-255,335,46250,8,324266
32196,0.000677,172.217.160.0-255,125,46375,8,324266
32197,0.000774,172.217.160.0-255,1484,47859,8,324266
32198,0.000779,172.31.36.0-255,66,47925,8,324266
32199,0.000785,172.217.160.0-255,2902,50827,8,324266
32200,0.000787,172.31.36.0-255,66,50893,8,324266
32201,0.000794,172.217.160.0-255,5738,56631,8,324266
32202,0.000796,172.31.36.0-255,66,56697,8,324266
32203,0.000831,172.217.160.0-255,2902,59599,8,324266
32204,0.000834,172.31.36.0-255,66,59665,8,324266
32205,0.000864,172.31.36.0-255,66,59731,8,324266
32206,0.000911,172.31.36.0-255,66,59797,8,324266
32207,0.000932,172.217.160.0-255,5113,64910,8,324266
32208,0.000934,172.31.36.0-255,66,64976,8,324266
32209,0.000938,172.217.160.0-255,1484,66460,8,324266
32210,0.000943,172.217.160.0-255,4320,70780,8,324266
32211,0.000946,172.31.36.0-255,66,70846,8,324266
32212,0.000968,172.217.160.0-255,5365,76211,8,324266
32213,0.000971,172.31.36.0-255,66,76277,8,324266
32214,0.002602,172.217.160.0-255,5738,82015,8,324266
32215,0.002609,172.31.36.0-255,66,82081,8,324266
32216,0.004235,172.217.160.0-255,5738,87819,8,324266
32217,0.004239,172.31.36.0-255,66,87885,8,324266
32218,0.00586,172.217.160.0-255,5738,93623,8,324266
32219,0.005866,172.31.36.0-255,66,93689,8,324266
32220,0.0075,172.217.160.0-255,5738,99427,8,324266
32221,0.007506,172.31.36.0-255,66,99493,8,324266
32222,0.009144,172.217.160.0-255,5738,105231,8,324266
32223,0.009154,172.31.36.0-255,66,105297,8,324266
32224,0.010789,172.217.160.0-255,5738,111035,8,324266
32225,0.010798,172.31.36.0-255,66,111101,8,324266
32226,0.012439,172.217.160.0-255,5738,116839,8,324266
32227,0.012447,172.31.36.0-255,66,116905,8,324266
32228,0.014079,172.217.160.0-255,5738,122643,8,324266
32229,0.014088,172.31.36.0-255,66,122709,8,324266
32230,0.015724,172.217.160.0-255,5738,128447,8,324266
32231,0.015731,172.31.36.0-255,66,128513,8,324266
32232,0.017424,172.217.160.0-255,5738,134251,8,324266
32233,0.017432,172.31.36.0-255,66,134317,8,324266
32234,0.019059,172.217.160.0-255,5738,140055,8,324266
32235,0.019067,172.31.36.0-255,66,140121,8,324266
32236,0.020696,172.217.160.0-255,5738,145859,8,324266
32237,0.020704,172.31.36.0-255,66,145925,8,324266
32238,0.022338,172.217.160.0-255,5738,151663,8,324266
32239,0.022345,172.31.36.0-255,66,151729,8,324266
32240,0.023985,172.217.160.0-255,5738,157467,8,324266
32241,0.023993,172.31.36.0-255,66,157533,8,324266
32242,0.025621,172.217.160.0-255,5738,163271,8,324266
32243,0.025629,172.31.36.0-255,66,163337,8,324266
32244,0.027261,172.217.160.0-255,5738,169075,8,324266
32245,0.027267,172.31.36.0-255,66,169141,8,324266
32246,0.02881,172.31.36.0-255,171,169312,8,324266
32247,0.028841,172.31.36.0-255,1136,170448,8,324266
32248,0.028891,172.217.160.0-255,5738,176186,8,324266
32249,0.028897,172.31.36.0-255,66,176252,8,324266
32250,0.028927,172.31.36.0-255,1514,177766,8,324266
32251,0.028928,172.31.36.0-255,1268,179034,8,324266
32252,0.030326,104.244.42.0-255,66,179100,8,324266
32253,0.030417,104.244.42.0-255,66,179166,8,324266
32254,0.030502,104.244.42.0-255,66,179232,8,324266
32255,0.03053,172.217.160.0-255,5738,184970,8,324266
32256,0.030536,172.31.36.0-255,66,185036,8,324266
32257,0.032175,172.217.160.0-255,5738,190774,8,324266
32258,0.032182,172.31.36.0-255,66,190840,8,324266
32259,0.03381,172.217.160.0-255,5738,196578,8,324266
32260,0.033817,172.31.36.0-255,66,196644,8,324266
32261,0.035481,172.217.160.0-255,5738,202382,8,324266
32262,0.035487,172.31.36.0-255,66,202448,8,324266
32263,0.037126,172.217.160.0-255,5738,208186,8,324266
32264,0.037134,172.31.36.0-255,66,208252,8,324266
32265,0.03877,172.217.160.0-255,5738,213990,8,324266
32266,0.03878,172.31.36.0-255,66,214056,8,324266
32267,0.04042,172.217.160.0-255,5738,219794,8,324266
32268,0.040427,172.31.36.0-255,66,219860,8,324266
32269,0.042066,172.217.160.0-255,5738,225598,8,324266
32270,0.042073,172.31.36.0-255,66,225664,8,324266
32271,0.043706,172.217.160.0-255,5738,231402,8,324266
32272,0.043713,172.31.36.0-255,66,231468,8,324266
32273,0.045345,172.217.160.0-255,5738,237206,8,324266
32274,0.045352,172.31.36.0-255,66,237272,8,324266
32275,0.046998,172.217.160.0-255,5738,243010,8,324266
32276,0.047005,172.31.36.0-255,66,243076,8,324266
32277,0.048641,172.217.160.0-255,5738,248814,8,324266
32278,0.048648,172.31.36.0-255,66,248880,8,324266
32279,0.050279,172.217.160.0-255,5738,254618,8,324266
32280,0.050286,172.31.36.0-255,66,254684,8,324266
32281,0.051919,172.217.160.0-255,5738,260422,8,324266
32282,0.051926,172.31.36.0-255,66,260488,8,324266
32283,0.05356,172.217.160.0-255,5738,266226,8,324266
32284,0.053566,172.31.36.0-255,66,266292,8,324266
32285,0.055199,172.217.160.0-255,5738,272030,8,324266
32286,0.055204,172.31.36.0-255,66,272096,8,324266
32287,0.056839,172.217.160.0-255,5738,277834,8,324266
32288,0.056845,172.31.36.0-255,66,277900,8,324266
32289,0.05847,172.217.160.0-255,5738,283638,8,324266
32290,0.058477,172.31.36.0-255,66,283704,8,324266
32291,0.06011,172.217.160.0-255,5738,289442,8,324266
32292,0.060117,172.31.36.0-255,66,289508,8,324266
32293,0.061759,172.217.160.0-255,5738,295246,8,324266
32294,0.061766,172.31.36.0-255,66,295312,8,324266
32295,0.063401,172.217.160.0-255,5738,301050,8,324266
32296,0.063408,172.31.36.0-255,66,301116,8,324266
32297,0.065054,172.217.160.0-255,5738,306854,8,324266
32298,0.065061,172.31.36.0-255,66,306920,8,324266
32299,0.066695,172.217.160.0-255,5738,312658,8,324266
32300,0.066702,172.31.36.0-255,66,312724,8,324266
32301,0.06833,172.217.160.0-255,5738,318462,8,324266
32302,0.068336,172.31.36.0-255,66,318528,8,324266
32303,0.069999,172.217.160.0-255,5738,324266,8,324266
32304,0.0,172.31.36.0-255,105,105,8,525
32305,0.000211,172.31.36.0-255,90,195,8,525
32306,0.000222,172.31.36.0-255,66,261,8,525
32307,0.002462,74.125.24.0-255,66,327,8,525
32308,0.002474,74.125.24.0-255,66,393,8,525
32309,0.00248,172.31.36.0-255,66,459,8,525
32310,0.002483,74.125.24.0-255,66,525,8,525
32311,0.0,74.125.24.0-255,143,143,8,267106
32312,2.5e-05,172.31.36.0-255,66,209,8,267106
32313,3.2e-05,74.125.24.0-255,1484,1693,8,267106
32314,3.6e-05,172.31.36.0-255,66,1759,8,267106
32315,4.1e-05,74.125.24.0-255,2902,4661,8,267106
32316,4.4e-05,172.31.36.0-255,66,4727,8,267106
32317,5.8e-05,74.125.24.0-255,7156,11883,8,267106
32318,6.1e-05,172.31.36.0-255,66,11949,8,267106
32319,6.5e-05,74.125.24.0-255,2072,14021,8,267106
32320,6.8e-05,172.31.36.0-255,66,14087,8,267106
32321,0.000104,74.125.24.0-255,2902,16989,8,267106
32322,0.000107,172.31.36.0-255,66,17055,8,267106
32323,0.000114,74.125.24.0-255,7156,24211,8,267106
32324,0.000117,172.31.36.0-255,66,24277,8,267106
32325,0.000122,74.125.24.0-255,4320,28597,8,267106
32326,0.000123,172.31.36.0-255,66,28663,8,267106
32327,0.000138,74.125.24.0-255,2543,31206,8,267106
32328,0.000146,172.31.36.0-255,66,31272,8,267106
32329,0.000204,74.125.24.0-255,1484,32756,8,267106
32330,0.000208,172.31.36.0-255,66,32822,8,267106
32331,0.000212,74.125.24.0-255,2902,35724,8,267106
32332,0.000215,172.31.36.0-255,66,35790,8,267106
32333,0.000217,74.125.24.0-255,1484,37274,8,267106
32334,0.000225,172.31.36.0-255,66,37340,8,267106
32335,0.00023,74.125.24.0-255,2902,40242,8,267106
32336,0.000232,172.31.36.0-255,66,40308,8,267106
32337,0.000271,74.125.24.0-255,2902,43210,8,267106
32338,0.000276,172.31.36.0-255,66,43276,8,267106
32339,0.00029,172.31.36.0-255,66,43342,8,267106
32340,0.0003,172.31.36.0-255,66,43408,8,267106
32341,0.000302,74.125.24.0-255,366,43774,8,267106
32342,0.00035,74.125.24.0-255,410,44184,8,267106
32343,0.000591,74.125.24.0-255,1484,45668,8,267106
32344,0.000595,74.125.24.0-255,2902,48570,8,267106
32345,0.000596,172.31.36.0-255,66,48636,8,267106
32346,0.0006,172.31.36.0-255,66,48702,8,267106
32347,0.000624,74.125.24.0-255,5738,54440,8,267106
32348,0.000633,172.31.36.0-255,66,54506,8,267106
32349,0.000641,74.125.24.0-255,7156,61662,8,267106
32350,0.000643,172.31.36.0-255,66,61728,8,267106
32351,0.000648,74.125.24.0-255,4320,66048,8,267106
32352,0.00065,172.31.36.0-255,66,66114,8,267106
32353,0.00069,172.31.36.0-255,66,66180,8,267106
32354,0.000695,74.125.24.0-255,2184,68364,8,267106
32355,0.000698,172.31.36.0-255,66,68430,8,267106
32356,0.001059,74.125.24.0-255,1484,69914,8,267106
32357,0.001065,74.125.24.0-255,2902,72816,8,267106
32358,0.001068,172.31.36.0-255,66,72882,8,267106
32359,0.001072,74.125.24.0-255,1484,74366,8,267106
32360,0.001113,74.125.24.0-255,4320,78686,8,267106
32361,0.001117,172.31.36.0-255,66,78752,8,267106
32362,0.001125,74.125.24.0-255,7156,85908,8,267106
32363,0.001127,172.31.36.0-255,66,85974,8,267106
32364,0.001146,172.31.36.0-255,66,86040,8,267106
32365,0.00115,74.125.24.0-255,2184,88224,8,267106
32366,0.001153,172.31.36.0-255,66,88290,8,267106
32367,0.001256,74.125.24.0-255,1484,89774,8,267106
32368,0.001261,74.125.24.0-255,1484,91258,8,267106
32369,0.001264,172.31.36.0-255,66,91324,8,267106
32370,0.001276,74.125.24.0-255,1484,92808,8,267106
32371,0.001286,74.125.24.0-255,4320,97128,8,267106
32372,0.001289,172.31.36.0-255,66,97194,8,267106
32373,0.0013,74.125.24.0-255,1484,98678,8,267106
32374,0.001312,74.125.24.0-255,7156,105834,8,267106
32375,0.001315,172.31.36.0-255,66,105900,8,267106
32376,0.001345,74.125.24.0-255,5738,111638,8,267106
32377,0.001349,172.31.36.0-255,66,111704,8,267106
32378,0.001384,172.31.36.0-255,66,111770,8,267106
32379,0.001823,74.125.24.0-255,1484,113254,8,267106
32380,0.001831,74.125.24.0-255,2902,116156,8,267106
32381,0.001836,172.31.36.0-255,66,116222,8,267106
32382,0.001843,74.125.24.0-255,5738,121960,8,267106
32383,0.001845,172.31.36.0-255,66,122026,8,267106
32384,0.001886,172.31.36.0-255,66,122092,8,267106
32385,0.001899,172.31.36.0-255,66,122158,8,267106
32386,0.002051,74.125.24.0-255,1484,123642,8,267106
32387,0.002058,74.125.24.0-255,2902,126544,8,267106
32388,0.002062,172.31.36.0-255,66,126610,8,267106
32389,0.002069,74.125.24.0-255,5738,132348,8,267106
32390,0.002071,172.31.36.0-255,66,132414,8,267106
32391,0.002117,172.31.36.0-255,66,132480,8,267106
32392,0.002145,74.125.24.0-255,4320,136800,8,267106
32393,0.002147,172.31.36.0-255,66,136866,8,267106
32394,0.002187,172.31.36.0-255,66,136932,8,267106
32395,0.002201,172.31.36.0-255,66,136998,8,267106
32396,0.002206,74.125.24.0-255,4320,141318,8,267106
32397,0.002209,172.31.36.0-255,66,141384,8,267106
32398,0.002264,172.31.36.0-255,66,141450,8,267106
32399,0.002275,172.31.36.0-255,66,141516,8,267106
32400,0.002628,172.31.36.0-255,66,141582,8,267106
32401,0.00489,74.125.24.0-255,5738,147320,8,267106
32402,0.004895,172.31.36.0-255,66,147386,8,267106
32403,0.007161,74.125.24.0-255,4320,151706,8,267106
32404,0.007166,172.31.36.0-255,66,151772,8,267106
32405,0.007196,74.125.24.0-255,1484,153256,8,267106
32406,0.009439,74.125.24.0-255,4320,157576,8,267106
32407,0.009447,172.31.36.0-255,66,157642,8,267106
32408,0.011726,74.125.24.0-255,5738,163380,8,267106
32409,0.011734,172.31.36.0-255,66,163446,8,267106
32410,0.014042,74.125.24.0-255,5738,169184,8,267106
32411,0.014049,172.31.36.0-255,66,169250,8,267106
32412,0.016311,74.125.24.0-255,5738,174988,8,267106
32413,0.016318,172.31.36.0-255,66,175054,8,267106
32414,0.018597,74.125.24.0-255,5738,180792,8,267106
32415,0.018605,172.31.36.0-255,66,180858,8,267106
32416,0.020857,74.125.24.0-255,5738,186596,8,267106
32417,0.020863,172.31.36.0-255,66,186662,8,267106
32418,0.023146,74.125.24.0-255,5738,192400,8,267106
32419,0.023156,172.31.36.0-255,66,192466,8,267106
32420,0.025427,74.125.24.0-255,5738,198204,8,267106
32421,0.025434,172.31.36.0-255,66,198270,8,267106
32422,0.027705,74.125.24.0-255,5738,204008,8,267106
32423,0.027712,172.31.36.0-255,66,204074,8,267106
32424,0.029986,74.125.24.0-255,5738,209812,8,267106
32425,0.029992,172.31.36.0-255,66,209878,8,267106
32426,0.032248,74.125.24.0-255,5738,215616,8,267106
32427,0.032256,172.31.36.0-255,66,215682,8,267106
32428,0.034517,74.125.24.0-255,5738,221420,8,267106
32429,0.034523,172.31.36.0-255,66,221486,8,267106
32430,0.036803,74.125.24.0-255,5738,227224,8,267106
32431,0.036812,172.31.36.0-255,66,227290,8,267106
32432,0.039093,74.125.24.0-255,5738,233028,8,267106
32433,0.039101,172.31.36.0-255,66,233094,8,267106
32434,0.041373,74.125.24.0-255,5738,238832,8,267106
32435,0.04138,172.31.36.0-255,66,238898,8,267106
32436,0.042155,172.31.36.0-255,172,239070,8,267106
32437,0.042201,172.31.36.0-255,1110,240180,8,267106
32438,0.042268,172.31.36.0-255,572,240752,8,267106
32439,0.043667,74.125.24.0-255,5738,246490,8,267106
32440,0.043677,172.31.36.0-255,66,246556,8,267106
32441,0.043704,104.244.42.0-255,66,246622,8,267106
32442,0.043747,104.244.42.0-255,66,246688,8,267106
32443,0.043797,104.244.42.0-255,66,246754,8,267106
32444,0.045963,74.125.24.0-255,5738,252492,8,267106
32445,0.045976,172.31.36.0-255,66,252558,8,267106
32446,0.048244,74.125.24.0-255,5738,258296,8,267106
32447,0.04825,172.31.36.0-255,66,258362,8,267106
32448,0.050537,74.125.24.0-255,5738,264100,8,267106
32449,0.050542,172.31.36.0-255,66,264166,8,267106
32450,0.052823,74.125.24.0-255,2178,266344,8,267106
32451,0.052828,172.31.36.0-255,66,266410,8,267106
32452,0.052981,172.31.36.0-255,105,266515,8,267106
32453,0.053005,172.31.36.0-255,105,266620,8,267106
32454,0.053922,172.31.36.0-255,90,266710,8,267106
32455,0.053933,172.31.36.0-255,66,266776,8,267106
32456,0.055219,74.125.24.0-255,66,266842,8,267106
32457,0.055226,74.125.24.0-255,66,266908,8,267106
32458,0.056148,74.125.24.0-255,66,266974,8,267106
32459,0.056221,74.125.24.0-255,66,267040,8,267106
32460,0.056226,172.31.36.0-255,66,267106,8,267106
32461,0.0,74.125.24.0-255,150,150,8,336373
32462,2.8e-05,172.31.36.0-255,66,216,8,336373
32463,3.4e-05,74.125.24.0-255,1484,1700,8,336373
32464,3.8e-05,172.31.36.0-255,66,1766,8,336373
32465,4.9e-05,74.125.24.0-255,2902,4668,8,336373
32466,5.2e-05,172.31.36.0-255,66,4734,8,336373
32467,5.7e-05,74.125.24.0-255,4320,9054,8,336373
32468,5.9e-05,172.31.36.0-255,66,9120,8,336373
32469,8.4e-05,74.125.24.0-255,2902,12022,8,336373
32470,8.7e-05,172.31.36.0-255,66,12088,8,336373
32471,9.1e-05,74.125.24.0-255,3421,15509,8,336373
32472,9.3e-05,172.31.36.0-255,66,15575,8,336373
32473,9.8e-05,74.125.24.0-255,4320,19895,8,336373
32474,0.000101,172.31.36.0-255,66,19961,8,336373
32475,0.000144,172.31.36.0-255,66,20027,8,336373
32476,0.000147,74.125.24.0-255,1125,21152,8,336373
32477,0.000148,172.31.36.0-255,66,21218,8,336373
32478,0.000221,74.125.24.0-255,1484,22702,8,336373
32479,0.000224,74.125.24.0-255,1484,24186,8,336373
32480,0.000226,172.31.36.0-255,66,24252,8,336373
32481,0.000229,172.31.36.0-255,66,24318,8,336373
32482,0.00025,74.125.24.0-255,1484,25802,8,336373
32483,0.000253,172.31.36.0-255,66,25868,8,336373
32484,0.000259,74.125.24.0-255,5738,31606,8,336373
32485,0.000261,74.125.24.0-255,1484,33090,8,336373
32486,0.000262,172.31.36.0-255,66,33156,8,336373
32487,0.000265,172.31.36.0-255,66,33222,8,336373
32488,0.000304,74.125.24.0-255,5379,38601,8,336373
32489,0.000307,172.31.36.0-255,66,38667,8,336373
32490,0.000321,74.125.24.0-255,2543,41210,8,336373
32491,0.000321,172.31.36.0-255,66,41276,8,336373
32492,0.000323,74.125.24.0-255,400,41676,8,336373
32493,0.000324,172.31.36.0-255,66,41742,8,336373
32494,0.000524,74.125.24.0-255,345,42087,8,336373
32495,0.000566,74.125.24.0-255,1484,43571,8,336373
32496,0.000569,172.31.36.0-255,66,43637,8,336373
32497,0.000573,74.125.24.0-255,1484,45121,8,336373
32498,0.000589,74.125.24.0-255,2902,48023,8,336373
32499,0.000591,172.31.36.0-255,66,48089,8,336373
32500,0.000595,74.125.24.0-255,1484,49573,8,336373
32501,0.000597,74.125.24.0-255,1484,51057,8,336373
32502,0.000599,172.31.36.0-255,66,51123,8,336373
32503,0.000631,74.125.24.0-255,5738,56861,8,336373
32504,0.000634,172.31.36.0-255,66,56927,8,336373
32505,0.000662,74.125.24.0-255,7156,64083,8,336373
32506,0.000664,172.31.36.0-255,66,64149,8,336373
32507,0.000696,172.31.36.0-255,66,64215,8,336373
32508,0.000701,74.125.24.0-255,3602,67817,8,336373
32509,0.000703,74.125.24.0-255,1484,69301,8,336373
32510,0.000705,172.31.36.0-255,66,69367,8,336373
32511,0.000706,74.125.24.0-255,2902,72269,8,336373
32512,0.000709,172.31.36.0-255,66,72335,8,336373
32513,0.00075,74.125.24.0-255,5738,78073,8,336373
32514,0.000754,172.31.36.0-255,66,78139,8,336373
32515,0.000768,172.31.36.0-255,66,78205,8,336373
32516,0.000803,74.125.24.0-255,4320,82525,8,336373
32517,0.000805,172.31.36.0-255,66,82591,8,336373
32518,0.000833,74.125.24.0-255,6438,89029,8,336373
32519,0.000837,172.31.36.0-255,66,89095,8,336373
32520,0.000841,74.125.24.0-255,1484,90579,8,336373
32521,0.000861,74.125.24.0-255,2902,93481,8,336373
32522,0.000864,172.31.36.0-255,66,93547,8,336373
32523,0.000883,74.125.24.0-255,5738,99285,8,336373
32524,0.000886,172.31.36.0-255,66,99351,8,336373
32525,0.000891,74.125.24.0-255,4320,103671,8,336373
32526,0.000894,172.31.36.0-255,66,103737,8,336373
32527,0.000926,172.31.36.0-255,66,103803,8,336373
32528,0.000953,74.125.24.0-255,5738,109541,8,336373
32529,0.000956,172.31.36.0-255,66,109607,8,336373
32530,0.00097,74.125.24.0-255,5020,114627,8,336373
32531,0.000976,172.31.36.0-255,66,114693,8,336373
32532,0.000981,74.125.24.0-255,4320,119013,8,336373
32533,0.000984,172.31.36.0-255,66,119079,8,336373
32534,0.001017,74.125.24.0-255,7156,126235,8,336373
32535,0.00102,172.31.36.0-255,66,126301,8,336373
32536,0.001024,74.125.24.0-255,3782,130083,8,336373
32537,0.001026,172.31.36.0-255,66,130149,8,336373
32538,0.001054,74.125.24.0-255,1484,131633,8,336373
32539,0.001058,74.125.24.0-255,2902,134535,8,336373
32540,0.00106,172.31.36.0-255,66,134601,8,336373
32541,0.001065,74.125.24.0-255,4320,138921,8,336373
32542,0.001067,172.31.36.0-255,66,138987,8,336373
32543,0.001094,74.125.24.0-255,1484,140471,8,336373
32544,0.001105,172.31.36.0-255,66,140537,8,336373
32545,0.001135,74.125.24.0-255,2902,143439,8,336373
32546,0.001138,172.31.36.0-255,66,143505,8,336373
32547,0.001144,74.125.24.0-255,5738,149243,8,336373
32548,0.001146,172.31.36.0-255,66,149309,8,336373
32549,0.00115,74.125.24.0-255,2902,152211,8,336373
32550,0.001152,172.31.36.0-255,66,152277,8,336373
32551,0.001178,74.125.24.0-255,2184,154461,8,336373
32552,0.001181,172.31.36.0-255,66,154527,8,336373
32553,0.00175,74.125.24.0-255,1484,156011,8,336373
32554,0.001756,74.125.24.0-255,2902,158913,8,336373
32555,0.001759,172.31.36.0-255,66,158979,8,336373
32556,0.001765,74.125.24.0-255,5738,164717,8,336373
32557,0.001766,172.31.36.0-255,66,164783,8,336373
32558,0.001806,172.31.36.0-255,66,164849,8,336373
32559,0.001808,74.125.24.0-255,1484,166333,8,336373
32560,0.001846,172.31.36.0-255,66,166399,8,336373
32561,0.00421,74.125.24.0-255,5738,172137,8,336373
32562,0.004216,172.31.36.0-255,66,172203,8,336373
32563,0.006552,74.125.24.0-255,4320,176523,8,336373
32564,0.006557,172.31.36.0-255,66,176589,8,336373
32565,0.006588,74.125.24.0-255,1484,178073,8,336373
32566,0.008931,74.125.24.0-255,4320,182393,8,336373
32567,0.008938,172.31.36.0-255,66,182459,8,336373
32568,0.011295,74.125.24.0-255,5738,188197,8,336373
32569,0.011302,172.31.36.0-255,66,188263,8,336373
32570,0.013624,74.125.24.0-255,5738,194001,8,336373
32571,0.013631,172.31.36.0-255,66,194067,8,336373
32572,0.015977,74.125.24.0-255,5738,199805,8,336373
32573,0.015988,172.31.36.0-255,66,199871,8,336373
32574,0.018329,74.125.24.0-255,5738,205609,8,336373
32575,0.018342,172.31.36.0-255,66,205675,8,336373
32576,0.02071,74.125.24.0-255,5738,211413,8,336373
32577,0.020747,172.31.36.0-255,66,211479,8,336373
32578,0.023056,74.125.24.0-255,5738,217217,8,336373
32579,0.023063,172.31.36.0-255,66,217283,8,336373
32580,0.025409,74.125.24.0-255,5738,223021,8,336373
32581,0.025418,172.31.36.0-255,66,223087,8,336373
32582,0.027771,74.125.24.0-255,5738,228825,8,336373
32583,0.027778,172.31.36.0-255,66,228891,8,336373
32584,0.030015,172.31.36.0-255,172,229063,8,336373
32585,0.030045,172.31.36.0-255,1110,230173,8,336373
32586,0.030082,172.31.36.0-255,1514,231687,8,336373
32587,0.030083,172.31.36.0-255,1514,233201,8,336373
32588,0.030088,172.31.36.0-255,1514,234715,8,336373
32589,0.030089,172.31.36.0-255,1514,236229,8,336373
32590,0.030109,74.125.24.0-255,4320,240549,8,336373
32591,0.030113,172.31.36.0-255,66,240615,8,336373
32592,0.030118,172.31.36.0-255,1514,242129,8,336373
32593,0.030119,172.31.36.0-255,876,243005,8,336373
32594,0.030138,74.125.24.0-255,1484,244489,8,336373
32595,0.031588,104.244.42.0-255,66,244555,8,336373
32596,0.031641,104.244.42.0-255,66,244621,8,336373
32597,0.03171,104.244.42.0-255,66,244687,8,336373
32598,0.031716,104.244.42.0-255,66,244753,8,336373
32599,0.032489,74.125.24.0-255,4320,249073,8,336373
32600,0.032498,172.31.36.0-255,66,249139,8,336373
32601,0.034868,74.125.24.0-255,5738,254877,8,336373
32602,0.034875,172.31.36.0-255,66,254943,8,336373
32603,0.037248,74.125.24.0-255,5738,260681,8,336373
32604,0.037264,172.31.36.0-255,66,260747,8,336373
32605,0.039617,74.125.24.0-255,5738,266485,8,336373
32606,0.039627,172.31.36.0-255,66,266551,8,336373
32607,0.041944,74.125.24.0-255,5738,272289,8,336373
32608,0.041953,172.31.36.0-255,66,272355,8,336373
32609,0.042149,172.31.36.0-255,108,272463,8,336373
32610,0.043702,104.244.42.0-255,66,272529,8,336373
32611,0.044282,74.125.24.0-255,5738,278267,8,336373
32612,0.044291,172.31.36.0-255,66,278333,8,336373
32613,0.046663,74.125.24.0-255,5738,284071,8,336373
32614,0.046672,172.31.36.0-255,66,284137,8,336373
32615,0.049005,74.125.24.0-255,5738,289875,8,336373
32616,0.049017,172.31.36.0-255,66,289941,8,336373
32617,0.051358,74.125.24.0-255,5738,295679,8,336373
32618,0.051367,172.31.36.0-255,66,295745,8,336373
32619,0.053721,74.125.24.0-255,5738,301483,8,336373
32620,0.053731,172.31.36.0-255,66,301549,8,336373
32621,0.056095,74.125.24.0-255,5738,307287,8,336373
32622,0.05611,172.31.36.0-255,66,307353,8,336373
32623,0.058479,74.125.24.0-255,5738,313091,8,336373
32624,0.058487,172.31.36.0-255,66,313157,8,336373
32625,0.060815,74.125.24.0-255,5738,318895,8,336373
32626,0.06082,172.31.36.0-255,66,318961,8,336373
32627,0.063153,74.125.24.0-255,5738,324699,8,336373
32628,0.063159,172.31.36.0-255,66,324765,8,336373
32629,0.06556,74.125.24.0-255,5738,330503,8,336373
32630,0.065567,172.31.36.0-255,66,330569,8,336373
32631,0.067932,74.125.24.0-255,5738,336307,8,336373
32632,0.067938,172.31.36.0-255,66,336373,8,336373
32633,0.0,74.125.24.0-255,152,152,8,253324
32634,2.4e-05,172.31.36.0-255,66,218,8,253324
32635,3.1e-05,74.125.24.0-255,1484,1702,8,253324
32636,3.6e-05,172.31.36.0-255,66,1768,8,253324
32637,5e-05,74.125.24.0-255,2902,4670,8,253324
32638,5.4e-05,172.31.36.0-255,66,4736,8,253324
32639,5.7e-05,74.125.24.0-255,1484,6220,8,253324
32640,6e-05,172.31.36.0-255,66,6286,8,253324
32641,6.5e-05,74.125.24.0-255,2902,9188,8,253324
32642,6.8e-05,172.31.36.0-255,66,9254,8,253324
32643,9.5e-05,74.125.24.0-255,4838,14092,8,253324
32644,9.8e-05,172.31.36.0-255,66,14158,8,253324
32645,0.000101,74.125.24.0-255,1484,15642,8,253324
32646,0.000103,172.31.36.0-255,66,15708,8,253324
32647,0.000135,74.125.24.0-255,4320,20028,8,253324
32648,0.000138,172.31.36.0-255,66,20094,8,253324
32649,0.00015,172.31.36.0-255,66,20160,8,253324
32650,0.000181,74.125.24.0-255,2543,22703,8,253324
32651,0.000184,172.31.36.0-255,66,22769,8,253324
32652,0.000351,74.125.24.0-255,1484,24253,8,253324
32653,0.000355,172.31.36.0-255,66,24319,8,253324
32654,0.000361,74.125.24.0-255,2902,27221,8,253324
32655,0.000364,172.31.36.0-255,66,27287,8,253324
32656,0.000372,74.125.24.0-255,1484,28771,8,253324
32657,0.000374,172.31.36.0-255,66,28837,8,253324
32658,0.000409,74.125.24.0-255,4320,33157,8,253324
32659,0.000411,172.31.36.0-255,66,33223,8,253324
32660,0.000422,74.125.24.0-255,5738,38961,8,253324
32661,0.000424,172.31.36.0-255,66,39027,8,253324
32662,0.000431,74.125.24.0-255,7156,46183,8,253324
32663,0.000434,172.31.36.0-255,66,46249,8,253324
32664,0.00047,74.125.24.0-255,6797,53046,8,253324
32665,0.000474,172.31.36.0-255,66,53112,8,253324
32666,0.000479,74.125.24.0-255,3961,57073,8,253324
32667,0.000481,172.31.36.0-255,66,57139,8,253324
32668,0.000843,74.125.24.0-255,414,57553,8,253324
32669,0.000873,74.125.24.0-255,330,57883,8,253324
32670,0.000982,74.125.24.0-255,1484,59367,8,253324
32671,0.000993,172.31.36.0-255,66,59433,8,253324
32672,0.000999,74.125.24.0-255,2902,62335,8,253324
32673,0.001001,172.31.36.0-255,66,62401,8,253324
32674,0.001011,74.125.24.0-255,2902,65303,8,253324
32675,0.001013,172.31.36.0-255,66,65369,8,253324
32676,0.001025,74.125.24.0-255,2902,68271,8,253324
32677,0.001027,172.31.36.0-255,66,68337,8,253324
32678,0.001064,172.31.36.0-255,66,68403,8,253324
32679,0.001079,74.125.24.0-255,2902,71305,8,253324
32680,0.001081,172.31.36.0-255,66,71371,8,253324
32681,0.001094,172.31.36.0-255,66,71437,8,253324
32682,0.001758,74.125.24.0-255,1484,72921,8,253324
32683,0.001769,74.125.24.0-255,2902,75823,8,253324
32684,0.001773,172.31.36.0-255,66,75889,8,253324
32685,0.001781,74.125.24.0-255,5738,81627,8,253324
32686,0.001783,172.31.36.0-255,66,81693,8,253324
32687,0.001835,172.31.36.0-255,66,81759,8,253324
32688,0.001862,74.125.24.0-255,7156,88915,8,253324
32689,0.001865,172.31.36.0-255,66,88981,8,253324
32690,0.001895,74.125.24.0-255,3602,92583,8,253324
32691,0.001898,172.31.36.0-255,66,92649,8,253324
32692,0.002251,74.125.24.0-255,1484,94133,8,253324
32693,0.00226,74.125.24.0-255,2902,97035,8,253324
32694,0.002264,172.31.36.0-255,66,97101,8,253324
32695,0.002273,74.125.24.0-255,5738,102839,8,253324
32696,0.002274,172.31.36.0-255,66,102905,8,253324
32697,0.002285,74.125.24.0-255,2902,105807,8,253324
32698,0.002287,172.31.36.0-255,66,105873,8,253324
32699,0.002331,172.31.36.0-255,66,105939,8,253324
32700,0.002344,172.31.36.0-255,66,106005,8,253324
32701,0.004953,74.125.24.0-255,5738,111743,8,253324
32702,0.00496,172.31.36.0-255,66,111809,8,253324
32703,0.00756,74.125.24.0-255,5738,117547,8,253324
32704,0.007569,172.31.36.0-255,66,117613,8,253324
32705,0.009098,172.31.36.0-255,101,117714,8,253324
32706,0.01017,74.125.24.0-255,5738,123452,8,253324
32707,0.010177,172.31.36.0-255,66,123518,8,253324
32708,0.011664,74.125.24.0-255,66,123584,8,253324
32709,0.012772,74.125.24.0-255,5738,129322,8,253324
32710,0.01278,172.31.36.0-255,66,129388,8,253324
32711,0.015377,74.125.24.0-255,5738,135126,8,253324
32712,0.015385,172.31.36.0-255,66,135192,8,253324
32713,0.017998,74.125.24.0-255,5738,140930,8,253324
32714,0.018007,172.31.36.0-255,66,140996,8,253324
32715,0.020604,74.125.24.0-255,5738,146734,8,253324
32716,0.020614,172.31.36.0-255,66,146800,8,253324
32717,0.02324,74.125.24.0-255,5738,152538,8,253324
32718,0.023248,172.31.36.0-255,66,152604,8,253324
32719,0.025903,74.125.24.0-255,5738,158342,8,253324
32720,0.025911,172.31.36.0-255,66,158408,8,253324
32721,0.028508,74.125.24.0-255,5738,164146,8,253324
32722,0.028516,172.31.36.0-255,66,164212,8,253324
32723,0.031101,74.125.24.0-255,5738,169950,8,253324
32724,0.03111,172.31.36.0-255,66,170016,8,253324
32725,0.033744,74.125.24.0-255,5738,175754,8,253324
32726,0.033755,172.31.36.0-255,66,175820,8,253324
32727,0.03584,172.31.36.0-255,172,175992,8,253324
32728,0.035869,172.31.36.0-255,1110,177102,8,253324
32729,0.036046,172.31.36.0-255,572,177674,8,253324
32730,0.036358,74.125.24.0-255,5738,183412,8,253324
32731,0.036365,172.31.36.0-255,66,183478,8,253324
32732,0.037405,104.244.42.0-255,66,183544,8,253324
32733,0.03744,104.244.42.0-255,66,183610,8,253324
32734,0.037585,104.244.42.0-255,66,183676,8,253324
32735,0.038979,74.125.24.0-255,5738,189414,8,253324
32736,0.038986,172.31.36.0-255,66,189480,8,253324
32737,0.041628,74.125.24.0-255,5738,195218,8,253324
32738,0.041637,172.31.36.0-255,66,195284,8,253324
32739,0.044266,74.125.24.0-255,5738,201022,8,253324
32740,0.044273,172.31.36.0-255,66,201088,8,253324
32741,0.046939,74.125.24.0-255,5738,206826,8,253324
32742,0.046945,172.31.36.0-255,66,206892,8,253324
32743,0.049535,74.125.24.0-255,5738,212630,8,253324
32744,0.049541,172.31.36.0-255,66,212696,8,253324
32745,0.052131,74.125.24.0-255,5738,218434,8,253324
32746,0.052137,172.31.36.0-255,66,218500,8,253324
32747,0.05474,74.125.24.0-255,5738,224238,8,253324
32748,0.054746,172.31.36.0-255,66,224304,8,253324
32749,0.057389,74.125.24.0-255,5738,230042,8,253324
32750,0.057395,172.31.36.0-255,66,230108,8,253324
32751,0.059968,74.125.24.0-255,5738,235846,8,253324
32752,0.059976,172.31.36.0-255,66,235912,8,253324
32753,0.062587,74.125.24.0-255,5738,241650,8,253324
32754,0.062597,172.31.36.0-255,66,241716,8,253324
32755,0.065197,74.125.24.0-255,5738,247454,8,253324
32756,0.065202,172.31.36.0-255,66,247520,8,253324
32757,0.06781,74.125.24.0-255,5738,253258,8,253324
32758,0.067818,172.31.36.0-255,66,253324,8,253324
32759,0.0,74.125.24.0-255,152,152,8,292995
32760,2.3e-05,172.31.36.0-255,66,218,8,292995
32761,3.1e-05,74.125.24.0-255,1484,1702,8,292995
32762,3.6e-05,172.31.36.0-255,66,1768,8,292995
32763,7e-05,74.125.24.0-255,2902,4670,8,292995
32764,7.9e-05,172.31.36.0-255,66,4736,8,292995
32765,8.6e-05,74.125.24.0-255,5738,10474,8,292995
32766,8.8e-05,172.31.36.0-255,66,10540,8,292995
32767,9.3e-05,74.125.24.0-255,3436,13976,8,292995
32768,9.6e-05,172.31.36.0-255,66,14042,8,292995
32769,0.00026,74.125.24.0-255,1484,15526,8,292995
32770,0.000266,172.31.36.0-255,66,15592,8,292995
32771,0.000271,74.125.24.0-255,2902,18494,8,292995
32772,0.000274,172.31.36.0-255,66,18560,8,292995
32773,0.00031,74.125.24.0-255,5738,24298,8,292995
32774,0.000313,172.31.36.0-255,66,24364,8,292995
32775,0.000331,172.31.36.0-255,66,24430,8,292995
32776,0.000335,74.125.24.0-255,1484,25914,8,292995
32777,0.000337,172.31.36.0-255,66,25980,8,292995
32778,0.000371,172.31.36.0-255,66,26046,8,292995
32779,0.000411,172.31.36.0-255,66,26112,8,292995
32780,0.000414,74.125.24.0-255,403,26515,8,292995
32781,0.000417,172.31.36.0-255,66,26581,8,292995
32782,0.000457,74.125.24.0-255,110,26691,8,292995
32783,0.000459,172.31.36.0-255,66,26757,8,292995
32784,0.000693,74.125.24.0-255,1484,28241,8,292995
32785,0.000698,172.31.36.0-255,66,28307,8,292995
32786,0.000704,74.125.24.0-255,2902,31209,8,292995
32787,0.000706,172.31.36.0-255,66,31275,8,292995
32788,0.000711,74.125.24.0-255,2902,34177,8,292995
32789,0.000742,74.125.24.0-255,2902,37079,8,292995
32790,0.000767,172.31.36.0-255,66,37145,8,292995
32791,0.000803,172.31.36.0-255,66,37211,8,292995
32792,0.000824,74.125.24.0-255,6438,43649,8,292995
32793,0.000843,172.31.36.0-255,66,43715,8,292995
32794,0.001112,74.125.24.0-255,1484,45199,8,292995
32795,0.001118,74.125.24.0-255,2902,48101,8,292995
32796,0.001121,74.125.24.0-255,1484,49585,8,292995
32797,0.00114,172.31.36.0-255,66,49651,8,292995
32798,0.001146,74.125.24.0-255,4320,53971,8,292995
32799,0.001174,74.125.24.0-255,4320,58291,8,292995
32800,0.001177,172.31.36.0-255,66,58357,8,292995
32801,0.00122,172.31.36.0-255,66,58423,8,292995
32802,0.001276,74.125.24.0-255,1484,59907,8,292995
32803,0.001282,74.125.24.0-255,2902,62809,8,292995
32804,0.001298,74.125.24.0-255,4320,67129,8,292995
32805,0.001305,172.31.36.0-255,66,67195,8,292995
32806,0.001316,74.125.24.0-255,1484,68679,8,292995
32807,0.001324,74.125.24.0-255,1484,70163,8,292995
32808,0.001352,74.125.24.0-255,2902,73065,8,292995
32809,0.001359,172.31.36.0-255,66,73131,8,292995
32810,0.001398,74.125.24.0-255,5738,78869,8,292995
32811,0.001416,172.31.36.0-255,66,78935,8,292995
32812,0.00142,74.125.24.0-255,2184,81119,8,292995
32813,0.001425,172.31.36.0-255,66,81185,8,292995
32814,0.001552,74.125.24.0-255,1484,82669,8,292995
32815,0.001558,74.125.24.0-255,2902,85571,8,292995
32816,0.001581,74.125.24.0-255,5738,91309,8,292995
32817,0.001584,74.125.24.0-255,1484,92793,8,292995
32818,0.001591,172.31.36.0-255,66,92859,8,292995
32819,0.001604,74.125.24.0-255,7156,100015,8,292995
32820,0.001625,172.31.36.0-255,66,100081,8,292995
32821,0.001664,172.31.36.0-255,66,100147,8,292995
32822,0.001689,74.125.24.0-255,6438,106585,8,292995
32823,0.001701,172.31.36.0-255,66,106651,8,292995
32824,0.003705,74.125.24.0-255,5738,112389,8,292995
32825,0.003712,172.31.36.0-255,66,112455,8,292995
32826,0.005697,74.125.24.0-255,5738,118193,8,292995
32827,0.007739,172.31.36.0-255,66,118259,8,292995
32828,0.00974,74.125.24.0-255,5738,123997,8,292995
32829,0.009748,172.31.36.0-255,66,124063,8,292995
32830,0.01173,74.125.24.0-255,5738,129801,8,292995
32831,0.011738,172.31.36.0-255,66,129867,8,292995
32832,0.013731,74.125.24.0-255,5738,135605,8,292995
32833,0.015835,172.31.36.0-255,66,135671,8,292995
32834,0.017844,74.125.24.0-255,5738,141409,8,292995
32835,0.017854,172.31.36.0-255,66,141475,8,292995
32836,0.019852,74.125.24.0-255,5738,147213,8,292995
32837,0.019861,172.31.36.0-255,66,147279,8,292995
32838,0.021915,74.125.24.0-255,5738,153017,8,292995
32839,0.021921,172.31.36.0-255,66,153083,8,292995
32840,0.023916,74.125.24.0-255,5738,158821,8,292995
32841,0.023927,172.31.36.0-255,66,158887,8,292995
32842,0.025912,74.125.24.0-255,5738,164625,8,292995
32843,0.02592,172.31.36.0-255,66,164691,8,292995
32844,0.027915,74.125.24.0-255,5738,170429,8,292995
32845,0.027922,172.31.36.0-255,66,170495,8,292995
32846,0.029919,74.125.24.0-255,5738,176233,8,292995
32847,0.029926,172.31.36.0-255,66,176299,8,292995
32848,0.031924,74.125.24.0-255,5738,182037,8,292995
32849,0.031933,172.31.36.0-255,66,182103,8,292995
32850,0.033951,74.125.24.0-255,5738,187841,8,292995
32851,0.033957,172.31.36.0-255,66,187907,8,292995
32852,0.036006,74.125.24.0-255,5738,193645,8,292995
32853,0.036019,172.31.36.0-255,66,193711,8,292995
32854,0.037998,74.125.24.0-255,5738,199449,8,292995
32855,0.038006,172.31.36.0-255,66,199515,8,292995
32856,0.039711,172.31.36.0-255,172,199687,8,292995
32857,0.039743,172.31.36.0-255,1112,200799,8,292995
32858,0.039814,172.31.36.0-255,1514,202313,8,292995
32859,0.039816,172.31.36.0-255,1514,203827,8,292995
32860,0.039822,172.31.36.0-255,1514,205341,8,292995
32861,0.039823,172.31.36.0-255,1514,206855,8,292995
32862,0.03984,172.31.36.0-255,168,207023,8,292995
32863,0.039988,74.125.24.0-255,5738,212761,8,292995
32864,0.039994,172.31.36.0-255,66,212827,8,292995
32865,0.041229,104.244.42.0-255,66,212893,8,292995
32866,0.041251,104.244.42.0-255,66,212959,8,292995
32867,0.041333,104.244.42.0-255,66,213025,8,292995
32868,0.041339,104.244.42.0-255,66,213091,8,292995
32869,0.041973,74.125.24.0-255,5738,218829,8,292995
32870,0.04198,172.31.36.0-255,66,218895,8,292995
32871,0.043997,74.125.24.0-255,5738,224633,8,292995
32872,0.044002,172.31.36.0-255,66,224699,8,292995
32873,0.046012,74.125.24.0-255,4320,229019,8,292995
32874,0.046019,172.31.36.0-255,66,229085,8,292995
32875,0.046048,74.125.24.0-255,1484,230569,8,292995
32876,0.048056,74.125.24.0-255,4320,234889,8,292995
32877,0.048062,172.31.36.0-255,66,234955,8,292995
32878,0.050038,74.125.24.0-255,5738,240693,8,292995
32879,0.050075,172.31.36.0-255,66,240759,8,292995
32880,0.052073,74.125.24.0-255,5738,246497,8,292995
32881,0.052081,172.31.36.0-255,66,246563,8,292995
32882,0.054085,74.125.24.0-255,5738,252301,8,292995
32883,0.054094,172.31.36.0-255,66,252367,8,292995
32884,0.056105,74.125.24.0-255,5738,258105,8,292995
32885,0.056113,172.31.36.0-255,66,258171,8,292995
32886,0.058108,74.125.24.0-255,5738,263909,8,292995
32887,0.058114,172.31.36.0-255,66,263975,8,292995
32888,0.060116,74.125.24.0-255,5738,269713,8,292995
32889,0.060123,172.31.36.0-255,66,269779,8,292995
32890,0.062113,74.125.24.0-255,5738,275517,8,292995
32891,0.062119,172.31.36.0-255,66,275583,8,292995
32892,0.064113,74.125.24.0-255,5738,281321,8,292995
32893,0.064118,172.31.36.0-255,66,281387,8,292995
32894,0.066114,74.125.24.0-255,5738,287125,8,292995
32895,0.06612,172.31.36.0-255,66,287191,8,292995
32896,0.068122,74.125.24.0-255,5738,292929,8,292995
32897,0.068129,172.31.36.0-255,66,292995,8,292995
32898,0.0,74.125.68.0-255,153,153,8,358887
32899,1.4e-05,172.31.36.0-255,66,219,8,358887
32900,3.7e-05,74.125.68.0-255,1484,1703,8,358887
32901,4.1e-05,172.31.36.0-255,66,1769,8,358887
32902,6.8e-05,74.125.68.0-255,2902,4671,8,358887
32903,7.2e-05,172.31.36.0-255,66,4737,8,358887
32904,7.5e-05,74.125.68.0-255,1484,6221,8,358887
32905,7.8e-05,172.31.36.0-255,66,6287,8,358887
32906,8.4e-05,74.125.68.0-255,2902,9189,8,358887
32907,8.7e-05,172.31.36.0-255,66,9255,8,358887
32908,0.000108,74.125.68.0-255,6320,15575,8,358887
32909,0.000111,172.31.36.0-255,66,15641,8,358887
32910,0.000118,74.125.68.0-255,4320,19961,8,358887
32911,0.000119,172.31.36.0-255,66,20027,8,358887
32912,0.00015,74.125.68.0-255,5738,25765,8,358887
32913,0.000152,172.31.36.0-255,66,25831,8,358887
32914,0.000175,74.125.68.0-255,5379,31210,8,358887
32915,0.000178,172.31.36.0-255,66,31276,8,358887
32916,0.000306,74.125.68.0-255,1484,32760,8,358887
32917,0.000311,172.31.36.0-255,66,32826,8,358887
32918,0.000316,74.125.68.0-255,1484,34310,8,358887
32919,0.000318,172.31.36.0-255,66,34376,8,358887
32920,0.000322,74.125.68.0-255,1484,35860,8,358887
32921,0.000324,172.31.36.0-255,66,35926,8,358887
32922,0.000352,74.125.68.0-255,1484,37410,8,358887
32923,0.000355,172.31.36.0-255,66,37476,8,358887
32924,0.000361,74.125.68.0-255,5738,43214,8,358887
32925,0.000364,172.31.36.0-255,66,43280,8,358887
32926,0.000371,74.125.68.0-255,5379,48659,8,358887
32927,0.000374,172.31.36.0-255,66,48725,8,358887
32928,0.000393,74.125.68.0-255,5738,54463,8,358887
32929,0.000396,172.31.36.0-255,66,54529,8,358887
32930,0.000419,74.125.68.0-255,1484,56013,8,358887
32931,0.000434,74.125.68.0-255,5738,61751,8,358887
32932,0.000437,172.31.36.0-255,66,61817,8,358887
32933,0.000457,74.125.68.0-255,4265,66082,8,358887
32934,0.00046,172.31.36.0-255,66,66148,8,358887
32935,0.000463,74.125.68.0-255,116,66264,8,358887
32936,0.000486,74.125.68.0-255,332,66596,8,358887
32937,0.000738,74.125.68.0-255,1484,68080,8,358887
32938,0.000744,172.31.36.0-255,66,68146,8,358887
32939,0.000748,74.125.68.0-255,1484,69630,8,358887
32940,0.000764,74.125.68.0-255,1484,71114,8,358887
32941,0.000766,172.31.36.0-255,66,71180,8,358887
32942,0.000784,74.125.68.0-255,4320,75500,8,358887
32943,0.000787,172.31.36.0-255,66,75566,8,358887
32944,0.000793,74.125.68.0-255,5738,81304,8,358887
32945,0.000795,172.31.36.0-255,66,81370,8,358887
32946,0.000815,74.125.68.0-255,2902,84272,8,358887
32947,0.000817,172.31.36.0-255,66,84338,8,358887
32948,0.000853,172.31.36.0-255,66,84404,8,358887
32949,0.000858,74.125.68.0-255,4320,88724,8,358887
32950,0.000861,172.31.36.0-255,66,88790,8,358887
32951,0.00088,74.125.68.0-255,3602,92392,8,358887
32952,0.000883,172.31.36.0-255,66,92458,8,358887
32953,0.001044,74.125.68.0-255,1484,93942,8,358887
32954,0.001059,74.125.68.0-255,2902,96844,8,358887
32955,0.001062,172.31.36.0-255,66,96910,8,358887
32956,0.001066,74.125.68.0-255,1484,98394,8,358887
32957,0.00109,74.125.68.0-255,4320,102714,8,358887
32958,0.001093,172.31.36.0-255,66,102780,8,358887
32959,0.001097,74.125.68.0-255,2902,105682,8,358887
32960,0.001099,172.31.36.0-255,66,105748,8,358887
32961,0.001103,74.125.68.0-255,2902,108650,8,358887
32962,0.001106,172.31.36.0-255,66,108716,8,358887
32963,0.001122,74.125.68.0-255,1484,110200,8,358887
32964,0.001151,172.31.36.0-255,66,110266,8,358887
32965,0.001155,74.125.68.0-255,2902,113168,8,358887
32966,0.001157,172.31.36.0-255,66,113234,8,358887
32967,0.001199,74.125.68.0-255,5020,118254,8,358887
32968,0.001202,172.31.36.0-255,66,118320,8,358887
32969,0.001547,74.125.68.0-255,1484,119804,8,358887
32970,0.001563,74.125.68.0-255,2902,122706,8,358887
32971,0.001567,172.31.36.0-255,66,122772,8,358887
32972,0.001591,74.125.68.0-255,5738,128510,8,358887
32973,0.001594,172.31.36.0-255,66,128576,8,358887
32974,0.001598,74.125.68.0-255,1484,130060,8,358887
32975,0.001626,172.31.36.0-255,66,130126,8,358887
32976,0.001635,74.125.68.0-255,2902,133028,8,358887
32977,0.001637,172.31.36.0-255,66,133094,8,358887
32978,0.001659,172.31.36.0-255,66,133160,8,358887
32979,0.001875,74.125.68.0-255,1484,134644,8,358887
32980,0.001892,74.125.68.0-255,2902,137546,8,358887
32981,0.001896,172.31.36.0-255,66,137612,8,358887
32982,0.001902,74.125.68.0-255,2902,140514,8,358887
32983,0.001904,172.31.36.0-255,66,140580,8,358887
32984,0.001907,74.125.68.0-255,1484,142064,8,358887
32985,0.001937,74.125.68.0-255,2902,144966,8,358887
32986,0.001939,172.31.36.0-255,66,145032,8,358887
32987,0.001951,172.31.36.0-255,66,145098,8,358887
32988,0.001958,74.125.68.0-255,5738,150836,8,358887
32989,0.00196,172.31.36.0-255,66,150902,8,358887
32990,0.001985,74.125.68.0-255,7156,158058,8,358887
32991,0.001988,172.31.36.0-255,66,158124,8,358887
32992,0.001991,74.125.68.0-255,766,158890,8,358887
32993,0.002108,74.125.68.0-255,1484,160374,8,358887
32994,0.002112,172.31.36.0-255,66,160440,8,358887
32995,0.002118,74.125.68.0-255,2902,163342,8,358887
32996,0.00212,172.31.36.0-255,66,163408,8,358887
32997,0.002146,74.125.68.0-255,5738,169146,8,358887
32998,0.002148,172.31.36.0-255,66,169212,8,358887
32999,0.002154,74.125.68.0-255,4320,173532,8,358887
33000,0.002156,172.31.36.0-255,66,173598,8,358887
33001,0.002183,74.125.68.0-255,1484,175082,8,358887
33002,0.002191,74.125.68.0-255,7156,182238,8,358887
33003,0.002194,172.31.36.0-255,66,182304,8,358887
33004,0.00223,172.31.36.0-255,66,182370,8,358887
33005,0.004447,74.125.68.0-255,5738,188108,8,358887
33006,0.004455,172.31.36.0-255,66,188174,8,358887
33007,0.006672,74.125.68.0-255,4320,192494,8,358887
33008,0.006676,172.31.36.0-255,66,192560,8,358887
33009,0.00669,74.125.68.0-255,1484,194044,8,358887
33010,0.008906,74.125.68.0-255,4320,198364,8,358887
33011,0.008914,172.31.36.0-255,66,198430,8,358887
33012,0.011155,74.125.68.0-255,5738,204168,8,358887
33013,0.011166,172.31.36.0-255,66,204234,8,358887
33014,0.013391,74.125.68.0-255,5738,209972,8,358887
33015,0.013402,172.31.36.0-255,66,210038,8,358887
33016,0.015621,74.125.68.0-255,5738,215776,8,358887
33017,0.015629,172.31.36.0-255,66,215842,8,358887
33018,0.017879,74.125.68.0-255,5738,221580,8,358887
33019,0.017889,172.31.36.0-255,66,221646,8,358887
33020,0.020126,74.125.68.0-255,5738,227384,8,358887
33021,0.020137,172.31.36.0-255,66,227450,8,358887
33022,0.022387,74.125.68.0-255,5738,233188,8,358887
33023,0.0224,172.31.36.0-255,66,233254,8,358887
33024,0.024618,74.125.68.0-255,5738,238992,8,358887
33025,0.024627,172.31.36.0-255,66,239058,8,358887
33026,0.026872,74.125.68.0-255,5738,244796,8,358887
33027,0.026888,172.31.36.0-255,66,244862,8,358887
33028,0.029116,74.125.68.0-255,5738,250600,8,358887
33029,0.029131,172.31.36.0-255,66,250666,8,358887
33030,0.031358,74.125.68.0-255,5738,256404,8,358887
33031,0.03137,172.31.36.0-255,66,256470,8,358887
33032,0.033589,74.125.68.0-255,5738,262208,8,358887
33033,0.0336,172.31.36.0-255,66,262274,8,358887
33034,0.035836,74.125.68.0-255,5738,268012,8,358887
33035,0.035848,172.31.36.0-255,66,268078,8,358887
33036,0.038082,74.125.68.0-255,5738,273816,8,358887
33037,0.038093,172.31.36.0-255,66,273882,8,358887
33038,0.040336,74.125.68.0-255,5738,279620,8,358887
33039,0.040341,172.31.36.0-255,66,279686,8,358887
33040,0.042568,74.125.68.0-255,5738,285424,8,358887
33041,0.042576,172.31.36.0-255,66,285490,8,358887
33042,0.044064,172.31.36.0-255,172,285662,8,358887
33043,0.044108,172.31.36.0-255,1111,286773,8,358887
33044,0.044169,172.31.36.0-255,1514,288287,8,358887
33045,0.044171,172.31.36.0-255,754,289041,8,358887
33046,0.044801,74.125.68.0-255,5738,294779,8,358887
33047,0.044813,172.31.36.0-255,66,294845,8,358887
33048,0.045554,104.244.42.0-255,66,294911,8,358887
33049,0.045597,104.244.42.0-255,66,294977,8,358887
33050,0.045668,104.244.42.0-255,66,295043,8,358887
33051,0.047044,74.125.68.0-255,5738,300781,8,358887
33052,0.047051,172.31.36.0-255,66,300847,8,358887
33053,0.04928,74.125.68.0-255,5738,306585,8,358887
33054,0.049287,172.31.36.0-255,66,306651,8,358887
33055,0.051524,74.125.68.0-255,5738,312389,8,358887
33056,0.051529,172.31.36.0-255,66,312455,8,358887
33057,0.053751,74.125.68.0-255,5738,318193,8,358887
33058,0.053758,172.31.36.0-255,66,318259,8,358887
33059,0.055974,74.125.68.0-255,5738,323997,8,358887
33060,0.055982,172.31.36.0-255,66,324063,8,358887
33061,0.058251,74.125.68.0-255,5738,329801,8,358887
33062,0.058259,172.31.36.0-255,66,329867,8,358887
33063,0.060482,74.125.68.0-255,5738,335605,8,358887
33064,0.06049,172.31.36.0-255,66,335671,8,358887
33065,0.062716,74.125.68.0-255,5738,341409,8,358887
33066,0.062723,172.31.36.0-255,66,341475,8,358887
33067,0.064946,74.125.68.0-255,5738,347213,8,358887
33068,0.064953,172.31.36.0-255,66,347279,8,358887
33069,0.067195,74.125.68.0-255,5738,353017,8,358887
33070,0.067202,172.31.36.0-255,66,353083,8,358887
33071,0.069442,74.125.68.0-255,5738,358821,8,358887
33072,0.069451,172.31.36.0-255,66,358887,8,358887
33073,0.0,172.217.194.0-255,156,156,8,244035
33074,2.3e-05,172.31.36.0-255,66,222,8,244035
33075,3e-05,172.217.194.0-255,1484,1706,8,244035
33076,3.4e-05,172.31.36.0-255,66,1772,8,244035
33077,4e-05,172.217.194.0-255,2902,4674,8,244035
33078,4.4e-05,172.31.36.0-255,66,4740,8,244035
33079,5e-05,172.217.194.0-255,4320,9060,8,244035
33080,5.3e-05,172.31.36.0-255,66,9126,8,244035
33081,6.5e-05,172.31.36.0-255,66,9192,8,244035
33082,8.4e-05,172.217.194.0-255,577,9769,8,244035
33083,8.6e-05,172.31.36.0-255,66,9835,8,244035
33084,0.0001,172.31.36.0-255,66,9901,8,244035
33085,0.000122,172.217.194.0-255,2543,12444,8,244035
33086,0.000124,172.31.36.0-255,66,12510,8,244035
33087,0.000153,172.217.194.0-255,1484,13994,8,244035
33088,0.000156,172.31.36.0-255,66,14060,8,244035
33089,0.000159,172.217.194.0-255,1484,15544,8,244035
33090,0.000161,172.31.36.0-255,66,15610,8,244035
33091,0.000175,172.217.194.0-255,1484,17094,8,244035
33092,0.000177,172.31.36.0-255,66,17160,8,244035
33093,0.000184,172.217.194.0-255,5738,22898,8,244035
33094,0.000187,172.31.36.0-255,66,22964,8,244035
33095,0.00019,172.217.194.0-255,1484,24448,8,244035
33096,0.000191,172.31.36.0-255,66,24514,8,244035
33097,0.00023,172.31.36.0-255,66,24580,8,244035
33098,0.000241,172.31.36.0-255,66,24646,8,244035
33099,0.000257,172.217.194.0-255,2497,27143,8,244035
33100,0.000259,172.31.36.0-255,66,27209,8,244035
33101,0.000263,172.217.194.0-255,98,27307,8,244035
33102,0.000444,172.217.194.0-255,1484,28791,8,244035
33103,0.000464,172.217.194.0-255,2902,31693,8,244035
33104,0.000481,172.217.194.0-255,2902,34595,8,244035
33105,0.000493,172.217.194.0-255,2902,37497,8,244035
33106,0.000507,172.217.194.0-255,4320,41817,8,244035
33107,0.000524,172.217.194.0-255,4320,46137,8,244035
33108,0.000533,172.31.36.0-255,66,46203,8,244035
33109,0.000554,172.217.194.0-255,2902,49105,8,244035
33110,0.000568,172.217.194.0-255,2902,52007,8,244035
33111,0.000581,172.31.36.0-255,66,52073,8,244035
33112,0.000598,172.217.194.0-255,4320,56393,8,244035
33113,0.000616,172.217.194.0-255,2902,59295,8,244035
33114,0.000619,172.217.194.0-255,2184,61479,8,244035
33115,0.000623,172.31.36.0-255,66,61545,8,244035
33116,0.000628,172.31.36.0-255,66,61611,8,244035
33117,0.000689,172.217.194.0-255,1484,63095,8,244035
33118,0.000736,172.217.194.0-255,2902,65997,8,244035
33119,0.000743,172.217.194.0-255,5738,71735,8,244035
33120,0.00076,172.217.194.0-255,2902,74637,8,244035
33121,0.000769,172.31.36.0-255,66,74703,8,244035
33122,0.000777,172.217.194.0-255,1484,76187,8,244035
33123,0.000793,172.217.194.0-255,4320,80507,8,244035
33124,0.000814,172.31.36.0-255,66,80573,8,244035
33125,0.00083,172.217.194.0-255,3602,84175,8,244035
33126,0.000837,172.31.36.0-255,66,84241,8,244035
33127,0.000959,172.217.194.0-255,1484,85725,8,244035
33128,0.000973,172.217.194.0-255,2902,88627,8,244035
33129,0.000991,172.31.36.0-255,66,88693,8,244035
33130,0.00101,172.217.194.0-255,4320,93013,8,244035
33131,0.001021,172.31.36.0-255,66,93079,8,244035
33132,0.001024,172.217.194.0-255,1484,94563,8,244035
33133,0.001052,172.217.194.0-255,4320,98883,8,244035
33134,0.001063,172.217.194.0-255,2902,101785,8,244035
33135,0.001073,172.31.36.0-255,66,101851,8,244035
33136,0.001093,172.217.194.0-255,5738,107589,8,244035
33137,0.001106,172.31.36.0-255,66,107655,8,244035
33138,0.001113,172.217.194.0-255,1484,109139,8,244035
33139,0.001164,172.31.36.0-255,66,109205,8,244035
33140,0.001172,172.217.194.0-255,766,109971,8,244035
33141,0.001903,172.217.194.0-255,1484,111455,8,244035
33142,0.001908,172.31.36.0-255,66,111521,8,244035
33143,0.001914,172.217.194.0-255,2902,114423,8,244035
33144,0.001925,172.31.36.0-255,66,114489,8,244035
33145,0.001931,172.217.194.0-255,4320,118809,8,244035
33146,0.001935,172.31.36.0-255,66,118875,8,244035
33147,0.001944,172.217.194.0-255,1484,120359,8,244035
33148,0.001947,172.217.194.0-255,1484,121843,8,244035
33149,0.001975,172.31.36.0-255,66,121909,8,244035
33150,0.001987,172.217.194.0-255,7156,129065,8,244035
33151,0.001992,172.31.36.0-255,66,129131,8,244035
33152,0.002005,172.217.194.0-255,5738,134869,8,244035
33153,0.002025,172.31.36.0-255,66,134935,8,244035
33154,0.002033,172.217.194.0-255,2902,137837,8,244035
33155,0.002038,172.31.36.0-255,66,137903,8,244035
33156,0.002058,172.217.194.0-255,5738,143641,8,244035
33157,0.002074,172.217.194.0-255,5738,149379,8,244035
33158,0.002078,172.217.194.0-255,2902,152281,8,244035
33159,0.002087,172.31.36.0-255,66,152347,8,244035
33160,0.002109,172.31.36.0-255,66,152413,8,244035
33161,0.002125,172.217.194.0-255,1484,153897,8,244035
33162,0.00214,172.217.194.0-255,1484,155381,8,244035
33163,0.002146,172.217.194.0-255,4320,159701,8,244035
33164,0.00215,172.217.194.0-255,2902,162603,8,244035
33165,0.002163,172.217.194.0-255,4320,166923,8,244035
33166,0.002179,172.217.194.0-255,1484,168407,8,244035
33167,0.002225,172.217.194.0-255,3602,172009,8,244035
33168,0.002386,172.217.194.0-255,1484,173493,8,244035
33169,0.0024,172.217.194.0-255,2902,176395,8,244035
33170,0.00241,172.217.194.0-255,1484,177879,8,244035
33171,0.002432,172.217.194.0-255,4320,182199,8,244035
33172,0.002436,172.217.194.0-255,1484,183683,8,244035
33173,0.002449,172.217.194.0-255,2902,186585,8,244035
33174,0.002476,172.217.194.0-255,4320,190905,8,244035
33175,0.002483,172.217.194.0-255,5738,196643,8,244035
33176,0.002515,172.217.194.0-255,4320,200963,8,244035
33177,0.00255,172.217.194.0-255,2902,203865,8,244035
33178,0.002688,172.217.194.0-255,6438,210303,8,244035
33179,0.007711,172.31.36.0-255,66,210369,8,244035
33180,0.010362,172.217.194.0-255,5738,216107,8,244035
33181,0.010371,172.31.36.0-255,66,216173,8,244035
33182,0.013041,172.217.194.0-255,5738,221911,8,244035
33183,0.01305,172.31.36.0-255,66,221977,8,244035
33184,0.015667,172.217.194.0-255,5738,227715,8,244035
33185,0.016275,172.31.36.0-255,66,227781,8,244035
33186,0.018917,172.217.194.0-255,5738,233519,8,244035
33187,0.018925,172.31.36.0-255,66,233585,8,244035
33188,0.021532,172.217.194.0-255,4320,237905,8,244035
33189,0.021539,172.31.36.0-255,66,237971,8,244035
33190,0.021559,172.217.194.0-255,1484,239455,8,244035
33191,0.024139,172.217.194.0-255,300,239755,8,244035
33192,0.024147,172.31.36.0-255,66,239821,8,244035
33193,0.02431,172.31.36.0-255,105,239926,8,244035
33194,0.026885,172.217.194.0-255,66,239992,8,244035
33195,0.049371,172.31.36.0-255,192,240184,8,244035
33196,0.049402,172.31.36.0-255,955,241139,8,244035
33197,0.049487,172.31.36.0-255,1514,242653,8,244035
33198,0.049489,172.31.36.0-255,1184,243837,8,244035
33199,0.05091,104.244.42.0-255,66,243903,8,244035
33200,0.050949,104.244.42.0-255,66,243969,8,244035
33201,0.051055,104.244.42.0-255,66,244035,8,244035
33202,0.0,74.125.68.0-255,153,153,8,360118
33203,3.4e-05,172.31.36.0-255,66,219,8,360118
33204,4.1e-05,74.125.68.0-255,1484,1703,8,360118
33205,4.5e-05,172.31.36.0-255,66,1769,8,360118
33206,5.9e-05,74.125.68.0-255,2902,4671,8,360118
33207,6.2e-05,172.31.36.0-255,66,4737,8,360118
33208,6.8e-05,74.125.68.0-255,4320,9057,8,360118
33209,7e-05,172.31.36.0-255,66,9123,8,360118
33210,0.000105,74.125.68.0-255,4917,14040,8,360118
33211,0.000109,172.31.36.0-255,66,14106,8,360118
33212,0.000166,74.125.68.0-255,1484,15590,8,360118
33213,0.00017,172.31.36.0-255,66,15656,8,360118
33214,0.000175,74.125.68.0-255,2902,18558,8,360118
33215,0.000179,172.31.36.0-255,66,18624,8,360118
33216,0.000188,74.125.68.0-255,1484,20108,8,360118
33217,0.00019,172.31.36.0-255,66,20174,8,360118
33218,0.000222,74.125.68.0-255,1484,21658,8,360118
33219,0.000225,172.31.36.0-255,66,21724,8,360118
33220,0.000233,74.125.68.0-255,7156,28880,8,360118
33221,0.000236,172.31.36.0-255,66,28946,8,360118
33222,0.000244,74.125.68.0-255,1484,30430,8,360118
33223,0.000246,172.31.36.0-255,66,30496,8,360118
33224,0.000275,74.125.68.0-255,1125,31621,8,360118
33225,0.000278,172.31.36.0-255,66,31687,8,360118
33226,0.000284,74.125.68.0-255,2902,34589,8,360118
33227,0.000287,172.31.36.0-255,66,34655,8,360118
33228,0.000315,74.125.68.0-255,1484,36139,8,360118
33229,0.000317,172.31.36.0-255,66,36205,8,360118
33230,0.000345,74.125.68.0-255,2902,39107,8,360118
33231,0.000348,172.31.36.0-255,66,39173,8,360118
33232,0.000354,74.125.68.0-255,4320,43493,8,360118
33233,0.000356,172.31.36.0-255,66,43559,8,360118
33234,0.000384,74.125.68.0-255,5379,48938,8,360118
33235,0.000388,172.31.36.0-255,66,49004,8,360118
33236,0.000621,74.125.68.0-255,1484,50488,8,360118
33237,0.00065,74.125.68.0-255,2902,53390,8,360118
33238,0.000654,172.31.36.0-255,66,53456,8,360118
33239,0.000659,74.125.68.0-255,4320,57776,8,360118
33240,0.000662,172.31.36.0-255,66,57842,8,360118
33241,0.000666,74.125.68.0-255,2902,60744,8,360118
33242,0.000668,172.31.36.0-255,66,60810,8,360118
33243,0.000701,74.125.68.0-255,2902,63712,8,360118
33244,0.000706,74.125.68.0-255,3123,66835,8,360118
33245,0.000706,172.31.36.0-255,66,66901,8,360118
33246,0.00071,172.31.36.0-255,66,66967,8,360118
33247,0.000776,74.125.68.0-255,1484,68451,8,360118
33248,0.000793,74.125.68.0-255,2902,71353,8,360118
33249,0.000796,172.31.36.0-255,66,71419,8,360118
33250,0.00082,74.125.68.0-255,2902,74321,8,360118
33251,0.000823,172.31.36.0-255,66,74387,8,360118
33252,0.00085,74.125.68.0-255,1484,75871,8,360118
33253,0.000865,74.125.68.0-255,4320,80191,8,360118
33254,0.000868,172.31.36.0-255,66,80257,8,360118
33255,0.000893,74.125.68.0-255,1484,81741,8,360118
33256,0.000901,74.125.68.0-255,6797,88538,8,360118
33257,0.000903,172.31.36.0-255,66,88604,8,360118
33258,0.000908,74.125.68.0-255,2902,91506,8,360118
33259,0.00091,172.31.36.0-255,66,91572,8,360118
33260,0.00096,74.125.68.0-255,2902,94474,8,360118
33261,0.000964,172.31.36.0-255,66,94540,8,360118
33262,0.000986,74.125.68.0-255,6797,101337,8,360118
33263,0.000989,172.31.36.0-255,66,101403,8,360118
33264,0.001348,74.125.68.0-255,1484,102887,8,360118
33265,0.001356,74.125.68.0-255,1484,104371,8,360118
33266,0.00136,172.31.36.0-255,66,104437,8,360118
33267,0.001398,74.125.68.0-255,1484,105921,8,360118
33268,0.001404,74.125.68.0-255,5738,111659,8,360118
33269,0.001407,172.31.36.0-255,66,111725,8,360118
33270,0.001413,74.125.68.0-255,7156,118881,8,360118
33271,0.001415,172.31.36.0-255,66,118947,8,360118
33272,0.001459,172.31.36.0-255,66,119013,8,360118
33273,0.001484,74.125.68.0-255,2902,121915,8,360118
33274,0.001486,172.31.36.0-255,66,121981,8,360118
33275,0.00149,74.125.68.0-255,2184,124165,8,360118
33276,0.001492,172.31.36.0-255,66,124231,8,360118
33277,0.001676,74.125.68.0-255,1484,125715,8,360118
33278,0.001681,74.125.68.0-255,1484,127199,8,360118
33279,0.001683,172.31.36.0-255,66,127265,8,360118
33280,0.001717,74.125.68.0-255,1484,128749,8,360118
33281,0.001722,74.125.68.0-255,5738,134487,8,360118
33282,0.001724,172.31.36.0-255,66,134553,8,360118
33283,0.001728,74.125.68.0-255,2902,137455,8,360118
33284,0.00173,172.31.36.0-255,66,137521,8,360118
33285,0.001749,74.125.68.0-255,4320,141841,8,360118
33286,0.001751,172.31.36.0-255,66,141907,8,360118
33287,0.001783,74.125.68.0-255,5738,147645,8,360118
33288,0.001786,172.31.36.0-255,66,147711,8,360118
33289,0.001794,172.31.36.0-255,66,147777,8,360118
33290,0.001797,74.125.68.0-255,766,148543,8,360118
33291,0.001958,74.125.68.0-255,1484,150027,8,360118
33292,0.001959,172.31.36.0-255,66,150093,8,360118
33293,0.00198,74.125.68.0-255,1484,151577,8,360118
33294,0.001982,74.125.68.0-255,1484,153061,8,360118
33295,0.001984,172.31.36.0-255,66,153127,8,360118
33296,0.002006,74.125.68.0-255,1484,154611,8,360118
33297,0.00201,74.125.68.0-255,4320,158931,8,360118
33298,0.002012,172.31.36.0-255,66,158997,8,360118
33299,0.002023,74.125.68.0-255,1484,160481,8,360118
33300,0.002037,74.125.68.0-255,4320,164801,8,360118
33301,0.002039,172.31.36.0-255,66,164867,8,360118
33302,0.002067,74.125.68.0-255,5738,170605,8,360118
33303,0.002069,172.31.36.0-255,66,170671,8,360118
33304,0.002074,74.125.68.0-255,7156,177827,8,360118
33305,0.002076,172.31.36.0-255,66,177893,8,360118
33306,0.002093,74.125.68.0-255,4320,182213,8,360118
33307,0.002094,172.31.36.0-255,66,182279,8,360118
33308,0.002097,74.125.68.0-255,766,183045,8,360118
33309,0.004355,74.125.68.0-255,1484,184529,8,360118
33310,0.004358,172.31.36.0-255,66,184595,8,360118
33311,0.004385,74.125.68.0-255,2902,187497,8,360118
33312,0.004387,172.31.36.0-255,66,187563,8,360118
33313,0.00663,74.125.68.0-255,2902,190465,8,360118
33314,0.006637,172.31.36.0-255,66,190531,8,360118
33315,0.006668,74.125.68.0-255,2902,193433,8,360118
33316,0.006675,172.31.36.0-255,66,193499,8,360118
33317,0.008907,74.125.68.0-255,2902,196401,8,360118
33318,0.008915,172.31.36.0-255,66,196467,8,360118
33319,0.008946,74.125.68.0-255,2902,199369,8,360118
33320,0.008949,172.31.36.0-255,66,199435,8,360118
33321,0.011189,74.125.68.0-255,2902,202337,8,360118
33322,0.011197,172.31.36.0-255,66,202403,8,360118
33323,0.011232,74.125.68.0-255,2902,205305,8,360118
33324,0.011237,172.31.36.0-255,66,205371,8,360118
33325,0.01346,74.125.68.0-255,2902,208273,8,360118
33326,0.013466,172.31.36.0-255,66,208339,8,360118
33327,0.013495,74.125.68.0-255,2902,211241,8,360118
33328,0.013499,172.31.36.0-255,66,211307,8,360118
33329,0.015763,74.125.68.0-255,5738,217045,8,360118
33330,0.015772,172.31.36.0-255,66,217111,8,360118
33331,0.018072,74.125.68.0-255,5738,222849,8,360118
33332,0.018079,172.31.36.0-255,66,222915,8,360118
33333,0.020359,74.125.68.0-255,5738,228653,8,360118
33334,0.020366,172.31.36.0-255,66,228719,8,360118
33335,0.022188,172.31.36.0-255,164,228883,8,360118
33336,0.02222,172.31.36.0-255,1119,230002,8,360118
33337,0.022259,172.31.36.0-255,1514,231516,8,360118
33338,0.022283,172.31.36.0-255,1514,233030,8,360118
33339,0.022285,172.31.36.0-255,1514,234544,8,360118
33340,0.022311,172.31.36.0-255,1514,236058,8,360118
33341,0.022312,172.31.36.0-255,1350,237408,8,360118
33342,0.022681,74.125.68.0-255,5738,243146,8,360118
33343,0.022687,172.31.36.0-255,66,243212,8,360118
33344,0.023736,104.244.42.0-255,66,243278,8,360118
33345,0.023784,104.244.42.0-255,66,243344,8,360118
33346,0.023831,104.244.42.0-255,66,243410,8,360118
33347,0.02388,104.244.42.0-255,66,243476,8,360118
33348,0.024958,74.125.68.0-255,2902,246378,8,360118
33349,0.024963,172.31.36.0-255,66,246444,8,360118
33350,0.024997,74.125.68.0-255,2902,249346,8,360118
33351,0.025,172.31.36.0-255,66,249412,8,360118
33352,0.027252,74.125.68.0-255,2902,252314,8,360118
33353,0.027258,172.31.36.0-255,66,252380,8,360118
33354,0.027292,74.125.68.0-255,2902,255282,8,360118
33355,0.027295,172.31.36.0-255,66,255348,8,360118
33356,0.029522,74.125.68.0-255,1484,256832,8,360118
33357,0.029552,74.125.68.0-255,1484,258316,8,360118
33358,0.029557,172.31.36.0-255,66,258382,8,360118
33359,0.02959,74.125.68.0-255,2902,261284,8,360118
33360,0.029593,172.31.36.0-255,66,261350,8,360118
33361,0.031839,74.125.68.0-255,2902,264252,8,360118
33362,0.031846,172.31.36.0-255,66,264318,8,360118
33363,0.03187,74.125.68.0-255,2902,267220,8,360118
33364,0.031873,172.31.36.0-255,66,267286,8,360118
33365,0.034125,74.125.68.0-255,2902,270188,8,360118
33366,0.034131,172.31.36.0-255,66,270254,8,360118
33367,0.034165,74.125.68.0-255,2902,273156,8,360118
33368,0.034168,172.31.36.0-255,66,273222,8,360118
33369,0.036411,74.125.68.0-255,2902,276124,8,360118
33370,0.036417,172.31.36.0-255,66,276190,8,360118
33371,0.036433,74.125.68.0-255,2902,279092,8,360118
33372,0.03644,172.31.36.0-255,66,279158,8,360118
33373,0.038697,74.125.68.0-255,4320,283478,8,360118
33374,0.038702,172.31.36.0-255,66,283544,8,360118
33375,0.038739,74.125.68.0-255,1484,285028,8,360118
33376,0.040987,74.125.68.0-255,4320,289348,8,360118
33377,0.040992,172.31.36.0-255,66,289414,8,360118
33378,0.043259,74.125.68.0-255,2902,292316,8,360118
33379,0.043264,172.31.36.0-255,66,292382,8,360118
33380,0.043299,74.125.68.0-255,2902,295284,8,360118
33381,0.043302,172.31.36.0-255,66,295350,8,360118
33382,0.045525,74.125.68.0-255,2902,298252,8,360118
33383,0.04553,172.31.36.0-255,66,298318,8,360118
33384,0.045564,74.125.68.0-255,2902,301220,8,360118
33385,0.045567,172.31.36.0-255,66,301286,8,360118
33386,0.047812,74.125.68.0-255,2902,304188,8,360118
33387,0.047818,172.31.36.0-255,66,304254,8,360118
33388,0.047846,74.125.68.0-255,2902,307156,8,360118
33389,0.04785,172.31.36.0-255,66,307222,8,360118
33390,0.050083,74.125.68.0-255,2902,310124,8,360118
33391,0.05009,172.31.36.0-255,66,310190,8,360118
33392,0.050127,74.125.68.0-255,2902,313092,8,360118
33393,0.05013,172.31.36.0-255,66,313158,8,360118
33394,0.052357,74.125.68.0-255,2902,316060,8,360118
33395,0.052363,172.31.36.0-255,66,316126,8,360118
33396,0.052403,74.125.68.0-255,2902,319028,8,360118
33397,0.052406,172.31.36.0-255,66,319094,8,360118
33398,0.054632,74.125.68.0-255,2902,321996,8,360118
33399,0.054639,172.31.36.0-255,66,322062,8,360118
33400,0.054676,74.125.68.0-255,2902,324964,8,360118
33401,0.054679,172.31.36.0-255,66,325030,8,360118
33402,0.05692,74.125.68.0-255,2902,327932,8,360118
33403,0.056926,172.31.36.0-255,66,327998,8,360118
33404,0.056964,74.125.68.0-255,2902,330900,8,360118
33405,0.056967,172.31.36.0-255,66,330966,8,360118
33406,0.059208,74.125.68.0-255,2902,333868,8,360118
33407,0.059215,172.31.36.0-255,66,333934,8,360118
33408,0.059272,74.125.68.0-255,2902,336836,8,360118
33409,0.059276,172.31.36.0-255,66,336902,8,360118
33410,0.061546,74.125.68.0-255,5738,342640,8,360118
33411,0.061556,172.31.36.0-255,66,342706,8,360118
33412,0.06386,74.125.68.0-255,5738,348444,8,360118
33413,0.063874,172.31.36.0-255,66,348510,8,360118
33414,0.066171,74.125.68.0-255,5738,354248,8,360118
33415,0.066187,172.31.36.0-255,66,354314,8,360118
33416,0.068483,74.125.68.0-255,5738,360052,8,360118
33417,0.068497,172.31.36.0-255,66,360118,8,360118
33418,0.0,74.125.24.0-255,156,156,8,218872
33419,2.2e-05,172.31.36.0-255,66,222,8,218872
33420,3e-05,74.125.24.0-255,1484,1706,8,218872
33421,3.4e-05,172.31.36.0-255,66,1772,8,218872
33422,3.9e-05,74.125.24.0-255,2902,4674,8,218872
33423,4.3e-05,172.31.36.0-255,66,4740,8,218872
33424,5e-05,74.125.24.0-255,5738,10478,8,218872
33425,5.3e-05,172.31.36.0-255,66,10544,8,218872
33426,5.8e-05,74.125.24.0-255,2902,13446,8,218872
33427,6.1e-05,172.31.36.0-255,66,13512,8,218872
33428,9.1e-05,172.31.36.0-255,66,13578,8,218872
33429,0.000103,172.31.36.0-255,66,13644,8,218872
33430,0.000168,74.125.24.0-255,1484,15128,8,218872
33431,0.000171,172.31.36.0-255,66,15194,8,218872
33432,0.000176,74.125.24.0-255,2902,18096,8,218872
33433,0.000178,172.31.36.0-255,66,18162,8,218872
33434,0.000182,74.125.24.0-255,1484,19646,8,218872
33435,0.000185,172.31.36.0-255,66,19712,8,218872
33436,0.0002,74.125.24.0-255,4320,24032,8,218872
33437,0.000202,172.31.36.0-255,66,24098,8,218872
33438,0.000227,74.125.24.0-255,2902,27000,8,218872
33439,0.00023,172.31.36.0-255,66,27066,8,218872
33440,0.000256,172.31.36.0-255,66,27132,8,218872
33441,0.000264,74.125.24.0-255,5738,32870,8,218872
33442,0.000267,172.31.36.0-255,66,32936,8,218872
33443,0.000287,74.125.24.0-255,4300,37236,8,218872
33444,0.00029,172.31.36.0-255,66,37302,8,218872
33445,0.000453,74.125.24.0-255,1484,38786,8,218872
33446,0.000458,172.31.36.0-255,66,38852,8,218872
33447,0.000477,74.125.24.0-255,2902,41754,8,218872
33448,0.00048,172.31.36.0-255,66,41820,8,218872
33449,0.000504,74.125.24.0-255,2902,44722,8,218872
33450,0.000507,172.31.36.0-255,66,44788,8,218872
33451,0.000527,74.125.24.0-255,4320,49108,8,218872
33452,0.00053,172.31.36.0-255,66,49174,8,218872
33453,0.000546,74.125.24.0-255,2902,52076,8,218872
33454,0.000548,172.31.36.0-255,66,52142,8,218872
33455,0.000576,74.125.24.0-255,2244,54386,8,218872
33456,0.000578,172.31.36.0-255,66,54452,8,218872
33457,0.000584,74.125.24.0-255,5738,60190,8,218872
33458,0.000587,172.31.36.0-255,66,60256,8,218872
33459,0.000605,74.125.24.0-255,2902,63158,8,218872
33460,0.000608,172.31.36.0-255,66,63224,8,218872
33461,0.000639,172.31.36.0-255,66,63290,8,218872
33462,0.000877,74.125.24.0-255,1484,64774,8,218872
33463,0.000885,74.125.24.0-255,2902,67676,8,218872
33464,0.000889,172.31.36.0-255,66,67742,8,218872
33465,0.000894,74.125.24.0-255,2902,70644,8,218872
33466,0.000897,172.31.36.0-255,66,70710,8,218872
33467,0.000912,74.125.24.0-255,2902,73612,8,218872
33468,0.000916,172.31.36.0-255,66,73678,8,218872
33469,0.000923,74.125.24.0-255,7156,80834,8,218872
33470,0.000926,172.31.36.0-255,66,80900,8,218872
33471,0.000967,74.125.24.0-255,2184,83084,8,218872
33472,0.000971,172.31.36.0-255,66,83150,8,218872
33473,0.000974,172.31.36.0-255,66,83216,8,218872
33474,0.001275,74.125.24.0-255,1484,84700,8,218872
33475,0.001292,74.125.24.0-255,2902,87602,8,218872
33476,0.001295,172.31.36.0-255,66,87668,8,218872
33477,0.001303,74.125.24.0-255,5738,93406,8,218872
33478,0.001305,172.31.36.0-255,66,93472,8,218872
33479,0.001357,74.125.24.0-255,7156,100628,8,218872
33480,0.00136,172.31.36.0-255,66,100694,8,218872
33481,0.001391,172.31.36.0-255,66,100760,8,218872
33482,0.00141,74.125.24.0-255,4320,105080,8,218872
33483,0.001413,172.31.36.0-255,66,105146,8,218872
33484,0.001438,172.31.36.0-255,66,105212,8,218872
33485,0.001453,172.31.36.0-255,66,105278,8,218872
33486,0.001458,74.125.24.0-255,2902,108180,8,218872
33487,0.00146,172.31.36.0-255,66,108246,8,218872
33488,0.001497,172.31.36.0-255,66,108312,8,218872
33489,0.001529,74.125.24.0-255,1484,109796,8,218872
33490,0.001534,74.125.24.0-255,2902,112698,8,218872
33491,0.001537,172.31.36.0-255,66,112764,8,218872
33492,0.001543,74.125.24.0-255,5738,118502,8,218872
33493,0.001546,172.31.36.0-255,66,118568,8,218872
33494,0.001615,74.125.24.0-255,2902,121470,8,218872
33495,0.001618,172.31.36.0-255,66,121536,8,218872
33496,0.001639,74.125.24.0-255,4320,125856,8,218872
33497,0.001652,74.125.24.0-255,5738,131594,8,218872
33498,0.001655,74.125.24.0-255,2184,133778,8,218872
33499,0.00166,172.31.36.0-255,66,133844,8,218872
33500,0.001668,172.31.36.0-255,66,133910,8,218872
33501,0.001671,172.31.36.0-255,66,133976,8,218872
33502,0.001674,172.31.36.0-255,66,134042,8,218872
33503,0.001679,74.125.24.0-255,2902,136944,8,218872
33504,0.001682,172.31.36.0-255,66,137010,8,218872
33505,0.001713,74.125.24.0-255,7156,144166,8,218872
33506,0.001716,172.31.36.0-255,66,144232,8,218872
33507,0.001721,74.125.24.0-255,2902,147134,8,218872
33508,0.001723,172.31.36.0-255,66,147200,8,218872
33509,0.001736,74.125.24.0-255,1484,148684,8,218872
33510,0.001796,74.125.24.0-255,7156,155840,8,218872
33511,0.001817,74.125.24.0-255,2184,158024,8,218872
33512,0.001832,172.31.36.0-255,66,158090,8,218872
33513,0.001883,172.31.36.0-255,66,158156,8,218872
33514,0.001926,74.125.24.0-255,2902,161058,8,218872
33515,0.001944,74.125.24.0-255,2902,163960,8,218872
33516,0.001953,172.31.36.0-255,66,164026,8,218872
33517,0.001972,74.125.24.0-255,5738,169764,8,218872
33518,0.001981,172.31.36.0-255,66,169830,8,218872
33519,0.002013,172.31.36.0-255,66,169896,8,218872
33520,0.002021,74.125.24.0-255,1484,171380,8,218872
33521,0.002035,74.125.24.0-255,5738,177118,8,218872
33522,0.002063,74.125.24.0-255,2902,180020,8,218872
33523,0.002069,172.31.36.0-255,66,180086,8,218872
33524,0.002103,74.125.24.0-255,5738,185824,8,218872
33525,0.002127,74.125.24.0-255,7156,192980,8,218872
33526,0.002168,172.31.36.0-255,66,193046,8,218872
33527,0.004231,74.125.24.0-255,5738,198784,8,218872
33528,0.004237,172.31.36.0-255,66,198850,8,218872
33529,0.006304,74.125.24.0-255,5738,204588,8,218872
33530,0.006312,172.31.36.0-255,66,204654,8,218872
33531,0.008368,74.125.24.0-255,5148,209802,8,218872
33532,0.008372,172.31.36.0-255,66,209868,8,218872
33533,0.010843,172.31.36.0-255,105,209973,8,218872
33534,0.012872,74.125.24.0-255,66,210039,8,218872
33535,0.039449,172.31.36.0-255,172,210211,8,218872
33536,0.039482,172.31.36.0-255,1112,211323,8,218872
33537,0.03957,172.31.36.0-255,1514,212837,8,218872
33538,0.039572,172.31.36.0-255,1514,214351,8,218872
33539,0.039577,172.31.36.0-255,1514,215865,8,218872
33540,0.039579,172.31.36.0-255,1514,217379,8,218872
33541,0.039598,172.31.36.0-255,1229,218608,8,218872
33542,0.041041,104.244.42.0-255,66,218674,8,218872
33543,0.041074,104.244.42.0-255,66,218740,8,218872
33544,0.041191,104.244.42.0-255,66,218806,8,218872
33545,0.041195,104.244.42.0-255,66,218872,8,218872
33546,0.0,74.125.200.0-255,144,144,8,339992
33547,2.3e-05,172.31.36.0-255,66,210,8,339992
33548,3.1e-05,74.125.200.0-255,1484,1694,8,339992
33549,3.5e-05,172.31.36.0-255,66,1760,8,339992
33550,4.1e-05,74.125.200.0-255,2902,4662,8,339992
33551,4.4e-05,172.31.36.0-255,66,4728,8,339992
33552,5.8e-05,74.125.200.0-255,5738,10466,8,339992
33553,6.1e-05,172.31.36.0-255,66,10532,8,339992
33554,6.7e-05,74.125.200.0-255,3464,13996,8,339992
33555,7.1e-05,172.31.36.0-255,66,14062,8,339992
33556,0.000194,74.125.200.0-255,1484,15546,8,339992
33557,0.000199,172.31.36.0-255,66,15612,8,339992
33558,0.000203,74.125.200.0-255,1484,17096,8,339992
33559,0.000205,172.31.36.0-255,66,17162,8,339992
33560,0.000241,74.125.200.0-255,1484,18646,8,339992
33561,0.000244,172.31.36.0-255,66,18712,8,339992
33562,0.000255,74.125.200.0-255,4320,23032,8,339992
33563,0.000257,172.31.36.0-255,66,23098,8,339992
33564,0.000297,172.31.36.0-255,66,23164,8,339992
33565,0.000303,74.125.200.0-255,4320,27484,8,339992
33566,0.000306,172.31.36.0-255,66,27550,8,339992
33567,0.000338,172.31.36.0-255,66,27616,8,339992
33568,0.000358,74.125.200.0-255,1484,29100,8,339992
33569,0.00036,172.31.36.0-255,66,29166,8,339992
33570,0.000376,74.125.200.0-255,2902,32068,8,339992
33571,0.000383,172.31.36.0-255,66,32134,8,339992
33572,0.000415,172.31.36.0-255,66,32200,8,339992
33573,0.000418,74.125.200.0-255,676,32876,8,339992
33574,0.00042,172.31.36.0-255,66,32942,8,339992
33575,0.000608,74.125.200.0-255,1484,34426,8,339992
33576,0.000617,74.125.200.0-255,2902,37328,8,339992
33577,0.000622,74.125.200.0-255,2902,40230,8,339992
33578,0.000633,74.125.200.0-255,1484,41714,8,339992
33579,0.00064,74.125.200.0-255,5738,47452,8,339992
33580,0.000655,172.31.36.0-255,66,47518,8,339992
33581,0.000682,74.125.200.0-255,4320,51838,8,339992
33582,0.000693,172.31.36.0-255,66,51904,8,339992
33583,0.00071,74.125.200.0-255,7156,59060,8,339992
33584,0.000737,172.31.36.0-255,66,59126,8,339992
33585,0.000742,74.125.200.0-255,2902,62028,8,339992
33586,0.000747,172.31.36.0-255,66,62094,8,339992
33587,0.000772,74.125.200.0-255,5020,67114,8,339992
33588,0.00079,172.31.36.0-255,66,67180,8,339992
33589,0.001037,74.125.200.0-255,1484,68664,8,339992
33590,0.001061,74.125.200.0-255,2902,71566,8,339992
33591,0.001075,172.31.36.0-255,66,71632,8,339992
33592,0.001085,74.125.200.0-255,2902,74534,8,339992
33593,0.001107,74.125.200.0-255,4320,78854,8,339992
33594,0.001136,74.125.200.0-255,1484,80338,8,339992
33595,0.001154,74.125.200.0-255,7156,87494,8,339992
33596,0.001159,74.125.200.0-255,5738,93232,8,339992
33597,0.001163,172.31.36.0-255,66,93298,8,339992
33598,0.001168,172.31.36.0-255,66,93364,8,339992
33599,0.001186,74.125.200.0-255,1484,94848,8,339992
33600,0.00121,74.125.200.0-255,6438,101286,8,339992
33601,0.001226,172.31.36.0-255,66,101352,8,339992
33602,0.001787,74.125.200.0-255,1484,102836,8,339992
33603,0.001793,74.125.200.0-255,1484,104320,8,339992
33604,0.001797,172.31.36.0-255,66,104386,8,339992
33605,0.001824,74.125.200.0-255,1484,105870,8,339992
33606,0.00183,74.125.200.0-255,5738,111608,8,339992
33607,0.001833,74.125.200.0-255,1484,113092,8,339992
33608,0.001852,74.125.200.0-255,4320,117412,8,339992
33609,0.001865,74.125.200.0-255,4320,121732,8,339992
33610,0.001875,172.31.36.0-255,66,121798,8,339992
33611,0.001883,74.125.200.0-255,2902,124700,8,339992
33612,0.001886,74.125.200.0-255,1484,126184,8,339992
33613,0.001905,74.125.200.0-255,2902,129086,8,339992
33614,0.00191,172.31.36.0-255,66,129152,8,339992
33615,0.001939,74.125.200.0-255,2902,132054,8,339992
33616,0.00195,172.31.36.0-255,66,132120,8,339992
33617,0.001963,74.125.200.0-255,3602,135722,8,339992
33618,0.001987,172.31.36.0-255,66,135788,8,339992
33619,0.002139,74.125.200.0-255,1484,137272,8,339992
33620,0.002144,74.125.200.0-255,2902,140174,8,339992
33621,0.002158,172.31.36.0-255,66,140240,8,339992
33622,0.002175,74.125.200.0-255,1484,141724,8,339992
33623,0.002196,74.125.200.0-255,4320,146044,8,339992
33624,0.002202,74.125.200.0-255,5738,151782,8,339992
33625,0.002207,172.31.36.0-255,66,151848,8,339992
33626,0.002217,74.125.200.0-255,2902,154750,8,339992
33627,0.002239,74.125.200.0-255,5738,160488,8,339992
33628,0.002251,172.31.36.0-255,66,160554,8,339992
33629,0.00226,74.125.200.0-255,2902,163456,8,339992
33630,0.00227,172.31.36.0-255,66,163522,8,339992
33631,0.002298,74.125.200.0-255,4320,167842,8,339992
33632,0.00231,74.125.200.0-255,2184,170026,8,339992
33633,0.002324,172.31.36.0-255,66,170092,8,339992
33634,0.004597,74.125.200.0-255,4320,174412,8,339992
33635,0.004605,172.31.36.0-255,66,174478,8,339992
33636,0.004633,74.125.200.0-255,1484,175962,8,339992
33637,0.006882,74.125.200.0-255,4320,180282,8,339992
33638,0.007027,172.31.36.0-255,66,180348,8,339992
33639,0.009307,74.125.200.0-255,5738,186086,8,339992
33640,0.009313,172.31.36.0-255,66,186152,8,339992
33641,0.011599,74.125.200.0-255,5738,191890,8,339992
33642,0.011614,172.31.36.0-255,66,191956,8,339992
33643,0.013927,74.125.200.0-255,5738,197694,8,339992
33644,0.013939,172.31.36.0-255,66,197760,8,339992
33645,0.016212,74.125.200.0-255,5738,203498,8,339992
33646,0.016225,172.31.36.0-255,66,203564,8,339992
33647,0.018495,74.125.200.0-255,5738,209302,8,339992
33648,0.018503,172.31.36.0-255,66,209368,8,339992
33649,0.020783,74.125.200.0-255,5738,215106,8,339992
33650,0.020794,172.31.36.0-255,66,215172,8,339992
33651,0.023081,74.125.200.0-255,5738,220910,8,339992
33652,0.023088,172.31.36.0-255,66,220976,8,339992
33653,0.02537,74.125.200.0-255,5738,226714,8,339992
33654,0.025378,172.31.36.0-255,66,226780,8,339992
33655,0.027661,74.125.200.0-255,5738,232518,8,339992
33656,0.02767,172.31.36.0-255,66,232584,8,339992
33657,0.028192,172.31.36.0-255,172,232756,8,339992
33658,0.028222,172.31.36.0-255,1112,233868,8,339992
33659,0.02829,172.31.36.0-255,1514,235382,8,339992
33660,0.028292,172.31.36.0-255,1292,236674,8,339992
33661,0.029715,104.244.42.0-255,66,236740,8,339992
33662,0.029773,104.244.42.0-255,66,236806,8,339992
33663,0.029881,104.244.42.0-255,66,236872,8,339992
33664,0.02993,74.125.200.0-255,4320,241192,8,339992
33665,0.029935,172.31.36.0-255,66,241258,8,339992
33666,0.029959,74.125.200.0-255,1484,242742,8,339992
33667,0.032222,74.125.200.0-255,4320,247062,8,339992
33668,0.03223,172.31.36.0-255,66,247128,8,339992
33669,0.034511,74.125.200.0-255,5738,252866,8,339992
33670,0.034828,172.31.36.0-255,66,252932,8,339992
33671,0.037111,74.125.200.0-255,5738,258670,8,339992
33672,0.037119,172.31.36.0-255,66,258736,8,339992
33673,0.039379,74.125.200.0-255,5738,264474,8,339992
33674,0.039386,172.31.36.0-255,66,264540,8,339992
33675,0.041695,74.125.200.0-255,5738,270278,8,339992
33676,0.042261,172.31.36.0-255,66,270344,8,339992
33677,0.044538,74.125.200.0-255,5738,276082,8,339992
33678,0.044544,172.31.36.0-255,66,276148,8,339992
33679,0.046825,74.125.200.0-255,5738,281886,8,339992
33680,0.046832,172.31.36.0-255,66,281952,8,339992
33681,0.049107,74.125.200.0-255,5738,287690,8,339992
33682,0.049114,172.31.36.0-255,66,287756,8,339992
33683,0.051387,74.125.200.0-255,5738,293494,8,339992
33684,0.051394,172.31.36.0-255,66,293560,8,339992
33685,0.053681,74.125.200.0-255,5738,299298,8,339992
33686,0.053687,172.31.36.0-255,66,299364,8,339992
33687,0.055949,74.125.200.0-255,5738,305102,8,339992
33688,0.055956,172.31.36.0-255,66,305168,8,339992
33689,0.058245,74.125.200.0-255,5738,310906,8,339992
33690,0.058251,172.31.36.0-255,66,310972,8,339992
33691,0.060523,74.125.200.0-255,5738,316710,8,339992
33692,0.060529,172.31.36.0-255,66,316776,8,339992
33693,0.062803,74.125.200.0-255,5738,322514,8,339992
33694,0.062809,172.31.36.0-255,66,322580,8,339992
33695,0.065084,74.125.200.0-255,5738,328318,8,339992
33696,0.065091,172.31.36.0-255,66,328384,8,339992
33697,0.067368,74.125.200.0-255,5738,334122,8,339992
33698,0.067375,172.31.36.0-255,66,334188,8,339992
33699,0.069655,74.125.200.0-255,5738,339926,8,339992
33700,0.069662,172.31.36.0-255,66,339992,8,339992
33701,0.0,74.125.200.0-255,153,153,8,332927
33702,2.9e-05,172.31.36.0-255,66,219,8,332927
33703,3.6e-05,74.125.200.0-255,1484,1703,8,332927
33704,4e-05,172.31.36.0-255,66,1769,8,332927
33705,7.4e-05,74.125.200.0-255,2902,4671,8,332927
33706,7.7e-05,172.31.36.0-255,66,4737,8,332927
33707,8e-05,74.125.200.0-255,1484,6221,8,332927
33708,8.3e-05,172.31.36.0-255,66,6287,8,332927
33709,8.8e-05,74.125.200.0-255,2902,9189,8,332927
33710,9.6e-05,172.31.36.0-255,66,9255,8,332927
33711,0.000133,74.125.200.0-255,4851,14106,8,332927
33712,0.000137,172.31.36.0-255,66,14172,8,332927
33713,0.000194,74.125.200.0-255,1484,15656,8,332927
33714,0.000197,172.31.36.0-255,66,15722,8,332927
33715,0.000226,74.125.200.0-255,2902,18624,8,332927
33716,0.000229,172.31.36.0-255,66,18690,8,332927
33717,0.000235,74.125.200.0-255,4320,23010,8,332927
33718,0.00024,172.31.36.0-255,66,23076,8,332927
33719,0.000263,74.125.200.0-255,1484,24560,8,332927
33720,0.000265,172.31.36.0-255,66,24626,8,332927
33721,0.000295,74.125.200.0-255,4320,28946,8,332927
33722,0.000299,172.31.36.0-255,66,29012,8,332927
33723,0.000326,74.125.200.0-255,2543,31555,8,332927
33724,0.00033,172.31.36.0-255,66,31621,8,332927
33725,0.000379,74.125.200.0-255,1484,33105,8,332927
33726,0.000382,172.31.36.0-255,66,33171,8,332927
33727,0.000404,74.125.200.0-255,2902,36073,8,332927
33728,0.000408,172.31.36.0-255,66,36139,8,332927
33729,0.00044,74.125.200.0-255,5738,41877,8,332927
33730,0.000443,172.31.36.0-255,66,41943,8,332927
33731,0.000448,74.125.200.0-255,2902,44845,8,332927
33732,0.000451,172.31.36.0-255,66,44911,8,332927
33733,0.000477,74.125.200.0-255,3961,48872,8,332927
33734,0.000487,172.31.36.0-255,66,48938,8,332927
33735,0.000537,74.125.200.0-255,1484,50422,8,332927
33736,0.000551,74.125.200.0-255,2902,53324,8,332927
33737,0.000555,172.31.36.0-255,66,53390,8,332927
33738,0.000577,74.125.200.0-255,5738,59128,8,332927
33739,0.00058,172.31.36.0-255,66,59194,8,332927
33740,0.000586,74.125.200.0-255,4320,63514,8,332927
33741,0.000589,172.31.36.0-255,66,63580,8,332927
33742,0.000644,74.125.200.0-255,2543,66123,8,332927
33743,0.000648,172.31.36.0-255,66,66189,8,332927
33744,0.000898,74.125.200.0-255,646,66835,8,332927
33745,0.001278,74.125.200.0-255,1484,68319,8,332927
33746,0.001285,172.31.36.0-255,66,68385,8,332927
33747,0.001291,74.125.200.0-255,2902,71287,8,332927
33748,0.001294,172.31.36.0-255,66,71353,8,332927
33749,0.001324,74.125.200.0-255,5738,77091,8,332927
33750,0.001327,172.31.36.0-255,66,77157,8,332927
33751,0.001333,74.125.200.0-255,2902,80059,8,332927
33752,0.001335,172.31.36.0-255,66,80125,8,332927
33753,0.001358,74.125.200.0-255,5738,85863,8,332927
33754,0.001361,172.31.36.0-255,66,85929,8,332927
33755,0.001377,172.31.36.0-255,66,85995,8,332927
33756,0.001383,74.125.200.0-255,5020,91015,8,332927
33757,0.001386,172.31.36.0-255,66,91081,8,332927
33758,0.001448,74.125.200.0-255,1484,92565,8,332927
33759,0.001463,74.125.200.0-255,2902,95467,8,332927
33760,0.001467,172.31.36.0-255,66,95533,8,332927
33761,0.001473,74.125.200.0-255,1484,97017,8,332927
33762,0.001502,74.125.200.0-255,2902,99919,8,332927
33763,0.001506,172.31.36.0-255,66,99985,8,332927
33764,0.001515,74.125.200.0-255,5738,105723,8,332927
33765,0.001518,172.31.36.0-255,66,105789,8,332927
33766,0.001531,74.125.200.0-255,1484,107273,8,332927
33767,0.001543,74.125.200.0-255,2902,110175,8,332927
33768,0.001551,172.31.36.0-255,66,110241,8,332927
33769,0.00158,74.125.200.0-255,5738,115979,8,332927
33770,0.001584,172.31.36.0-255,66,116045,8,332927
33771,0.001634,172.31.36.0-255,66,116111,8,332927
33772,0.001957,74.125.200.0-255,1484,117595,8,332927
33773,0.001994,74.125.200.0-255,1484,119079,8,332927
33774,0.001997,172.31.36.0-255,66,119145,8,332927
33775,0.002019,74.125.200.0-255,1484,120629,8,332927
33776,0.002025,74.125.200.0-255,4320,124949,8,332927
33777,0.002028,172.31.36.0-255,66,125015,8,332927
33778,0.002058,74.125.200.0-255,2902,127917,8,332927
33779,0.00206,172.31.36.0-255,66,127983,8,332927
33780,0.00209,74.125.200.0-255,5738,133721,8,332927
33781,0.002093,172.31.36.0-255,66,133787,8,332927
33782,0.002108,74.125.200.0-255,5738,139525,8,332927
33783,0.002115,172.31.36.0-255,66,139591,8,332927
33784,0.002141,74.125.200.0-255,4320,143911,8,332927
33785,0.002144,172.31.36.0-255,66,143977,8,332927
33786,0.002148,74.125.200.0-255,2902,146879,8,332927
33787,0.00215,172.31.36.0-255,66,146945,8,332927
33788,0.002155,74.125.200.0-255,3602,150547,8,332927
33789,0.002157,172.31.36.0-255,66,150613,8,332927
33790,0.002202,74.125.200.0-255,1484,152097,8,332927
33791,0.002223,74.125.200.0-255,2902,154999,8,332927
33792,0.002226,172.31.36.0-255,66,155065,8,332927
33793,0.002255,74.125.200.0-255,5738,160803,8,332927
33794,0.002257,172.31.36.0-255,66,160869,8,332927
33795,0.002286,74.125.200.0-255,7156,168025,8,332927
33796,0.002289,172.31.36.0-255,66,168091,8,332927
33797,0.002317,74.125.200.0-255,2902,170993,8,332927
33798,0.002319,172.31.36.0-255,66,171059,8,332927
33799,0.002346,74.125.200.0-255,4320,175379,8,332927
33800,0.002348,172.31.36.0-255,66,175445,8,332927
33801,0.002359,172.31.36.0-255,66,175511,8,332927
33802,0.00238,74.125.200.0-255,766,176277,8,332927
33803,0.002499,74.125.200.0-255,1484,177761,8,332927
33804,0.002502,172.31.36.0-255,66,177827,8,332927
33805,0.002507,74.125.200.0-255,2902,180729,8,332927
33806,0.002508,172.31.36.0-255,66,180795,8,332927
33807,0.002511,74.125.200.0-255,1484,182279,8,332927
33808,0.002515,74.125.200.0-255,2902,185181,8,332927
33809,0.002517,172.31.36.0-255,66,185247,8,332927
33810,0.002529,74.125.200.0-255,5738,190985,8,332927
33811,0.002531,172.31.36.0-255,66,191051,8,332927
33812,0.002584,172.31.36.0-255,66,191117,8,332927
33813,0.003829,172.31.36.0-255,66,191183,8,332927
33814,0.006425,74.125.200.0-255,5738,196921,8,332927
33815,0.006432,172.31.36.0-255,66,196987,8,332927
33816,0.009073,74.125.200.0-255,5738,202725,8,332927
33817,0.00908,172.31.36.0-255,66,202791,8,332927
33818,0.011694,74.125.200.0-255,5738,208529,8,332927
33819,0.011702,172.31.36.0-255,66,208595,8,332927
33820,0.014317,74.125.200.0-255,5738,214333,8,332927
33821,0.014327,172.31.36.0-255,66,214399,8,332927
33822,0.016928,74.125.200.0-255,5738,220137,8,332927
33823,0.016937,172.31.36.0-255,66,220203,8,332927
33824,0.01954,74.125.200.0-255,5738,225941,8,332927
33825,0.019551,172.31.36.0-255,66,226007,8,332927
33826,0.022157,74.125.200.0-255,5738,231745,8,332927
33827,0.022166,172.31.36.0-255,66,231811,8,332927
33828,0.024766,74.125.200.0-255,5738,237549,8,332927
33829,0.024773,172.31.36.0-255,66,237615,8,332927
33830,0.027378,74.125.200.0-255,4320,241935,8,332927
33831,0.027386,172.31.36.0-255,66,242001,8,332927
33832,0.027418,74.125.200.0-255,1484,243485,8,332927
33833,0.029984,74.125.200.0-255,4320,247805,8,332927
33834,0.029991,172.31.36.0-255,66,247871,8,332927
33835,0.032594,74.125.200.0-255,4320,252191,8,332927
33836,0.032601,172.31.36.0-255,66,252257,8,332927
33837,0.032628,74.125.200.0-255,1484,253741,8,332927
33838,0.035196,74.125.200.0-255,4320,258061,8,332927
33839,0.035209,172.31.36.0-255,66,258127,8,332927
33840,0.037806,74.125.200.0-255,5738,263865,8,332927
33841,0.037814,172.31.36.0-255,66,263931,8,332927
33842,0.040415,74.125.200.0-255,5738,269669,8,332927
33843,0.040424,172.31.36.0-255,66,269735,8,332927
33844,0.04301,74.125.200.0-255,5738,275473,8,332927
33845,0.043019,172.31.36.0-255,66,275539,8,332927
33846,0.045615,74.125.200.0-255,5738,281277,8,332927
33847,0.045624,172.31.36.0-255,66,281343,8,332927
33848,0.048228,74.125.200.0-255,5738,287081,8,332927
33849,0.048234,172.31.36.0-255,66,287147,8,332927
33850,0.050815,74.125.200.0-255,5738,292885,8,332927
33851,0.050824,172.31.36.0-255,66,292951,8,332927
33852,0.051212,172.31.36.0-255,172,293123,8,332927
33853,0.051307,172.31.36.0-255,1113,294236,8,332927
33854,0.051526,172.31.36.0-255,569,294805,8,332927
33855,0.052742,104.244.42.0-255,66,294871,8,332927
33856,0.052884,104.244.42.0-255,66,294937,8,332927
33857,0.053086,104.244.42.0-255,66,295003,8,332927
33858,0.053423,74.125.200.0-255,5738,300741,8,332927
33859,0.05343,172.31.36.0-255,66,300807,8,332927
33860,0.056019,74.125.200.0-255,4320,305127,8,332927
33861,0.056025,172.31.36.0-255,66,305193,8,332927
33862,0.056058,74.125.200.0-255,1484,306677,8,332927
33863,0.058609,74.125.200.0-255,4320,310997,8,332927
33864,0.058614,172.31.36.0-255,66,311063,8,332927
33865,0.061213,74.125.200.0-255,5738,316801,8,332927
33866,0.061222,172.31.36.0-255,66,316867,8,332927
33867,0.063809,74.125.200.0-255,5738,322605,8,332927
33868,0.063815,172.31.36.0-255,66,322671,8,332927
33869,0.066415,74.125.200.0-255,4320,326991,8,332927
33870,0.066429,172.31.36.0-255,66,327057,8,332927
33871,0.066469,74.125.200.0-255,1484,328541,8,332927
33872,0.069024,74.125.200.0-255,4320,332861,8,332927
33873,0.069032,172.31.36.0-255,66,332927,8,332927
33874,0.0,74.125.24.0-255,153,153,8,234166
33875,3.4e-05,172.31.36.0-255,66,219,8,234166
33876,4.1e-05,74.125.24.0-255,1484,1703,8,234166
33877,4.5e-05,172.31.36.0-255,66,1769,8,234166
33878,5e-05,74.125.24.0-255,2902,4671,8,234166
33879,5.2e-05,172.31.36.0-255,66,4737,8,234166
33880,5.6e-05,74.125.24.0-255,2902,7639,8,234166
33881,5.9e-05,172.31.36.0-255,66,7705,8,234166
33882,9.6e-05,172.31.36.0-255,66,7771,8,234166
33883,0.000108,172.31.36.0-255,66,7837,8,234166
33884,0.000133,74.125.24.0-255,1484,9321,8,234166
33885,0.000135,172.31.36.0-255,66,9387,8,234166
33886,0.00015,172.31.36.0-255,66,9453,8,234166
33887,0.000172,74.125.24.0-255,6438,15891,8,234166
33888,0.000175,172.31.36.0-255,66,15957,8,234166
33889,0.000193,74.125.24.0-255,1484,17441,8,234166
33890,0.000195,172.31.36.0-255,66,17507,8,234166
33891,0.000234,172.31.36.0-255,66,17573,8,234166
33892,0.001513,74.125.24.0-255,111,17684,8,234166
33893,0.001523,172.31.36.0-255,66,17750,8,234166
33894,0.001548,74.125.24.0-255,1484,19234,8,234166
33895,0.001551,172.31.36.0-255,66,19300,8,234166
33896,0.001557,74.125.24.0-255,2902,22202,8,234166
33897,0.001559,172.31.36.0-255,66,22268,8,234166
33898,0.001567,74.125.24.0-255,7156,29424,8,234166
33899,0.001569,172.31.36.0-255,66,29490,8,234166
33900,0.001607,172.31.36.0-255,66,29556,8,234166
33901,0.001611,74.125.24.0-255,1484,31040,8,234166
33902,0.001636,74.125.24.0-255,6438,37478,8,234166
33903,0.001645,172.31.36.0-255,66,37544,8,234166
33904,0.001812,74.125.24.0-255,1484,39028,8,234166
33905,0.001819,74.125.24.0-255,2902,41930,8,234166
33906,0.001822,74.125.24.0-255,1484,43414,8,234166
33907,0.001829,172.31.36.0-255,66,43480,8,234166
33908,0.001846,74.125.24.0-255,4320,47800,8,234166
33909,0.001879,74.125.24.0-255,4320,52120,8,234166
33910,0.001915,172.31.36.0-255,66,52186,8,234166
33911,0.001932,74.125.24.0-255,2902,55088,8,234166
33912,0.001941,172.31.36.0-255,66,55154,8,234166
33913,0.001986,74.125.24.0-255,5020,60174,8,234166
33914,0.001997,172.31.36.0-255,66,60240,8,234166
33915,0.002008,172.31.36.0-255,66,60306,8,234166
33916,0.002019,74.125.24.0-255,2902,63208,8,234166
33917,0.002033,74.125.24.0-255,5738,68946,8,234166
33918,0.002106,172.31.36.0-255,66,69012,8,234166
33919,0.002127,74.125.24.0-255,7156,76168,8,234166
33920,0.002133,172.31.36.0-255,66,76234,8,234166
33921,0.002154,74.125.24.0-255,5738,81972,8,234166
33922,0.002174,172.31.36.0-255,66,82038,8,234166
33923,0.002187,172.31.36.0-255,66,82104,8,234166
33924,0.002197,74.125.24.0-255,5020,87124,8,234166
33925,0.002199,74.125.24.0-255,1484,88608,8,234166
33926,0.002252,172.31.36.0-255,66,88674,8,234166
33927,0.00482,74.125.24.0-255,5738,94412,8,234166
33928,0.004828,172.31.36.0-255,66,94478,8,234166
33929,0.007402,74.125.24.0-255,5738,100216,8,234166
33930,0.00742,172.31.36.0-255,66,100282,8,234166
33931,0.010004,74.125.24.0-255,5738,106020,8,234166
33932,0.010025,172.31.36.0-255,66,106086,8,234166
33933,0.012605,74.125.24.0-255,5738,111824,8,234166
33934,0.012625,172.31.36.0-255,66,111890,8,234166
33935,0.01526,74.125.24.0-255,5738,117628,8,234166
33936,0.015269,172.31.36.0-255,66,117694,8,234166
33937,0.017851,74.125.24.0-255,5738,123432,8,234166
33938,0.017859,172.31.36.0-255,66,123498,8,234166
33939,0.020437,74.125.24.0-255,5738,129236,8,234166
33940,0.020445,172.31.36.0-255,66,129302,8,234166
33941,0.023012,74.125.24.0-255,5738,135040,8,234166
33942,0.02302,172.31.36.0-255,66,135106,8,234166
33943,0.025589,74.125.24.0-255,5738,140844,8,234166
33944,0.025595,172.31.36.0-255,66,140910,8,234166
33945,0.028172,74.125.24.0-255,5738,146648,8,234166
33946,0.028182,172.31.36.0-255,66,146714,8,234166
33947,0.030765,74.125.24.0-255,5738,152452,8,234166
33948,0.030772,172.31.36.0-255,66,152518,8,234166
33949,0.032055,172.31.36.0-255,188,152706,8,234166
33950,0.032085,172.31.36.0-255,955,153661,8,234166
33951,0.03213,172.31.36.0-255,1514,155175,8,234166
33952,0.032131,172.31.36.0-255,135,155310,8,234166
33953,0.033352,74.125.24.0-255,5738,161048,8,234166
33954,0.033359,172.31.36.0-255,66,161114,8,234166
33955,0.033634,104.244.42.0-255,66,161180,8,234166
33956,0.033701,104.244.42.0-255,66,161246,8,234166
33957,0.033767,104.244.42.0-255,66,161312,8,234166
33958,0.035926,74.125.24.0-255,5738,167050,8,234166
33959,0.035932,172.31.36.0-255,66,167116,8,234166
33960,0.038498,74.125.24.0-255,5738,172854,8,234166
33961,0.038503,172.31.36.0-255,66,172920,8,234166
33962,0.041107,74.125.24.0-255,5738,178658,8,234166
33963,0.041112,172.31.36.0-255,66,178724,8,234166
33964,0.043688,74.125.24.0-255,5738,184462,8,234166
33965,0.043709,172.31.36.0-255,66,184528,8,234166
33966,0.04629,74.125.24.0-255,4320,188848,8,234166
33967,0.046295,172.31.36.0-255,66,188914,8,234166
33968,0.046322,74.125.24.0-255,1484,190398,8,234166
33969,0.048875,74.125.24.0-255,4320,194718,8,234166
33970,0.04888,172.31.36.0-255,66,194784,8,234166
33971,0.051461,74.125.24.0-255,5738,200522,8,234166
33972,0.051813,172.31.36.0-255,66,200588,8,234166
33973,0.054382,74.125.24.0-255,5738,206326,8,234166
33974,0.054388,172.31.36.0-255,66,206392,8,234166
33975,0.056991,74.125.24.0-255,5738,212130,8,234166
33976,0.056997,172.31.36.0-255,66,212196,8,234166
33977,0.059572,74.125.24.0-255,5738,217934,8,234166
33978,0.059578,172.31.36.0-255,66,218000,8,234166
33979,0.062136,74.125.24.0-255,5738,223738,8,234166
33980,0.062141,172.31.36.0-255,66,223804,8,234166
33981,0.064716,74.125.24.0-255,2902,226706,8,234166
33982,0.064721,172.31.36.0-255,66,226772,8,234166
33983,0.064753,74.125.24.0-255,2902,229674,8,234166
33984,0.064779,172.31.36.0-255,66,229740,8,234166
33985,0.067299,74.125.24.0-255,2902,232642,8,234166
33986,0.067304,172.31.36.0-255,66,232708,8,234166
33987,0.067331,74.125.24.0-255,1287,233995,8,234166
33988,0.067472,172.31.36.0-255,66,234061,8,234166
33989,0.067502,172.31.36.0-255,105,234166,8,234166
33990,0.0,74.125.68.0-255,153,153,8,342032
33991,2.3e-05,172.31.36.0-255,66,219,8,342032
33992,3e-05,74.125.68.0-255,1484,1703,8,342032
33993,3.6e-05,172.31.36.0-255,66,1769,8,342032
33994,5e-05,74.125.68.0-255,2902,4671,8,342032
33995,5.4e-05,172.31.36.0-255,66,4737,8,342032
33996,6.3e-05,74.125.68.0-255,7156,11893,8,342032
33997,6.6e-05,172.31.36.0-255,66,11959,8,342032
33998,0.000101,74.125.68.0-255,1967,13926,8,342032
33999,0.000105,172.31.36.0-255,66,13992,8,342032
34000,0.000183,74.125.68.0-255,1484,15476,8,342032
34001,0.000186,172.31.36.0-255,66,15542,8,342032
34002,0.000192,74.125.68.0-255,2902,18444,8,342032
34003,0.000195,172.31.36.0-255,66,18510,8,342032
34004,0.000208,74.125.68.0-255,5738,24248,8,342032
34005,0.00021,172.31.36.0-255,66,24314,8,342032
34006,0.000234,74.125.68.0-255,2902,27216,8,342032
34007,0.000236,172.31.36.0-255,66,27282,8,342032
34008,0.000262,74.125.68.0-255,3961,31243,8,342032
34009,0.000265,172.31.36.0-255,66,31309,8,342032
34010,0.000291,74.125.68.0-255,7156,38465,8,342032
34011,0.000294,172.31.36.0-255,66,38531,8,342032
34012,0.000298,74.125.68.0-255,2902,41433,8,342032
34013,0.000301,172.31.36.0-255,66,41499,8,342032
34014,0.000322,74.125.68.0-255,4320,45819,8,342032
34015,0.000325,172.31.36.0-255,66,45885,8,342032
34016,0.000358,74.125.68.0-255,7156,53041,8,342032
34017,0.00036,172.31.36.0-255,66,53107,8,342032
34018,0.000371,172.31.36.0-255,66,53173,8,342032
34019,0.000414,74.125.68.0-255,3602,56775,8,342032
34020,0.000417,172.31.36.0-255,66,56841,8,342032
34021,0.000711,74.125.68.0-255,399,57240,8,342032
34022,0.000729,74.125.68.0-255,107,57347,8,342032
34023,0.000951,74.125.68.0-255,1484,58831,8,342032
34024,0.000955,172.31.36.0-255,66,58897,8,342032
34025,0.000979,74.125.68.0-255,2902,61799,8,342032
34026,0.000981,172.31.36.0-255,66,61865,8,342032
34027,0.000988,74.125.68.0-255,5738,67603,8,342032
34028,0.000991,172.31.36.0-255,66,67669,8,342032
34029,0.001022,74.125.68.0-255,2902,70571,8,342032
34030,0.001024,172.31.36.0-255,66,70637,8,342032
34031,0.001037,172.31.36.0-255,66,70703,8,342032
34032,0.001074,172.31.36.0-255,66,70769,8,342032
34033,0.001185,74.125.68.0-255,1484,72253,8,342032
34034,0.001202,74.125.68.0-255,2902,75155,8,342032
34035,0.001205,172.31.36.0-255,66,75221,8,342032
34036,0.001234,74.125.68.0-255,5738,80959,8,342032
34037,0.001237,172.31.36.0-255,66,81025,8,342032
34038,0.001266,74.125.68.0-255,1484,82509,8,342032
34039,0.00128,74.125.68.0-255,4320,86829,8,342032
34040,0.001283,172.31.36.0-255,66,86895,8,342032
34041,0.00131,74.125.68.0-255,813,87708,8,342032
34042,0.001347,74.125.68.0-255,5738,93446,8,342032
34043,0.00135,172.31.36.0-255,66,93512,8,342032
34044,0.001362,74.125.68.0-255,1484,94996,8,342032
34045,0.00138,172.31.36.0-255,66,95062,8,342032
34046,0.001394,172.31.36.0-255,66,95128,8,342032
34047,0.001399,74.125.68.0-255,2184,97312,8,342032
34048,0.001401,172.31.36.0-255,66,97378,8,342032
34049,0.001428,74.125.68.0-255,1484,98862,8,342032
34050,0.00146,74.125.68.0-255,2902,101764,8,342032
34051,0.001463,172.31.36.0-255,66,101830,8,342032
34052,0.00147,74.125.68.0-255,5738,107568,8,342032
34053,0.001473,172.31.36.0-255,66,107634,8,342032
34054,0.001481,74.125.68.0-255,1484,109118,8,342032
34055,0.001485,74.125.68.0-255,2902,112020,8,342032
34056,0.001488,172.31.36.0-255,66,112086,8,342032
34057,0.001495,74.125.68.0-255,5738,117824,8,342032
34058,0.001497,172.31.36.0-255,66,117890,8,342032
34059,0.001525,74.125.68.0-255,7156,125046,8,342032
34060,0.001528,172.31.36.0-255,66,125112,8,342032
34061,0.001549,74.125.68.0-255,1484,126596,8,342032
34062,0.001575,74.125.68.0-255,5020,131616,8,342032
34063,0.001578,172.31.36.0-255,66,131682,8,342032
34064,0.001633,74.125.68.0-255,5738,137420,8,342032
34065,0.001636,172.31.36.0-255,66,137486,8,342032
34066,0.001679,74.125.68.0-255,1484,138970,8,342032
34067,0.00169,74.125.68.0-255,1484,140454,8,342032
34068,0.001693,172.31.36.0-255,66,140520,8,342032
34069,0.001717,74.125.68.0-255,4320,144840,8,342032
34070,0.00172,172.31.36.0-255,66,144906,8,342032
34071,0.001728,74.125.68.0-255,5738,150644,8,342032
34072,0.00173,172.31.36.0-255,66,150710,8,342032
34073,0.001735,74.125.68.0-255,2902,153612,8,342032
34074,0.001737,172.31.36.0-255,66,153678,8,342032
34075,0.001774,74.125.68.0-255,4320,157998,8,342032
34076,0.001778,172.31.36.0-255,66,158064,8,342032
34077,0.001788,172.31.36.0-255,66,158130,8,342032
34078,0.001921,74.125.68.0-255,1484,159614,8,342032
34079,0.00194,74.125.68.0-255,2902,162516,8,342032
34080,0.001943,172.31.36.0-255,66,162582,8,342032
34081,0.001949,74.125.68.0-255,4320,166902,8,342032
34082,0.001952,172.31.36.0-255,66,166968,8,342032
34083,0.001977,74.125.68.0-255,1484,168452,8,342032
34084,0.001982,74.125.68.0-255,2902,171354,8,342032
34085,0.001985,172.31.36.0-255,66,171420,8,342032
34086,0.00199,74.125.68.0-255,4320,175740,8,342032
34087,0.001992,172.31.36.0-255,66,175806,8,342032
34088,0.002004,172.31.36.0-255,66,175872,8,342032
34089,0.002009,74.125.68.0-255,2902,178774,8,342032
34090,0.002011,172.31.36.0-255,66,178840,8,342032
34091,0.002039,74.125.68.0-255,4320,183160,8,342032
34092,0.002042,172.31.36.0-255,66,183226,8,342032
34093,0.002065,74.125.68.0-255,766,183992,8,342032
34094,0.002101,74.125.68.0-255,1484,185476,8,342032
34095,0.002104,172.31.36.0-255,66,185542,8,342032
34096,0.002108,74.125.68.0-255,1484,187026,8,342032
34097,0.002129,74.125.68.0-255,2902,189928,8,342032
34098,0.002132,172.31.36.0-255,66,189994,8,342032
34099,0.002153,74.125.68.0-255,1484,191478,8,342032
34100,0.00218,74.125.68.0-255,1484,192962,8,342032
34101,0.002184,172.31.36.0-255,66,193028,8,342032
34102,0.00221,74.125.68.0-255,2902,195930,8,342032
34103,0.002213,172.31.36.0-255,66,195996,8,342032
34104,0.002217,74.125.68.0-255,2902,198898,8,342032
34105,0.002219,172.31.36.0-255,66,198964,8,342032
34106,0.002225,74.125.68.0-255,4320,203284,8,342032
34107,0.002227,172.31.36.0-255,66,203350,8,342032
34108,0.002243,172.31.36.0-255,66,203416,8,342032
34109,0.002248,74.125.68.0-255,4320,207736,8,342032
34110,0.002251,172.31.36.0-255,66,207802,8,342032
34111,0.002278,74.125.68.0-255,2184,209986,8,342032
34112,0.002281,172.31.36.0-255,66,210052,8,342032
34113,0.00475,74.125.68.0-255,2902,212954,8,342032
34114,0.004757,172.31.36.0-255,66,213020,8,342032
34115,0.004787,74.125.68.0-255,2902,215922,8,342032
34116,0.004789,172.31.36.0-255,66,215988,8,342032
34117,0.007264,74.125.68.0-255,2902,218890,8,342032
34118,0.007271,172.31.36.0-255,66,218956,8,342032
34119,0.007303,74.125.68.0-255,2902,221858,8,342032
34120,0.007305,172.31.36.0-255,66,221924,8,342032
34121,0.009766,74.125.68.0-255,1484,223408,8,342032
34122,0.009784,74.125.68.0-255,1484,224892,8,342032
34123,0.009787,172.31.36.0-255,66,224958,8,342032
34124,0.009814,74.125.68.0-255,2902,227860,8,342032
34125,0.009816,172.31.36.0-255,66,227926,8,342032
34126,0.012302,74.125.68.0-255,2902,230828,8,342032
34127,0.012309,172.31.36.0-255,66,230894,8,342032
34128,0.012334,74.125.68.0-255,2902,233796,8,342032
34129,0.012337,172.31.36.0-255,66,233862,8,342032
34130,0.014812,74.125.68.0-255,2902,236764,8,342032
34131,0.014822,172.31.36.0-255,66,236830,8,342032
34132,0.014842,74.125.68.0-255,2902,239732,8,342032
34133,0.014845,172.31.36.0-255,66,239798,8,342032
34134,0.017335,74.125.68.0-255,5738,245536,8,342032
34135,0.017344,172.31.36.0-255,66,245602,8,342032
34136,0.019852,74.125.68.0-255,5738,251340,8,342032
34137,0.01986,172.31.36.0-255,66,251406,8,342032
34138,0.022367,74.125.68.0-255,5738,257144,8,342032
34139,0.022375,172.31.36.0-255,66,257210,8,342032
34140,0.024881,74.125.68.0-255,5738,262948,8,342032
34141,0.024888,172.31.36.0-255,66,263014,8,342032
34142,0.0274,74.125.68.0-255,5738,268752,8,342032
34143,0.027408,172.31.36.0-255,66,268818,8,342032
34144,0.029917,74.125.68.0-255,5738,274556,8,342032
34145,0.029924,172.31.36.0-255,66,274622,8,342032
34146,0.032448,74.125.68.0-255,5738,280360,8,342032
34147,0.032455,172.31.36.0-255,66,280426,8,342032
34148,0.0333,172.31.36.0-255,191,280617,8,342032
34149,0.033333,172.31.36.0-255,979,281596,8,342032
34150,0.033393,172.31.36.0-255,1514,283110,8,342032
34151,0.033395,172.31.36.0-255,111,283221,8,342032
34152,0.034855,104.244.42.0-255,66,283287,8,342032
34153,0.034947,104.244.42.0-255,66,283353,8,342032
34154,0.03495,104.244.42.0-255,66,283419,8,342032
34155,0.034964,74.125.68.0-255,5738,289157,8,342032
34156,0.034969,172.31.36.0-255,66,289223,8,342032
34157,0.037497,74.125.68.0-255,5738,294961,8,342032
34158,0.037504,172.31.36.0-255,66,295027,8,342032
34159,0.040016,74.125.68.0-255,5738,300765,8,342032
34160,0.040027,172.31.36.0-255,66,300831,8,342032
34161,0.042542,74.125.68.0-255,5738,306569,8,342032
34162,0.042549,172.31.36.0-255,66,306635,8,342032
34163,0.045062,74.125.68.0-255,5738,312373,8,342032
34164,0.045069,172.31.36.0-255,66,312439,8,342032
34165,0.047574,74.125.68.0-255,4320,316759,8,342032
34166,0.047581,172.31.36.0-255,66,316825,8,342032
34167,0.04761,74.125.68.0-255,1484,318309,8,342032
34168,0.050085,74.125.68.0-255,4320,322629,8,342032
34169,0.050092,172.31.36.0-255,66,322695,8,342032
34170,0.052595,74.125.68.0-255,5738,328433,8,342032
34171,0.052601,172.31.36.0-255,66,328499,8,342032
34172,0.055105,74.125.68.0-255,5738,334237,8,342032
34173,0.055112,172.31.36.0-255,66,334303,8,342032
34174,0.057637,74.125.68.0-255,5738,340041,8,342032
34175,0.057646,172.31.36.0-255,66,340107,8,342032
34176,0.060153,74.125.68.0-255,1688,341795,8,342032
34177,0.06016,172.31.36.0-255,66,341861,8,342032
34178,0.060341,172.31.36.0-255,105,341966,8,342032
34179,0.062802,74.125.68.0-255,66,342032,8,342032
34180,0.0,172.217.194.0-255,150,150,8,217007
34181,2.4e-05,172.31.36.0-255,66,216,8,217007
34182,5.3e-05,172.217.194.0-255,1484,1700,8,217007
34183,5.8e-05,172.31.36.0-255,66,1766,8,217007
34184,8.3e-05,172.217.194.0-255,2902,4668,8,217007
34185,8.6e-05,172.31.36.0-255,66,4734,8,217007
34186,9.5e-05,172.217.194.0-255,7156,11890,8,217007
34187,9.7e-05,172.31.36.0-255,66,11956,8,217007
34188,0.000102,172.217.194.0-255,3518,15474,8,217007
34189,0.000105,172.31.36.0-255,66,15540,8,217007
34190,0.000122,172.217.194.0-255,2902,18442,8,217007
34191,0.000127,172.31.36.0-255,66,18508,8,217007
34192,0.000169,172.31.36.0-255,66,18574,8,217007
34193,0.000173,172.217.194.0-255,2543,21117,8,217007
34194,0.000175,172.31.36.0-255,66,21183,8,217007
34195,0.000204,172.217.194.0-255,1484,22667,8,217007
34196,0.000207,172.31.36.0-255,66,22733,8,217007
34197,0.000212,172.217.194.0-255,2902,25635,8,217007
34198,0.000214,172.31.36.0-255,66,25701,8,217007
34199,0.000254,172.217.194.0-255,5738,31439,8,217007
34200,0.000259,172.31.36.0-255,66,31505,8,217007
34201,0.000266,172.217.194.0-255,5738,37243,8,217007
34202,0.000268,172.31.36.0-255,66,37309,8,217007
34203,0.000312,172.31.36.0-255,66,37375,8,217007
34204,0.000317,172.217.194.0-255,4218,41593,8,217007
34205,0.000319,172.31.36.0-255,66,41659,8,217007
34206,0.000322,172.217.194.0-255,120,41779,8,217007
34207,0.00033,172.31.36.0-255,66,41845,8,217007
34208,0.000487,172.217.194.0-255,375,42220,8,217007
34209,0.000491,172.31.36.0-255,66,42286,8,217007
34210,0.000797,172.217.194.0-255,1484,43770,8,217007
34211,0.000804,172.217.194.0-255,2902,46672,8,217007
34212,0.000809,172.31.36.0-255,66,46738,8,217007
34213,0.000845,172.217.194.0-255,5738,52476,8,217007
34214,0.000848,172.31.36.0-255,66,52542,8,217007
34215,0.000859,172.31.36.0-255,66,52608,8,217007
34216,0.000883,172.217.194.0-255,4320,56928,8,217007
34217,0.000891,172.31.36.0-255,66,56994,8,217007
34218,0.000901,172.31.36.0-255,66,57060,8,217007
34219,0.000906,172.217.194.0-255,1635,58695,8,217007
34220,0.000908,172.31.36.0-255,66,58761,8,217007
34221,0.000987,172.217.194.0-255,1484,60245,8,217007
34222,0.000993,172.217.194.0-255,2902,63147,8,217007
34223,0.000996,172.31.36.0-255,66,63213,8,217007
34224,0.001,172.217.194.0-255,2902,66115,8,217007
34225,0.001002,172.31.36.0-255,66,66181,8,217007
34226,0.001025,172.217.194.0-255,2902,69083,8,217007
34227,0.001028,172.31.36.0-255,66,69149,8,217007
34228,0.00104,172.31.36.0-255,66,69215,8,217007
34229,0.00107,172.217.194.0-255,2902,72117,8,217007
34230,0.001073,172.31.36.0-255,66,72183,8,217007
34231,0.001085,172.31.36.0-255,66,72249,8,217007
34232,0.001262,172.217.194.0-255,1484,73733,8,217007
34233,0.00128,172.217.194.0-255,2902,76635,8,217007
34234,0.001284,172.31.36.0-255,66,76701,8,217007
34235,0.00129,172.217.194.0-255,5738,82439,8,217007
34236,0.001292,172.31.36.0-255,66,82505,8,217007
34237,0.001328,172.31.36.0-255,66,82571,8,217007
34238,0.00137,172.217.194.0-255,5738,88309,8,217007
34239,0.001373,172.31.36.0-255,66,88375,8,217007
34240,0.0014,172.217.194.0-255,5020,93395,8,217007
34241,0.001403,172.31.36.0-255,66,93461,8,217007
34242,0.001636,172.217.194.0-255,1484,94945,8,217007
34243,0.00164,172.217.194.0-255,1484,96429,8,217007
34244,0.001644,172.31.36.0-255,66,96495,8,217007
34245,0.00167,172.217.194.0-255,1484,97979,8,217007
34246,0.001676,172.217.194.0-255,5738,103717,8,217007
34247,0.001679,172.31.36.0-255,66,103783,8,217007
34248,0.001686,172.217.194.0-255,7156,110939,8,217007
34249,0.001688,172.31.36.0-255,66,111005,8,217007
34250,0.001706,172.217.194.0-255,2902,113907,8,217007
34251,0.00171,172.31.36.0-255,66,113973,8,217007
34252,0.001725,172.31.36.0-255,66,114039,8,217007
34253,0.00174,172.217.194.0-255,5020,119059,8,217007
34254,0.001746,172.31.36.0-255,66,119125,8,217007
34255,0.001906,172.217.194.0-255,1484,120609,8,217007
34256,0.001937,172.217.194.0-255,2902,123511,8,217007
34257,0.001941,172.31.36.0-255,66,123577,8,217007
34258,0.001977,172.217.194.0-255,4320,127897,8,217007
34259,0.001981,172.31.36.0-255,66,127963,8,217007
34260,0.002006,172.217.194.0-255,5738,133701,8,217007
34261,0.002009,172.31.36.0-255,66,133767,8,217007
34262,0.002013,172.217.194.0-255,2902,136669,8,217007
34263,0.002015,172.31.36.0-255,66,136735,8,217007
34264,0.00205,172.31.36.0-255,66,136801,8,217007
34265,0.002081,172.217.194.0-255,6438,143239,8,217007
34266,0.002085,172.31.36.0-255,66,143305,8,217007
34267,0.002222,172.217.194.0-255,1484,144789,8,217007
34268,0.002226,172.217.194.0-255,1484,146273,8,217007
34269,0.002229,172.31.36.0-255,66,146339,8,217007
34270,0.002254,172.217.194.0-255,1484,147823,8,217007
34271,0.002261,172.217.194.0-255,5738,153561,8,217007
34272,0.002264,172.31.36.0-255,66,153627,8,217007
34273,0.00227,172.217.194.0-255,5738,159365,8,217007
34274,0.002272,172.31.36.0-255,66,159431,8,217007
34275,0.002315,172.217.194.0-255,7156,166587,8,217007
34276,0.002319,172.31.36.0-255,66,166653,8,217007
34277,0.00233,172.31.36.0-255,66,166719,8,217007
34278,0.00236,172.31.36.0-255,66,166785,8,217007
34279,0.002373,172.31.36.0-255,66,166851,8,217007
34280,0.002411,172.31.36.0-255,66,166917,8,217007
34281,0.002414,172.217.194.0-255,1484,168401,8,217007
34282,0.002418,172.217.194.0-255,766,169167,8,217007
34283,0.00242,172.31.36.0-255,66,169233,8,217007
34284,0.002424,172.217.194.0-255,4320,173553,8,217007
34285,0.002427,172.31.36.0-255,66,173619,8,217007
34286,0.002429,172.217.194.0-255,1484,175103,8,217007
34287,0.002433,172.217.194.0-255,2902,178005,8,217007
34288,0.002435,172.31.36.0-255,66,178071,8,217007
34289,0.002441,172.217.194.0-255,5738,183809,8,217007
34290,0.002444,172.31.36.0-255,66,183875,8,217007
34291,0.002447,172.217.194.0-255,1484,185359,8,217007
34292,0.002487,172.217.194.0-255,2184,187543,8,217007
34293,0.002491,172.31.36.0-255,78,187621,8,217007
34294,0.002509,172.31.36.0-255,78,187699,8,217007
34295,0.002536,172.217.194.0-255,4320,192019,8,217007
34296,0.00254,172.31.36.0-255,66,192085,8,217007
34297,0.002555,172.31.36.0-255,66,192151,8,217007
34298,0.002558,172.217.194.0-255,1484,193635,8,217007
34299,0.002561,172.217.194.0-255,1484,195119,8,217007
34300,0.002563,172.31.36.0-255,66,195185,8,217007
34301,0.002613,172.31.36.0-255,66,195251,8,217007
34302,0.002617,172.217.194.0-255,2902,198153,8,217007
34303,0.002619,172.31.36.0-255,66,198219,8,217007
34304,0.002658,172.217.194.0-255,1484,199703,8,217007
34305,0.002661,172.31.36.0-255,78,199781,8,217007
34306,0.002682,172.31.36.0-255,66,199847,8,217007
34307,0.002684,172.217.194.0-255,1484,201331,8,217007
34308,0.002724,172.217.194.0-255,5738,207069,8,217007
34309,0.002727,172.31.36.0-255,66,207135,8,217007
34310,0.002753,172.217.194.0-255,6438,213573,8,217007
34311,0.002757,172.31.36.0-255,66,213639,8,217007
34312,0.002762,172.217.194.0-255,2094,215733,8,217007
34313,0.002764,172.31.36.0-255,66,215799,8,217007
34314,0.002767,172.217.194.0-255,105,215904,8,217007
34315,0.010043,172.31.36.0-255,66,215970,8,217007
34316,0.01007,172.31.36.0-255,105,216075,8,217007
34317,0.012336,172.217.194.0-255,66,216141,8,217007
34318,0.040087,172.31.36.0-255,172,216313,8,217007
34319,0.040117,172.31.36.0-255,562,216875,8,217007
34320,0.041634,104.244.42.0-255,66,216941,8,217007
34321,0.041643,104.244.42.0-255,66,217007,8,217007
34322,0.0,74.125.24.0-255,153,153,8,223498
34323,2.8e-05,172.31.36.0-255,66,219,8,223498
34324,3.5e-05,74.125.24.0-255,1484,1703,8,223498
34325,3.9e-05,172.31.36.0-255,66,1769,8,223498
34326,4.3e-05,74.125.24.0-255,2902,4671,8,223498
34327,4.5e-05,172.31.36.0-255,66,4737,8,223498
34328,5.9e-05,74.125.24.0-255,7156,11893,8,223498
34329,6.2e-05,172.31.36.0-255,66,11959,8,223498
34330,9.3e-05,74.125.24.0-255,1980,13939,8,223498
34331,9.6e-05,172.31.36.0-255,66,14005,8,223498
34332,0.0001,74.125.24.0-255,2902,16907,8,223498
34333,0.000102,172.31.36.0-255,66,16973,8,223498
34334,0.000108,74.125.24.0-255,7156,24129,8,223498
34335,0.000109,172.31.36.0-255,66,24195,8,223498
34336,0.000135,74.125.24.0-255,6797,30992,8,223498
34337,0.000138,172.31.36.0-255,66,31058,8,223498
34338,0.000192,74.125.24.0-255,1484,32542,8,223498
34339,0.000195,172.31.36.0-255,66,32608,8,223498
34340,0.000199,74.125.24.0-255,1484,34092,8,223498
34341,0.0002,172.31.36.0-255,66,34158,8,223498
34342,0.000228,74.125.24.0-255,1484,35642,8,223498
34343,0.00023,172.31.36.0-255,66,35708,8,223498
34344,0.000236,74.125.24.0-255,5738,41446,8,223498
34345,0.000238,172.31.36.0-255,66,41512,8,223498
34346,0.000241,74.125.24.0-255,1484,42996,8,223498
34347,0.000243,172.31.36.0-255,66,43062,8,223498
34348,0.000248,74.125.24.0-255,4320,47382,8,223498
34349,0.000251,172.31.36.0-255,66,47448,8,223498
34350,0.000274,74.125.24.0-255,5379,52827,8,223498
34351,0.000277,172.31.36.0-255,66,52893,8,223498
34352,0.00028,74.125.24.0-255,1484,54377,8,223498
34353,0.000282,172.31.36.0-255,66,54443,8,223498
34354,0.000324,172.31.36.0-255,66,54509,8,223498
34355,0.000327,74.125.24.0-255,110,54619,8,223498
34356,0.00033,74.125.24.0-255,331,54950,8,223498
34357,0.000555,74.125.24.0-255,1484,56434,8,223498
34358,0.000559,172.31.36.0-255,66,56500,8,223498
34359,0.000564,74.125.24.0-255,2902,59402,8,223498
34360,0.000566,172.31.36.0-255,66,59468,8,223498
34361,0.000569,74.125.24.0-255,1484,60952,8,223498
34362,0.000599,74.125.24.0-255,4320,65272,8,223498
34363,0.000602,172.31.36.0-255,66,65338,8,223498
34364,0.000607,74.125.24.0-255,4320,69658,8,223498
34365,0.000609,172.31.36.0-255,66,69724,8,223498
34366,0.000619,172.31.36.0-255,66,69790,8,223498
34367,0.00064,74.125.24.0-255,5738,75528,8,223498
34368,0.000643,172.31.36.0-255,66,75594,8,223498
34369,0.000668,74.125.24.0-255,2184,77778,8,223498
34370,0.00067,172.31.36.0-255,66,77844,8,223498
34371,0.000765,74.125.24.0-255,1484,79328,8,223498
34372,0.00077,74.125.24.0-255,2902,82230,8,223498
34373,0.000773,172.31.36.0-255,66,82296,8,223498
34374,0.000776,74.125.24.0-255,1484,83780,8,223498
34375,0.000801,74.125.24.0-255,4320,88100,8,223498
34376,0.000804,172.31.36.0-255,66,88166,8,223498
34377,0.000814,172.31.36.0-255,66,88232,8,223498
34378,0.000869,172.31.36.0-255,66,88298,8,223498
34379,0.000904,74.125.24.0-255,5020,93318,8,223498
34380,0.000907,172.31.36.0-255,66,93384,8,223498
34381,0.000919,172.31.36.0-255,66,93450,8,223498
34382,0.000924,74.125.24.0-255,7156,100606,8,223498
34383,0.000927,172.31.36.0-255,66,100672,8,223498
34384,0.000966,172.31.36.0-255,66,100738,8,223498
34385,0.000995,172.31.36.0-255,66,100804,8,223498
34386,0.001024,74.125.24.0-255,4320,105124,8,223498
34387,0.001027,172.31.36.0-255,66,105190,8,223498
34388,0.001036,172.31.36.0-255,66,105256,8,223498
34389,0.001039,74.125.24.0-255,1484,106740,8,223498
34390,0.001079,172.31.36.0-255,66,106806,8,223498
34391,0.001139,74.125.24.0-255,1484,108290,8,223498
34392,0.001145,74.125.24.0-255,2902,111192,8,223498
34393,0.001148,172.31.36.0-255,66,111258,8,223498
34394,0.00115,74.125.24.0-255,1484,112742,8,223498
34395,0.001173,74.125.24.0-255,4320,117062,8,223498
34396,0.001176,172.31.36.0-255,66,117128,8,223498
34397,0.00118,74.125.24.0-255,2902,120030,8,223498
34398,0.001187,172.31.36.0-255,66,120096,8,223498
34399,0.001211,172.31.36.0-255,66,120162,8,223498
34400,0.001221,172.31.36.0-255,66,120228,8,223498
34401,0.001248,74.125.24.0-255,2184,122412,8,223498
34402,0.00125,172.31.36.0-255,66,122478,8,223498
34403,0.001575,74.125.24.0-255,1484,123962,8,223498
34404,0.001592,74.125.24.0-255,2902,126864,8,223498
34405,0.001595,172.31.36.0-255,66,126930,8,223498
34406,0.001598,74.125.24.0-255,1484,128414,8,223498
34407,0.001624,74.125.24.0-255,5738,134152,8,223498
34408,0.001626,172.31.36.0-255,66,134218,8,223498
34409,0.001637,74.125.24.0-255,5738,139956,8,223498
34410,0.001639,172.31.36.0-255,66,140022,8,223498
34411,0.001667,74.125.24.0-255,7156,147178,8,223498
34412,0.00167,172.31.36.0-255,66,147244,8,223498
34413,0.001679,172.31.36.0-255,66,147310,8,223498
34414,0.001719,74.125.24.0-255,1484,148794,8,223498
34415,0.001724,74.125.24.0-255,2902,151696,8,223498
34416,0.001728,172.31.36.0-255,66,151762,8,223498
34417,0.001758,74.125.24.0-255,5738,157500,8,223498
34418,0.001762,172.31.36.0-255,66,157566,8,223498
34419,0.001768,74.125.24.0-255,4320,161886,8,223498
34420,0.00177,172.31.36.0-255,66,161952,8,223498
34421,0.001777,74.125.24.0-255,5738,167690,8,223498
34422,0.001779,172.31.36.0-255,66,167756,8,223498
34423,0.00182,74.125.24.0-255,5738,173494,8,223498
34424,0.001824,172.31.36.0-255,66,173560,8,223498
34425,0.001838,172.31.36.0-255,66,173626,8,223498
34426,0.001854,172.31.36.0-255,66,173692,8,223498
34427,0.001888,74.125.24.0-255,2902,176594,8,223498
34428,0.001891,172.31.36.0-255,66,176660,8,223498
34429,0.001933,172.31.36.0-255,66,176726,8,223498
34430,0.001939,74.125.24.0-255,4320,181046,8,223498
34431,0.001941,172.31.36.0-255,66,181112,8,223498
34432,0.001947,74.125.24.0-255,5738,186850,8,223498
34433,0.001949,172.31.36.0-255,66,186916,8,223498
34434,0.00196,172.31.36.0-255,66,186982,8,223498
34435,0.001974,172.31.36.0-255,66,187048,8,223498
34436,0.002014,172.31.36.0-255,66,187114,8,223498
34437,0.002022,74.125.24.0-255,7156,194270,8,223498
34438,0.002025,172.31.36.0-255,66,194336,8,223498
34439,0.002029,74.125.24.0-255,4320,198656,8,223498
34440,0.002032,172.31.36.0-255,66,198722,8,223498
34441,0.002066,74.125.24.0-255,7156,205878,8,223498
34442,0.00207,172.31.36.0-255,66,205944,8,223498
34443,0.004004,74.125.24.0-255,5738,211682,8,223498
34444,0.004011,172.31.36.0-255,66,211748,8,223498
34445,0.005948,74.125.24.0-255,3477,215225,8,223498
34446,0.005953,172.31.36.0-255,66,215291,8,223498
34447,0.006117,172.31.36.0-255,105,215396,8,223498
34448,0.00805,74.125.24.0-255,66,215462,8,223498
34449,0.036389,172.31.36.0-255,188,215650,8,223498
34450,0.036435,172.31.36.0-255,955,216605,8,223498
34451,0.03653,172.31.36.0-255,1514,218119,8,223498
34452,0.036533,172.31.36.0-255,1514,219633,8,223498
34453,0.036534,172.31.36.0-255,1514,221147,8,223498
34454,0.036536,172.31.36.0-255,1514,222661,8,223498
34455,0.036566,172.31.36.0-255,573,223234,8,223498
34456,0.03794,104.244.42.0-255,66,223300,8,223498
34457,0.03795,104.244.42.0-255,66,223366,8,223498
34458,0.038114,104.244.42.0-255,66,223432,8,223498
34459,0.038119,104.244.42.0-255,66,223498,8,223498
34460,0.0,74.125.130.0-255,150,150,8,334251
34461,2.2e-05,172.31.36.0-255,66,216,8,334251
34462,3e-05,74.125.130.0-255,1484,1700,8,334251
34463,3.5e-05,172.31.36.0-255,66,1766,8,334251
34464,3.9e-05,74.125.130.0-255,1484,3250,8,334251
34465,4.2e-05,172.31.36.0-255,66,3316,8,334251
34466,4.8e-05,74.125.130.0-255,2902,6218,8,334251
34467,5.1e-05,172.31.36.0-255,66,6284,8,334251
34468,5.9e-05,74.125.130.0-255,5738,12022,8,334251
34469,6.2e-05,172.31.36.0-255,66,12088,8,334251
34470,6.6e-05,74.125.130.0-255,1484,13572,8,334251
34471,6.9e-05,172.31.36.0-255,66,13638,8,334251
34472,9.3e-05,74.125.130.0-255,643,14281,8,334251
34473,9.6e-05,172.31.36.0-255,66,14347,8,334251
34474,0.000279,74.125.130.0-255,1484,15831,8,334251
34475,0.000284,172.31.36.0-255,66,15897,8,334251
34476,0.00029,74.125.130.0-255,2902,18799,8,334251
34477,0.000293,172.31.36.0-255,66,18865,8,334251
34478,0.000324,74.125.130.0-255,5738,24603,8,334251
34479,0.000327,172.31.36.0-255,66,24669,8,334251
34480,0.000333,74.125.130.0-255,4320,28989,8,334251
34481,0.000335,172.31.36.0-255,66,29055,8,334251
34482,0.000371,74.125.130.0-255,2543,31598,8,334251
34483,0.000374,172.31.36.0-255,66,31664,8,334251
34484,0.000482,74.125.130.0-255,1484,33148,8,334251
34485,0.000486,172.31.36.0-255,66,33214,8,334251
34486,0.000492,74.125.130.0-255,2902,36116,8,334251
34487,0.000495,172.31.36.0-255,66,36182,8,334251
34488,0.000522,74.125.130.0-255,5738,41920,8,334251
34489,0.000525,172.31.36.0-255,66,41986,8,334251
34490,0.000531,74.125.130.0-255,4320,46306,8,334251
34491,0.000533,172.31.36.0-255,66,46372,8,334251
34492,0.000555,74.125.130.0-255,5379,51751,8,334251
34493,0.000558,172.31.36.0-255,66,51817,8,334251
34494,0.000574,74.125.130.0-255,2902,54719,8,334251
34495,0.000577,172.31.36.0-255,66,54785,8,334251
34496,0.000604,74.125.130.0-255,7156,61941,8,334251
34497,0.000607,172.31.36.0-255,66,62007,8,334251
34498,0.00063,74.125.130.0-255,4214,66221,8,334251
34499,0.000634,172.31.36.0-255,66,66287,8,334251
34500,0.000643,74.125.130.0-255,119,66406,8,334251
34501,0.000751,74.125.130.0-255,1484,67890,8,334251
34502,0.000755,172.31.36.0-255,66,67956,8,334251
34503,0.000776,74.125.130.0-255,2902,70858,8,334251
34504,0.000779,172.31.36.0-255,66,70924,8,334251
34505,0.000782,74.125.130.0-255,1484,72408,8,334251
34506,0.000796,74.125.130.0-255,2902,75310,8,334251
34507,0.000798,172.31.36.0-255,66,75376,8,334251
34508,0.000824,74.125.130.0-255,2902,78278,8,334251
34509,0.000828,172.31.36.0-255,66,78344,8,334251
34510,0.000841,74.125.130.0-255,6797,85141,8,334251
34511,0.000844,172.31.36.0-255,66,85207,8,334251
34512,0.000848,74.125.130.0-255,2902,88109,8,334251
34513,0.00085,172.31.36.0-255,66,88175,8,334251
34514,0.000901,172.31.36.0-255,66,88241,8,334251
34515,0.000918,74.125.130.0-255,2543,90784,8,334251
34516,0.000921,172.31.36.0-255,66,90850,8,334251
34517,0.001375,74.125.130.0-255,1484,92334,8,334251
34518,0.00138,74.125.130.0-255,2902,95236,8,334251
34519,0.001386,172.31.36.0-255,66,95302,8,334251
34520,0.001406,74.125.130.0-255,4320,99622,8,334251
34521,0.001409,172.31.36.0-255,66,99688,8,334251
34522,0.001426,74.125.130.0-255,4320,104008,8,334251
34523,0.001429,172.31.36.0-255,66,104074,8,334251
34524,0.001454,74.125.130.0-255,4320,108394,8,334251
34525,0.001457,172.31.36.0-255,66,108460,8,334251
34526,0.001463,74.125.130.0-255,4320,112780,8,334251
34527,0.001465,172.31.36.0-255,66,112846,8,334251
34528,0.001472,74.125.130.0-255,5738,118584,8,334251
34529,0.001475,172.31.36.0-255,66,118650,8,334251
34530,0.001498,74.125.130.0-255,6438,125088,8,334251
34531,0.001501,172.31.36.0-255,66,125154,8,334251
34532,0.001999,74.125.130.0-255,1484,126638,8,334251
34533,0.00201,74.125.130.0-255,2902,129540,8,334251
34534,0.002014,172.31.36.0-255,66,129606,8,334251
34535,0.002039,74.125.130.0-255,5738,135344,8,334251
34536,0.002041,172.31.36.0-255,66,135410,8,334251
34537,0.002045,74.125.130.0-255,1484,136894,8,334251
34538,0.002071,74.125.130.0-255,5738,142632,8,334251
34539,0.002074,172.31.36.0-255,66,142698,8,334251
34540,0.002106,74.125.130.0-255,4320,147018,8,334251
34541,0.002108,172.31.36.0-255,66,147084,8,334251
34542,0.002134,74.125.130.0-255,4320,151404,8,334251
34543,0.002137,172.31.36.0-255,66,151470,8,334251
34544,0.002142,74.125.130.0-255,4320,155790,8,334251
34545,0.002144,172.31.36.0-255,66,155856,8,334251
34546,0.002148,74.125.130.0-255,1484,157340,8,334251
34547,0.002162,74.125.130.0-255,2184,159524,8,334251
34548,0.002164,172.31.36.0-255,66,159590,8,334251
34549,0.004457,74.125.130.0-255,2902,162492,8,334251
34550,0.004464,172.31.36.0-255,66,162558,8,334251
34551,0.004483,74.125.130.0-255,2902,165460,8,334251
34552,0.004486,172.31.36.0-255,66,165526,8,334251
34553,0.006774,74.125.130.0-255,2902,168428,8,334251
34554,0.006777,172.31.36.0-255,66,168494,8,334251
34555,0.006799,74.125.130.0-255,2902,171396,8,334251
34556,0.006802,172.31.36.0-255,66,171462,8,334251
34557,0.009104,74.125.130.0-255,4320,175782,8,334251
34558,0.009111,172.31.36.0-255,66,175848,8,334251
34559,0.009131,74.125.130.0-255,1484,177332,8,334251
34560,0.011547,74.125.130.0-255,4320,181652,8,334251
34561,0.011556,172.31.36.0-255,66,181718,8,334251
34562,0.013885,74.125.130.0-255,5738,187456,8,334251
34563,0.013894,172.31.36.0-255,66,187522,8,334251
34564,0.01622,74.125.130.0-255,5738,193260,8,334251
34565,0.016229,172.31.36.0-255,66,193326,8,334251
34566,0.018551,74.125.130.0-255,5738,199064,8,334251
34567,0.018559,172.31.36.0-255,66,199130,8,334251
34568,0.020895,74.125.130.0-255,5738,204868,8,334251
34569,0.020903,172.31.36.0-255,66,204934,8,334251
34570,0.023243,74.125.130.0-255,5738,210672,8,334251
34571,0.023251,172.31.36.0-255,66,210738,8,334251
34572,0.025574,74.125.130.0-255,5738,216476,8,334251
34573,0.025582,172.31.36.0-255,66,216542,8,334251
34574,0.027915,74.125.130.0-255,5738,222280,8,334251
34575,0.027924,172.31.36.0-255,66,222346,8,334251
34576,0.030243,74.125.130.0-255,5738,228084,8,334251
34577,0.03025,172.31.36.0-255,66,228150,8,334251
34578,0.032581,74.125.130.0-255,5738,233888,8,334251
34579,0.032589,172.31.36.0-255,66,233954,8,334251
34580,0.034938,74.125.130.0-255,5738,239692,8,334251
34581,0.034955,172.31.36.0-255,66,239758,8,334251
34582,0.037283,74.125.130.0-255,5738,245496,8,334251
34583,0.037292,172.31.36.0-255,66,245562,8,334251
34584,0.038199,172.31.36.0-255,190,245752,8,334251
34585,0.038229,172.31.36.0-255,1110,246862,8,334251
34586,0.038306,172.31.36.0-255,1514,248376,8,334251
34587,0.038308,172.31.36.0-255,1514,249890,8,334251
34588,0.038314,172.31.36.0-255,1514,251404,8,334251
34589,0.038315,172.31.36.0-255,1514,252918,8,334251
34590,0.038333,172.31.36.0-255,1231,254149,8,334251
34591,0.039631,74.125.130.0-255,5738,259887,8,334251
34592,0.039639,172.31.36.0-255,66,259953,8,334251
34593,0.039739,104.244.42.0-255,66,260019,8,334251
34594,0.0398,104.244.42.0-255,66,260085,8,334251
34595,0.039904,104.244.42.0-255,66,260151,8,334251
34596,0.039909,104.244.42.0-255,66,260217,8,334251
34597,0.04197,74.125.130.0-255,5738,265955,8,334251
34598,0.041977,172.31.36.0-255,66,266021,8,334251
34599,0.044308,74.125.130.0-255,5738,271759,8,334251
34600,0.044314,172.31.36.0-255,66,271825,8,334251
34601,0.046668,74.125.130.0-255,5738,277563,8,334251
34602,0.046675,172.31.36.0-255,66,277629,8,334251
34603,0.048987,74.125.130.0-255,4320,281949,8,334251
34604,0.049009,172.31.36.0-255,66,282015,8,334251
34605,0.04902,74.125.130.0-255,1484,283499,8,334251
34606,0.051365,74.125.130.0-255,4320,287819,8,334251
34607,0.051371,172.31.36.0-255,66,287885,8,334251
34608,0.053681,74.125.130.0-255,5738,293623,8,334251
34609,0.053686,172.31.36.0-255,66,293689,8,334251
34610,0.055997,74.125.130.0-255,5738,299427,8,334251
34611,0.056005,172.31.36.0-255,66,299493,8,334251
34612,0.05834,74.125.130.0-255,5738,305231,8,334251
34613,0.058345,172.31.36.0-255,66,305297,8,334251
34614,0.060669,74.125.130.0-255,5738,311035,8,334251
34615,0.060675,172.31.36.0-255,66,311101,8,334251
34616,0.062992,74.125.130.0-255,5738,316839,8,334251
34617,0.062996,172.31.36.0-255,66,316905,8,334251
34618,0.065325,74.125.130.0-255,5738,322643,8,334251
34619,0.065331,172.31.36.0-255,66,322709,8,334251
34620,0.067667,74.125.130.0-255,5738,328447,8,334251
34621,0.067673,172.31.36.0-255,66,328513,8,334251
34622,0.069995,74.125.130.0-255,5738,334251,8,334251
34623,0.0,74.125.24.0-255,152,152,8,190618
34624,3e-05,172.31.36.0-255,66,218,8,190618
34625,3.7e-05,74.125.24.0-255,1484,1702,8,190618
34626,4.1e-05,172.31.36.0-255,66,1768,8,190618
34627,5.4e-05,74.125.24.0-255,2902,4670,8,190618
34628,5.8e-05,172.31.36.0-255,66,4736,8,190618
34629,8.2e-05,74.125.24.0-255,1484,6220,8,190618
34630,8.7e-05,172.31.36.0-255,66,6286,8,190618
34631,0.000105,74.125.24.0-255,5738,12024,8,190618
34632,0.000108,172.31.36.0-255,66,12090,8,190618
34633,0.000195,74.125.24.0-255,2902,14992,8,190618
34634,0.0002,172.31.36.0-255,66,15058,8,190618
34635,0.000234,172.31.36.0-255,66,15124,8,190618
34636,0.000359,74.125.24.0-255,4320,19444,8,190618
34637,0.000364,172.31.36.0-255,66,19510,8,190618
34638,0.00039,74.125.24.0-255,3961,23471,8,190618
34639,0.000394,172.31.36.0-255,66,23537,8,190618
34640,0.000454,74.125.24.0-255,2902,26439,8,190618
34641,0.000458,172.31.36.0-255,66,26505,8,190618
34642,0.000505,172.31.36.0-255,66,26571,8,190618
34643,0.000781,172.31.36.0-255,66,26637,8,190618
34644,0.003299,74.125.24.0-255,2902,29539,8,190618
34645,0.003305,172.31.36.0-255,66,29605,8,190618
34646,0.003313,74.125.24.0-255,2902,32507,8,190618
34647,0.003315,172.31.36.0-255,66,32573,8,190618
34648,0.005854,74.125.24.0-255,5738,38311,8,190618
34649,0.005861,172.31.36.0-255,66,38377,8,190618
34650,0.008379,74.125.24.0-255,5738,44115,8,190618
34651,0.008387,172.31.36.0-255,66,44181,8,190618
34652,0.010904,74.125.24.0-255,5738,49919,8,190618
34653,0.010911,172.31.36.0-255,66,49985,8,190618
34654,0.013453,74.125.24.0-255,2902,52887,8,190618
34655,0.013458,172.31.36.0-255,66,52953,8,190618
34656,0.013489,74.125.24.0-255,2902,55855,8,190618
34657,0.013493,172.31.36.0-255,66,55921,8,190618
34658,0.016001,74.125.24.0-255,2902,58823,8,190618
34659,0.016012,172.31.36.0-255,66,58889,8,190618
34660,0.016055,74.125.24.0-255,2902,61791,8,190618
34661,0.01606,172.31.36.0-255,66,61857,8,190618
34662,0.018544,74.125.24.0-255,2902,64759,8,190618
34663,0.018553,172.31.36.0-255,66,64825,8,190618
34664,0.018592,74.125.24.0-255,2902,67727,8,190618
34665,0.018598,172.31.36.0-255,66,67793,8,190618
34666,0.021071,74.125.24.0-255,2902,70695,8,190618
34667,0.021077,172.31.36.0-255,66,70761,8,190618
34668,0.021125,74.125.24.0-255,2902,73663,8,190618
34669,0.021129,172.31.36.0-255,66,73729,8,190618
34670,0.023608,74.125.24.0-255,2902,76631,8,190618
34671,0.023615,172.31.36.0-255,66,76697,8,190618
34672,0.023647,74.125.24.0-255,2902,79599,8,190618
34673,0.023651,172.31.36.0-255,66,79665,8,190618
34674,0.026181,74.125.24.0-255,2902,82567,8,190618
34675,0.026189,172.31.36.0-255,66,82633,8,190618
34676,0.026223,74.125.24.0-255,2902,85535,8,190618
34677,0.026227,172.31.36.0-255,66,85601,8,190618
34678,0.028735,74.125.24.0-255,2902,88503,8,190618
34679,0.028748,172.31.36.0-255,66,88569,8,190618
34680,0.028784,74.125.24.0-255,2902,91471,8,190618
34681,0.028789,172.31.36.0-255,66,91537,8,190618
34682,0.031332,74.125.24.0-255,2902,94439,8,190618
34683,0.031339,172.31.36.0-255,66,94505,8,190618
34684,0.031376,74.125.24.0-255,2902,97407,8,190618
34685,0.031381,172.31.36.0-255,66,97473,8,190618
34686,0.033902,74.125.24.0-255,2902,100375,8,190618
34687,0.03391,172.31.36.0-255,66,100441,8,190618
34688,0.033942,74.125.24.0-255,2902,103343,8,190618
34689,0.033946,172.31.36.0-255,66,103409,8,190618
34690,0.035973,172.31.36.0-255,188,103597,8,190618
34691,0.036003,172.31.36.0-255,955,104552,8,190618
34692,0.036048,172.31.36.0-255,1514,106066,8,190618
34693,0.03605,172.31.36.0-255,1184,107250,8,190618
34694,0.036458,74.125.24.0-255,2902,110152,8,190618
34695,0.036465,172.31.36.0-255,66,110218,8,190618
34696,0.036494,74.125.24.0-255,2902,113120,8,190618
34697,0.036499,172.31.36.0-255,66,113186,8,190618
34698,0.037562,104.244.42.0-255,66,113252,8,190618
34699,0.037571,104.244.42.0-255,66,113318,8,190618
34700,0.037601,104.244.42.0-255,66,113384,8,190618
34701,0.038981,74.125.24.0-255,2902,116286,8,190618
34702,0.038986,172.31.36.0-255,66,116352,8,190618
34703,0.039024,74.125.24.0-255,2902,119254,8,190618
34704,0.039027,172.31.36.0-255,66,119320,8,190618
34705,0.041534,74.125.24.0-255,2902,122222,8,190618
34706,0.041541,172.31.36.0-255,66,122288,8,190618
34707,0.041569,74.125.24.0-255,2902,125190,8,190618
34708,0.041574,172.31.36.0-255,66,125256,8,190618
34709,0.044057,74.125.24.0-255,2902,128158,8,190618
34710,0.044062,172.31.36.0-255,66,128224,8,190618
34711,0.04409,74.125.24.0-255,1484,129708,8,190618
34712,0.0441,74.125.24.0-255,1484,131192,8,190618
34713,0.044103,172.31.36.0-255,66,131258,8,190618
34714,0.046591,74.125.24.0-255,2902,134160,8,190618
34715,0.046597,172.31.36.0-255,66,134226,8,190618
34716,0.046653,74.125.24.0-255,2902,137128,8,190618
34717,0.046658,172.31.36.0-255,66,137194,8,190618
34718,0.049135,74.125.24.0-255,2902,140096,8,190618
34719,0.049141,172.31.36.0-255,66,140162,8,190618
34720,0.049188,74.125.24.0-255,2902,143064,8,190618
34721,0.049192,172.31.36.0-255,66,143130,8,190618
34722,0.051654,74.125.24.0-255,2902,146032,8,190618
34723,0.051659,172.31.36.0-255,66,146098,8,190618
34724,0.051711,74.125.24.0-255,2902,149000,8,190618
34725,0.051716,172.31.36.0-255,66,149066,8,190618
34726,0.054196,74.125.24.0-255,2902,151968,8,190618
34727,0.054202,172.31.36.0-255,66,152034,8,190618
34728,0.054234,74.125.24.0-255,2902,154936,8,190618
34729,0.054237,172.31.36.0-255,66,155002,8,190618
34730,0.056739,74.125.24.0-255,2902,157904,8,190618
34731,0.056744,172.31.36.0-255,66,157970,8,190618
34732,0.056778,74.125.24.0-255,2902,160872,8,190618
34733,0.056782,172.31.36.0-255,66,160938,8,190618
34734,0.059281,74.125.24.0-255,2902,163840,8,190618
34735,0.059287,172.31.36.0-255,66,163906,8,190618
34736,0.059319,74.125.24.0-255,2902,166808,8,190618
34737,0.059322,172.31.36.0-255,66,166874,8,190618
34738,0.061821,74.125.24.0-255,2902,169776,8,190618
34739,0.061826,172.31.36.0-255,66,169842,8,190618
34740,0.061863,74.125.24.0-255,2902,172744,8,190618
34741,0.061866,172.31.36.0-255,66,172810,8,190618
34742,0.064364,74.125.24.0-255,2902,175712,8,190618
34743,0.064369,172.31.36.0-255,66,175778,8,190618
34744,0.064403,74.125.24.0-255,2902,178680,8,190618
34745,0.064407,172.31.36.0-255,66,178746,8,190618
34746,0.066904,74.125.24.0-255,2902,181648,8,190618
34747,0.06691,172.31.36.0-255,66,181714,8,190618
34748,0.06693,74.125.24.0-255,2902,184616,8,190618
34749,0.066933,172.31.36.0-255,66,184682,8,190618
34750,0.069461,74.125.24.0-255,2902,187584,8,190618
34751,0.069468,172.31.36.0-255,66,187650,8,190618
34752,0.069506,74.125.24.0-255,2902,190552,8,190618
34753,0.069509,172.31.36.0-255,66,190618,8,190618
34754,0.0,74.125.24.0-255,153,153,8,211513
34755,1.7e-05,172.31.36.0-255,66,219,8,211513
34756,2.5e-05,74.125.24.0-255,1484,1703,8,211513
34757,3e-05,172.31.36.0-255,66,1769,8,211513
34758,3.5e-05,74.125.24.0-255,2902,4671,8,211513
34759,3.9e-05,172.31.36.0-255,66,4737,8,211513
34760,4.4e-05,74.125.24.0-255,2902,7639,8,211513
34761,4.6e-05,172.31.36.0-255,66,7705,8,211513
34762,7.6e-05,74.125.24.0-255,4320,12025,8,211513
34763,7.9e-05,172.31.36.0-255,66,12091,8,211513
34764,8.3e-05,74.125.24.0-255,2024,14115,8,211513
34765,8.6e-05,172.31.36.0-255,66,14181,8,211513
34766,0.000106,74.125.24.0-255,5738,19919,8,211513
34767,0.000108,172.31.36.0-255,66,19985,8,211513
34768,0.00013,74.125.24.0-255,5738,25723,8,211513
34769,0.000133,172.31.36.0-255,66,25789,8,211513
34770,0.00014,74.125.24.0-255,7156,32945,8,211513
34771,0.000142,172.31.36.0-255,66,33011,8,211513
34772,0.000164,74.125.24.0-255,1484,34495,8,211513
34773,0.000166,172.31.36.0-255,66,34561,8,211513
34774,0.0002,172.31.36.0-255,66,34627,8,211513
34775,0.000676,74.125.24.0-255,1484,36111,8,211513
34776,0.000682,172.31.36.0-255,66,36177,8,211513
34777,0.000688,74.125.24.0-255,2902,39079,8,211513
34778,0.00069,172.31.36.0-255,66,39145,8,211513
34779,0.000697,74.125.24.0-255,5738,44883,8,211513
34780,0.000699,172.31.36.0-255,66,44949,8,211513
34781,0.000734,172.31.36.0-255,66,45015,8,211513
34782,0.000744,172.31.36.0-255,66,45081,8,211513
34783,0.000811,172.31.36.0-255,66,45147,8,211513
34784,0.000822,172.31.36.0-255,66,45213,8,211513
34785,0.000849,172.31.36.0-255,66,45279,8,211513
34786,0.001165,74.125.24.0-255,1484,46763,8,211513
34787,0.001183,74.125.24.0-255,2902,49665,8,211513
34788,0.001188,172.31.36.0-255,66,49731,8,211513
34789,0.001205,74.125.24.0-255,4320,54051,8,211513
34790,0.001208,172.31.36.0-255,66,54117,8,211513
34791,0.001234,74.125.24.0-255,1484,55601,8,211513
34792,0.001245,172.31.36.0-255,66,55667,8,211513
34793,0.00125,74.125.24.0-255,4320,59987,8,211513
34794,0.001252,172.31.36.0-255,66,60053,8,211513
34795,0.001282,74.125.24.0-255,7156,67209,8,211513
34796,0.001286,172.31.36.0-255,66,67275,8,211513
34797,0.001292,74.125.24.0-255,3050,70325,8,211513
34798,0.001294,172.31.36.0-255,66,70391,8,211513
34799,0.001301,74.125.24.0-255,4320,74711,8,211513
34800,0.001303,172.31.36.0-255,66,74777,8,211513
34801,0.001307,74.125.24.0-255,1484,76261,8,211513
34802,0.001341,172.31.36.0-255,66,76327,8,211513
34803,0.001347,74.125.24.0-255,4320,80647,8,211513
34804,0.001349,172.31.36.0-255,66,80713,8,211513
34805,0.001407,172.31.36.0-255,66,80779,8,211513
34806,0.001584,74.125.24.0-255,1484,82263,8,211513
34807,0.001598,74.125.24.0-255,2902,85165,8,211513
34808,0.001602,172.31.36.0-255,66,85231,8,211513
34809,0.001624,74.125.24.0-255,5738,90969,8,211513
34810,0.001627,172.31.36.0-255,66,91035,8,211513
34811,0.001632,74.125.24.0-255,4320,95355,8,211513
34812,0.001634,172.31.36.0-255,66,95421,8,211513
34813,0.001667,172.31.36.0-255,66,95487,8,211513
34814,0.001683,74.125.24.0-255,2902,98389,8,211513
34815,0.001685,172.31.36.0-255,66,98455,8,211513
34816,0.001696,172.31.36.0-255,66,98521,8,211513
34817,0.001876,74.125.24.0-255,1484,100005,8,211513
34818,0.001883,74.125.24.0-255,2902,102907,8,211513
34819,0.001888,172.31.36.0-255,66,102973,8,211513
34820,0.001896,74.125.24.0-255,5738,108711,8,211513
34821,0.001899,172.31.36.0-255,66,108777,8,211513
34822,0.001922,74.125.24.0-255,4320,113097,8,211513
34823,0.001924,172.31.36.0-255,66,113163,8,211513
34824,0.001952,172.31.36.0-255,66,113229,8,211513
34825,0.001957,74.125.24.0-255,4320,117549,8,211513
34826,0.00196,172.31.36.0-255,66,117615,8,211513
34827,0.001987,74.125.24.0-255,4320,121935,8,211513
34828,0.00199,172.31.36.0-255,66,122001,8,211513
34829,0.00202,172.31.36.0-255,66,122067,8,211513
34830,0.002037,74.125.24.0-255,2184,124251,8,211513
34831,0.002039,172.31.36.0-255,66,124317,8,211513
34832,0.00209,172.31.36.0-255,66,124383,8,211513
34833,0.002116,172.31.36.0-255,66,124449,8,211513
34834,0.002118,74.125.24.0-255,766,125215,8,211513
34835,0.002121,74.125.24.0-255,1484,126699,8,211513
34836,0.002124,172.31.36.0-255,66,126765,8,211513
34837,0.002128,74.125.24.0-255,2902,129667,8,211513
34838,0.002131,172.31.36.0-255,66,129733,8,211513
34839,0.002136,74.125.24.0-255,5738,135471,8,211513
34840,0.002139,172.31.36.0-255,66,135537,8,211513
34841,0.002142,74.125.24.0-255,1484,137021,8,211513
34842,0.002186,172.31.36.0-255,66,137087,8,211513
34843,0.002193,74.125.24.0-255,7156,144243,8,211513
34844,0.002195,172.31.36.0-255,66,144309,8,211513
34845,0.002201,74.125.24.0-255,3602,147911,8,211513
34846,0.002203,172.31.36.0-255,66,147977,8,211513
34847,0.002231,74.125.24.0-255,4320,152297,8,211513
34848,0.002234,172.31.36.0-255,66,152363,8,211513
34849,0.002239,74.125.24.0-255,2902,155265,8,211513
34850,0.002241,172.31.36.0-255,66,155331,8,211513
34851,0.002258,74.125.24.0-255,4320,159651,8,211513
34852,0.002261,172.31.36.0-255,66,159717,8,211513
34853,0.002272,172.31.36.0-255,66,159783,8,211513
34854,0.002293,74.125.24.0-255,2902,162685,8,211513
34855,0.002295,172.31.36.0-255,66,162751,8,211513
34856,0.002327,172.31.36.0-255,66,162817,8,211513
34857,0.002333,74.125.24.0-255,5738,168555,8,211513
34858,0.002335,172.31.36.0-255,66,168621,8,211513
34859,0.002374,172.31.36.0-255,66,168687,8,211513
34860,0.002387,172.31.36.0-255,66,168753,8,211513
34861,0.002393,74.125.24.0-255,5738,174491,8,211513
34862,0.002395,172.31.36.0-255,66,174557,8,211513
34863,0.002419,74.125.24.0-255,7156,181713,8,211513
34864,0.002422,172.31.36.0-255,66,181779,8,211513
34865,0.00476,74.125.24.0-255,5738,187517,8,211513
34866,0.004766,172.31.36.0-255,66,187583,8,211513
34867,0.007112,74.125.24.0-255,5738,193321,8,211513
34868,0.007126,172.31.36.0-255,66,193387,8,211513
34869,0.009472,74.125.24.0-255,5738,199125,8,211513
34870,0.00948,172.31.36.0-255,66,199191,8,211513
34871,0.011849,74.125.24.0-255,5738,204929,8,211513
34872,0.011858,172.31.36.0-255,66,204995,8,211513
34873,0.014203,74.125.24.0-255,3291,208286,8,211513
34874,0.014212,172.31.36.0-255,66,208352,8,211513
34875,0.017427,172.31.36.0-255,105,208457,8,211513
34876,0.019743,74.125.24.0-255,66,208523,8,211513
34877,0.030003,172.31.36.0-255,188,208711,8,211513
34878,0.03004,172.31.36.0-255,955,209666,8,211513
34879,0.030109,172.31.36.0-255,1514,211180,8,211513
34880,0.030111,172.31.36.0-255,135,211315,8,211513
34881,0.031579,104.244.42.0-255,66,211381,8,211513
34882,0.03161,104.244.42.0-255,66,211447,8,211513
34883,0.031651,104.244.42.0-255,66,211513,8,211513
34884,0.0,74.125.24.0-255,152,152,8,241264
34885,2.3e-05,172.31.36.0-255,66,218,8,241264
34886,3e-05,74.125.24.0-255,1484,1702,8,241264
34887,3.4e-05,172.31.36.0-255,66,1768,8,241264
34888,3.8e-05,74.125.24.0-255,1484,3252,8,241264
34889,4e-05,172.31.36.0-255,66,3318,8,241264
34890,6e-05,74.125.24.0-255,1484,4802,8,241264
34891,6.3e-05,172.31.36.0-255,66,4868,8,241264
34892,8.1e-05,74.125.24.0-255,4320,9188,8,241264
34893,8.4e-05,172.31.36.0-255,66,9254,8,241264
34894,9.1e-05,74.125.24.0-255,4840,14094,8,241264
34895,9.3e-05,172.31.36.0-255,66,14160,8,241264
34896,0.00055,74.125.24.0-255,1484,15644,8,241264
34897,0.000557,172.31.36.0-255,66,15710,8,241264
34898,0.000563,74.125.24.0-255,2902,18612,8,241264
34899,0.000565,172.31.36.0-255,66,18678,8,241264
34900,0.000572,74.125.24.0-255,5738,24416,8,241264
34901,0.000574,172.31.36.0-255,66,24482,8,241264
34902,0.000598,74.125.24.0-255,1484,25966,8,241264
34903,0.0006,172.31.36.0-255,66,26032,8,241264
34904,0.000627,74.125.24.0-255,5379,31411,8,241264
34905,0.00063,172.31.36.0-255,66,31477,8,241264
34906,0.000939,74.125.24.0-255,1484,32961,8,241264
34907,0.000945,172.31.36.0-255,66,33027,8,241264
34908,0.000954,74.125.24.0-255,2902,35929,8,241264
34909,0.000956,172.31.36.0-255,66,35995,8,241264
34910,0.000961,74.125.24.0-255,2902,38897,8,241264
34911,0.000963,172.31.36.0-255,66,38963,8,241264
34912,0.000967,74.125.24.0-255,1484,40447,8,241264
34913,0.000968,172.31.36.0-255,66,40513,8,241264
34914,0.000993,74.125.24.0-255,5738,46251,8,241264
34915,0.000995,172.31.36.0-255,66,46317,8,241264
34916,0.000999,74.125.24.0-255,1484,47801,8,241264
34917,0.001037,172.31.36.0-255,66,47867,8,241264
34918,0.001079,74.125.24.0-255,5379,53246,8,241264
34919,0.001083,172.31.36.0-255,66,53312,8,241264
34920,0.001951,74.125.24.0-255,648,53960,8,241264
34921,0.003183,74.125.24.0-255,4320,58280,8,241264
34922,0.003189,172.31.36.0-255,66,58346,8,241264
34923,0.005311,74.125.24.0-255,5738,64084,8,241264
34924,0.005318,172.31.36.0-255,66,64150,8,241264
34925,0.007447,74.125.24.0-255,5738,69888,8,241264
34926,0.007457,172.31.36.0-255,66,69954,8,241264
34927,0.00958,74.125.24.0-255,5738,75692,8,241264
34928,0.009597,172.31.36.0-255,66,75758,8,241264
34929,0.011736,74.125.24.0-255,5738,81496,8,241264
34930,0.011751,172.31.36.0-255,66,81562,8,241264
34931,0.013889,74.125.24.0-255,5738,87300,8,241264
34932,0.013903,172.31.36.0-255,66,87366,8,241264
34933,0.016045,74.125.24.0-255,5738,93104,8,241264
34934,0.016065,172.31.36.0-255,66,93170,8,241264
34935,0.018201,74.125.24.0-255,5738,98908,8,241264
34936,0.018216,172.31.36.0-255,66,98974,8,241264
34937,0.020349,74.125.24.0-255,5738,104712,8,241264
34938,0.020362,172.31.36.0-255,66,104778,8,241264
34939,0.022493,74.125.24.0-255,5738,110516,8,241264
34940,0.022507,172.31.36.0-255,66,110582,8,241264
34941,0.024626,74.125.24.0-255,5738,116320,8,241264
34942,0.024638,172.31.36.0-255,66,116386,8,241264
34943,0.026773,74.125.24.0-255,5738,122124,8,241264
34944,0.026788,172.31.36.0-255,66,122190,8,241264
34945,0.028923,74.125.24.0-255,5738,127928,8,241264
34946,0.028935,172.31.36.0-255,66,127994,8,241264
34947,0.030965,172.31.36.0-255,192,128186,8,241264
34948,0.031001,172.31.36.0-255,955,129141,8,241264
34949,0.031044,74.125.24.0-255,5738,134879,8,241264
34950,0.03105,172.31.36.0-255,66,134945,8,241264
34951,0.031154,172.31.36.0-255,1514,136459,8,241264
34952,0.031156,172.31.36.0-255,135,136594,8,241264
34953,0.032551,104.244.42.0-255,66,136660,8,241264
34954,0.03259,104.244.42.0-255,66,136726,8,241264
34955,0.032762,104.244.42.0-255,66,136792,8,241264
34956,0.033206,74.125.24.0-255,5738,142530,8,241264
34957,0.033211,172.31.36.0-255,66,142596,8,241264
34958,0.03538,74.125.24.0-255,5738,148334,8,241264
34959,0.035386,172.31.36.0-255,66,148400,8,241264
34960,0.03751,74.125.24.0-255,5738,154138,8,241264
34961,0.037519,172.31.36.0-255,66,154204,8,241264
34962,0.039681,74.125.24.0-255,5738,159942,8,241264
34963,0.039695,172.31.36.0-255,66,160008,8,241264
34964,0.041827,74.125.24.0-255,5738,165746,8,241264
34965,0.041837,172.31.36.0-255,66,165812,8,241264
34966,0.043962,74.125.24.0-255,5738,171550,8,241264
34967,0.043972,172.31.36.0-255,66,171616,8,241264
34968,0.046103,74.125.24.0-255,5738,177354,8,241264
34969,0.046115,172.31.36.0-255,66,177420,8,241264
34970,0.048274,74.125.24.0-255,5738,183158,8,241264
34971,0.048291,172.31.36.0-255,66,183224,8,241264
34972,0.05043,74.125.24.0-255,5738,188962,8,241264
34973,0.05044,172.31.36.0-255,66,189028,8,241264
34974,0.052552,74.125.24.0-255,5738,194766,8,241264
34975,0.052561,172.31.36.0-255,66,194832,8,241264
34976,0.054706,74.125.24.0-255,5738,200570,8,241264
34977,0.054719,172.31.36.0-255,66,200636,8,241264
34978,0.056843,74.125.24.0-255,5738,206374,8,241264
34979,0.056853,172.31.36.0-255,66,206440,8,241264
34980,0.058989,74.125.24.0-255,5738,212178,8,241264
34981,0.059002,172.31.36.0-255,66,212244,8,241264
34982,0.061124,74.125.24.0-255,5738,217982,8,241264
34983,0.061137,172.31.36.0-255,66,218048,8,241264
34984,0.063257,74.125.24.0-255,5738,223786,8,241264
34985,0.063268,172.31.36.0-255,66,223852,8,241264
34986,0.065433,74.125.24.0-255,5738,229590,8,241264
34987,0.065444,172.31.36.0-255,66,229656,8,241264
34988,0.067569,74.125.24.0-255,5738,235394,8,241264
34989,0.06758,172.31.36.0-255,66,235460,8,241264
34990,0.069732,74.125.24.0-255,5738,241198,8,241264
34991,0.069748,172.31.36.0-255,66,241264,8,241264
34992,0.0,172.217.27.0-255,150,150,8,324821
34993,2.6e-05,172.31.36.0-255,66,216,8,324821
34994,3.3e-05,172.217.27.0-255,1484,1700,8,324821
34995,3.9e-05,172.31.36.0-255,66,1766,8,324821
34996,5.3e-05,172.217.27.0-255,2902,4668,8,324821
34997,5.7e-05,172.31.36.0-255,66,4734,8,324821
34998,6.6e-05,172.217.27.0-255,7156,11890,8,324821
34999,6.9e-05,172.31.36.0-255,66,11956,8,324821
35000,7.4e-05,172.217.27.0-255,2065,14021,8,324821
35001,7.7e-05,172.31.36.0-255,66,14087,8,324821
35002,0.000133,172.217.27.0-255,1484,15571,8,324821
35003,0.000136,172.31.36.0-255,66,15637,8,324821
35004,0.000169,172.217.27.0-255,2902,18539,8,324821
35005,0.000172,172.31.36.0-255,66,18605,8,324821
35006,0.000178,172.217.27.0-255,5738,24343,8,324821
35007,0.000181,172.31.36.0-255,66,24409,8,324821
35008,0.000212,172.217.27.0-255,6797,31206,8,324821
35009,0.000214,172.31.36.0-255,66,31272,8,324821
35010,0.000255,172.217.27.0-255,1484,32756,8,324821
35011,0.000258,172.31.36.0-255,66,32822,8,324821
35012,0.000263,172.217.27.0-255,2902,35724,8,324821
35013,0.000265,172.31.36.0-255,66,35790,8,324821
35014,0.00027,172.217.27.0-255,2902,38692,8,324821
35015,0.000272,172.31.36.0-255,66,38758,8,324821
35016,0.000293,172.217.27.0-255,2902,41660,8,324821
35017,0.000295,172.31.36.0-255,66,41726,8,324821
35018,0.000299,172.217.27.0-255,1484,43210,8,324821
35019,0.000301,172.31.36.0-255,66,43276,8,324821
35020,0.000335,172.217.27.0-255,5379,48655,8,324821
35021,0.000339,172.31.36.0-255,66,48721,8,324821
35022,0.000412,172.217.27.0-255,1484,50205,8,324821
35023,0.000415,172.31.36.0-255,66,50271,8,324821
35024,0.00042,172.217.27.0-255,2902,53173,8,324821
35025,0.000423,172.31.36.0-255,66,53239,8,324821
35026,0.000426,172.217.27.0-255,1484,54723,8,324821
35027,0.000449,172.217.27.0-255,4320,59043,8,324821
35028,0.000455,172.31.36.0-255,66,59109,8,324821
35029,0.000462,172.217.27.0-255,6797,65906,8,324821
35030,0.000464,172.31.36.0-255,66,65972,8,324821
35031,0.000488,172.217.27.0-255,394,66366,8,324821
35032,0.000763,172.217.27.0-255,118,66484,8,324821
35033,0.000903,172.217.27.0-255,1484,67968,8,324821
35034,0.000908,172.31.36.0-255,66,68034,8,324821
35035,0.000914,172.217.27.0-255,2902,70936,8,324821
35036,0.000917,172.31.36.0-255,66,71002,8,324821
35037,0.000923,172.217.27.0-255,4320,75322,8,324821
35038,0.000925,172.31.36.0-255,66,75388,8,324821
35039,0.00096,172.217.27.0-255,1484,76872,8,324821
35040,0.000976,172.31.36.0-255,66,76938,8,324821
35041,0.001007,172.217.27.0-255,5738,82676,8,324821
35042,0.00101,172.31.36.0-255,66,82742,8,324821
35043,0.00104,172.217.27.0-255,3961,86703,8,324821
35044,0.001043,172.31.36.0-255,66,86769,8,324821
35045,0.00116,172.217.27.0-255,329,87098,8,324821
35046,0.00157,172.31.36.0-255,66,87164,8,324821
35047,0.002677,172.217.27.0-255,4320,91484,8,324821
35048,0.002687,172.31.36.0-255,66,91550,8,324821
35049,0.003199,172.217.27.0-255,1484,93034,8,324821
35050,0.004321,172.217.27.0-255,4320,97354,8,324821
35051,0.004325,172.31.36.0-255,66,97420,8,324821
35052,0.005955,172.217.27.0-255,4320,101740,8,324821
35053,0.005959,172.31.36.0-255,66,101806,8,324821
35054,0.005983,172.217.27.0-255,1484,103290,8,324821
35055,0.007605,172.217.27.0-255,4320,107610,8,324821
35056,0.007612,172.31.36.0-255,66,107676,8,324821
35057,0.009255,172.217.27.0-255,5738,113414,8,324821
35058,0.009265,172.31.36.0-255,66,113480,8,324821
35059,0.010915,172.217.27.0-255,5738,119218,8,324821
35060,0.010929,172.31.36.0-255,66,119284,8,324821
35061,0.012587,172.217.27.0-255,5738,125022,8,324821
35062,0.0126,172.31.36.0-255,66,125088,8,324821
35063,0.014252,172.217.27.0-255,5738,130826,8,324821
35064,0.014266,172.31.36.0-255,66,130892,8,324821
35065,0.015912,172.217.27.0-255,5738,136630,8,324821
35066,0.015925,172.31.36.0-255,66,136696,8,324821
35067,0.017569,172.217.27.0-255,5738,142434,8,324821
35068,0.017578,172.31.36.0-255,66,142500,8,324821
35069,0.019225,172.217.27.0-255,5738,148238,8,324821
35070,0.019237,172.31.36.0-255,66,148304,8,324821
35071,0.02088,172.217.27.0-255,5738,154042,8,324821
35072,0.020891,172.31.36.0-255,66,154108,8,324821
35073,0.022539,172.217.27.0-255,5738,159846,8,324821
35074,0.022549,172.31.36.0-255,66,159912,8,324821
35075,0.024201,172.217.27.0-255,5738,165650,8,324821
35076,0.024212,172.31.36.0-255,66,165716,8,324821
35077,0.025869,172.217.27.0-255,5738,171454,8,324821
35078,0.025885,172.31.36.0-255,66,171520,8,324821
35079,0.02756,172.217.27.0-255,5738,177258,8,324821
35080,0.027572,172.31.36.0-255,66,177324,8,324821
35081,0.029255,172.217.27.0-255,5738,183062,8,324821
35082,0.029265,172.31.36.0-255,66,183128,8,324821
35083,0.030712,172.31.36.0-255,172,183300,8,324821
35084,0.030747,172.31.36.0-255,1111,184411,8,324821
35085,0.030806,172.31.36.0-255,1514,185925,8,324821
35086,0.030808,172.31.36.0-255,754,186679,8,324821
35087,0.030902,172.217.27.0-255,5738,192417,8,324821
35088,0.030908,172.31.36.0-255,66,192483,8,324821
35089,0.032273,104.244.42.0-255,66,192549,8,324821
35090,0.032309,104.244.42.0-255,66,192615,8,324821
35091,0.032361,104.244.42.0-255,66,192681,8,324821
35092,0.032539,172.217.27.0-255,4320,197001,8,324821
35093,0.032546,172.31.36.0-255,66,197067,8,324821
35094,0.032579,172.217.27.0-255,1484,198551,8,324821
35095,0.034191,172.217.27.0-255,4320,202871,8,324821
35096,0.034199,172.31.36.0-255,66,202937,8,324821
35097,0.035852,172.217.27.0-255,5738,208675,8,324821
35098,0.035862,172.31.36.0-255,66,208741,8,324821
35099,0.03751,172.217.27.0-255,5738,214479,8,324821
35100,0.03752,172.31.36.0-255,66,214545,8,324821
35101,0.039172,172.217.27.0-255,5738,220283,8,324821
35102,0.039181,172.31.36.0-255,66,220349,8,324821
35103,0.04084,172.217.27.0-255,5738,226087,8,324821
35104,0.040849,172.31.36.0-255,66,226153,8,324821
35105,0.042507,172.217.27.0-255,5738,231891,8,324821
35106,0.042518,172.31.36.0-255,66,231957,8,324821
35107,0.044168,172.217.27.0-255,5738,237695,8,324821
35108,0.044178,172.31.36.0-255,66,237761,8,324821
35109,0.045835,172.217.27.0-255,5738,243499,8,324821
35110,0.045846,172.31.36.0-255,66,243565,8,324821
35111,0.047494,172.217.27.0-255,5738,249303,8,324821
35112,0.047501,172.31.36.0-255,66,249369,8,324821
35113,0.049158,172.217.27.0-255,5738,255107,8,324821
35114,0.049166,172.31.36.0-255,66,255173,8,324821
35115,0.050804,172.217.27.0-255,5738,260911,8,324821
35116,0.050813,172.31.36.0-255,66,260977,8,324821
35117,0.052469,172.217.27.0-255,5738,266715,8,324821
35118,0.052478,172.31.36.0-255,66,266781,8,324821
35119,0.054122,172.217.27.0-255,5738,272519,8,324821
35120,0.05413,172.31.36.0-255,66,272585,8,324821
35121,0.055785,172.217.27.0-255,5738,278323,8,324821
35122,0.055792,172.31.36.0-255,66,278389,8,324821
35123,0.057429,172.217.27.0-255,5738,284127,8,324821
35124,0.057435,172.31.36.0-255,66,284193,8,324821
35125,0.059082,172.217.27.0-255,5738,289931,8,324821
35126,0.059088,172.31.36.0-255,66,289997,8,324821
35127,0.060739,172.217.27.0-255,5738,295735,8,324821
35128,0.060746,172.31.36.0-255,66,295801,8,324821
35129,0.062394,172.217.27.0-255,5738,301539,8,324821
35130,0.062401,172.31.36.0-255,66,301605,8,324821
35131,0.064048,172.217.27.0-255,5738,307343,8,324821
35132,0.064056,172.31.36.0-255,66,307409,8,324821
35133,0.065703,172.217.27.0-255,5738,313147,8,324821
35134,0.06571,172.31.36.0-255,66,313213,8,324821
35135,0.067361,172.217.27.0-255,5738,318951,8,324821
35136,0.067368,172.31.36.0-255,66,319017,8,324821
35137,0.069019,172.217.27.0-255,5738,324755,8,324821
35138,0.069025,172.31.36.0-255,66,324821,8,324821
35139,0.0,172.31.36.0-255,105,105,8,459
35140,0.000205,172.31.36.0-255,90,195,8,459
35141,0.000214,172.31.36.0-255,66,261,8,459
35142,0.002465,74.125.68.0-255,66,327,8,459
35143,0.00248,74.125.68.0-255,66,393,8,459
35144,0.002493,172.31.36.0-255,66,459,8,459
35145,0.0,74.125.68.0-255,150,150,8,308986
35146,1.5e-05,172.31.36.0-255,66,216,8,308986
35147,2.1e-05,74.125.68.0-255,1484,1700,8,308986
35148,2.6e-05,172.31.36.0-255,66,1766,8,308986
35149,3.1e-05,74.125.68.0-255,2902,4668,8,308986
35150,3.4e-05,172.31.36.0-255,66,4734,8,308986
35151,6.8e-05,74.125.68.0-255,7156,11890,8,308986
35152,7.1e-05,172.31.36.0-255,66,11956,8,308986
35153,7.5e-05,74.125.68.0-255,1987,13943,8,308986
35154,7.7e-05,172.31.36.0-255,66,14009,8,308986
35155,0.000203,74.125.68.0-255,1484,15493,8,308986
35156,0.000207,172.31.36.0-255,66,15559,8,308986
35157,0.000229,74.125.68.0-255,2902,18461,8,308986
35158,0.000231,172.31.36.0-255,66,18527,8,308986
35159,0.000234,74.125.68.0-255,1484,20011,8,308986
35160,0.000236,172.31.36.0-255,66,20077,8,308986
35161,0.00024,74.125.68.0-255,2902,22979,8,308986
35162,0.000242,172.31.36.0-255,66,23045,8,308986
35163,0.000257,74.125.68.0-255,4320,27365,8,308986
35164,0.00026,172.31.36.0-255,66,27431,8,308986
35165,0.00027,74.125.68.0-255,1484,28915,8,308986
35166,0.000272,172.31.36.0-255,66,28981,8,308986
35167,0.00029,74.125.68.0-255,2543,31524,8,308986
35168,0.000293,172.31.36.0-255,66,31590,8,308986
35169,0.000374,74.125.68.0-255,1484,33074,8,308986
35170,0.000377,172.31.36.0-255,66,33140,8,308986
35171,0.000383,74.125.68.0-255,2902,36042,8,308986
35172,0.000385,172.31.36.0-255,66,36108,8,308986
35173,0.000402,74.125.68.0-255,5738,41846,8,308986
35174,0.000405,172.31.36.0-255,66,41912,8,308986
35175,0.00043,74.125.68.0-255,4320,46232,8,308986
35176,0.000433,172.31.36.0-255,66,46298,8,308986
35177,0.000452,74.125.68.0-255,2543,48841,8,308986
35178,0.000455,172.31.36.0-255,66,48907,8,308986
35179,0.000479,74.125.68.0-255,2902,51809,8,308986
35180,0.000483,172.31.36.0-255,66,51875,8,308986
35181,0.00051,74.125.68.0-255,2902,54777,8,308986
35182,0.000515,172.31.36.0-255,66,54843,8,308986
35183,0.000523,74.125.68.0-255,7156,61999,8,308986
35184,0.000525,172.31.36.0-255,66,62065,8,308986
35185,0.00053,74.125.68.0-255,2902,64967,8,308986
35186,0.000532,172.31.36.0-255,66,65033,8,308986
35187,0.000556,74.125.68.0-255,1399,66432,8,308986
35188,0.000745,74.125.68.0-255,127,66559,8,308986
35189,0.000812,74.125.68.0-255,351,66910,8,308986
35190,0.000816,172.31.36.0-255,66,66976,8,308986
35191,0.001117,74.125.68.0-255,1484,68460,8,308986
35192,0.001126,74.125.68.0-255,2902,71362,8,308986
35193,0.001129,172.31.36.0-255,66,71428,8,308986
35194,0.001138,74.125.68.0-255,5738,77166,8,308986
35195,0.00114,172.31.36.0-255,66,77232,8,308986
35196,0.001146,74.125.68.0-255,4320,81552,8,308986
35197,0.001148,172.31.36.0-255,66,81618,8,308986
35198,0.001167,74.125.68.0-255,2902,84520,8,308986
35199,0.001169,172.31.36.0-255,66,84586,8,308986
35200,0.00118,172.31.36.0-255,66,84652,8,308986
35201,0.001184,74.125.68.0-255,2902,87554,8,308986
35202,0.001187,172.31.36.0-255,66,87620,8,308986
35203,0.001215,74.125.68.0-255,5020,92640,8,308986
35204,0.001217,172.31.36.0-255,66,92706,8,308986
35205,0.001969,74.125.68.0-255,1484,94190,8,308986
35206,0.001978,74.125.68.0-255,2902,97092,8,308986
35207,0.001983,172.31.36.0-255,66,97158,8,308986
35208,0.001988,74.125.68.0-255,2902,100060,8,308986
35209,0.00199,172.31.36.0-255,66,100126,8,308986
35210,0.001996,74.125.68.0-255,4320,104446,8,308986
35211,0.001999,172.31.36.0-255,66,104512,8,308986
35212,0.002004,74.125.68.0-255,2902,107414,8,308986
35213,0.002006,172.31.36.0-255,66,107480,8,308986
35214,0.00203,74.125.68.0-255,5738,113218,8,308986
35215,0.002032,172.31.36.0-255,66,113284,8,308986
35216,0.002035,74.125.68.0-255,1484,114768,8,308986
35217,0.002039,74.125.68.0-255,2902,117670,8,308986
35218,0.002041,172.31.36.0-255,66,117736,8,308986
35219,0.002065,74.125.68.0-255,5738,123474,8,308986
35220,0.002067,172.31.36.0-255,66,123540,8,308986
35221,0.002071,74.125.68.0-255,1484,125024,8,308986
35222,0.002092,74.125.68.0-255,2184,127208,8,308986
35223,0.002095,172.31.36.0-255,66,127274,8,308986
35224,0.004304,74.125.68.0-255,1484,128758,8,308986
35225,0.004332,74.125.68.0-255,4320,133078,8,308986
35226,0.004336,172.31.36.0-255,66,133144,8,308986
35227,0.006585,74.125.68.0-255,5738,138882,8,308986
35228,0.006591,172.31.36.0-255,66,138948,8,308986
35229,0.008834,74.125.68.0-255,5738,144686,8,308986
35230,0.008842,172.31.36.0-255,66,144752,8,308986
35231,0.011093,74.125.68.0-255,5738,150490,8,308986
35232,0.0111,172.31.36.0-255,66,150556,8,308986
35233,0.013432,74.125.68.0-255,5738,156294,8,308986
35234,0.013441,172.31.36.0-255,66,156360,8,308986
35235,0.015686,74.125.68.0-255,5738,162098,8,308986
35236,0.015696,172.31.36.0-255,66,162164,8,308986
35237,0.017945,74.125.68.0-255,5738,167902,8,308986
35238,0.017954,172.31.36.0-255,66,167968,8,308986
35239,0.020191,74.125.68.0-255,5738,173706,8,308986
35240,0.020198,172.31.36.0-255,66,173772,8,308986
35241,0.022443,74.125.68.0-255,4320,178092,8,308986
35242,0.02245,172.31.36.0-255,66,178158,8,308986
35243,0.022471,74.125.68.0-255,1484,179642,8,308986
35244,0.02472,74.125.68.0-255,4320,183962,8,308986
35245,0.024728,172.31.36.0-255,66,184028,8,308986
35246,0.026975,74.125.68.0-255,5738,189766,8,308986
35247,0.026982,172.31.36.0-255,66,189832,8,308986
35248,0.029228,74.125.68.0-255,5738,195570,8,308986
35249,0.029237,172.31.36.0-255,66,195636,8,308986
35250,0.031485,74.125.68.0-255,5738,201374,8,308986
35251,0.031493,172.31.36.0-255,66,201440,8,308986
35252,0.032262,172.31.36.0-255,172,201612,8,308986
35253,0.032296,172.31.36.0-255,1111,202723,8,308986
35254,0.032368,172.31.36.0-255,1514,204237,8,308986
35255,0.03237,172.31.36.0-255,1514,205751,8,308986
35256,0.032377,172.31.36.0-255,1514,207265,8,308986
35257,0.032378,172.31.36.0-255,1514,208779,8,308986
35258,0.032407,172.31.36.0-255,1275,210054,8,308986
35259,0.03373,74.125.68.0-255,5738,215792,8,308986
35260,0.033737,172.31.36.0-255,66,215858,8,308986
35261,0.033793,104.244.42.0-255,66,215924,8,308986
35262,0.033855,104.244.42.0-255,66,215990,8,308986
35263,0.033952,104.244.42.0-255,66,216056,8,308986
35264,0.033958,104.244.42.0-255,66,216122,8,308986
35265,0.035998,74.125.68.0-255,5738,221860,8,308986
35266,0.036005,172.31.36.0-255,66,221926,8,308986
35267,0.038258,74.125.68.0-255,5738,227664,8,308986
35268,0.038264,172.31.36.0-255,66,227730,8,308986
35269,0.040535,74.125.68.0-255,5738,233468,8,308986
35270,0.04054,172.31.36.0-255,66,233534,8,308986
35271,0.042801,74.125.68.0-255,5738,239272,8,308986
35272,0.042808,172.31.36.0-255,66,239338,8,308986
35273,0.045095,74.125.68.0-255,5738,245076,8,308986
35274,0.045102,172.31.36.0-255,66,245142,8,308986
35275,0.047357,74.125.68.0-255,5738,250880,8,308986
35276,0.047363,172.31.36.0-255,66,250946,8,308986
35277,0.049627,74.125.68.0-255,5738,256684,8,308986
35278,0.049634,172.31.36.0-255,66,256750,8,308986
35279,0.051889,74.125.68.0-255,5738,262488,8,308986
35280,0.051896,172.31.36.0-255,66,262554,8,308986
35281,0.05414,74.125.68.0-255,5738,268292,8,308986
35282,0.054147,172.31.36.0-255,66,268358,8,308986
35283,0.056393,74.125.68.0-255,5738,274096,8,308986
35284,0.0564,172.31.36.0-255,66,274162,8,308986
35285,0.05867,74.125.68.0-255,5738,279900,8,308986
35286,0.058677,172.31.36.0-255,66,279966,8,308986
35287,0.060933,74.125.68.0-255,5738,285704,8,308986
35288,0.060939,172.31.36.0-255,66,285770,8,308986
35289,0.063195,74.125.68.0-255,5738,291508,8,308986
35290,0.063204,172.31.36.0-255,66,291574,8,308986
35291,0.065456,74.125.68.0-255,5738,297312,8,308986
35292,0.065464,172.31.36.0-255,66,297378,8,308986
35293,0.067723,74.125.68.0-255,5738,303116,8,308986
35294,0.067729,172.31.36.0-255,66,303182,8,308986
35295,0.069973,74.125.68.0-255,5738,308920,8,308986
35296,0.06998,172.31.36.0-255,66,308986,8,308986
35297,0.0,74.125.24.0-255,150,150,8,176428
35298,1.8e-05,172.31.36.0-255,66,216,8,176428
35299,2.5e-05,74.125.24.0-255,1484,1700,8,176428
35300,2.9e-05,172.31.36.0-255,66,1766,8,176428
35301,4.5e-05,74.125.24.0-255,2902,4668,8,176428
35302,5e-05,172.31.36.0-255,66,4734,8,176428
35303,5.7e-05,74.125.24.0-255,7156,11890,8,176428
35304,6.1e-05,172.31.36.0-255,66,11956,8,176428
35305,0.000112,74.125.24.0-255,2543,14499,8,176428
35306,0.000113,172.31.36.0-255,66,14565,8,176428
35307,0.000117,172.31.36.0-255,66,14631,8,176428
35308,0.000177,74.125.24.0-255,1484,16115,8,176428
35309,0.000181,172.31.36.0-255,66,16181,8,176428
35310,0.000214,74.125.24.0-255,2902,19083,8,176428
35311,0.000218,172.31.36.0-255,66,19149,8,176428
35312,0.000223,74.125.24.0-255,5738,24887,8,176428
35313,0.000225,172.31.36.0-255,66,24953,8,176428
35314,0.000229,74.125.24.0-255,1484,26437,8,176428
35315,0.000237,172.31.36.0-255,66,26503,8,176428
35316,0.000288,172.31.36.0-255,66,26569,8,176428
35317,0.000295,74.125.24.0-255,7156,33725,8,176428
35318,0.000297,172.31.36.0-255,66,33791,8,176428
35319,0.000308,74.125.24.0-255,2815,36606,8,176428
35320,0.00031,172.31.36.0-255,66,36672,8,176428
35321,0.000333,74.125.24.0-255,126,36798,8,176428
35322,0.000336,172.31.36.0-255,66,36864,8,176428
35323,0.000463,74.125.24.0-255,1484,38348,8,176428
35324,0.000467,172.31.36.0-255,66,38414,8,176428
35325,0.000473,74.125.24.0-255,2902,41316,8,176428
35326,0.000475,172.31.36.0-255,66,41382,8,176428
35327,0.000506,74.125.24.0-255,5738,47120,8,176428
35328,0.000513,74.125.24.0-255,4320,51440,8,176428
35329,0.000519,172.31.36.0-255,66,51506,8,176428
35330,0.000561,172.31.36.0-255,66,51572,8,176428
35331,0.000563,74.125.24.0-255,6797,58369,8,176428
35332,0.000577,172.31.36.0-255,66,58435,8,176428
35333,0.000586,74.125.24.0-255,354,58789,8,176428
35334,0.000827,74.125.24.0-255,1484,60273,8,176428
35335,0.000832,172.31.36.0-255,66,60339,8,176428
35336,0.000837,74.125.24.0-255,2902,63241,8,176428
35337,0.000843,74.125.24.0-255,5738,68979,8,176428
35338,0.00085,172.31.36.0-255,66,69045,8,176428
35339,0.000877,172.31.36.0-255,66,69111,8,176428
35340,0.000911,74.125.24.0-255,2902,72013,8,176428
35341,0.000921,172.31.36.0-255,66,72079,8,176428
35342,0.000953,172.31.36.0-255,66,72145,8,176428
35343,0.001003,74.125.24.0-255,1484,73629,8,176428
35344,0.001008,74.125.24.0-255,2902,76531,8,176428
35345,0.001011,172.31.36.0-255,66,76597,8,176428
35346,0.001018,74.125.24.0-255,5738,82335,8,176428
35347,0.001027,172.31.36.0-255,66,82401,8,176428
35348,0.001044,172.31.36.0-255,66,82467,8,176428
35349,0.001094,172.31.36.0-255,66,82533,8,176428
35350,0.001117,74.125.24.0-255,4320,86853,8,176428
35351,0.001129,172.31.36.0-255,66,86919,8,176428
35352,0.001153,172.31.36.0-255,66,86985,8,176428
35353,0.001165,74.125.24.0-255,4320,91305,8,176428
35354,0.00117,172.31.36.0-255,66,91371,8,176428
35355,0.001178,74.125.24.0-255,2184,93555,8,176428
35356,0.001182,172.31.36.0-255,66,93621,8,176428
35357,0.001502,74.125.24.0-255,1484,95105,8,176428
35358,0.001509,74.125.24.0-255,2902,98007,8,176428
35359,0.001513,172.31.36.0-255,66,98073,8,176428
35360,0.001518,74.125.24.0-255,2902,100975,8,176428
35361,0.001529,172.31.36.0-255,66,101041,8,176428
35362,0.001539,74.125.24.0-255,2902,103943,8,176428
35363,0.001545,172.31.36.0-255,66,104009,8,176428
35364,0.00155,74.125.24.0-255,4320,108329,8,176428
35365,0.001558,172.31.36.0-255,66,108395,8,176428
35366,0.001595,172.31.36.0-255,66,108461,8,176428
35367,0.00161,172.31.36.0-255,66,108527,8,176428
35368,0.0018,74.125.24.0-255,1484,110011,8,176428
35369,0.001813,74.125.24.0-255,2902,112913,8,176428
35370,0.001817,172.31.36.0-255,66,112979,8,176428
35371,0.001824,74.125.24.0-255,5738,118717,8,176428
35372,0.001831,172.31.36.0-255,66,118783,8,176428
35373,0.001886,74.125.24.0-255,7156,125939,8,176428
35374,0.001889,172.31.36.0-255,66,126005,8,176428
35375,0.001894,172.31.36.0-255,66,126071,8,176428
35376,0.001936,74.125.24.0-255,7156,133227,8,176428
35377,0.001942,172.31.36.0-255,66,133293,8,176428
35378,0.001988,172.31.36.0-255,66,133359,8,176428
35379,0.001994,74.125.24.0-255,1484,134843,8,176428
35380,0.002004,172.31.36.0-255,66,134909,8,176428
35381,0.002013,74.125.24.0-255,2902,137811,8,176428
35382,0.002019,172.31.36.0-255,66,137877,8,176428
35383,0.002022,74.125.24.0-255,2902,140779,8,176428
35384,0.002025,74.125.24.0-255,1484,142263,8,176428
35385,0.002033,172.31.36.0-255,66,142329,8,176428
35386,0.00207,74.125.24.0-255,4320,146649,8,176428
35387,0.002072,172.31.36.0-255,66,146715,8,176428
35388,0.002077,172.31.36.0-255,66,146781,8,176428
35389,0.002129,172.31.36.0-255,66,146847,8,176428
35390,0.002158,74.125.24.0-255,2184,149031,8,176428
35391,0.002162,172.31.36.0-255,66,149097,8,176428
35392,0.002176,172.31.36.0-255,66,149163,8,176428
35393,0.002185,74.125.24.0-255,1484,150647,8,176428
35394,0.002189,172.31.36.0-255,66,150713,8,176428
35395,0.002197,74.125.24.0-255,1484,152197,8,176428
35396,0.002206,172.31.36.0-255,66,152263,8,176428
35397,0.00221,172.31.36.0-255,66,152329,8,176428
35398,0.002246,74.125.24.0-255,7156,159485,8,176428
35399,0.00225,74.125.24.0-255,2902,162387,8,176428
35400,0.002251,172.31.36.0-255,66,162453,8,176428
35401,0.002257,172.31.36.0-255,66,162519,8,176428
35402,0.002268,172.31.36.0-255,66,162585,8,176428
35403,0.002281,74.125.24.0-255,3602,166187,8,176428
35404,0.002284,74.125.24.0-255,1484,167671,8,176428
35405,0.002287,172.31.36.0-255,66,167737,8,176428
35406,0.002291,74.125.24.0-255,1484,169221,8,176428
35407,0.002305,172.31.36.0-255,66,169287,8,176428
35408,0.002314,74.125.24.0-255,2710,171997,8,176428
35409,0.002318,172.31.36.0-255,66,172063,8,176428
35410,0.002335,74.125.24.0-255,105,172168,8,176428
35411,0.003714,172.31.36.0-255,66,172234,8,176428
35412,0.003741,172.31.36.0-255,105,172339,8,176428
35413,0.005655,74.125.24.0-255,66,172405,8,176428
35414,0.043616,172.31.36.0-255,172,172577,8,176428
35415,0.043647,172.31.36.0-255,1113,173690,8,176428
35416,0.04371,172.31.36.0-255,1514,175204,8,176428
35417,0.043711,172.31.36.0-255,1026,176230,8,176428
35418,0.04516,104.244.42.0-255,66,176296,8,176428
35419,0.045204,104.244.42.0-255,66,176362,8,176428
35420,0.045293,104.244.42.0-255,66,176428,8,176428
35421,0.0,74.125.68.0-255,153,153,8,350327
35422,2.8e-05,172.31.36.0-255,66,219,8,350327
35423,3.6e-05,74.125.68.0-255,1484,1703,8,350327
35424,4e-05,172.31.36.0-255,66,1769,8,350327
35425,4.5e-05,74.125.68.0-255,2902,4671,8,350327
35426,4.7e-05,172.31.36.0-255,66,4737,8,350327
35427,6.6e-05,74.125.68.0-255,2902,7639,8,350327
35428,6.8e-05,172.31.36.0-255,66,7705,8,350327
35429,7.4e-05,74.125.68.0-255,4320,12025,8,350327
35430,7.6e-05,172.31.36.0-255,66,12091,8,350327
35431,0.0001,74.125.68.0-255,2101,14192,8,350327
35432,0.000102,172.31.36.0-255,66,14258,8,350327
35433,0.00023,74.125.68.0-255,1484,15742,8,350327
35434,0.000235,172.31.36.0-255,66,15808,8,350327
35435,0.000241,74.125.68.0-255,2902,18710,8,350327
35436,0.000244,172.31.36.0-255,66,18776,8,350327
35437,0.000271,74.125.68.0-255,2902,21678,8,350327
35438,0.000273,172.31.36.0-255,66,21744,8,350327
35439,0.000297,74.125.68.0-255,1484,23228,8,350327
35440,0.000299,172.31.36.0-255,66,23294,8,350327
35441,0.000306,74.125.68.0-255,5738,29032,8,350327
35442,0.000309,172.31.36.0-255,66,29098,8,350327
35443,0.000313,74.125.68.0-255,2543,31641,8,350327
35444,0.000316,172.31.36.0-255,66,31707,8,350327
35445,0.000332,74.125.68.0-255,2902,34609,8,350327
35446,0.000335,172.31.36.0-255,66,34675,8,350327
35447,0.000359,74.125.68.0-255,7156,41831,8,350327
35448,0.000363,172.31.36.0-255,66,41897,8,350327
35449,0.000371,74.125.68.0-255,6797,48694,8,350327
35450,0.000373,172.31.36.0-255,66,48760,8,350327
35451,0.000685,74.125.68.0-255,1484,50244,8,350327
35452,0.000689,172.31.36.0-255,66,50310,8,350327
35453,0.000694,74.125.68.0-255,2902,53212,8,350327
35454,0.000696,172.31.36.0-255,66,53278,8,350327
35455,0.000713,74.125.68.0-255,5738,59016,8,350327
35456,0.000716,172.31.36.0-255,66,59082,8,350327
35457,0.000738,74.125.68.0-255,6797,65879,8,350327
35458,0.000741,172.31.36.0-255,66,65945,8,350327
35459,0.000767,74.125.68.0-255,4320,70265,8,350327
35460,0.000769,172.31.36.0-255,66,70331,8,350327
35461,0.000787,74.125.68.0-255,7156,77487,8,350327
35462,0.00079,172.31.36.0-255,66,77553,8,350327
35463,0.000819,74.125.68.0-255,1484,79037,8,350327
35464,0.000834,74.125.68.0-255,4541,83578,8,350327
35465,0.000837,172.31.36.0-255,66,83644,8,350327
35466,0.000878,74.125.68.0-255,1484,85128,8,350327
35467,0.000881,74.125.68.0-255,1484,86612,8,350327
35468,0.000884,172.31.36.0-255,66,86678,8,350327
35469,0.0009,74.125.68.0-255,1484,88162,8,350327
35470,0.000905,74.125.68.0-255,4320,92482,8,350327
35471,0.000908,172.31.36.0-255,66,92548,8,350327
35472,0.000926,74.125.68.0-255,1484,94032,8,350327
35473,0.000933,74.125.68.0-255,6797,100829,8,350327
35474,0.000936,172.31.36.0-255,66,100895,8,350327
35475,0.001507,74.125.68.0-255,1484,102379,8,350327
35476,0.001518,74.125.68.0-255,2902,105281,8,350327
35477,0.001522,172.31.36.0-255,66,105347,8,350327
35478,0.001526,74.125.68.0-255,1484,106831,8,350327
35479,0.001531,74.125.68.0-255,2902,109733,8,350327
35480,0.001533,172.31.36.0-255,66,109799,8,350327
35481,0.001569,74.125.68.0-255,5738,115537,8,350327
35482,0.001571,172.31.36.0-255,66,115603,8,350327
35483,0.001577,74.125.68.0-255,2902,118505,8,350327
35484,0.001578,172.31.36.0-255,66,118571,8,350327
35485,0.001595,74.125.68.0-255,4320,122891,8,350327
35486,0.001597,172.31.36.0-255,66,122957,8,350327
35487,0.001636,172.31.36.0-255,66,123023,8,350327
35488,0.001642,74.125.68.0-255,3602,126625,8,350327
35489,0.001644,172.31.36.0-255,66,126691,8,350327
35490,0.001845,74.125.68.0-255,1484,128175,8,350327
35491,0.001869,74.125.68.0-255,2902,131077,8,350327
35492,0.001873,172.31.36.0-255,66,131143,8,350327
35493,0.00188,74.125.68.0-255,5738,136881,8,350327
35494,0.001882,172.31.36.0-255,66,136947,8,350327
35495,0.001886,74.125.68.0-255,2902,139849,8,350327
35496,0.001889,172.31.36.0-255,66,139915,8,350327
35497,0.001914,74.125.68.0-255,4320,144235,8,350327
35498,0.001917,172.31.36.0-255,66,144301,8,350327
35499,0.00195,172.31.36.0-255,66,144367,8,350327
35500,0.001954,74.125.68.0-255,2902,147269,8,350327
35501,0.001956,172.31.36.0-255,66,147335,8,350327
35502,0.001992,74.125.68.0-255,5020,152355,8,350327
35503,0.001997,172.31.36.0-255,66,152421,8,350327
35504,0.002155,74.125.68.0-255,1484,153905,8,350327
35505,0.002181,74.125.68.0-255,2902,156807,8,350327
35506,0.002184,172.31.36.0-255,66,156873,8,350327
35507,0.002189,74.125.68.0-255,2902,159775,8,350327
35508,0.002191,172.31.36.0-255,66,159841,8,350327
35509,0.002204,74.125.68.0-255,2902,162743,8,350327
35510,0.002206,172.31.36.0-255,66,162809,8,350327
35511,0.002213,74.125.68.0-255,5738,168547,8,350327
35512,0.002216,172.31.36.0-255,66,168613,8,350327
35513,0.00224,74.125.68.0-255,1484,170097,8,350327
35514,0.002247,74.125.68.0-255,5738,175835,8,350327
35515,0.002251,172.31.36.0-255,66,175901,8,350327
35516,0.002275,172.31.36.0-255,66,175967,8,350327
35517,0.00234,172.31.36.0-255,66,176033,8,350327
35518,0.002345,74.125.68.0-255,4320,180353,8,350327
35519,0.002348,172.31.36.0-255,66,180419,8,350327
35520,0.00464,74.125.68.0-255,1484,181903,8,350327
35521,0.004662,74.125.68.0-255,4320,186223,8,350327
35522,0.004665,172.31.36.0-255,66,186289,8,350327
35523,0.006966,74.125.68.0-255,1484,187773,8,350327
35524,0.006984,74.125.68.0-255,4320,192093,8,350327
35525,0.006989,172.31.36.0-255,66,192159,8,350327
35526,0.009276,74.125.68.0-255,5738,197897,8,350327
35527,0.009282,172.31.36.0-255,66,197963,8,350327
35528,0.011568,74.125.68.0-255,5738,203701,8,350327
35529,0.011575,172.31.36.0-255,66,203767,8,350327
35530,0.013868,74.125.68.0-255,5738,209505,8,350327
35531,0.013876,172.31.36.0-255,66,209571,8,350327
35532,0.016189,74.125.68.0-255,5738,215309,8,350327
35533,0.016198,172.31.36.0-255,66,215375,8,350327
35534,0.018484,74.125.68.0-255,5738,221113,8,350327
35535,0.018493,172.31.36.0-255,66,221179,8,350327
35536,0.020783,74.125.68.0-255,5738,226917,8,350327
35537,0.020793,172.31.36.0-255,66,226983,8,350327
35538,0.023084,74.125.68.0-255,5738,232721,8,350327
35539,0.023092,172.31.36.0-255,66,232787,8,350327
35540,0.025383,74.125.68.0-255,5738,238525,8,350327
35541,0.025389,172.31.36.0-255,66,238591,8,350327
35542,0.027676,74.125.68.0-255,5738,244329,8,350327
35543,0.027683,172.31.36.0-255,66,244395,8,350327
35544,0.029973,74.125.68.0-255,5738,250133,8,350327
35545,0.02998,172.31.36.0-255,66,250199,8,350327
35546,0.032262,74.125.68.0-255,5738,255937,8,350327
35547,0.032269,172.31.36.0-255,66,256003,8,350327
35548,0.034554,74.125.68.0-255,5738,261741,8,350327
35549,0.034561,172.31.36.0-255,66,261807,8,350327
35550,0.036861,74.125.68.0-255,5738,267545,8,350327
35551,0.036873,172.31.36.0-255,66,267611,8,350327
35552,0.039177,74.125.68.0-255,5738,273349,8,350327
35553,0.039187,172.31.36.0-255,66,273415,8,350327
35554,0.041477,172.31.36.0-255,172,273587,8,350327
35555,0.041478,74.125.68.0-255,5738,279325,8,350327
35556,0.041483,172.31.36.0-255,66,279391,8,350327
35557,0.0415,172.31.36.0-255,562,279953,8,350327
35558,0.043655,104.244.42.0-255,66,280019,8,350327
35559,0.043784,74.125.68.0-255,2902,282921,8,350327
35560,0.043788,172.31.36.0-255,66,282987,8,350327
35561,0.043818,74.125.68.0-255,2902,285889,8,350327
35562,0.043821,172.31.36.0-255,66,285955,8,350327
35563,0.04608,74.125.68.0-255,2902,288857,8,350327
35564,0.046085,172.31.36.0-255,66,288923,8,350327
35565,0.046119,74.125.68.0-255,2902,291825,8,350327
35566,0.046123,172.31.36.0-255,66,291891,8,350327
35567,0.048375,74.125.68.0-255,2902,294793,8,350327
35568,0.048382,172.31.36.0-255,66,294859,8,350327
35569,0.048405,74.125.68.0-255,2902,297761,8,350327
35570,0.048408,172.31.36.0-255,66,297827,8,350327
35571,0.050665,74.125.68.0-255,2902,300729,8,350327
35572,0.050672,172.31.36.0-255,66,300795,8,350327
35573,0.050701,74.125.68.0-255,2902,303697,8,350327
35574,0.050705,172.31.36.0-255,66,303763,8,350327
35575,0.052967,74.125.68.0-255,2902,306665,8,350327
35576,0.052983,172.31.36.0-255,66,306731,8,350327
35577,0.053005,74.125.68.0-255,2902,309633,8,350327
35578,0.053008,172.31.36.0-255,66,309699,8,350327
35579,0.055263,74.125.68.0-255,5738,315437,8,350327
35580,0.055269,172.31.36.0-255,66,315503,8,350327
35581,0.057555,74.125.68.0-255,5738,321241,8,350327
35582,0.057561,172.31.36.0-255,66,321307,8,350327
35583,0.059841,74.125.68.0-255,5738,327045,8,350327
35584,0.059847,172.31.36.0-255,66,327111,8,350327
35585,0.062127,74.125.68.0-255,5738,332849,8,350327
35586,0.062132,172.31.36.0-255,66,332915,8,350327
35587,0.064418,74.125.68.0-255,5738,338653,8,350327
35588,0.064424,172.31.36.0-255,66,338719,8,350327
35589,0.06671,74.125.68.0-255,5738,344457,8,350327
35590,0.066717,172.31.36.0-255,66,344523,8,350327
35591,0.069053,74.125.68.0-255,5738,350261,8,350327
35592,0.06906,172.31.36.0-255,66,350327,8,350327
35593,0.0,74.125.130.0-255,153,153,8,358364
35594,2.7e-05,172.31.36.0-255,66,219,8,358364
35595,3.4e-05,74.125.130.0-255,1484,1703,8,358364
35596,3.7e-05,172.31.36.0-255,66,1769,8,358364
35597,4e-05,74.125.130.0-255,1484,3253,8,358364
35598,4.3e-05,172.31.36.0-255,66,3319,8,358364
35599,6.7e-05,74.125.130.0-255,1484,4803,8,358364
35600,7e-05,172.31.36.0-255,66,4869,8,358364
35601,8.4e-05,74.125.130.0-255,5738,10607,8,358364
35602,8.6e-05,172.31.36.0-255,66,10673,8,358364
35603,0.000113,74.125.130.0-255,4320,14993,8,358364
35604,0.000116,172.31.36.0-255,66,15059,8,358364
35605,0.000146,74.125.130.0-255,2077,17136,8,358364
35606,0.000149,172.31.36.0-255,66,17202,8,358364
35607,0.000153,74.125.130.0-255,1484,18686,8,358364
35608,0.000155,172.31.36.0-255,66,18752,8,358364
35609,0.0002,172.31.36.0-255,66,18818,8,358364
35610,0.000203,74.125.130.0-255,1484,20302,8,358364
35611,0.000205,172.31.36.0-255,66,20368,8,358364
35612,0.00023,74.125.130.0-255,1125,21493,8,358364
35613,0.000239,172.31.36.0-255,66,21559,8,358364
35614,0.000379,74.125.130.0-255,1484,23043,8,358364
35615,0.000384,172.31.36.0-255,66,23109,8,358364
35616,0.000389,74.125.130.0-255,2902,26011,8,358364
35617,0.000392,172.31.36.0-255,66,26077,8,358364
35618,0.000435,74.125.130.0-255,5738,31815,8,358364
35619,0.000439,172.31.36.0-255,66,31881,8,358364
35620,0.000442,74.125.130.0-255,1484,33365,8,358364
35621,0.000444,172.31.36.0-255,66,33431,8,358364
35622,0.000449,74.125.130.0-255,2902,36333,8,358364
35623,0.00046,172.31.36.0-255,66,36399,8,358364
35624,0.000484,74.125.130.0-255,3961,40360,8,358364
35625,0.000489,172.31.36.0-255,66,40426,8,358364
35626,0.000509,74.125.130.0-255,4320,44746,8,358364
35627,0.000513,172.31.36.0-255,66,44812,8,358364
35628,0.000542,74.125.130.0-255,7156,51968,8,358364
35629,0.000546,172.31.36.0-255,66,52034,8,358364
35630,0.000582,74.125.130.0-255,4213,56247,8,358364
35631,0.000586,172.31.36.0-255,66,56313,8,358364
35632,0.000613,74.125.130.0-255,403,56716,8,358364
35633,0.000789,74.125.130.0-255,1484,58200,8,358364
35634,0.000793,172.31.36.0-255,66,58266,8,358364
35635,0.000797,74.125.130.0-255,1484,59750,8,358364
35636,0.000817,74.125.130.0-255,1484,61234,8,358364
35637,0.00082,172.31.36.0-255,66,61300,8,358364
35638,0.000847,74.125.130.0-255,5738,67038,8,358364
35639,0.00085,172.31.36.0-255,66,67104,8,358364
35640,0.000878,74.125.130.0-255,6797,73901,8,358364
35641,0.000881,172.31.36.0-255,66,73967,8,358364
35642,0.000932,74.125.130.0-255,1484,75451,8,358364
35643,0.000937,74.125.130.0-255,2902,78353,8,358364
35644,0.000939,172.31.36.0-255,66,78419,8,358364
35645,0.000943,74.125.130.0-255,2902,81321,8,358364
35646,0.000946,172.31.36.0-255,66,81387,8,358364
35647,0.000977,74.125.130.0-255,4320,85707,8,358364
35648,0.00098,172.31.36.0-255,66,85773,8,358364
35649,0.001013,74.125.130.0-255,5379,91152,8,358364
35650,0.001016,172.31.36.0-255,66,91218,8,358364
35651,0.001213,74.125.130.0-255,1484,92702,8,358364
35652,0.001242,74.125.130.0-255,2902,95604,8,358364
35653,0.001248,172.31.36.0-255,66,95670,8,358364
35654,0.001285,74.125.130.0-255,4320,99990,8,358364
35655,0.001289,172.31.36.0-255,66,100056,8,358364
35656,0.001293,74.125.130.0-255,2902,102958,8,358364
35657,0.001295,172.31.36.0-255,66,103024,8,358364
35658,0.001319,74.125.130.0-255,2902,105926,8,358364
35659,0.001322,172.31.36.0-255,66,105992,8,358364
35660,0.00133,74.125.130.0-255,5738,111730,8,358364
35661,0.001338,172.31.36.0-255,66,111796,8,358364
35662,0.001364,74.125.130.0-255,1484,113280,8,358364
35663,0.001372,74.125.130.0-255,1484,114764,8,358364
35664,0.001375,172.31.36.0-255,66,114830,8,358364
35665,0.00138,74.125.130.0-255,2902,117732,8,358364
35666,0.001382,172.31.36.0-255,66,117798,8,358364
35667,0.001388,74.125.130.0-255,5738,123536,8,358364
35668,0.00139,172.31.36.0-255,66,123602,8,358364
35669,0.001393,74.125.130.0-255,1484,125086,8,358364
35670,0.001424,74.125.130.0-255,766,125852,8,358364
35671,0.001428,172.31.36.0-255,66,125918,8,358364
35672,0.001512,74.125.130.0-255,1484,127402,8,358364
35673,0.00154,74.125.130.0-255,2902,130304,8,358364
35674,0.001544,172.31.36.0-255,66,130370,8,358364
35675,0.001549,74.125.130.0-255,2902,133272,8,358364
35676,0.001552,172.31.36.0-255,66,133338,8,358364
35677,0.001586,74.125.130.0-255,4320,137658,8,358364
35678,0.00159,172.31.36.0-255,66,137724,8,358364
35679,0.001595,74.125.130.0-255,2902,140626,8,358364
35680,0.001596,172.31.36.0-255,66,140692,8,358364
35681,0.001617,74.125.130.0-255,2902,143594,8,358364
35682,0.001625,172.31.36.0-255,66,143660,8,358364
35683,0.001657,74.125.130.0-255,7156,150816,8,358364
35684,0.001662,172.31.36.0-255,66,150882,8,358364
35685,0.001702,172.31.36.0-255,66,150948,8,358364
35686,0.001705,74.125.130.0-255,766,151714,8,358364
35687,0.002036,74.125.130.0-255,1484,153198,8,358364
35688,0.00204,172.31.36.0-255,66,153264,8,358364
35689,0.002059,74.125.130.0-255,2902,156166,8,358364
35690,0.002061,172.31.36.0-255,66,156232,8,358364
35691,0.002084,74.125.130.0-255,5738,161970,8,358364
35692,0.002087,172.31.36.0-255,66,162036,8,358364
35693,0.002114,74.125.130.0-255,2902,164938,8,358364
35694,0.002117,172.31.36.0-255,66,165004,8,358364
35695,0.00212,74.125.130.0-255,1484,166488,8,358364
35696,0.002142,74.125.130.0-255,2902,169390,8,358364
35697,0.002144,172.31.36.0-255,66,169456,8,358364
35698,0.00215,74.125.130.0-255,4320,173776,8,358364
35699,0.002151,172.31.36.0-255,66,173842,8,358364
35700,0.002186,74.125.130.0-255,5738,179580,8,358364
35701,0.002189,172.31.36.0-255,66,179646,8,358364
35702,0.002215,74.125.130.0-255,4320,183966,8,358364
35703,0.002218,172.31.36.0-255,66,184032,8,358364
35704,0.002252,74.125.130.0-255,2184,186216,8,358364
35705,0.002255,172.31.36.0-255,66,186282,8,358364
35706,0.002448,74.125.130.0-255,1484,187766,8,358364
35707,0.002462,74.125.130.0-255,1484,189250,8,358364
35708,0.002465,172.31.36.0-255,66,189316,8,358364
35709,0.002484,74.125.130.0-255,1484,190800,8,358364
35710,0.002503,74.125.130.0-255,5738,196538,8,358364
35711,0.002506,172.31.36.0-255,66,196604,8,358364
35712,0.002509,74.125.130.0-255,1484,198088,8,358364
35713,0.002548,74.125.130.0-255,4320,202408,8,358364
35714,0.002551,172.31.36.0-255,66,202474,8,358364
35715,0.002569,74.125.130.0-255,2902,205376,8,358364
35716,0.002572,172.31.36.0-255,66,205442,8,358364
35717,0.005057,74.125.130.0-255,2902,208344,8,358364
35718,0.005064,172.31.36.0-255,66,208410,8,358364
35719,0.005096,74.125.130.0-255,2902,211312,8,358364
35720,0.0051,172.31.36.0-255,66,211378,8,358364
35721,0.007564,74.125.130.0-255,2902,214280,8,358364
35722,0.00757,172.31.36.0-255,66,214346,8,358364
35723,0.007597,74.125.130.0-255,1484,215830,8,358364
35724,0.007616,74.125.130.0-255,1484,217314,8,358364
35725,0.007619,172.31.36.0-255,66,217380,8,358364
35726,0.01008,74.125.130.0-255,2902,220282,8,358364
35727,0.010087,172.31.36.0-255,66,220348,8,358364
35728,0.010117,74.125.130.0-255,2902,223250,8,358364
35729,0.01012,172.31.36.0-255,66,223316,8,358364
35730,0.012643,74.125.130.0-255,5738,229054,8,358364
35731,0.012652,172.31.36.0-255,66,229120,8,358364
35732,0.015197,74.125.130.0-255,5738,234858,8,358364
35733,0.015207,172.31.36.0-255,66,234924,8,358364
35734,0.017718,74.125.130.0-255,5738,240662,8,358364
35735,0.017727,172.31.36.0-255,66,240728,8,358364
35736,0.02023,74.125.130.0-255,5738,246466,8,358364
35737,0.020237,172.31.36.0-255,66,246532,8,358364
35738,0.022741,74.125.130.0-255,4320,250852,8,358364
35739,0.022747,172.31.36.0-255,66,250918,8,358364
35740,0.022807,74.125.130.0-255,1484,252402,8,358364
35741,0.024605,172.31.36.0-255,172,252574,8,358364
35742,0.024639,172.31.36.0-255,1110,253684,8,358364
35743,0.024701,172.31.36.0-255,1428,255112,8,358364
35744,0.025257,74.125.130.0-255,4320,259432,8,358364
35745,0.025265,172.31.36.0-255,66,259498,8,358364
35746,0.026169,104.244.42.0-255,66,259564,8,358364
35747,0.026197,104.244.42.0-255,66,259630,8,358364
35748,0.02629,104.244.42.0-255,66,259696,8,358364
35749,0.027794,74.125.130.0-255,5738,265434,8,358364
35750,0.0278,172.31.36.0-255,66,265500,8,358364
35751,0.030321,74.125.130.0-255,5738,271238,8,358364
35752,0.030328,172.31.36.0-255,66,271304,8,358364
35753,0.032848,74.125.130.0-255,5738,277042,8,358364
35754,0.032853,172.31.36.0-255,66,277108,8,358364
35755,0.035369,74.125.130.0-255,5738,282846,8,358364
35756,0.035376,172.31.36.0-255,66,282912,8,358364
35757,0.037907,74.125.130.0-255,5738,288650,8,358364
35758,0.037913,172.31.36.0-255,66,288716,8,358364
35759,0.040426,74.125.130.0-255,5738,294454,8,358364
35760,0.040434,172.31.36.0-255,66,294520,8,358364
35761,0.042948,74.125.130.0-255,5738,300258,8,358364
35762,0.042955,172.31.36.0-255,66,300324,8,358364
35763,0.045477,74.125.130.0-255,5738,306062,8,358364
35764,0.045484,172.31.36.0-255,66,306128,8,358364
35765,0.048002,74.125.130.0-255,5738,311866,8,358364
35766,0.048009,172.31.36.0-255,66,311932,8,358364
35767,0.050533,74.125.130.0-255,5738,317670,8,358364
35768,0.050539,172.31.36.0-255,66,317736,8,358364
35769,0.05307,74.125.130.0-255,5738,323474,8,358364
35770,0.053076,172.31.36.0-255,66,323540,8,358364
35771,0.055601,74.125.130.0-255,5738,329278,8,358364
35772,0.055608,172.31.36.0-255,66,329344,8,358364
35773,0.058128,74.125.130.0-255,5738,335082,8,358364
35774,0.058135,172.31.36.0-255,66,335148,8,358364
35775,0.060665,74.125.130.0-255,5738,340886,8,358364
35776,0.060675,172.31.36.0-255,66,340952,8,358364
35777,0.063206,74.125.130.0-255,5738,346690,8,358364
35778,0.063213,172.31.36.0-255,66,346756,8,358364
35779,0.065738,74.125.130.0-255,5738,352494,8,358364
35780,0.065744,172.31.36.0-255,66,352560,8,358364
35781,0.068273,74.125.130.0-255,5738,358298,8,358364
35782,0.068279,172.31.36.0-255,66,358364,8,358364
35783,0.0,172.217.194.0-255,153,153,8,227918
35784,3.6e-05,172.31.36.0-255,66,219,8,227918
35785,4.2e-05,172.217.194.0-255,1484,1703,8,227918
35786,4.7e-05,172.31.36.0-255,66,1769,8,227918
35787,5.2e-05,172.217.194.0-255,2902,4671,8,227918
35788,6.4e-05,172.31.36.0-255,66,4737,8,227918
35789,6.7e-05,172.217.194.0-255,1484,6221,8,227918
35790,7e-05,172.31.36.0-255,66,6287,8,227918
35791,7.4e-05,172.217.194.0-255,2902,9189,8,227918
35792,7.6e-05,172.31.36.0-255,66,9255,8,227918
35793,8.1e-05,172.217.194.0-255,2902,12157,8,227918
35794,8.2e-05,172.31.36.0-255,66,12223,8,227918
35795,0.000111,172.217.194.0-255,2037,14260,8,227918
35796,0.00012,172.31.36.0-255,66,14326,8,227918
35797,0.000126,172.217.194.0-255,5738,20064,8,227918
35798,0.000128,172.31.36.0-255,66,20130,8,227918
35799,0.000131,172.217.194.0-255,1484,21614,8,227918
35800,0.000134,172.31.36.0-255,66,21680,8,227918
35801,0.000183,172.31.36.0-255,66,21746,8,227918
35802,0.000287,172.217.194.0-255,1484,23230,8,227918
35803,0.000291,172.31.36.0-255,66,23296,8,227918
35804,0.000296,172.217.194.0-255,2902,26198,8,227918
35805,0.000299,172.31.36.0-255,66,26264,8,227918
35806,0.000311,172.217.194.0-255,4320,30584,8,227918
35807,0.000313,172.31.36.0-255,66,30650,8,227918
35808,0.000347,172.217.194.0-255,1484,32134,8,227918
35809,0.00035,172.31.36.0-255,66,32200,8,227918
35810,0.000358,172.217.194.0-255,6797,38997,8,227918
35811,0.00036,172.31.36.0-255,66,39063,8,227918
35812,0.000381,172.31.36.0-255,66,39129,8,227918
35813,0.000387,172.217.194.0-255,2834,41963,8,227918
35814,0.000393,172.31.36.0-255,66,42029,8,227918
35815,0.000429,172.217.194.0-255,364,42393,8,227918
35816,0.000687,172.217.194.0-255,1484,43877,8,227918
35817,0.000691,172.217.194.0-255,2902,46779,8,227918
35818,0.000692,172.31.36.0-255,66,46845,8,227918
35819,0.000709,172.31.36.0-255,66,46911,8,227918
35820,0.000713,172.217.194.0-255,5738,52649,8,227918
35821,0.000726,172.31.36.0-255,66,52715,8,227918
35822,0.000747,172.217.194.0-255,5738,58453,8,227918
35823,0.000753,172.31.36.0-255,66,58519,8,227918
35824,0.000763,172.217.194.0-255,5738,64257,8,227918
35825,0.000768,172.31.36.0-255,66,64323,8,227918
35826,0.000787,172.31.36.0-255,66,64389,8,227918
35827,0.000802,172.217.194.0-255,2184,66573,8,227918
35828,0.000813,172.31.36.0-255,66,66639,8,227918
35829,0.001086,172.217.194.0-255,1484,68123,8,227918
35830,0.001099,172.217.194.0-255,2902,71025,8,227918
35831,0.001103,172.31.36.0-255,66,71091,8,227918
35832,0.001107,172.217.194.0-255,1484,72575,8,227918
35833,0.001131,172.217.194.0-255,4320,76895,8,227918
35834,0.001134,172.31.36.0-255,66,76961,8,227918
35835,0.001151,172.31.36.0-255,66,77027,8,227918
35836,0.001197,172.217.194.0-255,7156,84183,8,227918
35837,0.00121,172.31.36.0-255,66,84249,8,227918
35838,0.001235,172.31.36.0-255,66,84315,8,227918
35839,0.001242,172.217.194.0-255,1484,85799,8,227918
35840,0.001246,172.217.194.0-255,2902,88701,8,227918
35841,0.001251,172.31.36.0-255,66,88767,8,227918
35842,0.001315,172.217.194.0-255,5738,94505,8,227918
35843,0.001319,172.31.36.0-255,66,94571,8,227918
35844,0.001324,172.217.194.0-255,4320,98891,8,227918
35845,0.00133,172.217.194.0-255,5738,104629,8,227918
35846,0.001333,172.31.36.0-255,66,104695,8,227918
35847,0.00135,172.217.194.0-255,2184,106879,8,227918
35848,0.001358,172.31.36.0-255,66,106945,8,227918
35849,0.001394,172.217.194.0-255,2902,109847,8,227918
35850,0.001398,172.217.194.0-255,2902,112749,8,227918
35851,0.001405,172.31.36.0-255,66,112815,8,227918
35852,0.00141,172.217.194.0-255,1484,114299,8,227918
35853,0.001413,172.217.194.0-255,1484,115783,8,227918
35854,0.001419,172.31.36.0-255,66,115849,8,227918
35855,0.00145,172.217.194.0-255,7156,123005,8,227918
35856,0.001462,172.31.36.0-255,66,123071,8,227918
35857,0.001475,172.31.36.0-255,66,123137,8,227918
35858,0.001668,172.217.194.0-255,1484,124621,8,227918
35859,0.001672,172.217.194.0-255,1484,126105,8,227918
35860,0.001676,172.31.36.0-255,66,126171,8,227918
35861,0.001694,172.217.194.0-255,1484,127655,8,227918
35862,0.001701,172.217.194.0-255,5738,133393,8,227918
35863,0.001705,172.31.36.0-255,66,133459,8,227918
35864,0.001738,172.31.36.0-255,66,133525,8,227918
35865,0.00177,172.217.194.0-255,1484,135009,8,227918
35866,0.001795,172.31.36.0-255,66,135075,8,227918
35867,0.001924,172.217.194.0-255,1484,136559,8,227918
35868,0.001928,172.217.194.0-255,1484,138043,8,227918
35869,0.001931,172.31.36.0-255,66,138109,8,227918
35870,0.001958,172.217.194.0-255,1484,139593,8,227918
35871,0.001965,172.217.194.0-255,5738,145331,8,227918
35872,0.001969,172.217.194.0-255,4320,149651,8,227918
35873,0.001971,172.31.36.0-255,66,149717,8,227918
35874,0.001976,172.31.36.0-255,66,149783,8,227918
35875,0.002029,172.31.36.0-255,66,149849,8,227918
35876,0.002033,172.31.36.0-255,66,149915,8,227918
35877,0.002064,172.217.194.0-255,6438,156353,8,227918
35878,0.00207,172.31.36.0-255,66,156419,8,227918
35879,0.002096,172.31.36.0-255,66,156485,8,227918
35880,0.002102,172.217.194.0-255,4320,160805,8,227918
35881,0.002102,172.31.36.0-255,66,160871,8,227918
35882,0.002108,172.217.194.0-255,5738,166609,8,227918
35883,0.002116,172.31.36.0-255,66,166675,8,227918
35884,0.002176,172.217.194.0-255,7156,173831,8,227918
35885,0.002183,172.31.36.0-255,66,173897,8,227918
35886,0.002199,172.217.194.0-255,4320,178217,8,227918
35887,0.002206,172.217.194.0-255,7156,185373,8,227918
35888,0.002211,172.217.194.0-255,5020,190393,8,227918
35889,0.002215,172.31.36.0-255,66,190459,8,227918
35890,0.002254,172.217.194.0-255,5738,196197,8,227918
35891,0.002258,172.31.36.0-255,66,196263,8,227918
35892,0.002263,172.217.194.0-255,2902,199165,8,227918
35893,0.002288,172.31.36.0-255,66,199231,8,227918
35894,0.002304,172.217.194.0-255,4320,203551,8,227918
35895,0.002311,172.217.194.0-255,5738,209289,8,227918
35896,0.002311,172.31.36.0-255,66,209355,8,227918
35897,0.002324,172.31.36.0-255,66,209421,8,227918
35898,0.002359,172.217.194.0-255,2902,212323,8,227918
35899,0.002361,172.31.36.0-255,66,212389,8,227918
35900,0.002374,172.31.36.0-255,66,212455,8,227918
35901,0.002415,172.31.36.0-255,66,212521,8,227918
35902,0.00242,172.31.36.0-255,66,212587,8,227918
35903,0.002444,172.31.36.0-255,66,212653,8,227918
35904,0.002458,172.217.194.0-255,766,213419,8,227918
35905,0.002467,172.217.194.0-255,1484,214903,8,227918
35906,0.00247,172.217.194.0-255,1484,216387,8,227918
35907,0.002482,172.31.36.0-255,66,216453,8,227918
35908,0.002491,172.217.194.0-255,2902,219355,8,227918
35909,0.0025,172.31.36.0-255,66,219421,8,227918
35910,0.002502,172.217.194.0-255,3804,223225,8,227918
35911,0.002518,172.31.36.0-255,66,223291,8,227918
35912,0.002553,172.217.194.0-255,105,223396,8,227918
35913,0.003808,172.31.36.0-255,66,223462,8,227918
35914,0.003835,172.31.36.0-255,105,223567,8,227918
35915,0.00638,172.217.194.0-255,66,223633,8,227918
35916,0.024314,172.31.36.0-255,167,223800,8,227918
35917,0.024364,172.31.36.0-255,1112,224912,8,227918
35918,0.024384,172.31.36.0-255,1514,226426,8,227918
35919,0.024385,172.31.36.0-255,1294,227720,8,227918
35920,0.025847,104.244.42.0-255,66,227786,8,227918
35921,0.025882,104.244.42.0-255,66,227852,8,227918
35922,0.025928,104.244.42.0-255,66,227918,8,227918
35923,0.0,172.217.194.0-255,153,153,8,306050
35924,3.2e-05,172.31.36.0-255,66,219,8,306050
35925,3.9e-05,172.217.194.0-255,1484,1703,8,306050
35926,4.4e-05,172.31.36.0-255,66,1769,8,306050
35927,5.1e-05,172.217.194.0-255,2902,4671,8,306050
35928,5.4e-05,172.31.36.0-255,66,4737,8,306050
35929,6.1e-05,172.217.194.0-255,7156,11893,8,306050
35930,6.4e-05,172.31.36.0-255,66,11959,8,306050
35931,6.8e-05,172.217.194.0-255,2085,14044,8,306050
35932,7.1e-05,172.31.36.0-255,66,14110,8,306050
35933,0.00011,172.217.194.0-255,2902,17012,8,306050
35934,0.000114,172.31.36.0-255,66,17078,8,306050
35935,0.00012,172.217.194.0-255,5738,22816,8,306050
35936,0.000123,172.31.36.0-255,66,22882,8,306050
35937,0.000183,172.31.36.0-255,66,22948,8,306050
35938,0.000215,172.217.194.0-255,2902,25850,8,306050
35939,0.000218,172.31.36.0-255,66,25916,8,306050
35940,0.00024,172.217.194.0-255,1484,27400,8,306050
35941,0.000243,172.31.36.0-255,66,27466,8,306050
35942,0.000249,172.217.194.0-255,5738,33204,8,306050
35943,0.000251,172.31.36.0-255,66,33270,8,306050
35944,0.000274,172.217.194.0-255,1484,34754,8,306050
35945,0.000277,172.31.36.0-255,66,34820,8,306050
35946,0.000308,172.31.36.0-255,66,34886,8,306050
35947,0.000321,172.31.36.0-255,66,34952,8,306050
35948,0.000323,172.217.194.0-255,1377,36329,8,306050
35949,0.000325,172.31.36.0-255,66,36395,8,306050
35950,0.000351,172.217.194.0-255,435,36830,8,306050
35951,0.000353,172.31.36.0-255,66,36896,8,306050
35952,0.000579,172.217.194.0-255,1484,38380,8,306050
35953,0.000585,172.217.194.0-255,2902,41282,8,306050
35954,0.000597,172.31.36.0-255,66,41348,8,306050
35955,0.000608,172.217.194.0-255,4320,45668,8,306050
35956,0.00061,172.31.36.0-255,66,45734,8,306050
35957,0.000626,172.217.194.0-255,1484,47218,8,306050
35958,0.000632,172.217.194.0-255,5738,52956,8,306050
35959,0.000637,172.31.36.0-255,66,53022,8,306050
35960,0.000644,172.217.194.0-255,2902,55924,8,306050
35961,0.000651,172.31.36.0-255,66,55990,8,306050
35962,0.00068,172.217.194.0-255,4320,60310,8,306050
35963,0.000691,172.31.36.0-255,66,60376,8,306050
35964,0.000721,172.31.36.0-255,66,60442,8,306050
35965,0.001079,172.217.194.0-255,1484,61926,8,306050
35966,0.001085,172.217.194.0-255,2902,64828,8,306050
35967,0.001089,172.31.36.0-255,66,64894,8,306050
35968,0.001096,172.217.194.0-255,5738,70632,8,306050
35969,0.001116,172.31.36.0-255,66,70698,8,306050
35970,0.00113,172.217.194.0-255,1484,72182,8,306050
35971,0.001133,172.31.36.0-255,66,72248,8,306050
35972,0.001147,172.217.194.0-255,5738,77986,8,306050
35973,0.001159,172.31.36.0-255,66,78052,8,306050
35974,0.001176,172.217.194.0-255,1484,79536,8,306050
35975,0.001192,172.217.194.0-255,2184,81720,8,306050
35976,0.001196,172.31.36.0-255,66,81786,8,306050
35977,0.001805,172.217.194.0-255,1484,83270,8,306050
35978,0.001815,172.217.194.0-255,2902,86172,8,306050
35979,0.001819,172.31.36.0-255,66,86238,8,306050
35980,0.001827,172.217.194.0-255,5738,91976,8,306050
35981,0.001844,172.217.194.0-255,5738,97714,8,306050
35982,0.00186,172.217.194.0-255,7156,104870,8,306050
35983,0.001891,172.217.194.0-255,1484,106354,8,306050
35984,0.00195,172.217.194.0-255,1484,107838,8,306050
35985,0.001966,172.217.194.0-255,2902,110740,8,306050
35986,0.001969,172.217.194.0-255,2902,113642,8,306050
35987,0.001982,172.217.194.0-255,2902,116544,8,306050
35988,0.001988,172.217.194.0-255,5738,122282,8,306050
35989,0.002002,172.217.194.0-255,1484,123766,8,306050
35990,0.002008,172.217.194.0-255,4320,128086,8,306050
35991,0.002037,172.217.194.0-255,2184,130270,8,306050
35992,0.006695,172.31.36.0-255,66,130336,8,306050
35993,0.008731,172.217.194.0-255,2902,133238,8,306050
35994,0.008738,172.31.36.0-255,66,133304,8,306050
35995,0.008762,172.217.194.0-255,2902,136206,8,306050
35996,0.010751,172.217.194.0-255,2902,139108,8,306050
35997,0.011922,172.31.36.0-255,66,139174,8,306050
35998,0.013986,172.217.194.0-255,5738,144912,8,306050
35999,0.014007,172.31.36.0-255,66,144978,8,306050
36000,0.016046,172.217.194.0-255,5738,150716,8,306050
36001,0.016059,172.31.36.0-255,66,150782,8,306050
36002,0.018138,172.217.194.0-255,5738,156520,8,306050
36003,0.018147,172.31.36.0-255,66,156586,8,306050
36004,0.020193,172.217.194.0-255,5738,162324,8,306050
36005,0.020201,172.31.36.0-255,66,162390,8,306050
36006,0.022225,172.217.194.0-255,5738,168128,8,306050
36007,0.022233,172.31.36.0-255,66,168194,8,306050
36008,0.024279,172.217.194.0-255,5738,173932,8,306050
36009,0.024288,172.31.36.0-255,66,173998,8,306050
36010,0.026324,172.217.194.0-255,5738,179736,8,306050
36011,0.026333,172.31.36.0-255,66,179802,8,306050
36012,0.028393,172.217.194.0-255,5738,185540,8,306050
36013,0.028406,172.31.36.0-255,66,185606,8,306050
36014,0.030459,172.217.194.0-255,5738,191344,8,306050
36015,0.030476,172.31.36.0-255,66,191410,8,306050
36016,0.032524,172.217.194.0-255,5738,197148,8,306050
36017,0.032536,172.31.36.0-255,66,197214,8,306050
36018,0.034577,172.217.194.0-255,5738,202952,8,306050
36019,0.034594,172.31.36.0-255,66,203018,8,306050
36020,0.036632,172.217.194.0-255,5738,208756,8,306050
36021,0.036644,172.31.36.0-255,66,208822,8,306050
36022,0.038696,172.217.194.0-255,5738,214560,8,306050
36023,0.038709,172.31.36.0-255,66,214626,8,306050
36024,0.040737,172.217.194.0-255,5738,220364,8,306050
36025,0.040745,172.31.36.0-255,66,220430,8,306050
36026,0.042774,172.217.194.0-255,5738,226168,8,306050
36027,0.042781,172.31.36.0-255,66,226234,8,306050
36028,0.04481,172.217.194.0-255,5738,231972,8,306050
36029,0.044817,172.31.36.0-255,66,232038,8,306050
36030,0.046839,172.217.194.0-255,5738,237776,8,306050
36031,0.046846,172.31.36.0-255,66,237842,8,306050
36032,0.048903,172.217.194.0-255,5738,243580,8,306050
36033,0.048928,172.31.36.0-255,66,243646,8,306050
36034,0.050242,172.31.36.0-255,172,243818,8,306050
36035,0.050272,172.31.36.0-255,1109,244927,8,306050
36036,0.050315,172.31.36.0-255,1514,246441,8,306050
36037,0.050317,172.31.36.0-255,1371,247812,8,306050
36038,0.050959,172.217.194.0-255,5738,253550,8,306050
36039,0.050966,172.31.36.0-255,66,253616,8,306050
36040,0.051726,104.244.42.0-255,66,253682,8,306050
36041,0.051753,104.244.42.0-255,66,253748,8,306050
36042,0.051811,104.244.42.0-255,66,253814,8,306050
36043,0.053007,172.217.194.0-255,5738,259552,8,306050
36044,0.053013,172.31.36.0-255,66,259618,8,306050
36045,0.055054,172.217.194.0-255,5738,265356,8,306050
36046,0.055062,172.31.36.0-255,66,265422,8,306050
36047,0.057114,172.217.194.0-255,5738,271160,8,306050
36048,0.057119,172.31.36.0-255,66,271226,8,306050
36049,0.059138,172.217.194.0-255,5738,276964,8,306050
36050,0.059143,172.31.36.0-255,66,277030,8,306050
36051,0.061172,172.217.194.0-255,5738,282768,8,306050
36052,0.061177,172.31.36.0-255,66,282834,8,306050
36053,0.063194,172.217.194.0-255,5738,288572,8,306050
36054,0.063201,172.31.36.0-255,66,288638,8,306050
36055,0.065219,172.217.194.0-255,5738,294376,8,306050
36056,0.065225,172.31.36.0-255,66,294442,8,306050
36057,0.067254,172.217.194.0-255,5738,300180,8,306050
36058,0.06726,172.31.36.0-255,66,300246,8,306050
36059,0.069312,172.217.194.0-255,5738,305984,8,306050
36060,0.069318,172.31.36.0-255,66,306050,8,306050
36061,0.0,74.125.24.0-255,152,152,8,300600
36062,2.1e-05,172.31.36.0-255,66,218,8,300600
36063,2.8e-05,74.125.24.0-255,1484,1702,8,300600
36064,3.1e-05,172.31.36.0-255,66,1768,8,300600
36065,3.7e-05,74.125.24.0-255,2902,4670,8,300600
36066,4.7e-05,172.31.36.0-255,66,4736,8,300600
36067,5.4e-05,74.125.24.0-255,5738,10474,8,300600
36068,5.7e-05,172.31.36.0-255,66,10540,8,300600
36069,8.2e-05,74.125.24.0-255,3419,13959,8,300600
36070,8.5e-05,172.31.36.0-255,66,14025,8,300600
36071,0.000116,74.125.24.0-255,1484,15509,8,300600
36072,0.000119,172.31.36.0-255,66,15575,8,300600
36073,0.000143,74.125.24.0-255,2902,18477,8,300600
36074,0.000145,172.31.36.0-255,66,18543,8,300600
36075,0.000151,74.125.24.0-255,5738,24281,8,300600
36076,0.000153,172.31.36.0-255,66,24347,8,300600
36077,0.000186,74.125.24.0-255,6797,31144,8,300600
36078,0.000189,172.31.36.0-255,66,31210,8,300600
36079,0.000325,74.125.24.0-255,1484,32694,8,300600
36080,0.00033,172.31.36.0-255,66,32760,8,300600
36081,0.000336,74.125.24.0-255,2902,35662,8,300600
36082,0.000338,172.31.36.0-255,66,35728,8,300600
36083,0.000352,74.125.24.0-255,5738,41466,8,300600
36084,0.000355,172.31.36.0-255,66,41532,8,300600
36085,0.000391,74.125.24.0-255,6797,48329,8,300600
36086,0.000394,172.31.36.0-255,66,48395,8,300600
36087,0.000428,74.125.24.0-255,1484,49879,8,300600
36088,0.00043,172.31.36.0-255,66,49945,8,300600
36089,0.000435,74.125.24.0-255,2902,52847,8,300600
36090,0.000437,172.31.36.0-255,66,52913,8,300600
36091,0.000441,74.125.24.0-255,1484,54397,8,300600
36092,0.000448,172.31.36.0-255,66,54463,8,300600
36093,0.000485,74.125.24.0-255,4320,58783,8,300600
36094,0.000488,172.31.36.0-255,66,58849,8,300600
36095,0.000494,74.125.24.0-255,5738,64587,8,300600
36096,0.000496,172.31.36.0-255,66,64653,8,300600
36097,0.000514,74.125.24.0-255,1125,65778,8,300600
36098,0.001038,74.125.24.0-255,414,66192,8,300600
36099,0.001063,74.125.24.0-255,330,66522,8,300600
36100,0.001067,172.31.36.0-255,66,66588,8,300600
36101,0.001704,74.125.24.0-255,1484,68072,8,300600
36102,0.001717,74.125.24.0-255,2902,70974,8,300600
36103,0.001721,172.31.36.0-255,66,71040,8,300600
36104,0.00173,74.125.24.0-255,5738,76778,8,300600
36105,0.001732,172.31.36.0-255,66,76844,8,300600
36106,0.001764,74.125.24.0-255,2902,79746,8,300600
36107,0.001766,172.31.36.0-255,66,79812,8,300600
36108,0.001772,74.125.24.0-255,4320,84132,8,300600
36109,0.001774,172.31.36.0-255,66,84198,8,300600
36110,0.001801,74.125.24.0-255,5738,89936,8,300600
36111,0.001804,172.31.36.0-255,66,90002,8,300600
36112,0.001854,172.31.36.0-255,66,90068,8,300600
36113,0.001881,74.125.24.0-255,2184,92252,8,300600
36114,0.001883,172.31.36.0-255,66,92318,8,300600
36115,0.00382,74.125.24.0-255,2902,95220,8,300600
36116,0.003827,172.31.36.0-255,66,95286,8,300600
36117,0.003855,74.125.24.0-255,2902,98188,8,300600
36118,0.003857,172.31.36.0-255,66,98254,8,300600
36119,0.005809,74.125.24.0-255,2902,101156,8,300600
36120,0.005816,172.31.36.0-255,66,101222,8,300600
36121,0.005844,74.125.24.0-255,2902,104124,8,300600
36122,0.005846,172.31.36.0-255,66,104190,8,300600
36123,0.007784,74.125.24.0-255,2902,107092,8,300600
36124,0.00779,172.31.36.0-255,66,107158,8,300600
36125,0.007816,74.125.24.0-255,2902,110060,8,300600
36126,0.007819,172.31.36.0-255,66,110126,8,300600
36127,0.009751,74.125.24.0-255,2902,113028,8,300600
36128,0.009759,172.31.36.0-255,66,113094,8,300600
36129,0.009793,74.125.24.0-255,2902,115996,8,300600
36130,0.009796,172.31.36.0-255,66,116062,8,300600
36131,0.011729,74.125.24.0-255,2902,118964,8,300600
36132,0.011736,172.31.36.0-255,66,119030,8,300600
36133,0.011775,74.125.24.0-255,2902,121932,8,300600
36134,0.011778,172.31.36.0-255,66,121998,8,300600
36135,0.013729,74.125.24.0-255,5738,127736,8,300600
36136,0.013736,172.31.36.0-255,66,127802,8,300600
36137,0.015718,74.125.24.0-255,5738,133540,8,300600
36138,0.015725,172.31.36.0-255,66,133606,8,300600
36139,0.017692,74.125.24.0-255,5738,139344,8,300600
36140,0.0177,172.31.36.0-255,66,139410,8,300600
36141,0.019682,74.125.24.0-255,5738,145148,8,300600
36142,0.019688,172.31.36.0-255,66,145214,8,300600
36143,0.02171,74.125.24.0-255,5738,150952,8,300600
36144,0.021716,172.31.36.0-255,66,151018,8,300600
36145,0.023702,74.125.24.0-255,5738,156756,8,300600
36146,0.023709,172.31.36.0-255,66,156822,8,300600
36147,0.025701,74.125.24.0-255,5738,162560,8,300600
36148,0.02571,172.31.36.0-255,66,162626,8,300600
36149,0.027678,74.125.24.0-255,5738,168364,8,300600
36150,0.027684,172.31.36.0-255,66,168430,8,300600
36151,0.029149,172.31.36.0-255,172,168602,8,300600
36152,0.029183,172.31.36.0-255,1110,169712,8,300600
36153,0.029248,172.31.36.0-255,1514,171226,8,300600
36154,0.02925,172.31.36.0-255,1514,172740,8,300600
36155,0.029254,172.31.36.0-255,1514,174254,8,300600
36156,0.029256,172.31.36.0-255,1514,175768,8,300600
36157,0.029274,172.31.36.0-255,1514,177282,8,300600
36158,0.029276,172.31.36.0-255,996,178278,8,300600
36159,0.029668,74.125.24.0-255,5738,184016,8,300600
36160,0.029675,172.31.36.0-255,66,184082,8,300600
36161,0.030719,104.244.42.0-255,66,184148,8,300600
36162,0.030754,104.244.42.0-255,66,184214,8,300600
36163,0.030842,104.244.42.0-255,66,184280,8,300600
36164,0.030848,104.244.42.0-255,66,184346,8,300600
36165,0.031663,74.125.24.0-255,5738,190084,8,300600
36166,0.03167,172.31.36.0-255,66,190150,8,300600
36167,0.033665,74.125.24.0-255,5738,195888,8,300600
36168,0.033673,172.31.36.0-255,66,195954,8,300600
36169,0.035675,74.125.24.0-255,5738,201692,8,300600
36170,0.035684,172.31.36.0-255,66,201758,8,300600
36171,0.037647,74.125.24.0-255,5738,207496,8,300600
36172,0.037655,172.31.36.0-255,66,207562,8,300600
36173,0.03965,74.125.24.0-255,5738,213300,8,300600
36174,0.039658,172.31.36.0-255,66,213366,8,300600
36175,0.041646,74.125.24.0-255,5738,219104,8,300600
36176,0.04166,172.31.36.0-255,66,219170,8,300600
36177,0.043648,74.125.24.0-255,5738,224908,8,300600
36178,0.043656,172.31.36.0-255,66,224974,8,300600
36179,0.045641,74.125.24.0-255,5738,230712,8,300600
36180,0.045648,172.31.36.0-255,66,230778,8,300600
36181,0.047665,74.125.24.0-255,5738,236516,8,300600
36182,0.047672,172.31.36.0-255,66,236582,8,300600
36183,0.047926,172.31.36.0-255,108,236690,8,300600
36184,0.0495,104.244.42.0-255,66,236756,8,300600
36185,0.049642,74.125.24.0-255,5738,242494,8,300600
36186,0.04965,172.31.36.0-255,66,242560,8,300600
36187,0.051625,74.125.24.0-255,5738,248298,8,300600
36188,0.051633,172.31.36.0-255,66,248364,8,300600
36189,0.053596,74.125.24.0-255,5738,254102,8,300600
36190,0.053604,172.31.36.0-255,66,254168,8,300600
36191,0.05558,74.125.24.0-255,5738,259906,8,300600
36192,0.055593,172.31.36.0-255,66,259972,8,300600
36193,0.057585,74.125.24.0-255,5738,265710,8,300600
36194,0.057594,172.31.36.0-255,66,265776,8,300600
36195,0.059575,74.125.24.0-255,5738,271514,8,300600
36196,0.059582,172.31.36.0-255,66,271580,8,300600
36197,0.061583,74.125.24.0-255,5738,277318,8,300600
36198,0.061591,172.31.36.0-255,66,277384,8,300600
36199,0.06355,74.125.24.0-255,5738,283122,8,300600
36200,0.063555,172.31.36.0-255,66,283188,8,300600
36201,0.065533,74.125.24.0-255,5738,288926,8,300600
36202,0.06554,172.31.36.0-255,66,288992,8,300600
36203,0.067504,74.125.24.0-255,5738,294730,8,300600
36204,0.067511,172.31.36.0-255,66,294796,8,300600
36205,0.069506,74.125.24.0-255,5738,300534,8,300600
36206,0.069513,172.31.36.0-255,66,300600,8,300600
36207,0.0,172.217.194.0-255,145,145,8,211047
36208,2.3e-05,172.31.36.0-255,66,211,8,211047
36209,3e-05,172.217.194.0-255,1484,1695,8,211047
36210,3.5e-05,172.31.36.0-255,66,1761,8,211047
36211,4e-05,172.217.194.0-255,2902,4663,8,211047
36212,4.3e-05,172.31.36.0-255,66,4729,8,211047
36213,5.9e-05,172.217.194.0-255,7156,11885,8,211047
36214,6.2e-05,172.31.36.0-255,66,11951,8,211047
36215,6.7e-05,172.217.194.0-255,3439,15390,8,211047
36216,7.2e-05,172.31.36.0-255,66,15456,8,211047
36217,0.000146,172.31.36.0-255,66,15522,8,211047
36218,0.00015,172.217.194.0-255,2543,18065,8,211047
36219,0.000153,172.31.36.0-255,66,18131,8,211047
36220,0.000183,172.217.194.0-255,1484,19615,8,211047
36221,0.000185,172.31.36.0-255,66,19681,8,211047
36222,0.00019,172.217.194.0-255,2902,22583,8,211047
36223,0.000192,172.31.36.0-255,66,22649,8,211047
36224,0.000199,172.217.194.0-255,5738,28387,8,211047
36225,0.000205,172.31.36.0-255,66,28453,8,211047
36226,0.00025,172.31.36.0-255,66,28519,8,211047
36227,0.000261,172.31.36.0-255,66,28585,8,211047
36228,0.000271,172.217.194.0-255,4283,32868,8,211047
36229,0.000273,172.31.36.0-255,66,32934,8,211047
36230,0.000314,172.217.194.0-255,366,33300,8,211047
36231,0.000317,172.31.36.0-255,66,33366,8,211047
36232,0.000486,172.217.194.0-255,1484,34850,8,211047
36233,0.000491,172.31.36.0-255,66,34916,8,211047
36234,0.000497,172.217.194.0-255,2902,37818,8,211047
36235,0.0005,172.31.36.0-255,66,37884,8,211047
36236,0.000511,172.217.194.0-255,5738,43622,8,211047
36237,0.000514,172.31.36.0-255,66,43688,8,211047
36238,0.000517,172.217.194.0-255,1484,45172,8,211047
36239,0.000559,172.31.36.0-255,66,45238,8,211047
36240,0.000587,172.217.194.0-255,7156,52394,8,211047
36241,0.00059,172.31.36.0-255,66,52460,8,211047
36242,0.000618,172.217.194.0-255,4469,56929,8,211047
36243,0.000621,172.31.36.0-255,66,56995,8,211047
36244,0.000765,172.217.194.0-255,1484,58479,8,211047
36245,0.000771,172.217.194.0-255,2902,61381,8,211047
36246,0.000775,172.31.36.0-255,66,61447,8,211047
36247,0.000781,172.217.194.0-255,4320,65767,8,211047
36248,0.000784,172.31.36.0-255,66,65833,8,211047
36249,0.000812,172.217.194.0-255,1484,67317,8,211047
36250,0.000818,172.217.194.0-255,4320,71637,8,211047
36251,0.000821,172.31.36.0-255,66,71703,8,211047
36252,0.000855,172.31.36.0-255,66,71769,8,211047
36253,0.000862,172.217.194.0-255,5738,77507,8,211047
36254,0.000865,172.31.36.0-255,66,77573,8,211047
36255,0.000893,172.217.194.0-255,5020,82593,8,211047
36256,0.000896,172.31.36.0-255,66,82659,8,211047
36257,0.001279,172.217.194.0-255,1484,84143,8,211047
36258,0.001285,172.217.194.0-255,2902,87045,8,211047
36259,0.001288,172.31.36.0-255,66,87111,8,211047
36260,0.001296,172.217.194.0-255,5738,92849,8,211047
36261,0.001299,172.31.36.0-255,66,92915,8,211047
36262,0.001347,172.31.36.0-255,66,92981,8,211047
36263,0.001353,172.217.194.0-255,4320,97301,8,211047
36264,0.001355,172.31.36.0-255,66,97367,8,211047
36265,0.001394,172.217.194.0-255,4320,101687,8,211047
36266,0.001396,172.31.36.0-255,66,101753,8,211047
36267,0.001434,172.217.194.0-255,5020,106773,8,211047
36268,0.001437,172.31.36.0-255,66,106839,8,211047
36269,0.001448,172.31.36.0-255,66,106905,8,211047
36270,0.001502,172.31.36.0-255,66,106971,8,211047
36271,0.001525,172.217.194.0-255,1484,108455,8,211047
36272,0.00153,172.217.194.0-255,2184,110639,8,211047
36273,0.001532,172.31.36.0-255,66,110705,8,211047
36274,0.001541,172.217.194.0-255,2902,113607,8,211047
36275,0.001543,172.31.36.0-255,66,113673,8,211047
36276,0.00155,172.217.194.0-255,7156,120829,8,211047
36277,0.001553,172.31.36.0-255,66,120895,8,211047
36278,0.001559,172.217.194.0-255,5738,126633,8,211047
36279,0.001561,172.31.36.0-255,66,126699,8,211047
36280,0.001607,172.31.36.0-255,66,126765,8,211047
36281,0.001612,172.217.194.0-255,2902,129667,8,211047
36282,0.001614,172.31.36.0-255,66,129733,8,211047
36283,0.001642,172.217.194.0-255,766,130499,8,211047
36284,0.001676,172.217.194.0-255,1484,131983,8,211047
36285,0.001679,172.31.36.0-255,66,132049,8,211047
36286,0.001683,172.217.194.0-255,1484,133533,8,211047
36287,0.001709,172.217.194.0-255,4320,137853,8,211047
36288,0.001712,172.31.36.0-255,66,137919,8,211047
36289,0.001715,172.217.194.0-255,1484,139403,8,211047
36290,0.001746,172.31.36.0-255,66,139469,8,211047
36291,0.001799,172.217.194.0-255,2184,141653,8,211047
36292,0.001803,172.31.36.0-255,66,141719,8,211047
36293,0.001806,172.31.36.0-255,66,141785,8,211047
36294,0.00183,172.217.194.0-255,2902,144687,8,211047
36295,0.001837,172.31.36.0-255,66,144753,8,211047
36296,0.001844,172.217.194.0-255,7156,151909,8,211047
36297,0.001847,172.31.36.0-255,66,151975,8,211047
36298,0.001857,172.31.36.0-255,66,152041,8,211047
36299,0.001881,172.217.194.0-255,4320,156361,8,211047
36300,0.001883,172.31.36.0-255,66,156427,8,211047
36301,0.001932,172.31.36.0-255,66,156493,8,211047
36302,0.001951,172.31.36.0-255,66,156559,8,211047
36303,0.001956,172.217.194.0-255,2902,159461,8,211047
36304,0.001958,172.31.36.0-255,66,159527,8,211047
36305,0.002008,172.31.36.0-255,66,159593,8,211047
36306,0.002035,172.217.194.0-255,766,160359,8,211047
36307,0.002041,172.31.36.0-255,66,160425,8,211047
36308,0.004018,172.217.194.0-255,5738,166163,8,211047
36309,0.004025,172.31.36.0-255,66,166229,8,211047
36310,0.006031,172.217.194.0-255,5738,171967,8,211047
36311,0.006035,172.31.36.0-255,66,172033,8,211047
36312,0.008001,172.217.194.0-255,5738,177771,8,211047
36313,0.008008,172.31.36.0-255,66,177837,8,211047
36314,0.00996,172.217.194.0-255,5738,183575,8,211047
36315,0.009967,172.31.36.0-255,66,183641,8,211047
36316,0.011925,172.217.194.0-255,5738,189379,8,211047
36317,0.011933,172.31.36.0-255,66,189445,8,211047
36318,0.01392,172.217.194.0-255,5738,195183,8,211047
36319,0.013928,172.31.36.0-255,66,195249,8,211047
36320,0.015893,172.217.194.0-255,5738,200987,8,211047
36321,0.015901,172.31.36.0-255,66,201053,8,211047
36322,0.017911,172.217.194.0-255,1985,203038,8,211047
36323,0.017919,172.31.36.0-255,66,203104,8,211047
36324,0.02316,172.31.36.0-255,105,203209,8,211047
36325,0.025096,172.217.194.0-255,66,203275,8,211047
36326,0.057104,172.31.36.0-255,172,203447,8,211047
36327,0.057136,172.31.36.0-255,1112,204559,8,211047
36328,0.057223,172.31.36.0-255,1514,206073,8,211047
36329,0.057224,172.31.36.0-255,1514,207587,8,211047
36330,0.057226,172.31.36.0-255,1514,209101,8,211047
36331,0.057227,172.31.36.0-255,1514,210615,8,211047
36332,0.057254,172.31.36.0-255,168,210783,8,211047
36333,0.058629,104.244.42.0-255,66,210849,8,211047
36334,0.058665,104.244.42.0-255,66,210915,8,211047
36335,0.058814,104.244.42.0-255,66,210981,8,211047
36336,0.058818,104.244.42.0-255,66,211047,8,211047
36337,0.0,74.125.200.0-255,226,226,8,197104
36338,3.6e-05,172.31.36.0-255,66,292,8,197104
36339,4.3e-05,74.125.200.0-255,1484,1776,8,197104
36340,4.7e-05,172.31.36.0-255,66,1842,8,197104
36341,5.3e-05,74.125.200.0-255,4320,6162,8,197104
36342,5.5e-05,172.31.36.0-255,66,6228,8,197104
36343,0.000241,172.31.36.0-255,66,6294,8,197104
36344,0.00054,74.125.200.0-255,1484,7778,8,197104
36345,0.000546,172.31.36.0-255,66,7844,8,197104
36346,0.000602,74.125.200.0-255,2902,10746,8,197104
36347,0.000606,172.31.36.0-255,66,10812,8,197104
36348,0.000719,74.125.200.0-255,5738,16550,8,197104
36349,0.000724,172.31.36.0-255,66,16616,8,197104
36350,0.000947,74.125.200.0-255,5738,22354,8,197104
36351,0.000953,172.31.36.0-255,66,22420,8,197104
36352,0.000977,74.125.200.0-255,7156,29576,8,197104
36353,0.000981,172.31.36.0-255,66,29642,8,197104
36354,0.002611,74.125.200.0-255,2902,32544,8,197104
36355,0.002614,172.31.36.0-255,66,32610,8,197104
36356,0.003548,74.125.200.0-255,2902,35512,8,197104
36357,0.003554,172.31.36.0-255,66,35578,8,197104
36358,0.00519,74.125.200.0-255,2902,38480,8,197104
36359,0.005196,172.31.36.0-255,66,38546,8,197104
36360,0.006126,74.125.200.0-255,2902,41448,8,197104
36361,0.006133,172.31.36.0-255,66,41514,8,197104
36362,0.007763,74.125.200.0-255,2902,44416,8,197104
36363,0.007769,172.31.36.0-255,66,44482,8,197104
36364,0.0087,74.125.200.0-255,2902,47384,8,197104
36365,0.008708,172.31.36.0-255,66,47450,8,197104
36366,0.010337,74.125.200.0-255,2902,50352,8,197104
36367,0.010343,172.31.36.0-255,66,50418,8,197104
36368,0.011277,74.125.200.0-255,2902,53320,8,197104
36369,0.011283,172.31.36.0-255,66,53386,8,197104
36370,0.012913,74.125.200.0-255,2902,56288,8,197104
36371,0.01292,172.31.36.0-255,66,56354,8,197104
36372,0.013846,74.125.200.0-255,2902,59256,8,197104
36373,0.013853,172.31.36.0-255,66,59322,8,197104
36374,0.015355,172.31.36.0-255,164,59486,8,197104
36375,0.015385,172.31.36.0-255,1118,60604,8,197104
36376,0.015428,172.31.36.0-255,1514,62118,8,197104
36377,0.015429,172.31.36.0-255,1514,63632,8,197104
36378,0.015435,172.31.36.0-255,1514,65146,8,197104
36379,0.015436,172.31.36.0-255,1514,66660,8,197104
36380,0.015454,172.31.36.0-255,1514,68174,8,197104
36381,0.015456,172.31.36.0-255,868,69042,8,197104
36382,0.015484,74.125.200.0-255,2902,71944,8,197104
36383,0.015488,172.31.36.0-255,66,72010,8,197104
36384,0.016414,74.125.200.0-255,2902,74912,8,197104
36385,0.016422,172.31.36.0-255,66,74978,8,197104
36386,0.016902,104.244.42.0-255,66,75044,8,197104
36387,0.016914,104.244.42.0-255,66,75110,8,197104
36388,0.017008,104.244.42.0-255,66,75176,8,197104
36389,0.017013,104.244.42.0-255,66,75242,8,197104
36390,0.018053,74.125.200.0-255,2902,78144,8,197104
36391,0.01806,172.31.36.0-255,66,78210,8,197104
36392,0.018986,74.125.200.0-255,2902,81112,8,197104
36393,0.018992,172.31.36.0-255,66,81178,8,197104
36394,0.020622,74.125.200.0-255,2902,84080,8,197104
36395,0.020629,172.31.36.0-255,66,84146,8,197104
36396,0.021559,74.125.200.0-255,2902,87048,8,197104
36397,0.021565,172.31.36.0-255,66,87114,8,197104
36398,0.023205,74.125.200.0-255,2902,90016,8,197104
36399,0.023212,172.31.36.0-255,66,90082,8,197104
36400,0.024133,74.125.200.0-255,2902,92984,8,197104
36401,0.02414,172.31.36.0-255,66,93050,8,197104
36402,0.025776,74.125.200.0-255,2902,95952,8,197104
36403,0.025784,172.31.36.0-255,66,96018,8,197104
36404,0.026703,74.125.200.0-255,2902,98920,8,197104
36405,0.026708,172.31.36.0-255,66,98986,8,197104
36406,0.028353,74.125.200.0-255,2902,101888,8,197104
36407,0.028361,172.31.36.0-255,66,101954,8,197104
36408,0.029286,74.125.200.0-255,2902,104856,8,197104
36409,0.029294,172.31.36.0-255,66,104922,8,197104
36410,0.030918,74.125.200.0-255,2902,107824,8,197104
36411,0.030925,172.31.36.0-255,66,107890,8,197104
36412,0.031849,74.125.200.0-255,2902,110792,8,197104
36413,0.031854,172.31.36.0-255,66,110858,8,197104
36414,0.033498,74.125.200.0-255,2902,113760,8,197104
36415,0.033505,172.31.36.0-255,66,113826,8,197104
36416,0.034416,74.125.200.0-255,2902,116728,8,197104
36417,0.034423,172.31.36.0-255,66,116794,8,197104
36418,0.03609,74.125.200.0-255,2902,119696,8,197104
36419,0.036097,172.31.36.0-255,66,119762,8,197104
36420,0.036118,172.31.36.0-255,108,119870,8,197104
36421,0.037003,74.125.200.0-255,2902,122772,8,197104
36422,0.037008,172.31.36.0-255,66,122838,8,197104
36423,0.037638,104.244.42.0-255,66,122904,8,197104
36424,0.038665,74.125.200.0-255,2902,125806,8,197104
36425,0.03867,172.31.36.0-255,66,125872,8,197104
36426,0.03957,74.125.200.0-255,2902,128774,8,197104
36427,0.039576,172.31.36.0-255,66,128840,8,197104
36428,0.041232,74.125.200.0-255,2902,131742,8,197104
36429,0.041239,172.31.36.0-255,66,131808,8,197104
36430,0.042149,74.125.200.0-255,2902,134710,8,197104
36431,0.042155,172.31.36.0-255,66,134776,8,197104
36432,0.043799,74.125.200.0-255,2902,137678,8,197104
36433,0.043806,172.31.36.0-255,66,137744,8,197104
36434,0.044733,74.125.200.0-255,2902,140646,8,197104
36435,0.04474,172.31.36.0-255,66,140712,8,197104
36436,0.046368,74.125.200.0-255,2902,143614,8,197104
36437,0.046374,172.31.36.0-255,66,143680,8,197104
36438,0.047316,74.125.200.0-255,2902,146582,8,197104
36439,0.047322,172.31.36.0-255,66,146648,8,197104
36440,0.048934,74.125.200.0-255,2902,149550,8,197104
36441,0.048943,172.31.36.0-255,66,149616,8,197104
36442,0.049881,74.125.200.0-255,2902,152518,8,197104
36443,0.049886,172.31.36.0-255,66,152584,8,197104
36444,0.051504,74.125.200.0-255,2902,155486,8,197104
36445,0.051511,172.31.36.0-255,66,155552,8,197104
36446,0.052503,74.125.200.0-255,2902,158454,8,197104
36447,0.05251,172.31.36.0-255,66,158520,8,197104
36448,0.054076,74.125.200.0-255,2902,161422,8,197104
36449,0.054081,172.31.36.0-255,66,161488,8,197104
36450,0.055072,74.125.200.0-255,2902,164390,8,197104
36451,0.055078,172.31.36.0-255,66,164456,8,197104
36452,0.056644,74.125.200.0-255,2902,167358,8,197104
36453,0.056649,172.31.36.0-255,66,167424,8,197104
36454,0.057632,74.125.200.0-255,2902,170326,8,197104
36455,0.057637,172.31.36.0-255,66,170392,8,197104
36456,0.059214,74.125.200.0-255,2902,173294,8,197104
36457,0.059219,172.31.36.0-255,66,173360,8,197104
36458,0.060209,74.125.200.0-255,2902,176262,8,197104
36459,0.060215,172.31.36.0-255,66,176328,8,197104
36460,0.061796,74.125.200.0-255,2902,179230,8,197104
36461,0.061803,172.31.36.0-255,66,179296,8,197104
36462,0.062782,74.125.200.0-255,2902,182198,8,197104
36463,0.062788,172.31.36.0-255,66,182264,8,197104
36464,0.064372,74.125.200.0-255,2902,185166,8,197104
36465,0.064379,172.31.36.0-255,66,185232,8,197104
36466,0.065367,74.125.200.0-255,2902,188134,8,197104
36467,0.065373,172.31.36.0-255,66,188200,8,197104
36468,0.066941,74.125.200.0-255,2902,191102,8,197104
36469,0.066948,172.31.36.0-255,66,191168,8,197104
36470,0.067932,74.125.200.0-255,2902,194070,8,197104
36471,0.067936,172.31.36.0-255,66,194136,8,197104
36472,0.069563,74.125.200.0-255,2902,197038,8,197104
36473,0.069569,172.31.36.0-255,66,197104,8,197104
36474,0.0,74.125.24.0-255,153,153,8,154202
36475,3.4e-05,172.31.36.0-255,66,219,8,154202
36476,4.2e-05,74.125.24.0-255,1484,1703,8,154202
36477,4.7e-05,172.31.36.0-255,66,1769,8,154202
36478,5.2e-05,74.125.24.0-255,2902,4671,8,154202
36479,5.4e-05,172.31.36.0-255,66,4737,8,154202
36480,6.8e-05,74.125.24.0-255,4320,9057,8,154202
36481,7e-05,172.31.36.0-255,66,9123,8,154202
36482,8.4e-05,172.31.36.0-255,66,9189,8,154202
36483,9.6e-05,172.31.36.0-255,66,9255,8,154202
36484,0.000168,74.125.24.0-255,1484,10739,8,154202
36485,0.000171,172.31.36.0-255,66,10805,8,154202
36486,0.000179,74.125.24.0-255,2902,13707,8,154202
36487,0.000181,172.31.36.0-255,66,13773,8,154202
36488,0.000187,74.125.24.0-255,4320,18093,8,154202
36489,0.000195,172.31.36.0-255,66,18159,8,154202
36490,0.000222,74.125.24.0-255,1484,19643,8,154202
36491,0.000225,172.31.36.0-255,66,19709,8,154202
36492,0.000248,172.31.36.0-255,66,19775,8,154202
36493,0.000262,172.31.36.0-255,66,19841,8,154202
36494,0.000265,74.125.24.0-255,131,19972,8,154202
36495,0.000266,172.31.36.0-255,66,20038,8,154202
36496,0.001327,74.125.24.0-255,348,20386,8,154202
36497,0.001335,172.31.36.0-255,66,20452,8,154202
36498,0.001374,74.125.24.0-255,1484,21936,8,154202
36499,0.001377,172.31.36.0-255,66,22002,8,154202
36500,0.001385,74.125.24.0-255,4320,26322,8,154202
36501,0.001387,172.31.36.0-255,66,26388,8,154202
36502,0.001423,172.31.36.0-255,66,26454,8,154202
36503,0.00145,74.125.24.0-255,4320,30774,8,154202
36504,0.001452,172.31.36.0-255,66,30840,8,154202
36505,0.00149,74.125.24.0-255,7156,37996,8,154202
36506,0.001494,172.31.36.0-255,66,38062,8,154202
36507,0.001502,74.125.24.0-255,6438,44500,8,154202
36508,0.001504,172.31.36.0-255,66,44566,8,154202
36509,0.001611,74.125.24.0-255,1484,46050,8,154202
36510,0.001619,74.125.24.0-255,2902,48952,8,154202
36511,0.001623,172.31.36.0-255,66,49018,8,154202
36512,0.001632,74.125.24.0-255,5738,54756,8,154202
36513,0.001634,172.31.36.0-255,66,54822,8,154202
36514,0.001672,172.31.36.0-255,66,54888,8,154202
36515,0.001683,172.31.36.0-255,66,54954,8,154202
36516,0.001706,74.125.24.0-255,218,55172,8,154202
36517,0.001709,74.125.24.0-255,1484,56656,8,154202
36518,0.001711,172.31.36.0-255,66,56722,8,154202
36519,0.001745,172.31.36.0-255,66,56788,8,154202
36520,0.001779,172.31.36.0-255,66,56854,8,154202
36521,0.001791,172.31.36.0-255,66,56920,8,154202
36522,0.002043,74.125.24.0-255,1484,58404,8,154202
36523,0.002048,74.125.24.0-255,2902,61306,8,154202
36524,0.00205,172.31.36.0-255,66,61372,8,154202
36525,0.002078,74.125.24.0-255,5738,67110,8,154202
36526,0.002081,172.31.36.0-255,66,67176,8,154202
36527,0.002084,74.125.24.0-255,1484,68660,8,154202
36528,0.002116,172.31.36.0-255,66,68726,8,154202
36529,0.002152,172.31.36.0-255,66,68792,8,154202
36530,0.002232,74.125.24.0-255,1484,70276,8,154202
36531,0.002246,74.125.24.0-255,2902,73178,8,154202
36532,0.002249,172.31.36.0-255,66,73244,8,154202
36533,0.002254,74.125.24.0-255,4320,77564,8,154202
36534,0.002257,172.31.36.0-255,66,77630,8,154202
36535,0.002284,74.125.24.0-255,1484,79114,8,154202
36536,0.002298,172.31.36.0-255,66,79180,8,154202
36537,0.002301,74.125.24.0-255,2902,82082,8,154202
36538,0.002303,172.31.36.0-255,66,82148,8,154202
36539,0.002345,74.125.24.0-255,7156,89304,8,154202
36540,0.002348,172.31.36.0-255,66,89370,8,154202
36541,0.002374,172.31.36.0-255,66,89436,8,154202
36542,0.002376,74.125.24.0-255,1484,90920,8,154202
36543,0.002417,172.31.36.0-255,66,90986,8,154202
36544,0.002443,74.125.24.0-255,5738,96724,8,154202
36545,0.002446,172.31.36.0-255,66,96790,8,154202
36546,0.002449,74.125.24.0-255,766,97556,8,154202
36547,0.002519,74.125.24.0-255,2902,100458,8,154202
36548,0.002521,172.31.36.0-255,66,100524,8,154202
36549,0.002572,172.31.36.0-255,66,100590,8,154202
36550,0.002582,172.31.36.0-255,66,100656,8,154202
36551,0.002617,172.31.36.0-255,66,100722,8,154202
36552,0.002634,172.31.36.0-255,66,100788,8,154202
36553,0.002641,74.125.24.0-255,7156,107944,8,154202
36554,0.002644,172.31.36.0-255,66,108010,8,154202
36555,0.002656,172.31.36.0-255,66,108076,8,154202
36556,0.005272,74.125.24.0-255,4320,112396,8,154202
36557,0.005276,172.31.36.0-255,66,112462,8,154202
36558,0.005287,74.125.24.0-255,1484,113946,8,154202
36559,0.007923,74.125.24.0-255,4320,118266,8,154202
36560,0.007929,172.31.36.0-255,66,118332,8,154202
36561,0.010548,74.125.24.0-255,5738,124070,8,154202
36562,0.010556,172.31.36.0-255,66,124136,8,154202
36563,0.01332,74.125.24.0-255,5738,129874,8,154202
36564,0.013328,172.31.36.0-255,66,129940,8,154202
36565,0.015941,74.125.24.0-255,5738,135678,8,154202
36566,0.015953,172.31.36.0-255,66,135744,8,154202
36567,0.018547,74.125.24.0-255,5738,141482,8,154202
36568,0.018555,172.31.36.0-255,66,141548,8,154202
36569,0.021143,74.125.24.0-255,4320,145868,8,154202
36570,0.021151,172.31.36.0-255,66,145934,8,154202
36571,0.02118,74.125.24.0-255,1484,147418,8,154202
36572,0.023761,74.125.24.0-255,2798,150216,8,154202
36573,0.02377,172.31.36.0-255,66,150282,8,154202
36574,0.023961,172.31.36.0-255,105,150387,8,154202
36575,0.026513,74.125.24.0-255,66,150453,8,154202
36576,0.032332,172.31.36.0-255,172,150625,8,154202
36577,0.032364,172.31.36.0-255,1111,151736,8,154202
36578,0.032413,172.31.36.0-255,1514,153250,8,154202
36579,0.032415,172.31.36.0-255,754,154004,8,154202
36580,0.03388,104.244.42.0-255,66,154070,8,154202
36581,0.03394,104.244.42.0-255,66,154136,8,154202
36582,0.033991,104.244.42.0-255,66,154202,8,154202
36583,0.0,74.125.24.0-255,153,153,8,250024
36584,2.3e-05,172.31.36.0-255,66,219,8,250024
36585,3.1e-05,74.125.24.0-255,1484,1703,8,250024
36586,3.6e-05,172.31.36.0-255,66,1769,8,250024
36587,5e-05,74.125.24.0-255,2902,4671,8,250024
36588,5.4e-05,172.31.36.0-255,66,4737,8,250024
36589,6.2e-05,74.125.24.0-255,7156,11893,8,250024
36590,6.5e-05,172.31.36.0-255,66,11959,8,250024
36591,6.9e-05,74.125.24.0-255,1992,13951,8,250024
36592,7.2e-05,172.31.36.0-255,66,14017,8,250024
36593,0.000105,74.125.24.0-255,1484,15501,8,250024
36594,0.000112,172.31.36.0-255,66,15567,8,250024
36595,0.000119,74.125.24.0-255,2902,18469,8,250024
36596,0.000123,172.31.36.0-255,66,18535,8,250024
36597,0.000127,74.125.24.0-255,1484,20019,8,250024
36598,0.000129,172.31.36.0-255,66,20085,8,250024
36599,0.000165,74.125.24.0-255,4320,24405,8,250024
36600,0.000168,172.31.36.0-255,66,24471,8,250024
36601,0.000176,74.125.24.0-255,6797,31268,8,250024
36602,0.000183,172.31.36.0-255,66,31334,8,250024
36603,0.000325,74.125.24.0-255,1484,32818,8,250024
36604,0.00033,172.31.36.0-255,66,32884,8,250024
36605,0.000336,74.125.24.0-255,2902,35786,8,250024
36606,0.000339,172.31.36.0-255,66,35852,8,250024
36607,0.000373,74.125.24.0-255,5738,41590,8,250024
36608,0.000376,172.31.36.0-255,66,41656,8,250024
36609,0.000379,74.125.24.0-255,1484,43140,8,250024
36610,0.000381,172.31.36.0-255,66,43206,8,250024
36611,0.000384,74.125.24.0-255,1484,44690,8,250024
36612,0.000386,172.31.36.0-255,66,44756,8,250024
36613,0.000412,172.31.36.0-255,66,44822,8,250024
36614,0.000429,172.31.36.0-255,66,44888,8,250024
36615,0.000476,74.125.24.0-255,400,45288,8,250024
36616,0.000537,74.125.24.0-255,374,45662,8,250024
36617,0.000828,74.125.24.0-255,1484,47146,8,250024
36618,0.000833,172.31.36.0-255,66,47212,8,250024
36619,0.000839,74.125.24.0-255,2902,50114,8,250024
36620,0.000841,172.31.36.0-255,66,50180,8,250024
36621,0.000871,74.125.24.0-255,5738,55918,8,250024
36622,0.000874,172.31.36.0-255,66,55984,8,250024
36623,0.000882,74.125.24.0-255,5738,61722,8,250024
36624,0.000883,172.31.36.0-255,66,61788,8,250024
36625,0.000901,172.31.36.0-255,66,61854,8,250024
36626,0.000911,74.125.24.0-255,1484,63338,8,250024
36627,0.000939,74.125.24.0-255,5020,68358,8,250024
36628,0.000942,172.31.36.0-255,66,68424,8,250024
36629,0.003241,74.125.24.0-255,5738,74162,8,250024
36630,0.003248,172.31.36.0-255,66,74228,8,250024
36631,0.005568,74.125.24.0-255,5738,79966,8,250024
36632,0.005572,172.31.36.0-255,66,80032,8,250024
36633,0.007832,74.125.24.0-255,5738,85770,8,250024
36634,0.007838,172.31.36.0-255,66,85836,8,250024
36635,0.01012,74.125.24.0-255,5738,91574,8,250024
36636,0.010128,172.31.36.0-255,66,91640,8,250024
36637,0.012395,74.125.24.0-255,5738,97378,8,250024
36638,0.012404,172.31.36.0-255,66,97444,8,250024
36639,0.014641,74.125.24.0-255,5738,103182,8,250024
36640,0.014648,172.31.36.0-255,66,103248,8,250024
36641,0.016926,74.125.24.0-255,5738,108986,8,250024
36642,0.016935,172.31.36.0-255,66,109052,8,250024
36643,0.019204,74.125.24.0-255,5738,114790,8,250024
36644,0.019211,172.31.36.0-255,66,114856,8,250024
36645,0.02152,74.125.24.0-255,4320,119176,8,250024
36646,0.021529,172.31.36.0-255,66,119242,8,250024
36647,0.021556,74.125.24.0-255,1484,120726,8,250024
36648,0.023802,74.125.24.0-255,4320,125046,8,250024
36649,0.023811,172.31.36.0-255,66,125112,8,250024
36650,0.02608,74.125.24.0-255,5738,130850,8,250024
36651,0.026087,172.31.36.0-255,66,130916,8,250024
36652,0.028346,74.125.24.0-255,5738,136654,8,250024
36653,0.028361,172.31.36.0-255,66,136720,8,250024
36654,0.030636,74.125.24.0-255,5738,142458,8,250024
36655,0.030644,172.31.36.0-255,66,142524,8,250024
36656,0.03289,74.125.24.0-255,5738,148262,8,250024
36657,0.032896,172.31.36.0-255,66,148328,8,250024
36658,0.033772,172.31.36.0-255,172,148500,8,250024
36659,0.033803,172.31.36.0-255,1110,149610,8,250024
36660,0.033873,172.31.36.0-255,1514,151124,8,250024
36661,0.033875,172.31.36.0-255,1514,152638,8,250024
36662,0.03388,172.31.36.0-255,1514,154152,8,250024
36663,0.033881,172.31.36.0-255,1514,155666,8,250024
36664,0.033912,172.31.36.0-255,1230,156896,8,250024
36665,0.035158,74.125.24.0-255,5738,162634,8,250024
36666,0.035165,172.31.36.0-255,66,162700,8,250024
36667,0.035316,104.244.42.0-255,66,162766,8,250024
36668,0.03538,104.244.42.0-255,66,162832,8,250024
36669,0.035427,104.244.42.0-255,66,162898,8,250024
36670,0.035476,104.244.42.0-255,66,162964,8,250024
36671,0.037445,74.125.24.0-255,5738,168702,8,250024
36672,0.037452,172.31.36.0-255,66,168768,8,250024
36673,0.039718,74.125.24.0-255,5738,174506,8,250024
36674,0.039724,172.31.36.0-255,66,174572,8,250024
36675,0.04201,74.125.24.0-255,5738,180310,8,250024
36676,0.042017,172.31.36.0-255,66,180376,8,250024
36677,0.044254,74.125.24.0-255,5738,186114,8,250024
36678,0.04426,172.31.36.0-255,66,186180,8,250024
36679,0.046534,74.125.24.0-255,5738,191918,8,250024
36680,0.04654,172.31.36.0-255,66,191984,8,250024
36681,0.048787,74.125.24.0-255,5738,197722,8,250024
36682,0.048793,172.31.36.0-255,66,197788,8,250024
36683,0.051043,74.125.24.0-255,5738,203526,8,250024
36684,0.051051,172.31.36.0-255,66,203592,8,250024
36685,0.053303,74.125.24.0-255,5738,209330,8,250024
36686,0.053309,172.31.36.0-255,66,209396,8,250024
36687,0.055592,74.125.24.0-255,5738,215134,8,250024
36688,0.055599,172.31.36.0-255,66,215200,8,250024
36689,0.057849,74.125.24.0-255,5738,220938,8,250024
36690,0.057856,172.31.36.0-255,66,221004,8,250024
36691,0.060134,74.125.24.0-255,5738,226742,8,250024
36692,0.060148,172.31.36.0-255,66,226808,8,250024
36693,0.062414,74.125.24.0-255,5738,232546,8,250024
36694,0.06242,172.31.36.0-255,66,232612,8,250024
36695,0.064671,74.125.24.0-255,5738,238350,8,250024
36696,0.064677,172.31.36.0-255,66,238416,8,250024
36697,0.066923,74.125.24.0-255,5738,244154,8,250024
36698,0.06693,172.31.36.0-255,66,244220,8,250024
36699,0.069187,74.125.24.0-255,5738,249958,8,250024
36700,0.069194,172.31.36.0-255,66,250024,8,250024
36701,0.0,172.217.194.0-255,153,153,8,204086
36702,2.7e-05,172.31.36.0-255,66,219,8,204086
36703,3.3e-05,172.217.194.0-255,1484,1703,8,204086
36704,3.7e-05,172.31.36.0-255,66,1769,8,204086
36705,6.1e-05,172.217.194.0-255,2902,4671,8,204086
36706,6.4e-05,172.31.36.0-255,66,4737,8,204086
36707,6.9e-05,172.217.194.0-255,4320,9057,8,204086
36708,7.1e-05,172.31.36.0-255,66,9123,8,204086
36709,9.7e-05,172.217.194.0-255,2902,12025,8,204086
36710,0.0001,172.31.36.0-255,66,12091,8,204086
36711,0.000106,172.217.194.0-255,4981,17072,8,204086
36712,0.000108,172.31.36.0-255,66,17138,8,204086
36713,0.000113,172.217.194.0-255,5738,22876,8,204086
36714,0.000115,172.31.36.0-255,66,22942,8,204086
36715,0.000173,172.31.36.0-255,66,23008,8,204086
36716,0.000332,172.217.194.0-255,1484,24492,8,204086
36717,0.000338,172.31.36.0-255,66,24558,8,204086
36718,0.000345,172.217.194.0-255,2902,27460,8,204086
36719,0.000347,172.31.36.0-255,66,27526,8,204086
36720,0.000364,172.217.194.0-255,5738,33264,8,204086
36721,0.000368,172.31.36.0-255,66,33330,8,204086
36722,0.000393,172.217.194.0-255,2902,36232,8,204086
36723,0.000395,172.31.36.0-255,66,36298,8,204086
36724,0.000426,172.31.36.0-255,66,36364,8,204086
36725,0.000479,172.31.36.0-255,66,36430,8,204086
36726,0.000524,172.217.194.0-255,647,37077,8,204086
36727,0.000527,172.31.36.0-255,66,37143,8,204086
36728,0.000617,172.217.194.0-255,1484,38627,8,204086
36729,0.000622,172.31.36.0-255,66,38693,8,204086
36730,0.000627,172.217.194.0-255,2902,41595,8,204086
36731,0.000629,172.31.36.0-255,66,41661,8,204086
36732,0.000652,172.217.194.0-255,5738,47399,8,204086
36733,0.000655,172.31.36.0-255,66,47465,8,204086
36734,0.000732,172.31.36.0-255,66,47531,8,204086
36735,0.000739,172.217.194.0-255,7156,54687,8,204086
36736,0.000741,172.31.36.0-255,66,54753,8,204086
36737,0.000746,172.217.194.0-255,3602,58355,8,204086
36738,0.000748,172.31.36.0-255,66,58421,8,204086
36739,0.000795,172.217.194.0-255,1484,59905,8,204086
36740,0.0008,172.217.194.0-255,1484,61389,8,204086
36741,0.000803,172.31.36.0-255,66,61455,8,204086
36742,0.000818,172.217.194.0-255,1484,62939,8,204086
36743,0.000832,172.217.194.0-255,4320,67259,8,204086
36744,0.000836,172.31.36.0-255,66,67325,8,204086
36745,0.000853,172.217.194.0-255,1484,68809,8,204086
36746,0.000861,172.217.194.0-255,7156,75965,8,204086
36747,0.000864,172.31.36.0-255,66,76031,8,204086
36748,0.000887,172.217.194.0-255,4320,80351,8,204086
36749,0.000891,172.31.36.0-255,66,80417,8,204086
36750,0.000904,172.31.36.0-255,66,80483,8,204086
36751,0.000964,172.217.194.0-255,1484,81967,8,204086
36752,0.000985,172.217.194.0-255,2902,84869,8,204086
36753,0.000988,172.31.36.0-255,66,84935,8,204086
36754,0.000995,172.217.194.0-255,5738,90673,8,204086
36755,0.000998,172.31.36.0-255,66,90739,8,204086
36756,0.001003,172.217.194.0-255,5738,96477,8,204086
36757,0.001005,172.31.36.0-255,66,96543,8,204086
36758,0.001028,172.217.194.0-255,4320,100863,8,204086
36759,0.001032,172.31.36.0-255,66,100929,8,204086
36760,0.001065,172.217.194.0-255,7156,108085,8,204086
36761,0.001069,172.31.36.0-255,66,108151,8,204086
36762,0.00109,172.217.194.0-255,6438,114589,8,204086
36763,0.001095,172.31.36.0-255,66,114655,8,204086
36764,0.001106,172.217.194.0-255,5738,120393,8,204086
36765,0.001109,172.31.36.0-255,66,120459,8,204086
36766,0.001124,172.217.194.0-255,2902,123361,8,204086
36767,0.001126,172.31.36.0-255,66,123427,8,204086
36768,0.001137,172.31.36.0-255,66,123493,8,204086
36769,0.001159,172.217.194.0-255,1484,124977,8,204086
36770,0.001166,172.217.194.0-255,5738,130715,8,204086
36771,0.001169,172.31.36.0-255,66,130781,8,204086
36772,0.001196,172.31.36.0-255,66,130847,8,204086
36773,0.001271,172.217.194.0-255,1484,132331,8,204086
36774,0.001275,172.217.194.0-255,1484,133815,8,204086
36775,0.001277,172.31.36.0-255,66,133881,8,204086
36776,0.001294,172.217.194.0-255,1484,135365,8,204086
36777,0.001307,172.217.194.0-255,1484,136849,8,204086
36778,0.00131,172.31.36.0-255,66,136915,8,204086
36779,0.001331,172.217.194.0-255,4320,141235,8,204086
36780,0.001334,172.31.36.0-255,66,141301,8,204086
36781,0.001339,172.217.194.0-255,4320,145621,8,204086
36782,0.001341,172.31.36.0-255,66,145687,8,204086
36783,0.001362,172.217.194.0-255,5738,151425,8,204086
36784,0.001365,172.31.36.0-255,66,151491,8,204086
36785,0.001399,172.217.194.0-255,2902,154393,8,204086
36786,0.001403,172.31.36.0-255,66,154459,8,204086
36787,0.001428,172.31.36.0-255,66,154525,8,204086
36788,0.001468,172.217.194.0-255,2184,156709,8,204086
36789,0.001471,172.31.36.0-255,66,156775,8,204086
36790,0.001491,172.31.36.0-255,66,156841,8,204086
36791,0.001506,172.31.36.0-255,66,156907,8,204086
36792,0.001569,172.217.194.0-255,1484,158391,8,204086
36793,0.001575,172.217.194.0-255,2902,161293,8,204086
36794,0.001579,172.31.36.0-255,66,161359,8,204086
36795,0.00158,172.217.194.0-255,5738,167097,8,204086
36796,0.001583,172.31.36.0-255,66,167163,8,204086
36797,0.00159,172.31.36.0-255,66,167229,8,204086
36798,0.001605,172.217.194.0-255,4320,171549,8,204086
36799,0.001608,172.31.36.0-255,66,171615,8,204086
36800,0.001618,172.31.36.0-255,66,171681,8,204086
36801,0.001646,172.217.194.0-255,2184,173865,8,204086
36802,0.001649,172.31.36.0-255,66,173931,8,204086
36803,0.001671,172.217.194.0-255,1484,175415,8,204086
36804,0.001677,172.217.194.0-255,2902,178317,8,204086
36805,0.001681,172.31.36.0-255,66,178383,8,204086
36806,0.001692,172.217.194.0-255,4320,182703,8,204086
36807,0.001695,172.31.36.0-255,66,182769,8,204086
36808,0.001718,172.217.194.0-255,1484,184253,8,204086
36809,0.001732,172.31.36.0-255,66,184319,8,204086
36810,0.001749,172.217.194.0-255,2902,187221,8,204086
36811,0.001752,172.31.36.0-255,66,187287,8,204086
36812,0.00178,172.31.36.0-255,66,187353,8,204086
36813,0.001781,172.217.194.0-255,5738,193091,8,204086
36814,0.001784,172.31.36.0-255,66,193157,8,204086
36815,0.001834,172.31.36.0-255,66,193223,8,204086
36816,0.001873,172.31.36.0-255,66,193289,8,204086
36817,0.001878,172.217.194.0-255,3602,196891,8,204086
36818,0.00188,172.31.36.0-255,66,196957,8,204086
36819,0.001899,172.31.36.0-255,66,197023,8,204086
36820,0.001929,172.217.194.0-255,5738,202761,8,204086
36821,0.001932,172.31.36.0-255,66,202827,8,204086
36822,0.001947,172.31.36.0-255,66,202893,8,204086
36823,0.001967,172.217.194.0-255,105,202998,8,204086
36824,0.009123,172.31.36.0-255,66,203064,8,204086
36825,0.009154,172.31.36.0-255,105,203169,8,204086
36826,0.011171,172.217.194.0-255,66,203235,8,204086
36827,0.027546,172.31.36.0-255,172,203407,8,204086
36828,0.027576,172.31.36.0-255,613,204020,8,204086
36829,0.029709,104.244.42.0-255,66,204086,8,204086
36830,0.0,172.217.194.0-255,152,152,8,242652
36831,2.1e-05,172.31.36.0-255,66,218,8,242652
36832,2.7e-05,172.217.194.0-255,1484,1702,8,242652
36833,3.1e-05,172.31.36.0-255,66,1768,8,242652
36834,3.6e-05,172.217.194.0-255,2902,4670,8,242652
36835,4.7e-05,172.31.36.0-255,66,4736,8,242652
36836,5.3e-05,172.217.194.0-255,7156,11892,8,242652
36837,5.6e-05,172.31.36.0-255,66,11958,8,242652
36838,7.5e-05,172.217.194.0-255,2066,14024,8,242652
36839,8.1e-05,172.31.36.0-255,66,14090,8,242652
36840,0.000295,172.217.194.0-255,1484,15574,8,242652
36841,0.0003,172.31.36.0-255,66,15640,8,242652
36842,0.000306,172.217.194.0-255,2902,18542,8,242652
36843,0.000309,172.31.36.0-255,66,18608,8,242652
36844,0.000314,172.217.194.0-255,5738,24346,8,242652
36845,0.000321,172.31.36.0-255,66,24412,8,242652
36846,0.000326,172.217.194.0-255,4320,28732,8,242652
36847,0.000328,172.31.36.0-255,66,28798,8,242652
36848,0.000351,172.217.194.0-255,1484,30282,8,242652
36849,0.000357,172.31.36.0-255,66,30348,8,242652
36850,0.00036,172.217.194.0-255,1125,31473,8,242652
36851,0.000362,172.31.36.0-255,66,31539,8,242652
36852,0.000443,172.217.194.0-255,1484,33023,8,242652
36853,0.000447,172.31.36.0-255,66,33089,8,242652
36854,0.000452,172.217.194.0-255,2902,35991,8,242652
36855,0.000455,172.31.36.0-255,66,36057,8,242652
36856,0.000476,172.217.194.0-255,5738,41795,8,242652
36857,0.000482,172.31.36.0-255,66,41861,8,242652
36858,0.000511,172.217.194.0-255,5738,47599,8,242652
36859,0.000514,172.31.36.0-255,66,47665,8,242652
36860,0.000539,172.217.194.0-255,5379,53044,8,242652
36861,0.000542,172.31.36.0-255,66,53110,8,242652
36862,0.000574,172.31.36.0-255,66,53176,8,242652
36863,0.00059,172.217.194.0-255,3154,56330,8,242652
36864,0.000605,172.31.36.0-255,66,56396,8,242652
36865,0.000754,172.217.194.0-255,1484,57880,8,242652
36866,0.000759,172.217.194.0-255,2902,60782,8,242652
36867,0.000774,172.217.194.0-255,4320,65102,8,242652
36868,0.000783,172.31.36.0-255,66,65168,8,242652
36869,0.000802,172.217.194.0-255,1484,66652,8,242652
36870,0.000827,172.217.194.0-255,1484,68136,8,242652
36871,0.000833,172.31.36.0-255,66,68202,8,242652
36872,0.000876,172.217.194.0-255,1484,69686,8,242652
36873,0.000882,172.31.36.0-255,66,69752,8,242652
36874,0.000916,172.217.194.0-255,7156,76908,8,242652
36875,0.000928,172.217.194.0-255,2902,79810,8,242652
36876,0.00097,172.31.36.0-255,66,79876,8,242652
36877,0.002207,172.217.194.0-255,1484,81360,8,242652
36878,0.00222,172.217.194.0-255,2902,84262,8,242652
36879,0.002225,172.31.36.0-255,66,84328,8,242652
36880,0.002234,172.217.194.0-255,5738,90066,8,242652
36881,0.002237,172.217.194.0-255,1484,91550,8,242652
36882,0.002332,172.217.194.0-255,2184,93734,8,242652
36883,0.007594,172.31.36.0-255,66,93800,8,242652
36884,0.009923,172.217.194.0-255,5738,99538,8,242652
36885,0.00994,172.31.36.0-255,66,99604,8,242652
36886,0.012285,172.217.194.0-255,5738,105342,8,242652
36887,0.012303,172.31.36.0-255,66,105408,8,242652
36888,0.014631,172.217.194.0-255,5738,111146,8,242652
36889,0.01465,172.31.36.0-255,66,111212,8,242652
36890,0.01698,172.217.194.0-255,5738,116950,8,242652
36891,0.021679,172.31.36.0-255,66,117016,8,242652
36892,0.024008,172.217.194.0-255,5738,122754,8,242652
36893,0.024025,172.31.36.0-255,66,122820,8,242652
36894,0.026337,172.217.194.0-255,5738,128558,8,242652
36895,0.026348,172.31.36.0-255,66,128624,8,242652
36896,0.026918,172.31.36.0-255,190,128814,8,242652
36897,0.02696,172.31.36.0-255,1111,129925,8,242652
36898,0.027048,172.31.36.0-255,1514,131439,8,242652
36899,0.02705,172.31.36.0-255,1514,132953,8,242652
36900,0.027055,172.31.36.0-255,1514,134467,8,242652
36901,0.027056,172.31.36.0-255,1073,135540,8,242652
36902,0.028478,104.244.42.0-255,66,135606,8,242652
36903,0.028521,104.244.42.0-255,66,135672,8,242652
36904,0.028626,104.244.42.0-255,66,135738,8,242652
36905,0.028631,104.244.42.0-255,66,135804,8,242652
36906,0.028647,172.217.194.0-255,2902,138706,8,242652
36907,0.028652,172.31.36.0-255,66,138772,8,242652
36908,0.028685,172.217.194.0-255,2902,141674,8,242652
36909,0.0288,172.31.36.0-255,66,141740,8,242652
36910,0.030948,172.217.194.0-255,2902,144642,8,242652
36911,0.030961,172.31.36.0-255,66,144708,8,242652
36912,0.031113,172.217.194.0-255,2902,147610,8,242652
36913,0.03112,172.31.36.0-255,66,147676,8,242652
36914,0.033289,172.217.194.0-255,2902,150578,8,242652
36915,0.033295,172.31.36.0-255,66,150644,8,242652
36916,0.033419,172.217.194.0-255,2902,153546,8,242652
36917,0.033424,172.31.36.0-255,66,153612,8,242652
36918,0.035594,172.217.194.0-255,2902,156514,8,242652
36919,0.0356,172.31.36.0-255,66,156580,8,242652
36920,0.035734,172.217.194.0-255,2902,159482,8,242652
36921,0.03574,172.31.36.0-255,66,159548,8,242652
36922,0.037883,172.217.194.0-255,2902,162450,8,242652
36923,0.037889,172.31.36.0-255,66,162516,8,242652
36924,0.038036,172.217.194.0-255,2902,165418,8,242652
36925,0.038042,172.31.36.0-255,66,165484,8,242652
36926,0.040186,172.217.194.0-255,2902,168386,8,242652
36927,0.040192,172.31.36.0-255,66,168452,8,242652
36928,0.040334,172.217.194.0-255,2902,171354,8,242652
36929,0.040339,172.31.36.0-255,66,171420,8,242652
36930,0.042475,172.217.194.0-255,2902,174322,8,242652
36931,0.04248,172.31.36.0-255,66,174388,8,242652
36932,0.042629,172.217.194.0-255,2902,177290,8,242652
36933,0.042634,172.31.36.0-255,66,177356,8,242652
36934,0.044793,172.217.194.0-255,2902,180258,8,242652
36935,0.044803,172.31.36.0-255,66,180324,8,242652
36936,0.044931,172.217.194.0-255,2902,183226,8,242652
36937,0.04494,172.31.36.0-255,66,183292,8,242652
36938,0.047096,172.217.194.0-255,2902,186194,8,242652
36939,0.047111,172.31.36.0-255,66,186260,8,242652
36940,0.047223,172.217.194.0-255,2902,189162,8,242652
36941,0.047276,172.31.36.0-255,66,189228,8,242652
36942,0.049381,172.217.194.0-255,2902,192130,8,242652
36943,0.049389,172.31.36.0-255,66,192196,8,242652
36944,0.049585,172.217.194.0-255,2902,195098,8,242652
36945,0.049592,172.31.36.0-255,66,195164,8,242652
36946,0.05166,172.217.194.0-255,2902,198066,8,242652
36947,0.051665,172.31.36.0-255,66,198132,8,242652
36948,0.051899,172.217.194.0-255,2902,201034,8,242652
36949,0.051905,172.31.36.0-255,66,201100,8,242652
36950,0.053954,172.217.194.0-255,2902,204002,8,242652
36951,0.053961,172.31.36.0-255,66,204068,8,242652
36952,0.054187,172.217.194.0-255,2902,206970,8,242652
36953,0.054194,172.31.36.0-255,66,207036,8,242652
36954,0.056246,172.217.194.0-255,2902,209938,8,242652
36955,0.056251,172.31.36.0-255,66,210004,8,242652
36956,0.056472,172.217.194.0-255,2902,212906,8,242652
36957,0.056479,172.31.36.0-255,66,212972,8,242652
36958,0.058534,172.217.194.0-255,2902,215874,8,242652
36959,0.058541,172.31.36.0-255,66,215940,8,242652
36960,0.058807,172.217.194.0-255,2902,218842,8,242652
36961,0.058813,172.31.36.0-255,66,218908,8,242652
36962,0.060858,172.217.194.0-255,2902,221810,8,242652
36963,0.060865,172.31.36.0-255,66,221876,8,242652
36964,0.061084,172.217.194.0-255,2902,224778,8,242652
36965,0.061091,172.31.36.0-255,66,224844,8,242652
36966,0.063172,172.217.194.0-255,2902,227746,8,242652
36967,0.063185,172.31.36.0-255,66,227812,8,242652
36968,0.063379,172.217.194.0-255,2902,230714,8,242652
36969,0.063426,172.31.36.0-255,66,230780,8,242652
36970,0.065491,172.217.194.0-255,2902,233682,8,242652
36971,0.065499,172.31.36.0-255,66,233748,8,242652
36972,0.06572,172.217.194.0-255,2902,236650,8,242652
36973,0.065725,172.31.36.0-255,66,236716,8,242652
36974,0.067788,172.217.194.0-255,2902,239618,8,242652
36975,0.067799,172.31.36.0-255,66,239684,8,242652
36976,0.068008,172.217.194.0-255,2902,242586,8,242652
36977,0.068014,172.31.36.0-255,66,242652,8,242652
36978,0.0,172.217.194.0-255,150,150,8,242672
36979,1.6e-05,172.31.36.0-255,66,216,8,242672
36980,2.2e-05,172.217.194.0-255,1484,1700,8,242672
36981,2.6e-05,172.31.36.0-255,66,1766,8,242672
36982,3.2e-05,172.217.194.0-255,2902,4668,8,242672
36983,3.6e-05,172.31.36.0-255,66,4734,8,242672
36984,6.7e-05,172.217.194.0-255,7156,11890,8,242672
36985,7.1e-05,172.31.36.0-255,66,11956,8,242672
36986,7.5e-05,172.217.194.0-255,2037,13993,8,242672
36987,7.7e-05,172.31.36.0-255,66,14059,8,242672
36988,0.000145,172.217.194.0-255,1484,15543,8,242672
36989,0.000148,172.31.36.0-255,66,15609,8,242672
36990,0.000152,172.217.194.0-255,1484,17093,8,242672
36991,0.000154,172.31.36.0-255,66,17159,8,242672
36992,0.000171,172.217.194.0-255,1484,18643,8,242672
36993,0.000173,172.31.36.0-255,66,18709,8,242672
36994,0.000181,172.217.194.0-255,5738,24447,8,242672
36995,0.000183,172.31.36.0-255,66,24513,8,242672
36996,0.000215,172.31.36.0-255,66,24579,8,242672
36997,0.000242,172.217.194.0-255,3961,28540,8,242672
36998,0.000244,172.31.36.0-255,66,28606,8,242672
36999,0.000257,172.31.36.0-255,66,28672,8,242672
37000,0.000271,172.217.194.0-255,4320,32992,8,242672
37001,0.000273,172.31.36.0-255,66,33058,8,242672
37002,0.000305,172.31.36.0-255,66,33124,8,242672
37003,0.000321,172.217.194.0-255,5738,38862,8,242672
37004,0.000324,172.31.36.0-255,66,38928,8,242672
37005,0.000352,172.31.36.0-255,66,38994,8,242672
37006,0.000371,172.217.194.0-255,5738,44732,8,242672
37007,0.000374,172.31.36.0-255,66,44798,8,242672
37008,0.0004,172.31.36.0-255,66,44864,8,242672
37009,0.000441,172.31.36.0-255,66,44930,8,242672
37010,0.00046,172.217.194.0-255,4320,49250,8,242672
37011,0.000463,172.31.36.0-255,66,49316,8,242672
37012,0.000465,172.217.194.0-255,1125,50441,8,242672
37013,0.000488,172.217.194.0-255,1484,51925,8,242672
37014,0.000491,172.31.36.0-255,66,51991,8,242672
37015,0.000496,172.217.194.0-255,4320,56311,8,242672
37016,0.000499,172.31.36.0-255,66,56377,8,242672
37017,0.000533,172.31.36.0-255,66,56443,8,242672
37018,0.000539,172.217.194.0-255,4320,60763,8,242672
37019,0.000541,172.31.36.0-255,66,60829,8,242672
37020,0.000556,172.217.194.0-255,5738,66567,8,242672
37021,0.000558,172.31.36.0-255,66,66633,8,242672
37022,0.000603,172.31.36.0-255,66,66699,8,242672
37023,0.000667,172.31.36.0-255,66,66765,8,242672
37024,0.000681,172.31.36.0-255,66,66831,8,242672
37025,0.000709,172.217.194.0-255,5738,72569,8,242672
37026,0.000711,172.31.36.0-255,66,72635,8,242672
37027,0.000719,172.217.194.0-255,6438,79073,8,242672
37028,0.000721,172.31.36.0-255,66,79139,8,242672
37029,0.000744,172.217.194.0-255,5738,84877,8,242672
37030,0.000746,172.31.36.0-255,66,84943,8,242672
37031,0.000766,172.217.194.0-255,7156,92099,8,242672
37032,0.000768,172.31.36.0-255,66,92165,8,242672
37033,0.00078,172.217.194.0-255,1484,93649,8,242672
37034,0.0008,172.217.194.0-255,7156,100805,8,242672
37035,0.000803,172.31.36.0-255,66,100871,8,242672
37036,0.000828,172.217.194.0-255,5379,106250,8,242672
37037,0.000831,172.31.36.0-255,66,106316,8,242672
37038,0.000838,172.217.194.0-255,6797,113113,8,242672
37039,0.00084,172.31.36.0-255,66,113179,8,242672
37040,0.0011,172.217.194.0-255,1484,114663,8,242672
37041,0.001106,172.217.194.0-255,2902,117565,8,242672
37042,0.001109,172.31.36.0-255,66,117631,8,242672
37043,0.001112,172.217.194.0-255,1484,119115,8,242672
37044,0.001132,172.217.194.0-255,4320,123435,8,242672
37045,0.001134,172.31.36.0-255,66,123501,8,242672
37046,0.001137,172.217.194.0-255,1484,124985,8,242672
37047,0.001158,172.217.194.0-255,5379,130364,8,242672
37048,0.00116,172.31.36.0-255,66,130430,8,242672
37049,0.001462,172.217.194.0-255,1484,131914,8,242672
37050,0.001468,172.217.194.0-255,2902,134816,8,242672
37051,0.001471,172.31.36.0-255,66,134882,8,242672
37052,0.001477,172.217.194.0-255,2902,137784,8,242672
37053,0.001479,172.31.36.0-255,66,137850,8,242672
37054,0.001493,172.217.194.0-255,2902,140752,8,242672
37055,0.001495,172.31.36.0-255,66,140818,8,242672
37056,0.001512,172.31.36.0-255,66,140884,8,242672
37057,0.00155,172.217.194.0-255,5738,146622,8,242672
37058,0.001553,172.31.36.0-255,66,146688,8,242672
37059,0.001581,172.31.36.0-255,66,146754,8,242672
37060,0.001802,172.217.194.0-255,1484,148238,8,242672
37061,0.001807,172.217.194.0-255,2902,151140,8,242672
37062,0.001809,172.217.194.0-255,1484,152624,8,242672
37063,0.001815,172.31.36.0-255,66,152690,8,242672
37064,0.001827,172.217.194.0-255,4320,157010,8,242672
37065,0.001829,172.31.36.0-255,66,157076,8,242672
37066,0.001869,172.31.36.0-255,66,157142,8,242672
37067,0.00188,172.31.36.0-255,66,157208,8,242672
37068,0.001883,172.217.194.0-255,766,157974,8,242672
37069,0.002033,172.217.194.0-255,1484,159458,8,242672
37070,0.002037,172.217.194.0-255,1484,160942,8,242672
37071,0.002042,172.31.36.0-255,66,161008,8,242672
37072,0.002051,172.217.194.0-255,1484,162492,8,242672
37073,0.002053,172.31.36.0-255,66,162558,8,242672
37074,0.002071,172.217.194.0-255,5738,168296,8,242672
37075,0.002073,172.31.36.0-255,66,168362,8,242672
37076,0.002076,172.217.194.0-255,1484,169846,8,242672
37077,0.00211,172.31.36.0-255,66,169912,8,242672
37078,0.002151,172.31.36.0-255,66,169978,8,242672
37079,0.002169,172.217.194.0-255,2184,172162,8,242672
37080,0.002173,172.31.36.0-255,66,172228,8,242672
37081,0.002196,172.217.194.0-255,1484,173712,8,242672
37082,0.002201,172.217.194.0-255,2902,176614,8,242672
37083,0.002203,172.31.36.0-255,66,176680,8,242672
37084,0.00221,172.217.194.0-255,5738,182418,8,242672
37085,0.002212,172.31.36.0-255,66,182484,8,242672
37086,0.002258,172.217.194.0-255,7156,189640,8,242672
37087,0.002262,172.31.36.0-255,66,189706,8,242672
37088,0.002277,172.31.36.0-255,66,189772,8,242672
37089,0.002281,172.217.194.0-255,2184,191956,8,242672
37090,0.002283,172.31.36.0-255,66,192022,8,242672
37091,0.002291,172.217.194.0-255,7156,199178,8,242672
37092,0.002293,172.31.36.0-255,66,199244,8,242672
37093,0.00457,172.217.194.0-255,5738,204982,8,242672
37094,0.004577,172.31.36.0-255,66,205048,8,242672
37095,0.006814,172.217.194.0-255,5738,210786,8,242672
37096,0.006821,172.31.36.0-255,66,210852,8,242672
37097,0.009072,172.217.194.0-255,4320,215172,8,242672
37098,0.009075,172.31.36.0-255,66,215238,8,242672
37099,0.009092,172.217.194.0-255,1484,216722,8,242672
37100,0.011329,172.217.194.0-255,4320,221042,8,242672
37101,0.011335,172.31.36.0-255,66,221108,8,242672
37102,0.013597,172.217.194.0-255,5738,226846,8,242672
37103,0.013605,172.31.36.0-255,66,226912,8,242672
37104,0.015878,172.217.194.0-255,5738,232650,8,242672
37105,0.015887,172.31.36.0-255,66,232716,8,242672
37106,0.018125,172.217.194.0-255,4442,237158,8,242672
37107,0.018133,172.31.36.0-255,66,237224,8,242672
37108,0.018387,172.31.36.0-255,105,237329,8,242672
37109,0.020591,172.217.194.0-255,66,237395,8,242672
37110,0.031999,172.31.36.0-255,172,237567,8,242672
37111,0.032033,172.31.36.0-255,1112,238679,8,242672
37112,0.032097,172.31.36.0-255,1514,240193,8,242672
37113,0.032099,172.31.36.0-255,1514,241707,8,242672
37114,0.032124,172.31.36.0-255,701,242408,8,242672
37115,0.03354,104.244.42.0-255,66,242474,8,242672
37116,0.033571,104.244.42.0-255,66,242540,8,242672
37117,0.033655,104.244.42.0-255,66,242606,8,242672
37118,0.033669,104.244.42.0-255,66,242672,8,242672
37119,0.0,74.125.130.0-255,154,154,8,342053
37120,3e-05,172.31.36.0-255,66,220,8,342053
37121,3.7e-05,74.125.130.0-255,1484,1704,8,342053
37122,4.2e-05,172.31.36.0-255,66,1770,8,342053
37123,4.5e-05,74.125.130.0-255,1484,3254,8,342053
37124,4.8e-05,172.31.36.0-255,66,3320,8,342053
37125,5.3e-05,74.125.130.0-255,2902,6222,8,342053
37126,5.5e-05,172.31.36.0-255,66,6288,8,342053
37127,6.2e-05,74.125.130.0-255,5738,12026,8,342053
37128,6.4e-05,172.31.36.0-255,66,12092,8,342053
37129,8.6e-05,74.125.130.0-255,2051,14143,8,342053
37130,8.8e-05,172.31.36.0-255,66,14209,8,342053
37131,0.000138,74.125.130.0-255,1484,15693,8,342053
37132,0.000142,172.31.36.0-255,66,15759,8,342053
37133,0.000147,74.125.130.0-255,2902,18661,8,342053
37134,0.000149,172.31.36.0-255,66,18727,8,342053
37135,0.000168,74.125.130.0-255,5738,24465,8,342053
37136,0.000171,172.31.36.0-255,66,24531,8,342053
37137,0.000198,74.125.130.0-255,6797,31328,8,342053
37138,0.000201,172.31.36.0-255,66,31394,8,342053
37139,0.000215,74.125.130.0-255,4320,35714,8,342053
37140,0.000218,172.31.36.0-255,66,35780,8,342053
37141,0.000243,74.125.130.0-255,2902,38682,8,342053
37142,0.000245,172.31.36.0-255,66,38748,8,342053
37143,0.000259,172.31.36.0-255,66,38814,8,342053
37144,0.000989,74.125.130.0-255,1484,40298,8,342053
37145,0.000995,172.31.36.0-255,66,40364,8,342053
37146,0.001003,74.125.130.0-255,2902,43266,8,342053
37147,0.001006,172.31.36.0-255,66,43332,8,342053
37148,0.001012,74.125.130.0-255,4320,47652,8,342053
37149,0.001015,172.31.36.0-255,66,47718,8,342053
37150,0.001047,74.125.130.0-255,5738,53456,8,342053
37151,0.001051,172.31.36.0-255,66,53522,8,342053
37152,0.001069,74.125.130.0-255,2543,56065,8,342053
37153,0.001072,172.31.36.0-255,66,56131,8,342053
37154,0.001126,74.125.130.0-255,1484,57615,8,342053
37155,0.001133,74.125.130.0-255,2902,60517,8,342053
37156,0.001136,172.31.36.0-255,66,60583,8,342053
37157,0.001161,74.125.130.0-255,5738,66321,8,342053
37158,0.001164,172.31.36.0-255,66,66387,8,342053
37159,0.001206,74.125.130.0-255,5738,72125,8,342053
37160,0.001209,172.31.36.0-255,66,72191,8,342053
37161,0.00123,172.31.36.0-255,66,72257,8,342053
37162,0.00124,172.31.36.0-255,66,72323,8,342053
37163,0.001243,74.125.130.0-255,1125,73448,8,342053
37164,0.001325,74.125.130.0-255,1484,74932,8,342053
37165,0.001329,172.31.36.0-255,66,74998,8,342053
37166,0.001335,74.125.130.0-255,2902,77900,8,342053
37167,0.001338,172.31.36.0-255,66,77966,8,342053
37168,0.001343,74.125.130.0-255,2902,80868,8,342053
37169,0.001345,172.31.36.0-255,66,80934,8,342053
37170,0.001363,74.125.130.0-255,1484,82418,8,342053
37171,0.001394,74.125.130.0-255,2902,85320,8,342053
37172,0.001398,172.31.36.0-255,66,85386,8,342053
37173,0.001417,74.125.130.0-255,5365,90751,8,342053
37174,0.001421,172.31.36.0-255,66,90817,8,342053
37175,0.001456,74.125.130.0-255,1484,92301,8,342053
37176,0.001462,74.125.130.0-255,2902,95203,8,342053
37177,0.001466,172.31.36.0-255,66,95269,8,342053
37178,0.00149,74.125.130.0-255,5738,101007,8,342053
37179,0.001493,172.31.36.0-255,66,101073,8,342053
37180,0.001499,74.125.130.0-255,5738,106811,8,342053
37181,0.001502,172.31.36.0-255,66,106877,8,342053
37182,0.001516,74.125.130.0-255,4320,111197,8,342053
37183,0.001519,172.31.36.0-255,66,111263,8,342053
37184,0.001526,74.125.130.0-255,7156,118419,8,342053
37185,0.00153,172.31.36.0-255,66,118485,8,342053
37186,0.001559,74.125.130.0-255,4320,122805,8,342053
37187,0.001562,172.31.36.0-255,66,122871,8,342053
37188,0.001566,74.125.130.0-255,2184,125055,8,342053
37189,0.001568,172.31.36.0-255,66,125121,8,342053
37190,0.00195,74.125.130.0-255,1484,126605,8,342053
37191,0.001963,74.125.130.0-255,2902,129507,8,342053
37192,0.001966,172.31.36.0-255,66,129573,8,342053
37193,0.00197,74.125.130.0-255,2902,132475,8,342053
37194,0.001973,172.31.36.0-255,66,132541,8,342053
37195,0.001984,74.125.130.0-255,2902,135443,8,342053
37196,0.001986,172.31.36.0-255,66,135509,8,342053
37197,0.002008,74.125.130.0-255,7156,142665,8,342053
37198,0.002011,172.31.36.0-255,66,142731,8,342053
37199,0.002038,74.125.130.0-255,5738,148469,8,342053
37200,0.00204,172.31.36.0-255,66,148535,8,342053
37201,0.002046,74.125.130.0-255,7156,155691,8,342053
37202,0.002048,172.31.36.0-255,66,155757,8,342053
37203,0.00207,74.125.130.0-255,3602,159359,8,342053
37204,0.002072,172.31.36.0-255,66,159425,8,342053
37205,0.004226,74.125.130.0-255,1484,160909,8,342053
37206,0.004254,74.125.130.0-255,4320,165229,8,342053
37207,0.004257,172.31.36.0-255,66,165295,8,342053
37208,0.006464,74.125.130.0-255,5738,171033,8,342053
37209,0.00647,172.31.36.0-255,66,171099,8,342053
37210,0.008666,74.125.130.0-255,5738,176837,8,342053
37211,0.008674,172.31.36.0-255,66,176903,8,342053
37212,0.010938,74.125.130.0-255,5738,182641,8,342053
37213,0.010947,172.31.36.0-255,66,182707,8,342053
37214,0.01315,74.125.130.0-255,5738,188445,8,342053
37215,0.013161,172.31.36.0-255,66,188511,8,342053
37216,0.015436,74.125.130.0-255,5738,194249,8,342053
37217,0.015448,172.31.36.0-255,66,194315,8,342053
37218,0.017691,74.125.130.0-255,5738,200053,8,342053
37219,0.017705,172.31.36.0-255,66,200119,8,342053
37220,0.019911,74.125.130.0-255,5738,205857,8,342053
37221,0.019919,172.31.36.0-255,66,205923,8,342053
37222,0.022148,74.125.130.0-255,5738,211661,8,342053
37223,0.022157,172.31.36.0-255,66,211727,8,342053
37224,0.024366,74.125.130.0-255,5738,217465,8,342053
37225,0.024374,172.31.36.0-255,66,217531,8,342053
37226,0.026573,74.125.130.0-255,5738,223269,8,342053
37227,0.026581,172.31.36.0-255,66,223335,8,342053
37228,0.028785,74.125.130.0-255,5738,229073,8,342053
37229,0.028793,172.31.36.0-255,66,229139,8,342053
37230,0.029258,172.31.36.0-255,172,229311,8,342053
37231,0.029284,172.31.36.0-255,1112,230423,8,342053
37232,0.029347,172.31.36.0-255,1514,231937,8,342053
37233,0.029349,172.31.36.0-255,1514,233451,8,342053
37234,0.029355,172.31.36.0-255,1514,234965,8,342053
37235,0.029356,172.31.36.0-255,1514,236479,8,342053
37236,0.029382,172.31.36.0-255,168,236647,8,342053
37237,0.030807,104.244.42.0-255,66,236713,8,342053
37238,0.030815,104.244.42.0-255,66,236779,8,342053
37239,0.030881,104.244.42.0-255,66,236845,8,342053
37240,0.030927,104.244.42.0-255,66,236911,8,342053
37241,0.030988,74.125.130.0-255,2902,239813,8,342053
37242,0.030992,172.31.36.0-255,66,239879,8,342053
37243,0.031029,74.125.130.0-255,2902,242781,8,342053
37244,0.031032,172.31.36.0-255,66,242847,8,342053
37245,0.031561,104.244.42.0-255,108,242955,8,342053
37246,0.031583,172.31.36.0-255,66,243021,8,342053
37247,0.033183,74.125.130.0-255,2902,245923,8,342053
37248,0.033187,172.31.36.0-255,66,245989,8,342053
37249,0.033259,74.125.130.0-255,2902,248891,8,342053
37250,0.033264,172.31.36.0-255,66,248957,8,342053
37251,0.035377,74.125.130.0-255,2902,251859,8,342053
37252,0.035383,172.31.36.0-255,66,251925,8,342053
37253,0.035451,74.125.130.0-255,2902,254827,8,342053
37254,0.035457,172.31.36.0-255,66,254893,8,342053
37255,0.037586,74.125.130.0-255,2902,257795,8,342053
37256,0.037593,172.31.36.0-255,66,257861,8,342053
37257,0.037661,74.125.130.0-255,2902,260763,8,342053
37258,0.037665,172.31.36.0-255,66,260829,8,342053
37259,0.039786,74.125.130.0-255,2902,263731,8,342053
37260,0.039792,172.31.36.0-255,66,263797,8,342053
37261,0.039856,74.125.130.0-255,2902,266699,8,342053
37262,0.03986,172.31.36.0-255,66,266765,8,342053
37263,0.041986,74.125.130.0-255,2902,269667,8,342053
37264,0.042008,172.31.36.0-255,66,269733,8,342053
37265,0.042028,74.125.130.0-255,2902,272635,8,342053
37266,0.042031,172.31.36.0-255,66,272701,8,342053
37267,0.044209,74.125.130.0-255,2902,275603,8,342053
37268,0.044214,172.31.36.0-255,66,275669,8,342053
37269,0.044245,74.125.130.0-255,2902,278571,8,342053
37270,0.044248,172.31.36.0-255,66,278637,8,342053
37271,0.046397,74.125.130.0-255,2902,281539,8,342053
37272,0.046402,172.31.36.0-255,66,281605,8,342053
37273,0.046436,74.125.130.0-255,2902,284507,8,342053
37274,0.046439,172.31.36.0-255,66,284573,8,342053
37275,0.0486,74.125.130.0-255,2902,287475,8,342053
37276,0.048605,172.31.36.0-255,66,287541,8,342053
37277,0.048641,74.125.130.0-255,2902,290443,8,342053
37278,0.048644,172.31.36.0-255,66,290509,8,342053
37279,0.050795,74.125.130.0-255,2902,293411,8,342053
37280,0.0508,172.31.36.0-255,66,293477,8,342053
37281,0.050831,74.125.130.0-255,2902,296379,8,342053
37282,0.050835,172.31.36.0-255,66,296445,8,342053
37283,0.052984,74.125.130.0-255,2902,299347,8,342053
37284,0.05299,172.31.36.0-255,66,299413,8,342053
37285,0.053021,74.125.130.0-255,2902,302315,8,342053
37286,0.053024,172.31.36.0-255,66,302381,8,342053
37287,0.055191,74.125.130.0-255,2902,305283,8,342053
37288,0.055196,172.31.36.0-255,66,305349,8,342053
37289,0.055231,74.125.130.0-255,2902,308251,8,342053
37290,0.055234,172.31.36.0-255,66,308317,8,342053
37291,0.057395,74.125.130.0-255,2902,311219,8,342053
37292,0.057401,172.31.36.0-255,66,311285,8,342053
37293,0.057433,74.125.130.0-255,2902,314187,8,342053
37294,0.057436,172.31.36.0-255,66,314253,8,342053
37295,0.059608,74.125.130.0-255,2902,317155,8,342053
37296,0.059614,172.31.36.0-255,66,317221,8,342053
37297,0.059632,74.125.130.0-255,2902,320123,8,342053
37298,0.059634,172.31.36.0-255,66,320189,8,342053
37299,0.061824,74.125.130.0-255,5738,325927,8,342053
37300,0.06183,172.31.36.0-255,66,325993,8,342053
37301,0.064025,74.125.130.0-255,4320,330313,8,342053
37302,0.064031,172.31.36.0-255,66,330379,8,342053
37303,0.064062,74.125.130.0-255,1484,331863,8,342053
37304,0.066209,74.125.130.0-255,4320,336183,8,342053
37305,0.066214,172.31.36.0-255,66,336249,8,342053
37306,0.068405,74.125.130.0-255,5738,341987,8,342053
37307,0.068413,172.31.36.0-255,66,342053,8,342053
37308,0.0,172.217.194.0-255,146,146,8,275941
37309,2.2e-05,172.31.36.0-255,66,212,8,275941
37310,2.9e-05,172.217.194.0-255,1484,1696,8,275941
37311,3.3e-05,172.31.36.0-255,66,1762,8,275941
37312,3.9e-05,172.217.194.0-255,2902,4664,8,275941
37313,4.2e-05,172.31.36.0-255,66,4730,8,275941
37314,5e-05,172.217.194.0-255,7156,11886,8,275941
37315,5.3e-05,172.31.36.0-255,66,11952,8,275941
37316,8.7e-05,172.217.194.0-255,1978,13930,8,275941
37317,9e-05,172.31.36.0-255,66,13996,8,275941
37318,0.000115,172.217.194.0-255,1484,15480,8,275941
37319,0.000117,172.31.36.0-255,66,15546,8,275941
37320,0.000135,172.217.194.0-255,1484,17030,8,275941
37321,0.000138,172.31.36.0-255,66,17096,8,275941
37322,0.000146,172.217.194.0-255,7156,24252,8,275941
37323,0.000149,172.31.36.0-255,66,24318,8,275941
37324,0.000185,172.217.194.0-255,1484,25802,8,275941
37325,0.000187,172.31.36.0-255,66,25868,8,275941
37326,0.00021,172.217.194.0-255,5379,31247,8,275941
37327,0.000213,172.31.36.0-255,66,31313,8,275941
37328,0.000358,172.217.194.0-255,1484,32797,8,275941
37329,0.000362,172.31.36.0-255,66,32863,8,275941
37330,0.000369,172.217.194.0-255,2902,35765,8,275941
37331,0.000372,172.31.36.0-255,66,35831,8,275941
37332,0.000378,172.217.194.0-255,4320,40151,8,275941
37333,0.000381,172.31.36.0-255,66,40217,8,275941
37334,0.000398,172.217.194.0-255,1484,41701,8,275941
37335,0.000401,172.31.36.0-255,66,41767,8,275941
37336,0.000408,172.217.194.0-255,5738,47505,8,275941
37337,0.000411,172.31.36.0-255,66,47571,8,275941
37338,0.000434,172.217.194.0-255,7156,54727,8,275941
37339,0.000437,172.31.36.0-255,66,54793,8,275941
37340,0.000466,172.217.194.0-255,6797,61590,8,275941
37341,0.000469,172.31.36.0-255,66,61656,8,275941
37342,0.000474,172.217.194.0-255,3961,65617,8,275941
37343,0.000476,172.31.36.0-255,66,65683,8,275941
37344,0.000479,172.217.194.0-255,339,66022,8,275941
37345,0.000521,172.217.194.0-255,120,66142,8,275941
37346,0.00061,172.217.194.0-255,381,66523,8,275941
37347,0.000931,172.217.194.0-255,1484,68007,8,275941
37348,0.000936,172.31.36.0-255,66,68073,8,275941
37349,0.000942,172.217.194.0-255,2902,70975,8,275941
37350,0.000944,172.31.36.0-255,66,71041,8,275941
37351,0.000974,172.217.194.0-255,4320,75361,8,275941
37352,0.000977,172.31.36.0-255,66,75427,8,275941
37353,0.000981,172.217.194.0-255,2902,78329,8,275941
37354,0.000983,172.31.36.0-255,66,78395,8,275941
37355,0.000999,172.217.194.0-255,2902,81297,8,275941
37356,0.001002,172.31.36.0-255,66,81363,8,275941
37357,0.001015,172.31.36.0-255,66,81429,8,275941
37358,0.001027,172.31.36.0-255,66,81495,8,275941
37359,0.001056,172.217.194.0-255,1484,82979,8,275941
37360,0.001069,172.217.194.0-255,2902,85881,8,275941
37361,0.001072,172.31.36.0-255,66,85947,8,275941
37362,0.001093,172.217.194.0-255,5738,91685,8,275941
37363,0.001095,172.31.36.0-255,66,91751,8,275941
37364,0.001122,172.217.194.0-255,1484,93235,8,275941
37365,0.001137,172.217.194.0-255,2902,96137,8,275941
37366,0.001139,172.31.36.0-255,66,96203,8,275941
37367,0.001152,172.31.36.0-255,66,96269,8,275941
37368,0.001163,172.31.36.0-255,66,96335,8,275941
37369,0.00123,172.217.194.0-255,1484,97819,8,275941
37370,0.001236,172.217.194.0-255,2902,100721,8,275941
37371,0.001239,172.31.36.0-255,66,100787,8,275941
37372,0.001255,172.217.194.0-255,4320,105107,8,275941
37373,0.001258,172.31.36.0-255,66,105173,8,275941
37374,0.001279,172.217.194.0-255,1484,106657,8,275941
37375,0.001287,172.217.194.0-255,7156,113813,8,275941
37376,0.00129,172.31.36.0-255,66,113879,8,275941
37377,0.001312,172.217.194.0-255,5738,119617,8,275941
37378,0.001315,172.31.36.0-255,66,119683,8,275941
37379,0.001327,172.31.36.0-255,66,119749,8,275941
37380,0.001362,172.217.194.0-255,7156,126905,8,275941
37381,0.001365,172.31.36.0-255,66,126971,8,275941
37382,0.001386,172.217.194.0-255,2902,129873,8,275941
37383,0.001394,172.217.194.0-255,7156,137029,8,275941
37384,0.001398,172.31.36.0-255,66,137095,8,275941
37385,0.001406,172.31.36.0-255,66,137161,8,275941
37386,0.001411,172.217.194.0-255,4320,141481,8,275941
37387,0.001414,172.31.36.0-255,66,141547,8,275941
37388,0.00142,172.217.194.0-255,5738,147285,8,275941
37389,0.001422,172.31.36.0-255,66,147351,8,275941
37390,0.001452,172.217.194.0-255,5738,153089,8,275941
37391,0.001456,172.31.36.0-255,66,153155,8,275941
37392,0.001459,172.217.194.0-255,766,153921,8,275941
37393,0.001612,172.217.194.0-255,1484,155405,8,275941
37394,0.001616,172.31.36.0-255,66,155471,8,275941
37395,0.001622,172.217.194.0-255,2902,158373,8,275941
37396,0.001624,172.31.36.0-255,66,158439,8,275941
37397,0.001628,172.217.194.0-255,1484,159923,8,275941
37398,0.00165,172.217.194.0-255,4320,164243,8,275941
37399,0.001653,172.31.36.0-255,66,164309,8,275941
37400,0.001656,172.217.194.0-255,1484,165793,8,275941
37401,0.001684,172.31.36.0-255,66,165859,8,275941
37402,0.00172,172.217.194.0-255,7156,173015,8,275941
37403,0.001725,172.31.36.0-255,66,173081,8,275941
37404,0.001744,172.217.194.0-255,3602,176683,8,275941
37405,0.001748,172.31.36.0-255,66,176749,8,275941
37406,0.001785,172.217.194.0-255,1484,178233,8,275941
37407,0.001803,172.217.194.0-255,2902,181135,8,275941
37408,0.001807,172.31.36.0-255,66,181201,8,275941
37409,0.001812,172.217.194.0-255,2902,184103,8,275941
37410,0.001814,172.31.36.0-255,66,184169,8,275941
37411,0.001826,172.217.194.0-255,1484,185653,8,275941
37412,0.001846,172.31.36.0-255,66,185719,8,275941
37413,0.001856,172.217.194.0-255,1484,187203,8,275941
37414,0.001893,172.31.36.0-255,66,187269,8,275941
37415,0.001957,172.217.194.0-255,1484,188753,8,275941
37416,0.001962,172.217.194.0-255,2902,191655,8,275941
37417,0.001965,172.31.36.0-255,66,191721,8,275941
37418,0.001969,172.217.194.0-255,1484,193205,8,275941
37419,0.001988,172.217.194.0-255,4320,197525,8,275941
37420,0.001991,172.217.194.0-255,1484,199009,8,275941
37421,0.002052,172.217.194.0-255,5738,204747,8,275941
37422,0.00209,172.31.36.0-255,66,204813,8,275941
37423,0.002098,172.217.194.0-255,5020,209833,8,275941
37424,0.002145,172.217.194.0-255,1484,211317,8,275941
37425,0.002147,172.217.194.0-255,1484,212801,8,275941
37426,0.002169,172.217.194.0-255,1484,214285,8,275941
37427,0.002176,172.217.194.0-255,5738,220023,8,275941
37428,0.002181,172.217.194.0-255,4320,224343,8,275941
37429,0.002196,172.217.194.0-255,2902,227245,8,275941
37430,0.002237,172.217.194.0-255,4320,231565,8,275941
37431,0.002244,172.217.194.0-255,5020,236585,8,275941
37432,0.002249,172.217.194.0-255,4320,240905,8,275941
37433,0.002267,172.217.194.0-255,1484,242389,8,275941
37434,0.002272,172.217.194.0-255,4320,246709,8,275941
37435,0.002299,172.217.194.0-255,5738,252447,8,275941
37436,0.002344,172.217.194.0-255,5738,258185,8,275941
37437,0.002367,172.217.194.0-255,6670,264855,8,275941
37438,0.002421,172.217.194.0-255,105,264960,8,275941
37439,0.01204,172.31.36.0-255,66,265026,8,275941
37440,0.012475,172.217.194.0-255,105,265131,8,275941
37441,0.012484,172.31.36.0-255,78,265209,8,275941
37442,0.013166,172.31.36.0-255,101,265310,8,275941
37443,0.014792,172.31.36.0-255,105,265415,8,275941
37444,0.015829,172.217.194.0-255,66,265481,8,275941
37445,0.017478,172.217.194.0-255,66,265547,8,275941
37446,0.046004,172.31.36.0-255,172,265719,8,275941
37447,0.04604,172.31.36.0-255,1111,266830,8,275941
37448,0.04614,172.31.36.0-255,1514,268344,8,275941
37449,0.046142,172.31.36.0-255,1514,269858,8,275941
37450,0.046148,172.31.36.0-255,1514,271372,8,275941
37451,0.046149,172.31.36.0-255,1514,272886,8,275941
37452,0.046169,172.31.36.0-255,1514,274400,8,275941
37453,0.04617,172.31.36.0-255,995,275395,8,275941
37454,0.047565,104.244.42.0-255,66,275461,8,275941
37455,0.047607,104.244.42.0-255,66,275527,8,275941
37456,0.047697,104.244.42.0-255,66,275593,8,275941
37457,0.047756,104.244.42.0-255,66,275659,8,275941
37458,0.048292,104.244.42.0-255,108,275767,8,275941
37459,0.048303,172.31.36.0-255,66,275833,8,275941
37460,0.054552,172.31.36.0-255,108,275941,8,275941
37461,0.0,74.125.68.0-255,294,294,8,367587
37462,2.8e-05,172.31.36.0-255,66,360,8,367587
37463,3.4e-05,74.125.68.0-255,1484,1844,8,367587
37464,3.9e-05,172.31.36.0-255,66,1910,8,367587
37465,6.1e-05,74.125.68.0-255,2902,4812,8,367587
37466,6.4e-05,172.31.36.0-255,66,4878,8,367587
37467,7e-05,74.125.68.0-255,4320,9198,8,367587
37468,7.3e-05,172.31.36.0-255,66,9264,8,367587
37469,0.0001,74.125.68.0-255,6121,15385,8,367587
37470,0.000104,172.31.36.0-255,66,15451,8,367587
37471,0.000146,74.125.68.0-255,7156,22607,8,367587
37472,0.000151,172.31.36.0-255,66,22673,8,367587
37473,0.000217,172.31.36.0-255,66,22739,8,367587
37474,0.000281,74.125.68.0-255,1484,24223,8,367587
37475,0.000288,172.31.36.0-255,66,24289,8,367587
37476,0.000293,74.125.68.0-255,2902,27191,8,367587
37477,0.000295,172.31.36.0-255,66,27257,8,367587
37478,0.000316,74.125.68.0-255,4320,31577,8,367587
37479,0.000319,172.31.36.0-255,66,31643,8,367587
37480,0.000359,74.125.68.0-255,5738,37381,8,367587
37481,0.000365,172.31.36.0-255,66,37447,8,367587
37482,0.000401,74.125.68.0-255,2543,39990,8,367587
37483,0.000405,172.31.36.0-255,66,40056,8,367587
37484,0.000451,172.31.36.0-255,66,40122,8,367587
37485,0.00051,74.125.68.0-255,2902,43024,8,367587
37486,0.000514,172.31.36.0-255,66,43090,8,367587
37487,0.000535,74.125.68.0-255,4236,47326,8,367587
37488,0.000537,172.31.36.0-255,66,47392,8,367587
37489,0.000541,74.125.68.0-255,126,47518,8,367587
37490,0.000543,172.31.36.0-255,66,47584,8,367587
37491,0.000577,74.125.68.0-255,5738,53322,8,367587
37492,0.000581,172.31.36.0-255,66,53388,8,367587
37493,0.000625,74.125.68.0-255,7156,60544,8,367587
37494,0.000629,172.31.36.0-255,66,60610,8,367587
37495,0.000686,74.125.68.0-255,5738,66348,8,367587
37496,0.00069,172.31.36.0-255,66,66414,8,367587
37497,0.000714,74.125.68.0-255,7156,73570,8,367587
37498,0.000719,172.31.36.0-255,66,73636,8,367587
37499,0.000789,74.125.68.0-255,4320,77956,8,367587
37500,0.000793,172.31.36.0-255,66,78022,8,367587
37501,0.000814,74.125.68.0-255,3602,81624,8,367587
37502,0.000818,172.31.36.0-255,66,81690,8,367587
37503,0.000837,74.125.68.0-255,352,82042,8,367587
37504,0.001069,172.31.36.0-255,66,82108,8,367587
37505,0.001258,74.125.68.0-255,1484,83592,8,367587
37506,0.001269,74.125.68.0-255,2902,86494,8,367587
37507,0.001273,172.31.36.0-255,66,86560,8,367587
37508,0.001281,74.125.68.0-255,5738,92298,8,367587
37509,0.001283,172.31.36.0-255,66,92364,8,367587
37510,0.001318,74.125.68.0-255,2902,95266,8,367587
37511,0.001322,172.31.36.0-255,66,95332,8,367587
37512,0.001345,74.125.68.0-255,4320,99652,8,367587
37513,0.001349,172.31.36.0-255,66,99718,8,367587
37514,0.001389,74.125.68.0-255,5738,105456,8,367587
37515,0.001393,172.31.36.0-255,66,105522,8,367587
37516,0.001412,74.125.68.0-255,2902,108424,8,367587
37517,0.001414,172.31.36.0-255,66,108490,8,367587
37518,0.00147,172.31.36.0-255,66,108556,8,367587
37519,0.00159,74.125.68.0-255,1484,110040,8,367587
37520,0.001596,74.125.68.0-255,1484,111524,8,367587
37521,0.0016,172.31.36.0-255,66,111590,8,367587
37522,0.001623,74.125.68.0-255,1484,113074,8,367587
37523,0.001629,74.125.68.0-255,2902,115976,8,367587
37524,0.001632,172.31.36.0-255,66,116042,8,367587
37525,0.001636,74.125.68.0-255,1484,117526,8,367587
37526,0.001663,74.125.68.0-255,5738,123264,8,367587
37527,0.001666,172.31.36.0-255,66,123330,8,367587
37528,0.001693,74.125.68.0-255,1484,124814,8,367587
37529,0.001711,74.125.68.0-255,2902,127716,8,367587
37530,0.001716,172.31.36.0-255,66,127782,8,367587
37531,0.001732,74.125.68.0-255,1484,129266,8,367587
37532,0.001747,74.125.68.0-255,4320,133586,8,367587
37533,0.00175,172.31.36.0-255,66,133652,8,367587
37534,0.001781,74.125.68.0-255,1484,135136,8,367587
37535,0.001785,74.125.68.0-255,1484,136620,8,367587
37536,0.001787,172.31.36.0-255,66,136686,8,367587
37537,0.001815,74.125.68.0-255,6438,143124,8,367587
37538,0.001819,172.31.36.0-255,66,143190,8,367587
37539,0.001864,74.125.68.0-255,1484,144674,8,367587
37540,0.001887,74.125.68.0-255,2902,147576,8,367587
37541,0.001892,172.31.36.0-255,66,147642,8,367587
37542,0.001895,74.125.68.0-255,1484,149126,8,367587
37543,0.001915,74.125.68.0-255,4320,153446,8,367587
37544,0.001917,172.31.36.0-255,66,153512,8,367587
37545,0.001964,172.31.36.0-255,66,153578,8,367587
37546,0.002059,74.125.68.0-255,4320,157898,8,367587
37547,0.002061,172.31.36.0-255,66,157964,8,367587
37548,0.002094,74.125.68.0-255,2902,160866,8,367587
37549,0.002097,172.31.36.0-255,66,160932,8,367587
37550,0.002116,74.125.68.0-255,3602,164534,8,367587
37551,0.002119,172.31.36.0-255,66,164600,8,367587
37552,0.002157,74.125.68.0-255,5738,170338,8,367587
37553,0.00216,172.31.36.0-255,66,170404,8,367587
37554,0.002179,74.125.68.0-255,7156,177560,8,367587
37555,0.002182,172.31.36.0-255,66,177626,8,367587
37556,0.002257,74.125.68.0-255,1484,179110,8,367587
37557,0.002277,74.125.68.0-255,4320,183430,8,367587
37558,0.002279,172.31.36.0-255,66,183496,8,367587
37559,0.00229,74.125.68.0-255,1484,184980,8,367587
37560,0.002375,172.31.36.0-255,66,185046,8,367587
37561,0.002397,74.125.68.0-255,3602,188648,8,367587
37562,0.0024,172.31.36.0-255,66,188714,8,367587
37563,0.002437,74.125.68.0-255,1484,190198,8,367587
37564,0.002468,172.31.36.0-255,66,190264,8,367587
37565,0.004722,74.125.68.0-255,5738,196002,8,367587
37566,0.00473,172.31.36.0-255,66,196068,8,367587
37567,0.006981,74.125.68.0-255,5738,201806,8,367587
37568,0.006987,172.31.36.0-255,66,201872,8,367587
37569,0.009247,74.125.68.0-255,5738,207610,8,367587
37570,0.009254,172.31.36.0-255,66,207676,8,367587
37571,0.011498,74.125.68.0-255,5738,213414,8,367587
37572,0.011505,172.31.36.0-255,66,213480,8,367587
37573,0.013753,74.125.68.0-255,5738,219218,8,367587
37574,0.013762,172.31.36.0-255,66,219284,8,367587
37575,0.016012,74.125.68.0-255,5738,225022,8,367587
37576,0.016019,172.31.36.0-255,66,225088,8,367587
37577,0.01827,74.125.68.0-255,5738,230826,8,367587
37578,0.018281,172.31.36.0-255,66,230892,8,367587
37579,0.020531,74.125.68.0-255,5738,236630,8,367587
37580,0.020539,172.31.36.0-255,66,236696,8,367587
37581,0.022795,74.125.68.0-255,5738,242434,8,367587
37582,0.022805,172.31.36.0-255,66,242500,8,367587
37583,0.02505,74.125.68.0-255,5738,248238,8,367587
37584,0.025057,172.31.36.0-255,66,248304,8,367587
37585,0.027313,74.125.68.0-255,5738,254042,8,367587
37586,0.027322,172.31.36.0-255,66,254108,8,367587
37587,0.02958,74.125.68.0-255,5738,259846,8,367587
37588,0.029588,172.31.36.0-255,66,259912,8,367587
37589,0.03007,172.31.36.0-255,172,260084,8,367587
37590,0.030099,172.31.36.0-255,1112,261196,8,367587
37591,0.030169,172.31.36.0-255,1514,262710,8,367587
37592,0.03017,172.31.36.0-255,1514,264224,8,367587
37593,0.030172,172.31.36.0-255,1514,265738,8,367587
37594,0.030199,172.31.36.0-255,1514,267252,8,367587
37595,0.030201,172.31.36.0-255,1229,268481,8,367587
37596,0.03164,104.244.42.0-255,66,268547,8,367587
37597,0.03165,104.244.42.0-255,66,268613,8,367587
37598,0.031788,104.244.42.0-255,66,268679,8,367587
37599,0.031849,104.244.42.0-255,66,268745,8,367587
37600,0.031864,74.125.68.0-255,5738,274483,8,367587
37601,0.031869,172.31.36.0-255,66,274549,8,367587
37602,0.032536,104.244.42.0-255,108,274657,8,367587
37603,0.032543,172.31.36.0-255,66,274723,8,367587
37604,0.034126,74.125.68.0-255,5738,280461,8,367587
37605,0.034132,172.31.36.0-255,66,280527,8,367587
37606,0.036381,74.125.68.0-255,5738,286265,8,367587
37607,0.036388,172.31.36.0-255,66,286331,8,367587
37608,0.038652,74.125.68.0-255,5738,292069,8,367587
37609,0.038661,172.31.36.0-255,66,292135,8,367587
37610,0.040911,74.125.68.0-255,5738,297873,8,367587
37611,0.040923,172.31.36.0-255,66,297939,8,367587
37612,0.04318,74.125.68.0-255,5738,303677,8,367587
37613,0.043187,172.31.36.0-255,66,303743,8,367587
37614,0.045452,74.125.68.0-255,5738,309481,8,367587
37615,0.045459,172.31.36.0-255,66,309547,8,367587
37616,0.047715,74.125.68.0-255,5738,315285,8,367587
37617,0.047722,172.31.36.0-255,66,315351,8,367587
37618,0.049973,74.125.68.0-255,5738,321089,8,367587
37619,0.049979,172.31.36.0-255,66,321155,8,367587
37620,0.052237,74.125.68.0-255,5738,326893,8,367587
37621,0.052244,172.31.36.0-255,66,326959,8,367587
37622,0.054506,74.125.68.0-255,5738,332697,8,367587
37623,0.054513,172.31.36.0-255,66,332763,8,367587
37624,0.056757,74.125.68.0-255,5738,338501,8,367587
37625,0.056764,172.31.36.0-255,66,338567,8,367587
37626,0.059013,74.125.68.0-255,5738,344305,8,367587
37627,0.059018,172.31.36.0-255,66,344371,8,367587
37628,0.061288,74.125.68.0-255,5738,350109,8,367587
37629,0.061295,172.31.36.0-255,66,350175,8,367587
37630,0.063556,74.125.68.0-255,5738,355913,8,367587
37631,0.063563,172.31.36.0-255,66,355979,8,367587
37632,0.065859,74.125.68.0-255,5738,361717,8,367587
37633,0.065866,172.31.36.0-255,66,361783,8,367587
37634,0.068127,74.125.68.0-255,5738,367521,8,367587
37635,0.068133,172.31.36.0-255,66,367587,8,367587
37636,0.0,74.125.24.0-255,153,153,8,286639
37637,2.5e-05,172.31.36.0-255,66,219,8,286639
37638,3.2e-05,74.125.24.0-255,1484,1703,8,286639
37639,3.6e-05,172.31.36.0-255,66,1769,8,286639
37640,4.1e-05,74.125.24.0-255,2902,4671,8,286639
37641,4.5e-05,172.31.36.0-255,66,4737,8,286639
37642,4.8e-05,74.125.24.0-255,1484,6221,8,286639
37643,5e-05,172.31.36.0-255,66,6287,8,286639
37644,5.4e-05,74.125.24.0-255,2902,9189,8,286639
37645,5.6e-05,172.31.36.0-255,66,9255,8,286639
37646,8.6e-05,74.125.24.0-255,4849,14104,8,286639
37647,9.2e-05,172.31.36.0-255,66,14170,8,286639
37648,0.00016,74.125.24.0-255,1484,15654,8,286639
37649,0.000165,172.31.36.0-255,66,15720,8,286639
37650,0.000172,74.125.24.0-255,2902,18622,8,286639
37651,0.000174,172.31.36.0-255,66,18688,8,286639
37652,0.000178,74.125.24.0-255,1484,20172,8,286639
37653,0.000181,172.31.36.0-255,66,20238,8,286639
37654,0.000208,74.125.24.0-255,4320,24558,8,286639
37655,0.000211,172.31.36.0-255,66,24624,8,286639
37656,0.000235,172.31.36.0-255,66,24690,8,286639
37657,0.000257,74.125.24.0-255,5379,30069,8,286639
37658,0.00026,172.31.36.0-255,66,30135,8,286639
37659,0.000267,74.125.24.0-255,7156,37291,8,286639
37660,0.00027,172.31.36.0-255,66,37357,8,286639
37661,0.00032,74.125.24.0-255,2543,39900,8,286639
37662,0.000325,172.31.36.0-255,66,39966,8,286639
37663,0.000366,74.125.24.0-255,1484,41450,8,286639
37664,0.00037,172.31.36.0-255,66,41516,8,286639
37665,0.000391,74.125.24.0-255,2902,44418,8,286639
37666,0.000394,172.31.36.0-255,66,44484,8,286639
37667,0.000398,74.125.24.0-255,2902,47386,8,286639
37668,0.000402,172.31.36.0-255,66,47452,8,286639
37669,0.000414,74.125.24.0-255,2902,50354,8,286639
37670,0.000417,74.125.24.0-255,1484,51838,8,286639
37671,0.000437,74.125.24.0-255,5379,57217,8,286639
37672,0.00044,172.31.36.0-255,66,57283,8,286639
37673,0.000446,172.31.36.0-255,66,57349,8,286639
37674,0.000458,74.125.24.0-255,646,57995,8,286639
37675,0.000678,74.125.24.0-255,1484,59479,8,286639
37676,0.000682,172.31.36.0-255,66,59545,8,286639
37677,0.000687,74.125.24.0-255,2902,62447,8,286639
37678,0.000697,172.31.36.0-255,66,62513,8,286639
37679,0.000703,74.125.24.0-255,5738,68251,8,286639
37680,0.000705,172.31.36.0-255,66,68317,8,286639
37681,0.000739,172.31.36.0-255,66,68383,8,286639
37682,0.000749,74.125.24.0-255,2902,71285,8,286639
37683,0.000757,172.31.36.0-255,66,71351,8,286639
37684,0.000771,172.31.36.0-255,66,71417,8,286639
37685,0.001159,74.125.24.0-255,1484,72901,8,286639
37686,0.001165,172.31.36.0-255,66,72967,8,286639
37687,0.001173,74.125.24.0-255,2902,75869,8,286639
37688,0.00118,74.125.24.0-255,5738,81607,8,286639
37689,0.001193,74.125.24.0-255,1484,83091,8,286639
37690,0.001252,74.125.24.0-255,5738,88829,8,286639
37691,0.00174,74.125.24.0-255,1484,90313,8,286639
37692,0.001747,74.125.24.0-255,2902,93215,8,286639
37693,0.00175,74.125.24.0-255,1484,94699,8,286639
37694,0.001765,74.125.24.0-255,4320,99019,8,286639
37695,0.001826,74.125.24.0-255,2184,101203,8,286639
37696,0.004611,172.31.36.0-255,66,101269,8,286639
37697,0.006684,74.125.24.0-255,5738,107007,8,286639
37698,0.00669,172.31.36.0-255,66,107073,8,286639
37699,0.008767,74.125.24.0-255,5738,112811,8,286639
37700,0.008773,172.31.36.0-255,66,112877,8,286639
37701,0.010829,74.125.24.0-255,5738,118615,8,286639
37702,0.012071,172.31.36.0-255,66,118681,8,286639
37703,0.014144,74.125.24.0-255,5738,124419,8,286639
37704,0.014152,172.31.36.0-255,66,124485,8,286639
37705,0.016227,74.125.24.0-255,5738,130223,8,286639
37706,0.016236,172.31.36.0-255,66,130289,8,286639
37707,0.018312,74.125.24.0-255,5738,136027,8,286639
37708,0.01832,172.31.36.0-255,66,136093,8,286639
37709,0.020379,74.125.24.0-255,5738,141831,8,286639
37710,0.020386,172.31.36.0-255,66,141897,8,286639
37711,0.022452,74.125.24.0-255,5738,147635,8,286639
37712,0.022459,172.31.36.0-255,66,147701,8,286639
37713,0.02454,74.125.24.0-255,5738,153439,8,286639
37714,0.024547,172.31.36.0-255,66,153505,8,286639
37715,0.026618,74.125.24.0-255,5738,159243,8,286639
37716,0.026625,172.31.36.0-255,66,159309,8,286639
37717,0.028727,74.125.24.0-255,5738,165047,8,286639
37718,0.028733,172.31.36.0-255,66,165113,8,286639
37719,0.030813,74.125.24.0-255,5738,170851,8,286639
37720,0.030821,172.31.36.0-255,66,170917,8,286639
37721,0.032911,74.125.24.0-255,5738,176655,8,286639
37722,0.032917,172.31.36.0-255,66,176721,8,286639
37723,0.033283,172.31.36.0-255,172,176893,8,286639
37724,0.033313,172.31.36.0-255,1113,178006,8,286639
37725,0.033365,172.31.36.0-255,1514,179520,8,286639
37726,0.033367,172.31.36.0-255,1514,181034,8,286639
37727,0.033372,172.31.36.0-255,1514,182548,8,286639
37728,0.033373,172.31.36.0-255,1514,184062,8,286639
37729,0.033417,172.31.36.0-255,1227,185289,8,286639
37730,0.034813,104.244.42.0-255,66,185355,8,286639
37731,0.034927,104.244.42.0-255,66,185421,8,286639
37732,0.034931,104.244.42.0-255,66,185487,8,286639
37733,0.035008,74.125.24.0-255,2902,188389,8,286639
37734,0.035015,172.31.36.0-255,66,188455,8,286639
37735,0.035036,104.244.42.0-255,66,188521,8,286639
37736,0.03504,74.125.24.0-255,2902,191423,8,286639
37737,0.035394,172.31.36.0-255,66,191489,8,286639
37738,0.035572,104.244.42.0-255,108,191597,8,286639
37739,0.035582,172.31.36.0-255,66,191663,8,286639
37740,0.037083,74.125.24.0-255,2902,194565,8,286639
37741,0.037088,172.31.36.0-255,66,194631,8,286639
37742,0.037455,74.125.24.0-255,2902,197533,8,286639
37743,0.037461,172.31.36.0-255,66,197599,8,286639
37744,0.03913,74.125.24.0-255,2902,200501,8,286639
37745,0.039136,172.31.36.0-255,66,200567,8,286639
37746,0.03952,74.125.24.0-255,2902,203469,8,286639
37747,0.039525,172.31.36.0-255,66,203535,8,286639
37748,0.041215,74.125.24.0-255,2902,206437,8,286639
37749,0.041221,172.31.36.0-255,66,206503,8,286639
37750,0.041585,74.125.24.0-255,2902,209405,8,286639
37751,0.04159,172.31.36.0-255,66,209471,8,286639
37752,0.043286,74.125.24.0-255,2902,212373,8,286639
37753,0.043292,172.31.36.0-255,66,212439,8,286639
37754,0.043664,74.125.24.0-255,2902,215341,8,286639
37755,0.043669,172.31.36.0-255,66,215407,8,286639
37756,0.045364,74.125.24.0-255,2902,218309,8,286639
37757,0.04537,172.31.36.0-255,66,218375,8,286639
37758,0.045746,74.125.24.0-255,2902,221277,8,286639
37759,0.045752,172.31.36.0-255,66,221343,8,286639
37760,0.047438,74.125.24.0-255,2902,224245,8,286639
37761,0.047444,172.31.36.0-255,66,224311,8,286639
37762,0.047823,74.125.24.0-255,2902,227213,8,286639
37763,0.047828,172.31.36.0-255,66,227279,8,286639
37764,0.049526,74.125.24.0-255,2902,230181,8,286639
37765,0.049531,172.31.36.0-255,66,230247,8,286639
37766,0.049924,74.125.24.0-255,2902,233149,8,286639
37767,0.04993,172.31.36.0-255,66,233215,8,286639
37768,0.051621,74.125.24.0-255,2902,236117,8,286639
37769,0.051627,172.31.36.0-255,66,236183,8,286639
37770,0.051985,74.125.24.0-255,2902,239085,8,286639
37771,0.051991,172.31.36.0-255,66,239151,8,286639
37772,0.053702,74.125.24.0-255,2902,242053,8,286639
37773,0.053707,172.31.36.0-255,66,242119,8,286639
37774,0.054051,74.125.24.0-255,2902,245021,8,286639
37775,0.054056,172.31.36.0-255,66,245087,8,286639
37776,0.055762,74.125.24.0-255,2902,247989,8,286639
37777,0.055768,172.31.36.0-255,66,248055,8,286639
37778,0.05612,74.125.24.0-255,2902,250957,8,286639
37779,0.056126,172.31.36.0-255,66,251023,8,286639
37780,0.057822,74.125.24.0-255,2902,253925,8,286639
37781,0.057827,172.31.36.0-255,66,253991,8,286639
37782,0.058198,74.125.24.0-255,2902,256893,8,286639
37783,0.058204,172.31.36.0-255,66,256959,8,286639
37784,0.059895,74.125.24.0-255,2902,259861,8,286639
37785,0.0599,172.31.36.0-255,66,259927,8,286639
37786,0.060278,74.125.24.0-255,2902,262829,8,286639
37787,0.060283,172.31.36.0-255,66,262895,8,286639
37788,0.06197,74.125.24.0-255,2902,265797,8,286639
37789,0.061975,172.31.36.0-255,66,265863,8,286639
37790,0.062351,74.125.24.0-255,2902,268765,8,286639
37791,0.062356,172.31.36.0-255,66,268831,8,286639
37792,0.064037,74.125.24.0-255,2902,271733,8,286639
37793,0.064042,172.31.36.0-255,66,271799,8,286639
37794,0.064421,74.125.24.0-255,2902,274701,8,286639
37795,0.064427,172.31.36.0-255,66,274767,8,286639
37796,0.066093,74.125.24.0-255,2902,277669,8,286639
37797,0.066098,172.31.36.0-255,66,277735,8,286639
37798,0.066493,74.125.24.0-255,2902,280637,8,286639
37799,0.066499,172.31.36.0-255,66,280703,8,286639
37800,0.06815,74.125.24.0-255,2902,283605,8,286639
37801,0.068156,172.31.36.0-255,66,283671,8,286639
37802,0.068548,74.125.24.0-255,2902,286573,8,286639
37803,0.068553,172.31.36.0-255,66,286639,8,286639
37804,0.0,74.125.24.0-255,152,152,8,295036
37805,2.6e-05,172.31.36.0-255,66,218,8,295036
37806,3.3e-05,74.125.24.0-255,1484,1702,8,295036
37807,3.6e-05,172.31.36.0-255,66,1768,8,295036
37808,4.1e-05,74.125.24.0-255,2902,4670,8,295036
37809,4.3e-05,172.31.36.0-255,66,4736,8,295036
37810,4.9e-05,74.125.24.0-255,5738,10474,8,295036
37811,5.1e-05,172.31.36.0-255,66,10540,8,295036
37812,7.2e-05,74.125.24.0-255,1484,12024,8,295036
37813,7.4e-05,172.31.36.0-255,66,12090,8,295036
37814,7.8e-05,74.125.24.0-255,3466,15556,8,295036
37815,8e-05,172.31.36.0-255,66,15622,8,295036
37816,8.5e-05,74.125.24.0-255,5738,21360,8,295036
37817,8.7e-05,172.31.36.0-255,66,21426,8,295036
37818,0.000118,74.125.24.0-255,7156,28582,8,295036
37819,0.000121,172.31.36.0-255,66,28648,8,295036
37820,0.000124,74.125.24.0-255,2543,31191,8,295036
37821,0.000126,172.31.36.0-255,66,31257,8,295036
37822,0.000141,74.125.24.0-255,2902,34159,8,295036
37823,0.000143,172.31.36.0-255,66,34225,8,295036
37824,0.000162,74.125.24.0-255,7156,41381,8,295036
37825,0.000165,172.31.36.0-255,66,41447,8,295036
37826,0.00017,74.125.24.0-255,4320,45767,8,295036
37827,0.000172,172.31.36.0-255,66,45833,8,295036
37828,0.000218,74.125.24.0-255,2543,48376,8,295036
37829,0.000222,172.31.36.0-255,66,48442,8,295036
37830,0.000517,74.125.24.0-255,1484,49926,8,295036
37831,0.000521,172.31.36.0-255,66,49992,8,295036
37832,0.000527,74.125.24.0-255,2902,52894,8,295036
37833,0.00053,172.31.36.0-255,66,52960,8,295036
37834,0.000536,74.125.24.0-255,5738,58698,8,295036
37835,0.000538,172.31.36.0-255,66,58764,8,295036
37836,0.000571,74.125.24.0-255,4320,63084,8,295036
37837,0.000574,172.31.36.0-255,66,63150,8,295036
37838,0.000602,172.31.36.0-255,66,63216,8,295036
37839,0.000649,172.31.36.0-255,66,63282,8,295036
37840,0.000781,74.125.24.0-255,1484,64766,8,295036
37841,0.000787,74.125.24.0-255,2902,67668,8,295036
37842,0.00079,172.31.36.0-255,66,67734,8,295036
37843,0.000795,74.125.24.0-255,4320,72054,8,295036
37844,0.000798,172.31.36.0-255,66,72120,8,295036
37845,0.000811,74.125.24.0-255,1484,73604,8,295036
37846,0.000831,74.125.24.0-255,6797,80401,8,295036
37847,0.000835,172.31.36.0-255,66,80467,8,295036
37848,0.000974,74.125.24.0-255,1484,81951,8,295036
37849,0.000979,74.125.24.0-255,2902,84853,8,295036
37850,0.000982,172.31.36.0-255,66,84919,8,295036
37851,0.001006,74.125.24.0-255,5738,90657,8,295036
37852,0.001009,172.31.36.0-255,66,90723,8,295036
37853,0.001028,74.125.24.0-255,2902,93625,8,295036
37854,0.00103,172.31.36.0-255,66,93691,8,295036
37855,0.00105,74.125.24.0-255,3847,97538,8,295036
37856,0.001053,172.31.36.0-255,66,97604,8,295036
37857,0.001129,74.125.24.0-255,211,97815,8,295036
37858,0.001163,172.31.36.0-255,66,97881,8,295036
37859,0.001491,74.125.24.0-255,1484,99365,8,295036
37860,0.001502,74.125.24.0-255,2902,102267,8,295036
37861,0.001506,172.31.36.0-255,66,102333,8,295036
37862,0.001513,74.125.24.0-255,5738,108071,8,295036
37863,0.001515,172.31.36.0-255,66,108137,8,295036
37864,0.001553,172.31.36.0-255,66,108203,8,295036
37865,0.001568,74.125.24.0-255,4320,112523,8,295036
37866,0.001571,172.31.36.0-255,66,112589,8,295036
37867,0.001587,74.125.24.0-255,7156,119745,8,295036
37868,0.001589,172.31.36.0-255,66,119811,8,295036
37869,0.001593,74.125.24.0-255,2184,121995,8,295036
37870,0.001595,172.31.36.0-255,66,122061,8,295036
37871,0.003904,74.125.24.0-255,2902,124963,8,295036
37872,0.00391,172.31.36.0-255,66,125029,8,295036
37873,0.003934,74.125.24.0-255,2902,127931,8,295036
37874,0.003936,172.31.36.0-255,66,127997,8,295036
37875,0.005544,172.31.36.0-255,101,128098,8,295036
37876,0.006233,74.125.24.0-255,2902,131000,8,295036
37877,0.006238,172.31.36.0-255,66,131066,8,295036
37878,0.006266,74.125.24.0-255,2902,133968,8,295036
37879,0.006269,172.31.36.0-255,66,134034,8,295036
37880,0.007841,74.125.24.0-255,66,134100,8,295036
37881,0.008568,74.125.24.0-255,2902,137002,8,295036
37882,0.008574,172.31.36.0-255,66,137068,8,295036
37883,0.008595,74.125.24.0-255,2902,139970,8,295036
37884,0.008598,172.31.36.0-255,66,140036,8,295036
37885,0.010892,74.125.24.0-255,2902,142938,8,295036
37886,0.0109,172.31.36.0-255,66,143004,8,295036
37887,0.010929,74.125.24.0-255,2902,145906,8,295036
37888,0.010931,172.31.36.0-255,66,145972,8,295036
37889,0.013262,74.125.24.0-255,5738,151710,8,295036
37890,0.013269,172.31.36.0-255,66,151776,8,295036
37891,0.015586,74.125.24.0-255,5738,157514,8,295036
37892,0.015594,172.31.36.0-255,66,157580,8,295036
37893,0.017948,74.125.24.0-255,5738,163318,8,295036
37894,0.017956,172.31.36.0-255,66,163384,8,295036
37895,0.020303,74.125.24.0-255,5738,169122,8,295036
37896,0.020309,172.31.36.0-255,66,169188,8,295036
37897,0.022655,74.125.24.0-255,5738,174926,8,295036
37898,0.022661,172.31.36.0-255,66,174992,8,295036
37899,0.02499,74.125.24.0-255,5738,180730,8,295036
37900,0.024996,172.31.36.0-255,66,180796,8,295036
37901,0.027351,74.125.24.0-255,5738,186534,8,295036
37902,0.027357,172.31.36.0-255,66,186600,8,295036
37903,0.029703,74.125.24.0-255,5738,192338,8,295036
37904,0.029711,172.31.36.0-255,66,192404,8,295036
37905,0.031162,172.31.36.0-255,172,192576,8,295036
37906,0.031192,172.31.36.0-255,1110,193686,8,295036
37907,0.031255,172.31.36.0-255,1514,195200,8,295036
37908,0.031257,172.31.36.0-255,1514,196714,8,295036
37909,0.031263,172.31.36.0-255,1514,198228,8,295036
37910,0.031264,172.31.36.0-255,1514,199742,8,295036
37911,0.031282,172.31.36.0-255,418,200160,8,295036
37912,0.032042,74.125.24.0-255,5738,205898,8,295036
37913,0.032048,172.31.36.0-255,66,205964,8,295036
37914,0.032712,104.244.42.0-255,66,206030,8,295036
37915,0.032761,104.244.42.0-255,66,206096,8,295036
37916,0.032857,104.244.42.0-255,66,206162,8,295036
37917,0.032864,104.244.42.0-255,66,206228,8,295036
37918,0.034376,74.125.24.0-255,4320,210548,8,295036
37919,0.034382,172.31.36.0-255,66,210614,8,295036
37920,0.034416,74.125.24.0-255,1484,212098,8,295036
37921,0.03673,74.125.24.0-255,4320,216418,8,295036
37922,0.036735,172.31.36.0-255,66,216484,8,295036
37923,0.039057,74.125.24.0-255,4320,220804,8,295036
37924,0.039062,172.31.36.0-255,66,220870,8,295036
37925,0.039107,74.125.24.0-255,1484,222354,8,295036
37926,0.041378,74.125.24.0-255,4320,226674,8,295036
37927,0.041383,172.31.36.0-255,66,226740,8,295036
37928,0.043729,74.125.24.0-255,5738,232478,8,295036
37929,0.043734,172.31.36.0-255,66,232544,8,295036
37930,0.046079,74.125.24.0-255,5738,238282,8,295036
37931,0.046084,172.31.36.0-255,66,238348,8,295036
37932,0.048425,74.125.24.0-255,5738,244086,8,295036
37933,0.04843,172.31.36.0-255,66,244152,8,295036
37934,0.050774,74.125.24.0-255,5738,249890,8,295036
37935,0.05078,172.31.36.0-255,66,249956,8,295036
37936,0.053116,74.125.24.0-255,5738,255694,8,295036
37937,0.053121,172.31.36.0-255,66,255760,8,295036
37938,0.055454,74.125.24.0-255,5738,261498,8,295036
37939,0.055459,172.31.36.0-255,66,261564,8,295036
37940,0.057767,74.125.24.0-255,5738,267302,8,295036
37941,0.057773,172.31.36.0-255,66,267368,8,295036
37942,0.060102,74.125.24.0-255,4320,271688,8,295036
37943,0.060108,172.31.36.0-255,66,271754,8,295036
37944,0.060136,74.125.24.0-255,1484,273238,8,295036
37945,0.062438,74.125.24.0-255,4320,277558,8,295036
37946,0.062443,172.31.36.0-255,66,277624,8,295036
37947,0.064791,74.125.24.0-255,5738,283362,8,295036
37948,0.064796,172.31.36.0-255,66,283428,8,295036
37949,0.067118,74.125.24.0-255,5738,289166,8,295036
37950,0.067123,172.31.36.0-255,66,289232,8,295036
37951,0.069451,74.125.24.0-255,5738,294970,8,295036
37952,0.069456,172.31.36.0-255,66,295036,8,295036
37953,0.0,74.125.24.0-255,291,291,8,339782
37954,2.4e-05,172.31.36.0-255,66,357,8,339782
37955,3.1e-05,74.125.24.0-255,1484,1841,8,339782
37956,3.6e-05,172.31.36.0-255,66,1907,8,339782
37957,4.4e-05,74.125.24.0-255,4320,6227,8,339782
37958,4.8e-05,172.31.36.0-255,66,6293,8,339782
37959,5.1e-05,74.125.24.0-255,1484,7777,8,339782
37960,5.4e-05,172.31.36.0-255,66,7843,8,339782
37961,7.8e-05,74.125.24.0-255,6159,14002,8,339782
37962,8.1e-05,172.31.36.0-255,66,14068,8,339782
37963,0.000108,74.125.24.0-255,7156,21224,8,339782
37964,0.000112,172.31.36.0-255,66,21290,8,339782
37965,0.000186,74.125.24.0-255,5738,27028,8,339782
37966,0.00019,172.31.36.0-255,66,27094,8,339782
37967,0.000209,74.125.24.0-255,3961,31055,8,339782
37968,0.000211,172.31.36.0-255,66,31121,8,339782
37969,0.000257,74.125.24.0-255,1484,32605,8,339782
37970,0.00026,172.31.36.0-255,66,32671,8,339782
37971,0.000265,74.125.24.0-255,2902,35573,8,339782
37972,0.000268,172.31.36.0-255,66,35639,8,339782
37973,0.000271,74.125.24.0-255,1484,37123,8,339782
37974,0.000273,172.31.36.0-255,66,37189,8,339782
37975,0.000298,74.125.24.0-255,4320,41509,8,339782
37976,0.000301,172.31.36.0-255,66,41575,8,339782
37977,0.000309,74.125.24.0-255,7156,48731,8,339782
37978,0.000311,172.31.36.0-255,66,48797,8,339782
37979,0.000331,74.125.24.0-255,6797,55594,8,339782
37980,0.000334,172.31.36.0-255,66,55660,8,339782
37981,0.000346,172.31.36.0-255,66,55726,8,339782
37982,0.000367,74.125.24.0-255,361,56087,8,339782
37983,0.000369,172.31.36.0-255,66,56153,8,339782
37984,0.000396,74.125.24.0-255,132,56285,8,339782
37985,0.000491,74.125.24.0-255,347,56632,8,339782
37986,0.000839,74.125.24.0-255,1484,58116,8,339782
37987,0.000844,172.31.36.0-255,66,58182,8,339782
37988,0.000849,74.125.24.0-255,2902,61084,8,339782
37989,0.000852,172.31.36.0-255,66,61150,8,339782
37990,0.000858,74.125.24.0-255,4320,65470,8,339782
37991,0.00086,172.31.36.0-255,66,65536,8,339782
37992,0.000877,74.125.24.0-255,1484,67020,8,339782
37993,0.000892,172.31.36.0-255,66,67086,8,339782
37994,0.000897,74.125.24.0-255,2902,69988,8,339782
37995,0.000899,172.31.36.0-255,66,70054,8,339782
37996,0.000946,74.125.24.0-255,4320,74374,8,339782
37997,0.00095,172.31.36.0-255,66,74440,8,339782
37998,0.000964,74.125.24.0-255,3602,78042,8,339782
37999,0.000966,172.31.36.0-255,66,78108,8,339782
38000,0.001058,74.125.24.0-255,1484,79592,8,339782
38001,0.001064,74.125.24.0-255,2902,82494,8,339782
38002,0.001067,172.31.36.0-255,66,82560,8,339782
38003,0.001084,74.125.24.0-255,5738,88298,8,339782
38004,0.001087,172.31.36.0-255,66,88364,8,339782
38005,0.00109,74.125.24.0-255,1484,89848,8,339782
38006,0.001127,172.31.36.0-255,66,89914,8,339782
38007,0.001147,74.125.24.0-255,4320,94234,8,339782
38008,0.00115,172.31.36.0-255,66,94300,8,339782
38009,0.001172,172.31.36.0-255,66,94366,8,339782
38010,0.00173,74.125.24.0-255,1484,95850,8,339782
38011,0.001737,74.125.24.0-255,2902,98752,8,339782
38012,0.001741,172.31.36.0-255,66,98818,8,339782
38013,0.001763,74.125.24.0-255,5738,104556,8,339782
38014,0.001766,172.31.36.0-255,66,104622,8,339782
38015,0.00177,74.125.24.0-255,2902,107524,8,339782
38016,0.001772,172.31.36.0-255,66,107590,8,339782
38017,0.001794,74.125.24.0-255,7156,114746,8,339782
38018,0.001796,172.31.36.0-255,66,114812,8,339782
38019,0.001821,172.31.36.0-255,66,114878,8,339782
38020,0.001845,74.125.24.0-255,5020,119898,8,339782
38021,0.001849,172.31.36.0-255,66,119964,8,339782
38022,0.002084,74.125.24.0-255,1484,121448,8,339782
38023,0.00209,74.125.24.0-255,2902,124350,8,339782
38024,0.002093,172.31.36.0-255,66,124416,8,339782
38025,0.0021,74.125.24.0-255,4320,128736,8,339782
38026,0.002102,172.31.36.0-255,66,128802,8,339782
38027,0.002128,74.125.24.0-255,1484,130286,8,339782
38028,0.002136,74.125.24.0-255,7156,137442,8,339782
38029,0.002139,172.31.36.0-255,66,137508,8,339782
38030,0.002151,172.31.36.0-255,66,137574,8,339782
38031,0.00217,74.125.24.0-255,5738,143312,8,339782
38032,0.002172,172.31.36.0-255,66,143378,8,339782
38033,0.00221,74.125.24.0-255,2184,145562,8,339782
38034,0.002213,172.31.36.0-255,66,145628,8,339782
38035,0.00225,74.125.24.0-255,2902,148530,8,339782
38036,0.002254,172.31.36.0-255,66,148596,8,339782
38037,0.002275,74.125.24.0-255,4320,152916,8,339782
38038,0.002278,172.31.36.0-255,66,152982,8,339782
38039,0.002282,74.125.24.0-255,2902,155884,8,339782
38040,0.002285,172.31.36.0-255,66,155950,8,339782
38041,0.0023,74.125.24.0-255,5738,161688,8,339782
38042,0.002302,172.31.36.0-255,66,161754,8,339782
38043,0.002326,74.125.24.0-255,5738,167492,8,339782
38044,0.002328,172.31.36.0-255,66,167558,8,339782
38045,0.002355,172.31.36.0-255,66,167624,8,339782
38046,0.002382,172.31.36.0-255,66,167690,8,339782
38047,0.002388,74.125.24.0-255,5738,173428,8,339782
38048,0.002391,172.31.36.0-255,66,173494,8,339782
38049,0.004759,74.125.24.0-255,5738,179232,8,339782
38050,0.004767,172.31.36.0-255,66,179298,8,339782
38051,0.007112,74.125.24.0-255,5738,185036,8,339782
38052,0.007118,172.31.36.0-255,66,185102,8,339782
38053,0.009492,74.125.24.0-255,5738,190840,8,339782
38054,0.009499,172.31.36.0-255,66,190906,8,339782
38055,0.011881,74.125.24.0-255,5738,196644,8,339782
38056,0.011889,172.31.36.0-255,66,196710,8,339782
38057,0.014274,74.125.24.0-255,5738,202448,8,339782
38058,0.014284,172.31.36.0-255,66,202514,8,339782
38059,0.016658,74.125.24.0-255,5738,208252,8,339782
38060,0.016667,172.31.36.0-255,66,208318,8,339782
38061,0.019067,74.125.24.0-255,5738,214056,8,339782
38062,0.019074,172.31.36.0-255,66,214122,8,339782
38063,0.021417,74.125.24.0-255,5738,219860,8,339782
38064,0.021425,172.31.36.0-255,66,219926,8,339782
38065,0.023774,74.125.24.0-255,5738,225664,8,339782
38066,0.023784,172.31.36.0-255,66,225730,8,339782
38067,0.026163,74.125.24.0-255,5738,231468,8,339782
38068,0.026175,172.31.36.0-255,66,231534,8,339782
38069,0.028584,74.125.24.0-255,5738,237272,8,339782
38070,0.028599,172.31.36.0-255,66,237338,8,339782
38071,0.030948,74.125.24.0-255,5738,243076,8,339782
38072,0.030961,172.31.36.0-255,66,243142,8,339782
38073,0.033348,74.125.24.0-255,5738,248880,8,339782
38074,0.033358,172.31.36.0-255,66,248946,8,339782
38075,0.035722,74.125.24.0-255,5738,254684,8,339782
38076,0.035729,172.31.36.0-255,66,254750,8,339782
38077,0.036475,172.31.36.0-255,199,254949,8,339782
38078,0.036505,172.31.36.0-255,1111,256060,8,339782
38079,0.036567,172.31.36.0-255,1514,257574,8,339782
38080,0.036569,172.31.36.0-255,754,258328,8,339782
38081,0.038006,104.244.42.0-255,66,258394,8,339782
38082,0.038059,104.244.42.0-255,66,258460,8,339782
38083,0.038092,74.125.24.0-255,5738,264198,8,339782
38084,0.038097,172.31.36.0-255,66,264264,8,339782
38085,0.038128,104.244.42.0-255,66,264330,8,339782
38086,0.040449,74.125.24.0-255,5738,270068,8,339782
38087,0.04046,172.31.36.0-255,66,270134,8,339782
38088,0.042844,74.125.24.0-255,5738,275872,8,339782
38089,0.042853,172.31.36.0-255,66,275938,8,339782
38090,0.04528,74.125.24.0-255,5738,281676,8,339782
38091,0.045292,172.31.36.0-255,66,281742,8,339782
38092,0.047656,74.125.24.0-255,5738,287480,8,339782
38093,0.047663,172.31.36.0-255,66,287546,8,339782
38094,0.050016,74.125.24.0-255,5738,293284,8,339782
38095,0.050022,172.31.36.0-255,66,293350,8,339782
38096,0.052389,74.125.24.0-255,5738,299088,8,339782
38097,0.052395,172.31.36.0-255,66,299154,8,339782
38098,0.054757,74.125.24.0-255,5738,304892,8,339782
38099,0.054764,172.31.36.0-255,66,304958,8,339782
38100,0.057139,74.125.24.0-255,5738,310696,8,339782
38101,0.057147,172.31.36.0-255,66,310762,8,339782
38102,0.059515,74.125.24.0-255,5738,316500,8,339782
38103,0.059522,172.31.36.0-255,66,316566,8,339782
38104,0.061876,74.125.24.0-255,5738,322304,8,339782
38105,0.061885,172.31.36.0-255,66,322370,8,339782
38106,0.064242,74.125.24.0-255,5738,328108,8,339782
38107,0.064253,172.31.36.0-255,66,328174,8,339782
38108,0.066629,74.125.24.0-255,5738,333912,8,339782
38109,0.066637,172.31.36.0-255,66,333978,8,339782
38110,0.069012,74.125.24.0-255,5738,339716,8,339782
38111,0.069018,172.31.36.0-255,66,339782,8,339782
38112,0.0,74.125.130.0-255,150,150,8,302779
38113,2.2e-05,172.31.36.0-255,66,216,8,302779
38114,3e-05,74.125.130.0-255,1484,1700,8,302779
38115,3.4e-05,172.31.36.0-255,66,1766,8,302779
38116,4.1e-05,74.125.130.0-255,2902,4668,8,302779
38117,4.6e-05,172.31.36.0-255,66,4734,8,302779
38118,5.4e-05,74.125.130.0-255,7156,11890,8,302779
38119,5.7e-05,172.31.36.0-255,66,11956,8,302779
38120,6.1e-05,74.125.130.0-255,2077,14033,8,302779
38121,6.4e-05,172.31.36.0-255,66,14099,8,302779
38122,0.000239,74.125.130.0-255,1484,15583,8,302779
38123,0.000243,172.31.36.0-255,66,15649,8,302779
38124,0.000249,74.125.130.0-255,2902,18551,8,302779
38125,0.000252,172.31.36.0-255,66,18617,8,302779
38126,0.000257,74.125.130.0-255,2902,21519,8,302779
38127,0.000259,172.31.36.0-255,66,21585,8,302779
38128,0.00029,74.125.130.0-255,4320,25905,8,302779
38129,0.000293,172.31.36.0-255,66,25971,8,302779
38130,0.000309,74.125.130.0-255,5379,31350,8,302779
38131,0.000311,172.31.36.0-255,66,31416,8,302779
38132,0.00046,74.125.130.0-255,1484,32900,8,302779
38133,0.000465,172.31.36.0-255,66,32966,8,302779
38134,0.000471,74.125.130.0-255,2902,35868,8,302779
38135,0.000473,172.31.36.0-255,66,35934,8,302779
38136,0.00049,74.125.130.0-255,1484,37418,8,302779
38137,0.000494,172.31.36.0-255,66,37484,8,302779
38138,0.000504,74.125.130.0-255,4320,41804,8,302779
38139,0.000506,172.31.36.0-255,66,41870,8,302779
38140,0.000538,74.125.130.0-255,6797,48667,8,302779
38141,0.000542,172.31.36.0-255,66,48733,8,302779
38142,0.000548,74.125.130.0-255,7156,55889,8,302779
38143,0.000551,172.31.36.0-255,66,55955,8,302779
38144,0.000556,74.125.130.0-255,4320,60275,8,302779
38145,0.000558,172.31.36.0-255,66,60341,8,302779
38146,0.000578,74.125.130.0-255,4320,64661,8,302779
38147,0.00058,172.31.36.0-255,66,64727,8,302779
38148,0.000619,74.125.130.0-255,1375,66102,8,302779
38149,0.000624,74.125.130.0-255,121,66223,8,302779
38150,0.00065,74.125.130.0-255,380,66603,8,302779
38151,0.000654,172.31.36.0-255,66,66669,8,302779
38152,0.000968,74.125.130.0-255,1484,68153,8,302779
38153,0.000973,74.125.130.0-255,1484,69637,8,302779
38154,0.000976,172.31.36.0-255,66,69703,8,302779
38155,0.000995,74.125.130.0-255,1484,71187,8,302779
38156,0.001001,74.125.130.0-255,5738,76925,8,302779
38157,0.001004,74.125.130.0-255,1484,78409,8,302779
38158,0.001008,172.31.36.0-255,66,78475,8,302779
38159,0.001019,74.125.130.0-255,4320,82795,8,302779
38160,0.001021,172.31.36.0-255,66,82861,8,302779
38161,0.001027,74.125.130.0-255,4320,87181,8,302779
38162,0.001029,172.31.36.0-255,66,87247,8,302779
38163,0.001051,74.125.130.0-255,2902,90149,8,302779
38164,0.001054,172.31.36.0-255,66,90215,8,302779
38165,0.001067,74.125.130.0-255,4320,94535,8,302779
38166,0.001069,172.31.36.0-255,66,94601,8,302779
38167,0.001081,74.125.130.0-255,1484,96085,8,302779
38168,0.001116,74.125.130.0-255,5020,101105,8,302779
38169,0.001119,172.31.36.0-255,66,101171,8,302779
38170,0.003122,74.125.130.0-255,5738,106909,8,302779
38171,0.00313,172.31.36.0-255,66,106975,8,302779
38172,0.00513,74.125.130.0-255,4320,111295,8,302779
38173,0.005135,172.31.36.0-255,66,111361,8,302779
38174,0.005152,74.125.130.0-255,1484,112845,8,302779
38175,0.007142,74.125.130.0-255,4320,117165,8,302779
38176,0.007148,172.31.36.0-255,66,117231,8,302779
38177,0.009137,74.125.130.0-255,5738,122969,8,302779
38178,0.009144,172.31.36.0-255,66,123035,8,302779
38179,0.011144,74.125.130.0-255,5738,128773,8,302779
38180,0.011152,172.31.36.0-255,66,128839,8,302779
38181,0.013156,74.125.130.0-255,5738,134577,8,302779
38182,0.013164,172.31.36.0-255,66,134643,8,302779
38183,0.015171,74.125.130.0-255,5738,140381,8,302779
38184,0.015179,172.31.36.0-255,66,140447,8,302779
38185,0.017184,74.125.130.0-255,5738,146185,8,302779
38186,0.017196,172.31.36.0-255,66,146251,8,302779
38187,0.019192,74.125.130.0-255,5738,151989,8,302779
38188,0.019201,172.31.36.0-255,66,152055,8,302779
38189,0.021204,74.125.130.0-255,5738,157793,8,302779
38190,0.021212,172.31.36.0-255,66,157859,8,302779
38191,0.023214,74.125.130.0-255,5738,163597,8,302779
38192,0.02322,172.31.36.0-255,66,163663,8,302779
38193,0.025216,74.125.130.0-255,5738,169401,8,302779
38194,0.025227,172.31.36.0-255,66,169467,8,302779
38195,0.027228,74.125.130.0-255,5738,175205,8,302779
38196,0.027237,172.31.36.0-255,66,175271,8,302779
38197,0.029334,74.125.130.0-255,5738,181009,8,302779
38198,0.029343,172.31.36.0-255,66,181075,8,302779
38199,0.031349,74.125.130.0-255,5738,186813,8,302779
38200,0.031358,172.31.36.0-255,66,186879,8,302779
38201,0.033353,74.125.130.0-255,5738,192617,8,302779
38202,0.033361,172.31.36.0-255,66,192683,8,302779
38203,0.03536,74.125.130.0-255,5738,198421,8,302779
38204,0.035369,172.31.36.0-255,66,198487,8,302779
38205,0.037361,74.125.130.0-255,5738,204225,8,302779
38206,0.037369,172.31.36.0-255,66,204291,8,302779
38207,0.03937,74.125.130.0-255,5738,210029,8,302779
38208,0.039379,172.31.36.0-255,66,210095,8,302779
38209,0.041377,74.125.130.0-255,5738,215833,8,302779
38210,0.041386,172.31.36.0-255,66,215899,8,302779
38211,0.043073,172.31.36.0-255,172,216071,8,302779
38212,0.043105,172.31.36.0-255,1111,217182,8,302779
38213,0.043169,172.31.36.0-255,1514,218696,8,302779
38214,0.043171,172.31.36.0-255,1514,220210,8,302779
38215,0.043194,172.31.36.0-255,1049,221259,8,302779
38216,0.043382,74.125.130.0-255,5738,226997,8,302779
38217,0.043389,172.31.36.0-255,66,227063,8,302779
38218,0.044624,104.244.42.0-255,66,227129,8,302779
38219,0.044661,104.244.42.0-255,66,227195,8,302779
38220,0.044739,104.244.42.0-255,66,227261,8,302779
38221,0.044787,104.244.42.0-255,66,227327,8,302779
38222,0.045389,74.125.130.0-255,5738,233065,8,302779
38223,0.045397,172.31.36.0-255,66,233131,8,302779
38224,0.047397,74.125.130.0-255,5738,238869,8,302779
38225,0.047417,172.31.36.0-255,66,238935,8,302779
38226,0.049446,74.125.130.0-255,5738,244673,8,302779
38227,0.049453,172.31.36.0-255,66,244739,8,302779
38228,0.051456,74.125.130.0-255,5738,250477,8,302779
38229,0.051463,172.31.36.0-255,66,250543,8,302779
38230,0.053531,74.125.130.0-255,5738,256281,8,302779
38231,0.053537,172.31.36.0-255,66,256347,8,302779
38232,0.05555,74.125.130.0-255,5738,262085,8,302779
38233,0.055571,172.31.36.0-255,66,262151,8,302779
38234,0.057585,74.125.130.0-255,5738,267889,8,302779
38235,0.057593,172.31.36.0-255,66,267955,8,302779
38236,0.059601,74.125.130.0-255,5738,273693,8,302779
38237,0.059619,172.31.36.0-255,66,273759,8,302779
38238,0.061616,74.125.130.0-255,5738,279497,8,302779
38239,0.061623,172.31.36.0-255,66,279563,8,302779
38240,0.063643,74.125.130.0-255,5738,285301,8,302779
38241,0.06365,172.31.36.0-255,66,285367,8,302779
38242,0.065647,74.125.130.0-255,5738,291105,8,302779
38243,0.065653,172.31.36.0-255,66,291171,8,302779
38244,0.067697,74.125.130.0-255,5738,296909,8,302779
38245,0.067705,172.31.36.0-255,66,296975,8,302779
38246,0.069714,74.125.130.0-255,5738,302713,8,302779
38247,0.06972,172.31.36.0-255,66,302779,8,302779
38248,0.0,74.125.24.0-255,146,146,8,327367
38249,2.7e-05,172.31.36.0-255,66,212,8,327367
38250,3.4e-05,74.125.24.0-255,1484,1696,8,327367
38251,3.8e-05,172.31.36.0-255,66,1762,8,327367
38252,4.3e-05,74.125.24.0-255,2902,4664,8,327367
38253,5.3e-05,172.31.36.0-255,66,4730,8,327367
38254,6.1e-05,74.125.24.0-255,7156,11886,8,327367
38255,6.3e-05,172.31.36.0-255,66,11952,8,327367
38256,7e-05,74.125.24.0-255,6313,18265,8,327367
38257,7.3e-05,172.31.36.0-255,66,18331,8,327367
38258,0.000108,74.125.24.0-255,2902,21233,8,327367
38259,0.000111,172.31.36.0-255,66,21299,8,327367
38260,0.000141,172.31.36.0-255,66,21365,8,327367
38261,0.000154,74.125.24.0-255,1484,22849,8,327367
38262,0.00016,172.31.36.0-255,66,22915,8,327367
38263,0.000166,74.125.24.0-255,2902,25817,8,327367
38264,0.000168,172.31.36.0-255,66,25883,8,327367
38265,0.000174,74.125.24.0-255,2902,28785,8,327367
38266,0.000177,172.31.36.0-255,66,28851,8,327367
38267,0.000213,74.125.24.0-255,2902,31753,8,327367
38268,0.000216,172.31.36.0-255,66,31819,8,327367
38269,0.000237,172.31.36.0-255,66,31885,8,327367
38270,0.000269,74.125.24.0-255,5738,37623,8,327367
38271,0.000272,172.31.36.0-255,66,37689,8,327367
38272,0.000291,74.125.24.0-255,4235,41924,8,327367
38273,0.000294,172.31.36.0-255,66,41990,8,327367
38274,0.000297,74.125.24.0-255,131,42121,8,327367
38275,0.000301,172.31.36.0-255,66,42187,8,327367
38276,0.000324,74.125.24.0-255,348,42535,8,327367
38277,0.000327,172.31.36.0-255,66,42601,8,327367
38278,0.000828,74.125.24.0-255,1484,44085,8,327367
38279,0.000836,74.125.24.0-255,2902,46987,8,327367
38280,0.00084,172.31.36.0-255,66,47053,8,327367
38281,0.000847,74.125.24.0-255,5738,52791,8,327367
38282,0.000849,172.31.36.0-255,66,52857,8,327367
38283,0.000852,74.125.24.0-255,1484,54341,8,327367
38284,0.000884,74.125.24.0-255,4320,58661,8,327367
38285,0.000889,172.31.36.0-255,66,58727,8,327367
38286,0.000911,74.125.24.0-255,2902,61629,8,327367
38287,0.000911,172.31.36.0-255,66,61695,8,327367
38288,0.000915,172.31.36.0-255,66,61761,8,327367
38289,0.000936,74.125.24.0-255,2184,63945,8,327367
38290,0.000944,172.31.36.0-255,66,64011,8,327367
38291,0.001262,74.125.24.0-255,1484,65495,8,327367
38292,0.001271,74.125.24.0-255,2902,68397,8,327367
38293,0.001275,172.31.36.0-255,66,68463,8,327367
38294,0.001284,74.125.24.0-255,5738,74201,8,327367
38295,0.001287,172.31.36.0-255,66,74267,8,327367
38296,0.001307,172.31.36.0-255,66,74333,8,327367
38297,0.001339,74.125.24.0-255,1484,75817,8,327367
38298,0.001344,74.125.24.0-255,1484,77301,8,327367
38299,0.001347,172.31.36.0-255,66,77367,8,327367
38300,0.001358,172.31.36.0-255,66,77433,8,327367
38301,0.001378,74.125.24.0-255,766,78199,8,327367
38302,0.001487,74.125.24.0-255,1484,79683,8,327367
38303,0.001492,172.31.36.0-255,66,79749,8,327367
38304,0.001498,74.125.24.0-255,2902,82651,8,327367
38305,0.001501,172.31.36.0-255,66,82717,8,327367
38306,0.00153,74.125.24.0-255,5738,88455,8,327367
38307,0.001533,172.31.36.0-255,66,88521,8,327367
38308,0.00154,74.125.24.0-255,7156,95677,8,327367
38309,0.001542,172.31.36.0-255,66,95743,8,327367
38310,0.001565,74.125.24.0-255,5738,101481,8,327367
38311,0.001572,172.31.36.0-255,66,101547,8,327367
38312,0.00158,74.125.24.0-255,7156,108703,8,327367
38313,0.001583,172.31.36.0-255,66,108769,8,327367
38314,0.001641,74.125.24.0-255,3602,112371,8,327367
38315,0.001646,172.31.36.0-255,66,112437,8,327367
38316,0.001651,74.125.24.0-255,4320,116757,8,327367
38317,0.001654,172.31.36.0-255,66,116823,8,327367
38318,0.001692,74.125.24.0-255,5738,122561,8,327367
38319,0.001695,172.31.36.0-255,66,122627,8,327367
38320,0.001706,172.31.36.0-255,66,122693,8,327367
38321,0.001728,74.125.24.0-255,2902,125595,8,327367
38322,0.001731,172.31.36.0-255,66,125661,8,327367
38323,0.001744,74.125.24.0-255,7156,132817,8,327367
38324,0.001747,172.31.36.0-255,66,132883,8,327367
38325,0.001753,74.125.24.0-255,5020,137903,8,327367
38326,0.001755,172.31.36.0-255,66,137969,8,327367
38327,0.002128,74.125.24.0-255,1484,139453,8,327367
38328,0.002136,74.125.24.0-255,2902,142355,8,327367
38329,0.002139,172.31.36.0-255,66,142421,8,327367
38330,0.002147,74.125.24.0-255,5738,148159,8,327367
38331,0.002149,172.31.36.0-255,66,148225,8,327367
38332,0.002152,74.125.24.0-255,1484,149709,8,327367
38333,0.002181,74.125.24.0-255,7156,156865,8,327367
38334,0.002183,172.31.36.0-255,66,156931,8,327367
38335,0.002205,74.125.24.0-255,2902,159833,8,327367
38336,0.002208,172.31.36.0-255,66,159899,8,327367
38337,0.002233,172.31.36.0-255,66,159965,8,327367
38338,0.004556,74.125.24.0-255,4320,164285,8,327367
38339,0.00456,172.31.36.0-255,66,164351,8,327367
38340,0.004584,74.125.24.0-255,1484,165835,8,327367
38341,0.00687,74.125.24.0-255,4320,170155,8,327367
38342,0.006879,172.31.36.0-255,66,170221,8,327367
38343,0.009192,74.125.24.0-255,5738,175959,8,327367
38344,0.009205,172.31.36.0-255,66,176025,8,327367
38345,0.011702,74.125.24.0-255,5738,181763,8,327367
38346,0.011761,172.31.36.0-255,66,181829,8,327367
38347,0.014102,74.125.24.0-255,5738,187567,8,327367
38348,0.01411,172.31.36.0-255,66,187633,8,327367
38349,0.016462,74.125.24.0-255,5738,193371,8,327367
38350,0.016473,172.31.36.0-255,66,193437,8,327367
38351,0.018811,74.125.24.0-255,5738,199175,8,327367
38352,0.018818,172.31.36.0-255,66,199241,8,327367
38353,0.021147,74.125.24.0-255,5738,204979,8,327367
38354,0.021154,172.31.36.0-255,66,205045,8,327367
38355,0.023452,74.125.24.0-255,5738,210783,8,327367
38356,0.023459,172.31.36.0-255,66,210849,8,327367
38357,0.025808,74.125.24.0-255,5738,216587,8,327367
38358,0.025815,172.31.36.0-255,66,216653,8,327367
38359,0.028098,74.125.24.0-255,5738,222391,8,327367
38360,0.028105,172.31.36.0-255,66,222457,8,327367
38361,0.030432,74.125.24.0-255,5738,228195,8,327367
38362,0.030439,172.31.36.0-255,66,228261,8,327367
38363,0.03278,74.125.24.0-255,5738,233999,8,327367
38364,0.032787,172.31.36.0-255,66,234065,8,327367
38365,0.035026,172.31.36.0-255,172,234237,8,327367
38366,0.035058,172.31.36.0-255,562,234799,8,327367
38367,0.03512,74.125.24.0-255,5738,240537,8,327367
38368,0.035125,172.31.36.0-255,66,240603,8,327367
38369,0.037226,104.244.42.0-255,66,240669,8,327367
38370,0.03742,74.125.24.0-255,4320,244989,8,327367
38371,0.037425,172.31.36.0-255,66,245055,8,327367
38372,0.037452,74.125.24.0-255,1484,246539,8,327367
38373,0.039733,74.125.24.0-255,4320,250859,8,327367
38374,0.039739,172.31.36.0-255,66,250925,8,327367
38375,0.042071,74.125.24.0-255,5738,256663,8,327367
38376,0.042077,172.31.36.0-255,66,256729,8,327367
38377,0.044431,74.125.24.0-255,2902,259631,8,327367
38378,0.044435,172.31.36.0-255,66,259697,8,327367
38379,0.044467,74.125.24.0-255,2902,262599,8,327367
38380,0.04447,172.31.36.0-255,66,262665,8,327367
38381,0.046716,74.125.24.0-255,2902,265567,8,327367
38382,0.046721,172.31.36.0-255,66,265633,8,327367
38383,0.0468,74.125.24.0-255,1484,267117,8,327367
38384,0.046816,74.125.24.0-255,1484,268601,8,327367
38385,0.046819,172.31.36.0-255,66,268667,8,327367
38386,0.049062,74.125.24.0-255,2902,271569,8,327367
38387,0.049068,172.31.36.0-255,66,271635,8,327367
38388,0.049153,74.125.24.0-255,2902,274537,8,327367
38389,0.049158,172.31.36.0-255,66,274603,8,327367
38390,0.051414,74.125.24.0-255,2902,277505,8,327367
38391,0.051419,172.31.36.0-255,66,277571,8,327367
38392,0.051473,74.125.24.0-255,2902,280473,8,327367
38393,0.051476,172.31.36.0-255,66,280539,8,327367
38394,0.053726,74.125.24.0-255,2902,283441,8,327367
38395,0.053734,172.31.36.0-255,66,283507,8,327367
38396,0.053778,74.125.24.0-255,2902,286409,8,327367
38397,0.053782,172.31.36.0-255,66,286475,8,327367
38398,0.056019,74.125.24.0-255,2902,289377,8,327367
38399,0.056025,172.31.36.0-255,66,289443,8,327367
38400,0.056079,74.125.24.0-255,2902,292345,8,327367
38401,0.056082,172.31.36.0-255,66,292411,8,327367
38402,0.05837,74.125.24.0-255,2902,295313,8,327367
38403,0.058375,172.31.36.0-255,66,295379,8,327367
38404,0.058399,74.125.24.0-255,2902,298281,8,327367
38405,0.0584,172.31.36.0-255,66,298347,8,327367
38406,0.060689,74.125.24.0-255,5738,304085,8,327367
38407,0.060695,172.31.36.0-255,66,304151,8,327367
38408,0.063019,74.125.24.0-255,5738,309889,8,327367
38409,0.063024,172.31.36.0-255,66,309955,8,327367
38410,0.065341,74.125.24.0-255,5738,315693,8,327367
38411,0.065346,172.31.36.0-255,66,315759,8,327367
38412,0.06768,74.125.24.0-255,5738,321497,8,327367
38413,0.067684,172.31.36.0-255,66,321563,8,327367
38414,0.069987,74.125.24.0-255,5738,327301,8,327367
38415,0.069993,172.31.36.0-255,66,327367,8,327367
38416,0.0,74.125.24.0-255,153,153,8,232429
38417,1.7e-05,172.31.36.0-255,66,219,8,232429
38418,2.4e-05,74.125.24.0-255,1484,1703,8,232429
38419,2.9e-05,172.31.36.0-255,66,1769,8,232429
38420,3.6e-05,74.125.24.0-255,2902,4671,8,232429
38421,4e-05,172.31.36.0-255,66,4737,8,232429
38422,4.5e-05,74.125.24.0-255,2902,7639,8,232429
38423,4.8e-05,172.31.36.0-255,66,7705,8,232429
38424,8.2e-05,172.31.36.0-255,66,7771,8,232429
38425,9.3e-05,172.31.36.0-255,66,7837,8,232429
38426,0.000115,74.125.24.0-255,3961,11798,8,232429
38427,0.000117,172.31.36.0-255,66,11864,8,232429
38428,0.000189,74.125.24.0-255,1484,13348,8,232429
38429,0.000192,172.31.36.0-255,66,13414,8,232429
38430,0.000211,74.125.24.0-255,1484,14898,8,232429
38431,0.000213,172.31.36.0-255,66,14964,8,232429
38432,0.000227,74.125.24.0-255,1484,16448,8,232429
38433,0.00023,172.31.36.0-255,66,16514,8,232429
38434,0.000236,74.125.24.0-255,4320,20834,8,232429
38435,0.000239,172.31.36.0-255,66,20900,8,232429
38436,0.000263,74.125.24.0-255,1484,22384,8,232429
38437,0.000265,172.31.36.0-255,66,22450,8,232429
38438,0.000272,74.125.24.0-255,5738,28188,8,232429
38439,0.000274,172.31.36.0-255,66,28254,8,232429
38440,0.000286,172.31.36.0-255,66,28320,8,232429
38441,0.000312,74.125.24.0-255,5379,33699,8,232429
38442,0.000315,172.31.36.0-255,66,33765,8,232429
38443,0.00032,74.125.24.0-255,3961,37726,8,232429
38444,0.000322,172.31.36.0-255,66,37792,8,232429
38445,0.000325,74.125.24.0-255,426,38218,8,232429
38446,0.000473,74.125.24.0-255,1484,39702,8,232429
38447,0.00048,74.125.24.0-255,2902,42604,8,232429
38448,0.00051,172.31.36.0-255,66,42670,8,232429
38449,0.000517,74.125.24.0-255,5738,48408,8,232429
38450,0.000528,172.31.36.0-255,66,48474,8,232429
38451,0.000546,74.125.24.0-255,7156,55630,8,232429
38452,0.00056,172.31.36.0-255,66,55696,8,232429
38453,0.000572,74.125.24.0-255,3961,59657,8,232429
38454,0.000585,74.125.24.0-255,827,60484,8,232429
38455,0.000609,172.31.36.0-255,66,60550,8,232429
38456,0.000765,74.125.24.0-255,1484,62034,8,232429
38457,0.000772,74.125.24.0-255,2902,64936,8,232429
38458,0.000777,172.31.36.0-255,66,65002,8,232429
38459,0.000801,74.125.24.0-255,5738,70740,8,232429
38460,0.000806,74.125.24.0-255,4320,75060,8,232429
38461,0.00081,172.31.36.0-255,66,75126,8,232429
38462,0.000871,74.125.24.0-255,1484,76610,8,232429
38463,0.000887,74.125.24.0-255,6438,83048,8,232429
38464,0.000904,74.125.24.0-255,7156,90204,8,232429
38465,0.000913,172.31.36.0-255,66,90270,8,232429
38466,0.000957,74.125.24.0-255,5738,96008,8,232429
38467,0.000961,172.31.36.0-255,66,96074,8,232429
38468,0.000965,172.31.36.0-255,66,96140,8,232429
38469,0.000983,74.125.24.0-255,2543,98683,8,232429
38470,0.000998,74.125.24.0-255,4320,103003,8,232429
38471,0.001006,172.31.36.0-255,66,103069,8,232429
38472,0.001046,172.31.36.0-255,66,103135,8,232429
38473,0.001067,74.125.24.0-255,5020,108155,8,232429
38474,0.001075,172.31.36.0-255,66,108221,8,232429
38475,0.001123,74.125.24.0-255,1484,109705,8,232429
38476,0.001127,74.125.24.0-255,1484,111189,8,232429
38477,0.001143,74.125.24.0-255,1484,112673,8,232429
38478,0.00115,74.125.24.0-255,5738,118411,8,232429
38479,0.001155,74.125.24.0-255,4320,122731,8,232429
38480,0.001168,172.31.36.0-255,66,122797,8,232429
38481,0.001174,74.125.24.0-255,4320,127117,8,232429
38482,0.001183,172.31.36.0-255,66,127183,8,232429
38483,0.001191,74.125.24.0-255,7156,134339,8,232429
38484,0.001211,74.125.24.0-255,4320,138659,8,232429
38485,0.001218,172.31.36.0-255,66,138725,8,232429
38486,0.001237,74.125.24.0-255,3602,142327,8,232429
38487,0.001258,172.31.36.0-255,66,142393,8,232429
38488,0.001275,74.125.24.0-255,1484,143877,8,232429
38489,0.001289,74.125.24.0-255,2902,146779,8,232429
38490,0.001292,74.125.24.0-255,1484,148263,8,232429
38491,0.00131,74.125.24.0-255,2902,151165,8,232429
38492,0.001313,74.125.24.0-255,1484,152649,8,232429
38493,0.001318,172.31.36.0-255,66,152715,8,232429
38494,0.001338,74.125.24.0-255,7156,159871,8,232429
38495,0.001351,74.125.24.0-255,1484,161355,8,232429
38496,0.001354,172.31.36.0-255,66,161421,8,232429
38497,0.001394,172.31.36.0-255,66,161487,8,232429
38498,0.0014,74.125.24.0-255,3602,165089,8,232429
38499,0.001428,172.31.36.0-255,66,165155,8,232429
38500,0.001434,74.125.24.0-255,4320,169475,8,232429
38501,0.00144,74.125.24.0-255,7156,176631,8,232429
38502,0.001456,74.125.24.0-255,1484,178115,8,232429
38503,0.001487,172.31.36.0-255,66,178181,8,232429
38504,0.001607,74.125.24.0-255,1484,179665,8,232429
38505,0.001627,74.125.24.0-255,2902,182567,8,232429
38506,0.001633,74.125.24.0-255,5738,188305,8,232429
38507,0.001645,74.125.24.0-255,2902,191207,8,232429
38508,0.001673,74.125.24.0-255,7156,198363,8,232429
38509,0.001713,172.31.36.0-255,66,198429,8,232429
38510,0.001725,74.125.24.0-255,3602,202031,8,232429
38511,0.00173,172.31.36.0-255,66,202097,8,232429
38512,0.001754,74.125.24.0-255,4320,206417,8,232429
38513,0.001759,74.125.24.0-255,2902,209319,8,232429
38514,0.001774,172.31.36.0-255,66,209385,8,232429
38515,0.001777,74.125.24.0-255,1484,210869,8,232429
38516,0.001818,172.31.36.0-255,66,210935,8,232429
38517,0.001836,172.31.36.0-255,66,211001,8,232429
38518,0.001854,74.125.24.0-255,6438,217439,8,232429
38519,0.001879,74.125.24.0-255,4320,221759,8,232429
38520,0.001881,74.125.24.0-255,1484,223243,8,232429
38521,0.001891,172.31.36.0-255,66,223309,8,232429
38522,0.001921,172.31.36.0-255,66,223375,8,232429
38523,0.001934,74.125.24.0-255,5738,229113,8,232429
38524,0.001984,172.31.36.0-255,66,229179,8,232429
38525,0.001998,74.125.24.0-255,105,229284,8,232429
38526,0.002011,172.31.36.0-255,66,229350,8,232429
38527,0.004546,172.31.36.0-255,105,229455,8,232429
38528,0.007037,74.125.24.0-255,66,229521,8,232429
38529,0.033582,172.31.36.0-255,172,229693,8,232429
38530,0.03362,172.31.36.0-255,1113,230806,8,232429
38531,0.033681,172.31.36.0-255,1425,232231,8,232429
38532,0.035079,104.244.42.0-255,66,232297,8,232429
38533,0.035126,104.244.42.0-255,66,232363,8,232429
38534,0.035216,104.244.42.0-255,66,232429,8,232429
38535,0.0,74.125.200.0-255,150,150,8,337683
38536,2.7e-05,172.31.36.0-255,66,216,8,337683
38537,3.4e-05,74.125.200.0-255,1484,1700,8,337683
38538,3.9e-05,172.31.36.0-255,66,1766,8,337683
38539,4.5e-05,74.125.200.0-255,2902,4668,8,337683
38540,4.8e-05,172.31.36.0-255,66,4734,8,337683
38541,5.5e-05,74.125.200.0-255,7156,11890,8,337683
38542,5.9e-05,172.31.36.0-255,66,11956,8,337683
38543,9.4e-05,74.125.200.0-255,2040,13996,8,337683
38544,9.7e-05,172.31.36.0-255,66,14062,8,337683
38545,0.000528,74.125.200.0-255,1484,15546,8,337683
38546,0.000533,172.31.36.0-255,66,15612,8,337683
38547,0.00054,74.125.200.0-255,2902,18514,8,337683
38548,0.000542,172.31.36.0-255,66,18580,8,337683
38549,0.000549,74.125.200.0-255,5738,24318,8,337683
38550,0.000551,172.31.36.0-255,66,24384,8,337683
38551,0.000559,74.125.200.0-255,6797,31181,8,337683
38552,0.000561,172.31.36.0-255,66,31247,8,337683
38553,0.000596,74.125.200.0-255,7156,38403,8,337683
38554,0.000599,172.31.36.0-255,66,38469,8,337683
38555,0.000606,74.125.200.0-255,5738,44207,8,337683
38556,0.000608,172.31.36.0-255,66,44273,8,337683
38557,0.000628,74.125.200.0-255,1484,45757,8,337683
38558,0.00063,172.31.36.0-255,66,45823,8,337683
38559,0.000654,74.125.200.0-255,5738,51561,8,337683
38560,0.000657,172.31.36.0-255,66,51627,8,337683
38561,0.000668,172.31.36.0-255,66,51693,8,337683
38562,0.000736,74.125.200.0-255,5020,56713,8,337683
38563,0.00074,172.31.36.0-255,66,56779,8,337683
38564,0.000842,74.125.200.0-255,364,57143,8,337683
38565,0.000846,172.31.36.0-255,66,57209,8,337683
38566,0.000927,74.125.200.0-255,380,57589,8,337683
38567,0.001134,74.125.200.0-255,1484,59073,8,337683
38568,0.001139,172.31.36.0-255,66,59139,8,337683
38569,0.001145,74.125.200.0-255,2902,62041,8,337683
38570,0.001147,172.31.36.0-255,66,62107,8,337683
38571,0.001149,74.125.200.0-255,1484,63591,8,337683
38572,0.001171,74.125.200.0-255,2902,66493,8,337683
38573,0.001173,172.31.36.0-255,66,66559,8,337683
38574,0.001197,74.125.200.0-255,4320,70879,8,337683
38575,0.0012,172.31.36.0-255,66,70945,8,337683
38576,0.001218,74.125.200.0-255,1484,72429,8,337683
38577,0.001224,74.125.200.0-255,7156,79585,8,337683
38578,0.001227,172.31.36.0-255,66,79651,8,337683
38579,0.001252,74.125.200.0-255,4320,83971,8,337683
38580,0.001255,172.31.36.0-255,66,84037,8,337683
38581,0.001276,74.125.200.0-255,4320,88357,8,337683
38582,0.001278,172.31.36.0-255,66,88423,8,337683
38583,0.001299,74.125.200.0-255,3602,92025,8,337683
38584,0.001301,172.31.36.0-255,66,92091,8,337683
38585,0.001355,74.125.200.0-255,1484,93575,8,337683
38586,0.001375,74.125.200.0-255,2902,96477,8,337683
38587,0.001378,172.31.36.0-255,66,96543,8,337683
38588,0.001382,74.125.200.0-255,1484,98027,8,337683
38589,0.001408,74.125.200.0-255,4320,102347,8,337683
38590,0.001411,172.31.36.0-255,66,102413,8,337683
38591,0.001416,74.125.200.0-255,2902,105315,8,337683
38592,0.001418,172.31.36.0-255,66,105381,8,337683
38593,0.001424,74.125.200.0-255,4320,109701,8,337683
38594,0.001427,172.31.36.0-255,66,109767,8,337683
38595,0.001463,172.31.36.0-255,66,109833,8,337683
38596,0.001468,74.125.200.0-255,2902,112735,8,337683
38597,0.00147,172.31.36.0-255,66,112801,8,337683
38598,0.001484,74.125.200.0-255,1484,114285,8,337683
38599,0.001515,74.125.200.0-255,3602,117887,8,337683
38600,0.001519,172.31.36.0-255,66,117953,8,337683
38601,0.001555,74.125.200.0-255,1484,119437,8,337683
38602,0.001568,74.125.200.0-255,2902,122339,8,337683
38603,0.001572,172.31.36.0-255,66,122405,8,337683
38604,0.001578,74.125.200.0-255,4320,126725,8,337683
38605,0.001581,172.31.36.0-255,66,126791,8,337683
38606,0.001593,74.125.200.0-255,1484,128275,8,337683
38607,0.001596,74.125.200.0-255,1484,129759,8,337683
38608,0.001598,172.31.36.0-255,66,129825,8,337683
38609,0.00162,74.125.200.0-255,5738,135563,8,337683
38610,0.001622,172.31.36.0-255,66,135629,8,337683
38611,0.001664,74.125.200.0-255,5738,141367,8,337683
38612,0.001668,172.31.36.0-255,66,141433,8,337683
38613,0.001693,74.125.200.0-255,2902,144335,8,337683
38614,0.001696,172.31.36.0-255,66,144401,8,337683
38615,0.001708,172.31.36.0-255,66,144467,8,337683
38616,0.001745,74.125.200.0-255,1484,145951,8,337683
38617,0.001757,74.125.200.0-255,1484,147435,8,337683
38618,0.001761,172.31.36.0-255,66,147501,8,337683
38619,0.001764,74.125.200.0-255,1484,148985,8,337683
38620,0.001783,74.125.200.0-255,1484,150469,8,337683
38621,0.001786,172.31.36.0-255,66,150535,8,337683
38622,0.001831,74.125.200.0-255,5738,156273,8,337683
38623,0.001835,172.31.36.0-255,66,156339,8,337683
38624,0.00184,74.125.200.0-255,2902,159241,8,337683
38625,0.001843,172.31.36.0-255,66,159307,8,337683
38626,0.001849,74.125.200.0-255,4320,163627,8,337683
38627,0.001852,172.31.36.0-255,66,163693,8,337683
38628,0.001864,172.31.36.0-255,66,163759,8,337683
38629,0.00187,74.125.200.0-255,4320,168079,8,337683
38630,0.001872,172.31.36.0-255,66,168145,8,337683
38631,0.001891,74.125.200.0-255,2184,170329,8,337683
38632,0.001894,172.31.36.0-255,66,170395,8,337683
38633,0.004233,74.125.200.0-255,5738,176133,8,337683
38634,0.004246,172.31.36.0-255,66,176199,8,337683
38635,0.006649,74.125.200.0-255,5738,181937,8,337683
38636,0.006663,172.31.36.0-255,66,182003,8,337683
38637,0.009028,74.125.200.0-255,5738,187741,8,337683
38638,0.009036,172.31.36.0-255,66,187807,8,337683
38639,0.011406,74.125.200.0-255,5738,193545,8,337683
38640,0.011422,172.31.36.0-255,66,193611,8,337683
38641,0.013801,74.125.200.0-255,5738,199349,8,337683
38642,0.013817,172.31.36.0-255,66,199415,8,337683
38643,0.016196,74.125.200.0-255,5738,205153,8,337683
38644,0.016206,172.31.36.0-255,66,205219,8,337683
38645,0.018568,74.125.200.0-255,5738,210957,8,337683
38646,0.018586,172.31.36.0-255,66,211023,8,337683
38647,0.020969,74.125.200.0-255,5738,216761,8,337683
38648,0.020983,172.31.36.0-255,66,216827,8,337683
38649,0.023366,74.125.200.0-255,5738,222565,8,337683
38650,0.023389,172.31.36.0-255,66,222631,8,337683
38651,0.025756,74.125.200.0-255,5738,228369,8,337683
38652,0.02577,172.31.36.0-255,66,228435,8,337683
38653,0.028125,74.125.200.0-255,5738,234173,8,337683
38654,0.028135,172.31.36.0-255,66,234239,8,337683
38655,0.030496,74.125.200.0-255,5738,239977,8,337683
38656,0.030507,172.31.36.0-255,66,240043,8,337683
38657,0.032896,74.125.200.0-255,5738,245781,8,337683
38658,0.032914,172.31.36.0-255,66,245847,8,337683
38659,0.035306,74.125.200.0-255,5738,251585,8,337683
38660,0.035323,172.31.36.0-255,66,251651,8,337683
38661,0.037693,74.125.200.0-255,5738,257389,8,337683
38662,0.037706,172.31.36.0-255,66,257455,8,337683
38663,0.040094,74.125.200.0-255,5738,263193,8,337683
38664,0.040111,172.31.36.0-255,66,263259,8,337683
38665,0.042493,74.125.200.0-255,5738,268997,8,337683
38666,0.042517,172.31.36.0-255,66,269063,8,337683
38667,0.044896,74.125.200.0-255,5738,274801,8,337683
38668,0.04491,172.31.36.0-255,66,274867,8,337683
38669,0.047277,74.125.200.0-255,5738,280605,8,337683
38670,0.047291,172.31.36.0-255,66,280671,8,337683
38671,0.049658,74.125.200.0-255,5738,286409,8,337683
38672,0.049675,172.31.36.0-255,66,286475,8,337683
38673,0.052063,74.125.200.0-255,5738,292213,8,337683
38674,0.05208,172.31.36.0-255,66,292279,8,337683
38675,0.054451,74.125.200.0-255,5738,298017,8,337683
38676,0.054465,172.31.36.0-255,66,298083,8,337683
38677,0.056823,74.125.200.0-255,5738,303821,8,337683
38678,0.056832,172.31.36.0-255,66,303887,8,337683
38679,0.059078,172.31.36.0-255,188,304075,8,337683
38680,0.059111,172.31.36.0-255,955,305030,8,337683
38681,0.059189,74.125.200.0-255,2902,307932,8,337683
38682,0.059196,172.31.36.0-255,66,307998,8,337683
38683,0.059203,172.31.36.0-255,1514,309512,8,337683
38684,0.059205,172.31.36.0-255,1514,311026,8,337683
38685,0.059215,74.125.200.0-255,2902,313928,8,337683
38686,0.059219,172.31.36.0-255,66,313994,8,337683
38687,0.059229,172.31.36.0-255,77,314071,8,337683
38688,0.060676,104.244.42.0-255,66,314137,8,337683
38689,0.060701,104.244.42.0-255,66,314203,8,337683
38690,0.06078,104.244.42.0-255,66,314269,8,337683
38691,0.060786,104.244.42.0-255,66,314335,8,337683
38692,0.061537,74.125.200.0-255,2902,317237,8,337683
38693,0.061543,172.31.36.0-255,66,317303,8,337683
38694,0.061566,74.125.200.0-255,2902,320205,8,337683
38695,0.061569,172.31.36.0-255,66,320271,8,337683
38696,0.063922,74.125.200.0-255,5738,326009,8,337683
38697,0.063939,172.31.36.0-255,66,326075,8,337683
38698,0.066321,74.125.200.0-255,5738,331813,8,337683
38699,0.066332,172.31.36.0-255,66,331879,8,337683
38700,0.068699,74.125.200.0-255,5738,337617,8,337683
38701,0.068707,172.31.36.0-255,66,337683,8,337683
38702,0.0,74.125.68.0-255,298,298,8,338682
38703,1.2e-05,172.31.36.0-255,66,364,8,338682
38704,4.3e-05,74.125.68.0-255,1484,1848,8,338682
38705,4.7e-05,172.31.36.0-255,66,1914,8,338682
38706,5e-05,74.125.68.0-255,1484,3398,8,338682
38707,5.2e-05,172.31.36.0-255,66,3464,8,338682
38708,6.8e-05,74.125.68.0-255,2902,6366,8,338682
38709,7.1e-05,172.31.36.0-255,66,6432,8,338682
38710,7.8e-05,74.125.68.0-255,5738,12170,8,338682
38711,8.1e-05,172.31.36.0-255,66,12236,8,338682
38712,0.000115,74.125.68.0-255,6127,18363,8,338682
38713,0.000117,172.31.36.0-255,66,18429,8,338682
38714,0.000121,74.125.68.0-255,1484,19913,8,338682
38715,0.000122,172.31.36.0-255,66,19979,8,338682
38716,0.000147,74.125.68.0-255,7156,27135,8,338682
38717,0.00015,172.31.36.0-255,66,27201,8,338682
38718,0.000177,74.125.68.0-255,3961,31162,8,338682
38719,0.000181,172.31.36.0-255,66,31228,8,338682
38720,0.000547,74.125.68.0-255,1484,32712,8,338682
38721,0.000553,74.125.68.0-255,2902,35614,8,338682
38722,0.00056,172.31.36.0-255,66,35680,8,338682
38723,0.000569,172.31.36.0-255,66,35746,8,338682
38724,0.000573,74.125.68.0-255,1484,37230,8,338682
38725,0.000575,172.31.36.0-255,66,37296,8,338682
38726,0.000595,74.125.68.0-255,4320,41616,8,338682
38727,0.000597,172.31.36.0-255,66,41682,8,338682
38728,0.000605,74.125.68.0-255,6797,48479,8,338682
38729,0.000607,172.31.36.0-255,66,48545,8,338682
38730,0.000643,172.31.36.0-255,66,48611,8,338682
38731,0.000692,74.125.68.0-255,7069,55680,8,338682
38732,0.000696,172.31.36.0-255,66,55746,8,338682
38733,0.000699,74.125.68.0-255,137,55883,8,338682
38734,0.000778,74.125.68.0-255,1484,57367,8,338682
38735,0.000781,172.31.36.0-255,66,57433,8,338682
38736,0.000786,74.125.68.0-255,1484,58917,8,338682
38737,0.000802,74.125.68.0-255,1484,60401,8,338682
38738,0.000804,172.31.36.0-255,66,60467,8,338682
38739,0.000811,74.125.68.0-255,5738,66205,8,338682
38740,0.000814,172.31.36.0-255,66,66271,8,338682
38741,0.000845,74.125.68.0-255,6797,73068,8,338682
38742,0.000848,172.31.36.0-255,66,73134,8,338682
38743,0.000873,74.125.68.0-255,2902,76036,8,338682
38744,0.000875,172.31.36.0-255,66,76102,8,338682
38745,0.000899,74.125.68.0-255,4320,80422,8,338682
38746,0.000901,172.31.36.0-255,66,80488,8,338682
38747,0.000914,172.31.36.0-255,66,80554,8,338682
38748,0.000932,74.125.68.0-255,1402,81956,8,338682
38749,0.001273,74.125.68.0-255,1484,83440,8,338682
38750,0.001278,172.31.36.0-255,66,83506,8,338682
38751,0.001283,74.125.68.0-255,1484,84990,8,338682
38752,0.001288,74.125.68.0-255,2902,87892,8,338682
38753,0.00129,172.31.36.0-255,66,87958,8,338682
38754,0.001316,74.125.68.0-255,5738,93696,8,338682
38755,0.001319,172.31.36.0-255,66,93762,8,338682
38756,0.001347,172.31.36.0-255,66,93828,8,338682
38757,0.001402,172.31.36.0-255,66,93894,8,338682
38758,0.001852,74.125.68.0-255,1484,95378,8,338682
38759,0.001866,74.125.68.0-255,2902,98280,8,338682
38760,0.001869,172.31.36.0-255,66,98346,8,338682
38761,0.00189,74.125.68.0-255,5738,104084,8,338682
38762,0.001892,172.31.36.0-255,66,104150,8,338682
38763,0.001896,74.125.68.0-255,2902,107052,8,338682
38764,0.001898,172.31.36.0-255,66,107118,8,338682
38765,0.001903,74.125.68.0-255,2902,110020,8,338682
38766,0.001905,172.31.36.0-255,66,110086,8,338682
38767,0.001928,74.125.68.0-255,1484,111570,8,338682
38768,0.001939,172.31.36.0-255,66,111636,8,338682
38769,0.001944,74.125.68.0-255,4320,115956,8,338682
38770,0.001946,172.31.36.0-255,66,116022,8,338682
38771,0.001996,74.125.68.0-255,3602,119624,8,338682
38772,0.001999,172.31.36.0-255,66,119690,8,338682
38773,0.002087,74.125.68.0-255,1484,121174,8,338682
38774,0.002103,74.125.68.0-255,2902,124076,8,338682
38775,0.002106,172.31.36.0-255,66,124142,8,338682
38776,0.00211,74.125.68.0-255,1484,125626,8,338682
38777,0.002126,74.125.68.0-255,1484,127110,8,338682
38778,0.002128,172.31.36.0-255,66,127176,8,338682
38779,0.002131,74.125.68.0-255,1484,128660,8,338682
38780,0.002148,74.125.68.0-255,1484,130144,8,338682
38781,0.00215,172.31.36.0-255,66,130210,8,338682
38782,0.002168,74.125.68.0-255,2902,133112,8,338682
38783,0.002172,172.31.36.0-255,66,133178,8,338682
38784,0.002179,74.125.68.0-255,5738,138916,8,338682
38785,0.002181,172.31.36.0-255,66,138982,8,338682
38786,0.002205,74.125.68.0-255,4320,143302,8,338682
38787,0.002208,172.31.36.0-255,66,143368,8,338682
38788,0.002213,74.125.68.0-255,2902,146270,8,338682
38789,0.002215,172.31.36.0-255,66,146336,8,338682
38790,0.002229,74.125.68.0-255,1484,147820,8,338682
38791,0.002233,74.125.68.0-255,2902,150722,8,338682
38792,0.002235,172.31.36.0-255,66,150788,8,338682
38793,0.002241,74.125.68.0-255,3602,154390,8,338682
38794,0.002243,172.31.36.0-255,66,154456,8,338682
38795,0.002387,74.125.68.0-255,1484,155940,8,338682
38796,0.002401,74.125.68.0-255,1484,157424,8,338682
38797,0.002405,172.31.36.0-255,66,157490,8,338682
38798,0.002411,74.125.68.0-255,2902,160392,8,338682
38799,0.002413,172.31.36.0-255,66,160458,8,338682
38800,0.002416,74.125.68.0-255,1484,161942,8,338682
38801,0.002437,74.125.68.0-255,4320,166262,8,338682
38802,0.00244,172.31.36.0-255,66,166328,8,338682
38803,0.002443,74.125.68.0-255,1484,167812,8,338682
38804,0.002464,172.31.36.0-255,66,167878,8,338682
38805,0.002489,172.31.36.0-255,66,167944,8,338682
38806,0.002512,74.125.68.0-255,2902,170846,8,338682
38807,0.002516,172.31.36.0-255,66,170912,8,338682
38808,0.002519,74.125.68.0-255,766,171678,8,338682
38809,0.002556,74.125.68.0-255,1484,173162,8,338682
38810,0.002559,172.31.36.0-255,66,173228,8,338682
38811,0.002564,74.125.68.0-255,2902,176130,8,338682
38812,0.002567,172.31.36.0-255,66,176196,8,338682
38813,0.002607,74.125.68.0-255,5738,181934,8,338682
38814,0.00261,172.31.36.0-255,66,182000,8,338682
38815,0.002614,74.125.68.0-255,2902,184902,8,338682
38816,0.002621,172.31.36.0-255,66,184968,8,338682
38817,0.002628,74.125.68.0-255,4320,189288,8,338682
38818,0.00263,172.31.36.0-255,66,189354,8,338682
38819,0.002635,74.125.68.0-255,4320,193674,8,338682
38820,0.002638,172.31.36.0-255,66,193740,8,338682
38821,0.002662,74.125.68.0-255,4320,198060,8,338682
38822,0.002665,172.31.36.0-255,66,198126,8,338682
38823,0.00267,74.125.68.0-255,2902,201028,8,338682
38824,0.002672,172.31.36.0-255,66,201094,8,338682
38825,0.002675,74.125.68.0-255,1484,202578,8,338682
38826,0.002711,74.125.68.0-255,5020,207598,8,338682
38827,0.002715,172.31.36.0-255,66,207664,8,338682
38828,0.002718,74.125.68.0-255,1484,209148,8,338682
38829,0.00276,74.125.68.0-255,2902,212050,8,338682
38830,0.002763,172.31.36.0-255,66,212116,8,338682
38831,0.00277,74.125.68.0-255,5738,217854,8,338682
38832,0.002772,172.31.36.0-255,66,217920,8,338682
38833,0.002776,74.125.68.0-255,2902,220822,8,338682
38834,0.002778,172.31.36.0-255,66,220888,8,338682
38835,0.002799,74.125.68.0-255,5738,226626,8,338682
38836,0.002801,172.31.36.0-255,66,226692,8,338682
38837,0.002827,74.125.68.0-255,4320,231012,8,338682
38838,0.002831,172.31.36.0-255,66,231078,8,338682
38839,0.002835,74.125.68.0-255,2902,233980,8,338682
38840,0.002837,172.31.36.0-255,66,234046,8,338682
38841,0.002843,74.125.68.0-255,5738,239784,8,338682
38842,0.002845,172.31.36.0-255,66,239850,8,338682
38843,0.002848,74.125.68.0-255,766,240616,8,338682
38844,0.002862,74.125.68.0-255,1484,242100,8,338682
38845,0.002865,172.31.36.0-255,66,242166,8,338682
38846,0.002868,74.125.68.0-255,1484,243650,8,338682
38847,0.002887,74.125.68.0-255,4320,247970,8,338682
38848,0.00289,172.31.36.0-255,66,248036,8,338682
38849,0.00291,74.125.68.0-255,4320,252356,8,338682
38850,0.002913,172.31.36.0-255,66,252422,8,338682
38851,0.002934,74.125.68.0-255,2902,255324,8,338682
38852,0.002937,172.31.36.0-255,66,255390,8,338682
38853,0.00294,74.125.68.0-255,1484,256874,8,338682
38854,0.002944,74.125.68.0-255,1484,258358,8,338682
38855,0.002946,172.31.36.0-255,66,258424,8,338682
38856,0.002959,74.125.68.0-255,4320,262744,8,338682
38857,0.002962,172.31.36.0-255,66,262810,8,338682
38858,0.002985,74.125.68.0-255,5738,268548,8,338682
38859,0.002988,172.31.36.0-255,66,268614,8,338682
38860,0.002993,74.125.68.0-255,4320,272934,8,338682
38861,0.002996,172.31.36.0-255,66,273000,8,338682
38862,0.003017,74.125.68.0-255,2184,275184,8,338682
38863,0.003019,172.31.36.0-255,66,275250,8,338682
38864,0.003024,74.125.68.0-255,2902,278152,8,338682
38865,0.003026,172.31.36.0-255,66,278218,8,338682
38866,0.003039,74.125.68.0-255,1484,279702,8,338682
38867,0.003061,74.125.68.0-255,5738,285440,8,338682
38868,0.003064,172.31.36.0-255,66,285506,8,338682
38869,0.003068,74.125.68.0-255,2902,288408,8,338682
38870,0.00307,172.31.36.0-255,66,288474,8,338682
38871,0.00309,74.125.68.0-255,7156,295630,8,338682
38872,0.003093,172.31.36.0-255,66,295696,8,338682
38873,0.003122,74.125.68.0-255,4320,300016,8,338682
38874,0.003125,172.31.36.0-255,66,300082,8,338682
38875,0.003132,74.125.68.0-255,7156,307238,8,338682
38876,0.003134,172.31.36.0-255,66,307304,8,338682
38877,0.003154,172.31.36.0-255,66,307370,8,338682
38878,0.003158,74.125.68.0-255,2902,310272,8,338682
38879,0.00316,172.31.36.0-255,66,310338,8,338682
38880,0.003194,74.125.68.0-255,5738,316076,8,338682
38881,0.003198,172.31.36.0-255,66,316142,8,338682
38882,0.003219,74.125.68.0-255,7156,323298,8,338682
38883,0.003222,172.31.36.0-255,66,323364,8,338682
38884,0.003229,74.125.68.0-255,7156,330520,8,338682
38885,0.003232,172.31.36.0-255,66,330586,8,338682
38886,0.00329,172.31.36.0-255,66,330652,8,338682
38887,0.003294,74.125.68.0-255,2902,333554,8,338682
38888,0.003296,172.31.36.0-255,66,333620,8,338682
38889,0.003302,74.125.68.0-255,3077,336697,8,338682
38890,0.003304,172.31.36.0-255,66,336763,8,338682
38891,0.003307,74.125.68.0-255,97,336860,8,338682
38892,0.003337,74.125.68.0-255,105,336965,8,338682
38893,0.010091,172.31.36.0-255,101,337066,8,338682
38894,0.010515,172.31.36.0-255,105,337171,8,338682
38895,0.01213,74.125.68.0-255,66,337237,8,338682
38896,0.012558,74.125.68.0-255,66,337303,8,338682
38897,0.042005,172.31.36.0-255,172,337475,8,338682
38898,0.042038,172.31.36.0-255,1075,338550,8,338682
38899,0.043516,104.244.42.0-255,66,338616,8,338682
38900,0.043547,104.244.42.0-255,66,338682,8,338682
38901,0.0,172.217.194.0-255,146,146,8,199090
38902,2.7e-05,172.31.36.0-255,66,212,8,199090
38903,3.3e-05,172.217.194.0-255,1484,1696,8,199090
38904,3.7e-05,172.31.36.0-255,66,1762,8,199090
38905,4.2e-05,172.217.194.0-255,2902,4664,8,199090
38906,4.4e-05,172.31.36.0-255,66,4730,8,199090
38907,5.1e-05,172.217.194.0-255,7156,11886,8,199090
38908,5.4e-05,172.31.36.0-255,66,11952,8,199090
38909,5.8e-05,172.217.194.0-255,2049,14001,8,199090
38910,6.1e-05,172.31.36.0-255,66,14067,8,199090
38911,6.6e-05,172.217.194.0-255,2902,16969,8,199090
38912,6.9e-05,172.31.36.0-255,66,17035,8,199090
38913,7.6e-05,172.217.194.0-255,7156,24191,8,199090
38914,7.9e-05,172.31.36.0-255,66,24257,8,199090
38915,0.000121,172.217.194.0-255,6797,31054,8,199090
38916,0.000125,172.31.36.0-255,66,31120,8,199090
38917,0.000158,172.217.194.0-255,5738,36858,8,199090
38918,0.000162,172.31.36.0-255,66,36924,8,199090
38919,0.000179,172.217.194.0-255,1484,38408,8,199090
38920,0.000181,172.31.36.0-255,66,38474,8,199090
38921,0.000185,172.217.194.0-255,1484,39958,8,199090
38922,0.000187,172.31.36.0-255,66,40024,8,199090
38923,0.000193,172.217.194.0-255,5738,45762,8,199090
38924,0.000196,172.31.36.0-255,66,45828,8,199090
38925,0.000217,172.217.194.0-255,5379,51207,8,199090
38926,0.00022,172.31.36.0-255,66,51273,8,199090
38927,0.000234,172.31.36.0-255,66,51339,8,199090
38928,0.000237,172.217.194.0-255,102,51441,8,199090
38929,0.000239,172.31.36.0-255,66,51507,8,199090
38930,0.000298,172.217.194.0-255,1484,52991,8,199090
38931,0.000302,172.31.36.0-255,66,53057,8,199090
38932,0.000321,172.217.194.0-255,1484,54541,8,199090
38933,0.000339,172.217.194.0-255,1484,56025,8,199090
38934,0.000345,172.31.36.0-255,66,56091,8,199090
38935,0.000345,172.217.194.0-255,5738,61829,8,199090
38936,0.000349,172.31.36.0-255,66,61895,8,199090
38937,0.000374,172.217.194.0-255,4320,66215,8,199090
38938,0.000378,172.31.36.0-255,66,66281,8,199090
38939,0.000398,172.217.194.0-255,2258,68539,8,199090
38940,0.000401,172.31.36.0-255,66,68605,8,199090
38941,0.00045,172.217.194.0-255,1484,70089,8,199090
38942,0.000456,172.217.194.0-255,2902,72991,8,199090
38943,0.000459,172.31.36.0-255,66,73057,8,199090
38944,0.000462,172.217.194.0-255,1484,74541,8,199090
38945,0.000477,172.217.194.0-255,4320,78861,8,199090
38946,0.00048,172.31.36.0-255,66,78927,8,199090
38947,0.000508,172.31.36.0-255,66,78993,8,199090
38948,0.000533,172.217.194.0-255,2902,81895,8,199090
38949,0.000536,172.31.36.0-255,66,81961,8,199090
38950,0.00055,172.31.36.0-255,66,82027,8,199090
38951,0.000622,172.217.194.0-255,1484,83511,8,199090
38952,0.000627,172.217.194.0-255,1484,84995,8,199090
38953,0.000629,172.31.36.0-255,66,85061,8,199090
38954,0.000649,172.217.194.0-255,1484,86545,8,199090
38955,0.000655,172.217.194.0-255,5738,92283,8,199090
38956,0.000659,172.31.36.0-255,66,92349,8,199090
38957,0.000661,172.217.194.0-255,5738,98087,8,199090
38958,0.000663,172.31.36.0-255,66,98153,8,199090
38959,0.000692,172.217.194.0-255,7156,105309,8,199090
38960,0.000696,172.31.36.0-255,66,105375,8,199090
38961,0.000703,172.31.36.0-255,66,105441,8,199090
38962,0.000794,172.217.194.0-255,1484,106925,8,199090
38963,0.000797,172.217.194.0-255,1484,108409,8,199090
38964,0.0008,172.31.36.0-255,66,108475,8,199090
38965,0.000818,172.217.194.0-255,1484,109959,8,199090
38966,0.000823,172.217.194.0-255,2902,112861,8,199090
38967,0.000825,172.31.36.0-255,66,112927,8,199090
38968,0.000845,172.217.194.0-255,2902,115829,8,199090
38969,0.000848,172.31.36.0-255,66,115895,8,199090
38970,0.000855,172.217.194.0-255,7156,123051,8,199090
38971,0.000857,172.31.36.0-255,66,123117,8,199090
38972,0.000897,172.217.194.0-255,2902,126019,8,199090
38973,0.000901,172.31.36.0-255,66,126085,8,199090
38974,0.000936,172.31.36.0-255,66,126151,8,199090
38975,0.000948,172.31.36.0-255,66,126217,8,199090
38976,0.000986,172.31.36.0-255,66,126283,8,199090
38977,0.000993,172.31.36.0-255,66,126349,8,199090
38978,0.001042,172.217.194.0-255,766,127115,8,199090
38979,0.001122,172.217.194.0-255,1484,128599,8,199090
38980,0.001126,172.31.36.0-255,66,128665,8,199090
38981,0.00113,172.217.194.0-255,1484,130149,8,199090
38982,0.001144,172.217.194.0-255,1484,131633,8,199090
38983,0.001148,172.31.36.0-255,66,131699,8,199090
38984,0.001154,172.217.194.0-255,5738,137437,8,199090
38985,0.001157,172.31.36.0-255,66,137503,8,199090
38986,0.00116,172.217.194.0-255,1484,138987,8,199090
38987,0.001177,172.217.194.0-255,7156,146143,8,199090
38988,0.00118,172.31.36.0-255,66,146209,8,199090
38989,0.001212,172.217.194.0-255,4320,150529,8,199090
38990,0.001215,172.31.36.0-255,66,150595,8,199090
38991,0.001226,172.31.36.0-255,66,150661,8,199090
38992,0.001268,172.31.36.0-255,66,150727,8,199090
38993,0.00128,172.31.36.0-255,66,150793,8,199090
38994,0.001283,172.217.194.0-255,1484,152277,8,199090
38995,0.001314,172.31.36.0-255,66,152343,8,199090
38996,0.001337,172.217.194.0-255,4320,156663,8,199090
38997,0.001341,172.31.36.0-255,66,156729,8,199090
38998,0.001342,172.217.194.0-255,5738,162467,8,199090
38999,0.001345,172.31.36.0-255,66,162533,8,199090
39000,0.001373,172.31.36.0-255,66,162599,8,199090
39001,0.001396,172.31.36.0-255,66,162665,8,199090
39002,0.001419,172.217.194.0-255,3602,166267,8,199090
39003,0.001429,172.31.36.0-255,66,166333,8,199090
39004,0.001438,172.217.194.0-255,7156,173489,8,199090
39005,0.001441,172.31.36.0-255,66,173555,8,199090
39006,0.001458,172.217.194.0-255,5738,179293,8,199090
39007,0.001461,172.31.36.0-255,66,179359,8,199090
39008,0.001474,172.31.36.0-255,66,179425,8,199090
39009,0.001488,172.217.194.0-255,2902,182327,8,199090
39010,0.001491,172.31.36.0-255,66,182393,8,199090
39011,0.001506,172.217.194.0-255,2902,185295,8,199090
39012,0.001508,172.31.36.0-255,66,185361,8,199090
39013,0.001541,172.31.36.0-255,66,185427,8,199090
39014,0.001583,172.31.36.0-255,66,185493,8,199090
39015,0.001595,172.31.36.0-255,66,185559,8,199090
39016,0.001624,172.217.194.0-255,2902,188461,8,199090
39017,0.001627,172.31.36.0-255,66,188527,8,199090
39018,0.001692,172.31.36.0-255,66,188593,8,199090
39019,0.001713,172.217.194.0-255,5725,194318,8,199090
39020,0.001716,172.31.36.0-255,66,194384,8,199090
39021,0.001719,172.217.194.0-255,105,194489,8,199090
39022,0.004313,172.31.36.0-255,66,194555,8,199090
39023,0.004341,172.31.36.0-255,105,194660,8,199090
39024,0.006831,172.217.194.0-255,66,194726,8,199090
39025,0.047931,172.31.36.0-255,172,194898,8,199090
39026,0.04796,172.31.36.0-255,1111,196009,8,199090
39027,0.04802,172.31.36.0-255,1514,197523,8,199090
39028,0.048021,172.31.36.0-255,1369,198892,8,199090
39029,0.049456,104.244.42.0-255,66,198958,8,199090
39030,0.049497,104.244.42.0-255,66,199024,8,199090
39031,0.049545,104.244.42.0-255,66,199090,8,199090
39032,0.0,172.217.24.0-255,146,146,8,299889
39033,3.8e-05,172.31.36.0-255,66,212,8,299889
39034,4.6e-05,172.217.24.0-255,1484,1696,8,299889
39035,5e-05,172.31.36.0-255,66,1762,8,299889
39036,5.5e-05,172.217.24.0-255,2902,4664,8,299889
39037,5.8e-05,172.31.36.0-255,66,4730,8,299889
39038,6.6e-05,172.217.24.0-255,7156,11886,8,299889
39039,6.9e-05,172.31.36.0-255,66,11952,8,299889
39040,7.3e-05,172.217.24.0-255,1965,13917,8,299889
39041,7.5e-05,172.31.36.0-255,66,13983,8,299889
39042,9.1e-05,172.217.24.0-255,2902,16885,8,299889
39043,9.4e-05,172.31.36.0-255,66,16951,8,299889
39044,0.000117,172.217.24.0-255,4320,21271,8,299889
39045,0.00012,172.31.36.0-255,66,21337,8,299889
39046,0.000127,172.217.24.0-255,5738,27075,8,299889
39047,0.000129,172.31.36.0-255,66,27141,8,299889
39048,0.000145,172.217.24.0-255,2902,30043,8,299889
39049,0.000147,172.31.36.0-255,66,30109,8,299889
39050,0.00015,172.217.24.0-255,1125,31234,8,299889
39051,0.000152,172.31.36.0-255,66,31300,8,299889
39052,0.000205,172.217.24.0-255,1484,32784,8,299889
39053,0.000208,172.31.36.0-255,66,32850,8,299889
39054,0.000229,172.217.24.0-255,2902,35752,8,299889
39055,0.000233,172.31.36.0-255,66,35818,8,299889
39056,0.000239,172.217.24.0-255,5738,41556,8,299889
39057,0.000243,172.31.36.0-255,66,41622,8,299889
39058,0.000251,172.217.24.0-255,6797,48419,8,299889
39059,0.000253,172.31.36.0-255,66,48485,8,299889
39060,0.000694,172.217.24.0-255,1484,49969,8,299889
39061,0.000699,172.31.36.0-255,66,50035,8,299889
39062,0.000706,172.217.24.0-255,2902,52937,8,299889
39063,0.000708,172.31.36.0-255,66,53003,8,299889
39064,0.000714,172.217.24.0-255,4320,57323,8,299889
39065,0.000716,172.31.36.0-255,66,57389,8,299889
39066,0.000734,172.217.24.0-255,1484,58873,8,299889
39067,0.000738,172.217.24.0-255,1484,60357,8,299889
39068,0.000741,172.31.36.0-255,66,60423,8,299889
39069,0.000759,172.217.24.0-255,5709,66132,8,299889
39070,0.000762,172.31.36.0-255,66,66198,8,299889
39071,0.001566,172.217.24.0-255,348,66546,8,299889
39072,0.001751,172.217.24.0-255,1484,68030,8,299889
39073,0.001755,172.31.36.0-255,66,68096,8,299889
39074,0.001762,172.217.24.0-255,2902,70998,8,299889
39075,0.001764,172.31.36.0-255,66,71064,8,299889
39076,0.001791,172.217.24.0-255,5738,76802,8,299889
39077,0.001794,172.31.36.0-255,66,76868,8,299889
39078,0.001819,172.217.24.0-255,6797,83665,8,299889
39079,0.001821,172.31.36.0-255,66,83731,8,299889
39080,0.001828,172.217.24.0-255,7156,90887,8,299889
39081,0.00183,172.31.36.0-255,66,90953,8,299889
39082,0.001854,172.217.24.0-255,2902,93855,8,299889
39083,0.001856,172.31.36.0-255,66,93921,8,299889
39084,0.001879,172.217.24.0-255,6797,100718,8,299889
39085,0.001881,172.31.36.0-255,66,100784,8,299889
39086,0.003831,172.217.24.0-255,5738,106522,8,299889
39087,0.003834,172.31.36.0-255,66,106588,8,299889
39088,0.005797,172.217.24.0-255,5738,112326,8,299889
39089,0.005805,172.31.36.0-255,66,112392,8,299889
39090,0.007776,172.217.24.0-255,5738,118130,8,299889
39091,0.007786,172.31.36.0-255,66,118196,8,299889
39092,0.009762,172.217.24.0-255,5738,123934,8,299889
39093,0.009779,172.31.36.0-255,66,124000,8,299889
39094,0.011764,172.217.24.0-255,5738,129738,8,299889
39095,0.011779,172.31.36.0-255,66,129804,8,299889
39096,0.013754,172.217.24.0-255,5738,135542,8,299889
39097,0.013766,172.31.36.0-255,66,135608,8,299889
39098,0.015754,172.217.24.0-255,5738,141346,8,299889
39099,0.015771,172.31.36.0-255,66,141412,8,299889
39100,0.017748,172.217.24.0-255,5738,147150,8,299889
39101,0.017761,172.31.36.0-255,66,147216,8,299889
39102,0.019774,172.217.24.0-255,5738,152954,8,299889
39103,0.019788,172.31.36.0-255,66,153020,8,299889
39104,0.021771,172.217.24.0-255,5738,158758,8,299889
39105,0.021784,172.31.36.0-255,66,158824,8,299889
39106,0.023525,172.31.36.0-255,187,159011,8,299889
39107,0.023565,172.31.36.0-255,979,159990,8,299889
39108,0.023641,172.31.36.0-255,1514,161504,8,299889
39109,0.023643,172.31.36.0-255,111,161615,8,299889
39110,0.023743,172.217.24.0-255,5738,167353,8,299889
39111,0.02375,172.31.36.0-255,66,167419,8,299889
39112,0.025057,104.244.42.0-255,66,167485,8,299889
39113,0.025103,104.244.42.0-255,66,167551,8,299889
39114,0.025188,104.244.42.0-255,66,167617,8,299889
39115,0.025727,172.217.24.0-255,5738,173355,8,299889
39116,0.025738,172.31.36.0-255,66,173421,8,299889
39117,0.027731,172.217.24.0-255,5738,179159,8,299889
39118,0.02774,172.31.36.0-255,66,179225,8,299889
39119,0.029793,172.217.24.0-255,5738,184963,8,299889
39120,0.029801,172.31.36.0-255,66,185029,8,299889
39121,0.031788,172.217.24.0-255,5738,190767,8,299889
39122,0.031799,172.31.36.0-255,66,190833,8,299889
39123,0.033791,172.217.24.0-255,5738,196571,8,299889
39124,0.033806,172.31.36.0-255,66,196637,8,299889
39125,0.035779,172.217.24.0-255,5738,202375,8,299889
39126,0.03579,172.31.36.0-255,66,202441,8,299889
39127,0.037767,172.217.24.0-255,5738,208179,8,299889
39128,0.037777,172.31.36.0-255,66,208245,8,299889
39129,0.039756,172.217.24.0-255,5738,213983,8,299889
39130,0.03977,172.31.36.0-255,66,214049,8,299889
39131,0.041749,172.217.24.0-255,5738,219787,8,299889
39132,0.041777,172.31.36.0-255,66,219853,8,299889
39133,0.043739,172.217.24.0-255,5738,225591,8,299889
39134,0.043747,172.31.36.0-255,66,225657,8,299889
39135,0.045715,172.217.24.0-255,5738,231395,8,299889
39136,0.045722,172.31.36.0-255,66,231461,8,299889
39137,0.047685,172.217.24.0-255,5738,237199,8,299889
39138,0.047691,172.31.36.0-255,66,237265,8,299889
39139,0.049647,172.217.24.0-255,4320,241585,8,299889
39140,0.049651,172.31.36.0-255,66,241651,8,299889
39141,0.049677,172.217.24.0-255,1484,243135,8,299889
39142,0.051638,172.217.24.0-255,4320,247455,8,299889
39143,0.051645,172.31.36.0-255,66,247521,8,299889
39144,0.053623,172.217.24.0-255,5738,253259,8,299889
39145,0.053631,172.31.36.0-255,66,253325,8,299889
39146,0.055594,172.217.24.0-255,5738,259063,8,299889
39147,0.0556,172.31.36.0-255,66,259129,8,299889
39148,0.057579,172.217.24.0-255,5738,264867,8,299889
39149,0.057588,172.31.36.0-255,66,264933,8,299889
39150,0.059552,172.217.24.0-255,5738,270671,8,299889
39151,0.05956,172.31.36.0-255,66,270737,8,299889
39152,0.061527,172.217.24.0-255,5738,276475,8,299889
39153,0.061535,172.31.36.0-255,66,276541,8,299889
39154,0.063507,172.217.24.0-255,5738,282279,8,299889
39155,0.063517,172.31.36.0-255,66,282345,8,299889
39156,0.065495,172.217.24.0-255,5738,288083,8,299889
39157,0.065502,172.31.36.0-255,66,288149,8,299889
39158,0.067469,172.217.24.0-255,5738,293887,8,299889
39159,0.067479,172.31.36.0-255,66,293953,8,299889
39160,0.069464,172.217.24.0-255,2902,296855,8,299889
39161,0.06947,172.31.36.0-255,66,296921,8,299889
39162,0.069562,172.217.24.0-255,2902,299823,8,299889
39163,0.069566,172.31.36.0-255,66,299889,8,299889
39164,0.0,74.125.24.0-255,153,153,8,286720
39165,1.6e-05,172.31.36.0-255,66,219,8,286720
39166,2.3e-05,74.125.24.0-255,1484,1703,8,286720
39167,2.7e-05,172.31.36.0-255,66,1769,8,286720
39168,3.3e-05,74.125.24.0-255,2902,4671,8,286720
39169,3.6e-05,172.31.36.0-255,66,4737,8,286720
39170,4.5e-05,74.125.24.0-255,7156,11893,8,286720
39171,4.8e-05,172.31.36.0-255,66,11959,8,286720
39172,5.2e-05,74.125.24.0-255,2105,14064,8,286720
39173,5.5e-05,172.31.36.0-255,66,14130,8,286720
39174,8.8e-05,172.31.36.0-255,66,14196,8,286720
39175,0.000105,74.125.24.0-255,1484,15680,8,286720
39176,0.000107,172.31.36.0-255,66,15746,8,286720
39177,0.000114,74.125.24.0-255,5379,21125,8,286720
39178,0.000117,172.31.36.0-255,66,21191,8,286720
39179,0.000223,74.125.24.0-255,1484,22675,8,286720
39180,0.000228,172.31.36.0-255,66,22741,8,286720
39181,0.000234,74.125.24.0-255,2902,25643,8,286720
39182,0.000236,172.31.36.0-255,66,25709,8,286720
39183,0.000253,74.125.24.0-255,5738,31447,8,286720
39184,0.000256,172.31.36.0-255,66,31513,8,286720
39185,0.000303,74.125.24.0-255,7156,38669,8,286720
39186,0.000306,172.31.36.0-255,66,38735,8,286720
39187,0.000326,74.125.24.0-255,6797,45532,8,286720
39188,0.000329,172.31.36.0-255,66,45598,8,286720
39189,0.000379,74.125.24.0-255,5738,51336,8,286720
39190,0.000382,172.31.36.0-255,66,51402,8,286720
39191,0.000402,74.125.24.0-255,3961,55363,8,286720
39192,0.000405,172.31.36.0-255,66,55429,8,286720
39193,0.000924,74.125.24.0-255,645,56074,8,286720
39194,0.00093,172.31.36.0-255,66,56140,8,286720
39195,0.000951,74.125.24.0-255,1484,57624,8,286720
39196,0.000988,74.125.24.0-255,4320,61944,8,286720
39197,0.00099,172.31.36.0-255,66,62010,8,286720
39198,0.001002,172.31.36.0-255,66,62076,8,286720
39199,0.001051,172.31.36.0-255,66,62142,8,286720
39200,0.001072,74.125.24.0-255,2184,64326,8,286720
39201,0.001075,172.31.36.0-255,66,64392,8,286720
39202,0.001351,74.125.24.0-255,1484,65876,8,286720
39203,0.001379,74.125.24.0-255,2902,68778,8,286720
39204,0.001382,172.31.36.0-255,66,68844,8,286720
39205,0.001389,74.125.24.0-255,5738,74582,8,286720
39206,0.001391,172.31.36.0-255,66,74648,8,286720
39207,0.00141,74.125.24.0-255,2902,77550,8,286720
39208,0.001412,172.31.36.0-255,66,77616,8,286720
39209,0.001446,172.31.36.0-255,66,77682,8,286720
39210,0.001459,172.31.36.0-255,66,77748,8,286720
39211,0.001479,74.125.24.0-255,766,78514,8,286720
39212,0.001725,172.31.36.0-255,66,78580,8,286720
39213,0.001835,74.125.24.0-255,1484,80064,8,286720
39214,0.001845,74.125.24.0-255,2902,82966,8,286720
39215,0.001849,172.31.36.0-255,66,83032,8,286720
39216,0.001874,74.125.24.0-255,5738,88770,8,286720
39217,0.001877,172.31.36.0-255,66,88836,8,286720
39218,0.001893,74.125.24.0-255,5738,94574,8,286720
39219,0.001896,172.31.36.0-255,66,94640,8,286720
39220,0.001913,74.125.24.0-255,4320,98960,8,286720
39221,0.001915,172.31.36.0-255,66,99026,8,286720
39222,0.00192,74.125.24.0-255,4320,103346,8,286720
39223,0.001923,172.31.36.0-255,66,103412,8,286720
39224,0.001951,172.31.36.0-255,66,103478,8,286720
39225,0.001954,74.125.24.0-255,766,104244,8,286720
39226,0.004029,74.125.24.0-255,4320,108564,8,286720
39227,0.004036,172.31.36.0-255,66,108630,8,286720
39228,0.006175,74.125.24.0-255,4320,112950,8,286720
39229,0.006179,172.31.36.0-255,66,113016,8,286720
39230,0.00619,74.125.24.0-255,1484,114500,8,286720
39231,0.008263,74.125.24.0-255,4320,118820,8,286720
39232,0.008269,172.31.36.0-255,66,118886,8,286720
39233,0.010375,74.125.24.0-255,5738,124624,8,286720
39234,0.010382,172.31.36.0-255,66,124690,8,286720
39235,0.012446,74.125.24.0-255,5738,130428,8,286720
39236,0.012453,172.31.36.0-255,66,130494,8,286720
39237,0.014513,74.125.24.0-255,5738,136232,8,286720
39238,0.014521,172.31.36.0-255,66,136298,8,286720
39239,0.016588,74.125.24.0-255,5738,142036,8,286720
39240,0.016595,172.31.36.0-255,66,142102,8,286720
39241,0.01871,74.125.24.0-255,5738,147840,8,286720
39242,0.018717,172.31.36.0-255,66,147906,8,286720
39243,0.020807,74.125.24.0-255,5738,153644,8,286720
39244,0.020819,172.31.36.0-255,66,153710,8,286720
39245,0.022924,74.125.24.0-255,5738,159448,8,286720
39246,0.022933,172.31.36.0-255,66,159514,8,286720
39247,0.02503,74.125.24.0-255,5738,165252,8,286720
39248,0.025037,172.31.36.0-255,66,165318,8,286720
39249,0.027134,74.125.24.0-255,5738,171056,8,286720
39250,0.027142,172.31.36.0-255,66,171122,8,286720
39251,0.029211,74.125.24.0-255,5738,176860,8,286720
39252,0.029218,172.31.36.0-255,66,176926,8,286720
39253,0.031324,74.125.24.0-255,5738,182664,8,286720
39254,0.031332,172.31.36.0-255,66,182730,8,286720
39255,0.033469,74.125.24.0-255,5738,188468,8,286720
39256,0.033478,172.31.36.0-255,66,188534,8,286720
39257,0.035554,74.125.24.0-255,5738,194272,8,286720
39258,0.035563,172.31.36.0-255,66,194338,8,286720
39259,0.037631,74.125.24.0-255,5738,200076,8,286720
39260,0.037637,172.31.36.0-255,66,200142,8,286720
39261,0.038063,172.31.36.0-255,176,200318,8,286720
39262,0.038094,172.31.36.0-255,562,200880,8,286720
39263,0.039635,104.244.42.0-255,66,200946,8,286720
39264,0.039642,104.244.42.0-255,66,201012,8,286720
39265,0.039706,74.125.24.0-255,5738,206750,8,286720
39266,0.039712,172.31.36.0-255,66,206816,8,286720
39267,0.041837,74.125.24.0-255,5738,212554,8,286720
39268,0.041844,172.31.36.0-255,66,212620,8,286720
39269,0.043927,74.125.24.0-255,5738,218358,8,286720
39270,0.043936,172.31.36.0-255,66,218424,8,286720
39271,0.046053,74.125.24.0-255,5738,224162,8,286720
39272,0.04606,172.31.36.0-255,66,224228,8,286720
39273,0.048149,74.125.24.0-255,5738,229966,8,286720
39274,0.048156,172.31.36.0-255,66,230032,8,286720
39275,0.050241,74.125.24.0-255,5738,235770,8,286720
39276,0.050249,172.31.36.0-255,66,235836,8,286720
39277,0.052341,74.125.24.0-255,5738,241574,8,286720
39278,0.052349,172.31.36.0-255,66,241640,8,286720
39279,0.054429,74.125.24.0-255,5738,247378,8,286720
39280,0.054436,172.31.36.0-255,66,247444,8,286720
39281,0.056496,74.125.24.0-255,4320,251764,8,286720
39282,0.056503,172.31.36.0-255,66,251830,8,286720
39283,0.056524,74.125.24.0-255,1484,253314,8,286720
39284,0.058601,74.125.24.0-255,4320,257634,8,286720
39285,0.058609,172.31.36.0-255,66,257700,8,286720
39286,0.060716,74.125.24.0-255,5738,263438,8,286720
39287,0.060723,172.31.36.0-255,66,263504,8,286720
39288,0.062917,74.125.24.0-255,5738,269242,8,286720
39289,0.062923,172.31.36.0-255,66,269308,8,286720
39290,0.065045,74.125.24.0-255,5738,275046,8,286720
39291,0.065052,172.31.36.0-255,66,275112,8,286720
39292,0.067146,74.125.24.0-255,5738,280850,8,286720
39293,0.067152,172.31.36.0-255,66,280916,8,286720
39294,0.069255,74.125.24.0-255,5738,286654,8,286720
39295,0.069262,172.31.36.0-255,66,286720,8,286720
39296,0.0,172.217.194.0-255,153,153,8,178085
39297,1.7e-05,172.31.36.0-255,66,219,8,178085
39298,2.4e-05,172.217.194.0-255,1484,1703,8,178085
39299,2.9e-05,172.31.36.0-255,66,1769,8,178085
39300,3.4e-05,172.217.194.0-255,2902,4671,8,178085
39301,3.7e-05,172.31.36.0-255,66,4737,8,178085
39302,4.3e-05,172.217.194.0-255,4320,9057,8,178085
39303,4.6e-05,172.31.36.0-255,66,9123,8,178085
39304,9.4e-05,172.31.36.0-255,66,9189,8,178085
39305,0.000107,172.31.36.0-255,66,9255,8,178085
39306,0.000146,172.217.194.0-255,1484,10739,8,178085
39307,0.000149,172.31.36.0-255,66,10805,8,178085
39308,0.000154,172.217.194.0-255,2902,13707,8,178085
39309,0.000156,172.31.36.0-255,66,13773,8,178085
39310,0.000174,172.217.194.0-255,1484,15257,8,178085
39311,0.000175,172.31.36.0-255,66,15323,8,178085
39312,0.000201,172.217.194.0-255,4320,19643,8,178085
39313,0.000204,172.31.36.0-255,66,19709,8,178085
39314,0.00021,172.217.194.0-255,4320,24029,8,178085
39315,0.000213,172.31.36.0-255,66,24095,8,178085
39316,0.000229,172.217.194.0-255,1484,25579,8,178085
39317,0.000231,172.31.36.0-255,66,25645,8,178085
39318,0.000237,172.217.194.0-255,4320,29965,8,178085
39319,0.00024,172.31.36.0-255,66,30031,8,178085
39320,0.000272,172.31.36.0-255,66,30097,8,178085
39321,0.000278,172.217.194.0-255,4214,34311,8,178085
39322,0.000279,172.31.36.0-255,66,34377,8,178085
39323,0.000282,172.217.194.0-255,434,34811,8,178085
39324,0.000284,172.31.36.0-255,66,34877,8,178085
39325,0.000872,172.217.194.0-255,1484,36361,8,178085
39326,0.000878,172.217.194.0-255,1484,37845,8,178085
39327,0.000882,172.31.36.0-255,66,37911,8,178085
39328,0.000905,172.217.194.0-255,1484,39395,8,178085
39329,0.000913,172.217.194.0-255,5738,45133,8,178085
39330,0.000916,172.31.36.0-255,66,45199,8,178085
39331,0.000935,172.217.194.0-255,5738,50937,8,178085
39332,0.000938,172.31.36.0-255,66,51003,8,178085
39333,0.000962,172.217.194.0-255,7156,58159,8,178085
39334,0.000965,172.31.36.0-255,66,58225,8,178085
39335,0.000976,172.31.36.0-255,66,58291,8,178085
39336,0.000996,172.217.194.0-255,2184,60475,8,178085
39337,0.000998,172.31.36.0-255,66,60541,8,178085
39338,0.001098,172.217.194.0-255,1484,62025,8,178085
39339,0.001104,172.217.194.0-255,1484,63509,8,178085
39340,0.001107,172.31.36.0-255,66,63575,8,178085
39341,0.001125,172.217.194.0-255,1484,65059,8,178085
39342,0.001132,172.217.194.0-255,5738,70797,8,178085
39343,0.001135,172.31.36.0-255,66,70863,8,178085
39344,0.001155,172.217.194.0-255,4320,75183,8,178085
39345,0.001159,172.31.36.0-255,66,75249,8,178085
39346,0.001191,172.31.36.0-255,66,75315,8,178085
39347,0.001196,172.217.194.0-255,4320,79635,8,178085
39348,0.001198,172.31.36.0-255,66,79701,8,178085
39349,0.001218,172.217.194.0-255,6438,86139,8,178085
39350,0.00122,172.31.36.0-255,66,86205,8,178085
39351,0.001258,172.217.194.0-255,1484,87689,8,178085
39352,0.001261,172.217.194.0-255,1484,89173,8,178085
39353,0.001265,172.31.36.0-255,66,89239,8,178085
39354,0.001282,172.217.194.0-255,1484,90723,8,178085
39355,0.001289,172.217.194.0-255,5738,96461,8,178085
39356,0.001292,172.31.36.0-255,66,96527,8,178085
39357,0.001299,172.217.194.0-255,5738,102265,8,178085
39358,0.001302,172.31.36.0-255,66,102331,8,178085
39359,0.00132,172.217.194.0-255,1484,103815,8,178085
39360,0.001354,172.31.36.0-255,66,103881,8,178085
39361,0.001367,172.217.194.0-255,1484,105365,8,178085
39362,0.001374,172.217.194.0-255,6438,111803,8,178085
39363,0.001376,172.31.36.0-255,66,111869,8,178085
39364,0.001383,172.217.194.0-255,7156,119025,8,178085
39365,0.001385,172.31.36.0-255,66,119091,8,178085
39366,0.001397,172.217.194.0-255,1484,120575,8,178085
39367,0.001438,172.31.36.0-255,66,120641,8,178085
39368,0.001454,172.31.36.0-255,66,120707,8,178085
39369,0.001476,172.217.194.0-255,2184,122891,8,178085
39370,0.001479,172.31.36.0-255,66,122957,8,178085
39371,0.00149,172.31.36.0-255,66,123023,8,178085
39372,0.001552,172.31.36.0-255,66,123089,8,178085
39373,0.00157,172.217.194.0-255,1484,124573,8,178085
39374,0.00159,172.217.194.0-255,2902,127475,8,178085
39375,0.001593,172.31.36.0-255,66,127541,8,178085
39376,0.001598,172.217.194.0-255,2902,130443,8,178085
39377,0.0016,172.31.36.0-255,66,130509,8,178085
39378,0.001618,172.217.194.0-255,2902,133411,8,178085
39379,0.00162,172.31.36.0-255,66,133477,8,178085
39380,0.001623,172.217.194.0-255,1484,134961,8,178085
39381,0.001629,172.217.194.0-255,4320,139281,8,178085
39382,0.001631,172.31.36.0-255,66,139347,8,178085
39383,0.001661,172.217.194.0-255,4320,143667,8,178085
39384,0.001665,172.31.36.0-255,66,143733,8,178085
39385,0.001679,172.31.36.0-255,66,143799,8,178085
39386,0.001709,172.217.194.0-255,1484,145283,8,178085
39387,0.001729,172.217.194.0-255,2902,148185,8,178085
39388,0.001732,172.31.36.0-255,66,148251,8,178085
39389,0.001738,172.217.194.0-255,5738,153989,8,178085
39390,0.001741,172.31.36.0-255,66,154055,8,178085
39391,0.001791,172.31.36.0-255,66,154121,8,178085
39392,0.001806,172.31.36.0-255,66,154187,8,178085
39393,0.001823,172.217.194.0-255,1484,155671,8,178085
39394,0.001844,172.31.36.0-255,66,155737,8,178085
39395,0.001879,172.31.36.0-255,66,155803,8,178085
39396,0.001901,172.217.194.0-255,1484,157287,8,178085
39397,0.00192,172.31.36.0-255,66,157353,8,178085
39398,0.00195,172.31.36.0-255,66,157419,8,178085
39399,0.001968,172.31.36.0-255,66,157485,8,178085
39400,0.002003,172.31.36.0-255,66,157551,8,178085
39401,0.002032,172.217.194.0-255,6438,163989,8,178085
39402,0.002035,172.31.36.0-255,66,164055,8,178085
39403,0.002042,172.217.194.0-255,6587,170642,8,178085
39404,0.002044,172.31.36.0-255,66,170708,8,178085
39405,0.002047,172.217.194.0-255,105,170813,8,178085
39406,0.021843,172.31.36.0-255,66,170879,8,178085
39407,0.021911,172.31.36.0-255,105,170984,8,178085
39408,0.024268,172.217.194.0-255,66,171050,8,178085
39409,0.035526,172.31.36.0-255,172,171222,8,178085
39410,0.035563,172.31.36.0-255,1112,172334,8,178085
39411,0.035634,172.31.36.0-255,1514,173848,8,178085
39412,0.035636,172.31.36.0-255,1514,175362,8,178085
39413,0.03564,172.31.36.0-255,1514,176876,8,178085
39414,0.035642,172.31.36.0-255,771,177647,8,178085
39415,0.037118,104.244.42.0-255,66,177713,8,178085
39416,0.037134,104.244.42.0-255,66,177779,8,178085
39417,0.037209,104.244.42.0-255,66,177845,8,178085
39418,0.037213,104.244.42.0-255,66,177911,8,178085
39419,0.038143,104.244.42.0-255,108,178019,8,178085
39420,0.038167,172.31.36.0-255,66,178085,8,178085
39421,0.0,172.217.194.0-255,152,152,8,133751
39422,2.3e-05,172.31.36.0-255,66,218,8,133751
39423,3e-05,172.217.194.0-255,1484,1702,8,133751
39424,3.5e-05,172.31.36.0-255,66,1768,8,133751
39425,4.2e-05,172.217.194.0-255,2902,4670,8,133751
39426,4.5e-05,172.31.36.0-255,66,4736,8,133751
39427,5.3e-05,172.217.194.0-255,7156,11892,8,133751
39428,5.6e-05,172.31.36.0-255,66,11958,8,133751
39429,6.2e-05,172.217.194.0-255,4855,16813,8,133751
39430,6.5e-05,172.31.36.0-255,66,16879,8,133751
39431,8.1e-05,172.31.36.0-255,66,16945,8,133751
39432,0.000131,172.217.194.0-255,1484,18429,8,133751
39433,0.000134,172.31.36.0-255,66,18495,8,133751
39434,0.000141,172.217.194.0-255,2902,21397,8,133751
39435,0.000143,172.31.36.0-255,66,21463,8,133751
39436,0.00015,172.217.194.0-255,5738,27201,8,133751
39437,0.000153,172.31.36.0-255,66,27267,8,133751
39438,0.000192,172.31.36.0-255,66,27333,8,133751
39439,0.000203,172.31.36.0-255,66,27399,8,133751
39440,0.000222,172.217.194.0-255,1125,28524,8,133751
39441,0.000224,172.31.36.0-255,66,28590,8,133751
39442,0.000286,172.217.194.0-255,647,29237,8,133751
39443,0.000289,172.31.36.0-255,66,29303,8,133751
39444,0.000372,172.217.194.0-255,1484,30787,8,133751
39445,0.000376,172.31.36.0-255,66,30853,8,133751
39446,0.000381,172.217.194.0-255,2902,33755,8,133751
39447,0.000384,172.31.36.0-255,66,33821,8,133751
39448,0.000388,172.217.194.0-255,2902,36723,8,133751
39449,0.000391,172.31.36.0-255,66,36789,8,133751
39450,0.000413,172.217.194.0-255,2902,39691,8,133751
39451,0.000416,172.31.36.0-255,66,39757,8,133751
39452,0.000428,172.31.36.0-255,66,39823,8,133751
39453,0.000443,172.217.194.0-255,3961,43784,8,133751
39454,0.000446,172.31.36.0-255,66,43850,8,133751
39455,0.000458,172.31.36.0-255,66,43916,8,133751
39456,0.000541,172.217.194.0-255,1484,45400,8,133751
39457,0.000554,172.217.194.0-255,2902,48302,8,133751
39458,0.000557,172.31.36.0-255,66,48368,8,133751
39459,0.000562,172.217.194.0-255,2902,51270,8,133751
39460,0.000565,172.31.36.0-255,66,51336,8,133751
39461,0.000577,172.217.194.0-255,2902,54238,8,133751
39462,0.000579,172.31.36.0-255,66,54304,8,133751
39463,0.000582,172.217.194.0-255,1484,55788,8,133751
39464,0.000621,172.31.36.0-255,66,55854,8,133751
39465,0.000632,172.31.36.0-255,66,55920,8,133751
39466,0.000655,172.217.194.0-255,2184,58104,8,133751
39467,0.000658,172.31.36.0-255,66,58170,8,133751
39468,0.000763,172.217.194.0-255,1484,59654,8,133751
39469,0.00077,172.217.194.0-255,2902,62556,8,133751
39470,0.000774,172.31.36.0-255,66,62622,8,133751
39471,0.00078,172.217.194.0-255,4320,66942,8,133751
39472,0.000783,172.31.36.0-255,66,67008,8,133751
39473,0.000807,172.217.194.0-255,1484,68492,8,133751
39474,0.000821,172.31.36.0-255,66,68558,8,133751
39475,0.00088,172.31.36.0-255,66,68624,8,133751
39476,0.001005,172.217.194.0-255,1484,70108,8,133751
39477,0.001009,172.217.194.0-255,1484,71592,8,133751
39478,0.001012,172.31.36.0-255,66,71658,8,133751
39479,0.001035,172.217.194.0-255,1484,73142,8,133751
39480,0.001042,172.217.194.0-255,5738,78880,8,133751
39481,0.001045,172.31.36.0-255,66,78946,8,133751
39482,0.001049,172.217.194.0-255,2902,81848,8,133751
39483,0.001051,172.31.36.0-255,66,81914,8,133751
39484,0.001084,172.31.36.0-255,66,81980,8,133751
39485,0.001095,172.31.36.0-255,66,82046,8,133751
39486,0.001119,172.217.194.0-255,2184,84230,8,133751
39487,0.001123,172.31.36.0-255,66,84296,8,133751
39488,0.001518,172.217.194.0-255,1484,85780,8,133751
39489,0.001523,172.217.194.0-255,1484,87264,8,133751
39490,0.001527,172.31.36.0-255,66,87330,8,133751
39491,0.001549,172.217.194.0-255,1484,88814,8,133751
39492,0.001556,172.217.194.0-255,5738,94552,8,133751
39493,0.001559,172.31.36.0-255,66,94618,8,133751
39494,0.001586,172.31.36.0-255,66,94684,8,133751
39495,0.001603,172.217.194.0-255,2902,97586,8,133751
39496,0.001605,172.31.36.0-255,66,97652,8,133751
39497,0.00162,172.217.194.0-255,2902,100554,8,133751
39498,0.001622,172.31.36.0-255,66,100620,8,133751
39499,0.001643,172.31.36.0-255,66,100686,8,133751
39500,0.001674,172.217.194.0-255,1484,102170,8,133751
39501,0.001679,172.217.194.0-255,2902,105072,8,133751
39502,0.001682,172.31.36.0-255,66,105138,8,133751
39503,0.001686,172.217.194.0-255,1484,106622,8,133751
39504,0.001703,172.217.194.0-255,4320,110942,8,133751
39505,0.001705,172.31.36.0-255,66,111008,8,133751
39506,0.001737,172.31.36.0-255,66,111074,8,133751
39507,0.00175,172.31.36.0-255,66,111140,8,133751
39508,0.001752,172.217.194.0-255,766,111906,8,133751
39509,0.001827,172.217.194.0-255,1484,113390,8,133751
39510,0.001831,172.31.36.0-255,66,113456,8,133751
39511,0.001836,172.217.194.0-255,2902,116358,8,133751
39512,0.001838,172.31.36.0-255,66,116424,8,133751
39513,0.001844,172.217.194.0-255,4320,120744,8,133751
39514,0.001847,172.31.36.0-255,66,120810,8,133751
39515,0.001865,172.217.194.0-255,1484,122294,8,133751
39516,0.00188,172.31.36.0-255,66,122360,8,133751
39517,0.001919,172.31.36.0-255,66,122426,8,133751
39518,0.001923,172.217.194.0-255,1484,123910,8,133751
39519,0.001956,172.31.36.0-255,66,123976,8,133751
39520,0.001969,172.31.36.0-255,66,124042,8,133751
39521,0.002046,172.31.36.0-255,66,124108,8,133751
39522,0.002064,172.217.194.0-255,766,124874,8,133751
39523,0.002084,172.31.36.0-255,66,124940,8,133751
39524,0.002098,172.31.36.0-255,66,125006,8,133751
39525,0.002111,172.31.36.0-255,66,125072,8,133751
39526,0.002155,172.31.36.0-255,66,125138,8,133751
39527,0.002158,172.217.194.0-255,316,125454,8,133751
39528,0.00216,172.217.194.0-255,105,125559,8,133751
39529,0.009685,172.31.36.0-255,66,125625,8,133751
39530,0.009721,172.31.36.0-255,105,125730,8,133751
39531,0.011148,172.217.194.0-255,105,125835,8,133751
39532,0.011157,172.31.36.0-255,78,125913,8,133751
39533,0.011965,172.217.194.0-255,66,125979,8,133751
39534,0.036463,172.31.36.0-255,172,126151,8,133751
39535,0.0365,172.31.36.0-255,1112,127263,8,133751
39536,0.036559,172.31.36.0-255,1514,128777,8,133751
39537,0.03656,172.31.36.0-255,1514,130291,8,133751
39538,0.036565,172.31.36.0-255,1514,131805,8,133751
39539,0.036566,172.31.36.0-255,1514,133319,8,133751
39540,0.036583,172.31.36.0-255,168,133487,8,133751
39541,0.037986,104.244.42.0-255,66,133553,8,133751
39542,0.037995,104.244.42.0-255,66,133619,8,133751
39543,0.038123,104.244.42.0-255,66,133685,8,133751
39544,0.038127,104.244.42.0-255,66,133751,8,133751
39545,0.0,172.217.194.0-255,290,290,8,212181
39546,2.9e-05,172.31.36.0-255,66,356,8,212181
39547,3.5e-05,172.217.194.0-255,1484,1840,8,212181
39548,4.1e-05,172.31.36.0-255,66,1906,8,212181
39549,4.6e-05,172.217.194.0-255,4320,6226,8,212181
39550,4.9e-05,172.31.36.0-255,66,6292,8,212181
39551,6e-05,172.31.36.0-255,66,6358,8,212181
39552,6.4e-05,172.217.194.0-255,2902,9260,8,212181
39553,6.7e-05,172.31.36.0-255,66,9326,8,212181
39554,0.00011,172.31.36.0-255,66,9392,8,212181
39555,0.000114,172.217.194.0-255,2543,11935,8,212181
39556,0.000116,172.31.36.0-255,66,12001,8,212181
39557,0.000159,172.217.194.0-255,1484,13485,8,212181
39558,0.000163,172.31.36.0-255,66,13551,8,212181
39559,0.000168,172.217.194.0-255,2902,16453,8,212181
39560,0.00017,172.31.36.0-255,66,16519,8,212181
39561,0.000175,172.217.194.0-255,4320,20839,8,212181
39562,0.000178,172.31.36.0-255,66,20905,8,212181
39563,0.000196,172.217.194.0-255,1484,22389,8,212181
39564,0.000198,172.31.36.0-255,66,22455,8,212181
39565,0.000205,172.217.194.0-255,6797,29252,8,212181
39566,0.000208,172.31.36.0-255,66,29318,8,212181
39567,0.000717,172.217.194.0-255,1484,30802,8,212181
39568,0.000722,172.31.36.0-255,66,30868,8,212181
39569,0.000732,172.217.194.0-255,2902,33770,8,212181
39570,0.000735,172.31.36.0-255,66,33836,8,212181
39571,0.000741,172.217.194.0-255,5738,39574,8,212181
39572,0.000743,172.31.36.0-255,66,39640,8,212181
39573,0.000746,172.217.194.0-255,1484,41124,8,212181
39574,0.000748,172.31.36.0-255,66,41190,8,212181
39575,0.000768,172.217.194.0-255,2902,44092,8,212181
39576,0.000771,172.31.36.0-255,66,44158,8,212181
39577,0.000804,172.217.194.0-255,3123,47281,8,212181
39578,0.000807,172.31.36.0-255,66,47347,8,212181
39579,0.001874,172.217.194.0-255,1484,48831,8,212181
39580,0.001883,172.217.194.0-255,2902,51733,8,212181
39581,0.001888,172.31.36.0-255,66,51799,8,212181
39582,0.001895,172.217.194.0-255,5738,57537,8,212181
39583,0.001897,172.31.36.0-255,66,57603,8,212181
39584,0.001918,172.217.194.0-255,2902,60505,8,212181
39585,0.00192,172.31.36.0-255,66,60571,8,212181
39586,0.001943,172.31.36.0-255,66,60637,8,212181
39587,0.00197,172.217.194.0-255,1484,62121,8,212181
39588,0.001996,172.31.36.0-255,66,62187,8,212181
39589,0.004523,172.217.194.0-255,5738,67925,8,212181
39590,0.004529,172.31.36.0-255,66,67991,8,212181
39591,0.007079,172.217.194.0-255,2902,70893,8,212181
39592,0.007083,172.31.36.0-255,66,70959,8,212181
39593,0.0071,172.217.194.0-255,2902,73861,8,212181
39594,0.007102,172.31.36.0-255,66,73927,8,212181
39595,0.009617,172.217.194.0-255,2902,76829,8,212181
39596,0.009625,172.31.36.0-255,66,76895,8,212181
39597,0.00965,172.217.194.0-255,1484,78379,8,212181
39598,0.009666,172.217.194.0-255,1484,79863,8,212181
39599,0.00967,172.31.36.0-255,66,79929,8,212181
39600,0.01218,172.217.194.0-255,2902,82831,8,212181
39601,0.012188,172.31.36.0-255,66,82897,8,212181
39602,0.012231,172.217.194.0-255,2902,85799,8,212181
39603,0.012236,172.31.36.0-255,66,85865,8,212181
39604,0.014742,172.217.194.0-255,2902,88767,8,212181
39605,0.014753,172.31.36.0-255,66,88833,8,212181
39606,0.01478,172.217.194.0-255,2902,91735,8,212181
39607,0.014784,172.31.36.0-255,66,91801,8,212181
39608,0.017305,172.217.194.0-255,2902,94703,8,212181
39609,0.017312,172.31.36.0-255,66,94769,8,212181
39610,0.017337,172.217.194.0-255,2902,97671,8,212181
39611,0.017342,172.31.36.0-255,66,97737,8,212181
39612,0.019845,172.217.194.0-255,2902,100639,8,212181
39613,0.019855,172.31.36.0-255,66,100705,8,212181
39614,0.019878,172.217.194.0-255,2902,103607,8,212181
39615,0.019881,172.31.36.0-255,66,103673,8,212181
39616,0.022407,172.217.194.0-255,2902,106575,8,212181
39617,0.022414,172.31.36.0-255,66,106641,8,212181
39618,0.022433,172.217.194.0-255,2902,109543,8,212181
39619,0.022436,172.31.36.0-255,66,109609,8,212181
39620,0.024968,172.217.194.0-255,5738,115347,8,212181
39621,0.024976,172.31.36.0-255,66,115413,8,212181
39622,0.027529,172.217.194.0-255,5738,121151,8,212181
39623,0.027537,172.31.36.0-255,66,121217,8,212181
39624,0.029846,172.31.36.0-255,176,121393,8,212181
39625,0.029877,172.31.36.0-255,562,121955,8,212181
39626,0.030083,172.217.194.0-255,5738,127693,8,212181
39627,0.030098,172.31.36.0-255,66,127759,8,212181
39628,0.031864,104.244.42.0-255,66,127825,8,212181
39629,0.03264,172.217.194.0-255,4320,132145,8,212181
39630,0.032644,172.31.36.0-255,66,132211,8,212181
39631,0.032678,172.217.194.0-255,1484,133695,8,212181
39632,0.035224,172.217.194.0-255,4320,138015,8,212181
39633,0.03523,172.31.36.0-255,66,138081,8,212181
39634,0.037786,172.217.194.0-255,5738,143819,8,212181
39635,0.037793,172.31.36.0-255,66,143885,8,212181
39636,0.04042,172.217.194.0-255,4320,148205,8,212181
39637,0.040425,172.31.36.0-255,66,148271,8,212181
39638,0.040456,172.217.194.0-255,1484,149755,8,212181
39639,0.042976,172.217.194.0-255,4320,154075,8,212181
39640,0.042981,172.31.36.0-255,66,154141,8,212181
39641,0.045545,172.217.194.0-255,5738,159879,8,212181
39642,0.045552,172.31.36.0-255,66,159945,8,212181
39643,0.048082,172.217.194.0-255,5738,165683,8,212181
39644,0.048088,172.31.36.0-255,66,165749,8,212181
39645,0.050615,172.217.194.0-255,5738,171487,8,212181
39646,0.050621,172.31.36.0-255,66,171553,8,212181
39647,0.053168,172.217.194.0-255,5738,177291,8,212181
39648,0.053174,172.31.36.0-255,66,177357,8,212181
39649,0.055753,172.217.194.0-255,5738,183095,8,212181
39650,0.055759,172.31.36.0-255,66,183161,8,212181
39651,0.058309,172.217.194.0-255,5738,188899,8,212181
39652,0.058315,172.31.36.0-255,66,188965,8,212181
39653,0.060846,172.217.194.0-255,5738,194703,8,212181
39654,0.060851,172.31.36.0-255,66,194769,8,212181
39655,0.063382,172.217.194.0-255,5738,200507,8,212181
39656,0.063387,172.31.36.0-255,66,200573,8,212181
39657,0.065937,172.217.194.0-255,5738,206311,8,212181
39658,0.065942,172.31.36.0-255,66,206377,8,212181
39659,0.068469,172.217.194.0-255,5738,212115,8,212181
39660,0.068474,172.31.36.0-255,66,212181,8,212181
39661,0.0,172.253.118.0-255,153,153,8,209971
39662,1.6e-05,172.31.36.0-255,66,219,8,209971
39663,5.1e-05,172.253.118.0-255,1484,1703,8,209971
39664,5.6e-05,172.31.36.0-255,66,1769,8,209971
39665,6.1e-05,172.253.118.0-255,2902,4671,8,209971
39666,6.5e-05,172.31.36.0-255,66,4737,8,209971
39667,0.0001,172.253.118.0-255,4320,9057,8,209971
39668,0.000104,172.31.36.0-255,66,9123,8,209971
39669,0.00011,172.253.118.0-255,4935,14058,8,209971
39670,0.000112,172.31.36.0-255,66,14124,8,209971
39671,0.000206,172.253.118.0-255,1484,15608,8,209971
39672,0.00021,172.31.36.0-255,66,15674,8,209971
39673,0.000214,172.253.118.0-255,1484,17158,8,209971
39674,0.000216,172.31.36.0-255,66,17224,8,209971
39675,0.000244,172.253.118.0-255,1484,18708,8,209971
39676,0.000247,172.31.36.0-255,66,18774,8,209971
39677,0.000254,172.253.118.0-255,4320,23094,8,209971
39678,0.000256,172.31.36.0-255,66,23160,8,209971
39679,0.000314,172.31.36.0-255,66,23226,8,209971
39680,0.000322,172.253.118.0-255,7156,30382,8,209971
39681,0.000325,172.31.36.0-255,66,30448,8,209971
39682,0.000346,172.253.118.0-255,1484,31932,8,209971
39683,0.000348,172.31.36.0-255,66,31998,8,209971
39684,0.000364,172.31.36.0-255,66,32064,8,209971
39685,0.00083,172.253.118.0-255,1484,33548,8,209971
39686,0.000835,172.253.118.0-255,1484,35032,8,209971
39687,0.000842,172.31.36.0-255,66,35098,8,209971
39688,0.00085,172.31.36.0-255,66,35164,8,209971
39689,0.000854,172.253.118.0-255,1484,36648,8,209971
39690,0.000861,172.31.36.0-255,66,36714,8,209971
39691,0.00087,172.253.118.0-255,5738,42452,8,209971
39692,0.000873,172.31.36.0-255,66,42518,8,209971
39693,0.000911,172.31.36.0-255,66,42584,8,209971
39694,0.000941,172.31.36.0-255,66,42650,8,209971
39695,0.000948,172.253.118.0-255,4541,47191,8,209971
39696,0.00095,172.31.36.0-255,66,47257,8,209971
39697,0.001035,172.253.118.0-255,1484,48741,8,209971
39698,0.00104,172.253.118.0-255,1484,50225,8,209971
39699,0.001043,172.31.36.0-255,66,50291,8,209971
39700,0.00107,172.253.118.0-255,1484,51775,8,209971
39701,0.001077,172.253.118.0-255,4320,56095,8,209971
39702,0.001079,172.31.36.0-255,66,56161,8,209971
39703,0.00109,172.253.118.0-255,1484,57645,8,209971
39704,0.001102,172.253.118.0-255,7156,64801,8,209971
39705,0.001106,172.31.36.0-255,66,64867,8,209971
39706,0.001142,172.31.36.0-255,66,64933,8,209971
39707,0.001145,172.253.118.0-255,1484,66417,8,209971
39708,0.001177,172.253.118.0-255,5774,72191,8,209971
39709,0.001181,172.31.36.0-255,66,72257,8,209971
39710,0.001359,172.253.118.0-255,1484,73741,8,209971
39711,0.001364,172.253.118.0-255,1484,75225,8,209971
39712,0.001367,172.31.36.0-255,66,75291,8,209971
39713,0.001394,172.253.118.0-255,1484,76775,8,209971
39714,0.001401,172.253.118.0-255,5738,82513,8,209971
39715,0.001404,172.31.36.0-255,66,82579,8,209971
39716,0.00141,172.253.118.0-255,5738,88317,8,209971
39717,0.001413,172.31.36.0-255,66,88383,8,209971
39718,0.001443,172.253.118.0-255,5738,94121,8,209971
39719,0.001446,172.31.36.0-255,66,94187,8,209971
39720,0.001476,172.253.118.0-255,7156,101343,8,209971
39721,0.001479,172.31.36.0-255,66,101409,8,209971
39722,0.001485,172.253.118.0-255,5020,106429,8,209971
39723,0.001487,172.31.36.0-255,66,106495,8,209971
39724,0.001699,172.253.118.0-255,1484,107979,8,209971
39725,0.001706,172.253.118.0-255,2902,110881,8,209971
39726,0.00171,172.31.36.0-255,66,110947,8,209971
39727,0.001742,172.253.118.0-255,5738,116685,8,209971
39728,0.001745,172.31.36.0-255,66,116751,8,209971
39729,0.001783,172.31.36.0-255,66,116817,8,209971
39730,0.001821,172.31.36.0-255,66,116883,8,209971
39731,0.001854,172.253.118.0-255,3602,120485,8,209971
39732,0.001857,172.31.36.0-255,66,120551,8,209971
39733,0.001872,172.31.36.0-255,66,120617,8,209971
39734,0.001887,172.31.36.0-255,66,120683,8,209971
39735,0.001962,172.253.118.0-255,1484,122167,8,209971
39736,0.00198,172.253.118.0-255,2902,125069,8,209971
39737,0.001984,172.31.36.0-255,66,125135,8,209971
39738,0.001991,172.253.118.0-255,5738,130873,8,209971
39739,0.002032,172.253.118.0-255,7156,138029,8,209971
39740,0.002051,172.31.36.0-255,66,138095,8,209971
39741,0.002077,172.253.118.0-255,3602,141697,8,209971
39742,0.00208,172.31.36.0-255,66,141763,8,209971
39743,0.002146,172.253.118.0-255,1484,143247,8,209971
39744,0.002151,172.253.118.0-255,2902,146149,8,209971
39745,0.002154,172.253.118.0-255,1484,147633,8,209971
39746,0.002181,172.253.118.0-255,4320,151953,8,209971
39747,0.002187,172.253.118.0-255,4320,156273,8,209971
39748,0.00219,172.253.118.0-255,2902,159175,8,209971
39749,0.00222,172.253.118.0-255,2902,162077,8,209971
39750,0.002311,172.253.118.0-255,4320,166397,8,209971
39751,0.002314,172.253.118.0-255,1484,167881,8,209971
39752,0.002331,172.253.118.0-255,1484,169365,8,209971
39753,0.002334,172.253.118.0-255,1484,170849,8,209971
39754,0.002401,172.253.118.0-255,2902,173751,8,209971
39755,0.002407,172.253.118.0-255,5738,179489,8,209971
39756,0.002414,172.253.118.0-255,7156,186645,8,209971
39757,0.002417,172.253.118.0-255,766,187411,8,209971
39758,0.002528,172.253.118.0-255,1484,188895,8,209971
39759,0.002534,172.253.118.0-255,2902,191797,8,209971
39760,0.002558,172.253.118.0-255,5738,197535,8,209971
39761,0.002562,172.253.118.0-255,1484,199019,8,209971
39762,0.002637,172.253.118.0-255,1484,200503,8,209971
39763,0.002641,172.253.118.0-255,766,201269,8,209971
39764,0.002643,172.253.118.0-255,1484,202753,8,209971
39765,0.002645,172.253.118.0-255,1484,204237,8,209971
39766,0.002711,172.253.118.0-255,2902,207139,8,209971
39767,0.002735,172.253.118.0-255,1457,208596,8,209971
39768,0.002749,172.253.118.0-255,105,208701,8,209971
39769,0.009034,172.31.36.0-255,66,208767,8,209971
39770,0.010947,172.31.36.0-255,101,208868,8,209971
39771,0.012268,172.31.36.0-255,105,208973,8,209971
39772,0.013235,172.253.118.0-255,66,209039,8,209971
39773,0.014528,172.253.118.0-255,66,209105,8,209971
39774,0.038636,172.31.36.0-255,172,209277,8,209971
39775,0.038693,172.31.36.0-255,562,209839,8,209971
39776,0.040212,104.244.42.0-255,66,209905,8,209971
39777,0.040244,104.244.42.0-255,66,209971,8,209971
39778,0.0,172.217.24.0-255,152,152,8,304197
39779,2.3e-05,172.31.36.0-255,66,218,8,304197
39780,3.1e-05,172.217.24.0-255,1484,1702,8,304197
39781,3.5e-05,172.31.36.0-255,66,1768,8,304197
39782,4.1e-05,172.217.24.0-255,2902,4670,8,304197
39783,4.5e-05,172.31.36.0-255,66,4736,8,304197
39784,5e-05,172.217.24.0-255,2902,7638,8,304197
39785,5.2e-05,172.31.36.0-255,66,7704,8,304197
39786,6.5e-05,172.31.36.0-255,66,7770,8,304197
39787,9.9e-05,172.31.36.0-255,66,7836,8,304197
39788,0.00012,172.217.24.0-255,5379,13215,8,304197
39789,0.000123,172.31.36.0-255,66,13281,8,304197
39790,0.000279,172.217.24.0-255,1484,14765,8,304197
39791,0.000284,172.31.36.0-255,66,14831,8,304197
39792,0.000289,172.217.24.0-255,2902,17733,8,304197
39793,0.000292,172.31.36.0-255,66,17799,8,304197
39794,0.000298,172.217.24.0-255,5738,23537,8,304197
39795,0.000301,172.31.36.0-255,66,23603,8,304197
39796,0.000335,172.217.24.0-255,2902,26505,8,304197
39797,0.000338,172.31.36.0-255,66,26571,8,304197
39798,0.000359,172.217.24.0-255,3961,30532,8,304197
39799,0.000362,172.31.36.0-255,66,30598,8,304197
39800,0.000552,172.217.24.0-255,1484,32082,8,304197
39801,0.000558,172.31.36.0-255,66,32148,8,304197
39802,0.000563,172.217.24.0-255,2902,35050,8,304197
39803,0.000566,172.31.36.0-255,66,35116,8,304197
39804,0.000572,172.217.24.0-255,5738,40854,8,304197
39805,0.000574,172.31.36.0-255,66,40920,8,304197
39806,0.000578,172.217.24.0-255,2902,43822,8,304197
39807,0.000581,172.31.36.0-255,66,43888,8,304197
39808,0.000607,172.217.24.0-255,3961,47849,8,304197
39809,0.00061,172.31.36.0-255,66,47915,8,304197
39810,0.000614,172.217.24.0-255,392,48307,8,304197
39811,0.001001,172.217.24.0-255,119,48426,8,304197
39812,0.001077,172.31.36.0-255,66,48492,8,304197
39813,0.001171,172.217.24.0-255,1484,49976,8,304197
39814,0.001179,172.217.24.0-255,2902,52878,8,304197
39815,0.001183,172.31.36.0-255,66,52944,8,304197
39816,0.001189,172.217.24.0-255,2902,55846,8,304197
39817,0.001191,172.31.36.0-255,66,55912,8,304197
39818,0.001196,172.217.24.0-255,4320,60232,8,304197
39819,0.001198,172.31.36.0-255,66,60298,8,304197
39820,0.001242,172.217.24.0-255,4320,64618,8,304197
39821,0.001245,172.31.36.0-255,66,64684,8,304197
39822,0.001256,172.217.24.0-255,1125,65809,8,304197
39823,0.001281,172.217.24.0-255,5738,71547,8,304197
39824,0.001284,172.31.36.0-255,66,71613,8,304197
39825,0.001299,172.217.24.0-255,2902,74515,8,304197
39826,0.001301,172.31.36.0-255,66,74581,8,304197
39827,0.001324,172.31.36.0-255,66,74647,8,304197
39828,0.001796,172.217.24.0-255,1484,76131,8,304197
39829,0.001805,172.217.24.0-255,2902,79033,8,304197
39830,0.001809,172.31.36.0-255,66,79099,8,304197
39831,0.001817,172.217.24.0-255,5738,84837,8,304197
39832,0.001819,172.31.36.0-255,66,84903,8,304197
39833,0.001842,172.31.36.0-255,66,84969,8,304197
39834,0.001878,172.217.24.0-255,2902,87871,8,304197
39835,0.001881,172.31.36.0-255,66,87937,8,304197
39836,0.001894,172.31.36.0-255,66,88003,8,304197
39837,0.001933,172.217.24.0-255,1484,89487,8,304197
39838,0.001939,172.217.24.0-255,2902,92389,8,304197
39839,0.001942,172.31.36.0-255,66,92455,8,304197
39840,0.001948,172.217.24.0-255,5738,98193,8,304197
39841,0.001951,172.31.36.0-255,66,98259,8,304197
39842,0.001993,172.31.36.0-255,66,98325,8,304197
39843,0.002011,172.217.24.0-255,2902,101227,8,304197
39844,0.002013,172.31.36.0-255,66,101293,8,304197
39845,0.00392,172.217.24.0-255,2902,104195,8,304197
39846,0.003928,172.31.36.0-255,66,104261,8,304197
39847,0.004035,172.217.24.0-255,2902,107163,8,304197
39848,0.004038,172.31.36.0-255,66,107229,8,304197
39849,0.005861,172.217.24.0-255,2902,110131,8,304197
39850,0.005868,172.31.36.0-255,66,110197,8,304197
39851,0.005965,172.217.24.0-255,2902,113099,8,304197
39852,0.005969,172.31.36.0-255,66,113165,8,304197
39853,0.007801,172.217.24.0-255,2902,116067,8,304197
39854,0.007806,172.31.36.0-255,66,116133,8,304197
39855,0.007899,172.217.24.0-255,2902,119035,8,304197
39856,0.007904,172.31.36.0-255,66,119101,8,304197
39857,0.009738,172.217.24.0-255,2902,122003,8,304197
39858,0.009746,172.31.36.0-255,66,122069,8,304197
39859,0.009827,172.217.24.0-255,2902,124971,8,304197
39860,0.009832,172.31.36.0-255,66,125037,8,304197
39861,0.011683,172.217.24.0-255,2902,127939,8,304197
39862,0.011691,172.31.36.0-255,66,128005,8,304197
39863,0.011747,172.217.24.0-255,2902,130907,8,304197
39864,0.011751,172.31.36.0-255,66,130973,8,304197
39865,0.013625,172.217.24.0-255,2902,133875,8,304197
39866,0.013632,172.31.36.0-255,66,133941,8,304197
39867,0.013666,172.217.24.0-255,2902,136843,8,304197
39868,0.013668,172.31.36.0-255,66,136909,8,304197
39869,0.015572,172.217.24.0-255,2902,139811,8,304197
39870,0.01558,172.31.36.0-255,66,139877,8,304197
39871,0.015609,172.217.24.0-255,2902,142779,8,304197
39872,0.015612,172.31.36.0-255,66,142845,8,304197
39873,0.017512,172.217.24.0-255,2902,145747,8,304197
39874,0.017518,172.31.36.0-255,66,145813,8,304197
39875,0.017536,172.217.24.0-255,2902,148715,8,304197
39876,0.017538,172.31.36.0-255,66,148781,8,304197
39877,0.019455,172.217.24.0-255,5738,154519,8,304197
39878,0.019465,172.31.36.0-255,66,154585,8,304197
39879,0.021402,172.217.24.0-255,5738,160323,8,304197
39880,0.021409,172.31.36.0-255,66,160389,8,304197
39881,0.023349,172.217.24.0-255,5738,166127,8,304197
39882,0.023356,172.31.36.0-255,66,166193,8,304197
39883,0.025289,172.217.24.0-255,5738,171931,8,304197
39884,0.025295,172.31.36.0-255,66,171997,8,304197
39885,0.027228,172.217.24.0-255,5738,177735,8,304197
39886,0.027236,172.31.36.0-255,66,177801,8,304197
39887,0.029175,172.217.24.0-255,5738,183539,8,304197
39888,0.029183,172.31.36.0-255,66,183605,8,304197
39889,0.031116,172.217.24.0-255,5738,189343,8,304197
39890,0.031123,172.31.36.0-255,66,189409,8,304197
39891,0.033065,172.217.24.0-255,5738,195147,8,304197
39892,0.033073,172.31.36.0-255,66,195213,8,304197
39893,0.03501,172.217.24.0-255,5738,200951,8,304197
39894,0.035016,172.31.36.0-255,66,201017,8,304197
39895,0.036955,172.217.24.0-255,5738,206755,8,304197
39896,0.036963,172.31.36.0-255,66,206821,8,304197
39897,0.0389,172.217.24.0-255,5738,212559,8,304197
39898,0.038907,172.31.36.0-255,66,212625,8,304197
39899,0.040855,172.217.24.0-255,5738,218363,8,304197
39900,0.040868,172.31.36.0-255,66,218429,8,304197
39901,0.04282,172.217.24.0-255,5738,224167,8,304197
39902,0.042827,172.31.36.0-255,66,224233,8,304197
39903,0.044767,172.217.24.0-255,5738,229971,8,304197
39904,0.044774,172.31.36.0-255,66,230037,8,304197
39905,0.04672,172.217.24.0-255,5738,235775,8,304197
39906,0.046727,172.31.36.0-255,66,235841,8,304197
39907,0.048665,172.217.24.0-255,5738,241579,8,304197
39908,0.048673,172.31.36.0-255,66,241645,8,304197
39909,0.050617,172.217.24.0-255,5738,247383,8,304197
39910,0.050625,172.31.36.0-255,66,247449,8,304197
39911,0.052563,172.217.24.0-255,5738,253187,8,304197
39912,0.052569,172.31.36.0-255,66,253253,8,304197
39913,0.054507,172.217.24.0-255,5738,258991,8,304197
39914,0.054514,172.31.36.0-255,66,259057,8,304197
39915,0.055358,172.31.36.0-255,188,259245,8,304197
39916,0.055388,172.31.36.0-255,955,260200,8,304197
39917,0.055457,172.31.36.0-255,1514,261714,8,304197
39918,0.055459,172.31.36.0-255,1514,263228,8,304197
39919,0.055483,172.31.36.0-255,77,263305,8,304197
39920,0.056449,172.217.24.0-255,5738,269043,8,304197
39921,0.056457,172.31.36.0-255,66,269109,8,304197
39922,0.056886,104.244.42.0-255,66,269175,8,304197
39923,0.056905,104.244.42.0-255,66,269241,8,304197
39924,0.056981,104.244.42.0-255,66,269307,8,304197
39925,0.056988,104.244.42.0-255,66,269373,8,304197
39926,0.058409,172.217.24.0-255,5738,275111,8,304197
39927,0.058416,172.31.36.0-255,66,275177,8,304197
39928,0.060359,172.217.24.0-255,5738,280915,8,304197
39929,0.060366,172.31.36.0-255,66,280981,8,304197
39930,0.062305,172.217.24.0-255,5738,286719,8,304197
39931,0.062311,172.31.36.0-255,66,286785,8,304197
39932,0.064306,172.217.24.0-255,5738,292523,8,304197
39933,0.064313,172.31.36.0-255,66,292589,8,304197
39934,0.066259,172.217.24.0-255,5738,298327,8,304197
39935,0.066265,172.31.36.0-255,66,298393,8,304197
39936,0.068212,172.217.24.0-255,5738,304131,8,304197
39937,0.068219,172.31.36.0-255,66,304197,8,304197
39938,0.0,172.217.194.0-255,298,298,8,273653
39939,2.4e-05,172.31.36.0-255,66,364,8,273653
39940,3.1e-05,172.217.194.0-255,1484,1848,8,273653
39941,3.5e-05,172.31.36.0-255,66,1914,8,273653
39942,4.4e-05,172.217.194.0-255,4320,6234,8,273653
39943,4.7e-05,172.31.36.0-255,66,6300,8,273653
39944,5.5e-05,172.217.194.0-255,7156,13456,8,273653
39945,5.8e-05,172.31.36.0-255,66,13522,8,273653
39946,8.8e-05,172.217.194.0-255,451,13973,8,273653
39947,9.1e-05,172.31.36.0-255,66,14039,8,273653
39948,0.000234,172.217.194.0-255,1484,15523,8,273653
39949,0.000239,172.31.36.0-255,66,15589,8,273653
39950,0.000245,172.217.194.0-255,2902,18491,8,273653
39951,0.000248,172.31.36.0-255,66,18557,8,273653
39952,0.000274,172.217.194.0-255,5738,24295,8,273653
39953,0.000276,172.31.36.0-255,66,24361,8,273653
39954,0.000281,172.217.194.0-255,2902,27263,8,273653
39955,0.000282,172.31.36.0-255,66,27329,8,273653
39956,0.000303,172.217.194.0-255,1484,28813,8,273653
39957,0.000305,172.31.36.0-255,66,28879,8,273653
39958,0.00034,172.217.194.0-255,2543,31422,8,273653
39959,0.000343,172.31.36.0-255,66,31488,8,273653
39960,0.000376,172.217.194.0-255,2902,34390,8,273653
39961,0.000379,172.31.36.0-255,66,34456,8,273653
39962,0.000402,172.217.194.0-255,4320,38776,8,273653
39963,0.000404,172.31.36.0-255,66,38842,8,273653
39964,0.000416,172.31.36.0-255,66,38908,8,273653
39965,0.00045,172.217.194.0-255,4320,43228,8,273653
39966,0.000452,172.31.36.0-255,66,43294,8,273653
39967,0.000482,172.31.36.0-255,66,43360,8,273653
39968,0.000485,172.217.194.0-255,378,43738,8,273653
39969,0.000512,172.217.194.0-255,98,43836,8,273653
39970,0.00076,172.217.194.0-255,363,44199,8,273653
39971,0.0009,172.217.194.0-255,1484,45683,8,273653
39972,0.000905,172.31.36.0-255,66,45749,8,273653
39973,0.00091,172.217.194.0-255,2902,48651,8,273653
39974,0.000912,172.31.36.0-255,66,48717,8,273653
39975,0.000918,172.217.194.0-255,4320,53037,8,273653
39976,0.00092,172.31.36.0-255,66,53103,8,273653
39977,0.000948,172.217.194.0-255,1484,54587,8,273653
39978,0.000963,172.31.36.0-255,66,54653,8,273653
39979,0.000968,172.217.194.0-255,2902,57555,8,273653
39980,0.00097,172.31.36.0-255,66,57621,8,273653
39981,0.001017,172.31.36.0-255,66,57687,8,273653
39982,0.001153,172.217.194.0-255,1484,59171,8,273653
39983,0.001158,172.217.194.0-255,2902,62073,8,273653
39984,0.001161,172.31.36.0-255,66,62139,8,273653
39985,0.001165,172.217.194.0-255,1484,63623,8,273653
39986,0.001183,172.217.194.0-255,4320,67943,8,273653
39987,0.001186,172.31.36.0-255,66,68009,8,273653
39988,0.001208,172.217.194.0-255,5738,73747,8,273653
39989,0.00121,172.31.36.0-255,66,73813,8,273653
39990,0.001234,172.217.194.0-255,7156,80969,8,273653
39991,0.001237,172.31.36.0-255,66,81035,8,273653
39992,0.001248,172.31.36.0-255,66,81101,8,273653
39993,0.001251,172.217.194.0-255,766,81867,8,273653
39994,0.001317,172.217.194.0-255,1484,83351,8,273653
39995,0.00132,172.31.36.0-255,66,83417,8,273653
39996,0.001325,172.217.194.0-255,2902,86319,8,273653
39997,0.001328,172.31.36.0-255,66,86385,8,273653
39998,0.001337,172.217.194.0-255,5738,92123,8,273653
39999,0.00134,172.31.36.0-255,66,92189,8,273653
40000,0.001344,172.217.194.0-255,1484,93673,8,273653
40001,0.001376,172.31.36.0-255,66,93739,8,273653
40002,0.001387,172.31.36.0-255,66,93805,8,273653
40003,0.001403,172.217.194.0-255,766,94571,8,273653
40004,0.001477,172.217.194.0-255,1484,96055,8,273653
40005,0.001481,172.31.36.0-255,66,96121,8,273653
40006,0.001501,172.217.194.0-255,2902,99023,8,273653
40007,0.001504,172.31.36.0-255,66,99089,8,273653
40008,0.001526,172.217.194.0-255,4320,103409,8,273653
40009,0.001528,172.31.36.0-255,66,103475,8,273653
40010,0.001548,172.31.36.0-255,66,103541,8,273653
40011,0.001582,172.217.194.0-255,4320,107861,8,273653
40012,0.001585,172.31.36.0-255,66,107927,8,273653
40013,0.001616,172.31.36.0-255,66,107993,8,273653
40014,0.00162,172.217.194.0-255,2184,110177,8,273653
40015,0.001623,172.31.36.0-255,66,110243,8,273653
40016,0.001644,172.217.194.0-255,2902,113145,8,273653
40017,0.001646,172.31.36.0-255,66,113211,8,273653
40018,0.001668,172.217.194.0-255,7156,120367,8,273653
40019,0.001671,172.31.36.0-255,66,120433,8,273653
40020,0.001699,172.217.194.0-255,7156,127589,8,273653
40021,0.001702,172.31.36.0-255,66,127655,8,273653
40022,0.001714,172.31.36.0-255,66,127721,8,273653
40023,0.001736,172.217.194.0-255,7156,134877,8,273653
40024,0.001739,172.31.36.0-255,66,134943,8,273653
40025,0.001741,172.217.194.0-255,766,135709,8,273653
40026,0.001783,172.217.194.0-255,7156,142865,8,273653
40027,0.001787,172.31.36.0-255,66,142931,8,273653
40028,0.00181,172.217.194.0-255,2902,145833,8,273653
40029,0.001812,172.31.36.0-255,66,145899,8,273653
40030,0.001831,172.31.36.0-255,66,145965,8,273653
40031,0.001845,172.31.36.0-255,66,146031,8,273653
40032,0.001864,172.217.194.0-255,766,146797,8,273653
40033,0.00187,172.217.194.0-255,2902,149699,8,273653
40034,0.001872,172.31.36.0-255,66,149765,8,273653
40035,0.001902,172.31.36.0-255,66,149831,8,273653
40036,0.001945,172.217.194.0-255,7156,156987,8,273653
40037,0.001948,172.31.36.0-255,66,157053,8,273653
40038,0.001976,172.217.194.0-255,2902,159955,8,273653
40039,0.00198,172.31.36.0-255,66,160021,8,273653
40040,0.001992,172.31.36.0-255,66,160087,8,273653
40041,0.003973,172.217.194.0-255,5738,165825,8,273653
40042,0.003981,172.31.36.0-255,66,165891,8,273653
40043,0.005926,172.217.194.0-255,5738,171629,8,273653
40044,0.005934,172.31.36.0-255,66,171695,8,273653
40045,0.007883,172.217.194.0-255,5738,177433,8,273653
40046,0.007887,172.31.36.0-255,66,177499,8,273653
40047,0.009875,172.217.194.0-255,5738,183237,8,273653
40048,0.009881,172.31.36.0-255,66,183303,8,273653
40049,0.011855,172.217.194.0-255,5738,189041,8,273653
40050,0.011863,172.31.36.0-255,66,189107,8,273653
40051,0.013838,172.217.194.0-255,5738,194845,8,273653
40052,0.013848,172.31.36.0-255,66,194911,8,273653
40053,0.015811,172.217.194.0-255,5738,200649,8,273653
40054,0.015819,172.31.36.0-255,66,200715,8,273653
40055,0.017779,172.217.194.0-255,5738,206453,8,273653
40056,0.01779,172.31.36.0-255,66,206519,8,273653
40057,0.019772,172.217.194.0-255,5738,212257,8,273653
40058,0.019781,172.31.36.0-255,66,212323,8,273653
40059,0.021763,172.217.194.0-255,5738,218061,8,273653
40060,0.021771,172.31.36.0-255,66,218127,8,273653
40061,0.023719,172.217.194.0-255,5738,223865,8,273653
40062,0.023726,172.31.36.0-255,66,223931,8,273653
40063,0.025703,172.217.194.0-255,5738,229669,8,273653
40064,0.025711,172.31.36.0-255,66,229735,8,273653
40065,0.027711,172.217.194.0-255,5738,235473,8,273653
40066,0.027719,172.31.36.0-255,66,235539,8,273653
40067,0.02967,172.217.194.0-255,5738,241277,8,273653
40068,0.029681,172.31.36.0-255,66,241343,8,273653
40069,0.031628,172.217.194.0-255,5738,247081,8,273653
40070,0.031635,172.31.36.0-255,66,247147,8,273653
40071,0.032714,172.31.36.0-255,176,247323,8,273653
40072,0.032747,172.31.36.0-255,1111,248434,8,273653
40073,0.032807,172.31.36.0-255,1514,249948,8,273653
40074,0.032809,172.31.36.0-255,754,250702,8,273653
40075,0.033578,172.217.194.0-255,5738,256440,8,273653
40076,0.033586,172.31.36.0-255,66,256506,8,273653
40077,0.034249,104.244.42.0-255,66,256572,8,273653
40078,0.034289,104.244.42.0-255,66,256638,8,273653
40079,0.034359,104.244.42.0-255,66,256704,8,273653
40080,0.035551,172.217.194.0-255,2902,259606,8,273653
40081,0.035556,172.31.36.0-255,66,259672,8,273653
40082,0.035577,172.217.194.0-255,2902,262574,8,273653
40083,0.03558,172.31.36.0-255,66,262640,8,273653
40084,0.037522,172.217.194.0-255,5738,268378,8,273653
40085,0.037529,172.31.36.0-255,66,268444,8,273653
40086,0.039497,172.217.194.0-255,4972,273416,8,273653
40087,0.039503,172.31.36.0-255,66,273482,8,273653
40088,0.039692,172.31.36.0-255,105,273587,8,273653
40089,0.041586,172.217.194.0-255,66,273653,8,273653
40090,0.0,74.125.24.0-255,153,153,8,348775
40091,2.7e-05,172.31.36.0-255,66,219,8,348775
40092,3.4e-05,74.125.24.0-255,1484,1703,8,348775
40093,3.9e-05,172.31.36.0-255,66,1769,8,348775
40094,4.4e-05,74.125.24.0-255,2902,4671,8,348775
40095,4.6e-05,172.31.36.0-255,66,4737,8,348775
40096,5e-05,74.125.24.0-255,1484,6221,8,348775
40097,5.4e-05,172.31.36.0-255,66,6287,8,348775
40098,7.5e-05,74.125.24.0-255,1484,7771,8,348775
40099,7.8e-05,172.31.36.0-255,66,7837,8,348775
40100,0.000127,74.125.24.0-255,6331,14168,8,348775
40101,0.000131,172.31.36.0-255,66,14234,8,348775
40102,0.0003,74.125.24.0-255,1484,15718,8,348775
40103,0.000304,172.31.36.0-255,66,15784,8,348775
40104,0.000309,74.125.24.0-255,1484,17268,8,348775
40105,0.000312,172.31.36.0-255,66,17334,8,348775
40106,0.000327,74.125.24.0-255,1484,18818,8,348775
40107,0.000329,172.31.36.0-255,66,18884,8,348775
40108,0.000336,74.125.24.0-255,5738,24622,8,348775
40109,0.000339,172.31.36.0-255,66,24688,8,348775
40110,0.000365,74.125.24.0-255,5738,30426,8,348775
40111,0.00037,172.31.36.0-255,66,30492,8,348775
40112,0.000391,74.125.24.0-255,1125,31617,8,348775
40113,0.000395,172.31.36.0-255,66,31683,8,348775
40114,0.0004,74.125.24.0-255,7156,38839,8,348775
40115,0.000404,172.31.36.0-255,66,38905,8,348775
40116,0.00041,74.125.24.0-255,5738,44643,8,348775
40117,0.000412,172.31.36.0-255,66,44709,8,348775
40118,0.00045,172.31.36.0-255,66,44775,8,348775
40119,0.000459,74.125.24.0-255,7156,51931,8,348775
40120,0.000461,172.31.36.0-255,66,51997,8,348775
40121,0.000477,74.125.24.0-255,3602,55599,8,348775
40122,0.000481,172.31.36.0-255,66,55665,8,348775
40123,0.000499,74.125.24.0-255,365,56030,8,348775
40124,0.000606,74.125.24.0-255,132,56162,8,348775
40125,0.000645,74.125.24.0-255,1484,57646,8,348775
40126,0.000648,172.31.36.0-255,66,57712,8,348775
40127,0.000652,74.125.24.0-255,1484,59196,8,348775
40128,0.000669,74.125.24.0-255,1484,60680,8,348775
40129,0.000672,172.31.36.0-255,66,60746,8,348775
40130,0.000676,74.125.24.0-255,2902,63648,8,348775
40131,0.000679,172.31.36.0-255,66,63714,8,348775
40132,0.000702,74.125.24.0-255,5738,69452,8,348775
40133,0.000706,172.31.36.0-255,66,69518,8,348775
40134,0.000733,74.125.24.0-255,1484,71002,8,348775
40135,0.000745,172.31.36.0-255,66,71068,8,348775
40136,0.000788,74.125.24.0-255,4320,75388,8,348775
40137,0.000791,172.31.36.0-255,66,75454,8,348775
40138,0.000812,74.125.24.0-255,4717,80171,8,348775
40139,0.000815,172.31.36.0-255,66,80237,8,348775
40140,0.001105,74.125.24.0-255,1484,81721,8,348775
40141,0.001125,74.125.24.0-255,2902,84623,8,348775
40142,0.001129,172.31.36.0-255,66,84689,8,348775
40143,0.001134,74.125.24.0-255,2902,87591,8,348775
40144,0.001135,172.31.36.0-255,66,87657,8,348775
40145,0.001149,74.125.24.0-255,2902,90559,8,348775
40146,0.001152,172.31.36.0-255,66,90625,8,348775
40147,0.001187,172.31.36.0-255,66,90691,8,348775
40148,0.001193,74.125.24.0-255,4320,95011,8,348775
40149,0.001195,172.31.36.0-255,66,95077,8,348775
40150,0.001231,74.125.24.0-255,6438,101515,8,348775
40151,0.001234,172.31.36.0-255,66,101581,8,348775
40152,0.001542,74.125.24.0-255,1484,103065,8,348775
40153,0.001553,74.125.24.0-255,2902,105967,8,348775
40154,0.001557,172.31.36.0-255,66,106033,8,348775
40155,0.001564,74.125.24.0-255,5738,111771,8,348775
40156,0.001566,172.31.36.0-255,66,111837,8,348775
40157,0.001608,172.31.36.0-255,66,111903,8,348775
40158,0.00165,74.125.24.0-255,5738,117641,8,348775
40159,0.001654,172.31.36.0-255,66,117707,8,348775
40160,0.001678,74.125.24.0-255,6438,124145,8,348775
40161,0.001681,172.31.36.0-255,66,124211,8,348775
40162,0.00191,74.125.24.0-255,1484,125695,8,348775
40163,0.001918,74.125.24.0-255,2902,128597,8,348775
40164,0.001922,172.31.36.0-255,66,128663,8,348775
40165,0.001929,74.125.24.0-255,5738,134401,8,348775
40166,0.001931,172.31.36.0-255,66,134467,8,348775
40167,0.001936,74.125.24.0-255,4320,138787,8,348775
40168,0.001938,172.31.36.0-255,66,138853,8,348775
40169,0.001955,74.125.24.0-255,4320,143173,8,348775
40170,0.001957,172.31.36.0-255,66,143239,8,348775
40171,0.001988,74.125.24.0-255,7156,150395,8,348775
40172,0.001991,172.31.36.0-255,66,150461,8,348775
40173,0.002028,74.125.24.0-255,1484,151945,8,348775
40174,0.002047,74.125.24.0-255,6438,158383,8,348775
40175,0.00205,172.31.36.0-255,66,158449,8,348775
40176,0.002216,74.125.24.0-255,1484,159933,8,348775
40177,0.002222,74.125.24.0-255,2902,162835,8,348775
40178,0.002226,172.31.36.0-255,66,162901,8,348775
40179,0.002247,74.125.24.0-255,2902,165803,8,348775
40180,0.002249,172.31.36.0-255,66,165869,8,348775
40181,0.002254,74.125.24.0-255,4320,170189,8,348775
40182,0.002256,172.31.36.0-255,66,170255,8,348775
40183,0.002272,74.125.24.0-255,2902,173157,8,348775
40184,0.002274,172.31.36.0-255,66,173223,8,348775
40185,0.00229,74.125.24.0-255,1484,174707,8,348775
40186,0.002324,172.31.36.0-255,66,174773,8,348775
40187,0.002349,74.125.24.0-255,5020,179793,8,348775
40188,0.002352,172.31.36.0-255,66,179859,8,348775
40189,0.004631,74.125.24.0-255,5738,185597,8,348775
40190,0.004636,172.31.36.0-255,66,185663,8,348775
40191,0.00693,74.125.24.0-255,5738,191401,8,348775
40192,0.006937,172.31.36.0-255,66,191467,8,348775
40193,0.009238,74.125.24.0-255,5738,197205,8,348775
40194,0.009247,172.31.36.0-255,66,197271,8,348775
40195,0.01155,74.125.24.0-255,5738,203009,8,348775
40196,0.011558,172.31.36.0-255,66,203075,8,348775
40197,0.013875,74.125.24.0-255,5738,208813,8,348775
40198,0.013888,172.31.36.0-255,66,208879,8,348775
40199,0.016188,74.125.24.0-255,5738,214617,8,348775
40200,0.016196,172.31.36.0-255,66,214683,8,348775
40201,0.018484,74.125.24.0-255,5738,220421,8,348775
40202,0.018492,172.31.36.0-255,66,220487,8,348775
40203,0.020797,74.125.24.0-255,5738,226225,8,348775
40204,0.02081,172.31.36.0-255,66,226291,8,348775
40205,0.023115,74.125.24.0-255,5738,232029,8,348775
40206,0.023128,172.31.36.0-255,66,232095,8,348775
40207,0.025435,74.125.24.0-255,5738,237833,8,348775
40208,0.025452,172.31.36.0-255,66,237899,8,348775
40209,0.027766,74.125.24.0-255,5738,243637,8,348775
40210,0.027775,172.31.36.0-255,66,243703,8,348775
40211,0.030071,74.125.24.0-255,5738,249441,8,348775
40212,0.030078,172.31.36.0-255,66,249507,8,348775
40213,0.030678,172.31.36.0-255,172,249679,8,348775
40214,0.03072,172.31.36.0-255,1110,250789,8,348775
40215,0.030796,172.31.36.0-255,1428,252217,8,348775
40216,0.032218,104.244.42.0-255,66,252283,8,348775
40217,0.032251,104.244.42.0-255,66,252349,8,348775
40218,0.032363,104.244.42.0-255,66,252415,8,348775
40219,0.032379,74.125.24.0-255,4320,256735,8,348775
40220,0.032383,172.31.36.0-255,66,256801,8,348775
40221,0.032413,74.125.24.0-255,1484,258285,8,348775
40222,0.034654,74.125.24.0-255,4320,262605,8,348775
40223,0.034659,172.31.36.0-255,66,262671,8,348775
40224,0.036952,74.125.24.0-255,5738,268409,8,348775
40225,0.036957,172.31.36.0-255,66,268475,8,348775
40226,0.039252,74.125.24.0-255,5738,274213,8,348775
40227,0.039261,172.31.36.0-255,66,274279,8,348775
40228,0.041588,74.125.24.0-255,5738,280017,8,348775
40229,0.041598,172.31.36.0-255,66,280083,8,348775
40230,0.043941,74.125.24.0-255,5738,285821,8,348775
40231,0.043955,172.31.36.0-255,66,285887,8,348775
40232,0.046269,74.125.24.0-255,5738,291625,8,348775
40233,0.046275,172.31.36.0-255,66,291691,8,348775
40234,0.048539,74.125.24.0-255,4320,296011,8,348775
40235,0.048545,172.31.36.0-255,66,296077,8,348775
40236,0.048576,74.125.24.0-255,1484,297561,8,348775
40237,0.050835,74.125.24.0-255,4320,301881,8,348775
40238,0.05084,172.31.36.0-255,66,301947,8,348775
40239,0.053136,74.125.24.0-255,5738,307685,8,348775
40240,0.053143,172.31.36.0-255,66,307751,8,348775
40241,0.055441,74.125.24.0-255,5738,313489,8,348775
40242,0.055446,172.31.36.0-255,66,313555,8,348775
40243,0.057748,74.125.24.0-255,2902,316457,8,348775
40244,0.057754,172.31.36.0-255,66,316523,8,348775
40245,0.057798,74.125.24.0-255,2902,319425,8,348775
40246,0.057801,172.31.36.0-255,66,319491,8,348775
40247,0.060063,74.125.24.0-255,2902,322393,8,348775
40248,0.060069,172.31.36.0-255,66,322459,8,348775
40249,0.060138,74.125.24.0-255,2902,325361,8,348775
40250,0.060142,172.31.36.0-255,66,325427,8,348775
40251,0.06237,74.125.24.0-255,2902,328329,8,348775
40252,0.062375,172.31.36.0-255,66,328395,8,348775
40253,0.062409,74.125.24.0-255,2902,331297,8,348775
40254,0.062413,172.31.36.0-255,66,331363,8,348775
40255,0.064706,74.125.24.0-255,5738,337101,8,348775
40256,0.064711,172.31.36.0-255,66,337167,8,348775
40257,0.066999,74.125.24.0-255,5738,342905,8,348775
40258,0.067005,172.31.36.0-255,66,342971,8,348775
40259,0.069292,74.125.24.0-255,5738,348709,8,348775
40260,0.069297,172.31.36.0-255,66,348775,8,348775
40261,0.0,172.217.194.0-255,291,291,8,276440
40262,1.6e-05,172.31.36.0-255,66,357,8,276440
40263,5.1e-05,172.217.194.0-255,1484,1841,8,276440
40264,5.7e-05,172.31.36.0-255,66,1907,8,276440
40265,6.4e-05,172.217.194.0-255,4320,6227,8,276440
40266,6.7e-05,172.31.36.0-255,66,6293,8,276440
40267,0.0001,172.217.194.0-255,4320,10613,8,276440
40268,0.000102,172.31.36.0-255,66,10679,8,276440
40269,0.000137,172.217.194.0-255,3257,13936,8,276440
40270,0.000141,172.31.36.0-255,66,14002,8,276440
40271,0.000152,172.31.36.0-255,66,14068,8,276440
40272,0.000164,172.31.36.0-255,66,14134,8,276440
40273,0.000561,172.217.194.0-255,1484,15618,8,276440
40274,0.000567,172.217.194.0-255,2902,18520,8,276440
40275,0.000573,172.31.36.0-255,66,18586,8,276440
40276,0.000583,172.31.36.0-255,66,18652,8,276440
40277,0.000591,172.217.194.0-255,1484,20136,8,276440
40278,0.000593,172.31.36.0-255,66,20202,8,276440
40279,0.000624,172.217.194.0-255,4320,24522,8,276440
40280,0.000627,172.31.36.0-255,66,24588,8,276440
40281,0.000631,172.217.194.0-255,1484,26072,8,276440
40282,0.000633,172.31.36.0-255,66,26138,8,276440
40283,0.000674,172.31.36.0-255,66,26204,8,276440
40284,0.000687,172.31.36.0-255,66,26270,8,276440
40285,0.000691,172.217.194.0-255,2184,28454,8,276440
40286,0.000696,172.31.36.0-255,66,28520,8,276440
40287,0.000821,172.217.194.0-255,346,28866,8,276440
40288,0.000825,172.31.36.0-255,66,28932,8,276440
40289,0.000851,172.217.194.0-255,116,29048,8,276440
40290,0.001014,172.217.194.0-255,1484,30532,8,276440
40291,0.001018,172.31.36.0-255,66,30598,8,276440
40292,0.001024,172.217.194.0-255,2902,33500,8,276440
40293,0.001027,172.31.36.0-255,66,33566,8,276440
40294,0.001048,172.217.194.0-255,5738,39304,8,276440
40295,0.00105,172.31.36.0-255,66,39370,8,276440
40296,0.001085,172.31.36.0-255,66,39436,8,276440
40297,0.001092,172.217.194.0-255,5738,45174,8,276440
40298,0.001094,172.31.36.0-255,66,45240,8,276440
40299,0.00112,172.217.194.0-255,1484,46724,8,276440
40300,0.001136,172.217.194.0-255,2902,49626,8,276440
40301,0.001138,172.31.36.0-255,66,49692,8,276440
40302,0.001173,172.31.36.0-255,66,49758,8,276440
40303,0.001187,172.31.36.0-255,66,49824,8,276440
40304,0.001213,172.217.194.0-255,1484,51308,8,276440
40305,0.001228,172.31.36.0-255,66,51374,8,276440
40306,0.00127,172.217.194.0-255,1484,52858,8,276440
40307,0.001293,172.217.194.0-255,2902,55760,8,276440
40308,0.001297,172.31.36.0-255,66,55826,8,276440
40309,0.001342,172.217.194.0-255,5738,61564,8,276440
40310,0.001346,172.31.36.0-255,66,61630,8,276440
40311,0.001377,172.217.194.0-255,1484,63114,8,276440
40312,0.001401,172.31.36.0-255,66,63180,8,276440
40313,0.001986,172.217.194.0-255,1484,64664,8,276440
40314,0.001993,172.217.194.0-255,2902,67566,8,276440
40315,0.001997,172.31.36.0-255,66,67632,8,276440
40316,0.002001,172.217.194.0-255,1484,69116,8,276440
40317,0.002028,172.217.194.0-255,4320,73436,8,276440
40318,0.002031,172.31.36.0-255,66,73502,8,276440
40319,0.002036,172.217.194.0-255,2902,76404,8,276440
40320,0.002038,172.31.36.0-255,66,76470,8,276440
40321,0.002083,172.31.36.0-255,66,76536,8,276440
40322,0.002095,172.31.36.0-255,66,76602,8,276440
40323,0.002098,172.217.194.0-255,766,77368,8,276440
40324,0.002662,172.31.36.0-255,66,77434,8,276440
40325,0.004139,172.217.194.0-255,4320,81754,8,276440
40326,0.004151,172.31.36.0-255,66,81820,8,276440
40327,0.004699,172.217.194.0-255,1484,83304,8,276440
40328,0.006195,172.217.194.0-255,4320,87624,8,276440
40329,0.006206,172.31.36.0-255,66,87690,8,276440
40330,0.008264,172.217.194.0-255,5738,93428,8,276440
40331,0.008271,172.31.36.0-255,66,93494,8,276440
40332,0.010337,172.217.194.0-255,5738,99232,8,276440
40333,0.010341,172.31.36.0-255,66,99298,8,276440
40334,0.012387,172.217.194.0-255,5738,105036,8,276440
40335,0.012397,172.31.36.0-255,66,105102,8,276440
40336,0.014453,172.217.194.0-255,5738,110840,8,276440
40337,0.014465,172.31.36.0-255,66,110906,8,276440
40338,0.01652,172.217.194.0-255,5738,116644,8,276440
40339,0.016529,172.31.36.0-255,66,116710,8,276440
40340,0.018601,172.217.194.0-255,5738,122448,8,276440
40341,0.01861,172.31.36.0-255,66,122514,8,276440
40342,0.020656,172.217.194.0-255,5738,128252,8,276440
40343,0.020664,172.31.36.0-255,66,128318,8,276440
40344,0.022717,172.217.194.0-255,5738,134056,8,276440
40345,0.022726,172.31.36.0-255,66,134122,8,276440
40346,0.024765,172.217.194.0-255,5738,139860,8,276440
40347,0.024773,172.31.36.0-255,66,139926,8,276440
40348,0.026799,172.217.194.0-255,5738,145664,8,276440
40349,0.026807,172.31.36.0-255,66,145730,8,276440
40350,0.028849,172.217.194.0-255,5738,151468,8,276440
40351,0.028872,172.31.36.0-255,66,151534,8,276440
40352,0.030938,172.217.194.0-255,5738,157272,8,276440
40353,0.030951,172.31.36.0-255,66,157338,8,276440
40354,0.033027,172.217.194.0-255,5738,163076,8,276440
40355,0.033035,172.31.36.0-255,66,163142,8,276440
40356,0.035082,172.217.194.0-255,5738,168880,8,276440
40357,0.035091,172.31.36.0-255,66,168946,8,276440
40358,0.035791,172.31.36.0-255,172,169118,8,276440
40359,0.035825,172.31.36.0-255,1110,170228,8,276440
40360,0.035894,172.31.36.0-255,1514,171742,8,276440
40361,0.035917,172.31.36.0-255,1514,173256,8,276440
40362,0.035921,172.31.36.0-255,1514,174770,8,276440
40363,0.035938,172.31.36.0-255,1514,176284,8,276440
40364,0.035947,172.31.36.0-255,1514,177798,8,276440
40365,0.035948,172.31.36.0-255,996,178794,8,276440
40366,0.037153,172.217.194.0-255,5738,184532,8,276440
40367,0.037162,172.31.36.0-255,66,184598,8,276440
40368,0.037344,104.244.42.0-255,66,184664,8,276440
40369,0.037388,104.244.42.0-255,66,184730,8,276440
40370,0.037469,104.244.42.0-255,66,184796,8,276440
40371,0.037474,104.244.42.0-255,66,184862,8,276440
40372,0.037513,104.244.42.0-255,66,184928,8,276440
40373,0.039228,172.217.194.0-255,5738,190666,8,276440
40374,0.039237,172.31.36.0-255,66,190732,8,276440
40375,0.041282,172.217.194.0-255,5738,196470,8,276440
40376,0.04129,172.31.36.0-255,66,196536,8,276440
40377,0.043331,172.217.194.0-255,5738,202274,8,276440
40378,0.043344,172.31.36.0-255,66,202340,8,276440
40379,0.045392,172.217.194.0-255,5738,208078,8,276440
40380,0.045402,172.31.36.0-255,66,208144,8,276440
40381,0.047434,172.217.194.0-255,5738,213882,8,276440
40382,0.047444,172.31.36.0-255,66,213948,8,276440
40383,0.049472,172.217.194.0-255,5738,219686,8,276440
40384,0.049484,172.31.36.0-255,66,219752,8,276440
40385,0.051539,172.217.194.0-255,5738,225490,8,276440
40386,0.051545,172.31.36.0-255,66,225556,8,276440
40387,0.053556,172.217.194.0-255,5738,231294,8,276440
40388,0.053564,172.31.36.0-255,66,231360,8,276440
40389,0.055623,172.217.194.0-255,4320,235680,8,276440
40390,0.055632,172.31.36.0-255,66,235746,8,276440
40391,0.055659,172.217.194.0-255,1484,237230,8,276440
40392,0.057654,172.217.194.0-255,4320,241550,8,276440
40393,0.057659,172.31.36.0-255,66,241616,8,276440
40394,0.059705,172.217.194.0-255,5738,247354,8,276440
40395,0.059714,172.31.36.0-255,66,247420,8,276440
40396,0.061752,172.217.194.0-255,5738,253158,8,276440
40397,0.061763,172.31.36.0-255,66,253224,8,276440
40398,0.063809,172.217.194.0-255,5738,258962,8,276440
40399,0.063817,172.31.36.0-255,66,259028,8,276440
40400,0.065849,172.217.194.0-255,5738,264766,8,276440
40401,0.065856,172.31.36.0-255,66,264832,8,276440
40402,0.067925,172.217.194.0-255,5738,270570,8,276440
40403,0.067932,172.31.36.0-255,66,270636,8,276440
40404,0.069974,172.217.194.0-255,5738,276374,8,276440
40405,0.069982,172.31.36.0-255,66,276440,8,276440
40406,0.0,74.125.200.0-255,150,150,8,301508
40407,2.3e-05,172.31.36.0-255,66,216,8,301508
40408,3.1e-05,74.125.200.0-255,1484,1700,8,301508
40409,3.5e-05,172.31.36.0-255,66,1766,8,301508
40410,5.9e-05,74.125.200.0-255,2902,4668,8,301508
40411,6.2e-05,172.31.36.0-255,66,4734,8,301508
40412,8.7e-05,74.125.200.0-255,4320,9054,8,301508
40413,9e-05,172.31.36.0-255,66,9120,8,301508
40414,9.3e-05,74.125.200.0-255,1484,10604,8,301508
40415,9.5e-05,172.31.36.0-255,66,10670,8,301508
40416,0.000113,74.125.200.0-255,3421,14091,8,301508
40417,0.000116,172.31.36.0-255,66,14157,8,301508
40418,0.000181,74.125.200.0-255,1484,15641,8,301508
40419,0.000185,172.31.36.0-255,66,15707,8,301508
40420,0.000206,74.125.200.0-255,2902,18609,8,301508
40421,0.00021,172.31.36.0-255,66,18675,8,301508
40422,0.000215,74.125.200.0-255,4320,22995,8,301508
40423,0.000218,172.31.36.0-255,66,23061,8,301508
40424,0.000241,74.125.200.0-255,2902,25963,8,301508
40425,0.000245,172.31.36.0-255,66,26029,8,301508
40426,0.000272,74.125.200.0-255,6797,32826,8,301508
40427,0.000275,172.31.36.0-255,66,32892,8,301508
40428,0.00028,74.125.200.0-255,2902,35794,8,301508
40429,0.000281,172.31.36.0-255,66,35860,8,301508
40430,0.000285,74.125.200.0-255,2902,38762,8,301508
40431,0.000288,172.31.36.0-255,66,38828,8,301508
40432,0.000315,172.31.36.0-255,66,38894,8,301508
40433,0.000321,74.125.200.0-255,7156,46050,8,301508
40434,0.000324,172.31.36.0-255,66,46116,8,301508
40435,0.000367,74.125.200.0-255,7156,53272,8,301508
40436,0.000371,172.31.36.0-255,66,53338,8,301508
40437,0.000388,74.125.200.0-255,766,54104,8,301508
40438,0.00071,74.125.200.0-255,412,54516,8,301508
40439,0.000946,74.125.200.0-255,1484,56000,8,301508
40440,0.000951,172.31.36.0-255,66,56066,8,301508
40441,0.000955,74.125.200.0-255,1484,57550,8,301508
40442,0.000972,74.125.200.0-255,2902,60452,8,301508
40443,0.000974,172.31.36.0-255,66,60518,8,301508
40444,0.000977,74.125.200.0-255,1484,62002,8,301508
40445,0.000998,74.125.200.0-255,4320,66322,8,301508
40446,0.001,172.31.36.0-255,66,66388,8,301508
40447,0.001006,74.125.200.0-255,4320,70708,8,301508
40448,0.001007,172.31.36.0-255,66,70774,8,301508
40449,0.001032,172.31.36.0-255,66,70840,8,301508
40450,0.00106,74.125.200.0-255,2902,73742,8,301508
40451,0.001065,172.31.36.0-255,66,73808,8,301508
40452,0.001087,74.125.200.0-255,6438,80246,8,301508
40453,0.001091,172.31.36.0-255,66,80312,8,301508
40454,0.001094,74.125.200.0-255,332,80644,8,301508
40455,0.001268,74.125.200.0-255,1484,82128,8,301508
40456,0.001274,172.31.36.0-255,66,82194,8,301508
40457,0.001285,74.125.200.0-255,1484,83678,8,301508
40458,0.001301,74.125.200.0-255,1484,85162,8,301508
40459,0.001304,172.31.36.0-255,66,85228,8,301508
40460,0.001322,74.125.200.0-255,5738,90966,8,301508
40461,0.001324,172.31.36.0-255,66,91032,8,301508
40462,0.001327,74.125.200.0-255,1484,92516,8,301508
40463,0.001332,74.125.200.0-255,2902,95418,8,301508
40464,0.001333,172.31.36.0-255,66,95484,8,301508
40465,0.001361,74.125.200.0-255,4320,99804,8,301508
40466,0.001364,172.31.36.0-255,66,99870,8,301508
40467,0.001381,74.125.200.0-255,1484,101354,8,301508
40468,0.001386,74.125.200.0-255,2902,104256,8,301508
40469,0.001388,172.31.36.0-255,66,104322,8,301508
40470,0.001394,74.125.200.0-255,4320,108642,8,301508
40471,0.001396,172.31.36.0-255,66,108708,8,301508
40472,0.001431,74.125.200.0-255,2902,111610,8,301508
40473,0.001434,172.31.36.0-255,66,111676,8,301508
40474,0.001465,74.125.200.0-255,3602,115278,8,301508
40475,0.001468,172.31.36.0-255,66,115344,8,301508
40476,0.001999,74.125.200.0-255,1484,116828,8,301508
40477,0.002005,74.125.200.0-255,1484,118312,8,301508
40478,0.002009,172.31.36.0-255,66,118378,8,301508
40479,0.002029,74.125.200.0-255,1484,119862,8,301508
40480,0.002032,74.125.200.0-255,1484,121346,8,301508
40481,0.002034,172.31.36.0-255,66,121412,8,301508
40482,0.002038,74.125.200.0-255,2902,124314,8,301508
40483,0.00204,172.31.36.0-255,66,124380,8,301508
40484,0.004049,74.125.200.0-255,5738,130118,8,301508
40485,0.004056,172.31.36.0-255,66,130184,8,301508
40486,0.006072,74.125.200.0-255,4320,134504,8,301508
40487,0.006076,172.31.36.0-255,66,134570,8,301508
40488,0.006094,74.125.200.0-255,1484,136054,8,301508
40489,0.008087,74.125.200.0-255,4320,140374,8,301508
40490,0.008093,172.31.36.0-255,66,140440,8,301508
40491,0.010143,74.125.200.0-255,4320,144760,8,301508
40492,0.010151,172.31.36.0-255,66,144826,8,301508
40493,0.010172,74.125.200.0-255,1484,146310,8,301508
40494,0.012164,74.125.200.0-255,4320,150630,8,301508
40495,0.012171,172.31.36.0-255,66,150696,8,301508
40496,0.014482,74.125.200.0-255,5738,156434,8,301508
40497,0.014492,172.31.36.0-255,66,156500,8,301508
40498,0.016917,74.125.200.0-255,4320,160820,8,301508
40499,0.016928,172.31.36.0-255,66,160886,8,301508
40500,0.016947,74.125.200.0-255,1484,162370,8,301508
40501,0.019534,74.125.200.0-255,4320,166690,8,301508
40502,0.019545,172.31.36.0-255,66,166756,8,301508
40503,0.022473,74.125.200.0-255,5738,172494,8,301508
40504,0.022486,172.31.36.0-255,66,172560,8,301508
40505,0.025486,74.125.200.0-255,5738,178298,8,301508
40506,0.025496,172.31.36.0-255,66,178364,8,301508
40507,0.027311,172.31.36.0-255,172,178536,8,301508
40508,0.027352,172.31.36.0-255,1110,179646,8,301508
40509,0.027389,172.31.36.0-255,1514,181160,8,301508
40510,0.027391,172.31.36.0-255,1514,182674,8,301508
40511,0.027396,172.31.36.0-255,1514,184188,8,301508
40512,0.027397,172.31.36.0-255,1514,185702,8,301508
40513,0.027414,172.31.36.0-255,1514,187216,8,301508
40514,0.027415,172.31.36.0-255,996,188212,8,301508
40515,0.028318,74.125.200.0-255,5738,193950,8,301508
40516,0.028325,172.31.36.0-255,66,194016,8,301508
40517,0.028994,104.244.42.0-255,66,194082,8,301508
40518,0.029002,104.244.42.0-255,66,194148,8,301508
40519,0.02902,104.244.42.0-255,66,194214,8,301508
40520,0.029025,104.244.42.0-255,66,194280,8,301508
40521,0.030899,104.244.42.0-255,108,194388,8,301508
40522,0.030911,172.31.36.0-255,66,194454,8,301508
40523,0.031147,74.125.200.0-255,4320,198774,8,301508
40524,0.031152,172.31.36.0-255,66,198840,8,301508
40525,0.031171,74.125.200.0-255,1484,200324,8,301508
40526,0.033522,74.125.200.0-255,4320,204644,8,301508
40527,0.033534,172.31.36.0-255,66,204710,8,301508
40528,0.035556,74.125.200.0-255,5738,210448,8,301508
40529,0.035564,172.31.36.0-255,66,210514,8,301508
40530,0.037585,74.125.200.0-255,4320,214834,8,301508
40531,0.037592,172.31.36.0-255,66,214900,8,301508
40532,0.037611,74.125.200.0-255,1484,216384,8,301508
40533,0.037742,172.31.36.0-255,108,216492,8,301508
40534,0.039604,74.125.200.0-255,4320,220812,8,301508
40535,0.039611,172.31.36.0-255,66,220878,8,301508
40536,0.041731,74.125.200.0-255,4320,225198,8,301508
40537,0.041738,172.31.36.0-255,66,225264,8,301508
40538,0.041759,74.125.200.0-255,1484,226748,8,301508
40539,0.044015,74.125.200.0-255,4320,231068,8,301508
40540,0.044023,172.31.36.0-255,66,231134,8,301508
40541,0.046049,74.125.200.0-255,5738,236872,8,301508
40542,0.046058,172.31.36.0-255,66,236938,8,301508
40543,0.048071,74.125.200.0-255,5738,242676,8,301508
40544,0.048084,172.31.36.0-255,66,242742,8,301508
40545,0.050103,74.125.200.0-255,5738,248480,8,301508
40546,0.050111,172.31.36.0-255,66,248546,8,301508
40547,0.052148,74.125.200.0-255,1484,250030,8,301508
40548,0.052166,74.125.200.0-255,1484,251514,8,301508
40549,0.05217,172.31.36.0-255,66,251580,8,301508
40550,0.052194,74.125.200.0-255,2902,254482,8,301508
40551,0.052197,172.31.36.0-255,66,254548,8,301508
40552,0.054193,74.125.200.0-255,2902,257450,8,301508
40553,0.0542,172.31.36.0-255,66,257516,8,301508
40554,0.054221,74.125.200.0-255,2902,260418,8,301508
40555,0.054224,172.31.36.0-255,66,260484,8,301508
40556,0.056211,74.125.200.0-255,2902,263386,8,301508
40557,0.056217,172.31.36.0-255,66,263452,8,301508
40558,0.056239,74.125.200.0-255,2902,266354,8,301508
40559,0.056242,172.31.36.0-255,66,266420,8,301508
40560,0.058226,74.125.200.0-255,2902,269322,8,301508
40561,0.058232,172.31.36.0-255,66,269388,8,301508
40562,0.058255,74.125.200.0-255,2902,272290,8,301508
40563,0.058258,172.31.36.0-255,66,272356,8,301508
40564,0.060267,74.125.200.0-255,2902,275258,8,301508
40565,0.060274,172.31.36.0-255,66,275324,8,301508
40566,0.060296,74.125.200.0-255,2902,278226,8,301508
40567,0.060298,172.31.36.0-255,66,278292,8,301508
40568,0.062308,74.125.200.0-255,5738,284030,8,301508
40569,0.062314,172.31.36.0-255,66,284096,8,301508
40570,0.064326,74.125.200.0-255,5738,289834,8,301508
40571,0.064333,172.31.36.0-255,66,289900,8,301508
40572,0.066431,74.125.200.0-255,5738,295638,8,301508
40573,0.066439,172.31.36.0-255,66,295704,8,301508
40574,0.068747,74.125.200.0-255,5738,301442,8,301508
40575,0.068753,172.31.36.0-255,66,301508,8,301508
40576,0.0,74.125.24.0-255,153,153,8,195612
40577,1.5e-05,172.31.36.0-255,66,219,8,195612
40578,2.3e-05,74.125.24.0-255,1484,1703,8,195612
40579,2.7e-05,172.31.36.0-255,66,1769,8,195612
40580,3.4e-05,74.125.24.0-255,2902,4671,8,195612
40581,4.5e-05,172.31.36.0-255,66,4737,8,195612
40582,5.3e-05,74.125.24.0-255,7156,11893,8,195612
40583,5.6e-05,172.31.36.0-255,66,11959,8,195612
40584,6e-05,74.125.24.0-255,1965,13924,8,195612
40585,6.3e-05,172.31.36.0-255,66,13990,8,195612
40586,0.000158,74.125.24.0-255,1484,15474,8,195612
40587,0.000162,172.31.36.0-255,66,15540,8,195612
40588,0.000167,74.125.24.0-255,2902,18442,8,195612
40589,0.00017,172.31.36.0-255,66,18508,8,195612
40590,0.0002,74.125.24.0-255,5738,24246,8,195612
40591,0.000202,172.31.36.0-255,66,24312,8,195612
40592,0.000207,74.125.24.0-255,2902,27214,8,195612
40593,0.000209,172.31.36.0-255,66,27280,8,195612
40594,0.000243,74.125.24.0-255,3961,31241,8,195612
40595,0.000246,172.31.36.0-255,66,31307,8,195612
40596,0.000545,74.125.24.0-255,1484,32791,8,195612
40597,0.000551,172.31.36.0-255,66,32857,8,195612
40598,0.000557,74.125.24.0-255,2902,35759,8,195612
40599,0.00056,172.31.36.0-255,66,35825,8,195612
40600,0.000571,74.125.24.0-255,5738,41563,8,195612
40601,0.000574,172.31.36.0-255,66,41629,8,195612
40602,0.000602,74.125.24.0-255,2902,44531,8,195612
40603,0.000605,172.31.36.0-255,66,44597,8,195612
40604,0.000649,172.31.36.0-255,66,44663,8,195612
40605,0.000665,172.31.36.0-255,66,44729,8,195612
40606,0.000668,74.125.24.0-255,678,45407,8,195612
40607,0.000937,74.125.24.0-255,1484,46891,8,195612
40608,0.000941,172.31.36.0-255,66,46957,8,195612
40609,0.000947,74.125.24.0-255,2902,49859,8,195612
40610,0.000949,172.31.36.0-255,66,49925,8,195612
40611,0.000961,74.125.24.0-255,4320,54245,8,195612
40612,0.000963,172.31.36.0-255,66,54311,8,195612
40613,0.000994,74.125.24.0-255,1484,55795,8,195612
40614,0.001001,74.125.24.0-255,5738,61533,8,195612
40615,0.001003,172.31.36.0-255,66,61599,8,195612
40616,0.001017,172.31.36.0-255,66,61665,8,195612
40617,0.001023,74.125.24.0-255,5020,66685,8,195612
40618,0.001026,172.31.36.0-255,66,66751,8,195612
40619,0.001147,74.125.24.0-255,1484,68235,8,195612
40620,0.001152,74.125.24.0-255,2902,71137,8,195612
40621,0.001156,172.31.36.0-255,66,71203,8,195612
40622,0.001187,74.125.24.0-255,5738,76941,8,195612
40623,0.00119,172.31.36.0-255,66,77007,8,195612
40624,0.001205,172.31.36.0-255,66,77073,8,195612
40625,0.001216,74.125.24.0-255,7156,84229,8,195612
40626,0.001219,172.31.36.0-255,66,84295,8,195612
40627,0.001247,74.125.24.0-255,1484,85779,8,195612
40628,0.001268,74.125.24.0-255,2184,87963,8,195612
40629,0.001271,172.31.36.0-255,66,88029,8,195612
40630,0.001298,74.125.24.0-255,4320,92349,8,195612
40631,0.001302,172.31.36.0-255,66,92415,8,195612
40632,0.001307,74.125.24.0-255,2902,95317,8,195612
40633,0.001309,172.31.36.0-255,66,95383,8,195612
40634,0.001313,74.125.24.0-255,2902,98285,8,195612
40635,0.001315,172.31.36.0-255,66,98351,8,195612
40636,0.001345,74.125.24.0-255,5738,104089,8,195612
40637,0.001348,172.31.36.0-255,66,104155,8,195612
40638,0.001369,172.31.36.0-255,66,104221,8,195612
40639,0.001398,172.31.36.0-255,66,104287,8,195612
40640,0.00143,74.125.24.0-255,1484,105771,8,195612
40641,0.001435,74.125.24.0-255,2902,108673,8,195612
40642,0.001438,172.31.36.0-255,66,108739,8,195612
40643,0.001445,74.125.24.0-255,5738,114477,8,195612
40644,0.001448,172.31.36.0-255,66,114543,8,195612
40645,0.001462,172.31.36.0-255,66,114609,8,195612
40646,0.001468,74.125.24.0-255,5738,120347,8,195612
40647,0.00147,172.31.36.0-255,66,120413,8,195612
40648,0.001516,74.125.24.0-255,5020,125433,8,195612
40649,0.001519,172.31.36.0-255,66,125499,8,195612
40650,0.001525,74.125.24.0-255,4320,129819,8,195612
40651,0.001527,172.31.36.0-255,66,129885,8,195612
40652,0.001559,74.125.24.0-255,1484,131369,8,195612
40653,0.001574,172.31.36.0-255,66,131435,8,195612
40654,0.001585,172.31.36.0-255,66,131501,8,195612
40655,0.001622,172.31.36.0-255,66,131567,8,195612
40656,0.00168,74.125.24.0-255,5020,136587,8,195612
40657,0.001727,172.31.36.0-255,66,136653,8,195612
40658,0.00173,172.31.36.0-255,66,136719,8,195612
40659,0.001734,172.31.36.0-255,66,136785,8,195612
40660,0.001756,74.125.24.0-255,5738,142523,8,195612
40661,0.001759,172.31.36.0-255,66,142589,8,195612
40662,0.001773,172.31.36.0-255,66,142655,8,195612
40663,0.001779,74.125.24.0-255,4320,146975,8,195612
40664,0.001782,172.31.36.0-255,66,147041,8,195612
40665,0.001794,172.31.36.0-255,66,147107,8,195612
40666,0.001797,74.125.24.0-255,1484,148591,8,195612
40667,0.001829,172.31.36.0-255,66,148657,8,195612
40668,0.001841,172.31.36.0-255,66,148723,8,195612
40669,0.001881,74.125.24.0-255,4320,153043,8,195612
40670,0.001883,172.31.36.0-255,66,153109,8,195612
40671,0.001916,74.125.24.0-255,6438,159547,8,195612
40672,0.001919,172.31.36.0-255,66,159613,8,195612
40673,0.002185,74.125.24.0-255,1484,161097,8,195612
40674,0.002192,74.125.24.0-255,2902,163999,8,195612
40675,0.002196,172.31.36.0-255,66,164065,8,195612
40676,0.0022,74.125.24.0-255,2902,166967,8,195612
40677,0.002202,172.31.36.0-255,66,167033,8,195612
40678,0.002227,74.125.24.0-255,2902,169935,8,195612
40679,0.002229,172.31.36.0-255,66,170001,8,195612
40680,0.002234,74.125.24.0-255,2902,172903,8,195612
40681,0.002236,172.31.36.0-255,66,172969,8,195612
40682,0.002292,74.125.24.0-255,7156,180125,8,195612
40683,0.002299,172.31.36.0-255,66,180191,8,195612
40684,0.002307,172.31.36.0-255,66,180257,8,195612
40685,0.002311,172.31.36.0-255,66,180323,8,195612
40686,0.002321,74.125.24.0-255,5738,186061,8,195612
40687,0.002324,172.31.36.0-255,66,186127,8,195612
40688,0.002384,172.31.36.0-255,66,186193,8,195612
40689,0.002394,172.31.36.0-255,66,186259,8,195612
40690,0.002397,74.125.24.0-255,97,186356,8,195612
40691,0.0024,74.125.24.0-255,105,186461,8,195612
40692,0.004707,172.31.36.0-255,66,186527,8,195612
40693,0.004745,172.31.36.0-255,105,186632,8,195612
40694,0.007223,74.125.24.0-255,66,186698,8,195612
40695,0.036022,172.31.36.0-255,188,186886,8,195612
40696,0.03606,172.31.36.0-255,955,187841,8,195612
40697,0.036114,172.31.36.0-255,1514,189355,8,195612
40698,0.036116,172.31.36.0-255,1514,190869,8,195612
40699,0.03612,172.31.36.0-255,1514,192383,8,195612
40700,0.036122,172.31.36.0-255,1514,193897,8,195612
40701,0.036148,172.31.36.0-255,1385,195282,8,195612
40702,0.037557,104.244.42.0-255,66,195348,8,195612
40703,0.037617,104.244.42.0-255,66,195414,8,195612
40704,0.037667,104.244.42.0-255,66,195480,8,195612
40705,0.037687,104.244.42.0-255,66,195546,8,195612
40706,0.037698,104.244.42.0-255,66,195612,8,195612
40707,0.0,172.217.194.0-255,152,152,8,217278
40708,3.2e-05,172.31.36.0-255,66,218,8,217278
40709,3.9e-05,172.217.194.0-255,1484,1702,8,217278
40710,4.3e-05,172.31.36.0-255,66,1768,8,217278
40711,5.5e-05,172.217.194.0-255,2902,4670,8,217278
40712,5.9e-05,172.31.36.0-255,66,4736,8,217278
40713,6.4e-05,172.217.194.0-255,4320,9056,8,217278
40714,6.7e-05,172.31.36.0-255,66,9122,8,217278
40715,0.000103,172.217.194.0-255,4783,13905,8,217278
40716,0.000106,172.31.36.0-255,66,13971,8,217278
40717,0.000293,172.217.194.0-255,1484,15455,8,217278
40718,0.000298,172.31.36.0-255,66,15521,8,217278
40719,0.000305,172.217.194.0-255,2902,18423,8,217278
40720,0.000307,172.31.36.0-255,66,18489,8,217278
40721,0.000346,172.217.194.0-255,5738,24227,8,217278
40722,0.000351,172.31.36.0-255,66,24293,8,217278
40723,0.000359,172.217.194.0-255,6797,31090,8,217278
40724,0.000365,172.31.36.0-255,66,31156,8,217278
40725,0.000502,172.217.194.0-255,1484,32640,8,217278
40726,0.000507,172.31.36.0-255,66,32706,8,217278
40727,0.000512,172.217.194.0-255,2902,35608,8,217278
40728,0.000515,172.31.36.0-255,66,35674,8,217278
40729,0.000546,172.217.194.0-255,5738,41412,8,217278
40730,0.000549,172.31.36.0-255,66,41478,8,217278
40731,0.000552,172.217.194.0-255,1484,42962,8,217278
40732,0.000554,172.31.36.0-255,66,43028,8,217278
40733,0.0006,172.31.36.0-255,66,43094,8,217278
40734,0.000603,172.217.194.0-255,1484,44578,8,217278
40735,0.000605,172.31.36.0-255,66,44644,8,217278
40736,0.00065,172.31.36.0-255,66,44710,8,217278
40737,0.000669,172.217.194.0-255,363,45073,8,217278
40738,0.000839,172.31.36.0-255,66,45139,8,217278
40739,0.000845,172.217.194.0-255,1484,46623,8,217278
40740,0.00085,172.217.194.0-255,2902,49525,8,217278
40741,0.000858,172.31.36.0-255,66,49591,8,217278
40742,0.000889,172.217.194.0-255,5738,55329,8,217278
40743,0.000893,172.31.36.0-255,66,55395,8,217278
40744,0.000907,172.31.36.0-255,66,55461,8,217278
40745,0.000912,172.217.194.0-255,2902,58363,8,217278
40746,0.000915,172.31.36.0-255,66,58429,8,217278
40747,0.000956,172.31.36.0-255,66,58495,8,217278
40748,0.001073,172.217.194.0-255,1484,59979,8,217278
40749,0.001092,172.217.194.0-255,2902,62881,8,217278
40750,0.001095,172.31.36.0-255,66,62947,8,217278
40751,0.001101,172.217.194.0-255,5738,68685,8,217278
40752,0.001103,172.31.36.0-255,66,68751,8,217278
40753,0.00113,172.31.36.0-255,66,68817,8,217278
40754,0.001159,172.217.194.0-255,1484,70301,8,217278
40755,0.001173,172.31.36.0-255,66,70367,8,217278
40756,0.001178,172.217.194.0-255,2184,72551,8,217278
40757,0.00118,172.31.36.0-255,66,72617,8,217278
40758,0.001242,172.217.194.0-255,2902,75519,8,217278
40759,0.001246,172.31.36.0-255,66,75585,8,217278
40760,0.001247,172.217.194.0-255,5738,81323,8,217278
40761,0.00125,172.31.36.0-255,66,81389,8,217278
40762,0.001257,172.217.194.0-255,7156,88545,8,217278
40763,0.001259,172.31.36.0-255,66,88611,8,217278
40764,0.00128,172.217.194.0-255,2902,91513,8,217278
40765,0.001283,172.31.36.0-255,66,91579,8,217278
40766,0.001313,172.217.194.0-255,5738,97317,8,217278
40767,0.001317,172.31.36.0-255,66,97383,8,217278
40768,0.001345,172.31.36.0-255,66,97449,8,217278
40769,0.001349,172.217.194.0-255,1484,98933,8,217278
40770,0.001353,172.217.194.0-255,2902,101835,8,217278
40771,0.001355,172.31.36.0-255,66,101901,8,217278
40772,0.001361,172.217.194.0-255,4320,106221,8,217278
40773,0.001363,172.31.36.0-255,66,106287,8,217278
40774,0.001387,172.217.194.0-255,1484,107771,8,217278
40775,0.001392,172.217.194.0-255,4320,112091,8,217278
40776,0.001395,172.31.36.0-255,66,112157,8,217278
40777,0.001407,172.31.36.0-255,66,112223,8,217278
40778,0.001429,172.217.194.0-255,2902,115125,8,217278
40779,0.001432,172.31.36.0-255,66,115191,8,217278
40780,0.001444,172.31.36.0-255,66,115257,8,217278
40781,0.001553,172.217.194.0-255,1484,116741,8,217278
40782,0.00156,172.217.194.0-255,2902,119643,8,217278
40783,0.001563,172.31.36.0-255,66,119709,8,217278
40784,0.00157,172.217.194.0-255,5738,125447,8,217278
40785,0.001573,172.31.36.0-255,66,125513,8,217278
40786,0.001576,172.217.194.0-255,2902,128415,8,217278
40787,0.001579,172.31.36.0-255,66,128481,8,217278
40788,0.001608,172.217.194.0-255,2902,131383,8,217278
40789,0.001611,172.31.36.0-255,66,131449,8,217278
40790,0.001624,172.31.36.0-255,66,131515,8,217278
40791,0.00163,172.217.194.0-255,5020,136535,8,217278
40792,0.001632,172.31.36.0-255,66,136601,8,217278
40793,0.001677,172.217.194.0-255,5738,142339,8,217278
40794,0.001681,172.31.36.0-255,66,142405,8,217278
40795,0.001687,172.217.194.0-255,5738,148143,8,217278
40796,0.00169,172.31.36.0-255,66,148209,8,217278
40797,0.001738,172.31.36.0-255,66,148275,8,217278
40798,0.001749,172.31.36.0-255,66,148341,8,217278
40799,0.001806,172.217.194.0-255,1484,149825,8,217278
40800,0.001812,172.217.194.0-255,2902,152727,8,217278
40801,0.001816,172.31.36.0-255,66,152793,8,217278
40802,0.001821,172.217.194.0-255,4320,157113,8,217278
40803,0.001823,172.31.36.0-255,66,157179,8,217278
40804,0.00185,172.217.194.0-255,1484,158663,8,217278
40805,0.001857,172.217.194.0-255,5738,164401,8,217278
40806,0.00186,172.31.36.0-255,66,164467,8,217278
40807,0.001879,172.31.36.0-255,66,164533,8,217278
40808,0.001908,172.217.194.0-255,5020,169553,8,217278
40809,0.001912,172.31.36.0-255,66,169619,8,217278
40810,0.001965,172.217.194.0-255,1484,171103,8,217278
40811,0.001979,172.217.194.0-255,2902,174005,8,217278
40812,0.001982,172.31.36.0-255,66,174071,8,217278
40813,0.002013,172.217.194.0-255,5738,179809,8,217278
40814,0.002016,172.31.36.0-255,66,179875,8,217278
40815,0.002023,172.31.36.0-255,101,179976,8,217278
40816,0.002059,172.217.194.0-255,2902,182878,8,217278
40817,0.002062,172.31.36.0-255,66,182944,8,217278
40818,0.002099,172.31.36.0-255,66,183010,8,217278
40819,0.002107,172.31.36.0-255,66,183076,8,217278
40820,0.002114,172.217.194.0-255,5738,188814,8,217278
40821,0.002118,172.31.36.0-255,66,188880,8,217278
40822,0.002124,172.217.194.0-255,7156,196036,8,217278
40823,0.002127,172.31.36.0-255,66,196102,8,217278
40824,0.002131,172.217.194.0-255,2902,199004,8,217278
40825,0.002134,172.31.36.0-255,66,199070,8,217278
40826,0.002179,172.31.36.0-255,66,199136,8,217278
40827,0.002198,172.31.36.0-255,66,199202,8,217278
40828,0.002215,172.217.194.0-255,7156,206358,8,217278
40829,0.002221,172.31.36.0-255,66,206424,8,217278
40830,0.002268,172.31.36.0-255,66,206490,8,217278
40831,0.002271,172.217.194.0-255,1484,207974,8,217278
40832,0.002287,172.31.36.0-255,66,208040,8,217278
40833,0.002309,172.217.194.0-255,105,208145,8,217278
40834,0.003539,172.31.36.0-255,105,208250,8,217278
40835,0.004292,172.217.194.0-255,66,208316,8,217278
40836,0.005793,172.217.194.0-255,66,208382,8,217278
40837,0.033974,172.31.36.0-255,190,208572,8,217278
40838,0.034006,172.31.36.0-255,1111,209683,8,217278
40839,0.03405,172.31.36.0-255,1514,211197,8,217278
40840,0.034052,172.31.36.0-255,1514,212711,8,217278
40841,0.034058,172.31.36.0-255,1514,214225,8,217278
40842,0.034059,172.31.36.0-255,1514,215739,8,217278
40843,0.034087,172.31.36.0-255,1275,217014,8,217278
40844,0.035512,104.244.42.0-255,66,217080,8,217278
40845,0.035535,104.244.42.0-255,66,217146,8,217278
40846,0.035622,104.244.42.0-255,66,217212,8,217278
40847,0.035625,104.244.42.0-255,66,217278,8,217278
40848,0.0,74.125.24.0-255,291,291,8,164150
40849,1.6e-05,172.31.36.0-255,66,357,8,164150
40850,2.2e-05,74.125.24.0-255,1484,1841,8,164150
40851,2.6e-05,172.31.36.0-255,66,1907,8,164150
40852,3.8e-05,74.125.24.0-255,4320,6227,8,164150
40853,4.1e-05,172.31.36.0-255,66,6293,8,164150
40854,4.5e-05,74.125.24.0-255,1484,7777,8,164150
40855,4.8e-05,172.31.36.0-255,66,7843,8,164150
40856,7.6e-05,74.125.24.0-255,6013,13856,8,164150
40857,8.4e-05,172.31.36.0-255,66,13922,8,164150
40858,0.000121,172.31.36.0-255,66,13988,8,164150
40859,0.000125,74.125.24.0-255,1484,15472,8,164150
40860,0.000127,172.31.36.0-255,66,15538,8,164150
40861,0.000174,172.31.36.0-255,66,15604,8,164150
40862,0.000179,74.125.24.0-255,3602,19206,8,164150
40863,0.000182,172.31.36.0-255,66,19272,8,164150
40864,0.000487,74.125.24.0-255,1484,20756,8,164150
40865,0.000494,172.31.36.0-255,66,20822,8,164150
40866,0.000519,74.125.24.0-255,2902,23724,8,164150
40867,0.000523,172.31.36.0-255,66,23790,8,164150
40868,0.00053,74.125.24.0-255,5738,29528,8,164150
40869,0.000533,172.31.36.0-255,66,29594,8,164150
40870,0.000573,74.125.24.0-255,7107,36701,8,164150
40871,0.000578,172.31.36.0-255,66,36767,8,164150
40872,0.001178,74.125.24.0-255,111,36878,8,164150
40873,0.001185,172.31.36.0-255,66,36944,8,164150
40874,0.001217,74.125.24.0-255,1484,38428,8,164150
40875,0.001221,172.31.36.0-255,66,38494,8,164150
40876,0.001227,74.125.24.0-255,2902,41396,8,164150
40877,0.001229,172.31.36.0-255,66,41462,8,164150
40878,0.001234,74.125.24.0-255,4320,45782,8,164150
40879,0.001241,172.31.36.0-255,66,45848,8,164150
40880,0.001276,74.125.24.0-255,2902,48750,8,164150
40881,0.001281,172.31.36.0-255,66,48816,8,164150
40882,0.001297,172.31.36.0-255,66,48882,8,164150
40883,0.0013,74.125.24.0-255,1484,50366,8,164150
40884,0.001315,74.125.24.0-255,2902,53268,8,164150
40885,0.001318,172.31.36.0-255,66,53334,8,164150
40886,0.001345,74.125.24.0-255,2184,55518,8,164150
40887,0.001348,172.31.36.0-255,66,55584,8,164150
40888,0.002663,74.125.24.0-255,1484,57068,8,164150
40889,0.00267,74.125.24.0-255,1484,58552,8,164150
40890,0.002674,172.31.36.0-255,66,58618,8,164150
40891,0.002696,74.125.24.0-255,1484,60102,8,164150
40892,0.002701,74.125.24.0-255,5738,65840,8,164150
40893,0.002704,172.31.36.0-255,66,65906,8,164150
40894,0.002707,74.125.24.0-255,1484,67390,8,164150
40895,0.002739,172.31.36.0-255,66,67456,8,164150
40896,0.002746,74.125.24.0-255,5738,73194,8,164150
40897,0.002748,172.31.36.0-255,66,73260,8,164150
40898,0.002757,74.125.24.0-255,1484,74744,8,164150
40899,0.002799,74.125.24.0-255,3602,78346,8,164150
40900,0.002801,172.31.36.0-255,66,78412,8,164150
40901,0.003089,74.125.24.0-255,1484,79896,8,164150
40902,0.003093,74.125.24.0-255,2902,82798,8,164150
40903,0.003096,172.31.36.0-255,66,82864,8,164150
40904,0.003123,74.125.24.0-255,5738,88602,8,164150
40905,0.003126,172.31.36.0-255,66,88668,8,164150
40906,0.003154,74.125.24.0-255,4320,92988,8,164150
40907,0.003156,172.31.36.0-255,66,93054,8,164150
40908,0.003199,172.31.36.0-255,66,93120,8,164150
40909,0.003212,172.31.36.0-255,66,93186,8,164150
40910,0.003219,74.125.24.0-255,7156,100342,8,164150
40911,0.003222,172.31.36.0-255,66,100408,8,164150
40912,0.003226,74.125.24.0-255,2902,103310,8,164150
40913,0.003231,172.31.36.0-255,66,103376,8,164150
40914,0.003276,172.31.36.0-255,66,103442,8,164150
40915,0.003278,74.125.24.0-255,766,104208,8,164150
40916,0.003301,74.125.24.0-255,7156,111364,8,164150
40917,0.003304,172.31.36.0-255,66,111430,8,164150
40918,0.003331,172.31.36.0-255,66,111496,8,164150
40919,0.003369,172.31.36.0-255,66,111562,8,164150
40920,0.003375,74.125.24.0-255,5738,117300,8,164150
40921,0.003377,172.31.36.0-255,66,117366,8,164150
40922,0.003414,172.31.36.0-255,66,117432,8,164150
40923,0.003428,172.31.36.0-255,66,117498,8,164150
40924,0.003432,74.125.24.0-255,2902,120400,8,164150
40925,0.003434,172.31.36.0-255,66,120466,8,164150
40926,0.003483,172.31.36.0-255,66,120532,8,164150
40927,0.003516,74.125.24.0-255,7156,127688,8,164150
40928,0.003519,172.31.36.0-255,66,127754,8,164150
40929,0.003521,74.125.24.0-255,766,128520,8,164150
40930,0.003526,74.125.24.0-255,4320,132840,8,164150
40931,0.003528,172.31.36.0-255,66,132906,8,164150
40932,0.003544,172.31.36.0-255,66,132972,8,164150
40933,0.003556,172.31.36.0-255,66,133038,8,164150
40934,0.003562,74.125.24.0-255,5020,138058,8,164150
40935,0.003564,172.31.36.0-255,66,138124,8,164150
40936,0.003567,74.125.24.0-255,1484,139608,8,164150
40937,0.003604,74.125.24.0-255,1484,141092,8,164150
40938,0.003606,172.31.36.0-255,66,141158,8,164150
40939,0.003637,74.125.24.0-255,4320,145478,8,164150
40940,0.00364,172.31.36.0-255,66,145544,8,164150
40941,0.003654,172.31.36.0-255,66,145610,8,164150
40942,0.003658,74.125.24.0-255,2902,148512,8,164150
40943,0.00366,172.31.36.0-255,66,148578,8,164150
40944,0.003664,74.125.24.0-255,4320,152898,8,164150
40945,0.003667,172.31.36.0-255,66,152964,8,164150
40946,0.003686,172.31.36.0-255,66,153030,8,164150
40947,0.003723,74.125.24.0-255,3602,156632,8,164150
40948,0.003725,172.31.36.0-255,66,156698,8,164150
40949,0.003737,172.31.36.0-255,66,156764,8,164150
40950,0.003746,172.31.36.0-255,66,156830,8,164150
40951,0.003767,74.125.24.0-255,105,156935,8,164150
40952,0.006475,172.31.36.0-255,101,157036,8,164150
40953,0.008719,74.125.24.0-255,66,157102,8,164150
40954,0.009423,172.31.36.0-255,105,157207,8,164150
40955,0.011656,74.125.24.0-255,66,157273,8,164150
40956,0.038602,172.31.36.0-255,188,157461,8,164150
40957,0.038636,172.31.36.0-255,955,158416,8,164150
40958,0.038705,172.31.36.0-255,1514,159930,8,164150
40959,0.038707,172.31.36.0-255,1514,161444,8,164150
40960,0.038708,172.31.36.0-255,1514,162958,8,164150
40961,0.038709,172.31.36.0-255,928,163886,8,164150
40962,0.040168,104.244.42.0-255,66,163952,8,164150
40963,0.040219,104.244.42.0-255,66,164018,8,164150
40964,0.040318,104.244.42.0-255,66,164084,8,164150
40965,0.040331,104.244.42.0-255,66,164150,8,164150
40966,0.0,172.217.194.0-255,296,296,8,210842
40967,3.4e-05,172.31.36.0-255,66,362,8,210842
40968,4e-05,172.217.194.0-255,1484,1846,8,210842
40969,4.5e-05,172.31.36.0-255,66,1912,8,210842
40970,5.1e-05,172.217.194.0-255,4320,6232,8,210842
40971,5.4e-05,172.31.36.0-255,66,6298,8,210842
40972,0.0001,172.217.194.0-255,2902,9200,8,210842
40973,0.000104,172.31.36.0-255,66,9266,8,210842
40974,0.000128,172.217.194.0-255,6030,15296,8,210842
40975,0.000131,172.31.36.0-255,66,15362,8,210842
40976,0.000293,172.217.194.0-255,5738,21100,8,210842
40977,0.000298,172.31.36.0-255,66,21166,8,210842
40978,0.000316,172.217.194.0-255,5738,26904,8,210842
40979,0.000319,172.31.36.0-255,66,26970,8,210842
40980,0.000527,172.217.194.0-255,7156,34126,8,210842
40981,0.000531,172.31.36.0-255,66,34192,8,210842
40982,0.000568,172.31.36.0-255,66,34258,8,210842
40983,0.000955,172.217.194.0-255,7156,41414,8,210842
40984,0.00096,172.31.36.0-255,66,41480,8,210842
40985,0.000991,172.31.36.0-255,66,41546,8,210842
40986,0.001324,172.31.36.0-255,66,41612,8,210842
40987,0.001372,172.31.36.0-255,66,41678,8,210842
40988,0.002016,172.31.36.0-255,66,41744,8,210842
40989,0.002048,172.31.36.0-255,66,41810,8,210842
40990,0.002677,172.217.194.0-255,2902,44712,8,210842
40991,0.00268,172.31.36.0-255,66,44778,8,210842
40992,0.002781,172.217.194.0-255,5738,50516,8,210842
40993,0.00368,172.217.194.0-255,4320,54836,8,210842
40994,0.004108,172.31.36.0-255,66,54902,8,210842
40995,0.006385,172.217.194.0-255,1484,56386,8,210842
40996,0.006405,172.217.194.0-255,4320,60706,8,210842
40997,0.006409,172.31.36.0-255,66,60772,8,210842
40998,0.00873,172.217.194.0-255,5738,66510,8,210842
40999,0.009064,172.31.36.0-255,66,66576,8,210842
41000,0.011355,172.217.194.0-255,5738,72314,8,210842
41001,0.011363,172.31.36.0-255,66,72380,8,210842
41002,0.013673,172.217.194.0-255,5738,78118,8,210842
41003,0.017946,172.31.36.0-255,66,78184,8,210842
41004,0.020251,172.217.194.0-255,5738,83922,8,210842
41005,0.020266,172.31.36.0-255,66,83988,8,210842
41006,0.022572,172.217.194.0-255,5738,89726,8,210842
41007,0.022578,172.31.36.0-255,66,89792,8,210842
41008,0.024857,172.217.194.0-255,5738,95530,8,210842
41009,0.024865,172.31.36.0-255,66,95596,8,210842
41010,0.027141,172.217.194.0-255,5738,101334,8,210842
41011,0.027149,172.31.36.0-255,66,101400,8,210842
41012,0.029428,172.217.194.0-255,5738,107138,8,210842
41013,0.029435,172.31.36.0-255,66,107204,8,210842
41014,0.031724,172.217.194.0-255,5738,112942,8,210842
41015,0.031732,172.31.36.0-255,66,113008,8,210842
41016,0.034068,172.217.194.0-255,5738,118746,8,210842
41017,0.034074,172.31.36.0-255,66,118812,8,210842
41018,0.035117,172.31.36.0-255,188,119000,8,210842
41019,0.035149,172.31.36.0-255,955,119955,8,210842
41020,0.035185,172.31.36.0-255,1514,121469,8,210842
41021,0.035187,172.31.36.0-255,135,121604,8,210842
41022,0.036362,172.217.194.0-255,2902,124506,8,210842
41023,0.036369,172.31.36.0-255,66,124572,8,210842
41024,0.036397,172.217.194.0-255,2902,127474,8,210842
41025,0.036415,172.31.36.0-255,66,127540,8,210842
41026,0.036736,104.244.42.0-255,66,127606,8,210842
41027,0.036743,104.244.42.0-255,66,127672,8,210842
41028,0.036765,104.244.42.0-255,66,127738,8,210842
41029,0.038649,172.217.194.0-255,2902,130640,8,210842
41030,0.038653,172.31.36.0-255,66,130706,8,210842
41031,0.038677,172.217.194.0-255,2902,133608,8,210842
41032,0.038696,172.31.36.0-255,66,133674,8,210842
41033,0.04095,172.217.194.0-255,2902,136576,8,210842
41034,0.040956,172.31.36.0-255,66,136642,8,210842
41035,0.040988,172.217.194.0-255,2902,139544,8,210842
41036,0.040997,172.31.36.0-255,66,139610,8,210842
41037,0.043276,172.217.194.0-255,2902,142512,8,210842
41038,0.043282,172.31.36.0-255,66,142578,8,210842
41039,0.043303,172.217.194.0-255,2902,145480,8,210842
41040,0.043326,172.31.36.0-255,66,145546,8,210842
41041,0.04559,172.217.194.0-255,2902,148448,8,210842
41042,0.045595,172.31.36.0-255,66,148514,8,210842
41043,0.045625,172.217.194.0-255,2902,151416,8,210842
41044,0.045654,172.31.36.0-255,66,151482,8,210842
41045,0.047894,172.217.194.0-255,2902,154384,8,210842
41046,0.0479,172.31.36.0-255,66,154450,8,210842
41047,0.047942,172.217.194.0-255,2902,157352,8,210842
41048,0.047956,172.31.36.0-255,66,157418,8,210842
41049,0.050186,172.217.194.0-255,2902,160320,8,210842
41050,0.050191,172.31.36.0-255,66,160386,8,210842
41051,0.050268,172.217.194.0-255,2902,163288,8,210842
41052,0.050282,172.31.36.0-255,66,163354,8,210842
41053,0.05249,172.217.194.0-255,2902,166256,8,210842
41054,0.052495,172.31.36.0-255,66,166322,8,210842
41055,0.052558,172.217.194.0-255,2902,169224,8,210842
41056,0.052574,172.31.36.0-255,66,169290,8,210842
41057,0.054793,172.217.194.0-255,2902,172192,8,210842
41058,0.054799,172.31.36.0-255,66,172258,8,210842
41059,0.054857,172.217.194.0-255,2902,175160,8,210842
41060,0.054869,172.31.36.0-255,66,175226,8,210842
41061,0.057106,172.217.194.0-255,2902,178128,8,210842
41062,0.057111,172.31.36.0-255,66,178194,8,210842
41063,0.05715,172.217.194.0-255,2902,181096,8,210842
41064,0.05718,172.31.36.0-255,66,181162,8,210842
41065,0.059391,172.217.194.0-255,2902,184064,8,210842
41066,0.059397,172.31.36.0-255,66,184130,8,210842
41067,0.059465,172.217.194.0-255,2902,187032,8,210842
41068,0.059479,172.31.36.0-255,66,187098,8,210842
41069,0.06168,172.217.194.0-255,2902,190000,8,210842
41070,0.061685,172.31.36.0-255,66,190066,8,210842
41071,0.061764,172.217.194.0-255,2902,192968,8,210842
41072,0.061768,172.31.36.0-255,66,193034,8,210842
41073,0.064,172.217.194.0-255,2902,195936,8,210842
41074,0.064006,172.31.36.0-255,66,196002,8,210842
41075,0.06405,172.217.194.0-255,2902,198904,8,210842
41076,0.064062,172.31.36.0-255,66,198970,8,210842
41077,0.066333,172.217.194.0-255,2902,201872,8,210842
41078,0.066339,172.31.36.0-255,66,201938,8,210842
41079,0.066366,172.217.194.0-255,2902,204840,8,210842
41080,0.066397,172.31.36.0-255,66,204906,8,210842
41081,0.068648,172.217.194.0-255,2902,207808,8,210842
41082,0.068653,172.31.36.0-255,66,207874,8,210842
41083,0.068684,172.217.194.0-255,2902,210776,8,210842
41084,0.068712,172.31.36.0-255,66,210842,8,210842
41085,0.0,172.217.194.0-255,153,153,8,146330
41086,2.6e-05,172.31.36.0-255,66,219,8,146330
41087,3.3e-05,172.217.194.0-255,1484,1703,8,146330
41088,3.8e-05,172.31.36.0-255,66,1769,8,146330
41089,4.3e-05,172.217.194.0-255,2902,4671,8,146330
41090,5.2e-05,172.31.36.0-255,66,4737,8,146330
41091,5.9e-05,172.217.194.0-255,5738,10475,8,146330
41092,6.1e-05,172.31.36.0-255,66,10541,8,146330
41093,9.1e-05,172.217.194.0-255,1484,12025,8,146330
41094,9.4e-05,172.31.36.0-255,66,12091,8,146330
41095,9.7e-05,172.217.194.0-255,1484,13575,8,146330
41096,9.9e-05,172.31.36.0-255,66,13641,8,146330
41097,0.000102,172.217.194.0-255,613,14254,8,146330
41098,0.000103,172.31.36.0-255,66,14320,8,146330
41099,0.000136,172.217.194.0-255,1484,15804,8,146330
41100,0.000139,172.31.36.0-255,66,15870,8,146330
41101,0.000145,172.217.194.0-255,4320,20190,8,146330
41102,0.000147,172.31.36.0-255,66,20256,8,146330
41103,0.000168,172.217.194.0-255,1484,21740,8,146330
41104,0.00017,172.31.36.0-255,66,21806,8,146330
41105,0.000196,172.217.194.0-255,7156,28962,8,146330
41106,0.000199,172.31.36.0-255,66,29028,8,146330
41107,0.000226,172.217.194.0-255,1484,30512,8,146330
41108,0.000229,172.31.36.0-255,66,30578,8,146330
41109,0.000232,172.217.194.0-255,1125,31703,8,146330
41110,0.000234,172.31.36.0-255,66,31769,8,146330
41111,0.000254,172.31.36.0-255,66,31835,8,146330
41112,0.00026,172.217.194.0-255,3961,35796,8,146330
41113,0.000262,172.31.36.0-255,66,35862,8,146330
41114,0.000351,172.217.194.0-255,1484,37346,8,146330
41115,0.000356,172.31.36.0-255,66,37412,8,146330
41116,0.000362,172.217.194.0-255,2902,40314,8,146330
41117,0.000364,172.31.36.0-255,66,40380,8,146330
41118,0.000377,172.217.194.0-255,5738,46118,8,146330
41119,0.00038,172.31.36.0-255,66,46184,8,146330
41120,0.000429,172.217.194.0-255,6797,52981,8,146330
41121,0.000433,172.31.36.0-255,66,53047,8,146330
41122,0.000491,172.31.36.0-255,66,53113,8,146330
41123,0.000501,172.31.36.0-255,66,53179,8,146330
41124,0.000552,172.31.36.0-255,66,53245,8,146330
41125,0.000819,172.217.194.0-255,1484,54729,8,146330
41126,0.000823,172.217.194.0-255,1484,56213,8,146330
41127,0.000825,172.31.36.0-255,66,56279,8,146330
41128,0.000843,172.217.194.0-255,1484,57763,8,146330
41129,0.000849,172.217.194.0-255,5738,63501,8,146330
41130,0.000852,172.31.36.0-255,66,63567,8,146330
41131,0.000894,172.31.36.0-255,66,63633,8,146330
41132,0.000899,172.217.194.0-255,1484,65117,8,146330
41133,0.000902,172.217.194.0-255,1484,66601,8,146330
41134,0.000904,172.31.36.0-255,66,66667,8,146330
41135,0.000941,172.31.36.0-255,66,66733,8,146330
41136,0.000955,172.31.36.0-255,66,66799,8,146330
41137,0.000973,172.31.36.0-255,66,66865,8,146330
41138,0.000997,172.217.194.0-255,1484,68349,8,146330
41139,0.001009,172.217.194.0-255,6438,74787,8,146330
41140,0.001013,172.31.36.0-255,66,74853,8,146330
41141,0.001051,172.217.194.0-255,7156,82009,8,146330
41142,0.001055,172.31.36.0-255,66,82075,8,146330
41143,0.001065,172.31.36.0-255,66,82141,8,146330
41144,0.001075,172.217.194.0-255,2902,85043,8,146330
41145,0.001077,172.31.36.0-255,66,85109,8,146330
41146,0.001125,172.31.36.0-255,66,85175,8,146330
41147,0.001128,172.217.194.0-255,766,85941,8,146330
41148,0.001133,172.217.194.0-255,2902,88843,8,146330
41149,0.001134,172.31.36.0-255,66,88909,8,146330
41150,0.001161,172.217.194.0-255,4320,93229,8,146330
41151,0.001164,172.31.36.0-255,66,93295,8,146330
41152,0.00118,172.31.36.0-255,66,93361,8,146330
41153,0.001213,172.31.36.0-255,66,93427,8,146330
41154,0.001247,172.217.194.0-255,5020,98447,8,146330
41155,0.001251,172.31.36.0-255,66,98513,8,146330
41156,0.001263,172.31.36.0-255,66,98579,8,146330
41157,0.001289,172.31.36.0-255,66,98645,8,146330
41158,0.001384,172.31.36.0-255,66,98711,8,146330
41159,0.001407,172.31.36.0-255,66,98777,8,146330
41160,0.001411,172.217.194.0-255,2184,100961,8,146330
41161,0.001413,172.31.36.0-255,66,101027,8,146330
41162,0.001418,172.217.194.0-255,4320,105347,8,146330
41163,0.001422,172.31.36.0-255,66,105413,8,146330
41164,0.001423,172.217.194.0-255,5738,111151,8,146330
41165,0.001426,172.31.36.0-255,66,111217,8,146330
41166,0.001431,172.217.194.0-255,4320,115537,8,146330
41167,0.001433,172.31.36.0-255,66,115603,8,146330
41168,0.001472,172.217.194.0-255,7156,122759,8,146330
41169,0.001476,172.31.36.0-255,66,122825,8,146330
41170,0.001489,172.31.36.0-255,66,122891,8,146330
41171,0.001522,172.217.194.0-255,1484,124375,8,146330
41172,0.001526,172.217.194.0-255,2902,127277,8,146330
41173,0.001529,172.31.36.0-255,66,127343,8,146330
41174,0.001535,172.217.194.0-255,5738,133081,8,146330
41175,0.001538,172.31.36.0-255,66,133147,8,146330
41176,0.001541,172.217.194.0-255,1484,134631,8,146330
41177,0.00158,172.31.36.0-255,66,134697,8,146330
41178,0.001591,172.31.36.0-255,66,134763,8,146330
41179,0.001628,172.31.36.0-255,66,134829,8,146330
41180,0.00167,172.31.36.0-255,66,134895,8,146330
41181,0.001697,172.31.36.0-255,66,134961,8,146330
41182,0.0017,172.217.194.0-255,862,135823,8,146330
41183,0.001702,172.217.194.0-255,105,135928,8,146330
41184,0.00401,172.31.36.0-255,66,135994,8,146330
41185,0.004038,172.31.36.0-255,105,136099,8,146330
41186,0.006629,172.217.194.0-255,66,136165,8,146330
41187,0.033706,172.31.36.0-255,172,136337,8,146330
41188,0.033739,172.31.36.0-255,1110,137447,8,146330
41189,0.033789,172.31.36.0-255,1514,138961,8,146330
41190,0.033791,172.31.36.0-255,1514,140475,8,146330
41191,0.033792,172.31.36.0-255,1514,141989,8,146330
41192,0.033797,172.31.36.0-255,1514,143503,8,146330
41193,0.033799,172.31.36.0-255,1514,145017,8,146330
41194,0.0338,172.31.36.0-255,875,145892,8,146330
41195,0.035249,104.244.42.0-255,66,145958,8,146330
41196,0.035294,104.244.42.0-255,66,146024,8,146330
41197,0.035347,104.244.42.0-255,66,146090,8,146330
41198,0.035353,104.244.42.0-255,66,146156,8,146330
41199,0.04226,172.31.36.0-255,108,146264,8,146330
41200,0.043891,104.244.42.0-255,66,146330,8,146330
41201,0.0,216.58.221.0-255,153,153,8,276107
41202,3.5e-05,172.31.36.0-255,66,219,8,276107
41203,7.6e-05,216.58.221.0-255,1484,1703,8,276107
41204,8.1e-05,172.31.36.0-255,66,1769,8,276107
41205,8.7e-05,216.58.221.0-255,2902,4671,8,276107
41206,9.1e-05,172.31.36.0-255,66,4737,8,276107
41207,0.000145,216.58.221.0-255,1484,6221,8,276107
41208,0.000148,172.31.36.0-255,66,6287,8,276107
41209,0.00017,216.58.221.0-255,4320,10607,8,276107
41210,0.000174,172.31.36.0-255,66,10673,8,276107
41211,0.00018,216.58.221.0-255,3421,14094,8,276107
41212,0.000182,172.31.36.0-255,66,14160,8,276107
41213,0.000193,216.58.221.0-255,1484,15644,8,276107
41214,0.000195,172.31.36.0-255,66,15710,8,276107
41215,0.000201,216.58.221.0-255,2902,18612,8,276107
41216,0.000203,172.31.36.0-255,66,18678,8,276107
41217,0.000243,216.58.221.0-255,5738,24416,8,276107
41218,0.000246,172.31.36.0-255,66,24482,8,276107
41219,0.00025,216.58.221.0-255,2902,27384,8,276107
41220,0.000255,172.31.36.0-255,66,27450,8,276107
41221,0.000286,216.58.221.0-255,3961,31411,8,276107
41222,0.00029,172.31.36.0-255,66,31477,8,276107
41223,0.000542,216.58.221.0-255,1484,32961,8,276107
41224,0.000547,172.31.36.0-255,66,33027,8,276107
41225,0.000552,216.58.221.0-255,2902,35929,8,276107
41226,0.000554,172.31.36.0-255,66,35995,8,276107
41227,0.000558,216.58.221.0-255,2902,38897,8,276107
41228,0.000561,172.31.36.0-255,66,38963,8,276107
41229,0.000593,216.58.221.0-255,2902,41865,8,276107
41230,0.000596,172.31.36.0-255,66,41931,8,276107
41231,0.000609,216.58.221.0-255,6797,48728,8,276107
41232,0.000612,172.31.36.0-255,66,48794,8,276107
41233,0.000772,216.58.221.0-255,1484,50278,8,276107
41234,0.000782,216.58.221.0-255,2902,53180,8,276107
41235,0.000785,172.31.36.0-255,66,53246,8,276107
41236,0.00079,216.58.221.0-255,2902,56148,8,276107
41237,0.000791,172.31.36.0-255,66,56214,8,276107
41238,0.000814,216.58.221.0-255,1484,57698,8,276107
41239,0.000828,172.31.36.0-255,66,57764,8,276107
41240,0.001364,216.58.221.0-255,353,58117,8,276107
41241,0.001536,216.58.221.0-255,1484,59601,8,276107
41242,0.001541,172.31.36.0-255,66,59667,8,276107
41243,0.001547,216.58.221.0-255,2902,62569,8,276107
41244,0.001549,172.31.36.0-255,66,62635,8,276107
41245,0.001558,216.58.221.0-255,2902,65537,8,276107
41246,0.00156,172.31.36.0-255,66,65603,8,276107
41247,0.001584,216.58.221.0-255,1484,67087,8,276107
41248,0.001609,172.31.36.0-255,66,67153,8,276107
41249,0.001643,172.31.36.0-255,66,67219,8,276107
41250,0.001673,172.31.36.0-255,66,67285,8,276107
41251,0.003637,216.58.221.0-255,5738,73023,8,276107
41252,0.003641,172.31.36.0-255,66,73089,8,276107
41253,0.005614,216.58.221.0-255,5738,78827,8,276107
41254,0.005618,172.31.36.0-255,66,78893,8,276107
41255,0.007595,216.58.221.0-255,5738,84631,8,276107
41256,0.007602,172.31.36.0-255,66,84697,8,276107
41257,0.009595,216.58.221.0-255,5738,90435,8,276107
41258,0.009607,172.31.36.0-255,66,90501,8,276107
41259,0.011596,216.58.221.0-255,5738,96239,8,276107
41260,0.011603,172.31.36.0-255,66,96305,8,276107
41261,0.01358,216.58.221.0-255,5738,102043,8,276107
41262,0.013587,172.31.36.0-255,66,102109,8,276107
41263,0.015562,216.58.221.0-255,5738,107847,8,276107
41264,0.015572,172.31.36.0-255,66,107913,8,276107
41265,0.017545,216.58.221.0-255,5738,113651,8,276107
41266,0.017552,172.31.36.0-255,66,113717,8,276107
41267,0.019578,216.58.221.0-255,5738,119455,8,276107
41268,0.019592,172.31.36.0-255,66,119521,8,276107
41269,0.021597,216.58.221.0-255,5738,125259,8,276107
41270,0.021612,172.31.36.0-255,66,125325,8,276107
41271,0.0236,216.58.221.0-255,5738,131063,8,276107
41272,0.023608,172.31.36.0-255,66,131129,8,276107
41273,0.025602,216.58.221.0-255,5738,136867,8,276107
41274,0.025611,172.31.36.0-255,66,136933,8,276107
41275,0.027608,216.58.221.0-255,5738,142671,8,276107
41276,0.027613,172.31.36.0-255,66,142737,8,276107
41277,0.028332,172.31.36.0-255,172,142909,8,276107
41278,0.028362,172.31.36.0-255,1110,144019,8,276107
41279,0.028408,172.31.36.0-255,1514,145533,8,276107
41280,0.02841,172.31.36.0-255,1514,147047,8,276107
41281,0.028415,172.31.36.0-255,1514,148561,8,276107
41282,0.028417,172.31.36.0-255,1514,150075,8,276107
41283,0.028437,172.31.36.0-255,1514,151589,8,276107
41284,0.028438,172.31.36.0-255,876,152465,8,276107
41285,0.0296,216.58.221.0-255,5738,158203,8,276107
41286,0.029608,172.31.36.0-255,66,158269,8,276107
41287,0.02986,104.244.42.0-255,66,158335,8,276107
41288,0.029884,104.244.42.0-255,66,158401,8,276107
41289,0.029967,104.244.42.0-255,66,158467,8,276107
41290,0.030012,104.244.42.0-255,66,158533,8,276107
41291,0.031587,216.58.221.0-255,5738,164271,8,276107
41292,0.031594,172.31.36.0-255,66,164337,8,276107
41293,0.033569,216.58.221.0-255,5738,170075,8,276107
41294,0.033575,172.31.36.0-255,66,170141,8,276107
41295,0.035549,216.58.221.0-255,5738,175879,8,276107
41296,0.035557,172.31.36.0-255,66,175945,8,276107
41297,0.037547,216.58.221.0-255,5738,181683,8,276107
41298,0.037554,172.31.36.0-255,66,181749,8,276107
41299,0.039537,216.58.221.0-255,5738,187487,8,276107
41300,0.039562,172.31.36.0-255,66,187553,8,276107
41301,0.041549,216.58.221.0-255,5738,193291,8,276107
41302,0.041558,172.31.36.0-255,66,193357,8,276107
41303,0.043536,216.58.221.0-255,5738,199095,8,276107
41304,0.043545,172.31.36.0-255,66,199161,8,276107
41305,0.045518,216.58.221.0-255,5738,204899,8,276107
41306,0.045526,172.31.36.0-255,66,204965,8,276107
41307,0.047501,216.58.221.0-255,2902,207867,8,276107
41308,0.047506,172.31.36.0-255,66,207933,8,276107
41309,0.047533,216.58.221.0-255,2902,210835,8,276107
41310,0.047536,172.31.36.0-255,66,210901,8,276107
41311,0.049473,216.58.221.0-255,2902,213803,8,276107
41312,0.049479,172.31.36.0-255,66,213869,8,276107
41313,0.04951,216.58.221.0-255,2902,216771,8,276107
41314,0.049513,172.31.36.0-255,66,216837,8,276107
41315,0.051462,216.58.221.0-255,2902,219739,8,276107
41316,0.051471,172.31.36.0-255,66,219805,8,276107
41317,0.051506,216.58.221.0-255,2902,222707,8,276107
41318,0.05151,172.31.36.0-255,66,222773,8,276107
41319,0.053451,216.58.221.0-255,2902,225675,8,276107
41320,0.05346,172.31.36.0-255,66,225741,8,276107
41321,0.053491,216.58.221.0-255,2902,228643,8,276107
41322,0.053493,172.31.36.0-255,66,228709,8,276107
41323,0.055443,216.58.221.0-255,2902,231611,8,276107
41324,0.055452,172.31.36.0-255,66,231677,8,276107
41325,0.055473,216.58.221.0-255,2902,234579,8,276107
41326,0.055476,172.31.36.0-255,66,234645,8,276107
41327,0.056604,172.31.36.0-255,108,234753,8,276107
41328,0.057422,216.58.221.0-255,2902,237655,8,276107
41329,0.057432,172.31.36.0-255,66,237721,8,276107
41330,0.057468,216.58.221.0-255,2902,240623,8,276107
41331,0.057472,172.31.36.0-255,66,240689,8,276107
41332,0.058126,104.244.42.0-255,66,240755,8,276107
41333,0.059397,216.58.221.0-255,2902,243657,8,276107
41334,0.059404,172.31.36.0-255,66,243723,8,276107
41335,0.059446,216.58.221.0-255,2902,246625,8,276107
41336,0.05945,172.31.36.0-255,66,246691,8,276107
41337,0.061381,216.58.221.0-255,2902,249593,8,276107
41338,0.061389,172.31.36.0-255,66,249659,8,276107
41339,0.061431,216.58.221.0-255,2902,252561,8,276107
41340,0.061435,172.31.36.0-255,66,252627,8,276107
41341,0.063371,216.58.221.0-255,2902,255529,8,276107
41342,0.063379,172.31.36.0-255,66,255595,8,276107
41343,0.063421,216.58.221.0-255,2902,258497,8,276107
41344,0.063424,172.31.36.0-255,66,258563,8,276107
41345,0.06534,216.58.221.0-255,2902,261465,8,276107
41346,0.065346,172.31.36.0-255,66,261531,8,276107
41347,0.065387,216.58.221.0-255,2902,264433,8,276107
41348,0.06539,172.31.36.0-255,66,264499,8,276107
41349,0.067371,216.58.221.0-255,5738,270237,8,276107
41350,0.067379,172.31.36.0-255,66,270303,8,276107
41351,0.069357,216.58.221.0-255,5738,276041,8,276107
41352,0.069364,172.31.36.0-255,66,276107,8,276107
41353,0.0,74.125.24.0-255,153,153,8,317825
41354,3.4e-05,172.31.36.0-255,66,219,8,317825
41355,4.2e-05,74.125.24.0-255,1484,1703,8,317825
41356,4.7e-05,172.31.36.0-255,66,1769,8,317825
41357,5.3e-05,74.125.24.0-255,2902,4671,8,317825
41358,5.5e-05,172.31.36.0-255,66,4737,8,317825
41359,6.3e-05,74.125.24.0-255,7156,11893,8,317825
41360,6.6e-05,172.31.36.0-255,66,11959,8,317825
41361,6.9e-05,74.125.24.0-255,2011,13970,8,317825
41362,7.2e-05,172.31.36.0-255,66,14036,8,317825
41363,8.8e-05,74.125.24.0-255,1484,15520,8,317825
41364,9e-05,172.31.36.0-255,66,15586,8,317825
41365,9.5e-05,74.125.24.0-255,2902,18488,8,317825
41366,9.8e-05,172.31.36.0-255,66,18554,8,317825
41367,0.000118,74.125.24.0-255,5738,24292,8,317825
41368,0.000121,172.31.36.0-255,66,24358,8,317825
41369,0.000148,74.125.24.0-255,6797,31155,8,317825
41370,0.000152,172.31.36.0-255,66,31221,8,317825
41371,0.000215,74.125.24.0-255,1484,32705,8,317825
41372,0.000218,172.31.36.0-255,66,32771,8,317825
41373,0.000224,74.125.24.0-255,2902,35673,8,317825
41374,0.000226,172.31.36.0-255,66,35739,8,317825
41375,0.000251,74.125.24.0-255,5738,41477,8,317825
41376,0.000255,172.31.36.0-255,66,41543,8,317825
41377,0.000261,74.125.24.0-255,6797,48340,8,317825
41378,0.000263,172.31.36.0-255,66,48406,8,317825
41379,0.000269,74.125.24.0-255,5738,54144,8,317825
41380,0.000273,172.31.36.0-255,66,54210,8,317825
41381,0.000282,74.125.24.0-255,1484,55694,8,317825
41382,0.000284,172.31.36.0-255,66,55760,8,317825
41383,0.00031,172.31.36.0-255,66,55826,8,317825
41384,0.00033,74.125.24.0-255,1125,56951,8,317825
41385,0.000334,74.125.24.0-255,415,57366,8,317825
41386,0.000371,74.125.24.0-255,331,57697,8,317825
41387,0.000375,172.31.36.0-255,66,57763,8,317825
41388,0.000612,74.125.24.0-255,1484,59247,8,317825
41389,0.000618,74.125.24.0-255,2902,62149,8,317825
41390,0.000622,172.31.36.0-255,66,62215,8,317825
41391,0.000626,74.125.24.0-255,1484,63699,8,317825
41392,0.000646,74.125.24.0-255,4320,68019,8,317825
41393,0.000649,172.31.36.0-255,66,68085,8,317825
41394,0.00069,172.31.36.0-255,66,68151,8,317825
41395,0.000693,74.125.24.0-255,1484,69635,8,317825
41396,0.000718,172.31.36.0-255,66,69701,8,317825
41397,0.000902,74.125.24.0-255,1484,71185,8,317825
41398,0.000907,74.125.24.0-255,2902,74087,8,317825
41399,0.000911,172.31.36.0-255,66,74153,8,317825
41400,0.000915,74.125.24.0-255,1484,75637,8,317825
41401,0.00093,74.125.24.0-255,4320,79957,8,317825
41402,0.000933,172.31.36.0-255,66,80023,8,317825
41403,0.000938,74.125.24.0-255,2902,82925,8,317825
41404,0.00094,172.31.36.0-255,66,82991,8,317825
41405,0.000975,172.31.36.0-255,66,83057,8,317825
41406,0.000982,74.125.24.0-255,7156,90213,8,317825
41407,0.000984,172.31.36.0-255,66,90279,8,317825
41408,0.001002,74.125.24.0-255,3602,93881,8,317825
41409,0.001005,172.31.36.0-255,66,93947,8,317825
41410,0.001273,74.125.24.0-255,1484,95431,8,317825
41411,0.00128,74.125.24.0-255,2902,98333,8,317825
41412,0.001284,172.31.36.0-255,66,98399,8,317825
41413,0.001299,74.125.24.0-255,4320,102719,8,317825
41414,0.001302,172.31.36.0-255,66,102785,8,317825
41415,0.001316,74.125.24.0-255,1484,104269,8,317825
41416,0.001321,74.125.24.0-255,2902,107171,8,317825
41417,0.001323,172.31.36.0-255,66,107237,8,317825
41418,0.001358,74.125.24.0-255,1484,108721,8,317825
41419,0.001379,172.31.36.0-255,66,108787,8,317825
41420,0.00139,172.31.36.0-255,66,108853,8,317825
41421,0.001474,74.125.24.0-255,1484,110337,8,317825
41422,0.001479,74.125.24.0-255,2902,113239,8,317825
41423,0.001484,172.31.36.0-255,66,113305,8,317825
41424,0.001492,74.125.24.0-255,1484,114789,8,317825
41425,0.001506,74.125.24.0-255,4320,119109,8,317825
41426,0.001509,172.31.36.0-255,66,119175,8,317825
41427,0.001514,74.125.24.0-255,5738,124913,8,317825
41428,0.001516,172.31.36.0-255,66,124979,8,317825
41429,0.001557,74.125.24.0-255,5020,129999,8,317825
41430,0.001557,172.31.36.0-255,66,130065,8,317825
41431,0.00156,172.31.36.0-255,66,130131,8,317825
41432,0.001659,74.125.24.0-255,1484,131615,8,317825
41433,0.001673,74.125.24.0-255,2902,134517,8,317825
41434,0.001676,172.31.36.0-255,66,134583,8,317825
41435,0.00168,74.125.24.0-255,1484,136067,8,317825
41436,0.001699,74.125.24.0-255,4320,140387,8,317825
41437,0.001702,172.31.36.0-255,66,140453,8,317825
41438,0.001707,74.125.24.0-255,2902,143355,8,317825
41439,0.001709,172.31.36.0-255,66,143421,8,317825
41440,0.001732,74.125.24.0-255,5738,149159,8,317825
41441,0.001732,172.31.36.0-255,66,149225,8,317825
41442,0.001736,172.31.36.0-255,66,149291,8,317825
41443,0.001753,74.125.24.0-255,1484,150775,8,317825
41444,0.00177,74.125.24.0-255,3602,154377,8,317825
41445,0.001773,172.31.36.0-255,66,154443,8,317825
41446,0.00181,74.125.24.0-255,5738,160181,8,317825
41447,0.001814,172.31.36.0-255,66,160247,8,317825
41448,0.001819,74.125.24.0-255,4320,164567,8,317825
41449,0.001822,172.31.36.0-255,66,164633,8,317825
41450,0.001835,74.125.24.0-255,2902,167535,8,317825
41451,0.001838,172.31.36.0-255,66,167601,8,317825
41452,0.001848,74.125.24.0-255,2902,170503,8,317825
41453,0.00185,172.31.36.0-255,66,170569,8,317825
41454,0.001888,172.31.36.0-255,66,170635,8,317825
41455,0.001894,74.125.24.0-255,6438,177073,8,317825
41456,0.001897,172.31.36.0-255,66,177139,8,317825
41457,0.001968,74.125.24.0-255,1484,178623,8,317825
41458,0.001972,74.125.24.0-255,1484,180107,8,317825
41459,0.001974,172.31.36.0-255,66,180173,8,317825
41460,0.001993,74.125.24.0-255,1484,181657,8,317825
41461,0.001999,74.125.24.0-255,5738,187395,8,317825
41462,0.002003,74.125.24.0-255,4320,191715,8,317825
41463,0.002003,172.31.36.0-255,66,191781,8,317825
41464,0.002007,172.31.36.0-255,66,191847,8,317825
41465,0.002027,172.31.36.0-255,66,191913,8,317825
41466,0.002034,74.125.24.0-255,7156,199069,8,317825
41467,0.002037,172.31.36.0-255,66,199135,8,317825
41468,0.002073,74.125.24.0-255,3602,202737,8,317825
41469,0.002076,172.31.36.0-255,66,202803,8,317825
41470,0.004068,74.125.24.0-255,1484,204287,8,317825
41471,0.004104,74.125.24.0-255,4320,208607,8,317825
41472,0.00411,172.31.36.0-255,66,208673,8,317825
41473,0.006154,74.125.24.0-255,5738,214411,8,317825
41474,0.006171,172.31.36.0-255,66,214477,8,317825
41475,0.008243,74.125.24.0-255,5738,220215,8,317825
41476,0.008259,172.31.36.0-255,66,220281,8,317825
41477,0.01033,74.125.24.0-255,5738,226019,8,317825
41478,0.010337,172.31.36.0-255,66,226085,8,317825
41479,0.012331,74.125.24.0-255,2902,228987,8,317825
41480,0.012334,172.31.36.0-255,66,229053,8,317825
41481,0.012388,74.125.24.0-255,2902,231955,8,317825
41482,0.01239,172.31.36.0-255,66,232021,8,317825
41483,0.014387,74.125.24.0-255,2902,234923,8,317825
41484,0.014395,172.31.36.0-255,66,234989,8,317825
41485,0.014435,74.125.24.0-255,2902,237891,8,317825
41486,0.014438,172.31.36.0-255,66,237957,8,317825
41487,0.016421,74.125.24.0-255,2902,240859,8,317825
41488,0.01643,172.31.36.0-255,66,240925,8,317825
41489,0.016475,74.125.24.0-255,2902,243827,8,317825
41490,0.016479,172.31.36.0-255,66,243893,8,317825
41491,0.018453,74.125.24.0-255,2902,246795,8,317825
41492,0.018461,172.31.36.0-255,66,246861,8,317825
41493,0.018483,74.125.24.0-255,2902,249763,8,317825
41494,0.018487,172.31.36.0-255,66,249829,8,317825
41495,0.020499,74.125.24.0-255,5738,255567,8,317825
41496,0.020506,172.31.36.0-255,66,255633,8,317825
41497,0.022542,74.125.24.0-255,5738,261371,8,317825
41498,0.02255,172.31.36.0-255,66,261437,8,317825
41499,0.024616,74.125.24.0-255,5738,267175,8,317825
41500,0.024624,172.31.36.0-255,66,267241,8,317825
41501,0.026677,74.125.24.0-255,5738,272979,8,317825
41502,0.026684,172.31.36.0-255,66,273045,8,317825
41503,0.028715,74.125.24.0-255,5738,278783,8,317825
41504,0.028722,172.31.36.0-255,66,278849,8,317825
41505,0.03076,74.125.24.0-255,5738,284587,8,317825
41506,0.030767,172.31.36.0-255,66,284653,8,317825
41507,0.032814,74.125.24.0-255,5738,290391,8,317825
41508,0.03282,172.31.36.0-255,66,290457,8,317825
41509,0.034853,74.125.24.0-255,5738,296195,8,317825
41510,0.034859,172.31.36.0-255,66,296261,8,317825
41511,0.036865,74.125.24.0-255,5738,301999,8,317825
41512,0.036874,172.31.36.0-255,66,302065,8,317825
41513,0.038922,74.125.24.0-255,5738,307803,8,317825
41514,0.038929,172.31.36.0-255,66,307869,8,317825
41515,0.040167,172.31.36.0-255,172,308041,8,317825
41516,0.0402,172.31.36.0-255,1111,309152,8,317825
41517,0.04024,172.31.36.0-255,1514,310666,8,317825
41518,0.040242,172.31.36.0-255,1072,311738,8,317825
41519,0.040967,74.125.24.0-255,5652,317390,8,317825
41520,0.040975,172.31.36.0-255,66,317456,8,317825
41521,0.041571,172.31.36.0-255,105,317561,8,317825
41522,0.041658,104.244.42.0-255,66,317627,8,317825
41523,0.041684,104.244.42.0-255,66,317693,8,317825
41524,0.041732,104.244.42.0-255,66,317759,8,317825
41525,0.043563,74.125.24.0-255,66,317825,8,317825
41526,0.0,172.217.194.0-255,153,153,8,271044
41527,3.2e-05,172.31.36.0-255,66,219,8,271044
41528,3.8e-05,172.217.194.0-255,1484,1703,8,271044
41529,4.3e-05,172.31.36.0-255,66,1769,8,271044
41530,4.7e-05,172.217.194.0-255,2902,4671,8,271044
41531,5e-05,172.31.36.0-255,66,4737,8,271044
41532,5.7e-05,172.217.194.0-255,7156,11893,8,271044
41533,6e-05,172.31.36.0-255,66,11959,8,271044
41534,6.4e-05,172.217.194.0-255,2049,14008,8,271044
41535,6.7e-05,172.31.36.0-255,66,14074,8,271044
41536,0.000189,172.217.194.0-255,1484,15558,8,271044
41537,0.000193,172.31.36.0-255,66,15624,8,271044
41538,0.000199,172.217.194.0-255,2902,18526,8,271044
41539,0.000202,172.31.36.0-255,66,18592,8,271044
41540,0.000207,172.217.194.0-255,4320,22912,8,271044
41541,0.000209,172.31.36.0-255,66,22978,8,271044
41542,0.000233,172.217.194.0-255,2902,25880,8,271044
41543,0.000235,172.31.36.0-255,66,25946,8,271044
41544,0.000254,172.217.194.0-255,6797,32743,8,271044
41545,0.000261,172.31.36.0-255,66,32809,8,271044
41546,0.000281,172.217.194.0-255,5738,38547,8,271044
41547,0.000284,172.31.36.0-255,66,38613,8,271044
41548,0.000313,172.31.36.0-255,66,38679,8,271044
41549,0.000326,172.31.36.0-255,66,38745,8,271044
41550,0.000348,172.217.194.0-255,2495,41240,8,271044
41551,0.000351,172.31.36.0-255,66,41306,8,271044
41552,0.00054,172.217.194.0-255,100,41406,8,271044
41553,0.000545,172.31.36.0-255,66,41472,8,271044
41554,0.000679,172.217.194.0-255,1484,42956,8,271044
41555,0.000683,172.31.36.0-255,66,43022,8,271044
41556,0.000689,172.217.194.0-255,2902,45924,8,271044
41557,0.000691,172.31.36.0-255,66,45990,8,271044
41558,0.000712,172.217.194.0-255,5738,51728,8,271044
41559,0.000716,172.31.36.0-255,66,51794,8,271044
41560,0.000721,172.217.194.0-255,4320,56114,8,271044
41561,0.000724,172.31.36.0-255,66,56180,8,271044
41562,0.000762,172.31.36.0-255,66,56246,8,271044
41563,0.000767,172.217.194.0-255,1484,57730,8,271044
41564,0.000785,172.217.194.0-255,6735,64465,8,271044
41565,0.000788,172.31.36.0-255,66,64531,8,271044
41566,0.00086,172.217.194.0-255,1484,66015,8,271044
41567,0.000865,172.217.194.0-255,2902,68917,8,271044
41568,0.000869,172.31.36.0-255,66,68983,8,271044
41569,0.000891,172.217.194.0-255,5738,74721,8,271044
41570,0.000893,172.217.194.0-255,1484,76205,8,271044
41571,0.000894,172.31.36.0-255,66,76271,8,271044
41572,0.000915,172.217.194.0-255,5738,82009,8,271044
41573,0.000918,172.31.36.0-255,66,82075,8,271044
41574,0.000943,172.217.194.0-255,5738,87813,8,271044
41575,0.000947,172.31.36.0-255,66,87879,8,271044
41576,0.000954,172.31.36.0-255,66,87945,8,271044
41577,0.001038,172.217.194.0-255,1484,89429,8,271044
41578,0.001051,172.217.194.0-255,2902,92331,8,271044
41579,0.001054,172.31.36.0-255,66,92397,8,271044
41580,0.001061,172.217.194.0-255,5738,98135,8,271044
41581,0.001064,172.31.36.0-255,66,98201,8,271044
41582,0.001082,172.31.36.0-255,66,98267,8,271044
41583,0.001135,172.217.194.0-255,7156,105423,8,271044
41584,0.00114,172.31.36.0-255,66,105489,8,271044
41585,0.001169,172.31.36.0-255,66,105555,8,271044
41586,0.001247,172.217.194.0-255,1484,107039,8,271044
41587,0.001272,172.217.194.0-255,2902,109941,8,271044
41588,0.001276,172.31.36.0-255,66,110007,8,271044
41589,0.001277,172.217.194.0-255,5738,115745,8,271044
41590,0.00128,172.31.36.0-255,66,115811,8,271044
41591,0.001287,172.217.194.0-255,7156,122967,8,271044
41592,0.001289,172.31.36.0-255,66,123033,8,271044
41593,0.001307,172.217.194.0-255,7156,130189,8,271044
41594,0.001309,172.31.36.0-255,66,130255,8,271044
41595,0.001338,172.217.194.0-255,7156,137411,8,271044
41596,0.001341,172.31.36.0-255,66,137477,8,271044
41597,0.001345,172.217.194.0-255,2184,139661,8,271044
41598,0.001347,172.31.36.0-255,66,139727,8,271044
41599,0.001382,172.217.194.0-255,1484,141211,8,271044
41600,0.001399,172.217.194.0-255,2902,144113,8,271044
41601,0.001402,172.31.36.0-255,66,144179,8,271044
41602,0.001431,172.217.194.0-255,1484,145663,8,271044
41603,0.001449,172.217.194.0-255,2902,148565,8,271044
41604,0.001452,172.31.36.0-255,66,148631,8,271044
41605,0.00147,172.217.194.0-255,5738,154369,8,271044
41606,0.001473,172.31.36.0-255,66,154435,8,271044
41607,0.001478,172.217.194.0-255,2902,157337,8,271044
41608,0.00148,172.31.36.0-255,66,157403,8,271044
41609,0.001503,172.217.194.0-255,4320,161723,8,271044
41610,0.001506,172.31.36.0-255,66,161789,8,271044
41611,0.001548,172.217.194.0-255,5738,167527,8,271044
41612,0.001552,172.31.36.0-255,66,167593,8,271044
41613,0.001571,172.217.194.0-255,6438,174031,8,271044
41614,0.001574,172.31.36.0-255,66,174097,8,271044
41615,0.001587,172.31.36.0-255,66,174163,8,271044
41616,0.001598,172.217.194.0-255,4320,178483,8,271044
41617,0.001601,172.31.36.0-255,66,178549,8,271044
41618,0.001628,172.31.36.0-255,66,178615,8,271044
41619,0.001634,172.217.194.0-255,3602,182217,8,271044
41620,0.001636,172.31.36.0-255,66,182283,8,271044
41621,0.00197,172.217.194.0-255,1484,183767,8,271044
41622,0.001975,172.217.194.0-255,2902,186669,8,271044
41623,0.001979,172.31.36.0-255,66,186735,8,271044
41624,0.001983,172.217.194.0-255,1484,188219,8,271044
41625,0.002,172.217.194.0-255,4320,192539,8,271044
41626,0.002003,172.31.36.0-255,66,192605,8,271044
41627,0.002063,172.31.36.0-255,66,192671,8,271044
41628,0.002078,172.217.194.0-255,4320,196991,8,271044
41629,0.00208,172.31.36.0-255,66,197057,8,271044
41630,0.002092,172.31.36.0-255,66,197123,8,271044
41631,0.002095,172.217.194.0-255,1484,198607,8,271044
41632,0.00211,172.217.194.0-255,2902,201509,8,271044
41633,0.002113,172.31.36.0-255,66,201575,8,271044
41634,0.002136,172.217.194.0-255,5738,207313,8,271044
41635,0.002139,172.31.36.0-255,66,207379,8,271044
41636,0.002143,172.217.194.0-255,2902,210281,8,271044
41637,0.002145,172.31.36.0-255,66,210347,8,271044
41638,0.002184,172.31.36.0-255,66,210413,8,271044
41639,0.00219,172.217.194.0-255,4320,214733,8,271044
41640,0.002192,172.31.36.0-255,66,214799,8,271044
41641,0.002216,172.217.194.0-255,5738,220537,8,271044
41642,0.002218,172.31.36.0-255,66,220603,8,271044
41643,0.002221,172.217.194.0-255,766,221369,8,271044
41644,0.002245,172.217.194.0-255,1484,222853,8,271044
41645,0.002248,172.31.36.0-255,66,222919,8,271044
41646,0.002262,172.217.194.0-255,1484,224403,8,271044
41647,0.00228,172.217.194.0-255,2902,227305,8,271044
41648,0.002283,172.31.36.0-255,66,227371,8,271044
41649,0.002289,172.217.194.0-255,4320,231691,8,271044
41650,0.002293,172.31.36.0-255,66,231757,8,271044
41651,0.002309,172.217.194.0-255,5738,237495,8,271044
41652,0.002312,172.31.36.0-255,66,237561,8,271044
41653,0.002322,172.31.36.0-255,66,237627,8,271044
41654,0.002338,172.217.194.0-255,1484,239111,8,271044
41655,0.002366,172.31.36.0-255,66,239177,8,271044
41656,0.002371,172.217.194.0-255,4320,243497,8,271044
41657,0.002373,172.31.36.0-255,66,243563,8,271044
41658,0.002375,172.217.194.0-255,1484,245047,8,271044
41659,0.002393,172.217.194.0-255,4320,249367,8,271044
41660,0.002396,172.31.36.0-255,66,249433,8,271044
41661,0.002401,172.217.194.0-255,4320,253753,8,271044
41662,0.002403,172.31.36.0-255,66,253819,8,271044
41663,0.002431,172.217.194.0-255,7156,260975,8,271044
41664,0.002434,172.31.36.0-255,66,261041,8,271044
41665,0.002439,172.217.194.0-255,4320,265361,8,271044
41666,0.002442,172.31.36.0-255,66,265427,8,271044
41667,0.002446,172.217.194.0-255,4320,269747,8,271044
41668,0.002481,172.217.194.0-255,97,269844,8,271044
41669,0.002494,172.217.194.0-255,105,269949,8,271044
41670,0.007658,172.31.36.0-255,66,270015,8,271044
41671,0.008899,172.31.36.0-255,105,270120,8,271044
41672,0.010978,172.217.194.0-255,66,270186,8,271044
41673,0.027793,172.31.36.0-255,164,270350,8,271044
41674,0.027822,172.31.36.0-255,562,270912,8,271044
41675,0.029327,104.244.42.0-255,66,270978,8,271044
41676,0.029355,104.244.42.0-255,66,271044,8,271044
41677,0.0,172.217.194.0-255,153,153,8,207372
41678,3e-05,172.31.36.0-255,66,219,8,207372
41679,3.7e-05,172.217.194.0-255,1484,1703,8,207372
41680,4.1e-05,172.31.36.0-255,66,1769,8,207372
41681,4.5e-05,172.217.194.0-255,2902,4671,8,207372
41682,4.7e-05,172.31.36.0-255,66,4737,8,207372
41683,5.2e-05,172.217.194.0-255,5738,10475,8,207372
41684,5.5e-05,172.31.36.0-255,66,10541,8,207372
41685,6.1e-05,172.217.194.0-255,6337,16878,8,207372
41686,6.4e-05,172.31.36.0-255,66,16944,8,207372
41687,8.5e-05,172.217.194.0-255,7156,24100,8,207372
41688,8.9e-05,172.31.36.0-255,66,24166,8,207372
41689,0.00011,172.217.194.0-255,6797,30963,8,207372
41690,0.000112,172.31.36.0-255,66,31029,8,207372
41691,0.000117,172.217.194.0-255,2902,33931,8,207372
41692,0.000119,172.31.36.0-255,66,33997,8,207372
41693,0.000145,172.217.194.0-255,7156,41153,8,207372
41694,0.000148,172.31.36.0-255,66,41219,8,207372
41695,0.000181,172.217.194.0-255,7156,48375,8,207372
41696,0.000183,172.31.36.0-255,66,48441,8,207372
41697,0.000201,172.217.194.0-255,1125,49566,8,207372
41698,0.000203,172.31.36.0-255,66,49632,8,207372
41699,0.000213,172.31.36.0-255,66,49698,8,207372
41700,0.000249,172.217.194.0-255,7125,56823,8,207372
41701,0.000252,172.31.36.0-255,66,56889,8,207372
41702,0.000255,172.217.194.0-255,380,57269,8,207372
41703,0.000256,172.31.36.0-255,66,57335,8,207372
41704,0.0004,172.217.194.0-255,1484,58819,8,207372
41705,0.000403,172.217.194.0-255,2902,61721,8,207372
41706,0.000405,172.31.36.0-255,66,61787,8,207372
41707,0.000409,172.31.36.0-255,66,61853,8,207372
41708,0.000424,172.217.194.0-255,5738,67591,8,207372
41709,0.000427,172.31.36.0-255,66,67657,8,207372
41710,0.000464,172.217.194.0-255,1484,69141,8,207372
41711,0.000496,172.217.194.0-255,1484,70625,8,207372
41712,0.000499,172.31.36.0-255,66,70691,8,207372
41713,0.000523,172.31.36.0-255,66,70757,8,207372
41714,0.000534,172.31.36.0-255,66,70823,8,207372
41715,0.000558,172.217.194.0-255,2543,73366,8,207372
41716,0.00056,172.31.36.0-255,66,73432,8,207372
41717,0.000962,172.217.194.0-255,1484,74916,8,207372
41718,0.00098,172.217.194.0-255,2902,77818,8,207372
41719,0.000984,172.31.36.0-255,66,77884,8,207372
41720,0.000989,172.217.194.0-255,2902,80786,8,207372
41721,0.00099,172.31.36.0-255,66,80852,8,207372
41722,0.001004,172.217.194.0-255,2902,83754,8,207372
41723,0.001006,172.31.36.0-255,66,83820,8,207372
41724,0.00101,172.217.194.0-255,2902,86722,8,207372
41725,0.001011,172.31.36.0-255,66,86788,8,207372
41726,0.001053,172.31.36.0-255,66,86854,8,207372
41727,0.001063,172.31.36.0-255,66,86920,8,207372
41728,0.001187,172.217.194.0-255,1484,88404,8,207372
41729,0.001193,172.217.194.0-255,2902,91306,8,207372
41730,0.001196,172.31.36.0-255,66,91372,8,207372
41731,0.001201,172.217.194.0-255,5738,97110,8,207372
41732,0.001203,172.31.36.0-255,66,97176,8,207372
41733,0.001226,172.217.194.0-255,2902,100078,8,207372
41734,0.001229,172.31.36.0-255,66,100144,8,207372
41735,0.001262,172.217.194.0-255,7156,107300,8,207372
41736,0.001266,172.31.36.0-255,66,107366,8,207372
41737,0.001273,172.31.36.0-255,66,107432,8,207372
41738,0.001277,172.217.194.0-255,3602,111034,8,207372
41739,0.001279,172.31.36.0-255,66,111100,8,207372
41740,0.001324,172.217.194.0-255,1484,112584,8,207372
41741,0.001328,172.217.194.0-255,2902,115486,8,207372
41742,0.001331,172.31.36.0-255,66,115552,8,207372
41743,0.001354,172.217.194.0-255,5738,121290,8,207372
41744,0.001357,172.31.36.0-255,66,121356,8,207372
41745,0.001387,172.31.36.0-255,66,121422,8,207372
41746,0.001407,172.217.194.0-255,1484,122906,8,207372
41747,0.001421,172.31.36.0-255,66,122972,8,207372
41748,0.001444,172.217.194.0-255,3602,126574,8,207372
41749,0.001447,172.31.36.0-255,66,126640,8,207372
41750,0.001497,172.31.36.0-255,66,126706,8,207372
41751,0.001514,172.217.194.0-255,1484,128190,8,207372
41752,0.001524,172.217.194.0-255,1484,129674,8,207372
41753,0.001527,172.217.194.0-255,2902,132576,8,207372
41754,0.001531,172.31.36.0-255,66,132642,8,207372
41755,0.001534,172.31.36.0-255,66,132708,8,207372
41756,0.001541,172.217.194.0-255,1484,134192,8,207372
41757,0.001567,172.217.194.0-255,4320,138512,8,207372
41758,0.001569,172.31.36.0-255,66,138578,8,207372
41759,0.001575,172.217.194.0-255,7156,145734,8,207372
41760,0.001581,172.31.36.0-255,66,145800,8,207372
41761,0.001587,172.217.194.0-255,5738,151538,8,207372
41762,0.001589,172.31.36.0-255,66,151604,8,207372
41763,0.001619,172.31.36.0-255,66,151670,8,207372
41764,0.001622,172.217.194.0-255,2184,153854,8,207372
41765,0.001624,172.31.36.0-255,66,153920,8,207372
41766,0.001702,172.217.194.0-255,1484,155404,8,207372
41767,0.001705,172.217.194.0-255,1484,156888,8,207372
41768,0.001707,172.31.36.0-255,66,156954,8,207372
41769,0.001723,172.217.194.0-255,1484,158438,8,207372
41770,0.001729,172.217.194.0-255,5738,164176,8,207372
41771,0.001731,172.31.36.0-255,66,164242,8,207372
41772,0.001748,172.217.194.0-255,2902,167144,8,207372
41773,0.00175,172.31.36.0-255,66,167210,8,207372
41774,0.001771,172.217.194.0-255,5738,172948,8,207372
41775,0.001774,172.31.36.0-255,66,173014,8,207372
41776,0.001795,172.217.194.0-255,4320,177334,8,207372
41777,0.001797,172.31.36.0-255,66,177400,8,207372
41778,0.001805,172.31.36.0-255,66,177466,8,207372
41779,0.001823,172.217.194.0-255,2184,179650,8,207372
41780,0.001825,172.31.36.0-255,66,179716,8,207372
41781,0.00184,172.217.194.0-255,4320,184036,8,207372
41782,0.001842,172.31.36.0-255,66,184102,8,207372
41783,0.00188,172.31.36.0-255,66,184168,8,207372
41784,0.001898,172.217.194.0-255,4320,188488,8,207372
41785,0.001903,172.217.194.0-255,5738,194226,8,207372
41786,0.001905,172.31.36.0-255,66,194292,8,207372
41787,0.001908,172.31.36.0-255,66,194358,8,207372
41788,0.001937,172.217.194.0-255,2184,196542,8,207372
41789,0.001939,172.31.36.0-255,66,196608,8,207372
41790,0.001962,172.31.36.0-255,66,196674,8,207372
41791,0.001974,172.31.36.0-255,66,196740,8,207372
41792,0.002016,172.31.36.0-255,66,196806,8,207372
41793,0.002029,172.31.36.0-255,66,196872,8,207372
41794,0.002031,172.217.194.0-255,105,196977,8,207372
41795,0.003832,172.31.36.0-255,66,197043,8,207372
41796,0.00388,172.31.36.0-255,105,197148,8,207372
41797,0.006196,172.217.194.0-255,66,197214,8,207372
41798,0.034014,172.31.36.0-255,164,197378,8,207372
41799,0.034054,172.31.36.0-255,1118,198496,8,207372
41800,0.034326,172.31.36.0-255,1514,200010,8,207372
41801,0.034329,172.31.36.0-255,1514,201524,8,207372
41802,0.034334,172.31.36.0-255,1514,203038,8,207372
41803,0.034335,172.31.36.0-255,1514,204552,8,207372
41804,0.034358,172.31.36.0-255,1514,206066,8,207372
41805,0.034367,172.31.36.0-255,868,206934,8,207372
41806,0.035579,104.244.42.0-255,66,207000,8,207372
41807,0.035616,104.244.42.0-255,66,207066,8,207372
41808,0.035921,104.244.42.0-255,66,207132,8,207372
41809,0.035928,104.244.42.0-255,66,207198,8,207372
41810,0.039386,172.31.36.0-255,108,207306,8,207372
41811,0.04095,104.244.42.0-255,66,207372,8,207372
41812,0.0,74.125.24.0-255,143,143,8,301602
41813,2.6e-05,172.31.36.0-255,66,209,8,301602
41814,3.3e-05,74.125.24.0-255,1484,1693,8,301602
41815,3.7e-05,172.31.36.0-255,66,1759,8,301602
41816,4.2e-05,74.125.24.0-255,2902,4661,8,301602
41817,5.2e-05,172.31.36.0-255,66,4727,8,301602
41818,5.9e-05,74.125.24.0-255,7156,11883,8,301602
41819,6.2e-05,172.31.36.0-255,66,11949,8,301602
41820,6.5e-05,74.125.24.0-255,2038,13987,8,301602
41821,6.8e-05,172.31.36.0-255,66,14053,8,301602
41822,0.000213,74.125.24.0-255,1484,15537,8,301602
41823,0.000218,172.31.36.0-255,66,15603,8,301602
41824,0.000224,74.125.24.0-255,2902,18505,8,301602
41825,0.000227,172.31.36.0-255,66,18571,8,301602
41826,0.000238,74.125.24.0-255,2902,21473,8,301602
41827,0.00024,172.31.36.0-255,66,21539,8,301602
41828,0.000268,74.125.24.0-255,2902,24441,8,301602
41829,0.000271,172.31.36.0-255,66,24507,8,301602
41830,0.000285,172.31.36.0-255,66,24573,8,301602
41831,0.000292,74.125.24.0-255,7156,31729,8,301602
41832,0.000295,172.31.36.0-255,66,31795,8,301602
41833,0.000322,74.125.24.0-255,4320,36115,8,301602
41834,0.000325,172.31.36.0-255,66,36181,8,301602
41835,0.000338,172.31.36.0-255,66,36247,8,301602
41836,0.00035,74.125.24.0-255,1484,37731,8,301602
41837,0.000352,172.31.36.0-255,66,37797,8,301602
41838,0.000379,74.125.24.0-255,5318,43115,8,301602
41839,0.000382,172.31.36.0-255,66,43181,8,301602
41840,0.0004,74.125.24.0-255,381,43562,8,301602
41841,0.000402,172.31.36.0-255,66,43628,8,301602
41842,0.000524,74.125.24.0-255,1484,45112,8,301602
41843,0.000544,74.125.24.0-255,2902,48014,8,301602
41844,0.000547,172.31.36.0-255,66,48080,8,301602
41845,0.000553,74.125.24.0-255,4320,52400,8,301602
41846,0.000557,172.31.36.0-255,66,52466,8,301602
41847,0.000578,74.125.24.0-255,1484,53950,8,301602
41848,0.000589,74.125.24.0-255,5738,59688,8,301602
41849,0.000592,172.31.36.0-255,66,59754,8,301602
41850,0.000598,74.125.24.0-255,4320,64074,8,301602
41851,0.0006,172.31.36.0-255,66,64140,8,301602
41852,0.000641,172.31.36.0-255,66,64206,8,301602
41853,0.000642,74.125.24.0-255,5020,69226,8,301602
41854,0.000645,172.31.36.0-255,66,69292,8,301602
41855,0.00075,74.125.24.0-255,1484,70776,8,301602
41856,0.00077,74.125.24.0-255,2902,73678,8,301602
41857,0.000773,172.31.36.0-255,66,73744,8,301602
41858,0.00078,74.125.24.0-255,5738,79482,8,301602
41859,0.000782,172.31.36.0-255,66,79548,8,301602
41860,0.000843,172.31.36.0-255,66,79614,8,301602
41861,0.000851,74.125.24.0-255,7156,86770,8,301602
41862,0.000854,172.31.36.0-255,66,86836,8,301602
41863,0.000887,74.125.24.0-255,3602,90438,8,301602
41864,0.00089,172.31.36.0-255,66,90504,8,301602
41865,0.00095,74.125.24.0-255,1484,91988,8,301602
41866,0.000957,74.125.24.0-255,2902,94890,8,301602
41867,0.000959,172.31.36.0-255,66,94956,8,301602
41868,0.000988,74.125.24.0-255,2902,97858,8,301602
41869,0.000991,172.31.36.0-255,66,97924,8,301602
41870,0.000998,74.125.24.0-255,7156,105080,8,301602
41871,0.001001,172.31.36.0-255,66,105146,8,301602
41872,0.001047,172.31.36.0-255,66,105212,8,301602
41873,0.001052,74.125.24.0-255,3602,108814,8,301602
41874,0.001054,172.31.36.0-255,66,108880,8,301602
41875,0.0012,74.125.24.0-255,1484,110364,8,301602
41876,0.001215,74.125.24.0-255,2902,113266,8,301602
41877,0.00122,172.31.36.0-255,66,113332,8,301602
41878,0.001242,74.125.24.0-255,4320,117652,8,301602
41879,0.001245,172.31.36.0-255,66,117718,8,301602
41880,0.00125,74.125.24.0-255,2902,120620,8,301602
41881,0.001253,172.31.36.0-255,66,120686,8,301602
41882,0.001285,74.125.24.0-255,5738,126424,8,301602
41883,0.001288,172.31.36.0-255,66,126490,8,301602
41884,0.001295,74.125.24.0-255,7156,133646,8,301602
41885,0.001297,172.31.36.0-255,66,133712,8,301602
41886,0.001334,74.125.24.0-255,7156,140868,8,301602
41887,0.001338,172.31.36.0-255,66,140934,8,301602
41888,0.001377,74.125.24.0-255,1484,142418,8,301602
41889,0.001389,74.125.24.0-255,766,143184,8,301602
41890,0.001397,172.31.36.0-255,66,143250,8,301602
41891,0.00154,74.125.24.0-255,1484,144734,8,301602
41892,0.001546,74.125.24.0-255,2902,147636,8,301602
41893,0.001549,172.31.36.0-255,66,147702,8,301602
41894,0.001581,74.125.24.0-255,5738,153440,8,301602
41895,0.001585,172.31.36.0-255,66,153506,8,301602
41896,0.001596,172.31.36.0-255,66,153572,8,301602
41897,0.001611,172.31.36.0-255,66,153638,8,301602
41898,0.001646,74.125.24.0-255,5020,158658,8,301602
41899,0.001649,172.31.36.0-255,66,158724,8,301602
41900,0.002139,74.125.24.0-255,1484,160208,8,301602
41901,0.002145,74.125.24.0-255,2902,163110,8,301602
41902,0.002148,172.31.36.0-255,66,163176,8,301602
41903,0.002154,74.125.24.0-255,4320,167496,8,301602
41904,0.002156,172.31.36.0-255,66,167562,8,301602
41905,0.002192,74.125.24.0-255,1484,169046,8,301602
41906,0.002222,172.31.36.0-255,66,169112,8,301602
41907,0.002232,172.31.36.0-255,66,169178,8,301602
41908,0.002286,172.31.36.0-255,66,169244,8,301602
41909,0.002298,172.31.36.0-255,66,169310,8,301602
41910,0.002312,74.125.24.0-255,4320,173630,8,301602
41911,0.002314,172.31.36.0-255,66,173696,8,301602
41912,0.002326,74.125.24.0-255,5020,178716,8,301602
41913,0.002328,172.31.36.0-255,66,178782,8,301602
41914,0.004609,74.125.24.0-255,5738,184520,8,301602
41915,0.004616,172.31.36.0-255,66,184586,8,301602
41916,0.006871,74.125.24.0-255,5738,190324,8,301602
41917,0.006877,172.31.36.0-255,66,190390,8,301602
41918,0.009208,74.125.24.0-255,4320,194710,8,301602
41919,0.009214,172.31.36.0-255,66,194776,8,301602
41920,0.009245,74.125.24.0-255,1484,196260,8,301602
41921,0.011496,74.125.24.0-255,4320,200580,8,301602
41922,0.011505,172.31.36.0-255,66,200646,8,301602
41923,0.013773,74.125.24.0-255,5738,206384,8,301602
41924,0.013779,172.31.36.0-255,66,206450,8,301602
41925,0.016049,74.125.24.0-255,5738,212188,8,301602
41926,0.016058,172.31.36.0-255,66,212254,8,301602
41927,0.018312,74.125.24.0-255,5738,217992,8,301602
41928,0.018319,172.31.36.0-255,66,218058,8,301602
41929,0.020583,74.125.24.0-255,5738,223796,8,301602
41930,0.020595,172.31.36.0-255,66,223862,8,301602
41931,0.022894,74.125.24.0-255,4320,228182,8,301602
41932,0.0229,172.31.36.0-255,66,228248,8,301602
41933,0.022937,74.125.24.0-255,1484,229732,8,301602
41934,0.025173,74.125.24.0-255,4320,234052,8,301602
41935,0.025182,172.31.36.0-255,66,234118,8,301602
41936,0.027434,74.125.24.0-255,5738,239856,8,301602
41937,0.027441,172.31.36.0-255,66,239922,8,301602
41938,0.029717,74.125.24.0-255,5738,245660,8,301602
41939,0.029724,172.31.36.0-255,66,245726,8,301602
41940,0.032025,74.125.24.0-255,5738,251464,8,301602
41941,0.032033,172.31.36.0-255,66,251530,8,301602
41942,0.033114,172.31.36.0-255,172,251702,8,301602
41943,0.033146,172.31.36.0-255,1110,252812,8,301602
41944,0.033185,172.31.36.0-255,1514,254326,8,301602
41945,0.033187,172.31.36.0-255,1514,255840,8,301602
41946,0.033194,172.31.36.0-255,1514,257354,8,301602
41947,0.033195,172.31.36.0-255,1514,258868,8,301602
41948,0.033213,172.31.36.0-255,1514,260382,8,301602
41949,0.033219,172.31.36.0-255,996,261378,8,301602
41950,0.034311,74.125.24.0-255,5738,267116,8,301602
41951,0.034318,172.31.36.0-255,66,267182,8,301602
41952,0.034708,104.244.42.0-255,66,267248,8,301602
41953,0.034716,104.244.42.0-255,66,267314,8,301602
41954,0.034772,104.244.42.0-255,66,267380,8,301602
41955,0.034797,104.244.42.0-255,66,267446,8,301602
41956,0.036579,74.125.24.0-255,5738,273184,8,301602
41957,0.036587,172.31.36.0-255,66,273250,8,301602
41958,0.03885,74.125.24.0-255,5738,278988,8,301602
41959,0.038858,172.31.36.0-255,66,279054,8,301602
41960,0.041135,74.125.24.0-255,5738,284792,8,301602
41961,0.041142,172.31.36.0-255,66,284858,8,301602
41962,0.043458,74.125.24.0-255,5738,290596,8,301602
41963,0.043469,172.31.36.0-255,66,290662,8,301602
41964,0.045755,74.125.24.0-255,5738,296400,8,301602
41965,0.045762,172.31.36.0-255,66,296466,8,301602
41966,0.047494,172.31.36.0-255,108,296574,8,301602
41967,0.048208,74.125.24.0-255,4725,301299,8,301602
41968,0.048269,172.31.36.0-255,66,301365,8,301602
41969,0.048673,172.31.36.0-255,105,301470,8,301602
41970,0.049075,104.244.42.0-255,66,301536,8,301602
41971,0.050898,74.125.24.0-255,66,301602,8,301602
41972,0.0,74.125.24.0-255,294,294,8,197610
41973,2e-05,172.31.36.0-255,66,360,8,197610
41974,2.6e-05,74.125.24.0-255,1484,1844,8,197610
41975,3e-05,172.31.36.0-255,66,1910,8,197610
41976,3.9e-05,74.125.24.0-255,4320,6230,8,197610
41977,4.2e-05,172.31.36.0-255,66,6296,8,197610
41978,5.4e-05,172.31.36.0-255,66,6362,8,197610
41979,6.6e-05,172.31.36.0-255,66,6428,8,197610
41980,9.7e-05,172.31.36.0-255,66,6494,8,197610
41981,0.000118,74.125.24.0-255,4320,10814,8,197610
41982,0.000121,172.31.36.0-255,66,10880,8,197610
41983,0.000129,74.125.24.0-255,6438,17318,8,197610
41984,0.000131,172.31.36.0-255,66,17384,8,197610
41985,0.000152,172.31.36.0-255,66,17450,8,197610
41986,0.000186,172.31.36.0-255,66,17516,8,197610
41987,0.000189,74.125.24.0-255,111,17627,8,197610
41988,0.000191,172.31.36.0-255,66,17693,8,197610
41989,0.000329,74.125.24.0-255,1484,19177,8,197610
41990,0.000334,172.31.36.0-255,66,19243,8,197610
41991,0.00034,74.125.24.0-255,2902,22145,8,197610
41992,0.000342,172.31.36.0-255,66,22211,8,197610
41993,0.000347,74.125.24.0-255,2902,25113,8,197610
41994,0.00035,172.31.36.0-255,66,25179,8,197610
41995,0.000371,74.125.24.0-255,2902,28081,8,197610
41996,0.000374,172.31.36.0-255,66,28147,8,197610
41997,0.000389,172.31.36.0-255,66,28213,8,197610
41998,0.000504,172.31.36.0-255,66,28279,8,197610
41999,0.00065,74.125.24.0-255,1484,29763,8,197610
42000,0.000657,74.125.24.0-255,2902,32665,8,197610
42001,0.000682,74.125.24.0-255,5738,38403,8,197610
42002,0.000688,74.125.24.0-255,4320,42723,8,197610
42003,0.000695,172.31.36.0-255,66,42789,8,197610
42004,0.000713,74.125.24.0-255,4320,47109,8,197610
42005,0.000725,172.31.36.0-255,66,47175,8,197610
42006,0.000758,74.125.24.0-255,6438,53613,8,197610
42007,0.00078,74.125.24.0-255,7156,60769,8,197610
42008,0.000795,172.31.36.0-255,66,60835,8,197610
42009,0.000807,74.125.24.0-255,7156,67991,8,197610
42010,0.000813,172.31.36.0-255,66,68057,8,197610
42011,0.000848,172.31.36.0-255,66,68123,8,197610
42012,0.000859,74.125.24.0-255,5738,73861,8,197610
42013,0.000864,172.31.36.0-255,66,73927,8,197610
42014,0.000878,74.125.24.0-255,5020,78947,8,197610
42015,0.000939,74.125.24.0-255,2902,81849,8,197610
42016,0.000979,172.31.36.0-255,66,81915,8,197610
42017,0.000982,74.125.24.0-255,1484,83399,8,197610
42018,0.001009,74.125.24.0-255,7156,90555,8,197610
42019,0.001013,172.31.36.0-255,66,90621,8,197610
42020,0.001021,74.125.24.0-255,1484,92105,8,197610
42021,0.00105,172.31.36.0-255,66,92171,8,197610
42022,0.001063,74.125.24.0-255,4320,96491,8,197610
42023,0.001097,172.31.36.0-255,66,96557,8,197610
42024,0.001114,74.125.24.0-255,1484,98041,8,197610
42025,0.001117,74.125.24.0-255,1484,99525,8,197610
42026,0.001125,172.31.36.0-255,66,99591,8,197610
42027,0.001132,74.125.24.0-255,1484,101075,8,197610
42028,0.001135,74.125.24.0-255,1484,102559,8,197610
42029,0.00114,172.31.36.0-255,66,102625,8,197610
42030,0.001151,74.125.24.0-255,4320,106945,8,197610
42031,0.001155,74.125.24.0-255,1484,108429,8,197610
42032,0.001196,172.31.36.0-255,66,108495,8,197610
42033,0.001212,74.125.24.0-255,7156,115651,8,197610
42034,0.001232,74.125.24.0-255,6438,122089,8,197610
42035,0.001242,172.31.36.0-255,66,122155,8,197610
42036,0.001485,74.125.24.0-255,1484,123639,8,197610
42037,0.001492,74.125.24.0-255,2902,126541,8,197610
42038,0.001508,74.125.24.0-255,5738,132279,8,197610
42039,0.001514,172.31.36.0-255,66,132345,8,197610
42040,0.001524,74.125.24.0-255,1484,133829,8,197610
42041,0.00153,74.125.24.0-255,4320,138149,8,197610
42042,0.001546,74.125.24.0-255,4320,142469,8,197610
42043,0.001567,74.125.24.0-255,7156,149625,8,197610
42044,0.001572,172.31.36.0-255,66,149691,8,197610
42045,0.001591,74.125.24.0-255,6438,156129,8,197610
42046,0.001607,172.31.36.0-255,66,156195,8,197610
42047,0.001689,74.125.24.0-255,1484,157679,8,197610
42048,0.001695,74.125.24.0-255,2902,160581,8,197610
42049,0.001714,74.125.24.0-255,5738,166319,8,197610
42050,0.00172,172.31.36.0-255,66,166385,8,197610
42051,0.001786,74.125.24.0-255,5020,171405,8,197610
42052,0.001796,172.31.36.0-255,66,171471,8,197610
42053,0.001808,74.125.24.0-255,1484,172955,8,197610
42054,0.001812,74.125.24.0-255,1484,174439,8,197610
42055,0.001828,74.125.24.0-255,1484,175923,8,197610
42056,0.001834,74.125.24.0-255,5738,181661,8,197610
42057,0.001847,172.31.36.0-255,66,181727,8,197610
42058,0.001866,172.31.36.0-255,66,181793,8,197610
42059,0.001883,74.125.24.0-255,2902,184695,8,197610
42060,0.001926,74.125.24.0-255,4320,189015,8,197610
42061,0.001941,74.125.24.0-255,5020,194035,8,197610
42062,0.001956,172.31.36.0-255,66,194101,8,197610
42063,0.002009,74.125.24.0-255,105,194206,8,197610
42064,0.002026,172.31.36.0-255,66,194272,8,197610
42065,0.011726,172.31.36.0-255,105,194377,8,197610
42066,0.014039,74.125.24.0-255,66,194443,8,197610
42067,0.032559,172.31.36.0-255,172,194615,8,197610
42068,0.032594,172.31.36.0-255,1111,195726,8,197610
42069,0.032654,172.31.36.0-255,1512,197238,8,197610
42070,0.034122,104.244.42.0-255,66,197304,8,197610
42071,0.034154,104.244.42.0-255,66,197370,8,197610
42072,0.034191,104.244.42.0-255,66,197436,8,197610
42073,0.035112,104.244.42.0-255,108,197544,8,197610
42074,0.035118,172.31.36.0-255,66,197610,8,197610
42075,0.0,74.125.130.0-255,153,153,8,315196
42076,3.7e-05,172.31.36.0-255,66,219,8,315196
42077,4.5e-05,74.125.130.0-255,1484,1703,8,315196
42078,5e-05,172.31.36.0-255,66,1769,8,315196
42079,5.5e-05,74.125.130.0-255,2902,4671,8,315196
42080,5.9e-05,172.31.36.0-255,66,4737,8,315196
42081,6.5e-05,74.125.130.0-255,5738,10475,8,315196
42082,6.8e-05,172.31.36.0-255,66,10541,8,315196
42083,0.000114,74.125.130.0-255,3523,14064,8,315196
42084,0.000117,172.31.36.0-255,66,14130,8,315196
42085,0.00018,74.125.130.0-255,1484,15614,8,315196
42086,0.000183,172.31.36.0-255,66,15680,8,315196
42087,0.000187,74.125.130.0-255,1484,17164,8,315196
42088,0.000189,172.31.36.0-255,66,17230,8,315196
42089,0.000204,74.125.130.0-255,1484,18714,8,315196
42090,0.000207,172.31.36.0-255,66,18780,8,315196
42091,0.000212,74.125.130.0-255,4320,23100,8,315196
42092,0.000214,172.31.36.0-255,66,23166,8,315196
42093,0.000222,74.125.130.0-255,5738,28904,8,315196
42094,0.000225,172.31.36.0-255,66,28970,8,315196
42095,0.000262,74.125.130.0-255,2543,31513,8,315196
42096,0.000266,172.31.36.0-255,66,31579,8,315196
42097,0.00057,74.125.130.0-255,1484,33063,8,315196
42098,0.000575,172.31.36.0-255,66,33129,8,315196
42099,0.00059,74.125.130.0-255,2902,36031,8,315196
42100,0.000595,172.31.36.0-255,66,36097,8,315196
42101,0.000608,74.125.130.0-255,5738,41835,8,315196
42102,0.00061,172.31.36.0-255,66,41901,8,315196
42103,0.000615,74.125.130.0-255,2902,44803,8,315196
42104,0.000617,172.31.36.0-255,66,44869,8,315196
42105,0.000646,74.125.130.0-255,1484,46353,8,315196
42106,0.00065,172.31.36.0-255,66,46419,8,315196
42107,0.000683,172.31.36.0-255,66,46485,8,315196
42108,0.000691,74.125.130.0-255,5738,52223,8,315196
42109,0.000693,172.31.36.0-255,66,52289,8,315196
42110,0.000715,74.125.130.0-255,4234,56523,8,315196
42111,0.000718,172.31.36.0-255,66,56589,8,315196
42112,0.000812,74.125.130.0-255,403,56992,8,315196
42113,0.000936,74.125.130.0-255,1484,58476,8,315196
42114,0.000938,172.31.36.0-255,66,58542,8,315196
42115,0.00095,74.125.130.0-255,2902,61444,8,315196
42116,0.000953,172.31.36.0-255,66,61510,8,315196
42117,0.000981,74.125.130.0-255,5738,67248,8,315196
42118,0.000985,172.31.36.0-255,66,67314,8,315196
42119,0.000997,74.125.130.0-255,6797,74111,8,315196
42120,0.001,172.31.36.0-255,66,74177,8,315196
42121,0.001066,74.125.130.0-255,1484,75661,8,315196
42122,0.001081,74.125.130.0-255,2902,78563,8,315196
42123,0.001084,172.31.36.0-255,66,78629,8,315196
42124,0.001105,74.125.130.0-255,4320,82949,8,315196
42125,0.001109,172.31.36.0-255,66,83015,8,315196
42126,0.001126,74.125.130.0-255,1484,84499,8,315196
42127,0.001133,74.125.130.0-255,6797,91296,8,315196
42128,0.001136,172.31.36.0-255,66,91362,8,315196
42129,0.001305,74.125.130.0-255,1484,92846,8,315196
42130,0.001315,74.125.130.0-255,2902,95748,8,315196
42131,0.001318,172.31.36.0-255,66,95814,8,315196
42132,0.001322,74.125.130.0-255,1484,97298,8,315196
42133,0.001337,74.125.130.0-255,1484,98782,8,315196
42134,0.001339,172.31.36.0-255,66,98848,8,315196
42135,0.001344,74.125.130.0-255,2902,101750,8,315196
42136,0.001346,172.31.36.0-255,66,101816,8,315196
42137,0.001364,74.125.130.0-255,4320,106136,8,315196
42138,0.001366,172.31.36.0-255,66,106202,8,315196
42139,0.001401,172.31.36.0-255,66,106268,8,315196
42140,0.001433,74.125.130.0-255,4320,110588,8,315196
42141,0.001437,172.31.36.0-255,66,110654,8,315196
42142,0.001456,74.125.130.0-255,5020,115674,8,315196
42143,0.001459,172.31.36.0-255,66,115740,8,315196
42144,0.001721,74.125.130.0-255,1484,117224,8,315196
42145,0.001727,74.125.130.0-255,1484,118708,8,315196
42146,0.00173,172.31.36.0-255,66,118774,8,315196
42147,0.001749,74.125.130.0-255,1484,120258,8,315196
42148,0.001756,74.125.130.0-255,4320,124578,8,315196
42149,0.001758,172.31.36.0-255,66,124644,8,315196
42150,0.001796,172.31.36.0-255,66,124710,8,315196
42151,0.001821,74.125.130.0-255,5738,130448,8,315196
42152,0.001824,172.31.36.0-255,66,130514,8,315196
42153,0.001843,74.125.130.0-255,4320,134834,8,315196
42154,0.001845,172.31.36.0-255,66,134900,8,315196
42155,0.001851,74.125.130.0-255,4320,139220,8,315196
42156,0.001853,172.31.36.0-255,66,139286,8,315196
42157,0.00188,74.125.130.0-255,2184,141470,8,315196
42158,0.001883,172.31.36.0-255,66,141536,8,315196
42159,0.002215,74.125.130.0-255,1484,143020,8,315196
42160,0.002223,74.125.130.0-255,2902,145922,8,315196
42161,0.002227,172.31.36.0-255,66,145988,8,315196
42162,0.002259,74.125.130.0-255,2902,148890,8,315196
42163,0.002262,172.31.36.0-255,66,148956,8,315196
42164,0.002279,74.125.130.0-255,2902,151858,8,315196
42165,0.002281,172.31.36.0-255,66,151924,8,315196
42166,0.002287,74.125.130.0-255,4320,156244,8,315196
42167,0.00229,172.31.36.0-255,66,156310,8,315196
42168,0.002301,74.125.130.0-255,2902,159212,8,315196
42169,0.002303,172.31.36.0-255,66,159278,8,315196
42170,0.002315,74.125.130.0-255,1484,160762,8,315196
42171,0.002337,74.125.130.0-255,5738,166500,8,315196
42172,0.002339,172.31.36.0-255,66,166566,8,315196
42173,0.00235,172.31.36.0-255,66,166632,8,315196
42174,0.002353,74.125.130.0-255,766,167398,8,315196
42175,0.004911,74.125.130.0-255,4320,171718,8,315196
42176,0.004915,172.31.36.0-255,66,171784,8,315196
42177,0.007521,74.125.130.0-255,5738,177522,8,315196
42178,0.007533,172.31.36.0-255,66,177588,8,315196
42179,0.010128,74.125.130.0-255,5738,183326,8,315196
42180,0.010139,172.31.36.0-255,66,183392,8,315196
42181,0.01272,74.125.130.0-255,5738,189130,8,315196
42182,0.012734,172.31.36.0-255,66,189196,8,315196
42183,0.015314,74.125.130.0-255,5738,194934,8,315196
42184,0.015328,172.31.36.0-255,66,195000,8,315196
42185,0.017915,74.125.130.0-255,5738,200738,8,315196
42186,0.017932,172.31.36.0-255,66,200804,8,315196
42187,0.020541,74.125.130.0-255,5738,206542,8,315196
42188,0.020554,172.31.36.0-255,66,206608,8,315196
42189,0.02313,74.125.130.0-255,5738,212346,8,315196
42190,0.023139,172.31.36.0-255,66,212412,8,315196
42191,0.025734,74.125.130.0-255,5738,218150,8,315196
42192,0.025746,172.31.36.0-255,66,218216,8,315196
42193,0.028335,74.125.130.0-255,5738,223954,8,315196
42194,0.028351,172.31.36.0-255,66,224020,8,315196
42195,0.030952,74.125.130.0-255,5738,229758,8,315196
42196,0.030969,172.31.36.0-255,66,229824,8,315196
42197,0.033557,74.125.130.0-255,5738,235562,8,315196
42198,0.033566,172.31.36.0-255,66,235628,8,315196
42199,0.034147,172.31.36.0-255,221,235849,8,315196
42200,0.034195,172.31.36.0-255,562,236411,8,315196
42201,0.03614,74.125.130.0-255,5738,242149,8,315196
42202,0.036149,172.31.36.0-255,66,242215,8,315196
42203,0.03638,104.244.42.0-255,66,242281,8,315196
42204,0.038708,74.125.130.0-255,4320,246601,8,315196
42205,0.038715,172.31.36.0-255,66,246667,8,315196
42206,0.038745,74.125.130.0-255,1484,248151,8,315196
42207,0.041282,74.125.130.0-255,4320,252471,8,315196
42208,0.041289,172.31.36.0-255,66,252537,8,315196
42209,0.043857,74.125.130.0-255,4320,256857,8,315196
42210,0.043864,172.31.36.0-255,66,256923,8,315196
42211,0.043893,74.125.130.0-255,1484,258407,8,315196
42212,0.046426,74.125.130.0-255,4320,262727,8,315196
42213,0.046432,172.31.36.0-255,66,262793,8,315196
42214,0.049,74.125.130.0-255,5738,268531,8,315196
42215,0.049008,172.31.36.0-255,66,268597,8,315196
42216,0.051584,74.125.130.0-255,5738,274335,8,315196
42217,0.051596,172.31.36.0-255,66,274401,8,315196
42218,0.054172,74.125.130.0-255,5738,280139,8,315196
42219,0.054181,172.31.36.0-255,66,280205,8,315196
42220,0.056753,74.125.130.0-255,5738,285943,8,315196
42221,0.056763,172.31.36.0-255,66,286009,8,315196
42222,0.059362,74.125.130.0-255,5738,291747,8,315196
42223,0.059378,172.31.36.0-255,66,291813,8,315196
42224,0.05958,172.31.36.0-255,101,291914,8,315196
42225,0.061949,74.125.130.0-255,5738,297652,8,315196
42226,0.061955,172.31.36.0-255,66,297718,8,315196
42227,0.062116,74.125.130.0-255,66,297784,8,315196
42228,0.064552,74.125.130.0-255,5738,303522,8,315196
42229,0.064558,172.31.36.0-255,66,303588,8,315196
42230,0.067149,74.125.130.0-255,5738,309326,8,315196
42231,0.067155,172.31.36.0-255,66,309392,8,315196
42232,0.069721,74.125.130.0-255,5738,315130,8,315196
42233,0.069727,172.31.36.0-255,66,315196,8,315196
42234,0.0,74.125.24.0-255,153,153,8,272708
42235,2e-05,172.31.36.0-255,66,219,8,272708
42236,2.7e-05,74.125.24.0-255,1484,1703,8,272708
42237,3.1e-05,172.31.36.0-255,66,1769,8,272708
42238,3.7e-05,74.125.24.0-255,2902,4671,8,272708
42239,4.1e-05,172.31.36.0-255,66,4737,8,272708
42240,4.9e-05,74.125.24.0-255,7156,11893,8,272708
42241,5.1e-05,172.31.36.0-255,66,11959,8,272708
42242,5.5e-05,74.125.24.0-255,2086,14045,8,272708
42243,5.9e-05,172.31.36.0-255,66,14111,8,272708
42244,6.4e-05,74.125.24.0-255,2902,17013,8,272708
42245,6.8e-05,172.31.36.0-255,66,17079,8,272708
42246,9.5e-05,74.125.24.0-255,7156,24235,8,272708
42247,9.8e-05,172.31.36.0-255,66,24301,8,272708
42248,0.000101,74.125.24.0-255,1484,25785,8,272708
42249,0.000103,172.31.36.0-255,66,25851,8,272708
42250,0.000123,74.125.24.0-255,5379,31230,8,272708
42251,0.000125,172.31.36.0-255,66,31296,8,272708
42252,0.000214,74.125.24.0-255,1484,32780,8,272708
42253,0.000217,172.31.36.0-255,66,32846,8,272708
42254,0.000221,74.125.24.0-255,1484,34330,8,272708
42255,0.000223,172.31.36.0-255,66,34396,8,272708
42256,0.000237,74.125.24.0-255,1484,35880,8,272708
42257,0.000239,172.31.36.0-255,66,35946,8,272708
42258,0.000244,74.125.24.0-255,2902,38848,8,272708
42259,0.000246,172.31.36.0-255,66,38914,8,272708
42260,0.000271,74.125.24.0-255,2902,41816,8,272708
42261,0.000274,172.31.36.0-255,66,41882,8,272708
42262,0.000281,74.125.24.0-255,6797,48679,8,272708
42263,0.000284,172.31.36.0-255,66,48745,8,272708
42264,0.000289,74.125.24.0-255,4320,53065,8,272708
42265,0.000292,172.31.36.0-255,66,53131,8,272708
42266,0.000321,172.31.36.0-255,66,53197,8,272708
42267,0.000326,74.125.24.0-255,2841,56038,8,272708
42268,0.000328,172.31.36.0-255,66,56104,8,272708
42269,0.000446,74.125.24.0-255,127,56231,8,272708
42270,0.000475,74.125.24.0-255,350,56581,8,272708
42271,0.000698,74.125.24.0-255,1484,58065,8,272708
42272,0.000703,172.31.36.0-255,66,58131,8,272708
42273,0.000709,74.125.24.0-255,2902,61033,8,272708
42274,0.000711,172.31.36.0-255,66,61099,8,272708
42275,0.000714,74.125.24.0-255,1484,62583,8,272708
42276,0.00074,74.125.24.0-255,4320,66903,8,272708
42277,0.000743,172.31.36.0-255,66,66969,8,272708
42278,0.000749,74.125.24.0-255,4320,71289,8,272708
42279,0.000751,172.31.36.0-255,66,71355,8,272708
42280,0.000774,172.31.36.0-255,66,71421,8,272708
42281,0.000788,172.31.36.0-255,66,71487,8,272708
42282,0.001143,74.125.24.0-255,1484,72971,8,272708
42283,0.001162,74.125.24.0-255,2902,75873,8,272708
42284,0.001165,172.31.36.0-255,66,75939,8,272708
42285,0.001172,74.125.24.0-255,5738,81677,8,272708
42286,0.001174,172.31.36.0-255,66,81743,8,272708
42287,0.001179,74.125.24.0-255,5738,87481,8,272708
42288,0.001182,172.31.36.0-255,66,87547,8,272708
42289,0.001221,172.31.36.0-255,66,87613,8,272708
42290,0.001242,74.125.24.0-255,5020,92633,8,272708
42291,0.001244,172.31.36.0-255,66,92699,8,272708
42292,0.001522,74.125.24.0-255,1484,94183,8,272708
42293,0.00154,74.125.24.0-255,2902,97085,8,272708
42294,0.001543,172.31.36.0-255,66,97151,8,272708
42295,0.00155,74.125.24.0-255,5738,102889,8,272708
42296,0.001552,172.31.36.0-255,66,102955,8,272708
42297,0.001595,172.31.36.0-255,66,103021,8,272708
42298,0.001608,172.31.36.0-255,66,103087,8,272708
42299,0.001924,74.125.24.0-255,1484,104571,8,272708
42300,0.00193,74.125.24.0-255,2902,107473,8,272708
42301,0.001933,172.31.36.0-255,66,107539,8,272708
42302,0.001938,74.125.24.0-255,2902,110441,8,272708
42303,0.00194,172.31.36.0-255,66,110507,8,272708
42304,0.001954,74.125.24.0-255,2902,113409,8,272708
42305,0.001956,172.31.36.0-255,66,113475,8,272708
42306,0.001985,172.31.36.0-255,66,113541,8,272708
42307,0.00201,74.125.24.0-255,4320,117861,8,272708
42308,0.002012,172.31.36.0-255,66,117927,8,272708
42309,0.002023,172.31.36.0-255,66,117993,8,272708
42310,0.002039,74.125.24.0-255,2184,120177,8,272708
42311,0.002042,172.31.36.0-255,66,120243,8,272708
42312,0.002089,74.125.24.0-255,1484,121727,8,272708
42313,0.002094,74.125.24.0-255,2902,124629,8,272708
42314,0.002097,172.31.36.0-255,66,124695,8,272708
42315,0.002101,74.125.24.0-255,1484,126179,8,272708
42316,0.00212,74.125.24.0-255,4320,130499,8,272708
42317,0.002123,172.31.36.0-255,66,130565,8,272708
42318,0.002156,74.125.24.0-255,5738,136303,8,272708
42319,0.002158,172.31.36.0-255,66,136369,8,272708
42320,0.002181,74.125.24.0-255,7156,143525,8,272708
42321,0.002184,172.31.36.0-255,66,143591,8,272708
42322,0.002192,74.125.24.0-255,7156,150747,8,272708
42323,0.002193,172.31.36.0-255,66,150813,8,272708
42324,0.002204,172.31.36.0-255,66,150879,8,272708
42325,0.002207,74.125.24.0-255,1484,152363,8,272708
42326,0.002234,74.125.24.0-255,7156,159519,8,272708
42327,0.002237,172.31.36.0-255,66,159585,8,272708
42328,0.002267,74.125.24.0-255,7156,166741,8,272708
42329,0.00227,172.31.36.0-255,66,166807,8,272708
42330,0.002294,172.31.36.0-255,66,166873,8,272708
42331,0.002298,74.125.24.0-255,2184,169057,8,272708
42332,0.002301,172.31.36.0-255,66,169123,8,272708
42333,0.002463,74.125.24.0-255,1484,170607,8,272708
42334,0.00247,74.125.24.0-255,2902,173509,8,272708
42335,0.002473,172.31.36.0-255,66,173575,8,272708
42336,0.00248,74.125.24.0-255,4320,177895,8,272708
42337,0.002482,172.31.36.0-255,66,177961,8,272708
42338,0.002494,74.125.24.0-255,1484,179445,8,272708
42339,0.002514,74.125.24.0-255,4320,183765,8,272708
42340,0.002517,172.31.36.0-255,66,183831,8,272708
42341,0.002522,74.125.24.0-255,4320,188151,8,272708
42342,0.002524,172.31.36.0-255,66,188217,8,272708
42343,0.002552,74.125.24.0-255,1484,189701,8,272708
42344,0.002555,74.125.24.0-255,1484,191185,8,272708
42345,0.002557,172.31.36.0-255,66,191251,8,272708
42346,0.00256,74.125.24.0-255,1484,192735,8,272708
42347,0.00258,74.125.24.0-255,7156,199891,8,272708
42348,0.002583,172.31.36.0-255,66,199957,8,272708
42349,0.0026,74.125.24.0-255,2902,202859,8,272708
42350,0.002603,172.31.36.0-255,66,202925,8,272708
42351,0.002606,74.125.24.0-255,766,203691,8,272708
42352,0.002627,74.125.24.0-255,1484,205175,8,272708
42353,0.002629,172.31.36.0-255,66,205241,8,272708
42354,0.002635,74.125.24.0-255,2902,208143,8,272708
42355,0.002637,172.31.36.0-255,66,208209,8,272708
42356,0.00264,74.125.24.0-255,1484,209693,8,272708
42357,0.002659,74.125.24.0-255,4320,214013,8,272708
42358,0.002662,172.31.36.0-255,66,214079,8,272708
42359,0.002665,74.125.24.0-255,1484,215563,8,272708
42360,0.002676,172.31.36.0-255,66,215629,8,272708
42361,0.002727,172.31.36.0-255,66,215695,8,272708
42362,0.002746,74.125.24.0-255,3602,219297,8,272708
42363,0.002749,172.31.36.0-255,66,219363,8,272708
42364,0.002752,74.125.24.0-255,1484,220847,8,272708
42365,0.002758,74.125.24.0-255,2902,223749,8,272708
42366,0.00276,172.31.36.0-255,66,223815,8,272708
42367,0.002788,74.125.24.0-255,5738,229553,8,272708
42368,0.002791,172.31.36.0-255,66,229619,8,272708
42369,0.002795,74.125.24.0-255,1484,231103,8,272708
42370,0.00282,172.31.36.0-255,66,231169,8,272708
42371,0.002827,74.125.24.0-255,7156,238325,8,272708
42372,0.00283,172.31.36.0-255,66,238391,8,272708
42373,0.002837,74.125.24.0-255,6438,244829,8,272708
42374,0.00284,172.31.36.0-255,66,244895,8,272708
42375,0.002883,74.125.24.0-255,5738,250633,8,272708
42376,0.002886,172.31.36.0-255,66,250699,8,272708
42377,0.002906,74.125.24.0-255,1484,252183,8,272708
42378,0.00292,172.31.36.0-255,66,252249,8,272708
42379,0.002925,74.125.24.0-255,4320,256569,8,272708
42380,0.002928,172.31.36.0-255,66,256635,8,272708
42381,0.00293,74.125.24.0-255,1484,258119,8,272708
42382,0.002985,74.125.24.0-255,7156,265275,8,272708
42383,0.002988,172.31.36.0-255,66,265341,8,272708
42384,0.003013,172.31.36.0-255,66,265407,8,272708
42385,0.003016,74.125.24.0-255,97,265504,8,272708
42386,0.003018,74.125.24.0-255,105,265609,8,272708
42387,0.008208,172.31.36.0-255,66,265675,8,272708
42388,0.008246,172.31.36.0-255,105,265780,8,272708
42389,0.010736,74.125.24.0-255,66,265846,8,272708
42390,0.041962,172.31.36.0-255,172,266018,8,272708
42391,0.041995,172.31.36.0-255,1111,267129,8,272708
42392,0.042072,172.31.36.0-255,1514,268643,8,272708
42393,0.042074,172.31.36.0-255,1514,270157,8,272708
42394,0.042079,172.31.36.0-255,1514,271671,8,272708
42395,0.042081,172.31.36.0-255,773,272444,8,272708
42396,0.043443,104.244.42.0-255,66,272510,8,272708
42397,0.043473,104.244.42.0-255,66,272576,8,272708
42398,0.043566,104.244.42.0-255,66,272642,8,272708
42399,0.043572,104.244.42.0-255,66,272708,8,272708
42400,0.0,74.125.130.0-255,302,302,8,388803
42401,3.3e-05,172.31.36.0-255,66,368,8,388803
42402,3.8e-05,74.125.130.0-255,1484,1852,8,388803
42403,4.3e-05,172.31.36.0-255,66,1918,8,388803
42404,4.6e-05,74.125.130.0-255,1484,3402,8,388803
42405,5.7e-05,172.31.36.0-255,66,3468,8,388803
42406,6.2e-05,74.125.130.0-255,2902,6370,8,388803
42407,6.5e-05,172.31.36.0-255,66,6436,8,388803
42408,7.1e-05,74.125.130.0-255,4320,10756,8,388803
42409,7.4e-05,172.31.36.0-255,66,10822,8,388803
42410,0.000102,74.125.130.0-255,1484,12306,8,388803
42411,0.000108,172.31.36.0-255,66,12372,8,388803
42412,0.000113,74.125.130.0-255,1887,14259,8,388803
42413,0.000115,172.31.36.0-255,66,14325,8,388803
42414,0.00012,74.125.130.0-255,2902,17227,8,388803
42415,0.000122,172.31.36.0-255,66,17293,8,388803
42416,0.00015,74.125.130.0-255,2902,20195,8,388803
42417,0.000154,172.31.36.0-255,66,20261,8,388803
42418,0.000189,74.125.130.0-255,4320,24581,8,388803
42419,0.000193,172.31.36.0-255,66,24647,8,388803
42420,0.000213,172.31.36.0-255,66,24713,8,388803
42421,0.000223,172.31.36.0-255,66,24779,8,388803
42422,0.000269,74.125.130.0-255,6438,31217,8,388803
42423,0.000272,172.31.36.0-255,66,31283,8,388803
42424,0.000415,74.125.130.0-255,1484,32767,8,388803
42425,0.000419,172.31.36.0-255,66,32833,8,388803
42426,0.000425,74.125.130.0-255,2902,35735,8,388803
42427,0.000428,172.31.36.0-255,66,35801,8,388803
42428,0.000469,74.125.130.0-255,1484,37285,8,388803
42429,0.000472,172.31.36.0-255,66,37351,8,388803
42430,0.000478,74.125.130.0-255,2902,40253,8,388803
42431,0.000483,172.31.36.0-255,66,40319,8,388803
42432,0.000511,74.125.130.0-255,5738,46057,8,388803
42433,0.000515,74.125.130.0-255,1484,47541,8,388803
42434,0.000528,172.31.36.0-255,66,47607,8,388803
42435,0.000559,74.125.130.0-255,1430,49037,8,388803
42436,0.000767,74.125.130.0-255,1484,50521,8,388803
42437,0.000771,172.31.36.0-255,66,50587,8,388803
42438,0.000775,74.125.130.0-255,1484,52071,8,388803
42439,0.000797,74.125.130.0-255,1484,53555,8,388803
42440,0.000799,74.125.130.0-255,1484,55039,8,388803
42441,0.000802,172.31.36.0-255,66,55105,8,388803
42442,0.000811,74.125.130.0-255,4320,59425,8,388803
42443,0.00082,172.31.36.0-255,66,59491,8,388803
42444,0.00083,74.125.130.0-255,4320,63811,8,388803
42445,0.000836,172.31.36.0-255,66,63877,8,388803
42446,0.000842,74.125.130.0-255,5738,69615,8,388803
42447,0.000851,172.31.36.0-255,66,69681,8,388803
42448,0.000867,74.125.130.0-255,2902,72583,8,388803
42449,0.000873,74.125.130.0-255,4320,76903,8,388803
42450,0.000893,172.31.36.0-255,66,76969,8,388803
42451,0.000929,74.125.130.0-255,6438,83407,8,388803
42452,0.000952,74.125.130.0-255,1484,84891,8,388803
42453,0.000975,74.125.130.0-255,2902,87793,8,388803
42454,0.000986,74.125.130.0-255,1484,89277,8,388803
42455,0.001009,74.125.130.0-255,4320,93597,8,388803
42456,0.001015,74.125.130.0-255,4320,97917,8,388803
42457,0.001017,74.125.130.0-255,1484,99401,8,388803
42458,0.001032,74.125.130.0-255,4320,103721,8,388803
42459,0.001048,74.125.130.0-255,4320,108041,8,388803
42460,0.001063,74.125.130.0-255,7156,115197,8,388803
42461,0.001067,74.125.130.0-255,2184,117381,8,388803
42462,0.001079,74.125.130.0-255,380,117761,8,388803
42463,0.00127,74.125.130.0-255,1484,119245,8,388803
42464,0.001277,74.125.130.0-255,2902,122147,8,388803
42465,0.001303,74.125.130.0-255,5738,127885,8,388803
42466,0.001306,74.125.130.0-255,1484,129369,8,388803
42467,0.001328,74.125.130.0-255,4320,133689,8,388803
42468,0.001336,74.125.130.0-255,7156,140845,8,388803
42469,0.00138,74.125.130.0-255,5738,146583,8,388803
42470,0.001395,74.125.130.0-255,2902,149485,8,388803
42471,0.001407,74.125.130.0-255,2184,151669,8,388803
42472,0.001589,74.125.130.0-255,1484,153153,8,388803
42473,0.001606,74.125.130.0-255,2902,156055,8,388803
42474,0.001609,74.125.130.0-255,1484,157539,8,388803
42475,0.001621,74.125.130.0-255,1484,159023,8,388803
42476,0.001626,74.125.130.0-255,4320,163343,8,388803
42477,0.001657,74.125.130.0-255,4320,167663,8,388803
42478,0.001674,74.125.130.0-255,4320,171983,8,388803
42479,0.001678,74.125.130.0-255,1484,173467,8,388803
42480,0.001719,74.125.130.0-255,2902,176369,8,388803
42481,0.001767,74.125.130.0-255,4320,180689,8,388803
42482,0.001806,74.125.130.0-255,5738,186427,8,388803
42483,0.001823,74.125.130.0-255,7156,193583,8,388803
42484,0.001831,74.125.130.0-255,7156,200739,8,388803
42485,0.00188,74.125.130.0-255,2184,202923,8,388803
42486,0.001968,74.125.130.0-255,1484,204407,8,388803
42487,0.001974,74.125.130.0-255,2902,207309,8,388803
42488,0.002012,74.125.130.0-255,4320,211629,8,388803
42489,0.002024,74.125.130.0-255,1484,213113,8,388803
42490,0.002028,74.125.130.0-255,2902,216015,8,388803
42491,0.002038,74.125.130.0-255,4320,220335,8,388803
42492,0.00206,74.125.130.0-255,2902,223237,8,388803
42493,0.002085,74.125.130.0-255,5738,228975,8,388803
42494,0.002089,74.125.130.0-255,2902,231877,8,388803
42495,0.002109,74.125.130.0-255,4320,236197,8,388803
42496,0.002112,74.125.130.0-255,766,236963,8,388803
42497,0.002238,74.125.130.0-255,1484,238447,8,388803
42498,0.002257,74.125.130.0-255,2902,241349,8,388803
42499,0.002275,74.125.130.0-255,5738,247087,8,388803
42500,0.006113,172.31.36.0-255,66,247153,8,388803
42501,0.008388,74.125.130.0-255,5738,252891,8,388803
42502,0.008395,172.31.36.0-255,66,252957,8,388803
42503,0.010642,74.125.130.0-255,5738,258695,8,388803
42504,0.010648,172.31.36.0-255,66,258761,8,388803
42505,0.012918,74.125.130.0-255,5738,264499,8,388803
42506,0.012925,172.31.36.0-255,66,264565,8,388803
42507,0.015178,74.125.130.0-255,5738,270303,8,388803
42508,0.015184,172.31.36.0-255,66,270369,8,388803
42509,0.017438,74.125.130.0-255,5738,276107,8,388803
42510,0.02076,172.31.36.0-255,66,276173,8,388803
42511,0.023031,74.125.130.0-255,5738,281911,8,388803
42512,0.023041,172.31.36.0-255,66,281977,8,388803
42513,0.025295,74.125.130.0-255,5738,287715,8,388803
42514,0.025307,172.31.36.0-255,66,287781,8,388803
42515,0.027563,74.125.130.0-255,5738,293519,8,388803
42516,0.027571,172.31.36.0-255,66,293585,8,388803
42517,0.029814,74.125.130.0-255,5738,299323,8,388803
42518,0.029823,172.31.36.0-255,66,299389,8,388803
42519,0.032079,74.125.130.0-255,5738,305127,8,388803
42520,0.032087,172.31.36.0-255,66,305193,8,388803
42521,0.034348,74.125.130.0-255,5738,310931,8,388803
42522,0.034358,172.31.36.0-255,66,310997,8,388803
42523,0.03663,74.125.130.0-255,5738,316735,8,388803
42524,0.03664,172.31.36.0-255,66,316801,8,388803
42525,0.038896,74.125.130.0-255,5738,322539,8,388803
42526,0.038905,172.31.36.0-255,66,322605,8,388803
42527,0.041159,74.125.130.0-255,5738,328343,8,388803
42528,0.041169,172.31.36.0-255,66,328409,8,388803
42529,0.043424,74.125.130.0-255,5738,334147,8,388803
42530,0.043432,172.31.36.0-255,66,334213,8,388803
42531,0.045706,74.125.130.0-255,5738,339951,8,388803
42532,0.045715,172.31.36.0-255,66,340017,8,388803
42533,0.047974,74.125.130.0-255,5738,345755,8,388803
42534,0.047983,172.31.36.0-255,66,345821,8,388803
42535,0.050235,74.125.130.0-255,5738,351559,8,388803
42536,0.050242,172.31.36.0-255,66,351625,8,388803
42537,0.050333,172.31.36.0-255,172,351797,8,388803
42538,0.050359,172.31.36.0-255,1111,352908,8,388803
42539,0.05041,172.31.36.0-255,1514,354422,8,388803
42540,0.050412,172.31.36.0-255,1514,355936,8,388803
42541,0.050416,172.31.36.0-255,1514,357450,8,388803
42542,0.050417,172.31.36.0-255,773,358223,8,388803
42543,0.051872,104.244.42.0-255,66,358289,8,388803
42544,0.051913,104.244.42.0-255,66,358355,8,388803
42545,0.05195,104.244.42.0-255,66,358421,8,388803
42546,0.051954,104.244.42.0-255,66,358487,8,388803
42547,0.052501,74.125.130.0-255,5738,364225,8,388803
42548,0.052507,172.31.36.0-255,66,364291,8,388803
42549,0.054762,74.125.130.0-255,5738,370029,8,388803
42550,0.054768,172.31.36.0-255,66,370095,8,388803
42551,0.057027,74.125.130.0-255,5738,375833,8,388803
42552,0.057046,172.31.36.0-255,66,375899,8,388803
42553,0.059301,74.125.130.0-255,5738,381637,8,388803
42554,0.059308,172.31.36.0-255,66,381703,8,388803
42555,0.061562,74.125.130.0-255,5738,387441,8,388803
42556,0.061569,172.31.36.0-255,66,387507,8,388803
42557,0.06382,74.125.130.0-255,1059,388566,8,388803
42558,0.063973,172.31.36.0-255,66,388632,8,388803
42559,0.064002,172.31.36.0-255,105,388737,8,388803
42560,0.066212,74.125.130.0-255,66,388803,8,388803
42561,0.0,34.209.199.0-255,97,97,8,260
42562,0.000188,172.31.36.0-255,97,194,8,260
42563,0.000201,172.31.36.0-255,66,260,8,260
42564,0.0,172.217.194.0-255,155,155,8,225951
42565,3.3e-05,172.31.36.0-255,66,221,8,225951
42566,4e-05,172.217.194.0-255,1484,1705,8,225951
42567,4.3e-05,172.31.36.0-255,66,1771,8,225951
42568,4.8e-05,172.217.194.0-255,2902,4673,8,225951
42569,5.1e-05,172.31.36.0-255,66,4739,8,225951
42570,5.8e-05,172.217.194.0-255,7156,11895,8,225951
42571,6e-05,172.31.36.0-255,66,11961,8,225951
42572,9.1e-05,172.217.194.0-255,4320,16281,8,225951
42573,9.4e-05,172.31.36.0-255,66,16347,8,225951
42574,0.000118,172.31.36.0-255,66,16413,8,225951
42575,0.000124,172.217.194.0-255,5379,21792,8,225951
42576,0.000126,172.31.36.0-255,66,21858,8,225951
42577,0.000215,172.217.194.0-255,1484,23342,8,225951
42578,0.000219,172.31.36.0-255,66,23408,8,225951
42579,0.000225,172.217.194.0-255,2902,26310,8,225951
42580,0.000227,172.31.36.0-255,66,26376,8,225951
42581,0.000234,172.217.194.0-255,5738,32114,8,225951
42582,0.000237,172.31.36.0-255,66,32180,8,225951
42583,0.00027,172.217.194.0-255,5738,37918,8,225951
42584,0.000273,172.31.36.0-255,66,37984,8,225951
42585,0.000305,172.31.36.0-255,66,38050,8,225951
42586,0.000316,172.31.36.0-255,66,38116,8,225951
42587,0.000319,172.217.194.0-255,1125,39241,8,225951
42588,0.000321,172.31.36.0-255,66,39307,8,225951
42589,0.00042,172.217.194.0-255,647,39954,8,225951
42590,0.000424,172.31.36.0-255,66,40020,8,225951
42591,0.00075,172.217.194.0-255,1484,41504,8,225951
42592,0.000754,172.31.36.0-255,66,41570,8,225951
42593,0.000759,172.217.194.0-255,2902,44472,8,225951
42594,0.000761,172.31.36.0-255,66,44538,8,225951
42595,0.000766,172.217.194.0-255,4320,48858,8,225951
42596,0.000768,172.31.36.0-255,66,48924,8,225951
42597,0.000785,172.217.194.0-255,1484,50408,8,225951
42598,0.000797,172.31.36.0-255,66,50474,8,225951
42599,0.000814,172.217.194.0-255,2902,53376,8,225951
42600,0.000817,172.31.36.0-255,66,53442,8,225951
42601,0.00082,172.217.194.0-255,1484,54926,8,225951
42602,0.000853,172.217.194.0-255,4320,59246,8,225951
42603,0.000857,172.31.36.0-255,66,59312,8,225951
42604,0.000878,172.217.194.0-255,4470,63782,8,225951
42605,0.000881,172.31.36.0-255,66,63848,8,225951
42606,0.000938,172.217.194.0-255,1484,65332,8,225951
42607,0.000957,172.217.194.0-255,2902,68234,8,225951
42608,0.000961,172.31.36.0-255,66,68300,8,225951
42609,0.000984,172.217.194.0-255,4320,72620,8,225951
42610,0.000987,172.31.36.0-255,66,72686,8,225951
42611,0.000999,172.217.194.0-255,1484,74170,8,225951
42612,0.001006,172.217.194.0-255,7156,81326,8,225951
42613,0.001009,172.31.36.0-255,66,81392,8,225951
42614,0.001023,172.217.194.0-255,2902,84294,8,225951
42615,0.001025,172.31.36.0-255,66,84360,8,225951
42616,0.001042,172.31.36.0-255,66,84426,8,225951
42617,0.001046,172.217.194.0-255,2184,86610,8,225951
42618,0.001048,172.31.36.0-255,66,86676,8,225951
42619,0.001053,172.217.194.0-255,2902,89578,8,225951
42620,0.001056,172.31.36.0-255,66,89644,8,225951
42621,0.001097,172.217.194.0-255,7156,96800,8,225951
42622,0.0011,172.31.36.0-255,66,96866,8,225951
42623,0.001107,172.217.194.0-255,6797,103663,8,225951
42624,0.001109,172.31.36.0-255,66,103729,8,225951
42625,0.001255,172.217.194.0-255,1484,105213,8,225951
42626,0.001261,172.217.194.0-255,2902,108115,8,225951
42627,0.001264,172.31.36.0-255,66,108181,8,225951
42628,0.001269,172.217.194.0-255,4320,112501,8,225951
42629,0.001271,172.31.36.0-255,66,112567,8,225951
42630,0.001285,172.217.194.0-255,1484,114051,8,225951
42631,0.001308,172.31.36.0-255,66,114117,8,225951
42632,0.001325,172.217.194.0-255,2902,117019,8,225951
42633,0.001328,172.31.36.0-255,66,117085,8,225951
42634,0.001362,172.31.36.0-255,66,117151,8,225951
42635,0.001381,172.217.194.0-255,2184,119335,8,225951
42636,0.001384,172.31.36.0-255,66,119401,8,225951
42637,0.001396,172.217.194.0-255,1484,120885,8,225951
42638,0.001418,172.217.194.0-255,2902,123787,8,225951
42639,0.001421,172.31.36.0-255,66,123853,8,225951
42640,0.001427,172.217.194.0-255,2902,126755,8,225951
42641,0.001429,172.31.36.0-255,66,126821,8,225951
42642,0.001447,172.217.194.0-255,2902,129723,8,225951
42643,0.00145,172.31.36.0-255,66,129789,8,225951
42644,0.001457,172.217.194.0-255,6797,136586,8,225951
42645,0.001459,172.31.36.0-255,66,136652,8,225951
42646,0.001501,172.217.194.0-255,1484,138136,8,225951
42647,0.001506,172.217.194.0-255,2902,141038,8,225951
42648,0.001509,172.31.36.0-255,66,141104,8,225951
42649,0.001531,172.217.194.0-255,5738,146842,8,225951
42650,0.001534,172.31.36.0-255,66,146908,8,225951
42651,0.00154,172.217.194.0-255,4320,151228,8,225951
42652,0.001543,172.31.36.0-255,66,151294,8,225951
42653,0.001585,172.31.36.0-255,66,151360,8,225951
42654,0.001591,172.31.36.0-255,66,151426,8,225951
42655,0.00162,172.217.194.0-255,2184,153610,8,225951
42656,0.001623,172.31.36.0-255,66,153676,8,225951
42657,0.002012,172.217.194.0-255,1484,155160,8,225951
42658,0.002017,172.217.194.0-255,2902,158062,8,225951
42659,0.002021,172.31.36.0-255,66,158128,8,225951
42660,0.00204,172.217.194.0-255,4320,162448,8,225951
42661,0.002043,172.31.36.0-255,66,162514,8,225951
42662,0.002078,172.31.36.0-255,66,162580,8,225951
42663,0.002089,172.217.194.0-255,1484,164064,8,225951
42664,0.002116,172.31.36.0-255,66,164130,8,225951
42665,0.002132,172.217.194.0-255,3602,167732,8,225951
42666,0.002135,172.31.36.0-255,66,167798,8,225951
42667,0.002185,172.217.194.0-255,1484,169282,8,225951
42668,0.002207,172.217.194.0-255,2902,172184,8,225951
42669,0.002211,172.31.36.0-255,66,172250,8,225951
42670,0.002218,172.217.194.0-255,5738,177988,8,225951
42671,0.002221,172.31.36.0-255,66,178054,8,225951
42672,0.002265,172.31.36.0-255,66,178120,8,225951
42673,0.002277,172.31.36.0-255,66,178186,8,225951
42674,0.00228,172.217.194.0-255,766,178952,8,225951
42675,0.002616,172.217.194.0-255,1484,180436,8,225951
42676,0.002622,172.31.36.0-255,66,180502,8,225951
42677,0.002628,172.217.194.0-255,2902,183404,8,225951
42678,0.002631,172.31.36.0-255,66,183470,8,225951
42679,0.002635,172.217.194.0-255,1484,184954,8,225951
42680,0.002662,172.31.36.0-255,66,185020,8,225951
42681,0.002665,172.217.194.0-255,1484,186504,8,225951
42682,0.0027,172.217.194.0-255,1484,187988,8,225951
42683,0.002704,172.31.36.0-255,66,188054,8,225951
42684,0.002729,172.31.36.0-255,66,188120,8,225951
42685,0.002737,172.217.194.0-255,6438,194558,8,225951
42686,0.002739,172.31.36.0-255,66,194624,8,225951
42687,0.002997,172.217.194.0-255,1484,196108,8,225951
42688,0.003004,172.217.194.0-255,2902,199010,8,225951
42689,0.003008,172.31.36.0-255,66,199076,8,225951
42690,0.003015,172.217.194.0-255,5738,204814,8,225951
42691,0.003017,172.31.36.0-255,66,204880,8,225951
42692,0.003043,172.217.194.0-255,1484,206364,8,225951
42693,0.003067,172.31.36.0-255,66,206430,8,225951
42694,0.003085,172.217.194.0-255,1484,207914,8,225951
42695,0.003096,172.31.36.0-255,66,207980,8,225951
42696,0.003129,172.217.194.0-255,4320,212300,8,225951
42697,0.003131,172.31.36.0-255,66,212366,8,225951
42698,0.003152,172.217.194.0-255,5738,218104,8,225951
42699,0.003154,172.31.36.0-255,66,218170,8,225951
42700,0.003166,172.31.36.0-255,66,218236,8,225951
42701,0.003203,172.31.36.0-255,66,218302,8,225951
42702,0.003222,172.217.194.0-255,3492,221794,8,225951
42703,0.003225,172.31.36.0-255,66,221860,8,225951
42704,0.003235,172.217.194.0-255,105,221965,8,225951
42705,0.009274,172.31.36.0-255,66,222031,8,225951
42706,0.009301,172.31.36.0-255,105,222136,8,225951
42707,0.011808,172.217.194.0-255,66,222202,8,225951
42708,0.029607,172.31.36.0-255,172,222374,8,225951
42709,0.029637,172.31.36.0-255,1111,223485,8,225951
42710,0.029697,172.31.36.0-255,1514,224999,8,225951
42711,0.029699,172.31.36.0-255,754,225753,8,225951
42712,0.031157,104.244.42.0-255,66,225819,8,225951
42713,0.031195,104.244.42.0-255,66,225885,8,225951
42714,0.031248,104.244.42.0-255,66,225951,8,225951
42715,0.0,74.125.24.0-255,156,156,8,333049
42716,3.1e-05,172.31.36.0-255,66,222,8,333049
42717,3.8e-05,74.125.24.0-255,1484,1706,8,333049
42718,4.2e-05,172.31.36.0-255,66,1772,8,333049
42719,4.8e-05,74.125.24.0-255,2902,4674,8,333049
42720,5e-05,172.31.36.0-255,66,4740,8,333049
42721,5.5e-05,74.125.24.0-255,4320,9060,8,333049
42722,5.7e-05,172.31.36.0-255,66,9126,8,333049
42723,8.4e-05,74.125.24.0-255,1484,10610,8,333049
42724,8.7e-05,172.31.36.0-255,66,10676,8,333049
42725,0.000108,74.125.24.0-255,3445,14121,8,333049
42726,0.000111,172.31.36.0-255,66,14187,8,333049
42727,0.000115,74.125.24.0-255,2902,17089,8,333049
42728,0.000117,172.31.36.0-255,66,17155,8,333049
42729,0.000133,74.125.24.0-255,2902,20057,8,333049
42730,0.000136,172.31.36.0-255,66,20123,8,333049
42731,0.000141,74.125.24.0-255,2902,23025,8,333049
42732,0.000143,172.31.36.0-255,66,23091,8,333049
42733,0.00018,172.31.36.0-255,66,23157,8,333049
42734,0.00036,74.125.24.0-255,1484,24641,8,333049
42735,0.000365,172.31.36.0-255,66,24707,8,333049
42736,0.00037,74.125.24.0-255,2902,27609,8,333049
42737,0.000373,172.31.36.0-255,66,27675,8,333049
42738,0.000379,74.125.24.0-255,5738,33413,8,333049
42739,0.000381,172.31.36.0-255,66,33479,8,333049
42740,0.000384,74.125.24.0-255,1484,34963,8,333049
42741,0.000388,172.31.36.0-255,66,35029,8,333049
42742,0.000417,74.125.24.0-255,5379,40408,8,333049
42743,0.00042,172.31.36.0-255,66,40474,8,333049
42744,0.000427,74.125.24.0-255,7156,47630,8,333049
42745,0.00043,172.31.36.0-255,66,47696,8,333049
42746,0.000447,74.125.24.0-255,7156,54852,8,333049
42747,0.00045,172.31.36.0-255,66,54918,8,333049
42748,0.000454,74.125.24.0-255,2543,57461,8,333049
42749,0.000461,172.31.36.0-255,66,57527,8,333049
42750,0.000994,74.125.24.0-255,646,58173,8,333049
42751,0.001171,74.125.24.0-255,1484,59657,8,333049
42752,0.001176,172.31.36.0-255,66,59723,8,333049
42753,0.001183,74.125.24.0-255,2902,62625,8,333049
42754,0.001185,172.31.36.0-255,66,62691,8,333049
42755,0.001191,74.125.24.0-255,5738,68429,8,333049
42756,0.001192,172.31.36.0-255,66,68495,8,333049
42757,0.001198,74.125.24.0-255,4320,72815,8,333049
42758,0.001226,74.125.24.0-255,4320,77135,8,333049
42759,0.00125,74.125.24.0-255,3602,80737,8,333049
42760,0.001548,74.125.24.0-255,1484,82221,8,333049
42761,0.001555,74.125.24.0-255,2902,85123,8,333049
42762,0.001561,74.125.24.0-255,5738,90861,8,333049
42763,0.001585,74.125.24.0-255,5738,96599,8,333049
42764,0.001601,74.125.24.0-255,7156,103755,8,333049
42765,0.001608,74.125.24.0-255,5738,109493,8,333049
42766,0.001626,74.125.24.0-255,5020,114513,8,333049
42767,0.001747,74.125.24.0-255,1484,115997,8,333049
42768,0.00175,74.125.24.0-255,1484,117481,8,333049
42769,0.00176,74.125.24.0-255,1484,118965,8,333049
42770,0.001782,74.125.24.0-255,5738,124703,8,333049
42771,0.001847,74.125.24.0-255,5738,130441,8,333049
42772,0.001858,74.125.24.0-255,2902,133343,8,333049
42773,0.00187,74.125.24.0-255,2184,135527,8,333049
42774,0.001941,74.125.24.0-255,1484,137011,8,333049
42775,0.001957,74.125.24.0-255,2902,139913,8,333049
42776,0.001979,74.125.24.0-255,5738,145651,8,333049
42777,0.002003,74.125.24.0-255,4320,149971,8,333049
42778,0.002029,74.125.24.0-255,5738,155709,8,333049
42779,0.002059,74.125.24.0-255,4320,160029,8,333049
42780,0.002068,74.125.24.0-255,766,160795,8,333049
42781,0.00216,74.125.24.0-255,1484,162279,8,333049
42782,0.002177,74.125.24.0-255,2902,165181,8,333049
42783,0.00218,74.125.24.0-255,1484,166665,8,333049
42784,0.002196,74.125.24.0-255,4320,170985,8,333049
42785,0.002199,74.125.24.0-255,1484,172469,8,333049
42786,0.002277,74.125.24.0-255,2184,174653,8,333049
42787,0.006327,172.31.36.0-255,66,174719,8,333049
42788,0.008686,74.125.24.0-255,5738,180457,8,333049
42789,0.008693,172.31.36.0-255,66,180523,8,333049
42790,0.011019,74.125.24.0-255,5738,186261,8,333049
42791,0.011026,172.31.36.0-255,66,186327,8,333049
42792,0.013343,74.125.24.0-255,5738,192065,8,333049
42793,0.013353,172.31.36.0-255,66,192131,8,333049
42794,0.015706,74.125.24.0-255,5738,197869,8,333049
42795,0.015714,172.31.36.0-255,66,197935,8,333049
42796,0.018042,74.125.24.0-255,5738,203673,8,333049
42797,0.01805,172.31.36.0-255,66,203739,8,333049
42798,0.020376,74.125.24.0-255,5738,209477,8,333049
42799,0.020384,172.31.36.0-255,66,209543,8,333049
42800,0.0227,74.125.24.0-255,5738,215281,8,333049
42801,0.022706,172.31.36.0-255,66,215347,8,333049
42802,0.025024,74.125.24.0-255,5738,221085,8,333049
42803,0.025033,172.31.36.0-255,66,221151,8,333049
42804,0.0268,172.31.36.0-255,172,221323,8,333049
42805,0.026831,172.31.36.0-255,1110,222433,8,333049
42806,0.026869,172.31.36.0-255,1428,223861,8,333049
42807,0.027327,74.125.24.0-255,5738,229599,8,333049
42808,0.027334,172.31.36.0-255,66,229665,8,333049
42809,0.028359,104.244.42.0-255,66,229731,8,333049
42810,0.028396,104.244.42.0-255,66,229797,8,333049
42811,0.028444,104.244.42.0-255,66,229863,8,333049
42812,0.029656,74.125.24.0-255,5738,235601,8,333049
42813,0.029661,172.31.36.0-255,66,235667,8,333049
42814,0.031981,74.125.24.0-255,5738,241405,8,333049
42815,0.031988,172.31.36.0-255,66,241471,8,333049
42816,0.034313,74.125.24.0-255,5738,247209,8,333049
42817,0.034319,172.31.36.0-255,66,247275,8,333049
42818,0.036644,74.125.24.0-255,5738,253013,8,333049
42819,0.036649,172.31.36.0-255,66,253079,8,333049
42820,0.03896,74.125.24.0-255,5738,258817,8,333049
42821,0.038966,172.31.36.0-255,66,258883,8,333049
42822,0.041274,74.125.24.0-255,5738,264621,8,333049
42823,0.041296,172.31.36.0-255,66,264687,8,333049
42824,0.043655,74.125.24.0-255,5738,270425,8,333049
42825,0.043661,172.31.36.0-255,66,270491,8,333049
42826,0.045978,74.125.24.0-255,5738,276229,8,333049
42827,0.045983,172.31.36.0-255,66,276295,8,333049
42828,0.048319,74.125.24.0-255,5738,282033,8,333049
42829,0.048326,172.31.36.0-255,66,282099,8,333049
42830,0.05067,74.125.24.0-255,5738,287837,8,333049
42831,0.050675,172.31.36.0-255,66,287903,8,333049
42832,0.05298,74.125.24.0-255,5738,293641,8,333049
42833,0.052985,172.31.36.0-255,66,293707,8,333049
42834,0.055294,74.125.24.0-255,1484,295191,8,333049
42835,0.055331,74.125.24.0-255,4320,299511,8,333049
42836,0.055336,172.31.36.0-255,66,299577,8,333049
42837,0.057684,74.125.24.0-255,5738,305315,8,333049
42838,0.057689,172.31.36.0-255,66,305381,8,333049
42839,0.060025,74.125.24.0-255,5738,311119,8,333049
42840,0.060032,172.31.36.0-255,66,311185,8,333049
42841,0.062343,74.125.24.0-255,5738,316923,8,333049
42842,0.062348,172.31.36.0-255,66,316989,8,333049
42843,0.064682,74.125.24.0-255,4320,321309,8,333049
42844,0.064687,172.31.36.0-255,66,321375,8,333049
42845,0.064714,74.125.24.0-255,1484,322859,8,333049
42846,0.067022,74.125.24.0-255,4320,327179,8,333049
42847,0.067028,172.31.36.0-255,66,327245,8,333049
42848,0.069367,74.125.24.0-255,5738,332983,8,333049
42849,0.069372,172.31.36.0-255,66,333049,8,333049
42850,0.0,172.217.194.0-255,147,147,8,311699
42851,2.1e-05,172.31.36.0-255,66,213,8,311699
42852,2.8e-05,172.217.194.0-255,1484,1697,8,311699
42853,3.1e-05,172.31.36.0-255,66,1763,8,311699
42854,3.7e-05,172.217.194.0-255,2902,4665,8,311699
42855,3.9e-05,172.31.36.0-255,66,4731,8,311699
42856,4.6e-05,172.217.194.0-255,7156,11887,8,311699
42857,4.8e-05,172.31.36.0-255,66,11953,8,311699
42858,5.2e-05,172.217.194.0-255,2005,13958,8,311699
42859,5.4e-05,172.31.36.0-255,66,14024,8,311699
42860,0.000101,172.217.194.0-255,5738,19762,8,311699
42861,0.000103,172.31.36.0-255,66,19828,8,311699
42862,0.000123,172.217.194.0-255,5738,25566,8,311699
42863,0.000125,172.31.36.0-255,66,25632,8,311699
42864,0.000146,172.217.194.0-255,5379,31011,8,311699
42865,0.000149,172.31.36.0-255,66,31077,8,311699
42866,0.000194,172.217.194.0-255,1484,32561,8,311699
42867,0.000196,172.31.36.0-255,66,32627,8,311699
42868,0.000215,172.217.194.0-255,2902,35529,8,311699
42869,0.000217,172.31.36.0-255,66,35595,8,311699
42870,0.000222,172.217.194.0-255,4320,39915,8,311699
42871,0.000224,172.31.36.0-255,66,39981,8,311699
42872,0.000244,172.217.194.0-255,1484,41465,8,311699
42873,0.000246,172.31.36.0-255,66,41531,8,311699
42874,0.000253,172.217.194.0-255,6797,48328,8,311699
42875,0.000256,172.31.36.0-255,66,48394,8,311699
42876,0.000271,172.217.194.0-255,5738,54132,8,311699
42877,0.000274,172.31.36.0-255,66,54198,8,311699
42878,0.000291,172.217.194.0-255,7156,61354,8,311699
42879,0.000293,172.31.36.0-255,66,61420,8,311699
42880,0.000315,172.217.194.0-255,1484,62904,8,311699
42881,0.000317,172.31.36.0-255,66,62970,8,311699
42882,0.000321,172.217.194.0-255,2839,65809,8,311699
42883,0.000322,172.31.36.0-255,66,65875,8,311699
42884,0.000333,172.217.194.0-255,382,66257,8,311699
42885,0.000407,172.217.194.0-255,1484,67741,8,311699
42886,0.000411,172.31.36.0-255,66,67807,8,311699
42887,0.000415,172.217.194.0-255,2902,70709,8,311699
42888,0.000417,172.31.36.0-255,66,70775,8,311699
42889,0.00042,172.217.194.0-255,1484,72259,8,311699
42890,0.000437,172.217.194.0-255,4320,76579,8,311699
42891,0.000439,172.31.36.0-255,66,76645,8,311699
42892,0.000446,172.217.194.0-255,6247,82892,8,311699
42893,0.000449,172.31.36.0-255,66,82958,8,311699
42894,0.000494,172.217.194.0-255,2902,85860,8,311699
42895,0.000496,172.31.36.0-255,66,85926,8,311699
42896,0.000501,172.217.194.0-255,4320,90246,8,311699
42897,0.000503,172.31.36.0-255,66,90312,8,311699
42898,0.000506,172.217.194.0-255,1484,91796,8,311699
42899,0.000534,172.217.194.0-255,7156,98952,8,311699
42900,0.000536,172.217.194.0-255,1125,100077,8,311699
42901,0.000543,172.31.36.0-255,66,100143,8,311699
42902,0.00082,172.217.194.0-255,1484,101627,8,311699
42903,0.000824,172.31.36.0-255,66,101693,8,311699
42904,0.00083,172.217.194.0-255,2902,104595,8,311699
42905,0.000831,172.31.36.0-255,66,104661,8,311699
42906,0.000835,172.217.194.0-255,2902,107563,8,311699
42907,0.000837,172.31.36.0-255,66,107629,8,311699
42908,0.000862,172.217.194.0-255,2902,110531,8,311699
42909,0.000864,172.31.36.0-255,66,110597,8,311699
42910,0.000867,172.217.194.0-255,1484,112081,8,311699
42911,0.000879,172.217.194.0-255,2902,114983,8,311699
42912,0.000882,172.31.36.0-255,66,115049,8,311699
42913,0.000905,172.217.194.0-255,5738,120787,8,311699
42914,0.000909,172.31.36.0-255,66,120853,8,311699
42915,0.000927,172.217.194.0-255,2902,123755,8,311699
42916,0.00093,172.31.36.0-255,66,123821,8,311699
42917,0.000936,172.217.194.0-255,5738,129559,8,311699
42918,0.000938,172.31.36.0-255,66,129625,8,311699
42919,0.000959,172.217.194.0-255,4320,133945,8,311699
42920,0.000962,172.31.36.0-255,66,134011,8,311699
42921,0.000964,172.217.194.0-255,766,134777,8,311699
42922,0.00105,172.217.194.0-255,1484,136261,8,311699
42923,0.001053,172.31.36.0-255,66,136327,8,311699
42924,0.001058,172.217.194.0-255,2902,139229,8,311699
42925,0.00106,172.31.36.0-255,66,139295,8,311699
42926,0.001066,172.217.194.0-255,5738,145033,8,311699
42927,0.001069,172.31.36.0-255,66,145099,8,311699
42928,0.001098,172.217.194.0-255,2902,148001,8,311699
42929,0.001101,172.31.36.0-255,66,148067,8,311699
42930,0.001125,172.217.194.0-255,7156,155223,8,311699
42931,0.001129,172.31.36.0-255,66,155289,8,311699
42932,0.001142,172.31.36.0-255,66,155355,8,311699
42933,0.001145,172.217.194.0-255,1484,156839,8,311699
42934,0.001164,172.217.194.0-255,5738,162577,8,311699
42935,0.001167,172.31.36.0-255,66,162643,8,311699
42936,0.001187,172.217.194.0-255,5738,168381,8,311699
42937,0.00119,172.31.36.0-255,66,168447,8,311699
42938,0.00121,172.217.194.0-255,1484,169931,8,311699
42939,0.001222,172.31.36.0-255,66,169997,8,311699
42940,0.001249,172.217.194.0-255,1484,171481,8,311699
42941,0.001261,172.31.36.0-255,66,171547,8,311699
42942,0.001296,172.31.36.0-255,66,171613,8,311699
42943,0.001303,172.217.194.0-255,7156,178769,8,311699
42944,0.001305,172.31.36.0-255,66,178835,8,311699
42945,0.001308,172.217.194.0-255,1484,180319,8,311699
42946,0.00134,172.217.194.0-255,7156,187475,8,311699
42947,0.001345,172.31.36.0-255,66,187541,8,311699
42948,0.001356,172.31.36.0-255,66,187607,8,311699
42949,0.001377,172.217.194.0-255,1484,189091,8,311699
42950,0.001381,172.217.194.0-255,2902,191993,8,311699
42951,0.001384,172.31.36.0-255,66,192059,8,311699
42952,0.001415,172.217.194.0-255,5738,197797,8,311699
42953,0.001419,172.31.36.0-255,66,197863,8,311699
42954,0.001429,172.217.194.0-255,5738,203601,8,311699
42955,0.001432,172.31.36.0-255,66,203667,8,311699
42956,0.001458,172.217.194.0-255,7156,210823,8,311699
42957,0.001462,172.31.36.0-255,66,210889,8,311699
42958,0.001467,172.217.194.0-255,4320,215209,8,311699
42959,0.001469,172.31.36.0-255,66,215275,8,311699
42960,0.001495,172.217.194.0-255,6438,221713,8,311699
42961,0.001499,172.31.36.0-255,66,221779,8,311699
42962,0.001517,172.217.194.0-255,1484,223263,8,311699
42963,0.001521,172.217.194.0-255,1484,224747,8,311699
42964,0.001523,172.31.36.0-255,66,224813,8,311699
42965,0.001547,172.217.194.0-255,1484,226297,8,311699
42966,0.001554,172.217.194.0-255,5738,232035,8,311699
42967,0.001557,172.31.36.0-255,66,232101,8,311699
42968,0.001596,172.31.36.0-255,66,232167,8,311699
42969,0.001599,172.217.194.0-255,1484,233651,8,311699
42970,0.001648,172.31.36.0-255,66,233717,8,311699
42971,0.001671,172.217.194.0-255,5738,239455,8,311699
42972,0.001675,172.31.36.0-255,66,239521,8,311699
42973,0.001703,172.217.194.0-255,4320,243841,8,311699
42974,0.001708,172.31.36.0-255,66,243907,8,311699
42975,0.001719,172.31.36.0-255,66,243973,8,311699
42976,0.001723,172.217.194.0-255,2902,246875,8,311699
42977,0.001725,172.31.36.0-255,66,246941,8,311699
42978,0.001767,172.31.36.0-255,66,247007,8,311699
42979,0.001867,172.217.194.0-255,1484,248491,8,311699
42980,0.001873,172.217.194.0-255,2902,251393,8,311699
42981,0.001877,172.31.36.0-255,66,251459,8,311699
42982,0.001882,172.217.194.0-255,4320,255779,8,311699
42983,0.001884,172.31.36.0-255,66,255845,8,311699
42984,0.001897,172.217.194.0-255,1484,257329,8,311699
42985,0.00192,172.217.194.0-255,5738,263067,8,311699
42986,0.001924,172.31.36.0-255,66,263133,8,311699
42987,0.001942,172.217.194.0-255,1484,264617,8,311699
42988,0.001961,172.217.194.0-255,2902,267519,8,311699
42989,0.001965,172.31.36.0-255,66,267585,8,311699
42990,0.002001,172.31.36.0-255,66,267651,8,311699
42991,0.003985,172.217.194.0-255,5738,273389,8,311699
42992,0.003991,172.31.36.0-255,66,273455,8,311699
42993,0.005953,172.217.194.0-255,5738,279193,8,311699
42994,0.00596,172.31.36.0-255,66,279259,8,311699
42995,0.007955,172.217.194.0-255,5738,284997,8,311699
42996,0.007959,172.31.36.0-255,66,285063,8,311699
42997,0.009938,172.217.194.0-255,5738,290801,8,311699
42998,0.009945,172.31.36.0-255,66,290867,8,311699
42999,0.011926,172.217.194.0-255,5738,296605,8,311699
43000,0.011935,172.31.36.0-255,66,296671,8,311699
43001,0.013902,172.217.194.0-255,5738,302409,8,311699
43002,0.013909,172.31.36.0-255,66,302475,8,311699
43003,0.015927,172.217.194.0-255,5738,308213,8,311699
43004,0.015935,172.31.36.0-255,66,308279,8,311699
43005,0.017872,172.217.194.0-255,194,308473,8,311699
43006,0.021734,172.31.36.0-255,66,308539,8,311699
43007,0.021766,172.31.36.0-255,105,308644,8,311699
43008,0.023717,172.217.194.0-255,66,308710,8,311699
43009,0.028717,172.31.36.0-255,187,308897,8,311699
43010,0.028752,172.31.36.0-255,979,309876,8,311699
43011,0.028789,172.31.36.0-255,1514,311390,8,311699
43012,0.028791,172.31.36.0-255,111,311501,8,311699
43013,0.030267,104.244.42.0-255,66,311567,8,311699
43014,0.030292,104.244.42.0-255,66,311633,8,311699
43015,0.030356,104.244.42.0-255,66,311699,8,311699
43016,0.0,74.125.24.0-255,153,153,8,329390
43017,2.2e-05,172.31.36.0-255,66,219,8,329390
43018,2.9e-05,74.125.24.0-255,1484,1703,8,329390
43019,3.4e-05,172.31.36.0-255,66,1769,8,329390
43020,4.1e-05,74.125.24.0-255,2902,4671,8,329390
43021,4.4e-05,172.31.36.0-255,66,4737,8,329390
43022,5.2e-05,74.125.24.0-255,7156,11893,8,329390
43023,5.4e-05,172.31.36.0-255,66,11959,8,329390
43024,8.8e-05,172.31.36.0-255,66,12025,8,329390
43025,0.000117,172.31.36.0-255,66,12091,8,329390
43026,0.000121,74.125.24.0-255,2543,14634,8,329390
43027,0.000123,172.31.36.0-255,66,14700,8,329390
43028,0.000174,74.125.24.0-255,1484,16184,8,329390
43029,0.000177,172.31.36.0-255,66,16250,8,329390
43030,0.000182,74.125.24.0-255,2902,19152,8,329390
43031,0.000184,172.31.36.0-255,66,19218,8,329390
43032,0.000188,74.125.24.0-255,1484,20702,8,329390
43033,0.000191,172.31.36.0-255,66,20768,8,329390
43034,0.000216,74.125.24.0-255,4320,25088,8,329390
43035,0.000219,172.31.36.0-255,66,25154,8,329390
43036,0.000222,74.125.24.0-255,1484,26638,8,329390
43037,0.000224,172.31.36.0-255,66,26704,8,329390
43038,0.000249,172.31.36.0-255,66,26770,8,329390
43039,0.000255,74.125.24.0-255,4320,31090,8,329390
43040,0.000258,172.31.36.0-255,66,31156,8,329390
43041,0.000287,74.125.24.0-255,7156,38312,8,329390
43042,0.00029,172.31.36.0-255,66,38378,8,329390
43043,0.000292,74.125.24.0-255,1435,39813,8,329390
43044,0.000294,172.31.36.0-255,66,39879,8,329390
43045,0.000579,74.125.24.0-255,110,39989,8,329390
43046,0.00063,74.125.24.0-255,1484,41473,8,329390
43047,0.000651,74.125.24.0-255,2902,44375,8,329390
43048,0.000658,74.125.24.0-255,5738,50113,8,329390
43049,0.000669,74.125.24.0-255,1484,51597,8,329390
43050,0.000673,74.125.24.0-255,1484,53081,8,329390
43051,0.000708,74.125.24.0-255,4320,57401,8,329390
43052,0.001269,172.31.36.0-255,66,57467,8,329390
43053,0.001588,74.125.24.0-255,1484,58951,8,329390
43054,0.001596,74.125.24.0-255,2902,61853,8,329390
43055,0.001599,74.125.24.0-255,1484,63337,8,329390
43056,0.001615,172.31.36.0-255,66,63403,8,329390
43057,0.001622,74.125.24.0-255,4320,67723,8,329390
43058,0.001627,74.125.24.0-255,2902,70625,8,329390
43059,0.001643,74.125.24.0-255,4320,74945,8,329390
43060,0.001648,172.31.36.0-255,66,75011,8,329390
43061,0.001683,74.125.24.0-255,2184,77195,8,329390
43062,0.001723,172.31.36.0-255,66,77261,8,329390
43063,0.001848,74.125.24.0-255,1484,78745,8,329390
43064,0.001854,74.125.24.0-255,2902,81647,8,329390
43065,0.001866,172.31.36.0-255,66,81713,8,329390
43066,0.001874,74.125.24.0-255,1484,83197,8,329390
43067,0.001888,74.125.24.0-255,4320,87517,8,329390
43068,0.001895,74.125.24.0-255,4320,91837,8,329390
43069,0.001913,74.125.24.0-255,2902,94739,8,329390
43070,0.001929,74.125.24.0-255,2902,97641,8,329390
43071,0.001951,74.125.24.0-255,2184,99825,8,329390
43072,0.001955,172.31.36.0-255,66,99891,8,329390
43073,0.001972,172.31.36.0-255,66,99957,8,329390
43074,0.002137,74.125.24.0-255,1484,101441,8,329390
43075,0.002142,74.125.24.0-255,2902,104343,8,329390
43076,0.002147,74.125.24.0-255,4320,108663,8,329390
43077,0.002162,74.125.24.0-255,1484,110147,8,329390
43078,0.002166,74.125.24.0-255,2902,113049,8,329390
43079,0.002182,172.31.36.0-255,66,113115,8,329390
43080,0.002198,74.125.24.0-255,5738,118853,8,329390
43081,0.002204,172.31.36.0-255,66,118919,8,329390
43082,0.002216,74.125.24.0-255,2902,121821,8,329390
43083,0.002237,74.125.24.0-255,2184,124005,8,329390
43084,0.002246,172.31.36.0-255,66,124071,8,329390
43085,0.002282,74.125.24.0-255,1484,125555,8,329390
43086,0.002287,74.125.24.0-255,1484,127039,8,329390
43087,0.002303,74.125.24.0-255,1484,128523,8,329390
43088,0.002309,74.125.24.0-255,5738,134261,8,329390
43089,0.002324,74.125.24.0-255,5738,139999,8,329390
43090,0.002334,172.31.36.0-255,66,140065,8,329390
43091,0.002342,74.125.24.0-255,7156,147221,8,329390
43092,0.002349,74.125.24.0-255,7156,154377,8,329390
43093,0.002355,172.31.36.0-255,66,154443,8,329390
43094,0.002391,74.125.24.0-255,7156,161599,8,329390
43095,0.002432,74.125.24.0-255,4320,165919,8,329390
43096,0.002437,74.125.24.0-255,4320,170239,8,329390
43097,0.002442,172.31.36.0-255,66,170305,8,329390
43098,0.002449,172.31.36.0-255,66,170371,8,329390
43099,0.004801,74.125.24.0-255,5738,176109,8,329390
43100,0.006859,172.31.36.0-255,66,176175,8,329390
43101,0.009231,74.125.24.0-255,5738,181913,8,329390
43102,0.009238,172.31.36.0-255,66,181979,8,329390
43103,0.01158,74.125.24.0-255,5738,187717,8,329390
43104,0.011588,172.31.36.0-255,66,187783,8,329390
43105,0.013926,74.125.24.0-255,5738,193521,8,329390
43106,0.014324,172.31.36.0-255,66,193587,8,329390
43107,0.016731,74.125.24.0-255,5738,199325,8,329390
43108,0.01674,172.31.36.0-255,66,199391,8,329390
43109,0.019118,74.125.24.0-255,5738,205129,8,329390
43110,0.019127,172.31.36.0-255,66,205195,8,329390
43111,0.021499,74.125.24.0-255,5738,210933,8,329390
43112,0.021508,172.31.36.0-255,66,210999,8,329390
43113,0.023892,74.125.24.0-255,5738,216737,8,329390
43114,0.0239,172.31.36.0-255,66,216803,8,329390
43115,0.026267,74.125.24.0-255,5738,222541,8,329390
43116,0.026274,172.31.36.0-255,66,222607,8,329390
43117,0.028688,74.125.24.0-255,5738,228345,8,329390
43118,0.028695,172.31.36.0-255,66,228411,8,329390
43119,0.031059,74.125.24.0-255,5738,234149,8,329390
43120,0.031068,172.31.36.0-255,66,234215,8,329390
43121,0.033416,74.125.24.0-255,5738,239953,8,329390
43122,0.03343,172.31.36.0-255,66,240019,8,329390
43123,0.035786,74.125.24.0-255,5738,245757,8,329390
43124,0.035795,172.31.36.0-255,66,245823,8,329390
43125,0.038158,74.125.24.0-255,5738,251561,8,329390
43126,0.038167,172.31.36.0-255,66,251627,8,329390
43127,0.039519,172.31.36.0-255,172,251799,8,329390
43128,0.039547,172.31.36.0-255,1111,252910,8,329390
43129,0.039598,172.31.36.0-255,1514,254424,8,329390
43130,0.0396,172.31.36.0-255,1514,255938,8,329390
43131,0.039604,172.31.36.0-255,1514,257452,8,329390
43132,0.039605,172.31.36.0-255,1514,258966,8,329390
43133,0.039633,172.31.36.0-255,1275,260241,8,329390
43134,0.040553,74.125.24.0-255,5738,265979,8,329390
43135,0.04056,172.31.36.0-255,66,266045,8,329390
43136,0.041089,104.244.42.0-255,66,266111,8,329390
43137,0.041131,104.244.42.0-255,66,266177,8,329390
43138,0.041211,104.244.42.0-255,66,266243,8,329390
43139,0.041216,104.244.42.0-255,66,266309,8,329390
43140,0.042908,74.125.24.0-255,5738,272047,8,329390
43141,0.042914,172.31.36.0-255,66,272113,8,329390
43142,0.045276,74.125.24.0-255,5738,277851,8,329390
43143,0.045283,172.31.36.0-255,66,277917,8,329390
43144,0.047679,74.125.24.0-255,5738,283655,8,329390
43145,0.047688,172.31.36.0-255,66,283721,8,329390
43146,0.05009,74.125.24.0-255,5738,289459,8,329390
43147,0.0501,172.31.36.0-255,66,289525,8,329390
43148,0.052478,74.125.24.0-255,5738,295263,8,329390
43149,0.052487,172.31.36.0-255,66,295329,8,329390
43150,0.054853,74.125.24.0-255,5738,301067,8,329390
43151,0.054858,172.31.36.0-255,66,301133,8,329390
43152,0.057235,74.125.24.0-255,5738,306871,8,329390
43153,0.057242,172.31.36.0-255,66,306937,8,329390
43154,0.059629,74.125.24.0-255,5738,312675,8,329390
43155,0.059636,172.31.36.0-255,66,312741,8,329390
43156,0.062025,74.125.24.0-255,5738,318479,8,329390
43157,0.062033,172.31.36.0-255,66,318545,8,329390
43158,0.064405,74.125.24.0-255,5738,324283,8,329390
43159,0.064411,172.31.36.0-255,66,324349,8,329390
43160,0.066777,74.125.24.0-255,4804,329153,8,329390
43161,0.066787,172.31.36.0-255,66,329219,8,329390
43162,0.066985,172.31.36.0-255,105,329324,8,329390
43163,0.069315,74.125.24.0-255,66,329390,8,329390
43164,0.0,172.217.194.0-255,290,290,8,143943
43165,3.5e-05,172.31.36.0-255,66,356,8,143943
43166,4.1e-05,172.217.194.0-255,1484,1840,8,143943
43167,4.6e-05,172.31.36.0-255,66,1906,8,143943
43168,6e-05,172.217.194.0-255,4320,6226,8,143943
43169,6.3e-05,172.31.36.0-255,66,6292,8,143943
43170,7e-05,172.217.194.0-255,7156,13448,8,143943
43171,7.2e-05,172.31.36.0-255,66,13514,8,143943
43172,8.9e-05,172.31.36.0-255,66,13580,8,143943
43173,9.2e-05,172.217.194.0-255,1125,14705,8,143943
43174,9.4e-05,172.31.36.0-255,66,14771,8,143943
43175,0.000154,172.217.194.0-255,7156,21927,8,143943
43176,0.000158,172.31.36.0-255,66,21993,8,143943
43177,0.000196,172.31.36.0-255,66,22059,8,143943
43178,0.000741,172.217.194.0-255,1484,23543,8,143943
43179,0.000747,172.31.36.0-255,66,23609,8,143943
43180,0.000757,172.217.194.0-255,2902,26511,8,143943
43181,0.000759,172.31.36.0-255,66,26577,8,143943
43182,0.000772,172.217.194.0-255,5738,32315,8,143943
43183,0.000774,172.31.36.0-255,66,32381,8,143943
43184,0.0008,172.31.36.0-255,66,32447,8,143943
43185,0.000832,172.217.194.0-255,3961,36408,8,143943
43186,0.000835,172.31.36.0-255,66,36474,8,143943
43187,0.000856,172.31.36.0-255,66,36540,8,143943
43188,0.000871,172.31.36.0-255,66,36606,8,143943
43189,0.000929,172.217.194.0-255,1484,38090,8,143943
43190,0.000933,172.31.36.0-255,66,38156,8,143943
43191,0.000938,172.217.194.0-255,2902,41058,8,143943
43192,0.000939,172.31.36.0-255,66,41124,8,143943
43193,0.000945,172.217.194.0-255,4320,45444,8,143943
43194,0.000954,172.31.36.0-255,66,45510,8,143943
43195,0.000981,172.217.194.0-255,1484,46994,8,143943
43196,0.000983,172.31.36.0-255,66,47060,8,143943
43197,0.001018,172.217.194.0-255,6814,53874,8,143943
43198,0.001023,172.31.36.0-255,66,53940,8,143943
43199,0.00106,172.217.194.0-255,1484,55424,8,143943
43200,0.001063,172.31.36.0-255,66,55490,8,143943
43201,0.001068,172.217.194.0-255,2902,58392,8,143943
43202,0.001071,172.31.36.0-255,66,58458,8,143943
43203,0.001083,172.217.194.0-255,5738,64196,8,143943
43204,0.001085,172.31.36.0-255,66,64262,8,143943
43205,0.001143,172.31.36.0-255,66,64328,8,143943
43206,0.001178,172.31.36.0-255,66,64394,8,143943
43207,0.001181,172.217.194.0-255,766,65160,8,143943
43208,0.001211,172.217.194.0-255,1484,66644,8,143943
43209,0.001217,172.217.194.0-255,2902,69546,8,143943
43210,0.00124,172.217.194.0-255,5738,75284,8,143943
43211,0.001251,172.31.36.0-255,66,75350,8,143943
43212,0.001331,172.217.194.0-255,2570,77920,8,143943
43213,0.001369,172.31.36.0-255,66,77986,8,143943
43214,0.001393,172.31.36.0-255,66,78052,8,143943
43215,0.001424,172.217.194.0-255,3602,81654,8,143943
43216,0.001444,172.217.194.0-255,5020,86674,8,143943
43217,0.001464,172.31.36.0-255,66,86740,8,143943
43218,0.001468,172.217.194.0-255,1484,88224,8,143943
43219,0.001472,172.217.194.0-255,2902,91126,8,143943
43220,0.001489,172.217.194.0-255,5738,96864,8,143943
43221,0.001506,172.217.194.0-255,5738,102602,8,143943
43222,0.00151,172.31.36.0-255,66,102668,8,143943
43223,0.001596,172.217.194.0-255,1484,104152,8,143943
43224,0.001679,172.31.36.0-255,66,104218,8,143943
43225,0.001686,172.31.36.0-255,66,104284,8,143943
43226,0.001799,172.217.194.0-255,1484,105768,8,143943
43227,0.001805,172.217.194.0-255,2902,108670,8,143943
43228,0.001824,172.217.194.0-255,5738,114408,8,143943
43229,0.001864,172.217.194.0-255,4320,118728,8,143943
43230,0.001867,172.217.194.0-255,2902,121630,8,143943
43231,0.001871,172.31.36.0-255,66,121696,8,143943
43232,0.001878,172.31.36.0-255,66,121762,8,143943
43233,0.001921,172.217.194.0-255,2902,124664,8,143943
43234,0.001927,172.217.194.0-255,4320,128984,8,143943
43235,0.00194,172.31.36.0-255,66,129050,8,143943
43236,0.001967,172.31.36.0-255,66,129116,8,143943
43237,0.001979,172.217.194.0-255,4320,133436,8,143943
43238,0.002069,172.217.194.0-255,105,133541,8,143943
43239,0.002081,172.31.36.0-255,66,133607,8,143943
43240,0.004732,172.31.36.0-255,105,133712,8,143943
43241,0.006907,172.217.194.0-255,66,133778,8,143943
43242,0.039702,172.31.36.0-255,172,133950,8,143943
43243,0.039746,172.31.36.0-255,1110,135060,8,143943
43244,0.039907,172.31.36.0-255,1514,136574,8,143943
43245,0.039909,172.31.36.0-255,1514,138088,8,143943
43246,0.039914,172.31.36.0-255,1514,139602,8,143943
43247,0.039915,172.31.36.0-255,1514,141116,8,143943
43248,0.039938,172.31.36.0-255,1514,142630,8,143943
43249,0.039939,172.31.36.0-255,875,143505,8,143943
43250,0.041233,104.244.42.0-255,66,143571,8,143943
43251,0.041285,104.244.42.0-255,66,143637,8,143943
43252,0.041498,104.244.42.0-255,66,143703,8,143943
43253,0.041594,104.244.42.0-255,66,143769,8,143943
43254,0.053193,172.31.36.0-255,108,143877,8,143943
43255,0.054729,104.244.42.0-255,66,143943,8,143943
43256,0.0,172.217.194.0-255,153,153,8,245988
43257,2.4e-05,172.31.36.0-255,66,219,8,245988
43258,3.2e-05,172.217.194.0-255,1484,1703,8,245988
43259,3.6e-05,172.31.36.0-255,66,1769,8,245988
43260,4.9e-05,172.217.194.0-255,2902,4671,8,245988
43261,5.2e-05,172.31.36.0-255,66,4737,8,245988
43262,6e-05,172.217.194.0-255,7156,11893,8,245988
43263,6.3e-05,172.31.36.0-255,66,11959,8,245988
43264,7.1e-05,172.217.194.0-255,7156,19115,8,245988
43265,7.4e-05,172.31.36.0-255,66,19181,8,245988
43266,0.000125,172.217.194.0-255,686,19867,8,245988
43267,0.000128,172.31.36.0-255,66,19933,8,245988
43268,0.000146,172.31.36.0-255,66,19999,8,245988
43269,0.00015,172.217.194.0-255,2543,22542,8,245988
43270,0.000152,172.31.36.0-255,66,22608,8,245988
43271,0.000275,172.217.194.0-255,1484,24092,8,245988
43272,0.000279,172.31.36.0-255,66,24158,8,245988
43273,0.000307,172.217.194.0-255,2902,27060,8,245988
43274,0.00031,172.31.36.0-255,66,27126,8,245988
43275,0.000317,172.217.194.0-255,5738,32864,8,245988
43276,0.000319,172.31.36.0-255,66,32930,8,245988
43277,0.000355,172.31.36.0-255,66,32996,8,245988
43278,0.000409,172.31.36.0-255,66,33062,8,245988
43279,0.000461,172.217.194.0-255,119,33181,8,245988
43280,0.000464,172.31.36.0-255,66,33247,8,245988
43281,0.000659,172.217.194.0-255,1484,34731,8,245988
43282,0.000664,172.31.36.0-255,66,34797,8,245988
43283,0.00067,172.217.194.0-255,2902,37699,8,245988
43284,0.000672,172.31.36.0-255,66,37765,8,245988
43285,0.000675,172.217.194.0-255,1484,39249,8,245988
43286,0.000711,172.217.194.0-255,4320,43569,8,245988
43287,0.000714,172.31.36.0-255,66,43635,8,245988
43288,0.00072,172.217.194.0-255,4320,47955,8,245988
43289,0.000722,172.31.36.0-255,66,48021,8,245988
43290,0.000728,172.217.194.0-255,5738,53759,8,245988
43291,0.000735,172.31.36.0-255,66,53825,8,245988
43292,0.000763,172.217.194.0-255,5738,59563,8,245988
43293,0.000766,172.31.36.0-255,66,59629,8,245988
43294,0.000777,172.31.36.0-255,66,59695,8,245988
43295,0.00078,172.217.194.0-255,382,60077,8,245988
43296,0.001479,172.31.36.0-255,66,60143,8,245988
43297,0.00169,172.217.194.0-255,1484,61627,8,245988
43298,0.001699,172.217.194.0-255,1484,63111,8,245988
43299,0.001702,172.31.36.0-255,66,63177,8,245988
43300,0.001729,172.217.194.0-255,1484,64661,8,245988
43301,0.001737,172.217.194.0-255,5738,70399,8,245988
43302,0.00174,172.31.36.0-255,66,70465,8,245988
43303,0.001746,172.217.194.0-255,4320,74785,8,245988
43304,0.001748,172.31.36.0-255,66,74851,8,245988
43305,0.001799,172.31.36.0-255,66,74917,8,245988
43306,0.001817,172.217.194.0-255,2902,77819,8,245988
43307,0.001819,172.31.36.0-255,66,77885,8,245988
43308,0.00183,172.31.36.0-255,66,77951,8,245988
43309,0.002319,172.217.194.0-255,1484,79435,8,245988
43310,0.002327,172.217.194.0-255,2902,82337,8,245988
43311,0.002332,172.31.36.0-255,66,82403,8,245988
43312,0.002369,172.217.194.0-255,1484,83887,8,245988
43313,0.002376,172.217.194.0-255,5738,89625,8,245988
43314,0.002378,172.31.36.0-255,66,89691,8,245988
43315,0.002416,172.31.36.0-255,66,89757,8,245988
43316,0.002419,172.217.194.0-255,1484,91241,8,245988
43317,0.002461,172.31.36.0-255,66,91307,8,245988
43318,0.002486,172.217.194.0-255,2184,93491,8,245988
43319,0.002488,172.31.36.0-255,66,93557,8,245988
43320,0.002823,172.217.194.0-255,1484,95041,8,245988
43321,0.002837,172.217.194.0-255,2902,97943,8,245988
43322,0.00284,172.31.36.0-255,66,98009,8,245988
43323,0.002858,172.217.194.0-255,4320,102329,8,245988
43324,0.00286,172.31.36.0-255,66,102395,8,245988
43325,0.002883,172.217.194.0-255,1484,103879,8,245988
43326,0.002895,172.31.36.0-255,66,103945,8,245988
43327,0.002921,172.217.194.0-255,2902,106847,8,245988
43328,0.002923,172.31.36.0-255,66,106913,8,245988
43329,0.002933,172.31.36.0-255,66,106979,8,245988
43330,0.002942,172.217.194.0-255,2184,109163,8,245988
43331,0.002945,172.31.36.0-255,66,109229,8,245988
43332,0.003127,172.217.194.0-255,1484,110713,8,245988
43333,0.003147,172.217.194.0-255,2902,113615,8,245988
43334,0.00315,172.31.36.0-255,66,113681,8,245988
43335,0.003153,172.217.194.0-255,1484,115165,8,245988
43336,0.003176,172.217.194.0-255,5738,120903,8,245988
43337,0.003179,172.31.36.0-255,66,120969,8,245988
43338,0.003206,172.217.194.0-255,5738,126707,8,245988
43339,0.003209,172.31.36.0-255,66,126773,8,245988
43340,0.003239,172.217.194.0-255,7156,133929,8,245988
43341,0.003242,172.31.36.0-255,66,133995,8,245988
43342,0.003249,172.217.194.0-255,5738,139733,8,245988
43343,0.003251,172.31.36.0-255,66,139799,8,245988
43344,0.003262,172.217.194.0-255,3602,143401,8,245988
43345,0.003264,172.31.36.0-255,66,143467,8,245988
43346,0.003496,172.217.194.0-255,1484,144951,8,245988
43347,0.003517,172.217.194.0-255,2902,147853,8,245988
43348,0.00352,172.31.36.0-255,66,147919,8,245988
43349,0.003525,172.217.194.0-255,2902,150821,8,245988
43350,0.003527,172.31.36.0-255,66,150887,8,245988
43351,0.003549,172.217.194.0-255,2902,153789,8,245988
43352,0.003551,172.31.36.0-255,66,153855,8,245988
43353,0.003571,172.31.36.0-255,66,153921,8,245988
43354,0.003595,172.217.194.0-255,4320,158241,8,245988
43355,0.003598,172.31.36.0-255,66,158307,8,245988
43356,0.003605,172.217.194.0-255,7156,165463,8,245988
43357,0.003608,172.31.36.0-255,66,165529,8,245988
43358,0.003629,172.217.194.0-255,3602,169131,8,245988
43359,0.003632,172.31.36.0-255,66,169197,8,245988
43360,0.003718,172.217.194.0-255,1484,170681,8,245988
43361,0.003735,172.217.194.0-255,2902,173583,8,245988
43362,0.003738,172.31.36.0-255,66,173649,8,245988
43363,0.003759,172.217.194.0-255,5738,179387,8,245988
43364,0.003762,172.31.36.0-255,66,179453,8,245988
43365,0.003772,172.217.194.0-255,1484,180937,8,245988
43366,0.003799,172.31.36.0-255,66,181003,8,245988
43367,0.003806,172.217.194.0-255,5738,186741,8,245988
43368,0.003809,172.31.36.0-255,66,186807,8,245988
43369,0.003842,172.217.194.0-255,5738,192545,8,245988
43370,0.003845,172.31.36.0-255,66,192611,8,245988
43371,0.003849,172.217.194.0-255,2184,194795,8,245988
43372,0.003851,172.31.36.0-255,66,194861,8,245988
43373,0.003895,172.31.36.0-255,66,194927,8,245988
43374,0.003902,172.217.194.0-255,7156,202083,8,245988
43375,0.003905,172.31.36.0-255,66,202149,8,245988
43376,0.003978,172.31.36.0-255,66,202215,8,245988
43377,0.004004,172.217.194.0-255,5738,207953,8,245988
43378,0.004007,172.31.36.0-255,66,208019,8,245988
43379,0.00401,172.217.194.0-255,1484,209503,8,245988
43380,0.004013,172.217.194.0-255,1484,210987,8,245988
43381,0.004016,172.31.36.0-255,66,211053,8,245988
43382,0.004049,172.217.194.0-255,7156,218209,8,245988
43383,0.004052,172.31.36.0-255,66,218275,8,245988
43384,0.004059,172.217.194.0-255,7156,225431,8,245988
43385,0.004062,172.31.36.0-255,66,225497,8,245988
43386,0.004112,172.31.36.0-255,66,225563,8,245988
43387,0.004357,172.217.194.0-255,1484,227047,8,245988
43388,0.004364,172.217.194.0-255,2902,229949,8,245988
43389,0.004368,172.31.36.0-255,66,230015,8,245988
43390,0.004399,172.217.194.0-255,5738,235753,8,245988
43391,0.004403,172.31.36.0-255,66,235819,8,245988
43392,0.004408,172.217.194.0-255,4320,240139,8,245988
43393,0.004411,172.31.36.0-255,66,240205,8,245988
43394,0.004428,172.31.36.0-255,66,240271,8,245988
43395,0.00446,172.217.194.0-255,1484,241755,8,245988
43396,0.004473,172.31.36.0-255,66,241821,8,245988
43397,0.004509,172.31.36.0-255,66,241887,8,245988
43398,0.004559,172.217.194.0-255,105,241992,8,245988
43399,0.007039,172.31.36.0-255,66,242058,8,245988
43400,0.007076,172.31.36.0-255,105,242163,8,245988
43401,0.00933,172.217.194.0-255,66,242229,8,245988
43402,0.038424,172.31.36.0-255,182,242411,8,245988
43403,0.038463,172.31.36.0-255,1111,243522,8,245988
43404,0.038534,172.31.36.0-255,1514,245036,8,245988
43405,0.038536,172.31.36.0-255,754,245790,8,245988
43406,0.039976,104.244.42.0-255,66,245856,8,245988
43407,0.040008,104.244.42.0-255,66,245922,8,245988
43408,0.040112,104.244.42.0-255,66,245988,8,245988
43409,0.0,74.125.68.0-255,152,152,8,362701
43410,2.1e-05,172.31.36.0-255,66,218,8,362701
43411,2.8e-05,74.125.68.0-255,1484,1702,8,362701
43412,3.2e-05,172.31.36.0-255,66,1768,8,362701
43413,3.7e-05,74.125.68.0-255,2902,4670,8,362701
43414,3.9e-05,172.31.36.0-255,66,4736,8,362701
43415,4.4e-05,74.125.68.0-255,2902,7638,8,362701
43416,4.6e-05,172.31.36.0-255,66,7704,8,362701
43417,5.1e-05,74.125.68.0-255,4320,12024,8,362701
43418,5.3e-05,172.31.36.0-255,66,12090,8,362701
43419,9.5e-05,74.125.68.0-255,2077,14167,8,362701
43420,9.9e-05,172.31.36.0-255,66,14233,8,362701
43421,0.00022,74.125.68.0-255,1484,15717,8,362701
43422,0.000224,172.31.36.0-255,66,15783,8,362701
43423,0.00023,74.125.68.0-255,2902,18685,8,362701
43424,0.000232,172.31.36.0-255,66,18751,8,362701
43425,0.000253,74.125.68.0-255,2902,21653,8,362701
43426,0.000256,172.31.36.0-255,66,21719,8,362701
43427,0.00028,74.125.68.0-255,2902,24621,8,362701
43428,0.000282,172.31.36.0-255,66,24687,8,362701
43429,0.00029,74.125.68.0-255,6797,31484,8,362701
43430,0.000292,172.31.36.0-255,66,31550,8,362701
43431,0.000296,74.125.68.0-255,1484,33034,8,362701
43432,0.000298,172.31.36.0-255,66,33100,8,362701
43433,0.000303,74.125.68.0-255,2902,36002,8,362701
43434,0.000305,172.31.36.0-255,66,36068,8,362701
43435,0.000335,74.125.68.0-255,5738,41806,8,362701
43436,0.000337,172.31.36.0-255,66,41872,8,362701
43437,0.000359,74.125.68.0-255,2902,44774,8,362701
43438,0.000361,172.31.36.0-255,66,44840,8,362701
43439,0.000367,74.125.68.0-255,4320,49160,8,362701
43440,0.000369,172.31.36.0-255,66,49226,8,362701
43441,0.000396,172.31.36.0-255,66,49292,8,362701
43442,0.000401,74.125.68.0-255,2902,52194,8,362701
43443,0.000403,172.31.36.0-255,66,52260,8,362701
43444,0.000447,74.125.68.0-255,4320,56580,8,362701
43445,0.00045,172.31.36.0-255,66,56646,8,362701
43446,0.000452,74.125.68.0-255,766,57412,8,362701
43447,0.000479,74.125.68.0-255,679,58091,8,362701
43448,0.000594,74.125.68.0-255,1484,59575,8,362701
43449,0.000599,172.31.36.0-255,66,59641,8,362701
43450,0.000623,74.125.68.0-255,2902,62543,8,362701
43451,0.000626,172.31.36.0-255,66,62609,8,362701
43452,0.000633,74.125.68.0-255,5738,68347,8,362701
43453,0.000635,172.31.36.0-255,66,68413,8,362701
43454,0.000639,74.125.68.0-255,2902,71315,8,362701
43455,0.000642,172.31.36.0-255,66,71381,8,362701
43456,0.00067,74.125.68.0-255,4320,75701,8,362701
43457,0.000673,172.31.36.0-255,66,75767,8,362701
43458,0.000703,74.125.68.0-255,2902,78669,8,362701
43459,0.000707,172.31.36.0-255,66,78735,8,362701
43460,0.000727,74.125.68.0-255,4320,83055,8,362701
43461,0.00073,172.31.36.0-255,66,83121,8,362701
43462,0.000733,74.125.68.0-255,1484,84605,8,362701
43463,0.000753,74.125.68.0-255,7156,91761,8,362701
43464,0.000755,172.31.36.0-255,66,91827,8,362701
43465,0.000758,74.125.68.0-255,766,92593,8,362701
43466,0.000856,74.125.68.0-255,1484,94077,8,362701
43467,0.000859,172.31.36.0-255,66,94143,8,362701
43468,0.000864,74.125.68.0-255,2902,97045,8,362701
43469,0.000867,172.31.36.0-255,66,97111,8,362701
43470,0.000889,74.125.68.0-255,5738,102849,8,362701
43471,0.000893,172.31.36.0-255,66,102915,8,362701
43472,0.000912,172.31.36.0-255,66,102981,8,362701
43473,0.000943,172.31.36.0-255,66,103047,8,362701
43474,0.000961,74.125.68.0-255,1484,104531,8,362701
43475,0.000968,74.125.68.0-255,5020,109551,8,362701
43476,0.000971,172.31.36.0-255,66,109617,8,362701
43477,0.001022,74.125.68.0-255,1484,111101,8,362701
43478,0.001025,74.125.68.0-255,1484,112585,8,362701
43479,0.001027,172.31.36.0-255,66,112651,8,362701
43480,0.001046,74.125.68.0-255,1484,114135,8,362701
43481,0.001051,74.125.68.0-255,2902,117037,8,362701
43482,0.001053,172.31.36.0-255,66,117103,8,362701
43483,0.001079,74.125.68.0-255,4320,121423,8,362701
43484,0.001082,172.31.36.0-255,66,121489,8,362701
43485,0.00112,74.125.68.0-255,5738,127227,8,362701
43486,0.001126,74.125.68.0-255,4320,131547,8,362701
43487,0.001138,74.125.68.0-255,2902,134449,8,362701
43488,0.001158,172.31.36.0-255,66,134515,8,362701
43489,0.001166,74.125.68.0-255,7156,141671,8,362701
43490,0.001174,172.31.36.0-255,66,141737,8,362701
43491,0.001192,74.125.68.0-255,1484,143221,8,362701
43492,0.001211,74.125.68.0-255,6438,149659,8,362701
43493,0.001215,74.125.68.0-255,1484,151143,8,362701
43494,0.001219,74.125.68.0-255,2902,154045,8,362701
43495,0.001239,74.125.68.0-255,5738,159783,8,362701
43496,0.001256,74.125.68.0-255,2902,162685,8,362701
43497,0.001275,74.125.68.0-255,2902,165587,8,362701
43498,0.001293,74.125.68.0-255,7156,172743,8,362701
43499,0.00134,172.31.36.0-255,66,172809,8,362701
43500,0.001347,74.125.68.0-255,5020,177829,8,362701
43501,0.001359,172.31.36.0-255,66,177895,8,362701
43502,0.001391,74.125.68.0-255,1484,179379,8,362701
43503,0.001407,74.125.68.0-255,2902,182281,8,362701
43504,0.001412,172.31.36.0-255,66,182347,8,362701
43505,0.001434,74.125.68.0-255,2902,185249,8,362701
43506,0.001448,74.125.68.0-255,1484,186733,8,362701
43507,0.001454,172.31.36.0-255,66,186799,8,362701
43508,0.001487,74.125.68.0-255,5738,192537,8,362701
43509,0.001494,74.125.68.0-255,7156,199693,8,362701
43510,0.001498,172.31.36.0-255,66,199759,8,362701
43511,0.001506,74.125.68.0-255,1484,201243,8,362701
43512,0.00152,74.125.68.0-255,2184,203427,8,362701
43513,0.001533,172.31.36.0-255,66,203493,8,362701
43514,0.001898,74.125.68.0-255,1484,204977,8,362701
43515,0.001916,74.125.68.0-255,2902,207879,8,362701
43516,0.001919,172.31.36.0-255,66,207945,8,362701
43517,0.001925,74.125.68.0-255,2902,210847,8,362701
43518,0.001936,74.125.68.0-255,1484,212331,8,362701
43519,0.00195,74.125.68.0-255,4320,216651,8,362701
43520,0.001955,172.31.36.0-255,66,216717,8,362701
43521,0.001974,74.125.68.0-255,4320,221037,8,362701
43522,0.00198,74.125.68.0-255,5738,226775,8,362701
43523,0.001983,74.125.68.0-255,1484,228259,8,362701
43524,0.002003,74.125.68.0-255,5738,233997,8,362701
43525,0.002012,172.31.36.0-255,66,234063,8,362701
43526,0.002032,74.125.68.0-255,3602,237665,8,362701
43527,0.002035,172.31.36.0-255,66,237731,8,362701
43528,0.00216,74.125.68.0-255,1484,239215,8,362701
43529,0.002166,74.125.68.0-255,2902,242117,8,362701
43530,0.002171,172.31.36.0-255,66,242183,8,362701
43531,0.002193,74.125.68.0-255,5738,247921,8,362701
43532,0.00221,172.31.36.0-255,66,247987,8,362701
43533,0.002222,74.125.68.0-255,5738,253725,8,362701
43534,0.002227,172.31.36.0-255,66,253791,8,362701
43535,0.002246,74.125.68.0-255,7156,260947,8,362701
43536,0.002265,172.31.36.0-255,66,261013,8,362701
43537,0.002273,74.125.68.0-255,1484,262497,8,362701
43538,0.002353,74.125.68.0-255,1484,263981,8,362701
43539,0.002359,74.125.68.0-255,2902,266883,8,362701
43540,0.00238,74.125.68.0-255,2902,269785,8,362701
43541,0.002394,74.125.68.0-255,4320,274105,8,362701
43542,0.002412,74.125.68.0-255,2902,277007,8,362701
43543,0.002429,74.125.68.0-255,5738,282745,8,362701
43544,0.002434,74.125.68.0-255,2902,285647,8,362701
43545,0.002487,74.125.68.0-255,5738,291385,8,362701
43546,0.00254,74.125.68.0-255,4320,295705,8,362701
43547,0.002547,74.125.68.0-255,5738,301443,8,362701
43548,0.00259,74.125.68.0-255,4320,305763,8,362701
43549,0.002607,74.125.68.0-255,6438,312201,8,362701
43550,0.006738,172.31.36.0-255,66,312267,8,362701
43551,0.009311,74.125.68.0-255,5738,318005,8,362701
43552,0.009317,172.31.36.0-255,66,318071,8,362701
43553,0.011915,74.125.68.0-255,5738,323809,8,362701
43554,0.011922,172.31.36.0-255,66,323875,8,362701
43555,0.01453,74.125.68.0-255,5738,329613,8,362701
43556,0.014538,172.31.36.0-255,66,329679,8,362701
43557,0.017158,74.125.68.0-255,5738,335417,8,362701
43558,0.017168,172.31.36.0-255,66,335483,8,362701
43559,0.019743,74.125.68.0-255,5738,341221,8,362701
43560,0.019753,172.31.36.0-255,66,341287,8,362701
43561,0.02234,74.125.68.0-255,5738,347025,8,362701
43562,0.022349,172.31.36.0-255,66,347091,8,362701
43563,0.02492,74.125.68.0-255,5738,352829,8,362701
43564,0.024926,172.31.36.0-255,66,352895,8,362701
43565,0.027487,74.125.68.0-255,1784,354679,8,362701
43566,0.027494,172.31.36.0-255,66,354745,8,362701
43567,0.028539,172.31.36.0-255,105,354850,8,362701
43568,0.03106,74.125.68.0-255,66,354916,8,362701
43569,0.038082,172.31.36.0-255,172,355088,8,362701
43570,0.038113,172.31.36.0-255,1110,356198,8,362701
43571,0.038184,172.31.36.0-255,1514,357712,8,362701
43572,0.038186,172.31.36.0-255,1514,359226,8,362701
43573,0.038191,172.31.36.0-255,1514,360740,8,362701
43574,0.038192,172.31.36.0-255,1514,362254,8,362701
43575,0.038211,172.31.36.0-255,183,362437,8,362701
43576,0.039575,104.244.42.0-255,66,362503,8,362701
43577,0.039626,104.244.42.0-255,66,362569,8,362701
43578,0.039691,104.244.42.0-255,66,362635,8,362701
43579,0.039697,104.244.42.0-255,66,362701,8,362701
43580,0.0,172.217.194.0-255,152,152,8,189389
43581,1.7e-05,172.31.36.0-255,66,218,8,189389
43582,2.4e-05,172.217.194.0-255,1484,1702,8,189389
43583,2.9e-05,172.31.36.0-255,66,1768,8,189389
43584,3.5e-05,172.217.194.0-255,2902,4670,8,189389
43585,3.8e-05,172.31.36.0-255,66,4736,8,189389
43586,4.2e-05,172.217.194.0-255,1484,6220,8,189389
43587,4.4e-05,172.31.36.0-255,66,6286,8,189389
43588,7.5e-05,172.217.194.0-255,5738,12024,8,189389
43589,7.9e-05,172.31.36.0-255,66,12090,8,189389
43590,9.3e-05,172.31.36.0-255,66,12156,8,189389
43591,0.0001,172.217.194.0-255,6797,18953,8,189389
43592,0.000103,172.31.36.0-255,66,19019,8,189389
43593,0.00018,172.217.194.0-255,1484,20503,8,189389
43594,0.000183,172.31.36.0-255,66,20569,8,189389
43595,0.000188,172.217.194.0-255,2902,23471,8,189389
43596,0.00019,172.31.36.0-255,66,23537,8,189389
43597,0.000208,172.217.194.0-255,5738,29275,8,189389
43598,0.000211,172.31.36.0-255,66,29341,8,189389
43599,0.000242,172.31.36.0-255,66,29407,8,189389
43600,0.000256,172.217.194.0-255,5379,34786,8,189389
43601,0.000259,172.31.36.0-255,66,34852,8,189389
43602,0.000271,172.31.36.0-255,66,34918,8,189389
43603,0.000351,172.217.194.0-255,100,35018,8,189389
43604,0.000355,172.31.36.0-255,66,35084,8,189389
43605,0.000457,172.217.194.0-255,1484,36568,8,189389
43606,0.000461,172.31.36.0-255,66,36634,8,189389
43607,0.000466,172.217.194.0-255,2902,39536,8,189389
43608,0.000469,172.31.36.0-255,66,39602,8,189389
43609,0.000497,172.217.194.0-255,2902,42504,8,189389
43610,0.0005,172.31.36.0-255,66,42570,8,189389
43611,0.000525,172.217.194.0-255,2902,45472,8,189389
43612,0.000528,172.31.36.0-255,66,45538,8,189389
43613,0.000541,172.31.36.0-255,66,45604,8,189389
43614,0.000557,172.217.194.0-255,5738,51342,8,189389
43615,0.000561,172.31.36.0-255,66,51408,8,189389
43616,0.000586,172.217.194.0-255,6515,57923,8,189389
43617,0.000589,172.31.36.0-255,66,57989,8,189389
43618,0.000858,172.217.194.0-255,1484,59473,8,189389
43619,0.000877,172.217.194.0-255,2902,62375,8,189389
43620,0.000881,172.31.36.0-255,66,62441,8,189389
43621,0.000888,172.217.194.0-255,5738,68179,8,189389
43622,0.000891,172.31.36.0-255,66,68245,8,189389
43623,0.000932,172.31.36.0-255,66,68311,8,189389
43624,0.000936,172.217.194.0-255,1484,69795,8,189389
43625,0.000956,172.217.194.0-255,1484,71279,8,189389
43626,0.00096,172.31.36.0-255,66,71345,8,189389
43627,0.000973,172.217.194.0-255,7156,78501,8,189389
43628,0.000976,172.31.36.0-255,66,78567,8,189389
43629,0.000998,172.217.194.0-255,766,79333,8,189389
43630,0.001148,172.217.194.0-255,1484,80817,8,189389
43631,0.001152,172.31.36.0-255,66,80883,8,189389
43632,0.001158,172.217.194.0-255,2902,83785,8,189389
43633,0.00116,172.31.36.0-255,66,83851,8,189389
43634,0.001166,172.217.194.0-255,4320,88171,8,189389
43635,0.001169,172.31.36.0-255,66,88237,8,189389
43636,0.001187,172.217.194.0-255,1484,89721,8,189389
43637,0.001192,172.217.194.0-255,4320,94041,8,189389
43638,0.001195,172.31.36.0-255,66,94107,8,189389
43639,0.001225,172.31.36.0-255,66,94173,8,189389
43640,0.001238,172.31.36.0-255,66,94239,8,189389
43641,0.001883,172.217.194.0-255,1484,95723,8,189389
43642,0.001888,172.217.194.0-255,1484,97207,8,189389
43643,0.001892,172.31.36.0-255,66,97273,8,189389
43644,0.001912,172.217.194.0-255,1484,98757,8,189389
43645,0.001919,172.217.194.0-255,5738,104495,8,189389
43646,0.001921,172.31.36.0-255,66,104561,8,189389
43647,0.001932,172.31.36.0-255,66,104627,8,189389
43648,0.001964,172.217.194.0-255,4320,108947,8,189389
43649,0.001968,172.31.36.0-255,66,109013,8,189389
43650,0.001979,172.31.36.0-255,66,109079,8,189389
43651,0.001982,172.217.194.0-255,766,109845,8,189389
43652,0.002122,172.217.194.0-255,1484,111329,8,189389
43653,0.002126,172.31.36.0-255,66,111395,8,189389
43654,0.002142,172.217.194.0-255,2902,114297,8,189389
43655,0.002144,172.31.36.0-255,66,114363,8,189389
43656,0.002151,172.217.194.0-255,5738,120101,8,189389
43657,0.002153,172.31.36.0-255,66,120167,8,189389
43658,0.002178,172.217.194.0-255,4320,124487,8,189389
43659,0.002181,172.31.36.0-255,66,124553,8,189389
43660,0.002215,172.31.36.0-255,66,124619,8,189389
43661,0.00222,172.217.194.0-255,4320,128939,8,189389
43662,0.002222,172.31.36.0-255,66,129005,8,189389
43663,0.002228,172.217.194.0-255,5738,134743,8,189389
43664,0.00223,172.31.36.0-255,66,134809,8,189389
43665,0.002233,172.217.194.0-255,1484,136293,8,189389
43666,0.002272,172.217.194.0-255,5738,142031,8,189389
43667,0.002277,172.31.36.0-255,66,142097,8,189389
43668,0.002325,172.217.194.0-255,5738,147835,8,189389
43669,0.002364,172.217.194.0-255,1484,149319,8,189389
43670,0.00241,172.217.194.0-255,4320,153639,8,189389
43671,0.002444,172.217.194.0-255,7156,160795,8,189389
43672,0.002446,172.217.194.0-255,1484,162279,8,189389
43673,0.002497,172.217.194.0-255,1484,163763,8,189389
43674,0.002533,172.217.194.0-255,2902,166665,8,189389
43675,0.002538,172.217.194.0-255,4320,170985,8,189389
43676,0.002594,172.217.194.0-255,1484,172469,8,189389
43677,0.00262,172.217.194.0-255,1484,173953,8,189389
43678,0.002637,172.217.194.0-255,5721,179674,8,189389
43679,0.00266,172.217.194.0-255,105,179779,8,189389
43680,0.002874,172.31.36.0-255,66,179845,8,189389
43681,0.002878,172.31.36.0-255,66,179911,8,189389
43682,0.002881,172.31.36.0-255,66,179977,8,189389
43683,0.002884,172.31.36.0-255,66,180043,8,189389
43684,0.002893,172.31.36.0-255,78,180121,8,189389
43685,0.002897,172.31.36.0-255,66,180187,8,189389
43686,0.002899,172.31.36.0-255,66,180253,8,189389
43687,0.002902,172.31.36.0-255,66,180319,8,189389
43688,0.002905,172.31.36.0-255,66,180385,8,189389
43689,0.002909,172.31.36.0-255,66,180451,8,189389
43690,0.002911,172.31.36.0-255,66,180517,8,189389
43691,0.002915,172.31.36.0-255,78,180595,8,189389
43692,0.002918,172.31.36.0-255,78,180673,8,189389
43693,0.002921,172.31.36.0-255,78,180751,8,189389
43694,0.002924,172.31.36.0-255,66,180817,8,189389
43695,0.002926,172.31.36.0-255,78,180895,8,189389
43696,0.00293,172.31.36.0-255,66,180961,8,189389
43697,0.002934,172.31.36.0-255,66,181027,8,189389
43698,0.00326,172.31.36.0-255,101,181128,8,189389
43699,0.004932,172.31.36.0-255,105,181233,8,189389
43700,0.005526,172.217.194.0-255,66,181299,8,189389
43701,0.007178,172.217.194.0-255,66,181365,8,189389
43702,0.029058,172.31.36.0-255,176,181541,8,189389
43703,0.029091,172.31.36.0-255,1110,182651,8,189389
43704,0.02916,172.31.36.0-255,1514,184165,8,189389
43705,0.029162,172.31.36.0-255,1514,185679,8,189389
43706,0.029167,172.31.36.0-255,1514,187193,8,189389
43707,0.029168,172.31.36.0-255,1514,188707,8,189389
43708,0.029188,172.31.36.0-255,418,189125,8,189389
43709,0.030646,104.244.42.0-255,66,189191,8,189389
43710,0.030677,104.244.42.0-255,66,189257,8,189389
43711,0.030725,104.244.42.0-255,66,189323,8,189389
43712,0.030738,104.244.42.0-255,66,189389,8,189389
43713,0.0,74.125.68.0-255,152,152,8,354161
43714,1.5e-05,172.31.36.0-255,66,218,8,354161
43715,2.2e-05,74.125.68.0-255,1484,1702,8,354161
43716,2.6e-05,172.31.36.0-255,66,1768,8,354161
43717,3.9e-05,74.125.68.0-255,2902,4670,8,354161
43718,4.2e-05,172.31.36.0-255,66,4736,8,354161
43719,4.8e-05,74.125.68.0-255,4320,9056,8,354161
43720,5e-05,172.31.36.0-255,66,9122,8,354161
43721,5.6e-05,74.125.68.0-255,4320,13442,8,354161
43722,5.8e-05,172.31.36.0-255,66,13508,8,354161
43723,8.7e-05,74.125.68.0-255,557,14065,8,354161
43724,9e-05,172.31.36.0-255,66,14131,8,354161
43725,9.4e-05,74.125.68.0-255,1484,15615,8,354161
43726,9.5e-05,172.31.36.0-255,66,15681,8,354161
43727,0.00013,172.31.36.0-255,66,15747,8,354161
43728,0.000161,74.125.68.0-255,5379,21126,8,354161
43729,0.000164,172.31.36.0-255,66,21192,8,354161
43730,0.000419,74.125.68.0-255,1484,22676,8,354161
43731,0.000424,172.31.36.0-255,66,22742,8,354161
43732,0.000431,74.125.68.0-255,2902,25644,8,354161
43733,0.000434,172.31.36.0-255,66,25710,8,354161
43734,0.000457,74.125.68.0-255,4320,30030,8,354161
43735,0.00046,172.31.36.0-255,66,30096,8,354161
43736,0.000486,74.125.68.0-255,1484,31580,8,354161
43737,0.000488,172.31.36.0-255,66,31646,8,354161
43738,0.000519,74.125.68.0-255,7156,38802,8,354161
43739,0.000522,172.31.36.0-255,66,38868,8,354161
43740,0.000526,74.125.68.0-255,1484,40352,8,354161
43741,0.000527,172.31.36.0-255,66,40418,8,354161
43742,0.00057,172.31.36.0-255,66,40484,8,354161
43743,0.000573,74.125.68.0-255,1484,41968,8,354161
43744,0.000579,74.125.68.0-255,2902,44870,8,354161
43745,0.000581,172.31.36.0-255,66,44936,8,354161
43746,0.000627,74.125.68.0-255,2184,47120,8,354161
43747,0.000643,172.31.36.0-255,66,47186,8,354161
43748,0.00072,74.125.68.0-255,401,47587,8,354161
43749,0.000757,74.125.68.0-255,1484,49071,8,354161
43750,0.000776,172.31.36.0-255,66,49137,8,354161
43751,0.000781,74.125.68.0-255,2902,52039,8,354161
43752,0.000786,172.31.36.0-255,66,52105,8,354161
43753,0.000806,74.125.68.0-255,1484,53589,8,354161
43754,0.000819,74.125.68.0-255,7156,60745,8,354161
43755,0.000845,74.125.68.0-255,1484,62229,8,354161
43756,0.000857,172.31.36.0-255,66,62295,8,354161
43757,0.000911,172.31.36.0-255,66,62361,8,354161
43758,0.000937,74.125.68.0-255,1484,63845,8,354161
43759,0.000941,74.125.68.0-255,2902,66747,8,354161
43760,0.000946,172.31.36.0-255,66,66813,8,354161
43761,0.000973,74.125.68.0-255,4320,71133,8,354161
43762,0.000989,74.125.68.0-255,1484,72617,8,354161
43763,0.000996,172.31.36.0-255,66,72683,8,354161
43764,0.001013,74.125.68.0-255,4320,77003,8,354161
43765,0.001027,74.125.68.0-255,1484,78487,8,354161
43766,0.001038,172.31.36.0-255,66,78553,8,354161
43767,0.001055,74.125.68.0-255,5738,84291,8,354161
43768,0.001071,172.31.36.0-255,66,84357,8,354161
43769,0.001079,74.125.68.0-255,1484,85841,8,354161
43770,0.001084,74.125.68.0-255,2902,88743,8,354161
43771,0.001092,74.125.68.0-255,4320,93063,8,354161
43772,0.001098,172.31.36.0-255,66,93129,8,354161
43773,0.001121,74.125.68.0-255,1484,94613,8,354161
43774,0.001149,74.125.68.0-255,2184,96797,8,354161
43775,0.001161,74.125.68.0-255,342,97139,8,354161
43776,0.001164,172.31.36.0-255,66,97205,8,354161
43777,0.001202,74.125.68.0-255,1484,98689,8,354161
43778,0.001217,172.31.36.0-255,66,98755,8,354161
43779,0.001222,74.125.68.0-255,2902,101657,8,354161
43780,0.00124,172.31.36.0-255,66,101723,8,354161
43781,0.001247,74.125.68.0-255,5738,107461,8,354161
43782,0.001283,74.125.68.0-255,1484,108945,8,354161
43783,0.001292,172.31.36.0-255,66,109011,8,354161
43784,0.001323,74.125.68.0-255,2184,111195,8,354161
43785,0.001333,172.31.36.0-255,66,111261,8,354161
43786,0.001525,74.125.68.0-255,1484,112745,8,354161
43787,0.001541,74.125.68.0-255,2902,115647,8,354161
43788,0.00156,74.125.68.0-255,4320,119967,8,354161
43789,0.001567,172.31.36.0-255,66,120033,8,354161
43790,0.001593,74.125.68.0-255,1484,121517,8,354161
43791,0.001601,74.125.68.0-255,7156,128673,8,354161
43792,0.00162,172.31.36.0-255,66,128739,8,354161
43793,0.001654,172.31.36.0-255,66,128805,8,354161
43794,0.001661,74.125.68.0-255,1484,130289,8,354161
43795,0.001682,74.125.68.0-255,2184,132473,8,354161
43796,0.001693,172.31.36.0-255,66,132539,8,354161
43797,0.001877,74.125.68.0-255,1484,134023,8,354161
43798,0.001899,74.125.68.0-255,1484,135507,8,354161
43799,0.001903,172.31.36.0-255,66,135573,8,354161
43800,0.001908,74.125.68.0-255,2902,138475,8,354161
43801,0.001915,74.125.68.0-255,5738,144213,8,354161
43802,0.001924,74.125.68.0-255,2902,147115,8,354161
43803,0.001929,74.125.68.0-255,4320,151435,8,354161
43804,0.001951,172.31.36.0-255,66,151501,8,354161
43805,0.001962,74.125.68.0-255,1484,152985,8,354161
43806,0.001987,74.125.68.0-255,7156,160141,8,354161
43807,0.00199,74.125.68.0-255,1484,161625,8,354161
43808,0.001995,74.125.68.0-255,2902,164527,8,354161
43809,0.002008,172.31.36.0-255,66,164593,8,354161
43810,0.002034,74.125.68.0-255,2184,166777,8,354161
43811,0.002041,172.31.36.0-255,66,166843,8,354161
43812,0.002143,74.125.68.0-255,1484,168327,8,354161
43813,0.002159,74.125.68.0-255,2902,171229,8,354161
43814,0.002162,172.31.36.0-255,66,171295,8,354161
43815,0.002181,74.125.68.0-255,2902,174197,8,354161
43816,0.002225,74.125.68.0-255,4320,178517,8,354161
43817,0.002237,74.125.68.0-255,5738,184255,8,354161
43818,0.002276,74.125.68.0-255,7156,191411,8,354161
43819,0.002281,74.125.68.0-255,2902,194313,8,354161
43820,0.002301,74.125.68.0-255,4320,198633,8,354161
43821,0.002329,74.125.68.0-255,2184,200817,8,354161
43822,0.010723,172.31.36.0-255,66,200883,8,354161
43823,0.012158,74.125.68.0-255,1484,202367,8,354161
43824,0.013051,74.125.68.0-255,4320,206687,8,354161
43825,0.013057,172.31.36.0-255,66,206753,8,354161
43826,0.015369,74.125.68.0-255,5738,212491,8,354161
43827,0.015377,172.31.36.0-255,66,212557,8,354161
43828,0.017725,74.125.68.0-255,5738,218295,8,354161
43829,0.017738,172.31.36.0-255,66,218361,8,354161
43830,0.020066,74.125.68.0-255,5738,224099,8,354161
43831,0.020078,172.31.36.0-255,66,224165,8,354161
43832,0.022375,74.125.68.0-255,5738,229903,8,354161
43833,0.022384,172.31.36.0-255,66,229969,8,354161
43834,0.02474,74.125.68.0-255,5738,235707,8,354161
43835,0.024749,172.31.36.0-255,66,235773,8,354161
43836,0.027057,74.125.68.0-255,5738,241511,8,354161
43837,0.027065,172.31.36.0-255,66,241577,8,354161
43838,0.029384,74.125.68.0-255,5738,247315,8,354161
43839,0.029392,172.31.36.0-255,66,247381,8,354161
43840,0.031692,74.125.68.0-255,5738,253119,8,354161
43841,0.0317,172.31.36.0-255,66,253185,8,354161
43842,0.034024,74.125.68.0-255,5738,258923,8,354161
43843,0.03403,172.31.36.0-255,66,258989,8,354161
43844,0.036339,74.125.68.0-255,5738,264727,8,354161
43845,0.036347,172.31.36.0-255,66,264793,8,354161
43846,0.038667,74.125.68.0-255,5738,270531,8,354161
43847,0.038675,172.31.36.0-255,66,270597,8,354161
43848,0.040984,74.125.68.0-255,5738,276335,8,354161
43849,0.040992,172.31.36.0-255,66,276401,8,354161
43850,0.043307,74.125.68.0-255,5738,282139,8,354161
43851,0.043314,172.31.36.0-255,66,282205,8,354161
43852,0.04345,172.31.36.0-255,172,282377,8,354161
43853,0.043483,172.31.36.0-255,1111,283488,8,354161
43854,0.043604,172.31.36.0-255,1514,285002,8,354161
43855,0.043606,172.31.36.0-255,1514,286516,8,354161
43856,0.043612,172.31.36.0-255,1514,288030,8,354161
43857,0.043613,172.31.36.0-255,1514,289544,8,354161
43858,0.043633,172.31.36.0-255,1514,291058,8,354161
43859,0.043634,172.31.36.0-255,995,292053,8,354161
43860,0.045022,104.244.42.0-255,66,292119,8,354161
43861,0.045081,104.244.42.0-255,66,292185,8,354161
43862,0.045179,104.244.42.0-255,66,292251,8,354161
43863,0.045235,104.244.42.0-255,66,292317,8,354161
43864,0.04524,104.244.42.0-255,66,292383,8,354161
43865,0.045633,74.125.68.0-255,5738,298121,8,354161
43866,0.04564,172.31.36.0-255,66,298187,8,354161
43867,0.047955,74.125.68.0-255,5738,303925,8,354161
43868,0.047962,172.31.36.0-255,66,303991,8,354161
43869,0.050275,74.125.68.0-255,5738,309729,8,354161
43870,0.050286,172.31.36.0-255,66,309795,8,354161
43871,0.052608,74.125.68.0-255,5738,315533,8,354161
43872,0.052616,172.31.36.0-255,66,315599,8,354161
43873,0.054931,74.125.68.0-255,5738,321337,8,354161
43874,0.054938,172.31.36.0-255,66,321403,8,354161
43875,0.057269,74.125.68.0-255,5738,327141,8,354161
43876,0.057276,172.31.36.0-255,66,327207,8,354161
43877,0.058231,172.31.36.0-255,108,327315,8,354161
43878,0.059602,74.125.68.0-255,5738,333053,8,354161
43879,0.059609,172.31.36.0-255,66,333119,8,354161
43880,0.059782,104.244.42.0-255,66,333185,8,354161
43881,0.061922,74.125.68.0-255,5738,338923,8,354161
43882,0.06193,172.31.36.0-255,66,338989,8,354161
43883,0.064259,74.125.68.0-255,5738,344727,8,354161
43884,0.064266,172.31.36.0-255,66,344793,8,354161
43885,0.066654,74.125.68.0-255,5738,350531,8,354161
43886,0.066662,172.31.36.0-255,66,350597,8,354161
43887,0.068975,74.125.68.0-255,3393,353990,8,354161
43888,0.068983,172.31.36.0-255,66,354056,8,354161
43889,0.069172,172.31.36.0-255,105,354161,8,354161
43890,0.0,74.125.200.0-255,146,146,8,265088
43891,2.3e-05,172.31.36.0-255,66,212,8,265088
43892,3e-05,74.125.200.0-255,1484,1696,8,265088
43893,3.4e-05,172.31.36.0-255,66,1762,8,265088
43894,4e-05,74.125.200.0-255,2902,4664,8,265088
43895,4.2e-05,172.31.36.0-255,66,4730,8,265088
43896,5.9e-05,74.125.200.0-255,7156,11886,8,265088
43897,6.2e-05,172.31.36.0-255,66,11952,8,265088
43898,6.6e-05,74.125.200.0-255,2000,13952,8,265088
43899,6.8e-05,172.31.36.0-255,66,14018,8,265088
43900,9.6e-05,74.125.200.0-255,4320,18338,8,265088
43901,9.9e-05,172.31.36.0-255,66,18404,8,265088
43902,0.000136,74.125.200.0-255,7156,25560,8,265088
43903,0.000139,172.31.36.0-255,66,25626,8,265088
43904,0.000146,74.125.200.0-255,5379,31005,8,265088
43905,0.000148,172.31.36.0-255,66,31071,8,265088
43906,0.000269,74.125.200.0-255,1484,32555,8,265088
43907,0.000273,172.31.36.0-255,66,32621,8,265088
43908,0.000278,74.125.200.0-255,2902,35523,8,265088
43909,0.000281,172.31.36.0-255,66,35589,8,265088
43910,0.000329,74.125.200.0-255,2902,38491,8,265088
43911,0.000332,172.31.36.0-255,66,38557,8,265088
43912,0.000358,74.125.200.0-255,2902,41459,8,265088
43913,0.000361,172.31.36.0-255,66,41525,8,265088
43914,0.000366,74.125.200.0-255,4320,45845,8,265088
43915,0.000368,172.31.36.0-255,66,45911,8,265088
43916,0.000404,74.125.200.0-255,5379,51290,8,265088
43917,0.000407,172.31.36.0-255,66,51356,8,265088
43918,0.00041,74.125.200.0-255,1484,52840,8,265088
43919,0.000412,172.31.36.0-255,66,52906,8,265088
43920,0.000417,74.125.200.0-255,2902,55808,8,265088
43921,0.000423,172.31.36.0-255,66,55874,8,265088
43922,0.000458,74.125.200.0-255,5738,61612,8,265088
43923,0.00046,172.31.36.0-255,66,61678,8,265088
43924,0.000466,74.125.200.0-255,4277,65955,8,265088
43925,0.000468,172.31.36.0-255,66,66021,8,265088
43926,0.00184,74.125.200.0-255,109,66130,8,265088
43927,0.002225,74.125.200.0-255,1484,67614,8,265088
43928,0.002232,172.31.36.0-255,66,67680,8,265088
43929,0.002264,74.125.200.0-255,2902,70582,8,265088
43930,0.002266,172.31.36.0-255,66,70648,8,265088
43931,0.00227,74.125.200.0-255,1484,72132,8,265088
43932,0.002294,74.125.200.0-255,2902,75034,8,265088
43933,0.002297,172.31.36.0-255,66,75100,8,265088
43934,0.002304,74.125.200.0-255,5738,80838,8,265088
43935,0.002305,172.31.36.0-255,66,80904,8,265088
43936,0.002339,172.31.36.0-255,66,80970,8,265088
43937,0.002342,74.125.200.0-255,1484,82454,8,265088
43938,0.002389,172.31.36.0-255,66,82520,8,265088
43939,0.002392,74.125.200.0-255,766,83286,8,265088
43940,0.002431,74.125.200.0-255,1484,84770,8,265088
43941,0.002434,172.31.36.0-255,66,84836,8,265088
43942,0.002439,74.125.200.0-255,2902,87738,8,265088
43943,0.002441,172.31.36.0-255,66,87804,8,265088
43944,0.002446,74.125.200.0-255,4320,92124,8,265088
43945,0.002452,172.31.36.0-255,66,92190,8,265088
43946,0.002479,74.125.200.0-255,4320,96510,8,265088
43947,0.002482,172.31.36.0-255,66,96576,8,265088
43948,0.002498,74.125.200.0-255,2902,99478,8,265088
43949,0.0025,172.31.36.0-255,66,99544,8,265088
43950,0.002527,172.31.36.0-255,66,99610,8,265088
43951,0.002531,74.125.200.0-255,2902,102512,8,265088
43952,0.002533,172.31.36.0-255,66,102578,8,265088
43953,0.00503,74.125.200.0-255,2902,105480,8,265088
43954,0.005034,172.31.36.0-255,66,105546,8,265088
43955,0.005052,74.125.200.0-255,2902,108448,8,265088
43956,0.005056,172.31.36.0-255,66,108514,8,265088
43957,0.007542,74.125.200.0-255,2902,111416,8,265088
43958,0.007549,172.31.36.0-255,66,111482,8,265088
43959,0.007579,74.125.200.0-255,2902,114384,8,265088
43960,0.007581,172.31.36.0-255,66,114450,8,265088
43961,0.01005,74.125.200.0-255,2902,117352,8,265088
43962,0.010059,172.31.36.0-255,66,117418,8,265088
43963,0.010091,74.125.200.0-255,2902,120320,8,265088
43964,0.010094,172.31.36.0-255,66,120386,8,265088
43965,0.012573,74.125.200.0-255,2902,123288,8,265088
43966,0.012582,172.31.36.0-255,66,123354,8,265088
43967,0.012613,74.125.200.0-255,2902,126256,8,265088
43968,0.012616,172.31.36.0-255,66,126322,8,265088
43969,0.015098,74.125.200.0-255,2902,129224,8,265088
43970,0.015107,172.31.36.0-255,66,129290,8,265088
43971,0.015143,74.125.200.0-255,2902,132192,8,265088
43972,0.015146,172.31.36.0-255,66,132258,8,265088
43973,0.017621,74.125.200.0-255,2902,135160,8,265088
43974,0.017631,172.31.36.0-255,66,135226,8,265088
43975,0.017666,74.125.200.0-255,2902,138128,8,265088
43976,0.017669,172.31.36.0-255,66,138194,8,265088
43977,0.020166,74.125.200.0-255,2902,141096,8,265088
43978,0.020185,172.31.36.0-255,66,141162,8,265088
43979,0.020228,74.125.200.0-255,2902,144064,8,265088
43980,0.020231,172.31.36.0-255,66,144130,8,265088
43981,0.022698,74.125.200.0-255,2902,147032,8,265088
43982,0.022711,172.31.36.0-255,66,147098,8,265088
43983,0.022744,74.125.200.0-255,2902,150000,8,265088
43984,0.022747,172.31.36.0-255,66,150066,8,265088
43985,0.02522,74.125.200.0-255,2902,152968,8,265088
43986,0.025231,172.31.36.0-255,66,153034,8,265088
43987,0.025265,74.125.200.0-255,2902,155936,8,265088
43988,0.025268,172.31.36.0-255,66,156002,8,265088
43989,0.027731,74.125.200.0-255,2902,158904,8,265088
43990,0.027737,172.31.36.0-255,66,158970,8,265088
43991,0.027757,74.125.200.0-255,2902,161872,8,265088
43992,0.02776,172.31.36.0-255,66,161938,8,265088
43993,0.029164,172.31.36.0-255,172,162110,8,265088
43994,0.029198,172.31.36.0-255,1110,163220,8,265088
43995,0.029264,172.31.36.0-255,1514,164734,8,265088
43996,0.029266,172.31.36.0-255,1514,166248,8,265088
43997,0.02927,172.31.36.0-255,1514,167762,8,265088
43998,0.029271,172.31.36.0-255,1514,169276,8,265088
43999,0.029291,172.31.36.0-255,1514,170790,8,265088
44000,0.029292,172.31.36.0-255,996,171786,8,265088
44001,0.030255,74.125.200.0-255,5738,177524,8,265088
44002,0.030262,172.31.36.0-255,66,177590,8,265088
44003,0.030701,104.244.42.0-255,66,177656,8,265088
44004,0.030755,104.244.42.0-255,66,177722,8,265088
44005,0.030853,104.244.42.0-255,66,177788,8,265088
44006,0.03086,104.244.42.0-255,66,177854,8,265088
44007,0.032774,74.125.200.0-255,5738,183592,8,265088
44008,0.032782,172.31.36.0-255,66,183658,8,265088
44009,0.035287,74.125.200.0-255,5738,189396,8,265088
44010,0.035296,172.31.36.0-255,66,189462,8,265088
44011,0.037821,74.125.200.0-255,5738,195200,8,265088
44012,0.037831,172.31.36.0-255,66,195266,8,265088
44013,0.040365,74.125.200.0-255,5738,201004,8,265088
44014,0.040376,172.31.36.0-255,66,201070,8,265088
44015,0.042895,74.125.200.0-255,5738,206808,8,265088
44016,0.04291,172.31.36.0-255,66,206874,8,265088
44017,0.045419,74.125.200.0-255,5738,212612,8,265088
44018,0.045426,172.31.36.0-255,66,212678,8,265088
44019,0.047965,74.125.200.0-255,5738,218416,8,265088
44020,0.047972,172.31.36.0-255,66,218482,8,265088
44021,0.048278,172.31.36.0-255,108,218590,8,265088
44022,0.049836,104.244.42.0-255,66,218656,8,265088
44023,0.050479,74.125.200.0-255,5738,224394,8,265088
44024,0.050488,172.31.36.0-255,66,224460,8,265088
44025,0.053001,74.125.200.0-255,5738,230198,8,265088
44026,0.05301,172.31.36.0-255,66,230264,8,265088
44027,0.055529,74.125.200.0-255,5738,236002,8,265088
44028,0.055542,172.31.36.0-255,66,236068,8,265088
44029,0.058094,74.125.200.0-255,5738,241806,8,265088
44030,0.058105,172.31.36.0-255,66,241872,8,265088
44031,0.060628,74.125.200.0-255,5738,247610,8,265088
44032,0.060637,172.31.36.0-255,66,247676,8,265088
44033,0.063143,74.125.200.0-255,5738,253414,8,265088
44034,0.063149,172.31.36.0-255,66,253480,8,265088
44035,0.065655,74.125.200.0-255,5738,259218,8,265088
44036,0.065662,172.31.36.0-255,66,259284,8,265088
44037,0.06821,74.125.200.0-255,5738,265022,8,265088
44038,0.068216,172.31.36.0-255,66,265088,8,265088
44039,0.0,172.217.194.0-255,298,298,8,223023
44040,3.1e-05,172.31.36.0-255,66,364,8,223023
44041,3.8e-05,172.217.194.0-255,1484,1848,8,223023
44042,4.2e-05,172.31.36.0-255,66,1914,8,223023
44043,4.8e-05,172.217.194.0-255,4320,6234,8,223023
44044,5.8e-05,172.31.36.0-255,66,6300,8,223023
44045,6.8e-05,172.31.36.0-255,66,6366,8,223023
44046,0.000122,172.217.194.0-255,1484,7850,8,223023
44047,0.000126,172.31.36.0-255,66,7916,8,223023
44048,0.000132,172.217.194.0-255,2902,10818,8,223023
44049,0.000134,172.31.36.0-255,66,10884,8,223023
44050,0.000148,172.217.194.0-255,5738,16622,8,223023
44051,0.000151,172.31.36.0-255,66,16688,8,223023
44052,0.000195,172.217.194.0-255,7156,23844,8,223023
44053,0.000198,172.31.36.0-255,66,23910,8,223023
44054,0.000234,172.217.194.0-255,6797,30707,8,223023
44055,0.000237,172.31.36.0-255,66,30773,8,223023
44056,0.000247,172.31.36.0-255,66,30839,8,223023
44057,0.000278,172.31.36.0-255,66,30905,8,223023
44058,0.000313,172.31.36.0-255,66,30971,8,223023
44059,0.000316,172.217.194.0-255,365,31336,8,223023
44060,0.000318,172.31.36.0-255,66,31402,8,223023
44061,0.000357,172.217.194.0-255,1484,32886,8,223023
44062,0.00036,172.31.36.0-255,66,32952,8,223023
44063,0.000379,172.217.194.0-255,2902,35854,8,223023
44064,0.000382,172.31.36.0-255,66,35920,8,223023
44065,0.000389,172.217.194.0-255,5738,41658,8,223023
44066,0.000392,172.31.36.0-255,66,41724,8,223023
44067,0.000462,172.31.36.0-255,66,41790,8,223023
44068,0.000498,172.31.36.0-255,66,41856,8,223023
44069,0.000851,172.217.194.0-255,1484,43340,8,223023
44070,0.000871,172.217.194.0-255,2902,46242,8,223023
44071,0.000875,172.31.36.0-255,66,46308,8,223023
44072,0.000882,172.217.194.0-255,5738,52046,8,223023
44073,0.000883,172.31.36.0-255,66,52112,8,223023
44074,0.000923,172.31.36.0-255,66,52178,8,223023
44075,0.000929,172.217.194.0-255,4320,56498,8,223023
44076,0.000931,172.31.36.0-255,66,56564,8,223023
44077,0.000966,172.217.194.0-255,6438,63002,8,223023
44078,0.00097,172.31.36.0-255,66,63068,8,223023
44079,0.000986,172.217.194.0-255,1484,64552,8,223023
44080,0.000999,172.217.194.0-255,2902,67454,8,223023
44081,0.001002,172.31.36.0-255,66,67520,8,223023
44082,0.001006,172.217.194.0-255,1484,69004,8,223023
44083,0.001029,172.217.194.0-255,4320,73324,8,223023
44084,0.001032,172.31.36.0-255,66,73390,8,223023
44085,0.001038,172.217.194.0-255,5738,79128,8,223023
44086,0.001042,172.31.36.0-255,66,79194,8,223023
44087,0.001074,172.217.194.0-255,7156,86350,8,223023
44088,0.001077,172.31.36.0-255,66,86416,8,223023
44089,0.001095,172.31.36.0-255,66,86482,8,223023
44090,0.001277,172.217.194.0-255,1484,87966,8,223023
44091,0.001283,172.217.194.0-255,2902,90868,8,223023
44092,0.001287,172.31.36.0-255,66,90934,8,223023
44093,0.001292,172.217.194.0-255,2902,93836,8,223023
44094,0.001294,172.31.36.0-255,66,93902,8,223023
44095,0.001314,172.217.194.0-255,2902,96804,8,223023
44096,0.001317,172.31.36.0-255,66,96870,8,223023
44097,0.001337,172.31.36.0-255,66,96936,8,223023
44098,0.001343,172.217.194.0-255,4320,101256,8,223023
44099,0.001346,172.31.36.0-255,66,101322,8,223023
44100,0.001374,172.217.194.0-255,4320,105642,8,223023
44101,0.001382,172.31.36.0-255,66,105708,8,223023
44102,0.0014,172.217.194.0-255,2184,107892,8,223023
44103,0.001403,172.31.36.0-255,66,107958,8,223023
44104,0.001633,172.217.194.0-255,1484,109442,8,223023
44105,0.001651,172.217.194.0-255,2902,112344,8,223023
44106,0.001655,172.31.36.0-255,66,112410,8,223023
44107,0.001662,172.217.194.0-255,5738,118148,8,223023
44108,0.001664,172.31.36.0-255,66,118214,8,223023
44109,0.001704,172.31.36.0-255,66,118280,8,223023
44110,0.001715,172.31.36.0-255,66,118346,8,223023
44111,0.001757,172.31.36.0-255,66,118412,8,223023
44112,0.001798,172.31.36.0-255,66,118478,8,223023
44113,0.001847,172.31.36.0-255,66,118544,8,223023
44114,0.001865,172.217.194.0-255,4320,122864,8,223023
44115,0.001868,172.31.36.0-255,66,122930,8,223023
44116,0.001872,172.217.194.0-255,2184,125114,8,223023
44117,0.001874,172.31.36.0-255,66,125180,8,223023
44118,0.001991,172.217.194.0-255,1484,126664,8,223023
44119,0.001996,172.217.194.0-255,1484,128148,8,223023
44120,0.001998,172.31.36.0-255,66,128214,8,223023
44121,0.002024,172.217.194.0-255,1484,129698,8,223023
44122,0.00203,172.217.194.0-255,5738,135436,8,223023
44123,0.002033,172.31.36.0-255,66,135502,8,223023
44124,0.002051,172.217.194.0-255,4320,139822,8,223023
44125,0.002054,172.31.36.0-255,66,139888,8,223023
44126,0.002079,172.31.36.0-255,66,139954,8,223023
44127,0.002082,172.217.194.0-255,1484,141438,8,223023
44128,0.002113,172.31.36.0-255,66,141504,8,223023
44129,0.002116,172.217.194.0-255,766,142270,8,223023
44130,0.002135,172.217.194.0-255,1484,143754,8,223023
44131,0.002137,172.31.36.0-255,66,143820,8,223023
44132,0.002161,172.217.194.0-255,1484,145304,8,223023
44133,0.002165,172.217.194.0-255,2902,148206,8,223023
44134,0.002167,172.31.36.0-255,66,148272,8,223023
44135,0.002173,172.217.194.0-255,5738,154010,8,223023
44136,0.002175,172.31.36.0-255,66,154076,8,223023
44137,0.002205,172.31.36.0-255,66,154142,8,223023
44138,0.002223,172.217.194.0-255,2902,157044,8,223023
44139,0.002225,172.31.36.0-255,66,157110,8,223023
44140,0.002235,172.31.36.0-255,66,157176,8,223023
44141,0.002264,172.217.194.0-255,4320,161496,8,223023
44142,0.002266,172.31.36.0-255,66,161562,8,223023
44143,0.002308,172.31.36.0-255,66,161628,8,223023
44144,0.002312,172.217.194.0-255,4320,165948,8,223023
44145,0.002314,172.31.36.0-255,66,166014,8,223023
44146,0.004568,172.217.194.0-255,2902,168916,8,223023
44147,0.004575,172.31.36.0-255,66,168982,8,223023
44148,0.0046,172.217.194.0-255,2902,171884,8,223023
44149,0.004602,172.31.36.0-255,66,171950,8,223023
44150,0.006794,172.217.194.0-255,2902,174852,8,223023
44151,0.006803,172.31.36.0-255,66,174918,8,223023
44152,0.006832,172.217.194.0-255,2902,177820,8,223023
44153,0.006836,172.31.36.0-255,66,177886,8,223023
44154,0.009025,172.217.194.0-255,2902,180788,8,223023
44155,0.009032,172.31.36.0-255,66,180854,8,223023
44156,0.009065,172.217.194.0-255,2902,183756,8,223023
44157,0.009067,172.31.36.0-255,66,183822,8,223023
44158,0.01126,172.217.194.0-255,2902,186724,8,223023
44159,0.011266,172.31.36.0-255,66,186790,8,223023
44160,0.011295,172.217.194.0-255,2902,189692,8,223023
44161,0.011298,172.31.36.0-255,66,189758,8,223023
44162,0.013467,172.217.194.0-255,1484,191242,8,223023
44163,0.013485,172.217.194.0-255,1484,192726,8,223023
44164,0.01349,172.31.36.0-255,66,192792,8,223023
44165,0.013541,172.217.194.0-255,2902,195694,8,223023
44166,0.013546,172.31.36.0-255,66,195760,8,223023
44167,0.015728,172.217.194.0-255,2902,198662,8,223023
44168,0.015735,172.31.36.0-255,66,198728,8,223023
44169,0.015768,172.217.194.0-255,2902,201630,8,223023
44170,0.01577,172.31.36.0-255,66,201696,8,223023
44171,0.017956,172.217.194.0-255,2902,204598,8,223023
44172,0.017962,172.31.36.0-255,66,204664,8,223023
44173,0.018026,172.217.194.0-255,2902,207566,8,223023
44174,0.018029,172.31.36.0-255,66,207632,8,223023
44175,0.020219,172.217.194.0-255,2902,210534,8,223023
44176,0.020227,172.31.36.0-255,66,210600,8,223023
44177,0.020271,172.217.194.0-255,2902,213502,8,223023
44178,0.020274,172.31.36.0-255,66,213568,8,223023
44179,0.022447,172.217.194.0-255,2357,215925,8,223023
44180,0.022454,172.31.36.0-255,66,215991,8,223023
44181,0.022638,172.31.36.0-255,105,216096,8,223023
44182,0.024862,172.217.194.0-255,66,216162,8,223023
44183,0.041992,172.31.36.0-255,172,216334,8,223023
44184,0.042025,172.31.36.0-255,1112,217446,8,223023
44185,0.042072,172.31.36.0-255,1514,218960,8,223023
44186,0.042074,172.31.36.0-255,1514,220474,8,223023
44187,0.042075,172.31.36.0-255,1514,221988,8,223023
44188,0.042076,172.31.36.0-255,771,222759,8,223023
44189,0.043593,104.244.42.0-255,66,222825,8,223023
44190,0.043604,104.244.42.0-255,66,222891,8,223023
44191,0.043674,104.244.42.0-255,66,222957,8,223023
44192,0.043678,104.244.42.0-255,66,223023,8,223023
44193,0.0,74.125.24.0-255,153,153,8,286532
44194,1.9e-05,172.31.36.0-255,66,219,8,286532
44195,2.7e-05,74.125.24.0-255,1484,1703,8,286532
44196,3.1e-05,172.31.36.0-255,66,1769,8,286532
44197,3.6e-05,74.125.24.0-255,2902,4671,8,286532
44198,4e-05,172.31.36.0-255,66,4737,8,286532
44199,4.7e-05,74.125.24.0-255,7156,11893,8,286532
44200,5e-05,172.31.36.0-255,66,11959,8,286532
44201,5.6e-05,74.125.24.0-255,4874,16833,8,286532
44202,6e-05,172.31.36.0-255,66,16899,8,286532
44203,8.7e-05,172.31.36.0-255,66,16965,8,286532
44204,0.000105,74.125.24.0-255,3961,20926,8,286532
44205,0.000108,172.31.36.0-255,66,20992,8,286532
44206,0.000147,74.125.24.0-255,1484,22476,8,286532
44207,0.00015,172.31.36.0-255,66,22542,8,286532
44208,0.000155,74.125.24.0-255,2902,25444,8,286532
44209,0.000157,172.31.36.0-255,66,25510,8,286532
44210,0.000162,74.125.24.0-255,2902,28412,8,286532
44211,0.000164,172.31.36.0-255,66,28478,8,286532
44212,0.000192,74.125.24.0-255,2902,31380,8,286532
44213,0.000194,172.31.36.0-255,66,31446,8,286532
44214,0.000201,74.125.24.0-255,6797,38243,8,286532
44215,0.000204,172.31.36.0-255,66,38309,8,286532
44216,0.00049,74.125.24.0-255,1484,39793,8,286532
44217,0.000495,172.31.36.0-255,66,39859,8,286532
44218,0.0005,74.125.24.0-255,1484,41343,8,286532
44219,0.000502,172.31.36.0-255,66,41409,8,286532
44220,0.000507,74.125.24.0-255,2902,44311,8,286532
44221,0.000509,172.31.36.0-255,66,44377,8,286532
44222,0.000515,74.125.24.0-255,4320,48697,8,286532
44223,0.000517,172.31.36.0-255,66,48763,8,286532
44224,0.000541,74.125.24.0-255,1484,50247,8,286532
44225,0.000556,74.125.24.0-255,2902,53149,8,286532
44226,0.000559,172.31.36.0-255,66,53215,8,286532
44227,0.000576,74.125.24.0-255,2543,55758,8,286532
44228,0.000579,172.31.36.0-255,66,55824,8,286532
44229,0.000601,74.125.24.0-255,1484,57308,8,286532
44230,0.000624,74.125.24.0-255,2902,60210,8,286532
44231,0.00063,74.125.24.0-255,5738,65948,8,286532
44232,0.000634,172.31.36.0-255,66,66014,8,286532
44233,0.000643,172.31.36.0-255,66,66080,8,286532
44234,0.000675,172.31.36.0-255,66,66146,8,286532
44235,0.000698,74.125.24.0-255,2543,68689,8,286532
44236,0.000702,172.31.36.0-255,66,68755,8,286532
44237,0.000714,172.31.36.0-255,66,68821,8,286532
44238,0.000718,74.125.24.0-255,1704,70525,8,286532
44239,0.00072,172.31.36.0-255,66,70591,8,286532
44240,0.001685,74.125.24.0-255,1484,72075,8,286532
44241,0.001696,74.125.24.0-255,2902,74977,8,286532
44242,0.001701,172.31.36.0-255,66,75043,8,286532
44243,0.001709,74.125.24.0-255,5738,80781,8,286532
44244,0.001711,172.31.36.0-255,66,80847,8,286532
44245,0.001746,172.31.36.0-255,66,80913,8,286532
44246,0.001795,172.31.36.0-255,66,80979,8,286532
44247,0.001897,74.125.24.0-255,1484,82463,8,286532
44248,0.001918,74.125.24.0-255,2902,85365,8,286532
44249,0.001922,172.31.36.0-255,66,85431,8,286532
44250,0.001926,74.125.24.0-255,1484,86915,8,286532
44251,0.001944,74.125.24.0-255,4320,91235,8,286532
44252,0.001947,172.31.36.0-255,66,91301,8,286532
44253,0.001986,172.31.36.0-255,66,91367,8,286532
44254,0.002031,172.31.36.0-255,66,91433,8,286532
44255,0.002039,74.125.24.0-255,7156,98589,8,286532
44256,0.002041,172.31.36.0-255,66,98655,8,286532
44257,0.00207,74.125.24.0-255,4320,102975,8,286532
44258,0.002072,172.31.36.0-255,66,103041,8,286532
44259,0.00209,172.31.36.0-255,66,103107,8,286532
44260,0.002126,74.125.24.0-255,5738,108845,8,286532
44261,0.002128,172.31.36.0-255,66,108911,8,286532
44262,0.002165,172.31.36.0-255,66,108977,8,286532
44263,0.002177,172.31.36.0-255,66,109043,8,286532
44264,0.0022,74.125.24.0-255,2184,111227,8,286532
44265,0.002202,172.31.36.0-255,66,111293,8,286532
44266,0.00231,74.125.24.0-255,1484,112777,8,286532
44267,0.002316,74.125.24.0-255,1484,114261,8,286532
44268,0.002319,172.31.36.0-255,66,114327,8,286532
44269,0.002338,74.125.24.0-255,1484,115811,8,286532
44270,0.002342,74.125.24.0-255,1484,117295,8,286532
44271,0.002344,172.31.36.0-255,66,117361,8,286532
44272,0.002363,74.125.24.0-255,4320,121681,8,286532
44273,0.002365,172.31.36.0-255,66,121747,8,286532
44274,0.0024,172.31.36.0-255,66,121813,8,286532
44275,0.004704,74.125.24.0-255,5738,127551,8,286532
44276,0.004709,172.31.36.0-255,66,127617,8,286532
44277,0.007029,74.125.24.0-255,5738,133355,8,286532
44278,0.007036,172.31.36.0-255,66,133421,8,286532
44279,0.009353,74.125.24.0-255,5738,139159,8,286532
44280,0.009361,172.31.36.0-255,66,139225,8,286532
44281,0.01173,74.125.24.0-255,5738,144963,8,286532
44282,0.011738,172.31.36.0-255,66,145029,8,286532
44283,0.014077,74.125.24.0-255,5738,150767,8,286532
44284,0.014085,172.31.36.0-255,66,150833,8,286532
44285,0.016452,74.125.24.0-255,5738,156571,8,286532
44286,0.016462,172.31.36.0-255,66,156637,8,286532
44287,0.018824,74.125.24.0-255,5738,162375,8,286532
44288,0.018833,172.31.36.0-255,66,162441,8,286532
44289,0.021191,74.125.24.0-255,5738,168179,8,286532
44290,0.021198,172.31.36.0-255,66,168245,8,286532
44291,0.023583,74.125.24.0-255,5738,173983,8,286532
44292,0.02359,172.31.36.0-255,66,174049,8,286532
44293,0.025911,74.125.24.0-255,5738,179787,8,286532
44294,0.025918,172.31.36.0-255,66,179853,8,286532
44295,0.028266,74.125.24.0-255,5738,185591,8,286532
44296,0.028277,172.31.36.0-255,66,185657,8,286532
44297,0.030619,74.125.24.0-255,5738,191395,8,286532
44298,0.030627,172.31.36.0-255,66,191461,8,286532
44299,0.03296,74.125.24.0-255,5738,197199,8,286532
44300,0.032969,172.31.36.0-255,66,197265,8,286532
44301,0.035311,74.125.24.0-255,5738,203003,8,286532
44302,0.035318,172.31.36.0-255,66,203069,8,286532
44303,0.037675,74.125.24.0-255,5738,208807,8,286532
44304,0.037684,172.31.36.0-255,66,208873,8,286532
44305,0.040029,74.125.24.0-255,5738,214611,8,286532
44306,0.040043,172.31.36.0-255,66,214677,8,286532
44307,0.042394,74.125.24.0-255,5738,220415,8,286532
44308,0.042402,172.31.36.0-255,66,220481,8,286532
44309,0.043913,172.31.36.0-255,190,220671,8,286532
44310,0.043954,172.31.36.0-255,1111,221782,8,286532
44311,0.044022,172.31.36.0-255,1514,223296,8,286532
44312,0.044024,172.31.36.0-255,1514,224810,8,286532
44313,0.044028,172.31.36.0-255,1514,226324,8,286532
44314,0.044029,172.31.36.0-255,773,227097,8,286532
44315,0.044735,74.125.24.0-255,5738,232835,8,286532
44316,0.044743,172.31.36.0-255,66,232901,8,286532
44317,0.045448,104.244.42.0-255,66,232967,8,286532
44318,0.045497,104.244.42.0-255,66,233033,8,286532
44319,0.045604,104.244.42.0-255,66,233099,8,286532
44320,0.04561,104.244.42.0-255,66,233165,8,286532
44321,0.047099,74.125.24.0-255,5738,238903,8,286532
44322,0.047106,172.31.36.0-255,66,238969,8,286532
44323,0.049474,74.125.24.0-255,5738,244707,8,286532
44324,0.049481,172.31.36.0-255,66,244773,8,286532
44325,0.051826,74.125.24.0-255,5738,250511,8,286532
44326,0.051833,172.31.36.0-255,66,250577,8,286532
44327,0.054183,74.125.24.0-255,5738,256315,8,286532
44328,0.054189,172.31.36.0-255,66,256381,8,286532
44329,0.056518,74.125.24.0-255,5738,262119,8,286532
44330,0.056525,172.31.36.0-255,66,262185,8,286532
44331,0.058865,74.125.24.0-255,5738,267923,8,286532
44332,0.058872,172.31.36.0-255,66,267989,8,286532
44333,0.06121,74.125.24.0-255,5738,273727,8,286532
44334,0.061216,172.31.36.0-255,66,273793,8,286532
44335,0.06356,74.125.24.0-255,5738,279531,8,286532
44336,0.063567,172.31.36.0-255,66,279597,8,286532
44337,0.065936,74.125.24.0-255,5738,285335,8,286532
44338,0.065942,172.31.36.0-255,66,285401,8,286532
44339,0.068288,74.125.24.0-255,960,286361,8,286532
44340,0.068431,172.31.36.0-255,66,286427,8,286532
44341,0.068468,172.31.36.0-255,105,286532,8,286532
44342,0.0,74.125.68.0-255,150,150,8,229084
44343,1.5e-05,172.31.36.0-255,66,216,8,229084
44344,2.2e-05,74.125.68.0-255,1484,1700,8,229084
44345,2.6e-05,172.31.36.0-255,66,1766,8,229084
44346,3.2e-05,74.125.68.0-255,2902,4668,8,229084
44347,4.3e-05,172.31.36.0-255,66,4734,8,229084
44348,8.7e-05,74.125.68.0-255,2902,7636,8,229084
44349,9.1e-05,172.31.36.0-255,66,7702,8,229084
44350,0.000157,172.31.36.0-255,66,7768,8,229084
44351,0.000325,74.125.68.0-255,4320,12088,8,229084
44352,0.000332,172.31.36.0-255,66,12154,8,229084
44353,0.00042,74.125.68.0-255,5738,17892,8,229084
44354,0.000424,172.31.36.0-255,66,17958,8,229084
44355,0.000463,172.31.36.0-255,66,18024,8,229084
44356,0.000814,74.125.68.0-255,5738,23762,8,229084
44357,0.000819,172.31.36.0-255,66,23828,8,229084
44358,0.000849,74.125.68.0-255,3602,27430,8,229084
44359,0.000851,172.31.36.0-255,66,27496,8,229084
44360,0.001034,172.31.36.0-255,66,27562,8,229084
44361,0.001071,172.31.36.0-255,66,27628,8,229084
44362,0.001405,74.125.68.0-255,4320,31948,8,229084
44363,0.001411,172.31.36.0-255,66,32014,8,229084
44364,0.001464,172.31.36.0-255,66,32080,8,229084
44365,0.00203,74.125.68.0-255,5020,37100,8,229084
44366,0.002036,172.31.36.0-255,66,37166,8,229084
44367,0.002159,74.125.68.0-255,5738,42904,8,229084
44368,0.002162,172.31.36.0-255,66,42970,8,229084
44369,0.002822,74.125.68.0-255,2902,45872,8,229084
44370,0.003618,74.125.68.0-255,7156,53028,8,229084
44371,0.003636,74.125.68.0-255,5738,58766,8,229084
44372,0.004204,172.31.36.0-255,66,58832,8,229084
44373,0.006444,74.125.68.0-255,5738,64570,8,229084
44374,0.006451,172.31.36.0-255,66,64636,8,229084
44375,0.008688,74.125.68.0-255,5738,70374,8,229084
44376,0.008695,172.31.36.0-255,66,70440,8,229084
44377,0.010941,74.125.68.0-255,5738,76178,8,229084
44378,0.010949,172.31.36.0-255,66,76244,8,229084
44379,0.0132,74.125.68.0-255,5738,81982,8,229084
44380,0.013207,172.31.36.0-255,66,82048,8,229084
44381,0.01551,74.125.68.0-255,5738,87786,8,229084
44382,0.01554,172.31.36.0-255,66,87852,8,229084
44383,0.017792,74.125.68.0-255,5738,93590,8,229084
44384,0.017801,172.31.36.0-255,66,93656,8,229084
44385,0.020033,74.125.68.0-255,4320,97976,8,229084
44386,0.02004,172.31.36.0-255,66,98042,8,229084
44387,0.02007,74.125.68.0-255,1484,99526,8,229084
44388,0.022273,74.125.68.0-255,4320,103846,8,229084
44389,0.022279,172.31.36.0-255,66,103912,8,229084
44390,0.024518,74.125.68.0-255,5738,109650,8,229084
44391,0.024567,172.31.36.0-255,66,109716,8,229084
44392,0.026817,74.125.68.0-255,5738,115454,8,229084
44393,0.026824,172.31.36.0-255,66,115520,8,229084
44394,0.028076,172.31.36.0-255,188,115708,8,229084
44395,0.028251,172.31.36.0-255,955,116663,8,229084
44396,0.028325,172.31.36.0-255,1514,118177,8,229084
44397,0.028327,172.31.36.0-255,135,118312,8,229084
44398,0.029072,74.125.68.0-255,5738,124050,8,229084
44399,0.02908,172.31.36.0-255,66,124116,8,229084
44400,0.029632,104.244.42.0-255,66,124182,8,229084
44401,0.029785,104.244.42.0-255,66,124248,8,229084
44402,0.029883,104.244.42.0-255,66,124314,8,229084
44403,0.031313,74.125.68.0-255,2902,127216,8,229084
44404,0.031318,172.31.36.0-255,66,127282,8,229084
44405,0.031349,74.125.68.0-255,2902,130184,8,229084
44406,0.031381,172.31.36.0-255,66,130250,8,229084
44407,0.03356,74.125.68.0-255,2902,133152,8,229084
44408,0.033568,172.31.36.0-255,66,133218,8,229084
44409,0.033625,74.125.68.0-255,2902,136120,8,229084
44410,0.033641,172.31.36.0-255,66,136186,8,229084
44411,0.035817,74.125.68.0-255,2902,139088,8,229084
44412,0.035825,172.31.36.0-255,66,139154,8,229084
44413,0.035868,74.125.68.0-255,1484,140638,8,229084
44414,0.035883,74.125.68.0-255,1484,142122,8,229084
44415,0.035898,172.31.36.0-255,66,142188,8,229084
44416,0.038052,74.125.68.0-255,1484,143672,8,229084
44417,0.038072,74.125.68.0-255,1484,145156,8,229084
44418,0.038078,172.31.36.0-255,66,145222,8,229084
44419,0.038123,74.125.68.0-255,2902,148124,8,229084
44420,0.038153,172.31.36.0-255,66,148190,8,229084
44421,0.040306,74.125.68.0-255,2902,151092,8,229084
44422,0.040315,172.31.36.0-255,66,151158,8,229084
44423,0.040381,74.125.68.0-255,2902,154060,8,229084
44424,0.040411,172.31.36.0-255,66,154126,8,229084
44425,0.042556,74.125.68.0-255,2902,157028,8,229084
44426,0.042562,172.31.36.0-255,66,157094,8,229084
44427,0.042638,74.125.68.0-255,2902,159996,8,229084
44428,0.042655,172.31.36.0-255,66,160062,8,229084
44429,0.044819,74.125.68.0-255,2902,162964,8,229084
44430,0.044826,172.31.36.0-255,66,163030,8,229084
44431,0.044882,74.125.68.0-255,2902,165932,8,229084
44432,0.044917,172.31.36.0-255,66,165998,8,229084
44433,0.047072,74.125.68.0-255,2902,168900,8,229084
44434,0.047079,172.31.36.0-255,66,168966,8,229084
44435,0.047142,74.125.68.0-255,2902,171868,8,229084
44436,0.047179,172.31.36.0-255,66,171934,8,229084
44437,0.049317,74.125.68.0-255,2902,174836,8,229084
44438,0.049323,172.31.36.0-255,66,174902,8,229084
44439,0.049406,74.125.68.0-255,2902,177804,8,229084
44440,0.049433,172.31.36.0-255,66,177870,8,229084
44441,0.051571,74.125.68.0-255,2902,180772,8,229084
44442,0.051578,172.31.36.0-255,66,180838,8,229084
44443,0.051664,74.125.68.0-255,2902,183740,8,229084
44444,0.051673,172.31.36.0-255,66,183806,8,229084
44445,0.053817,74.125.68.0-255,2902,186708,8,229084
44446,0.053823,172.31.36.0-255,66,186774,8,229084
44447,0.0539,74.125.68.0-255,2902,189676,8,229084
44448,0.053914,172.31.36.0-255,66,189742,8,229084
44449,0.056052,74.125.68.0-255,1484,191226,8,229084
44450,0.056159,74.125.68.0-255,4320,195546,8,229084
44451,0.056165,172.31.36.0-255,66,195612,8,229084
44452,0.058411,74.125.68.0-255,5738,201350,8,229084
44453,0.058451,172.31.36.0-255,66,201416,8,229084
44454,0.060692,74.125.68.0-255,4320,205736,8,229084
44455,0.060698,172.31.36.0-255,66,205802,8,229084
44456,0.060725,74.125.68.0-255,1484,207286,8,229084
44457,0.062941,74.125.68.0-255,4320,211606,8,229084
44458,0.062948,172.31.36.0-255,66,211672,8,229084
44459,0.065197,74.125.68.0-255,5738,217410,8,229084
44460,0.065255,172.31.36.0-255,66,217476,8,229084
44461,0.067509,74.125.68.0-255,5738,223214,8,229084
44462,0.067516,172.31.36.0-255,66,223280,8,229084
44463,0.069772,74.125.68.0-255,5738,229018,8,229084
44464,0.069778,172.31.36.0-255,66,229084,8,229084
44465,0.0,74.125.24.0-255,152,152,8,340272
44466,3.4e-05,172.31.36.0-255,66,218,8,340272
44467,4.2e-05,74.125.24.0-255,1484,1702,8,340272
44468,4.6e-05,172.31.36.0-255,66,1768,8,340272
44469,5.1e-05,74.125.24.0-255,2902,4670,8,340272
44470,5.4e-05,172.31.36.0-255,66,4736,8,340272
44471,6e-05,74.125.24.0-255,7156,11892,8,340272
44472,6.3e-05,172.31.36.0-255,66,11958,8,340272
44473,9.3e-05,74.125.24.0-255,7156,19114,8,340272
44474,9.8e-05,172.31.36.0-255,66,19180,8,340272
44475,0.000116,74.125.24.0-255,4857,24037,8,340272
44476,0.000119,172.31.36.0-255,66,24103,8,340272
44477,0.000163,74.125.24.0-255,6797,30900,8,340272
44478,0.000167,172.31.36.0-255,66,30966,8,340272
44479,0.000277,74.125.24.0-255,1484,32450,8,340272
44480,0.000281,172.31.36.0-255,66,32516,8,340272
44481,0.000286,74.125.24.0-255,2902,35418,8,340272
44482,0.000289,172.31.36.0-255,66,35484,8,340272
44483,0.000296,74.125.24.0-255,5738,41222,8,340272
44484,0.000299,172.31.36.0-255,66,41288,8,340272
44485,0.000322,74.125.24.0-255,2902,44190,8,340272
44486,0.000324,172.31.36.0-255,66,44256,8,340272
44487,0.000329,74.125.24.0-255,2902,47158,8,340272
44488,0.000332,172.31.36.0-255,66,47224,8,340272
44489,0.000354,172.31.36.0-255,66,47290,8,340272
44490,0.00042,74.125.24.0-255,5738,53028,8,340272
44491,0.000424,172.31.36.0-255,66,53094,8,340272
44492,0.000442,74.125.24.0-255,4235,57329,8,340272
44493,0.000444,172.31.36.0-255,66,57395,8,340272
44494,0.000447,74.125.24.0-255,414,57809,8,340272
44495,0.00045,172.31.36.0-255,66,57875,8,340272
44496,0.000623,74.125.24.0-255,1484,59359,8,340272
44497,0.00063,74.125.24.0-255,2902,62261,8,340272
44498,0.000634,172.31.36.0-255,66,62327,8,340272
44499,0.000638,74.125.24.0-255,2902,65229,8,340272
44500,0.000641,172.31.36.0-255,66,65295,8,340272
44501,0.000655,74.125.24.0-255,2902,68197,8,340272
44502,0.000657,172.31.36.0-255,66,68263,8,340272
44503,0.00068,74.125.24.0-255,1484,69747,8,340272
44504,0.000703,74.125.24.0-255,4320,74067,8,340272
44505,0.000706,172.31.36.0-255,66,74133,8,340272
44506,0.000713,74.125.24.0-255,5738,79871,8,340272
44507,0.000715,172.31.36.0-255,66,79937,8,340272
44508,0.000732,74.125.24.0-255,7156,87093,8,340272
44509,0.000735,172.31.36.0-255,66,87159,8,340272
44510,0.000791,74.125.24.0-255,4320,91479,8,340272
44511,0.000795,172.31.36.0-255,66,91545,8,340272
44512,0.000809,74.125.24.0-255,766,92311,8,340272
44513,0.001145,172.31.36.0-255,66,92377,8,340272
44514,0.001401,74.125.24.0-255,1484,93861,8,340272
44515,0.00141,74.125.24.0-255,1484,95345,8,340272
44516,0.001415,172.31.36.0-255,66,95411,8,340272
44517,0.001445,74.125.24.0-255,1484,96895,8,340272
44518,0.001452,74.125.24.0-255,5738,102633,8,340272
44519,0.001454,172.31.36.0-255,66,102699,8,340272
44520,0.001481,172.31.36.0-255,66,102765,8,340272
44521,0.0015,74.125.24.0-255,4320,107085,8,340272
44522,0.001503,172.31.36.0-255,66,107151,8,340272
44523,0.001559,74.125.24.0-255,1484,108635,8,340272
44524,0.001584,74.125.24.0-255,5738,114373,8,340272
44525,0.001588,172.31.36.0-255,66,114439,8,340272
44526,0.001612,74.125.24.0-255,3602,118041,8,340272
44527,0.001614,172.31.36.0-255,66,118107,8,340272
44528,0.001648,74.125.24.0-255,1484,119591,8,340272
44529,0.001665,74.125.24.0-255,1484,121075,8,340272
44530,0.00167,172.31.36.0-255,66,121141,8,340272
44531,0.00168,74.125.24.0-255,1484,122625,8,340272
44532,0.001699,74.125.24.0-255,2902,125527,8,340272
44533,0.001702,172.31.36.0-255,66,125593,8,340272
44534,0.001713,172.31.36.0-255,66,125659,8,340272
44535,0.001724,172.31.36.0-255,66,125725,8,340272
44536,0.001749,172.31.36.0-255,66,125791,8,340272
44537,0.001978,74.125.24.0-255,1484,127275,8,340272
44538,0.001983,74.125.24.0-255,1484,128759,8,340272
44539,0.001986,172.31.36.0-255,66,128825,8,340272
44540,0.002004,74.125.24.0-255,1484,130309,8,340272
44541,0.00201,74.125.24.0-255,5738,136047,8,340272
44542,0.002013,172.31.36.0-255,66,136113,8,340272
44543,0.002035,74.125.24.0-255,2902,139015,8,340272
44544,0.002037,172.31.36.0-255,66,139081,8,340272
44545,0.002059,172.31.36.0-255,66,139147,8,340272
44546,0.002079,74.125.24.0-255,1484,140631,8,340272
44547,0.002111,74.125.24.0-255,5738,146369,8,340272
44548,0.002114,172.31.36.0-255,66,146435,8,340272
44549,0.00214,74.125.24.0-255,5020,151455,8,340272
44550,0.002143,172.31.36.0-255,66,151521,8,340272
44551,0.002176,74.125.24.0-255,2902,154423,8,340272
44552,0.002179,172.31.36.0-255,66,154489,8,340272
44553,0.002231,74.125.24.0-255,7156,161645,8,340272
44554,0.002234,172.31.36.0-255,66,161711,8,340272
44555,0.002263,74.125.24.0-255,1484,163195,8,340272
44556,0.002279,172.31.36.0-255,66,163261,8,340272
44557,0.002349,74.125.24.0-255,5738,168999,8,340272
44558,0.002353,172.31.36.0-255,66,169065,8,340272
44559,0.00237,74.125.24.0-255,766,169831,8,340272
44560,0.002409,172.31.36.0-255,66,169897,8,340272
44561,0.002431,74.125.24.0-255,5738,175635,8,340272
44562,0.002434,172.31.36.0-255,66,175701,8,340272
44563,0.002533,74.125.24.0-255,2902,178603,8,340272
44564,0.002536,172.31.36.0-255,66,178669,8,340272
44565,0.002559,74.125.24.0-255,6438,185107,8,340272
44566,0.002562,172.31.36.0-255,66,185173,8,340272
44567,0.002688,172.31.36.0-255,101,185274,8,340272
44568,0.004844,74.125.24.0-255,5738,191012,8,340272
44569,0.00485,172.31.36.0-255,66,191078,8,340272
44570,0.004929,74.125.24.0-255,66,191144,8,340272
44571,0.007162,74.125.24.0-255,5738,196882,8,340272
44572,0.007168,172.31.36.0-255,66,196948,8,340272
44573,0.009466,74.125.24.0-255,5738,202686,8,340272
44574,0.009474,172.31.36.0-255,66,202752,8,340272
44575,0.011766,74.125.24.0-255,5738,208490,8,340272
44576,0.011777,172.31.36.0-255,66,208556,8,340272
44577,0.014072,74.125.24.0-255,5738,214294,8,340272
44578,0.01408,172.31.36.0-255,66,214360,8,340272
44579,0.016361,74.125.24.0-255,5738,220098,8,340272
44580,0.016369,172.31.36.0-255,66,220164,8,340272
44581,0.018648,74.125.24.0-255,5738,225902,8,340272
44582,0.018658,172.31.36.0-255,66,225968,8,340272
44583,0.020918,74.125.24.0-255,5738,231706,8,340272
44584,0.020925,172.31.36.0-255,66,231772,8,340272
44585,0.023234,74.125.24.0-255,5738,237510,8,340272
44586,0.023242,172.31.36.0-255,66,237576,8,340272
44587,0.025523,74.125.24.0-255,5738,243314,8,340272
44588,0.02553,172.31.36.0-255,66,243380,8,340272
44589,0.027816,74.125.24.0-255,5738,249118,8,340272
44590,0.027824,172.31.36.0-255,66,249184,8,340272
44591,0.030136,74.125.24.0-255,5738,254922,8,340272
44592,0.030148,172.31.36.0-255,66,254988,8,340272
44593,0.032441,74.125.24.0-255,5738,260726,8,340272
44594,0.032449,172.31.36.0-255,66,260792,8,340272
44595,0.034746,74.125.24.0-255,5738,266530,8,340272
44596,0.034754,172.31.36.0-255,66,266596,8,340272
44597,0.037071,74.125.24.0-255,5738,272334,8,340272
44598,0.037078,172.31.36.0-255,66,272400,8,340272
44599,0.037177,172.31.36.0-255,188,272588,8,340272
44600,0.037234,172.31.36.0-255,955,273543,8,340272
44601,0.037395,172.31.36.0-255,1514,275057,8,340272
44602,0.037397,172.31.36.0-255,1514,276571,8,340272
44603,0.037402,172.31.36.0-255,1514,278085,8,340272
44604,0.037403,172.31.36.0-255,1514,279599,8,340272
44605,0.037427,172.31.36.0-255,1430,281029,8,340272
44606,0.038723,104.244.42.0-255,66,281095,8,340272
44607,0.03876,104.244.42.0-255,66,281161,8,340272
44608,0.039005,104.244.42.0-255,66,281227,8,340272
44609,0.039334,74.125.24.0-255,4320,285547,8,340272
44610,0.039338,172.31.36.0-255,66,285613,8,340272
44611,0.03937,74.125.24.0-255,1484,287097,8,340272
44612,0.041614,74.125.24.0-255,4320,291417,8,340272
44613,0.04162,172.31.36.0-255,66,291483,8,340272
44614,0.043873,74.125.24.0-255,5738,297221,8,340272
44615,0.043878,172.31.36.0-255,66,297287,8,340272
44616,0.046163,74.125.24.0-255,5738,303025,8,340272
44617,0.046169,172.31.36.0-255,66,303091,8,340272
44618,0.048426,74.125.24.0-255,4320,307411,8,340272
44619,0.048431,172.31.36.0-255,66,307477,8,340272
44620,0.048457,74.125.24.0-255,1484,308961,8,340272
44621,0.050752,74.125.24.0-255,4320,313281,8,340272
44622,0.050757,172.31.36.0-255,66,313347,8,340272
44623,0.053048,74.125.24.0-255,4320,317667,8,340272
44624,0.053053,172.31.36.0-255,66,317733,8,340272
44625,0.053082,74.125.24.0-255,1484,319217,8,340272
44626,0.055333,74.125.24.0-255,4320,323537,8,340272
44627,0.055341,172.31.36.0-255,66,323603,8,340272
44628,0.057628,74.125.24.0-255,4320,327923,8,340272
44629,0.057634,172.31.36.0-255,66,327989,8,340272
44630,0.057664,74.125.24.0-255,1484,329473,8,340272
44631,0.0599,74.125.24.0-255,1484,330957,8,340272
44632,0.059905,172.31.36.0-255,66,331023,8,340272
44633,0.059935,74.125.24.0-255,2902,333925,8,340272
44634,0.059938,172.31.36.0-255,66,333991,8,340272
44635,0.062202,74.125.24.0-255,5738,339729,8,340272
44636,0.06221,172.31.36.0-255,66,339795,8,340272
44637,0.064521,74.125.24.0-255,372,340167,8,340272
44638,0.064692,172.31.36.0-255,105,340272,8,340272
44639,0.0,216.58.221.0-255,153,153,8,297595
44640,3.4e-05,172.31.36.0-255,66,219,8,297595
44641,4.2e-05,216.58.221.0-255,1484,1703,8,297595
44642,4.6e-05,172.31.36.0-255,66,1769,8,297595
44643,5.8e-05,216.58.221.0-255,2902,4671,8,297595
44644,6.2e-05,172.31.36.0-255,66,4737,8,297595
44645,6.9e-05,216.58.221.0-255,5738,10475,8,297595
44646,7.1e-05,172.31.36.0-255,66,10541,8,297595
44647,0.000112,216.58.221.0-255,3456,13997,8,297595
44648,0.000117,172.31.36.0-255,66,14063,8,297595
44649,0.000148,216.58.221.0-255,1484,15547,8,297595
44650,0.000152,172.31.36.0-255,66,15613,8,297595
44651,0.000158,216.58.221.0-255,2902,18515,8,297595
44652,0.00016,172.31.36.0-255,66,18581,8,297595
44653,0.000203,216.58.221.0-255,5738,24319,8,297595
44654,0.000207,172.31.36.0-255,66,24385,8,297595
44655,0.000217,216.58.221.0-255,6797,31182,8,297595
44656,0.000219,172.31.36.0-255,66,31248,8,297595
44657,0.000624,216.58.221.0-255,1484,32732,8,297595
44658,0.000629,172.31.36.0-255,66,32798,8,297595
44659,0.000637,216.58.221.0-255,2902,35700,8,297595
44660,0.00064,172.31.36.0-255,66,35766,8,297595
44661,0.000652,216.58.221.0-255,4320,40086,8,297595
44662,0.000654,172.31.36.0-255,66,40152,8,297595
44663,0.000661,216.58.221.0-255,5738,45890,8,297595
44664,0.000663,172.31.36.0-255,66,45956,8,297595
44665,0.000688,216.58.221.0-255,2543,48499,8,297595
44666,0.000691,172.31.36.0-255,66,48565,8,297595
44667,0.000805,216.58.221.0-255,1484,50049,8,297595
44668,0.000809,172.31.36.0-255,66,50115,8,297595
44669,0.000815,216.58.221.0-255,2902,53017,8,297595
44670,0.000817,172.31.36.0-255,66,53083,8,297595
44671,0.000847,216.58.221.0-255,5738,58821,8,297595
44672,0.000849,172.31.36.0-255,66,58887,8,297595
44673,0.000857,216.58.221.0-255,7126,66013,8,297595
44674,0.000859,172.31.36.0-255,66,66079,8,297595
44675,0.001632,216.58.221.0-255,114,66193,8,297595
44676,0.001794,216.58.221.0-255,1484,67677,8,297595
44677,0.0018,172.31.36.0-255,66,67743,8,297595
44678,0.001807,216.58.221.0-255,2902,70645,8,297595
44679,0.00181,172.31.36.0-255,66,70711,8,297595
44680,0.001821,216.58.221.0-255,4320,75031,8,297595
44681,0.001824,172.31.36.0-255,66,75097,8,297595
44682,0.001829,216.58.221.0-255,4320,79417,8,297595
44683,0.001831,172.31.36.0-255,66,79483,8,297595
44684,0.00186,216.58.221.0-255,5379,84862,8,297595
44685,0.001864,172.31.36.0-255,66,84928,8,297595
44686,0.00188,172.31.36.0-255,66,84994,8,297595
44687,0.001908,216.58.221.0-255,1125,86119,8,297595
44688,0.003798,216.58.221.0-255,4320,90439,8,297595
44689,0.003807,172.31.36.0-255,66,90505,8,297595
44690,0.005739,216.58.221.0-255,5738,96243,8,297595
44691,0.005746,172.31.36.0-255,66,96309,8,297595
44692,0.007665,216.58.221.0-255,5738,102047,8,297595
44693,0.00767,172.31.36.0-255,66,102113,8,297595
44694,0.009596,216.58.221.0-255,5738,107851,8,297595
44695,0.009602,172.31.36.0-255,66,107917,8,297595
44696,0.01153,216.58.221.0-255,5738,113655,8,297595
44697,0.011537,172.31.36.0-255,66,113721,8,297595
44698,0.013499,216.58.221.0-255,5738,119459,8,297595
44699,0.013506,172.31.36.0-255,66,119525,8,297595
44700,0.015437,216.58.221.0-255,5738,125263,8,297595
44701,0.015449,172.31.36.0-255,66,125329,8,297595
44702,0.017381,216.58.221.0-255,5738,131067,8,297595
44703,0.017389,172.31.36.0-255,66,131133,8,297595
44704,0.019324,216.58.221.0-255,5738,136871,8,297595
44705,0.019333,172.31.36.0-255,66,136937,8,297595
44706,0.021261,216.58.221.0-255,5738,142675,8,297595
44707,0.02127,172.31.36.0-255,66,142741,8,297595
44708,0.023213,216.58.221.0-255,5738,148479,8,297595
44709,0.023221,172.31.36.0-255,66,148545,8,297595
44710,0.025141,216.58.221.0-255,5738,154283,8,297595
44711,0.025149,172.31.36.0-255,66,154349,8,297595
44712,0.027081,216.58.221.0-255,5738,160087,8,297595
44713,0.02709,172.31.36.0-255,66,160153,8,297595
44714,0.029016,216.58.221.0-255,5738,165891,8,297595
44715,0.029023,172.31.36.0-255,66,165957,8,297595
44716,0.030949,216.58.221.0-255,5738,171695,8,297595
44717,0.030957,172.31.36.0-255,66,171761,8,297595
44718,0.032898,216.58.221.0-255,5738,177499,8,297595
44719,0.032903,172.31.36.0-255,66,177565,8,297595
44720,0.033354,172.31.36.0-255,172,177737,8,297595
44721,0.033384,172.31.36.0-255,1111,178848,8,297595
44722,0.033452,172.31.36.0-255,1514,180362,8,297595
44723,0.033454,172.31.36.0-255,1514,181876,8,297595
44724,0.033459,172.31.36.0-255,1514,183390,8,297595
44725,0.03346,172.31.36.0-255,1514,184904,8,297595
44726,0.033479,172.31.36.0-255,1514,186418,8,297595
44727,0.03348,172.31.36.0-255,637,187055,8,297595
44728,0.03488,216.58.221.0-255,5738,192793,8,297595
44729,0.034887,172.31.36.0-255,66,192859,8,297595
44730,0.034894,104.244.42.0-255,66,192925,8,297595
44731,0.034899,104.244.42.0-255,66,192991,8,297595
44732,0.034968,104.244.42.0-255,66,193057,8,297595
44733,0.034973,104.244.42.0-255,66,193123,8,297595
44734,0.036812,216.58.221.0-255,5738,198861,8,297595
44735,0.036818,172.31.36.0-255,66,198927,8,297595
44736,0.038749,216.58.221.0-255,5738,204665,8,297595
44737,0.038755,172.31.36.0-255,66,204731,8,297595
44738,0.040684,216.58.221.0-255,5738,210469,8,297595
44739,0.040691,172.31.36.0-255,66,210535,8,297595
44740,0.042614,216.58.221.0-255,5738,216273,8,297595
44741,0.042619,172.31.36.0-255,66,216339,8,297595
44742,0.044538,216.58.221.0-255,5738,222077,8,297595
44743,0.044543,172.31.36.0-255,66,222143,8,297595
44744,0.046461,216.58.221.0-255,5738,227881,8,297595
44745,0.046466,172.31.36.0-255,66,227947,8,297595
44746,0.048394,216.58.221.0-255,5738,233685,8,297595
44747,0.048399,172.31.36.0-255,66,233751,8,297595
44748,0.050326,216.58.221.0-255,5738,239489,8,297595
44749,0.050332,172.31.36.0-255,66,239555,8,297595
44750,0.05226,216.58.221.0-255,5738,245293,8,297595
44751,0.052266,172.31.36.0-255,66,245359,8,297595
44752,0.05419,216.58.221.0-255,5738,251097,8,297595
44753,0.054197,172.31.36.0-255,66,251163,8,297595
44754,0.056117,216.58.221.0-255,5738,256901,8,297595
44755,0.056124,172.31.36.0-255,66,256967,8,297595
44756,0.058067,216.58.221.0-255,5738,262705,8,297595
44757,0.058073,172.31.36.0-255,66,262771,8,297595
44758,0.059999,216.58.221.0-255,5738,268509,8,297595
44759,0.060005,172.31.36.0-255,66,268575,8,297595
44760,0.061928,216.58.221.0-255,5738,274313,8,297595
44761,0.061934,172.31.36.0-255,66,274379,8,297595
44762,0.063863,216.58.221.0-255,5738,280117,8,297595
44763,0.063869,172.31.36.0-255,66,280183,8,297595
44764,0.065787,216.58.221.0-255,5738,285921,8,297595
44765,0.065793,172.31.36.0-255,66,285987,8,297595
44766,0.067709,216.58.221.0-255,5738,291725,8,297595
44767,0.067715,172.31.36.0-255,66,291791,8,297595
44768,0.069638,216.58.221.0-255,5738,297529,8,297595
44769,0.069644,172.31.36.0-255,66,297595,8,297595
44770,0.0,74.125.130.0-255,153,153,8,318656
44771,3.1e-05,172.31.36.0-255,66,219,8,318656
44772,3.8e-05,74.125.130.0-255,1484,1703,8,318656
44773,4.3e-05,172.31.36.0-255,66,1769,8,318656
44774,4.8e-05,74.125.130.0-255,2902,4671,8,318656
44775,5.2e-05,172.31.36.0-255,66,4737,8,318656
44776,6.7e-05,74.125.130.0-255,7156,11893,8,318656
44777,7e-05,172.31.36.0-255,66,11959,8,318656
44778,7.4e-05,74.125.130.0-255,2102,14061,8,318656
44779,7.7e-05,172.31.36.0-255,66,14127,8,318656
44780,0.000507,74.125.130.0-255,1484,15611,8,318656
44781,0.000513,172.31.36.0-255,66,15677,8,318656
44782,0.000523,74.125.130.0-255,2902,18579,8,318656
44783,0.000526,172.31.36.0-255,66,18645,8,318656
44784,0.000538,74.125.130.0-255,2902,21547,8,318656
44785,0.000541,172.31.36.0-255,66,21613,8,318656
44786,0.000564,74.125.130.0-255,2902,24515,8,318656
44787,0.000572,172.31.36.0-255,66,24581,8,318656
44788,0.000585,172.31.36.0-255,66,24647,8,318656
44789,0.000596,172.31.36.0-255,66,24713,8,318656
44790,0.00063,74.125.130.0-255,2902,27615,8,318656
44791,0.000634,172.31.36.0-255,66,27681,8,318656
44792,0.000692,172.31.36.0-255,66,27747,8,318656
44793,0.000694,74.125.130.0-255,375,28122,8,318656
44794,0.000696,172.31.36.0-255,66,28188,8,318656
44795,0.000699,74.125.130.0-255,99,28287,8,318656
44796,0.000701,172.31.36.0-255,66,28353,8,318656
44797,0.000879,74.125.130.0-255,1484,29837,8,318656
44798,0.000885,172.31.36.0-255,66,29903,8,318656
44799,0.000892,74.125.130.0-255,2902,32805,8,318656
44800,0.000893,172.31.36.0-255,66,32871,8,318656
44801,0.000899,74.125.130.0-255,4320,37191,8,318656
44802,0.000908,172.31.36.0-255,66,37257,8,318656
44803,0.000937,74.125.130.0-255,1484,38741,8,318656
44804,0.000941,74.125.130.0-255,1484,40225,8,318656
44805,0.000953,172.31.36.0-255,66,40291,8,318656
44806,0.000958,74.125.130.0-255,2902,43193,8,318656
44807,0.00096,172.31.36.0-255,66,43259,8,318656
44808,0.000966,74.125.130.0-255,5738,48997,8,318656
44809,0.000968,172.31.36.0-255,66,49063,8,318656
44810,0.000974,74.125.130.0-255,7156,56219,8,318656
44811,0.000976,172.31.36.0-255,66,56285,8,318656
44812,0.001017,74.125.130.0-255,5738,62023,8,318656
44813,0.00102,172.31.36.0-255,66,62089,8,318656
44814,0.001022,74.125.130.0-255,766,62855,8,318656
44815,0.001047,74.125.130.0-255,1484,64339,8,318656
44816,0.001049,172.31.36.0-255,66,64405,8,318656
44817,0.001053,74.125.130.0-255,2902,67307,8,318656
44818,0.001055,172.31.36.0-255,66,67373,8,318656
44819,0.001058,74.125.130.0-255,1484,68857,8,318656
44820,0.001088,74.125.130.0-255,4320,73177,8,318656
44821,0.001091,172.31.36.0-255,66,73243,8,318656
44822,0.001098,74.125.130.0-255,7156,80399,8,318656
44823,0.0011,172.31.36.0-255,66,80465,8,318656
44824,0.001104,74.125.130.0-255,2902,83367,8,318656
44825,0.001106,172.31.36.0-255,66,83433,8,318656
44826,0.001146,172.31.36.0-255,66,83499,8,318656
44827,0.00115,74.125.130.0-255,2184,85683,8,318656
44828,0.001152,172.31.36.0-255,66,85749,8,318656
44829,0.00126,74.125.130.0-255,1484,87233,8,318656
44830,0.001266,74.125.130.0-255,2902,90135,8,318656
44831,0.001269,172.31.36.0-255,66,90201,8,318656
44832,0.001276,74.125.130.0-255,5738,95939,8,318656
44833,0.001278,172.31.36.0-255,66,96005,8,318656
44834,0.001284,74.125.130.0-255,5738,101743,8,318656
44835,0.001286,172.31.36.0-255,66,101809,8,318656
44836,0.001323,74.125.130.0-255,1484,103293,8,318656
44837,0.001338,172.31.36.0-255,66,103359,8,318656
44838,0.001342,74.125.130.0-255,2484,105843,8,318656
44839,0.001344,172.31.36.0-255,66,105909,8,318656
44840,0.001414,74.125.130.0-255,1484,107393,8,318656
44841,0.001419,74.125.130.0-255,2902,110295,8,318656
44842,0.001421,172.31.36.0-255,66,110361,8,318656
44843,0.001426,74.125.130.0-255,2902,113263,8,318656
44844,0.001427,172.31.36.0-255,66,113329,8,318656
44845,0.001448,74.125.130.0-255,4320,117649,8,318656
44846,0.001451,172.31.36.0-255,66,117715,8,318656
44847,0.001458,74.125.130.0-255,7156,124871,8,318656
44848,0.001466,172.31.36.0-255,66,124937,8,318656
44849,0.001476,74.125.130.0-255,1484,126421,8,318656
44850,0.00148,74.125.130.0-255,2902,129323,8,318656
44851,0.001483,172.31.36.0-255,66,129389,8,318656
44852,0.001518,172.31.36.0-255,66,129455,8,318656
44853,0.001581,74.125.130.0-255,1484,130939,8,318656
44854,0.001586,74.125.130.0-255,2902,133841,8,318656
44855,0.001588,172.31.36.0-255,66,133907,8,318656
44856,0.001594,74.125.130.0-255,5738,139645,8,318656
44857,0.001596,172.31.36.0-255,66,139711,8,318656
44858,0.001611,172.31.36.0-255,66,139777,8,318656
44859,0.001635,74.125.130.0-255,2902,142679,8,318656
44860,0.001637,172.31.36.0-255,66,142745,8,318656
44861,0.001648,74.125.130.0-255,7156,149901,8,318656
44862,0.001651,172.31.36.0-255,66,149967,8,318656
44863,0.001655,74.125.130.0-255,3602,153569,8,318656
44864,0.001657,172.31.36.0-255,66,153635,8,318656
44865,0.002079,74.125.130.0-255,1484,155119,8,318656
44866,0.002085,74.125.130.0-255,2902,158021,8,318656
44867,0.002089,172.31.36.0-255,66,158087,8,318656
44868,0.002094,74.125.130.0-255,2902,160989,8,318656
44869,0.002096,172.31.36.0-255,66,161055,8,318656
44870,0.002101,74.125.130.0-255,2902,163957,8,318656
44871,0.002108,172.31.36.0-255,66,164023,8,318656
44872,0.002141,74.125.130.0-255,1484,165507,8,318656
44873,0.002157,172.31.36.0-255,66,165573,8,318656
44874,0.002169,172.31.36.0-255,66,165639,8,318656
44875,0.002202,74.125.130.0-255,2184,167823,8,318656
44876,0.002205,172.31.36.0-255,66,167889,8,318656
44877,0.00439,74.125.130.0-255,2902,170791,8,318656
44878,0.004398,172.31.36.0-255,66,170857,8,318656
44879,0.004429,74.125.130.0-255,2902,173759,8,318656
44880,0.004432,172.31.36.0-255,66,173825,8,318656
44881,0.006621,74.125.130.0-255,2902,176727,8,318656
44882,0.00663,172.31.36.0-255,66,176793,8,318656
44883,0.006645,74.125.130.0-255,2902,179695,8,318656
44884,0.006653,172.31.36.0-255,66,179761,8,318656
44885,0.008847,74.125.130.0-255,2902,182663,8,318656
44886,0.008853,172.31.36.0-255,66,182729,8,318656
44887,0.008884,74.125.130.0-255,2902,185631,8,318656
44888,0.008888,172.31.36.0-255,66,185697,8,318656
44889,0.011088,74.125.130.0-255,2902,188599,8,318656
44890,0.011095,172.31.36.0-255,66,188665,8,318656
44891,0.011128,74.125.130.0-255,2902,191567,8,318656
44892,0.011132,172.31.36.0-255,66,191633,8,318656
44893,0.013339,74.125.130.0-255,2902,194535,8,318656
44894,0.013346,172.31.36.0-255,66,194601,8,318656
44895,0.01338,74.125.130.0-255,2902,197503,8,318656
44896,0.013383,172.31.36.0-255,66,197569,8,318656
44897,0.015585,74.125.130.0-255,5738,203307,8,318656
44898,0.015596,172.31.36.0-255,66,203373,8,318656
44899,0.017844,74.125.130.0-255,5738,209111,8,318656
44900,0.017854,172.31.36.0-255,66,209177,8,318656
44901,0.02008,74.125.130.0-255,5738,214915,8,318656
44902,0.020089,172.31.36.0-255,66,214981,8,318656
44903,0.022327,74.125.130.0-255,5738,220719,8,318656
44904,0.022334,172.31.36.0-255,66,220785,8,318656
44905,0.024573,74.125.130.0-255,5738,226523,8,318656
44906,0.02458,172.31.36.0-255,66,226589,8,318656
44907,0.02682,74.125.130.0-255,5738,232327,8,318656
44908,0.026829,172.31.36.0-255,66,232393,8,318656
44909,0.029054,74.125.130.0-255,5738,238131,8,318656
44910,0.029063,172.31.36.0-255,66,238197,8,318656
44911,0.030419,172.31.36.0-255,164,238361,8,318656
44912,0.03045,172.31.36.0-255,1120,239481,8,318656
44913,0.030492,172.31.36.0-255,1514,240995,8,318656
44914,0.030493,172.31.36.0-255,1514,242509,8,318656
44915,0.030499,172.31.36.0-255,1514,244023,8,318656
44916,0.0305,172.31.36.0-255,763,244786,8,318656
44917,0.031291,74.125.130.0-255,5738,250524,8,318656
44918,0.031297,172.31.36.0-255,66,250590,8,318656
44919,0.031944,104.244.42.0-255,66,250656,8,318656
44920,0.032014,104.244.42.0-255,66,250722,8,318656
44921,0.032081,104.244.42.0-255,66,250788,8,318656
44922,0.032086,104.244.42.0-255,66,250854,8,318656
44923,0.033516,74.125.130.0-255,5738,256592,8,318656
44924,0.033522,172.31.36.0-255,66,256658,8,318656
44925,0.03574,74.125.130.0-255,5738,262396,8,318656
44926,0.035746,172.31.36.0-255,66,262462,8,318656
44927,0.037972,74.125.130.0-255,4320,266782,8,318656
44928,0.037978,172.31.36.0-255,66,266848,8,318656
44929,0.038,74.125.130.0-255,1484,268332,8,318656
44930,0.040196,74.125.130.0-255,4320,272652,8,318656
44931,0.040201,172.31.36.0-255,66,272718,8,318656
44932,0.042428,74.125.130.0-255,5738,278456,8,318656
44933,0.042434,172.31.36.0-255,66,278522,8,318656
44934,0.044655,74.125.130.0-255,5738,284260,8,318656
44935,0.04466,172.31.36.0-255,66,284326,8,318656
44936,0.046889,74.125.130.0-255,2902,287228,8,318656
44937,0.046894,172.31.36.0-255,66,287294,8,318656
44938,0.046985,74.125.130.0-255,2902,290196,8,318656
44939,0.046991,172.31.36.0-255,66,290262,8,318656
44940,0.049114,74.125.130.0-255,2902,293164,8,318656
44941,0.049119,172.31.36.0-255,66,293230,8,318656
44942,0.049199,74.125.130.0-255,2902,296132,8,318656
44943,0.049204,172.31.36.0-255,66,296198,8,318656
44944,0.051351,74.125.130.0-255,2902,299100,8,318656
44945,0.051356,172.31.36.0-255,66,299166,8,318656
44946,0.05142,74.125.130.0-255,2902,302068,8,318656
44947,0.051424,172.31.36.0-255,66,302134,8,318656
44948,0.053563,74.125.130.0-255,1484,303618,8,318656
44949,0.05364,74.125.130.0-255,2902,306520,8,318656
44950,0.053645,172.31.36.0-255,66,306586,8,318656
44951,0.053674,74.125.130.0-255,1484,308070,8,318656
44952,0.055875,74.125.130.0-255,4320,312390,8,318656
44953,0.05588,172.31.36.0-255,66,312456,8,318656
44954,0.058095,74.125.130.0-255,5738,318194,8,318656
44955,0.058101,172.31.36.0-255,66,318260,8,318656
44956,0.060296,74.125.130.0-255,159,318419,8,318656
44957,0.060434,172.31.36.0-255,66,318485,8,318656
44958,0.060461,172.31.36.0-255,105,318590,8,318656
44959,0.062647,74.125.130.0-255,66,318656,8,318656
44960,0.0,74.125.200.0-255,153,153,8,333103
44961,3.7e-05,172.31.36.0-255,66,219,8,333103
44962,7.7e-05,74.125.200.0-255,1484,1703,8,333103
44963,8.2e-05,172.31.36.0-255,66,1769,8,333103
44964,0.00011,74.125.200.0-255,1484,3253,8,333103
44965,0.000114,172.31.36.0-255,66,3319,8,333103
44966,0.00012,74.125.200.0-255,2902,6221,8,333103
44967,0.000123,172.31.36.0-255,66,6287,8,333103
44968,0.000148,74.125.200.0-255,5738,12025,8,333103
44969,0.000157,172.31.36.0-255,66,12091,8,333103
44970,0.000191,74.125.200.0-255,6341,18432,8,333103
44971,0.000195,172.31.36.0-255,66,18498,8,333103
44972,0.000224,74.125.200.0-255,1484,19982,8,333103
44973,0.000226,172.31.36.0-255,66,20048,8,333103
44974,0.000246,172.31.36.0-255,66,20114,8,333103
44975,0.00025,74.125.200.0-255,1125,21239,8,333103
44976,0.000252,172.31.36.0-255,66,21305,8,333103
44977,0.000423,74.125.200.0-255,1484,22789,8,333103
44978,0.000428,172.31.36.0-255,66,22855,8,333103
44979,0.000433,74.125.200.0-255,2902,25757,8,333103
44980,0.000435,172.31.36.0-255,66,25823,8,333103
44981,0.00044,74.125.200.0-255,2902,28725,8,333103
44982,0.000449,172.31.36.0-255,66,28791,8,333103
44983,0.000481,74.125.200.0-255,4320,33111,8,333103
44984,0.00049,172.31.36.0-255,66,33177,8,333103
44985,0.000496,74.125.200.0-255,4320,37497,8,333103
44986,0.000499,172.31.36.0-255,66,37563,8,333103
44987,0.000535,74.125.200.0-255,3961,41524,8,333103
44988,0.000539,172.31.36.0-255,66,41590,8,333103
44989,0.00055,172.31.36.0-255,66,41656,8,333103
44990,0.00056,74.125.200.0-255,1484,43140,8,333103
44991,0.000565,74.125.200.0-255,2902,46042,8,333103
44992,0.000568,172.31.36.0-255,66,46108,8,333103
44993,0.000615,74.125.200.0-255,1396,47504,8,333103
44994,0.000619,74.125.200.0-255,385,47889,8,333103
44995,0.000621,172.31.36.0-255,66,47955,8,333103
44996,0.000709,74.125.200.0-255,1484,49439,8,333103
44997,0.000725,74.125.200.0-255,2902,52341,8,333103
44998,0.000729,172.31.36.0-255,66,52407,8,333103
44999,0.000734,74.125.200.0-255,2902,55309,8,333103
45000,0.000736,172.31.36.0-255,66,55375,8,333103
45001,0.000758,74.125.200.0-255,2902,58277,8,333103
45002,0.000761,172.31.36.0-255,66,58343,8,333103
45003,0.000767,74.125.200.0-255,5738,64081,8,333103
45004,0.000769,172.31.36.0-255,66,64147,8,333103
45005,0.000807,74.125.200.0-255,7156,71303,8,333103
45006,0.000811,172.31.36.0-255,66,71369,8,333103
45007,0.000818,74.125.200.0-255,4320,75689,8,333103
45008,0.000822,172.31.36.0-255,66,75755,8,333103
45009,0.00085,74.125.200.0-255,6438,82193,8,333103
45010,0.000853,172.31.36.0-255,66,82259,8,333103
45011,0.001238,74.125.200.0-255,1484,83743,8,333103
45012,0.001247,74.125.200.0-255,2902,86645,8,333103
45013,0.001252,172.31.36.0-255,66,86711,8,333103
45014,0.00126,74.125.200.0-255,5738,92449,8,333103
45015,0.001262,172.31.36.0-255,66,92515,8,333103
45016,0.001276,74.125.200.0-255,7156,99671,8,333103
45017,0.001279,172.31.36.0-255,66,99737,8,333103
45018,0.00131,74.125.200.0-255,5738,105475,8,333103
45019,0.001313,172.31.36.0-255,66,105541,8,333103
45020,0.00132,74.125.200.0-255,5738,111279,8,333103
45021,0.001321,172.31.36.0-255,66,111345,8,333103
45022,0.001326,74.125.200.0-255,2902,114247,8,333103
45023,0.001328,172.31.36.0-255,66,114313,8,333103
45024,0.00136,74.125.200.0-255,2184,116497,8,333103
45025,0.001362,172.31.36.0-255,66,116563,8,333103
45026,0.00153,74.125.200.0-255,1484,118047,8,333103
45027,0.001538,74.125.200.0-255,2902,120949,8,333103
45028,0.001543,172.31.36.0-255,66,121015,8,333103
45029,0.001547,74.125.200.0-255,1484,122499,8,333103
45030,0.00158,74.125.200.0-255,4320,126819,8,333103
45031,0.001584,172.31.36.0-255,66,126885,8,333103
45032,0.001591,74.125.200.0-255,7156,134041,8,333103
45033,0.001594,172.31.36.0-255,66,134107,8,333103
45034,0.001624,74.125.200.0-255,4320,138427,8,333103
45035,0.001627,172.31.36.0-255,66,138493,8,333103
45036,0.001643,172.31.36.0-255,66,138559,8,333103
45037,0.00366,74.125.200.0-255,4320,142879,8,333103
45038,0.003665,172.31.36.0-255,66,142945,8,333103
45039,0.003689,74.125.200.0-255,1484,144429,8,333103
45040,0.005702,74.125.200.0-255,4320,148749,8,333103
45041,0.005708,172.31.36.0-255,66,148815,8,333103
45042,0.007748,74.125.200.0-255,5738,154553,8,333103
45043,0.007755,172.31.36.0-255,66,154619,8,333103
45044,0.009801,74.125.200.0-255,5738,160357,8,333103
45045,0.009812,172.31.36.0-255,66,160423,8,333103
45046,0.011839,74.125.200.0-255,5738,166161,8,333103
45047,0.011846,172.31.36.0-255,66,166227,8,333103
45048,0.013892,74.125.200.0-255,5738,171965,8,333103
45049,0.013901,172.31.36.0-255,66,172031,8,333103
45050,0.015945,74.125.200.0-255,5738,177769,8,333103
45051,0.015953,172.31.36.0-255,66,177835,8,333103
45052,0.017994,74.125.200.0-255,5738,183573,8,333103
45053,0.018001,172.31.36.0-255,66,183639,8,333103
45054,0.020031,74.125.200.0-255,5738,189377,8,333103
45055,0.020039,172.31.36.0-255,66,189443,8,333103
45056,0.02208,74.125.200.0-255,5738,195181,8,333103
45057,0.022088,172.31.36.0-255,66,195247,8,333103
45058,0.02412,74.125.200.0-255,5738,200985,8,333103
45059,0.024128,172.31.36.0-255,66,201051,8,333103
45060,0.026176,74.125.200.0-255,5738,206789,8,333103
45061,0.026185,172.31.36.0-255,66,206855,8,333103
45062,0.028218,74.125.200.0-255,5738,212593,8,333103
45063,0.028225,172.31.36.0-255,66,212659,8,333103
45064,0.030288,74.125.200.0-255,5738,218397,8,333103
45065,0.030296,172.31.36.0-255,66,218463,8,333103
45066,0.032348,74.125.200.0-255,5738,224201,8,333103
45067,0.032356,172.31.36.0-255,66,224267,8,333103
45068,0.034392,74.125.200.0-255,5738,230005,8,333103
45069,0.0344,172.31.36.0-255,66,230071,8,333103
45070,0.036431,74.125.200.0-255,5738,235809,8,333103
45071,0.03644,172.31.36.0-255,66,235875,8,333103
45072,0.038481,74.125.200.0-255,5738,241613,8,333103
45073,0.03849,172.31.36.0-255,66,241679,8,333103
45074,0.040516,74.125.200.0-255,5738,247417,8,333103
45075,0.040523,172.31.36.0-255,66,247483,8,333103
45076,0.042571,74.125.200.0-255,5738,253221,8,333103
45077,0.042581,172.31.36.0-255,66,253287,8,333103
45078,0.044624,74.125.200.0-255,5738,259025,8,333103
45079,0.044632,172.31.36.0-255,66,259091,8,333103
45080,0.046669,74.125.200.0-255,5738,264829,8,333103
45081,0.046678,172.31.36.0-255,66,264895,8,333103
45082,0.048713,74.125.200.0-255,5738,270633,8,333103
45083,0.048721,172.31.36.0-255,66,270699,8,333103
45084,0.050755,74.125.200.0-255,5738,276437,8,333103
45085,0.050764,172.31.36.0-255,66,276503,8,333103
45086,0.052813,74.125.200.0-255,5738,282241,8,333103
45087,0.05282,172.31.36.0-255,66,282307,8,333103
45088,0.054246,172.31.36.0-255,172,282479,8,333103
45089,0.054278,172.31.36.0-255,1109,283588,8,333103
45090,0.054342,172.31.36.0-255,1514,285102,8,333103
45091,0.054344,172.31.36.0-255,1371,286473,8,333103
45092,0.054864,74.125.200.0-255,5738,292211,8,333103
45093,0.054871,172.31.36.0-255,66,292277,8,333103
45094,0.05573,104.244.42.0-255,66,292343,8,333103
45095,0.055762,104.244.42.0-255,66,292409,8,333103
45096,0.055847,104.244.42.0-255,66,292475,8,333103
45097,0.056913,74.125.200.0-255,5738,298213,8,333103
45098,0.056919,172.31.36.0-255,66,298279,8,333103
45099,0.058946,74.125.200.0-255,5738,304017,8,333103
45100,0.058953,172.31.36.0-255,66,304083,8,333103
45101,0.060982,74.125.200.0-255,5738,309821,8,333103
45102,0.060987,172.31.36.0-255,66,309887,8,333103
45103,0.06304,74.125.200.0-255,5738,315625,8,333103
45104,0.063049,172.31.36.0-255,66,315691,8,333103
45105,0.065092,74.125.200.0-255,5738,321429,8,333103
45106,0.065099,172.31.36.0-255,66,321495,8,333103
45107,0.067151,74.125.200.0-255,5738,327233,8,333103
45108,0.067157,172.31.36.0-255,66,327299,8,333103
45109,0.069186,74.125.200.0-255,5738,333037,8,333103
45110,0.069192,172.31.36.0-255,66,333103,8,333103
45111,0.0,74.125.68.0-255,152,152,8,259155
45112,3.1e-05,172.31.36.0-255,66,218,8,259155
45113,3.8e-05,74.125.68.0-255,1484,1702,8,259155
45114,4.2e-05,172.31.36.0-255,66,1768,8,259155
45115,4.6e-05,74.125.68.0-255,2902,4670,8,259155
45116,4.8e-05,172.31.36.0-255,66,4736,8,259155
45117,7.6e-05,74.125.68.0-255,4320,9056,8,259155
45118,7.8e-05,172.31.36.0-255,66,9122,8,259155
45119,9.6e-05,74.125.68.0-255,2902,12024,8,259155
45120,9.8e-05,172.31.36.0-255,66,12090,8,259155
45121,0.000115,74.125.68.0-255,2011,14101,8,259155
45122,0.000117,172.31.36.0-255,66,14167,8,259155
45123,0.00088,74.125.68.0-255,1484,15651,8,259155
45124,0.000885,172.31.36.0-255,66,15717,8,259155
45125,0.000894,74.125.68.0-255,2902,18619,8,259155
45126,0.000896,172.31.36.0-255,66,18685,8,259155
45127,0.000935,74.125.68.0-255,1484,20169,8,259155
45128,0.000938,172.31.36.0-255,66,20235,8,259155
45129,0.000957,74.125.68.0-255,1484,21719,8,259155
45130,0.00096,172.31.36.0-255,66,21785,8,259155
45131,0.000967,74.125.68.0-255,4320,26105,8,259155
45132,0.000968,172.31.36.0-255,66,26171,8,259155
45133,0.000974,74.125.68.0-255,5379,31550,8,259155
45134,0.000975,172.31.36.0-255,66,31616,8,259155
45135,0.001029,74.125.68.0-255,1484,33100,8,259155
45136,0.001034,172.31.36.0-255,66,33166,8,259155
45137,0.001063,74.125.68.0-255,2902,36068,8,259155
45138,0.001067,172.31.36.0-255,66,36134,8,259155
45139,0.001073,74.125.68.0-255,5738,41872,8,259155
45140,0.001076,172.31.36.0-255,66,41938,8,259155
45141,0.001083,74.125.68.0-255,6797,48735,8,259155
45142,0.001085,172.31.36.0-255,66,48801,8,259155
45143,0.001887,74.125.68.0-255,1484,50285,8,259155
45144,0.001895,74.125.68.0-255,1484,51769,8,259155
45145,0.001898,172.31.36.0-255,66,51835,8,259155
45146,0.00191,74.125.68.0-255,1484,53319,8,259155
45147,0.00192,74.125.68.0-255,1484,54803,8,259155
45148,0.001921,172.31.36.0-255,66,54869,8,259155
45149,0.001932,74.125.68.0-255,1484,56353,8,259155
45150,0.001935,74.125.68.0-255,1484,57837,8,259155
45151,0.001936,172.31.36.0-255,66,57903,8,259155
45152,0.001947,74.125.68.0-255,2902,60805,8,259155
45153,0.001949,172.31.36.0-255,66,60871,8,259155
45154,0.001984,74.125.68.0-255,2902,63773,8,259155
45155,0.001987,172.31.36.0-255,66,63839,8,259155
45156,0.001999,74.125.68.0-255,3123,66962,8,259155
45157,0.002001,172.31.36.0-255,66,67028,8,259155
45158,0.002092,74.125.68.0-255,1484,68512,8,259155
45159,0.002106,74.125.68.0-255,2902,71414,8,259155
45160,0.002108,172.31.36.0-255,66,71480,8,259155
45161,0.002121,74.125.68.0-255,1484,72964,8,259155
45162,0.002138,74.125.68.0-255,4320,77284,8,259155
45163,0.00214,172.31.36.0-255,66,77350,8,259155
45164,0.002144,74.125.68.0-255,2902,80252,8,259155
45165,0.002145,172.31.36.0-255,66,80318,8,259155
45166,0.00215,74.125.68.0-255,3961,84279,8,259155
45167,0.002151,172.31.36.0-255,66,84345,8,259155
45168,0.00222,74.125.68.0-255,2902,87247,8,259155
45169,0.002223,172.31.36.0-255,66,87313,8,259155
45170,0.002244,74.125.68.0-255,5738,93051,8,259155
45171,0.002246,172.31.36.0-255,66,93117,8,259155
45172,0.002254,172.31.36.0-255,66,93183,8,259155
45173,0.004572,74.125.68.0-255,4320,97503,8,259155
45174,0.004579,172.31.36.0-255,66,97569,8,259155
45175,0.004603,74.125.68.0-255,1484,99053,8,259155
45176,0.00691,74.125.68.0-255,4320,103373,8,259155
45177,0.00692,172.31.36.0-255,66,103439,8,259155
45178,0.009254,74.125.68.0-255,5738,109177,8,259155
45179,0.009261,172.31.36.0-255,66,109243,8,259155
45180,0.011585,74.125.68.0-255,5738,114981,8,259155
45181,0.011593,172.31.36.0-255,66,115047,8,259155
45182,0.013921,74.125.68.0-255,5738,120785,8,259155
45183,0.013929,172.31.36.0-255,66,120851,8,259155
45184,0.016259,74.125.68.0-255,5738,126589,8,259155
45185,0.016266,172.31.36.0-255,66,126655,8,259155
45186,0.018581,74.125.68.0-255,5738,132393,8,259155
45187,0.018588,172.31.36.0-255,66,132459,8,259155
45188,0.020331,172.31.36.0-255,172,132631,8,259155
45189,0.020363,172.31.36.0-255,1110,133741,8,259155
45190,0.020408,172.31.36.0-255,1514,135255,8,259155
45191,0.02041,172.31.36.0-255,1514,136769,8,259155
45192,0.020416,172.31.36.0-255,1514,138283,8,259155
45193,0.020417,172.31.36.0-255,1514,139797,8,259155
45194,0.020436,172.31.36.0-255,1514,141311,8,259155
45195,0.020437,172.31.36.0-255,996,142307,8,259155
45196,0.020934,74.125.68.0-255,5738,148045,8,259155
45197,0.020939,172.31.36.0-255,66,148111,8,259155
45198,0.021891,104.244.42.0-255,66,148177,8,259155
45199,0.021898,104.244.42.0-255,66,148243,8,259155
45200,0.022013,104.244.42.0-255,66,148309,8,259155
45201,0.022019,104.244.42.0-255,66,148375,8,259155
45202,0.02327,74.125.68.0-255,5738,154113,8,259155
45203,0.023278,172.31.36.0-255,66,154179,8,259155
45204,0.025616,74.125.68.0-255,4320,158499,8,259155
45205,0.025625,172.31.36.0-255,66,158565,8,259155
45206,0.025657,74.125.68.0-255,1484,160049,8,259155
45207,0.027961,74.125.68.0-255,4320,164369,8,259155
45208,0.027967,172.31.36.0-255,66,164435,8,259155
45209,0.030297,74.125.68.0-255,5738,170173,8,259155
45210,0.030306,172.31.36.0-255,66,170239,8,259155
45211,0.032647,74.125.68.0-255,5738,175977,8,259155
45212,0.032655,172.31.36.0-255,66,176043,8,259155
45213,0.034993,74.125.68.0-255,5738,181781,8,259155
45214,0.035001,172.31.36.0-255,66,181847,8,259155
45215,0.037324,74.125.68.0-255,5738,187585,8,259155
45216,0.037334,172.31.36.0-255,66,187651,8,259155
45217,0.039664,74.125.68.0-255,5738,193389,8,259155
45218,0.039672,172.31.36.0-255,66,193455,8,259155
45219,0.041692,172.31.36.0-255,108,193563,8,259155
45220,0.042001,74.125.68.0-255,5738,199301,8,259155
45221,0.042008,172.31.36.0-255,66,199367,8,259155
45222,0.043331,104.244.42.0-255,66,199433,8,259155
45223,0.044331,74.125.68.0-255,5738,205171,8,259155
45224,0.04434,172.31.36.0-255,66,205237,8,259155
45225,0.04667,74.125.68.0-255,5738,210975,8,259155
45226,0.046678,172.31.36.0-255,66,211041,8,259155
45227,0.049013,74.125.68.0-255,5738,216779,8,259155
45228,0.04902,172.31.36.0-255,66,216845,8,259155
45229,0.051343,74.125.68.0-255,5738,222583,8,259155
45230,0.051351,172.31.36.0-255,66,222649,8,259155
45231,0.053672,74.125.68.0-255,4320,226969,8,259155
45232,0.053681,172.31.36.0-255,66,227035,8,259155
45233,0.053717,74.125.68.0-255,1484,228519,8,259155
45234,0.056002,74.125.68.0-255,2902,231421,8,259155
45235,0.05601,172.31.36.0-255,66,231487,8,259155
45236,0.058329,74.125.68.0-255,5738,237225,8,259155
45237,0.058334,172.31.36.0-255,66,237291,8,259155
45238,0.060659,74.125.68.0-255,4320,241611,8,259155
45239,0.060665,172.31.36.0-255,66,241677,8,259155
45240,0.0607,74.125.68.0-255,1484,243161,8,259155
45241,0.063007,74.125.68.0-255,4320,247481,8,259155
45242,0.063013,172.31.36.0-255,66,247547,8,259155
45243,0.06535,74.125.68.0-255,5738,253285,8,259155
45244,0.065356,172.31.36.0-255,66,253351,8,259155
45245,0.067686,74.125.68.0-255,5738,259089,8,259155
45246,0.067693,172.31.36.0-255,66,259155,8,259155
45247,0.0,74.125.68.0-255,298,298,8,367437
45248,3.9e-05,172.31.36.0-255,66,364,8,367437
45249,4.5e-05,74.125.68.0-255,1484,1848,8,367437
45250,5e-05,172.31.36.0-255,66,1914,8,367437
45251,5.6e-05,74.125.68.0-255,4320,6234,8,367437
45252,5.9e-05,172.31.36.0-255,66,6300,8,367437
45253,6.4e-05,74.125.68.0-255,4320,10620,8,367437
45254,6.8e-05,172.31.36.0-255,66,10686,8,367437
45255,8.5e-05,74.125.68.0-255,1484,12170,8,367437
45256,8.7e-05,172.31.36.0-255,66,12236,8,367437
45257,0.000108,74.125.68.0-255,3246,15482,8,367437
45258,0.000111,172.31.36.0-255,66,15548,8,367437
45259,0.000121,172.31.36.0-255,66,15614,8,367437
45260,0.000152,74.125.68.0-255,2902,18516,8,367437
45261,0.000155,172.31.36.0-255,66,18582,8,367437
45262,0.000174,74.125.68.0-255,2543,21125,8,367437
45263,0.000177,172.31.36.0-255,66,21191,8,367437
45264,0.00024,74.125.68.0-255,1484,22675,8,367437
45265,0.000246,172.31.36.0-255,66,22741,8,367437
45266,0.00025,74.125.68.0-255,1484,24225,8,367437
45267,0.000252,172.31.36.0-255,66,24291,8,367437
45268,0.00027,74.125.68.0-255,2902,27193,8,367437
45269,0.000272,172.31.36.0-255,66,27259,8,367437
45270,0.000277,74.125.68.0-255,4320,31579,8,367437
45271,0.00028,172.31.36.0-255,66,31645,8,367437
45272,0.000292,74.125.68.0-255,1484,33129,8,367437
45273,0.000294,172.31.36.0-255,66,33195,8,367437
45274,0.000312,74.125.68.0-255,5738,38933,8,367437
45275,0.000316,172.31.36.0-255,66,38999,8,367437
45276,0.00032,74.125.68.0-255,1484,40483,8,367437
45277,0.000322,172.31.36.0-255,66,40549,8,367437
45278,0.000347,74.125.68.0-255,5738,46287,8,367437
45279,0.00035,172.31.36.0-255,66,46353,8,367437
45280,0.000375,172.31.36.0-255,66,46419,8,367437
45281,0.000396,74.125.68.0-255,680,47099,8,367437
45282,0.000438,74.125.68.0-255,1484,48583,8,367437
45283,0.000441,172.31.36.0-255,66,48649,8,367437
45284,0.000445,74.125.68.0-255,1484,50133,8,367437
45285,0.000462,74.125.68.0-255,2902,53035,8,367437
45286,0.000465,172.31.36.0-255,66,53101,8,367437
45287,0.00047,74.125.68.0-255,2902,56003,8,367437
45288,0.000472,172.31.36.0-255,66,56069,8,367437
45289,0.000486,74.125.68.0-255,2902,58971,8,367437
45290,0.00049,172.31.36.0-255,66,59037,8,367437
45291,0.000512,74.125.68.0-255,4827,63864,8,367437
45292,0.000515,172.31.36.0-255,66,63930,8,367437
45293,0.000554,74.125.68.0-255,4320,68250,8,367437
45294,0.000557,172.31.36.0-255,66,68316,8,367437
45295,0.000574,74.125.68.0-255,1484,69800,8,367437
45296,0.000583,74.125.68.0-255,7156,76956,8,367437
45297,0.000588,172.31.36.0-255,66,77022,8,367437
45298,0.000609,74.125.68.0-255,3961,80983,8,367437
45299,0.000613,172.31.36.0-255,66,81049,8,367437
45300,0.000808,74.125.68.0-255,1484,82533,8,367437
45301,0.000815,74.125.68.0-255,2902,85435,8,367437
45302,0.000818,172.31.36.0-255,66,85501,8,367437
45303,0.000821,74.125.68.0-255,1484,86985,8,367437
45304,0.000842,74.125.68.0-255,4320,91305,8,367437
45305,0.000845,172.31.36.0-255,66,91371,8,367437
45306,0.000862,74.125.68.0-255,1484,92855,8,367437
45307,0.000894,172.31.36.0-255,66,92921,8,367437
45308,0.000935,74.125.68.0-255,5738,98659,8,367437
45309,0.000939,172.31.36.0-255,66,98725,8,367437
45310,0.000958,74.125.68.0-255,5020,103745,8,367437
45311,0.000961,172.31.36.0-255,66,103811,8,367437
45312,0.001217,74.125.68.0-255,1484,105295,8,367437
45313,0.001223,74.125.68.0-255,2902,108197,8,367437
45314,0.001227,172.31.36.0-255,66,108263,8,367437
45315,0.001244,74.125.68.0-255,1484,109747,8,367437
45316,0.001265,74.125.68.0-255,4320,114067,8,367437
45317,0.001268,172.31.36.0-255,66,114133,8,367437
45318,0.001284,74.125.68.0-255,5738,119871,8,367437
45319,0.001287,172.31.36.0-255,66,119937,8,367437
45320,0.001334,74.125.68.0-255,7156,127093,8,367437
45321,0.001338,172.31.36.0-255,66,127159,8,367437
45322,0.001384,74.125.68.0-255,4320,131479,8,367437
45323,0.001388,172.31.36.0-255,66,131545,8,367437
45324,0.001406,74.125.68.0-255,4320,135865,8,367437
45325,0.001409,172.31.36.0-255,66,135931,8,367437
45326,0.001441,74.125.68.0-255,2184,138115,8,367437
45327,0.001445,172.31.36.0-255,66,138181,8,367437
45328,0.001464,74.125.68.0-255,2902,141083,8,367437
45329,0.001467,172.31.36.0-255,66,141149,8,367437
45330,0.00147,74.125.68.0-255,1484,142633,8,367437
45331,0.001484,74.125.68.0-255,1484,144117,8,367437
45332,0.001487,172.31.36.0-255,66,144183,8,367437
45333,0.001502,74.125.68.0-255,1484,145667,8,367437
45334,0.00152,74.125.68.0-255,5738,151405,8,367437
45335,0.001523,172.31.36.0-255,66,151471,8,367437
45336,0.001545,74.125.68.0-255,7156,158627,8,367437
45337,0.001547,172.31.36.0-255,66,158693,8,367437
45338,0.001551,74.125.68.0-255,1484,160177,8,367437
45339,0.001571,74.125.68.0-255,7156,167333,8,367437
45340,0.001574,172.31.36.0-255,66,167399,8,367437
45341,0.001639,74.125.68.0-255,5020,172419,8,367437
45342,0.001644,172.31.36.0-255,66,172485,8,367437
45343,0.002194,74.125.68.0-255,1484,173969,8,367437
45344,0.002206,74.125.68.0-255,2902,176871,8,367437
45345,0.00221,172.31.36.0-255,66,176937,8,367437
45346,0.002218,74.125.68.0-255,5738,182675,8,367437
45347,0.002221,172.31.36.0-255,66,182741,8,367437
45348,0.002258,172.31.36.0-255,66,182807,8,367437
45349,0.002279,74.125.68.0-255,4320,187127,8,367437
45350,0.002282,172.31.36.0-255,66,187193,8,367437
45351,0.002294,172.31.36.0-255,66,187259,8,367437
45352,0.004537,74.125.68.0-255,5738,192997,8,367437
45353,0.004547,172.31.36.0-255,66,193063,8,367437
45354,0.006818,74.125.68.0-255,5738,198801,8,367437
45355,0.006829,172.31.36.0-255,66,198867,8,367437
45356,0.009086,74.125.68.0-255,5738,204605,8,367437
45357,0.009096,172.31.36.0-255,66,204671,8,367437
45358,0.011355,74.125.68.0-255,5738,210409,8,367437
45359,0.01137,172.31.36.0-255,66,210475,8,367437
45360,0.01365,74.125.68.0-255,5738,216213,8,367437
45361,0.013667,172.31.36.0-255,66,216279,8,367437
45362,0.01591,74.125.68.0-255,5738,222017,8,367437
45363,0.015922,172.31.36.0-255,66,222083,8,367437
45364,0.018184,74.125.68.0-255,5738,227821,8,367437
45365,0.018198,172.31.36.0-255,66,227887,8,367437
45366,0.020445,74.125.68.0-255,5738,233625,8,367437
45367,0.020459,172.31.36.0-255,66,233691,8,367437
45368,0.022701,74.125.68.0-255,5738,239429,8,367437
45369,0.022712,172.31.36.0-255,66,239495,8,367437
45370,0.024951,74.125.68.0-255,5738,245233,8,367437
45371,0.024958,172.31.36.0-255,66,245299,8,367437
45372,0.027199,74.125.68.0-255,5738,251037,8,367437
45373,0.027207,172.31.36.0-255,66,251103,8,367437
45374,0.029445,74.125.68.0-255,5738,256841,8,367437
45375,0.029454,172.31.36.0-255,66,256907,8,367437
45376,0.031693,74.125.68.0-255,5738,262645,8,367437
45377,0.031699,172.31.36.0-255,66,262711,8,367437
45378,0.033948,74.125.68.0-255,5738,268449,8,367437
45379,0.033955,172.31.36.0-255,66,268515,8,367437
45380,0.034861,172.31.36.0-255,188,268703,8,367437
45381,0.034896,172.31.36.0-255,955,269658,8,367437
45382,0.034946,172.31.36.0-255,1514,271172,8,367437
45383,0.034948,172.31.36.0-255,1514,272686,8,367437
45384,0.034953,172.31.36.0-255,1514,274200,8,367437
45385,0.034954,172.31.36.0-255,1514,275714,8,367437
45386,0.034979,172.31.36.0-255,1431,277145,8,367437
45387,0.036196,74.125.68.0-255,5738,282883,8,367437
45388,0.036203,172.31.36.0-255,66,282949,8,367437
45389,0.036425,104.244.42.0-255,66,283015,8,367437
45390,0.036459,104.244.42.0-255,66,283081,8,367437
45391,0.036547,104.244.42.0-255,66,283147,8,367437
45392,0.038446,74.125.68.0-255,5738,288885,8,367437
45393,0.038451,172.31.36.0-255,66,288951,8,367437
45394,0.040694,74.125.68.0-255,5738,294689,8,367437
45395,0.040748,172.31.36.0-255,66,294755,8,367437
45396,0.042986,74.125.68.0-255,5738,300493,8,367437
45397,0.042991,172.31.36.0-255,66,300559,8,367437
45398,0.045229,74.125.68.0-255,5738,306297,8,367437
45399,0.045234,172.31.36.0-255,66,306363,8,367437
45400,0.047478,74.125.68.0-255,5738,312101,8,367437
45401,0.047483,172.31.36.0-255,66,312167,8,367437
45402,0.049744,74.125.68.0-255,5738,317905,8,367437
45403,0.04975,172.31.36.0-255,66,317971,8,367437
45404,0.051981,74.125.68.0-255,5738,323709,8,367437
45405,0.051989,172.31.36.0-255,66,323775,8,367437
45406,0.054237,74.125.68.0-255,5738,329513,8,367437
45407,0.054244,172.31.36.0-255,66,329579,8,367437
45408,0.056489,74.125.68.0-255,5738,335317,8,367437
45409,0.056497,172.31.36.0-255,66,335383,8,367437
45410,0.058759,74.125.68.0-255,5738,341121,8,367437
45411,0.058765,172.31.36.0-255,66,341187,8,367437
45412,0.061006,74.125.68.0-255,5738,346925,8,367437
45413,0.061013,172.31.36.0-255,66,346991,8,367437
45414,0.063253,74.125.68.0-255,4320,351311,8,367437
45415,0.063259,172.31.36.0-255,66,351377,8,367437
45416,0.063296,74.125.68.0-255,1484,352861,8,367437
45417,0.065493,74.125.68.0-255,4320,357181,8,367437
45418,0.065498,172.31.36.0-255,66,357247,8,367437
45419,0.067739,74.125.68.0-255,5738,362985,8,367437
45420,0.067745,172.31.36.0-255,66,363051,8,367437
45421,0.069973,74.125.68.0-255,4320,367371,8,367437
45422,0.069979,172.31.36.0-255,66,367437,8,367437
45423,0.0,74.125.200.0-255,155,155,8,357600
45424,3.6e-05,172.31.36.0-255,66,221,8,357600
45425,4.3e-05,74.125.200.0-255,1484,1705,8,357600
45426,4.8e-05,172.31.36.0-255,66,1771,8,357600
45427,5.3e-05,74.125.200.0-255,2902,4673,8,357600
45428,6.4e-05,172.31.36.0-255,66,4739,8,357600
45429,7.1e-05,74.125.200.0-255,5738,10477,8,357600
45430,7.4e-05,172.31.36.0-255,66,10543,8,357600
45431,7.7e-05,74.125.200.0-255,2902,13445,8,357600
45432,8e-05,172.31.36.0-255,66,13511,8,357600
45433,0.000119,74.125.200.0-255,3487,16998,8,357600
45434,0.000122,172.31.36.0-255,66,17064,8,357600
45435,0.000125,74.125.200.0-255,1484,18548,8,357600
45436,0.000126,172.31.36.0-255,66,18614,8,357600
45437,0.000131,74.125.200.0-255,2902,21516,8,357600
45438,0.000133,172.31.36.0-255,66,21582,8,357600
45439,0.000145,74.125.200.0-255,4320,25902,8,357600
45440,0.000148,172.31.36.0-255,66,25968,8,357600
45441,0.000172,74.125.200.0-255,1484,27452,8,357600
45442,0.000175,172.31.36.0-255,66,27518,8,357600
45443,0.000185,74.125.200.0-255,3961,31479,8,357600
45444,0.000188,172.31.36.0-255,66,31545,8,357600
45445,0.000354,74.125.200.0-255,1484,33029,8,357600
45446,0.000358,172.31.36.0-255,66,33095,8,357600
45447,0.000365,74.125.200.0-255,2902,35997,8,357600
45448,0.000367,172.31.36.0-255,66,36063,8,357600
45449,0.000386,74.125.200.0-255,4320,40383,8,357600
45450,0.00039,172.31.36.0-255,66,40449,8,357600
45451,0.000432,172.31.36.0-255,66,40515,8,357600
45452,0.000437,74.125.200.0-255,4320,44835,8,357600
45453,0.000442,172.31.36.0-255,66,44901,8,357600
45454,0.000479,74.125.200.0-255,4320,49221,8,357600
45455,0.000483,172.31.36.0-255,66,49287,8,357600
45456,0.000516,74.125.200.0-255,7068,56355,8,357600
45457,0.000519,172.31.36.0-255,66,56421,8,357600
45458,0.000522,74.125.200.0-255,129,56550,8,357600
45459,0.000565,74.125.200.0-255,1484,58034,8,357600
45460,0.000568,172.31.36.0-255,66,58100,8,357600
45461,0.000597,74.125.200.0-255,2902,61002,8,357600
45462,0.0006,172.31.36.0-255,66,61068,8,357600
45463,0.000607,74.125.200.0-255,5738,66806,8,357600
45464,0.000611,172.31.36.0-255,66,66872,8,357600
45465,0.000631,74.125.200.0-255,2902,69774,8,357600
45466,0.000633,172.31.36.0-255,66,69840,8,357600
45467,0.000676,74.125.200.0-255,7156,76996,8,357600
45468,0.000684,172.31.36.0-255,66,77062,8,357600
45469,0.0007,172.31.36.0-255,66,77128,8,357600
45470,0.000705,74.125.200.0-255,1890,79018,8,357600
45471,0.000707,172.31.36.0-255,66,79084,8,357600
45472,0.000801,74.125.200.0-255,1484,80568,8,357600
45473,0.000819,74.125.200.0-255,2902,83470,8,357600
45474,0.000822,172.31.36.0-255,66,83536,8,357600
45475,0.000825,74.125.200.0-255,1484,85020,8,357600
45476,0.000848,74.125.200.0-255,4320,89340,8,357600
45477,0.000851,172.31.36.0-255,66,89406,8,357600
45478,0.000857,74.125.200.0-255,4320,93726,8,357600
45479,0.00086,172.31.36.0-255,66,93792,8,357600
45480,0.000878,74.125.200.0-255,2902,96694,8,357600
45481,0.000881,172.31.36.0-255,66,96760,8,357600
45482,0.000892,74.125.200.0-255,5738,102498,8,357600
45483,0.000895,172.31.36.0-255,66,102564,8,357600
45484,0.000921,74.125.200.0-255,4320,106884,8,357600
45485,0.000924,172.31.36.0-255,66,106950,8,357600
45486,0.000935,74.125.200.0-255,6438,113388,8,357600
45487,0.000937,172.31.36.0-255,66,113454,8,357600
45488,0.001728,74.125.200.0-255,1484,114938,8,357600
45489,0.001737,74.125.200.0-255,2902,117840,8,357600
45490,0.001742,172.31.36.0-255,66,117906,8,357600
45491,0.001746,74.125.200.0-255,1484,119390,8,357600
45492,0.001775,74.125.200.0-255,4320,123710,8,357600
45493,0.001778,172.31.36.0-255,66,123776,8,357600
45494,0.001783,74.125.200.0-255,4320,128096,8,357600
45495,0.001785,172.31.36.0-255,66,128162,8,357600
45496,0.001803,74.125.200.0-255,4320,132482,8,357600
45497,0.001805,172.31.36.0-255,66,132548,8,357600
45498,0.001831,74.125.200.0-255,4320,136868,8,357600
45499,0.001834,172.31.36.0-255,66,136934,8,357600
45500,0.001839,74.125.200.0-255,2902,139836,8,357600
45501,0.001841,172.31.36.0-255,66,139902,8,357600
45502,0.001844,74.125.200.0-255,1484,141386,8,357600
45503,0.001879,74.125.200.0-255,6438,147824,8,357600
45504,0.001883,172.31.36.0-255,66,147890,8,357600
45505,0.001926,74.125.200.0-255,1484,149374,8,357600
45506,0.001941,74.125.200.0-255,2902,152276,8,357600
45507,0.001944,172.31.36.0-255,66,152342,8,357600
45508,0.001972,74.125.200.0-255,5738,158080,8,357600
45509,0.001975,172.31.36.0-255,66,158146,8,357600
45510,0.002055,172.31.36.0-255,66,158212,8,357600
45511,0.002067,172.31.36.0-255,66,158278,8,357600
45512,0.004044,74.125.200.0-255,5738,164016,8,357600
45513,0.004051,172.31.36.0-255,66,164082,8,357600
45514,0.006034,74.125.200.0-255,5738,169820,8,357600
45515,0.006041,172.31.36.0-255,66,169886,8,357600
45516,0.00801,74.125.200.0-255,4320,174206,8,357600
45517,0.008015,172.31.36.0-255,66,174272,8,357600
45518,0.008042,74.125.200.0-255,1484,175756,8,357600
45519,0.009975,74.125.200.0-255,4320,180076,8,357600
45520,0.009984,172.31.36.0-255,66,180142,8,357600
45521,0.011953,74.125.200.0-255,5738,185880,8,357600
45522,0.011963,172.31.36.0-255,66,185946,8,357600
45523,0.013955,74.125.200.0-255,5738,191684,8,357600
45524,0.013964,172.31.36.0-255,66,191750,8,357600
45525,0.015939,74.125.200.0-255,5738,197488,8,357600
45526,0.015951,172.31.36.0-255,66,197554,8,357600
45527,0.017922,74.125.200.0-255,5738,203292,8,357600
45528,0.017928,172.31.36.0-255,66,203358,8,357600
45529,0.019891,74.125.200.0-255,5738,209096,8,357600
45530,0.019896,172.31.36.0-255,66,209162,8,357600
45531,0.021871,74.125.200.0-255,5738,214900,8,357600
45532,0.021878,172.31.36.0-255,66,214966,8,357600
45533,0.023867,74.125.200.0-255,5738,220704,8,357600
45534,0.023874,172.31.36.0-255,66,220770,8,357600
45535,0.025841,74.125.200.0-255,5738,226508,8,357600
45536,0.025849,172.31.36.0-255,66,226574,8,357600
45537,0.027828,74.125.200.0-255,5738,232312,8,357600
45538,0.027835,172.31.36.0-255,66,232378,8,357600
45539,0.029811,74.125.200.0-255,5738,238116,8,357600
45540,0.029818,172.31.36.0-255,66,238182,8,357600
45541,0.031796,74.125.200.0-255,5738,243920,8,357600
45542,0.031802,172.31.36.0-255,66,243986,8,357600
45543,0.032662,172.31.36.0-255,172,244158,8,357600
45544,0.032705,172.31.36.0-255,1110,245268,8,357600
45545,0.032945,172.31.36.0-255,1428,246696,8,357600
45546,0.033778,74.125.200.0-255,1484,248180,8,357600
45547,0.033802,74.125.200.0-255,4320,252500,8,357600
45548,0.033807,172.31.36.0-255,66,252566,8,357600
45549,0.034206,104.244.42.0-255,66,252632,8,357600
45550,0.034297,104.244.42.0-255,66,252698,8,357600
45551,0.034531,104.244.42.0-255,66,252764,8,357600
45552,0.035778,74.125.200.0-255,4320,257084,8,357600
45553,0.035787,172.31.36.0-255,66,257150,8,357600
45554,0.035836,74.125.200.0-255,1484,258634,8,357600
45555,0.03776,74.125.200.0-255,4320,262954,8,357600
45556,0.037767,172.31.36.0-255,66,263020,8,357600
45557,0.039757,74.125.200.0-255,5738,268758,8,357600
45558,0.039763,172.31.36.0-255,66,268824,8,357600
45559,0.041729,74.125.200.0-255,5738,274562,8,357600
45560,0.041734,172.31.36.0-255,66,274628,8,357600
45561,0.043695,74.125.200.0-255,5738,280366,8,357600
45562,0.043701,172.31.36.0-255,66,280432,8,357600
45563,0.045668,74.125.200.0-255,2902,283334,8,357600
45564,0.045674,172.31.36.0-255,66,283400,8,357600
45565,0.0457,74.125.200.0-255,2902,286302,8,357600
45566,0.045704,172.31.36.0-255,66,286368,8,357600
45567,0.04766,74.125.200.0-255,2902,289270,8,357600
45568,0.047666,172.31.36.0-255,66,289336,8,357600
45569,0.047689,74.125.200.0-255,2902,292238,8,357600
45570,0.047692,172.31.36.0-255,66,292304,8,357600
45571,0.049628,74.125.200.0-255,2902,295206,8,357600
45572,0.049634,172.31.36.0-255,66,295272,8,357600
45573,0.04966,74.125.200.0-255,2902,298174,8,357600
45574,0.049663,172.31.36.0-255,66,298240,8,357600
45575,0.051595,74.125.200.0-255,2902,301142,8,357600
45576,0.051602,172.31.36.0-255,66,301208,8,357600
45577,0.051626,74.125.200.0-255,2902,304110,8,357600
45578,0.051629,172.31.36.0-255,66,304176,8,357600
45579,0.053573,74.125.200.0-255,2902,307078,8,357600
45580,0.053585,172.31.36.0-255,66,307144,8,357600
45581,0.053625,74.125.200.0-255,2902,310046,8,357600
45582,0.053628,172.31.36.0-255,66,310112,8,357600
45583,0.055556,74.125.200.0-255,2902,313014,8,357600
45584,0.055562,172.31.36.0-255,66,313080,8,357600
45585,0.055606,74.125.200.0-255,2902,315982,8,357600
45586,0.05561,172.31.36.0-255,66,316048,8,357600
45587,0.057534,74.125.200.0-255,2902,318950,8,357600
45588,0.057539,172.31.36.0-255,66,319016,8,357600
45589,0.057587,74.125.200.0-255,2902,321918,8,357600
45590,0.057591,172.31.36.0-255,66,321984,8,357600
45591,0.059515,74.125.200.0-255,2902,324886,8,357600
45592,0.05952,172.31.36.0-255,66,324952,8,357600
45593,0.059594,74.125.200.0-255,2902,327854,8,357600
45594,0.059599,172.31.36.0-255,66,327920,8,357600
45595,0.061484,74.125.200.0-255,2902,330822,8,357600
45596,0.06149,172.31.36.0-255,66,330888,8,357600
45597,0.061558,74.125.200.0-255,2902,333790,8,357600
45598,0.061563,172.31.36.0-255,66,333856,8,357600
45599,0.063458,74.125.200.0-255,2902,336758,8,357600
45600,0.063463,172.31.36.0-255,66,336824,8,357600
45601,0.063511,74.125.200.0-255,2902,339726,8,357600
45602,0.063516,172.31.36.0-255,66,339792,8,357600
45603,0.065425,74.125.200.0-255,2902,342694,8,357600
45604,0.065431,172.31.36.0-255,66,342760,8,357600
45605,0.065481,74.125.200.0-255,2902,345662,8,357600
45606,0.065484,172.31.36.0-255,66,345728,8,357600
45607,0.067398,74.125.200.0-255,2902,348630,8,357600
45608,0.067405,172.31.36.0-255,66,348696,8,357600
45609,0.067448,74.125.200.0-255,2902,351598,8,357600
45610,0.067452,172.31.36.0-255,66,351664,8,357600
45611,0.069373,74.125.200.0-255,2902,354566,8,357600
45612,0.069381,172.31.36.0-255,66,354632,8,357600
45613,0.069418,74.125.200.0-255,2902,357534,8,357600
45614,0.069421,172.31.36.0-255,66,357600,8,357600
45615,0.0,172.217.194.0-255,153,153,8,223676
45616,3.8e-05,172.31.36.0-255,66,219,8,223676
45617,4.6e-05,172.217.194.0-255,1484,1703,8,223676
45618,5.1e-05,172.31.36.0-255,66,1769,8,223676
45619,5.6e-05,172.217.194.0-255,2902,4671,8,223676
45620,5.8e-05,172.31.36.0-255,66,4737,8,223676
45621,6.5e-05,172.217.194.0-255,5738,10475,8,223676
45622,6.7e-05,172.31.36.0-255,66,10541,8,223676
45623,7.2e-05,172.217.194.0-255,3457,13998,8,223676
45624,7.5e-05,172.31.36.0-255,66,14064,8,223676
45625,9.7e-05,172.217.194.0-255,4320,18384,8,223676
45626,0.000101,172.31.36.0-255,66,18450,8,223676
45627,0.000141,172.31.36.0-255,66,18516,8,223676
45628,0.000145,172.217.194.0-255,2543,21059,8,223676
45629,0.000147,172.31.36.0-255,66,21125,8,223676
45630,0.000195,172.217.194.0-255,1484,22609,8,223676
45631,0.000198,172.31.36.0-255,66,22675,8,223676
45632,0.000203,172.217.194.0-255,2902,25577,8,223676
45633,0.000204,172.31.36.0-255,66,25643,8,223676
45634,0.000219,172.217.194.0-255,1484,27127,8,223676
45635,0.000222,172.31.36.0-255,66,27193,8,223676
45636,0.000236,172.217.194.0-255,2902,30095,8,223676
45637,0.000238,172.31.36.0-255,66,30161,8,223676
45638,0.000245,172.217.194.0-255,5738,35899,8,223676
45639,0.000247,172.31.36.0-255,66,35965,8,223676
45640,0.00027,172.217.194.0-255,1484,37449,8,223676
45641,0.000272,172.31.36.0-255,66,37515,8,223676
45642,0.000302,172.31.36.0-255,66,37581,8,223676
45643,0.000321,172.217.194.0-255,2902,40483,8,223676
45644,0.000324,172.31.36.0-255,66,40549,8,223676
45645,0.000345,172.217.194.0-255,2543,43092,8,223676
45646,0.000348,172.31.36.0-255,66,43158,8,223676
45647,0.00036,172.217.194.0-255,380,43538,8,223676
45648,0.000426,172.217.194.0-255,1781,45319,8,223676
45649,0.00043,172.31.36.0-255,66,45385,8,223676
45650,0.000435,172.217.194.0-255,2902,48287,8,223676
45651,0.000438,172.31.36.0-255,66,48353,8,223676
45652,0.000442,172.217.194.0-255,2902,51255,8,223676
45653,0.000444,172.31.36.0-255,66,51321,8,223676
45654,0.000463,172.217.194.0-255,4320,55641,8,223676
45655,0.000467,172.31.36.0-255,66,55707,8,223676
45656,0.000474,172.217.194.0-255,5738,61445,8,223676
45657,0.000476,172.31.36.0-255,66,61511,8,223676
45658,0.000509,172.31.36.0-255,66,61577,8,223676
45659,0.000516,172.217.194.0-255,6438,68015,8,223676
45660,0.000519,172.31.36.0-255,66,68081,8,223676
45661,0.000692,172.217.194.0-255,1484,69565,8,223676
45662,0.000713,172.217.194.0-255,2902,72467,8,223676
45663,0.000717,172.31.36.0-255,66,72533,8,223676
45664,0.000724,172.217.194.0-255,5738,78271,8,223676
45665,0.000727,172.31.36.0-255,66,78337,8,223676
45666,0.000764,172.31.36.0-255,66,78403,8,223676
45667,0.000767,172.217.194.0-255,1484,79887,8,223676
45668,0.000792,172.217.194.0-255,1484,81371,8,223676
45669,0.000795,172.31.36.0-255,66,81437,8,223676
45670,0.000821,172.31.36.0-255,66,81503,8,223676
45671,0.000826,172.217.194.0-255,2902,84405,8,223676
45672,0.000829,172.31.36.0-255,66,84471,8,223676
45673,0.000853,172.217.194.0-255,7156,91627,8,223676
45674,0.000857,172.31.36.0-255,66,91693,8,223676
45675,0.000864,172.217.194.0-255,7156,98849,8,223676
45676,0.000866,172.31.36.0-255,66,98915,8,223676
45677,0.000903,172.217.194.0-255,7156,106071,8,223676
45678,0.000906,172.31.36.0-255,66,106137,8,223676
45679,0.000937,172.31.36.0-255,66,106203,8,223676
45680,0.000953,172.217.194.0-255,1484,107687,8,223676
45681,0.000958,172.217.194.0-255,2902,110589,8,223676
45682,0.00096,172.31.36.0-255,66,110655,8,223676
45683,0.000978,172.217.194.0-255,5738,116393,8,223676
45684,0.000981,172.31.36.0-255,66,116459,8,223676
45685,0.001014,172.31.36.0-255,66,116525,8,223676
45686,0.001049,172.217.194.0-255,4320,120845,8,223676
45687,0.001053,172.31.36.0-255,66,120911,8,223676
45688,0.001071,172.217.194.0-255,6438,127349,8,223676
45689,0.001074,172.31.36.0-255,66,127415,8,223676
45690,0.001119,172.217.194.0-255,1484,128899,8,223676
45691,0.001135,172.217.194.0-255,2902,131801,8,223676
45692,0.001137,172.217.194.0-255,1484,133285,8,223676
45693,0.00114,172.31.36.0-255,66,133351,8,223676
45694,0.001159,172.217.194.0-255,4320,137671,8,223676
45695,0.001162,172.31.36.0-255,66,137737,8,223676
45696,0.001167,172.217.194.0-255,2902,140639,8,223676
45697,0.001169,172.31.36.0-255,66,140705,8,223676
45698,0.001186,172.217.194.0-255,4320,145025,8,223676
45699,0.00119,172.31.36.0-255,66,145091,8,223676
45700,0.001193,172.217.194.0-255,1484,146575,8,223676
45701,0.00122,172.31.36.0-255,66,146641,8,223676
45702,0.001248,172.217.194.0-255,2184,148825,8,223676
45703,0.001251,172.31.36.0-255,66,148891,8,223676
45704,0.001322,172.217.194.0-255,1484,150375,8,223676
45705,0.001328,172.217.194.0-255,2902,153277,8,223676
45706,0.001331,172.31.36.0-255,66,153343,8,223676
45707,0.001351,172.217.194.0-255,5738,159081,8,223676
45708,0.001354,172.31.36.0-255,66,159147,8,223676
45709,0.001389,172.217.194.0-255,1484,160631,8,223676
45710,0.001421,172.31.36.0-255,66,160697,8,223676
45711,0.001434,172.31.36.0-255,66,160763,8,223676
45712,0.001441,172.217.194.0-255,7156,167919,8,223676
45713,0.001444,172.31.36.0-255,66,167985,8,223676
45714,0.001476,172.217.194.0-255,4320,172305,8,223676
45715,0.00148,172.31.36.0-255,66,172371,8,223676
45716,0.001491,172.31.36.0-255,66,172437,8,223676
45717,0.001511,172.217.194.0-255,4320,176757,8,223676
45718,0.001513,172.31.36.0-255,66,176823,8,223676
45719,0.001536,172.31.36.0-255,66,176889,8,223676
45720,0.001547,172.31.36.0-255,66,176955,8,223676
45721,0.001571,172.217.194.0-255,5738,182693,8,223676
45722,0.001575,172.31.36.0-255,66,182759,8,223676
45723,0.001586,172.31.36.0-255,66,182825,8,223676
45724,0.001625,172.31.36.0-255,66,182891,8,223676
45725,0.001654,172.217.194.0-255,1484,184375,8,223676
45726,0.00166,172.217.194.0-255,2902,187277,8,223676
45727,0.001662,172.31.36.0-255,66,187343,8,223676
45728,0.001666,172.217.194.0-255,1484,188827,8,223676
45729,0.001682,172.217.194.0-255,4320,193147,8,223676
45730,0.001685,172.31.36.0-255,66,193213,8,223676
45731,0.001697,172.31.36.0-255,66,193279,8,223676
45732,0.001719,172.217.194.0-255,4320,197599,8,223676
45733,0.001723,172.31.36.0-255,66,197665,8,223676
45734,0.001734,172.31.36.0-255,66,197731,8,223676
45735,0.001737,172.217.194.0-255,766,198497,8,223676
45736,0.001756,172.217.194.0-255,1484,199981,8,223676
45737,0.001758,172.31.36.0-255,66,200047,8,223676
45738,0.001764,172.217.194.0-255,2902,202949,8,223676
45739,0.001766,172.31.36.0-255,66,203015,8,223676
45740,0.001781,172.217.194.0-255,1484,204499,8,223676
45741,0.001787,172.217.194.0-255,5738,210237,8,223676
45742,0.001789,172.31.36.0-255,66,210303,8,223676
45743,0.001817,172.217.194.0-255,4320,214623,8,223676
45744,0.00182,172.31.36.0-255,66,214689,8,223676
45745,0.001831,172.31.36.0-255,66,214755,8,223676
45746,0.001855,172.217.194.0-255,2902,217657,8,223676
45747,0.001858,172.31.36.0-255,66,217723,8,223676
45748,0.001892,172.217.194.0-255,105,217828,8,223676
45749,0.001894,172.31.36.0-255,66,217894,8,223676
45750,0.003641,172.31.36.0-255,66,217960,8,223676
45751,0.003671,172.31.36.0-255,105,218065,8,223676
45752,0.005971,172.217.194.0-255,66,218131,8,223676
45753,0.033658,172.31.36.0-255,167,218298,8,223676
45754,0.033693,172.31.36.0-255,1111,219409,8,223676
45755,0.033759,172.31.36.0-255,1514,220923,8,223676
45756,0.033761,172.31.36.0-255,1514,222437,8,223676
45757,0.033786,172.31.36.0-255,975,223412,8,223676
45758,0.03519,104.244.42.0-255,66,223478,8,223676
45759,0.03522,104.244.42.0-255,66,223544,8,223676
45760,0.03532,104.244.42.0-255,66,223610,8,223676
45761,0.035334,104.244.42.0-255,66,223676,8,223676
45762,0.0,172.217.194.0-255,146,146,8,214308
45763,1.3e-05,172.31.36.0-255,66,212,8,214308
45764,2e-05,172.217.194.0-255,1484,1696,8,214308
45765,2.5e-05,172.31.36.0-255,66,1762,8,214308
45766,3.1e-05,172.217.194.0-255,2902,4664,8,214308
45767,4.3e-05,172.31.36.0-255,66,4730,8,214308
45768,5e-05,172.217.194.0-255,7156,11886,8,214308
45769,5.3e-05,172.31.36.0-255,66,11952,8,214308
45770,5.8e-05,172.217.194.0-255,2082,14034,8,214308
45771,6e-05,172.31.36.0-255,66,14100,8,214308
45772,0.000108,172.217.194.0-255,5738,19838,8,214308
45773,0.000111,172.31.36.0-255,66,19904,8,214308
45774,0.000141,172.217.194.0-255,4320,24224,8,214308
45775,0.000144,172.31.36.0-255,66,24290,8,214308
45776,0.00015,172.217.194.0-255,2902,27192,8,214308
45777,0.000151,172.31.36.0-255,66,27258,8,214308
45778,0.000179,172.217.194.0-255,3961,31219,8,214308
45779,0.000181,172.31.36.0-255,66,31285,8,214308
45780,0.0004,172.217.194.0-255,1484,32769,8,214308
45781,0.000406,172.31.36.0-255,66,32835,8,214308
45782,0.000412,172.217.194.0-255,2902,35737,8,214308
45783,0.000415,172.31.36.0-255,66,35803,8,214308
45784,0.000451,172.217.194.0-255,5738,41541,8,214308
45785,0.000454,172.31.36.0-255,66,41607,8,214308
45786,0.000499,172.31.36.0-255,66,41673,8,214308
45787,0.000512,172.31.36.0-255,66,41739,8,214308
45788,0.000515,172.217.194.0-255,1405,43144,8,214308
45789,0.000517,172.31.36.0-255,66,43210,8,214308
45790,0.000574,172.217.194.0-255,118,43328,8,214308
45791,0.000576,172.31.36.0-255,66,43394,8,214308
45792,0.000579,172.217.194.0-255,378,43772,8,214308
45793,0.000849,172.217.194.0-255,1484,45256,8,214308
45794,0.000854,172.31.36.0-255,66,45322,8,214308
45795,0.00086,172.217.194.0-255,2902,48224,8,214308
45796,0.000862,172.31.36.0-255,66,48290,8,214308
45797,0.000867,172.217.194.0-255,2902,51192,8,214308
45798,0.000869,172.31.36.0-255,66,51258,8,214308
45799,0.000886,172.217.194.0-255,2902,54160,8,214308
45800,0.000888,172.31.36.0-255,66,54226,8,214308
45801,0.000901,172.217.194.0-255,7156,61382,8,214308
45802,0.000903,172.31.36.0-255,66,61448,8,214308
45803,0.000932,172.217.194.0-255,5738,67186,8,214308
45804,0.000934,172.31.36.0-255,66,67252,8,214308
45805,0.000942,172.217.194.0-255,7156,74408,8,214308
45806,0.000945,172.31.36.0-255,66,74474,8,214308
45807,0.000974,172.217.194.0-255,3602,78076,8,214308
45808,0.000979,172.31.36.0-255,66,78142,8,214308
45809,0.001042,172.217.194.0-255,1484,79626,8,214308
45810,0.001048,172.217.194.0-255,2902,82528,8,214308
45811,0.001051,172.31.36.0-255,66,82594,8,214308
45812,0.001058,172.217.194.0-255,5738,88332,8,214308
45813,0.00106,172.31.36.0-255,66,88398,8,214308
45814,0.001103,172.31.36.0-255,66,88464,8,214308
45815,0.001108,172.217.194.0-255,2902,91366,8,214308
45816,0.00111,172.31.36.0-255,66,91432,8,214308
45817,0.001152,172.31.36.0-255,66,91498,8,214308
45818,0.00124,172.217.194.0-255,1484,92982,8,214308
45819,0.001244,172.217.194.0-255,1484,94466,8,214308
45820,0.001247,172.31.36.0-255,66,94532,8,214308
45821,0.001277,172.217.194.0-255,1484,96016,8,214308
45822,0.001284,172.217.194.0-255,5738,101754,8,214308
45823,0.001287,172.31.36.0-255,66,101820,8,214308
45824,0.001301,172.31.36.0-255,66,101886,8,214308
45825,0.001338,172.31.36.0-255,66,101952,8,214308
45826,0.001345,172.217.194.0-255,5738,107690,8,214308
45827,0.001348,172.31.36.0-255,66,107756,8,214308
45828,0.001375,172.217.194.0-255,5738,113494,8,214308
45829,0.001377,172.31.36.0-255,66,113560,8,214308
45830,0.001394,172.31.36.0-255,66,113626,8,214308
45831,0.001439,172.217.194.0-255,6438,120064,8,214308
45832,0.001443,172.31.36.0-255,66,120130,8,214308
45833,0.001716,172.217.194.0-255,1484,121614,8,214308
45834,0.001724,172.217.194.0-255,2902,124516,8,214308
45835,0.001727,172.31.36.0-255,66,124582,8,214308
45836,0.001731,172.217.194.0-255,1484,126066,8,214308
45837,0.001764,172.217.194.0-255,4320,130386,8,214308
45838,0.001767,172.31.36.0-255,66,130452,8,214308
45839,0.001781,172.31.36.0-255,66,130518,8,214308
45840,0.001797,172.31.36.0-255,66,130584,8,214308
45841,0.0018,172.217.194.0-255,766,131350,8,214308
45842,0.002062,172.217.194.0-255,1484,132834,8,214308
45843,0.002066,172.31.36.0-255,66,132900,8,214308
45844,0.002072,172.217.194.0-255,2902,135802,8,214308
45845,0.002074,172.31.36.0-255,66,135868,8,214308
45846,0.002078,172.217.194.0-255,2902,138770,8,214308
45847,0.002086,172.31.36.0-255,66,138836,8,214308
45848,0.002111,172.217.194.0-255,2902,141738,8,214308
45849,0.002114,172.31.36.0-255,66,141804,8,214308
45850,0.002149,172.217.194.0-255,5738,147542,8,214308
45851,0.002151,172.31.36.0-255,66,147608,8,214308
45852,0.002188,172.217.194.0-255,7156,154764,8,214308
45853,0.002192,172.31.36.0-255,66,154830,8,214308
45854,0.0022,172.217.194.0-255,7156,161986,8,214308
45855,0.002202,172.31.36.0-255,66,162052,8,214308
45856,0.002207,172.217.194.0-255,3602,165654,8,214308
45857,0.002209,172.31.36.0-255,66,165720,8,214308
45858,0.00253,172.217.194.0-255,1484,167204,8,214308
45859,0.002537,172.217.194.0-255,2902,170106,8,214308
45860,0.00254,172.31.36.0-255,66,170172,8,214308
45861,0.002546,172.217.194.0-255,2902,173074,8,214308
45862,0.002548,172.31.36.0-255,66,173140,8,214308
45863,0.002569,172.217.194.0-255,2902,176042,8,214308
45864,0.002572,172.31.36.0-255,66,176108,8,214308
45865,0.002589,172.31.36.0-255,66,176174,8,214308
45866,0.002619,172.217.194.0-255,2902,179076,8,214308
45867,0.002622,172.31.36.0-255,66,179142,8,214308
45868,0.002632,172.31.36.0-255,66,179208,8,214308
45869,0.002636,172.217.194.0-255,2184,181392,8,214308
45870,0.002639,172.31.36.0-255,66,181458,8,214308
45871,0.002715,172.217.194.0-255,1484,182942,8,214308
45872,0.002719,172.217.194.0-255,1484,184426,8,214308
45873,0.002722,172.31.36.0-255,66,184492,8,214308
45874,0.002753,172.217.194.0-255,4320,188812,8,214308
45875,0.002757,172.31.36.0-255,66,188878,8,214308
45876,0.002768,172.31.36.0-255,66,188944,8,214308
45877,0.00278,172.31.36.0-255,66,189010,8,214308
45878,0.002802,172.217.194.0-255,1484,190494,8,214308
45879,0.002804,172.217.194.0-255,1484,191978,8,214308
45880,0.002807,172.217.194.0-255,1484,193462,8,214308
45881,0.002812,172.31.36.0-255,66,193528,8,214308
45882,0.002838,172.31.36.0-255,66,193594,8,214308
45883,0.002869,172.217.194.0-255,5020,198614,8,214308
45884,0.002872,172.31.36.0-255,66,198680,8,214308
45885,0.002888,172.31.36.0-255,66,198746,8,214308
45886,0.002894,172.217.194.0-255,4320,203066,8,214308
45887,0.002897,172.31.36.0-255,66,203132,8,214308
45888,0.002937,172.31.36.0-255,66,203198,8,214308
45889,0.002948,172.31.36.0-255,66,203264,8,214308
45890,0.002986,172.217.194.0-255,7156,210420,8,214308
45891,0.002989,172.31.36.0-255,66,210486,8,214308
45892,0.003007,172.31.36.0-255,66,210552,8,214308
45893,0.00301,172.217.194.0-255,506,211058,8,214308
45894,0.003034,172.217.194.0-255,105,211163,8,214308
45895,0.005185,172.31.36.0-255,66,211229,8,214308
45896,0.005223,172.31.36.0-255,105,211334,8,214308
45897,0.007449,172.217.194.0-255,66,211400,8,214308
45898,0.029435,172.31.36.0-255,172,211572,8,214308
45899,0.029474,172.31.36.0-255,1110,212682,8,214308
45900,0.029543,172.31.36.0-255,1428,214110,8,214308
45901,0.030965,104.244.42.0-255,66,214176,8,214308
45902,0.030998,104.244.42.0-255,66,214242,8,214308
45903,0.031097,104.244.42.0-255,66,214308,8,214308
45904,0.0,74.125.200.0-255,297,297,8,390471
45905,3e-05,172.31.36.0-255,66,363,8,390471
45906,5.4e-05,74.125.200.0-255,1484,1847,8,390471
45907,6e-05,172.31.36.0-255,66,1913,8,390471
45908,6.6e-05,74.125.200.0-255,2902,4815,8,390471
45909,6.8e-05,172.31.36.0-255,66,4881,8,390471
45910,9.9e-05,74.125.200.0-255,2902,7783,8,390471
45911,0.000103,172.31.36.0-255,66,7849,8,390471
45912,0.000108,74.125.200.0-255,4320,12169,8,390471
45913,0.000111,172.31.36.0-255,66,12235,8,390471
45914,0.00014,74.125.200.0-255,3197,15432,8,390471
45915,0.000144,172.31.36.0-255,66,15498,8,390471
45916,0.000148,74.125.200.0-255,2902,18400,8,390471
45917,0.000151,172.31.36.0-255,66,18466,8,390471
45918,0.000176,74.125.200.0-255,1484,19950,8,390471
45919,0.000182,172.31.36.0-255,66,20016,8,390471
45920,0.000188,74.125.200.0-255,4320,24336,8,390471
45921,0.00019,172.31.36.0-255,66,24402,8,390471
45922,0.000222,74.125.200.0-255,4320,28722,8,390471
45923,0.000226,172.31.36.0-255,66,28788,8,390471
45924,0.00023,74.125.200.0-255,2543,31331,8,390471
45925,0.000232,172.31.36.0-255,66,31397,8,390471
45926,0.000365,74.125.200.0-255,1484,32881,8,390471
45927,0.000369,172.31.36.0-255,66,32947,8,390471
45928,0.000398,74.125.200.0-255,2902,35849,8,390471
45929,0.000403,172.31.36.0-255,66,35915,8,390471
45930,0.000438,74.125.200.0-255,4320,40235,8,390471
45931,0.000442,74.125.200.0-255,2902,43137,8,390471
45932,0.000443,172.31.36.0-255,66,43203,8,390471
45933,0.000447,172.31.36.0-255,66,43269,8,390471
45934,0.000465,74.125.200.0-255,4320,47589,8,390471
45935,0.000468,172.31.36.0-255,66,47655,8,390471
45936,0.000501,74.125.200.0-255,6797,54452,8,390471
45937,0.000507,172.31.36.0-255,66,54518,8,390471
45938,0.000543,74.125.200.0-255,7156,61674,8,390471
45939,0.000548,74.125.200.0-255,2902,64576,8,390471
45940,0.000557,172.31.36.0-255,66,64642,8,390471
45941,0.00058,74.125.200.0-255,1478,66120,8,390471
45942,0.000618,74.125.200.0-255,334,66454,8,390471
45943,0.000623,172.31.36.0-255,66,66520,8,390471
45944,0.000758,74.125.200.0-255,1484,68004,8,390471
45945,0.000772,74.125.200.0-255,2902,70906,8,390471
45946,0.000776,172.31.36.0-255,66,70972,8,390471
45947,0.00078,74.125.200.0-255,1484,72456,8,390471
45948,0.000807,74.125.200.0-255,2902,75358,8,390471
45949,0.000813,172.31.36.0-255,66,75424,8,390471
45950,0.000833,74.125.200.0-255,4320,79744,8,390471
45951,0.000837,172.31.36.0-255,66,79810,8,390471
45952,0.000861,74.125.200.0-255,1484,81294,8,390471
45953,0.000864,74.125.200.0-255,1484,82778,8,390471
45954,0.000866,172.31.36.0-255,66,82844,8,390471
45955,0.000895,74.125.200.0-255,2902,85746,8,390471
45956,0.000903,74.125.200.0-255,5738,91484,8,390471
45957,0.000903,172.31.36.0-255,66,91550,8,390471
45958,0.000907,172.31.36.0-255,66,91616,8,390471
45959,0.00093,74.125.200.0-255,1484,93100,8,390471
45960,0.000951,74.125.200.0-255,1484,94584,8,390471
45961,0.000955,172.31.36.0-255,66,94650,8,390471
45962,0.00096,74.125.200.0-255,6438,101088,8,390471
45963,0.000971,172.31.36.0-255,66,101154,8,390471
45964,0.001406,74.125.200.0-255,1484,102638,8,390471
45965,0.001418,74.125.200.0-255,2902,105540,8,390471
45966,0.001423,172.31.36.0-255,66,105606,8,390471
45967,0.001428,74.125.200.0-255,1484,107090,8,390471
45968,0.001459,74.125.200.0-255,4320,111410,8,390471
45969,0.001464,74.125.200.0-255,2902,114312,8,390471
45970,0.001481,74.125.200.0-255,5738,120050,8,390471
45971,0.001505,74.125.200.0-255,2902,122952,8,390471
45972,0.001521,74.125.200.0-255,2184,125136,8,390471
45973,0.001609,74.125.200.0-255,1484,126620,8,390471
45974,0.001614,74.125.200.0-255,1484,128104,8,390471
45975,0.001626,74.125.200.0-255,1484,129588,8,390471
45976,0.001631,74.125.200.0-255,2902,132490,8,390471
45977,0.001651,74.125.200.0-255,2902,135392,8,390471
45978,0.001656,74.125.200.0-255,4320,139712,8,390471
45979,0.00166,74.125.200.0-255,1484,141196,8,390471
45980,0.001671,74.125.200.0-255,4320,145516,8,390471
45981,0.001692,74.125.200.0-255,4320,149836,8,390471
45982,0.001712,74.125.200.0-255,7156,156992,8,390471
45983,0.001716,74.125.200.0-255,2184,159176,8,390471
45984,0.001763,74.125.200.0-255,1484,160660,8,390471
45985,0.001786,74.125.200.0-255,2902,163562,8,390471
45986,0.001808,74.125.200.0-255,5738,169300,8,390471
45987,0.001826,74.125.200.0-255,2902,172202,8,390471
45988,0.001829,74.125.200.0-255,2902,175104,8,390471
45989,0.001841,172.31.36.0-255,66,175170,8,390471
45990,0.001852,74.125.200.0-255,7156,182326,8,390471
45991,0.001869,74.125.200.0-255,2902,185228,8,390471
45992,0.001873,74.125.200.0-255,2902,188130,8,390471
45993,0.001875,172.31.36.0-255,66,188196,8,390471
45994,0.00188,172.31.36.0-255,66,188262,8,390471
45995,0.001904,74.125.200.0-255,1484,189746,8,390471
45996,0.001912,74.125.200.0-255,3602,193348,8,390471
45997,0.001924,172.31.36.0-255,66,193414,8,390471
45998,0.001953,74.125.200.0-255,4320,197734,8,390471
45999,0.001957,74.125.200.0-255,1484,199218,8,390471
46000,0.001964,172.31.36.0-255,66,199284,8,390471
46001,0.001969,74.125.200.0-255,2902,202186,8,390471
46002,0.001979,172.31.36.0-255,66,202252,8,390471
46003,0.002,74.125.200.0-255,5738,207990,8,390471
46004,0.002007,172.31.36.0-255,66,208056,8,390471
46005,0.002049,172.31.36.0-255,66,208122,8,390471
46006,0.002076,74.125.200.0-255,6438,214560,8,390471
46007,0.002087,172.31.36.0-255,66,214626,8,390471
46008,0.002092,74.125.200.0-255,1484,216110,8,390471
46009,0.002118,74.125.200.0-255,5738,221848,8,390471
46010,0.002122,74.125.200.0-255,2902,224750,8,390471
46011,0.002122,172.31.36.0-255,66,224816,8,390471
46012,0.002127,172.31.36.0-255,66,224882,8,390471
46013,0.002156,74.125.200.0-255,4320,229202,8,390471
46014,0.002173,74.125.200.0-255,2902,232104,8,390471
46015,0.002173,172.31.36.0-255,66,232170,8,390471
46016,0.002178,172.31.36.0-255,66,232236,8,390471
46017,0.002211,74.125.200.0-255,5738,237974,8,390471
46018,0.002224,74.125.200.0-255,766,238740,8,390471
46019,0.00223,172.31.36.0-255,66,238806,8,390471
46020,0.002268,74.125.200.0-255,1484,240290,8,390471
46021,0.002283,74.125.200.0-255,2902,243192,8,390471
46022,0.002296,172.31.36.0-255,66,243258,8,390471
46023,0.002344,74.125.200.0-255,5738,248996,8,390471
46024,0.002348,74.125.200.0-255,2902,251898,8,390471
46025,0.002348,172.31.36.0-255,66,251964,8,390471
46026,0.002353,74.125.200.0-255,4320,256284,8,390471
46027,0.002353,172.31.36.0-255,66,256350,8,390471
46028,0.002373,172.31.36.0-255,66,256416,8,390471
46029,0.004678,74.125.200.0-255,1484,257900,8,390471
46030,0.004709,74.125.200.0-255,4320,262220,8,390471
46031,0.004714,172.31.36.0-255,66,262286,8,390471
46032,0.007044,74.125.200.0-255,2902,265188,8,390471
46033,0.007049,172.31.36.0-255,66,265254,8,390471
46034,0.007081,74.125.200.0-255,2902,268156,8,390471
46035,0.007095,172.31.36.0-255,66,268222,8,390471
46036,0.009365,74.125.200.0-255,2902,271124,8,390471
46037,0.00937,172.31.36.0-255,66,271190,8,390471
46038,0.009408,74.125.200.0-255,2902,274092,8,390471
46039,0.009496,172.31.36.0-255,66,274158,8,390471
46040,0.011724,74.125.200.0-255,2902,277060,8,390471
46041,0.01173,172.31.36.0-255,66,277126,8,390471
46042,0.011825,74.125.200.0-255,2902,280028,8,390471
46043,0.011838,172.31.36.0-255,66,280094,8,390471
46044,0.01406,74.125.200.0-255,2902,282996,8,390471
46045,0.014068,172.31.36.0-255,66,283062,8,390471
46046,0.01416,74.125.200.0-255,2902,285964,8,390471
46047,0.014259,172.31.36.0-255,66,286030,8,390471
46048,0.016384,74.125.200.0-255,2902,288932,8,390471
46049,0.016391,172.31.36.0-255,66,288998,8,390471
46050,0.016571,74.125.200.0-255,2902,291900,8,390471
46051,0.016578,172.31.36.0-255,66,291966,8,390471
46052,0.018715,74.125.200.0-255,2902,294868,8,390471
46053,0.018721,172.31.36.0-255,66,294934,8,390471
46054,0.018896,74.125.200.0-255,2902,297836,8,390471
46055,0.018901,172.31.36.0-255,66,297902,8,390471
46056,0.021045,74.125.200.0-255,2902,300804,8,390471
46057,0.021053,172.31.36.0-255,66,300870,8,390471
46058,0.021223,74.125.200.0-255,2902,303772,8,390471
46059,0.021228,172.31.36.0-255,66,303838,8,390471
46060,0.023375,74.125.200.0-255,2902,306740,8,390471
46061,0.023385,172.31.36.0-255,66,306806,8,390471
46062,0.023558,74.125.200.0-255,2902,309708,8,390471
46063,0.023565,172.31.36.0-255,66,309774,8,390471
46064,0.025713,74.125.200.0-255,2902,312676,8,390471
46065,0.02572,172.31.36.0-255,66,312742,8,390471
46066,0.025893,74.125.200.0-255,2902,315644,8,390471
46067,0.025899,172.31.36.0-255,66,315710,8,390471
46068,0.028045,74.125.200.0-255,2902,318612,8,390471
46069,0.028052,172.31.36.0-255,66,318678,8,390471
46070,0.028216,74.125.200.0-255,2902,321580,8,390471
46071,0.028222,172.31.36.0-255,66,321646,8,390471
46072,0.030391,74.125.200.0-255,2902,324548,8,390471
46073,0.030399,172.31.36.0-255,66,324614,8,390471
46074,0.030544,74.125.200.0-255,2902,327516,8,390471
46075,0.030973,172.31.36.0-255,66,327582,8,390471
46076,0.032726,74.125.200.0-255,2902,330484,8,390471
46077,0.032732,172.31.36.0-255,66,330550,8,390471
46078,0.033293,74.125.200.0-255,2902,333452,8,390471
46079,0.033299,172.31.36.0-255,66,333518,8,390471
46080,0.035073,74.125.200.0-255,2902,336420,8,390471
46081,0.03508,172.31.36.0-255,66,336486,8,390471
46082,0.035624,74.125.200.0-255,2902,339388,8,390471
46083,0.035631,172.31.36.0-255,66,339454,8,390471
46084,0.037402,74.125.200.0-255,2902,342356,8,390471
46085,0.03741,172.31.36.0-255,66,342422,8,390471
46086,0.03796,74.125.200.0-255,2902,345324,8,390471
46087,0.037967,172.31.36.0-255,66,345390,8,390471
46088,0.039732,74.125.200.0-255,2902,348292,8,390471
46089,0.039737,172.31.36.0-255,66,348358,8,390471
46090,0.039967,172.31.36.0-255,172,348530,8,390471
46091,0.039994,172.31.36.0-255,1113,349643,8,390471
46092,0.040023,172.31.36.0-255,1514,351157,8,390471
46093,0.040025,172.31.36.0-255,1514,352671,8,390471
46094,0.040029,172.31.36.0-255,1514,354185,8,390471
46095,0.04003,172.31.36.0-255,770,354955,8,390471
46096,0.04029,74.125.200.0-255,2902,357857,8,390471
46097,0.040295,172.31.36.0-255,66,357923,8,390471
46098,0.041545,104.244.42.0-255,66,357989,8,390471
46099,0.041552,104.244.42.0-255,66,358055,8,390471
46100,0.041606,104.244.42.0-255,66,358121,8,390471
46101,0.041609,104.244.42.0-255,66,358187,8,390471
46102,0.04206,74.125.200.0-255,2902,361089,8,390471
46103,0.042064,172.31.36.0-255,66,361155,8,390471
46104,0.042612,74.125.200.0-255,2902,364057,8,390471
46105,0.042618,172.31.36.0-255,66,364123,8,390471
46106,0.044377,74.125.200.0-255,2902,367025,8,390471
46107,0.044383,172.31.36.0-255,66,367091,8,390471
46108,0.044958,74.125.200.0-255,2902,369993,8,390471
46109,0.044963,172.31.36.0-255,66,370059,8,390471
46110,0.046705,74.125.200.0-255,2902,372961,8,390471
46111,0.046708,172.31.36.0-255,66,373027,8,390471
46112,0.047291,74.125.200.0-255,2902,375929,8,390471
46113,0.047296,172.31.36.0-255,66,375995,8,390471
46114,0.049024,74.125.200.0-255,2902,378897,8,390471
46115,0.049029,172.31.36.0-255,66,378963,8,390471
46116,0.049608,74.125.200.0-255,2902,381865,8,390471
46117,0.049613,172.31.36.0-255,66,381931,8,390471
46118,0.05135,74.125.200.0-255,2902,384833,8,390471
46119,0.051357,172.31.36.0-255,66,384899,8,390471
46120,0.05193,74.125.200.0-255,2902,387801,8,390471
46121,0.051936,172.31.36.0-255,66,387867,8,390471
46122,0.053687,74.125.200.0-255,2367,390234,8,390471
46123,0.053692,172.31.36.0-255,66,390300,8,390471
46124,0.053865,172.31.36.0-255,105,390405,8,390471
46125,0.056144,74.125.200.0-255,66,390471,8,390471
46126,0.0,172.217.194.0-255,150,150,8,287909
46127,3.4e-05,172.31.36.0-255,66,216,8,287909
46128,4e-05,172.217.194.0-255,1484,1700,8,287909
46129,4.4e-05,172.31.36.0-255,66,1766,8,287909
46130,4.9e-05,172.217.194.0-255,2902,4668,8,287909
46131,5.1e-05,172.31.36.0-255,66,4734,8,287909
46132,5.9e-05,172.217.194.0-255,7156,11890,8,287909
46133,6.2e-05,172.31.36.0-255,66,11956,8,287909
46134,6.5e-05,172.217.194.0-255,2011,13967,8,287909
46135,6.8e-05,172.31.36.0-255,66,14033,8,287909
46136,8.6e-05,172.217.194.0-255,7156,21189,8,287909
46137,9e-05,172.31.36.0-255,66,21255,8,287909
46138,0.000101,172.217.194.0-255,4320,25575,8,287909
46139,0.000103,172.31.36.0-255,66,25641,8,287909
46140,0.000111,172.217.194.0-255,5379,31020,8,287909
46141,0.000113,172.31.36.0-255,66,31086,8,287909
46142,0.000172,172.217.194.0-255,1484,32570,8,287909
46143,0.000176,172.31.36.0-255,66,32636,8,287909
46144,0.000197,172.217.194.0-255,2902,35538,8,287909
46145,0.0002,172.31.36.0-255,66,35604,8,287909
46146,0.000206,172.217.194.0-255,5738,41342,8,287909
46147,0.000209,172.31.36.0-255,66,41408,8,287909
46148,0.000239,172.217.194.0-255,6797,48205,8,287909
46149,0.000242,172.31.36.0-255,66,48271,8,287909
46150,0.000276,172.31.36.0-255,66,48337,8,287909
46151,0.00028,172.217.194.0-255,2832,51169,8,287909
46152,0.000282,172.31.36.0-255,66,51235,8,287909
46153,0.000634,172.217.194.0-255,366,51601,8,287909
46154,0.000639,172.31.36.0-255,66,51667,8,287909
46155,0.000658,172.217.194.0-255,1484,53151,8,287909
46156,0.000661,172.31.36.0-255,66,53217,8,287909
46157,0.000684,172.217.194.0-255,4320,57537,8,287909
46158,0.00069,172.31.36.0-255,66,57603,8,287909
46159,0.00072,172.217.194.0-255,576,58179,8,287909
46160,0.000729,172.31.36.0-255,66,58245,8,287909
46161,0.001074,172.217.194.0-255,1484,59729,8,287909
46162,0.001085,172.217.194.0-255,2902,62631,8,287909
46163,0.001089,172.31.36.0-255,66,62697,8,287909
46164,0.001097,172.217.194.0-255,5738,68435,8,287909
46165,0.001127,172.217.194.0-255,1484,69919,8,287909
46166,0.001389,172.217.194.0-255,1484,71403,8,287909
46167,0.001396,172.217.194.0-255,2902,74305,8,287909
46168,0.001398,172.217.194.0-255,1484,75789,8,287909
46169,0.001434,172.217.194.0-255,4320,80109,8,287909
46170,0.001449,172.217.194.0-255,4320,84429,8,287909
46171,0.001467,172.217.194.0-255,4320,88749,8,287909
46172,0.001479,172.217.194.0-255,2184,90933,8,287909
46173,0.002232,172.217.194.0-255,1484,92417,8,287909
46174,0.002256,172.217.194.0-255,2902,95319,8,287909
46175,0.002263,172.217.194.0-255,5738,101057,8,287909
46176,0.002265,172.217.194.0-255,1484,102541,8,287909
46177,0.002286,172.217.194.0-255,5738,108279,8,287909
46178,0.002309,172.217.194.0-255,1484,109763,8,287909
46179,0.00232,172.217.194.0-255,4320,114083,8,287909
46180,0.002334,172.217.194.0-255,2902,116985,8,287909
46181,0.002345,172.217.194.0-255,4320,121305,8,287909
46182,0.002356,172.217.194.0-255,3602,124907,8,287909
46183,0.002419,172.217.194.0-255,1484,126391,8,287909
46184,0.002423,172.217.194.0-255,2902,129293,8,287909
46185,0.002448,172.217.194.0-255,5738,135031,8,287909
46186,0.002454,172.217.194.0-255,4320,139351,8,287909
46187,0.002471,172.217.194.0-255,5738,145089,8,287909
46188,0.002494,172.217.194.0-255,1484,146573,8,287909
46189,0.002524,172.217.194.0-255,1484,148057,8,287909
46190,0.002546,172.217.194.0-255,7156,155213,8,287909
46191,0.002571,172.217.194.0-255,1484,156697,8,287909
46192,0.002576,172.217.194.0-255,2902,159599,8,287909
46193,0.002581,172.217.194.0-255,5738,165337,8,287909
46194,0.0026,172.217.194.0-255,1484,166821,8,287909
46195,0.002615,172.217.194.0-255,7156,173977,8,287909
46196,0.002657,172.217.194.0-255,6438,180415,8,287909
46197,0.002663,172.217.194.0-255,5738,186153,8,287909
46198,0.00272,172.217.194.0-255,4320,190473,8,287909
46199,0.002735,172.217.194.0-255,766,191239,8,287909
46200,0.002741,172.217.194.0-255,5738,196977,8,287909
46201,0.002795,172.217.194.0-255,2902,199879,8,287909
46202,0.002807,172.217.194.0-255,3602,203481,8,287909
46203,0.002821,172.217.194.0-255,1484,204965,8,287909
46204,0.002832,172.217.194.0-255,1484,206449,8,287909
46205,0.002844,172.217.194.0-255,1484,207933,8,287909
46206,0.002848,172.217.194.0-255,2902,210835,8,287909
46207,0.002857,172.217.194.0-255,2902,213737,8,287909
46208,0.002872,172.217.194.0-255,1484,215221,8,287909
46209,0.002883,172.217.194.0-255,4320,219541,8,287909
46210,0.002904,172.217.194.0-255,7156,226697,8,287909
46211,0.002907,172.217.194.0-255,1484,228181,8,287909
46212,0.002909,172.217.194.0-255,1484,229665,8,287909
46213,0.002929,172.217.194.0-255,7156,236821,8,287909
46214,0.002943,172.217.194.0-255,766,237587,8,287909
46215,0.002946,172.217.194.0-255,1484,239071,8,287909
46216,0.002949,172.217.194.0-255,1484,240555,8,287909
46217,0.002964,172.217.194.0-255,2902,243457,8,287909
46218,0.00298,172.217.194.0-255,5738,249195,8,287909
46219,0.002983,172.217.194.0-255,1484,250679,8,287909
46220,0.003009,172.217.194.0-255,5738,256417,8,287909
46221,0.003031,172.217.194.0-255,5738,262155,8,287909
46222,0.003056,172.217.194.0-255,1484,263639,8,287909
46223,0.003096,172.217.194.0-255,5738,269377,8,287909
46224,0.003117,172.217.194.0-255,4320,273697,8,287909
46225,0.003147,172.217.194.0-255,3410,277107,8,287909
46226,0.003164,172.217.194.0-255,105,277212,8,287909
46227,0.006635,172.31.36.0-255,66,277278,8,287909
46228,0.009512,172.31.36.0-255,105,277383,8,287909
46229,0.011737,172.217.194.0-255,66,277449,8,287909
46230,0.032753,172.31.36.0-255,172,277621,8,287909
46231,0.032787,172.31.36.0-255,1110,278731,8,287909
46232,0.032831,172.31.36.0-255,1514,280245,8,287909
46233,0.032833,172.31.36.0-255,1514,281759,8,287909
46234,0.032838,172.31.36.0-255,1514,283273,8,287909
46235,0.032839,172.31.36.0-255,1514,284787,8,287909
46236,0.032863,172.31.36.0-255,1514,286301,8,287909
46237,0.032864,172.31.36.0-255,996,287297,8,287909
46238,0.03431,104.244.42.0-255,66,287363,8,287909
46239,0.034378,104.244.42.0-255,66,287429,8,287909
46240,0.034383,104.244.42.0-255,66,287495,8,287909
46241,0.034434,104.244.42.0-255,66,287561,8,287909
46242,0.03444,104.244.42.0-255,66,287627,8,287909
46243,0.035641,104.244.42.0-255,108,287735,8,287909
46244,0.035666,172.31.36.0-255,66,287801,8,287909
46245,0.041644,172.31.36.0-255,108,287909,8,287909
46246,0.0,172.217.160.0-255,153,153,8,337699
46247,2.4e-05,172.31.36.0-255,66,219,8,337699
46248,3.1e-05,172.217.160.0-255,1484,1703,8,337699
46249,3.5e-05,172.31.36.0-255,66,1769,8,337699
46250,4.2e-05,172.217.160.0-255,2902,4671,8,337699
46251,4.6e-05,172.31.36.0-255,66,4737,8,337699
46252,5.5e-05,172.217.160.0-255,7156,11893,8,337699
46253,5.9e-05,172.31.36.0-255,66,11959,8,337699
46254,6.3e-05,172.217.160.0-255,2066,14025,8,337699
46255,6.6e-05,172.31.36.0-255,66,14091,8,337699
46256,0.000258,172.217.160.0-255,1484,15575,8,337699
46257,0.000264,172.31.36.0-255,66,15641,8,337699
46258,0.00027,172.217.160.0-255,2902,18543,8,337699
46259,0.000273,172.31.36.0-255,66,18609,8,337699
46260,0.00028,172.217.160.0-255,5738,24347,8,337699
46261,0.000282,172.31.36.0-255,66,24413,8,337699
46262,0.000288,172.217.160.0-255,4320,28733,8,337699
46263,0.00029,172.31.36.0-255,66,28799,8,337699
46264,0.000334,172.217.160.0-255,2543,31342,8,337699
46265,0.000338,172.31.36.0-255,66,31408,8,337699
46266,0.000411,172.217.160.0-255,1484,32892,8,337699
46267,0.000415,172.31.36.0-255,66,32958,8,337699
46268,0.000421,172.217.160.0-255,2902,35860,8,337699
46269,0.000424,172.31.36.0-255,66,35926,8,337699
46270,0.000431,172.217.160.0-255,5738,41664,8,337699
46271,0.000433,172.31.36.0-255,66,41730,8,337699
46272,0.000439,172.217.160.0-255,4320,46050,8,337699
46273,0.000441,172.31.36.0-255,66,46116,8,337699
46274,0.000487,172.217.160.0-255,2543,48659,8,337699
46275,0.00049,172.31.36.0-255,66,48725,8,337699
46276,0.000512,172.217.160.0-255,2902,51627,8,337699
46277,0.000515,172.31.36.0-255,66,51693,8,337699
46278,0.000519,172.217.160.0-255,1484,53177,8,337699
46279,0.000536,172.217.160.0-255,2902,56079,8,337699
46280,0.000538,172.31.36.0-255,66,56145,8,337699
46281,0.000546,172.217.160.0-255,7156,63301,8,337699
46282,0.000549,172.31.36.0-255,66,63367,8,337699
46283,0.000587,172.217.160.0-255,2543,65910,8,337699
46284,0.000589,172.31.36.0-255,66,65976,8,337699
46285,0.000622,172.217.160.0-255,375,66351,8,337699
46286,0.001041,172.31.36.0-255,66,66417,8,337699
46287,0.001206,172.217.160.0-255,368,66785,8,337699
46288,0.001299,172.217.160.0-255,1484,68269,8,337699
46289,0.001304,172.31.36.0-255,66,68335,8,337699
46290,0.00131,172.217.160.0-255,2902,71237,8,337699
46291,0.001312,172.31.36.0-255,66,71303,8,337699
46292,0.001318,172.217.160.0-255,4320,75623,8,337699
46293,0.00132,172.31.36.0-255,66,75689,8,337699
46294,0.001339,172.217.160.0-255,1484,77173,8,337699
46295,0.001344,172.217.160.0-255,2902,80075,8,337699
46296,0.001346,172.31.36.0-255,66,80141,8,337699
46297,0.001366,172.217.160.0-255,3961,84102,8,337699
46298,0.001368,172.31.36.0-255,66,84168,8,337699
46299,0.001376,172.217.160.0-255,7156,91324,8,337699
46300,0.001378,172.31.36.0-255,66,91390,8,337699
46301,0.001418,172.31.36.0-255,66,91456,8,337699
46302,0.001646,172.217.160.0-255,1484,92940,8,337699
46303,0.001654,172.217.160.0-255,2902,95842,8,337699
46304,0.001658,172.31.36.0-255,66,95908,8,337699
46305,0.001666,172.217.160.0-255,5738,101646,8,337699
46306,0.001668,172.31.36.0-255,66,101712,8,337699
46307,0.001672,172.217.160.0-255,2902,104614,8,337699
46308,0.001674,172.31.36.0-255,66,104680,8,337699
46309,0.003315,172.217.160.0-255,5738,110418,8,337699
46310,0.003321,172.31.36.0-255,66,110484,8,337699
46311,0.00501,172.217.160.0-255,5738,116222,8,337699
46312,0.005013,172.31.36.0-255,66,116288,8,337699
46313,0.006668,172.217.160.0-255,5738,122026,8,337699
46314,0.006673,172.31.36.0-255,66,122092,8,337699
46315,0.00835,172.217.160.0-255,5738,127830,8,337699
46316,0.008357,172.31.36.0-255,66,127896,8,337699
46317,0.010024,172.217.160.0-255,5738,133634,8,337699
46318,0.010032,172.31.36.0-255,66,133700,8,337699
46319,0.011698,172.217.160.0-255,5738,139438,8,337699
46320,0.011705,172.31.36.0-255,66,139504,8,337699
46321,0.013367,172.217.160.0-255,5738,145242,8,337699
46322,0.013375,172.31.36.0-255,66,145308,8,337699
46323,0.015027,172.217.160.0-255,5738,151046,8,337699
46324,0.015035,172.31.36.0-255,66,151112,8,337699
46325,0.016692,172.217.160.0-255,5738,156850,8,337699
46326,0.016699,172.31.36.0-255,66,156916,8,337699
46327,0.018372,172.217.160.0-255,5738,162654,8,337699
46328,0.018379,172.31.36.0-255,66,162720,8,337699
46329,0.020032,172.217.160.0-255,5738,168458,8,337699
46330,0.02004,172.31.36.0-255,66,168524,8,337699
46331,0.0217,172.217.160.0-255,5738,174262,8,337699
46332,0.021707,172.31.36.0-255,66,174328,8,337699
46333,0.023377,172.217.160.0-255,5738,180066,8,337699
46334,0.023384,172.31.36.0-255,66,180132,8,337699
46335,0.025049,172.217.160.0-255,5738,185870,8,337699
46336,0.025056,172.31.36.0-255,66,185936,8,337699
46337,0.026709,172.217.160.0-255,5738,191674,8,337699
46338,0.026716,172.31.36.0-255,66,191740,8,337699
46339,0.028368,172.217.160.0-255,5738,197478,8,337699
46340,0.028376,172.31.36.0-255,66,197544,8,337699
46341,0.030028,172.217.160.0-255,5738,203282,8,337699
46342,0.030035,172.31.36.0-255,66,203348,8,337699
46343,0.031691,172.217.160.0-255,5738,209086,8,337699
46344,0.031699,172.31.36.0-255,66,209152,8,337699
46345,0.03281,172.31.36.0-255,231,209383,8,337699
46346,0.032841,172.31.36.0-255,562,209945,8,337699
46347,0.033352,172.217.160.0-255,5738,215683,8,337699
46348,0.033359,172.31.36.0-255,66,215749,8,337699
46349,0.035005,104.244.42.0-255,66,215815,8,337699
46350,0.035015,172.217.160.0-255,5738,221553,8,337699
46351,0.03502,172.31.36.0-255,66,221619,8,337699
46352,0.036673,172.217.160.0-255,5738,227357,8,337699
46353,0.03668,172.31.36.0-255,66,227423,8,337699
46354,0.038333,172.217.160.0-255,5738,233161,8,337699
46355,0.03834,172.31.36.0-255,66,233227,8,337699
46356,0.039995,172.217.160.0-255,5738,238965,8,337699
46357,0.040003,172.31.36.0-255,66,239031,8,337699
46358,0.041666,172.217.160.0-255,5738,244769,8,337699
46359,0.041672,172.31.36.0-255,66,244835,8,337699
46360,0.043326,172.217.160.0-255,5738,250573,8,337699
46361,0.043332,172.31.36.0-255,66,250639,8,337699
46362,0.044989,172.217.160.0-255,5738,256377,8,337699
46363,0.044999,172.31.36.0-255,66,256443,8,337699
46364,0.046651,172.217.160.0-255,5738,262181,8,337699
46365,0.046659,172.31.36.0-255,66,262247,8,337699
46366,0.048323,172.217.160.0-255,5738,267985,8,337699
46367,0.048331,172.31.36.0-255,66,268051,8,337699
46368,0.049994,172.217.160.0-255,5738,273789,8,337699
46369,0.05,172.31.36.0-255,66,273855,8,337699
46370,0.051655,172.217.160.0-255,5738,279593,8,337699
46371,0.051661,172.31.36.0-255,66,279659,8,337699
46372,0.053354,172.217.160.0-255,5738,285397,8,337699
46373,0.05336,172.31.36.0-255,66,285463,8,337699
46374,0.055025,172.217.160.0-255,5738,291201,8,337699
46375,0.055031,172.31.36.0-255,66,291267,8,337699
46376,0.056701,172.217.160.0-255,5738,297005,8,337699
46377,0.056708,172.31.36.0-255,66,297071,8,337699
46378,0.058395,172.217.160.0-255,5738,302809,8,337699
46379,0.058401,172.31.36.0-255,66,302875,8,337699
46380,0.060053,172.217.160.0-255,5738,308613,8,337699
46381,0.060061,172.31.36.0-255,66,308679,8,337699
46382,0.061717,172.217.160.0-255,5738,314417,8,337699
46383,0.061724,172.31.36.0-255,66,314483,8,337699
46384,0.063388,172.217.160.0-255,5738,320221,8,337699
46385,0.063395,172.31.36.0-255,66,320287,8,337699
46386,0.065044,172.217.160.0-255,5738,326025,8,337699
46387,0.065051,172.31.36.0-255,66,326091,8,337699
46388,0.066707,172.217.160.0-255,5738,331829,8,337699
46389,0.066714,172.31.36.0-255,66,331895,8,337699
46390,0.068376,172.217.160.0-255,5738,337633,8,337699
46391,0.068382,172.31.36.0-255,66,337699,8,337699
46392,0.0,172.31.36.0-255,180,180,8,11907
46393,5.7e-05,172.31.36.0-255,332,512,8,11907
46394,0.001572,104.244.42.0-255,66,578,8,11907
46395,0.001615,104.244.42.0-255,66,644,8,11907
46396,0.020311,172.31.36.0-255,172,816,8,11907
46397,0.020338,172.31.36.0-255,1132,1948,8,11907
46398,0.020633,172.31.36.0-255,1514,3462,8,11907
46399,0.020636,172.31.36.0-255,1514,4976,8,11907
46400,0.020642,172.31.36.0-255,1514,6490,8,11907
46401,0.020643,172.31.36.0-255,1514,8004,8,11907
46402,0.020665,172.31.36.0-255,1514,9518,8,11907
46403,0.020671,172.31.36.0-255,1514,11032,8,11907
46404,0.020691,172.31.36.0-255,545,11577,8,11907
46405,0.02183,104.244.42.0-255,66,11643,8,11907
46406,0.021865,104.244.42.0-255,66,11709,8,11907
46407,0.022171,104.244.42.0-255,66,11775,8,11907
46408,0.02221,104.244.42.0-255,66,11841,8,11907
46409,0.022214,104.244.42.0-255,66,11907,8,11907
46410,0.0,104.244.42.0-255,66,66,8,66
46411,0.0,74.125.24.0-255,151,151,8,307973
46412,2.2e-05,172.31.36.0-255,66,217,8,307973
46413,3.1e-05,74.125.24.0-255,1484,1701,8,307973
46414,3.5e-05,172.31.36.0-255,66,1767,8,307973
46415,4.8e-05,74.125.24.0-255,2902,4669,8,307973
46416,5.1e-05,172.31.36.0-255,66,4735,8,307973
46417,5.7e-05,74.125.24.0-255,4320,9055,8,307973
46418,6e-05,172.31.36.0-255,66,9121,8,307973
46419,9.9e-05,74.125.24.0-255,4922,14043,8,307973
46420,0.000103,172.31.36.0-255,66,14109,8,307973
46421,0.000129,74.125.24.0-255,1484,15593,8,307973
46422,0.000132,172.31.36.0-255,66,15659,8,307973
46423,0.000137,74.125.24.0-255,2902,18561,8,307973
46424,0.000139,172.31.36.0-255,66,18627,8,307973
46425,0.000155,74.125.24.0-255,1484,20111,8,307973
46426,0.000157,172.31.36.0-255,66,20177,8,307973
46427,0.000186,74.125.24.0-255,4320,24497,8,307973
46428,0.000189,172.31.36.0-255,66,24563,8,307973
46429,0.000195,74.125.24.0-255,4320,28883,8,307973
46430,0.000197,172.31.36.0-255,66,28949,8,307973
46431,0.000226,172.31.36.0-255,66,29015,8,307973
46432,0.000255,74.125.24.0-255,2543,31558,8,307973
46433,0.000257,172.31.36.0-255,66,31624,8,307973
46434,0.000265,74.125.24.0-255,6797,38421,8,307973
46435,0.000268,172.31.36.0-255,66,38487,8,307973
46436,0.000894,74.125.24.0-255,1484,39971,8,307973
46437,0.000899,172.31.36.0-255,66,40037,8,307973
46438,0.000905,74.125.24.0-255,2902,42939,8,307973
46439,0.000907,172.31.36.0-255,66,43005,8,307973
46440,0.000918,74.125.24.0-255,5738,48743,8,307973
46441,0.00092,172.31.36.0-255,66,48809,8,307973
46442,0.000958,74.125.24.0-255,6797,55606,8,307973
46443,0.000961,172.31.36.0-255,66,55672,8,307973
46444,0.000991,74.125.24.0-255,5738,61410,8,307973
46445,0.000993,172.31.36.0-255,66,61476,8,307973
46446,0.000997,74.125.24.0-255,2902,64378,8,307973
46447,0.000999,172.31.36.0-255,66,64444,8,307973
46448,0.001019,74.125.24.0-255,4320,68764,8,307973
46449,0.001021,172.31.36.0-255,66,68830,8,307973
46450,0.001054,74.125.24.0-255,4543,73373,8,307973
46451,0.001057,172.31.36.0-255,66,73439,8,307973
46452,0.001063,74.125.24.0-255,5738,79177,8,307973
46453,0.001065,172.31.36.0-255,66,79243,8,307973
46454,0.00113,172.31.36.0-255,66,79309,8,307973
46455,0.001571,74.125.24.0-255,1484,80793,8,307973
46456,0.001578,74.125.24.0-255,2902,83695,8,307973
46457,0.001582,172.31.36.0-255,66,83761,8,307973
46458,0.001588,74.125.24.0-255,5738,89499,8,307973
46459,0.00159,172.31.36.0-255,66,89565,8,307973
46460,0.001643,74.125.24.0-255,6246,95811,8,307973
46461,0.001646,172.31.36.0-255,66,95877,8,307973
46462,0.001783,74.125.24.0-255,1484,97361,8,307973
46463,0.001805,74.125.24.0-255,2902,100263,8,307973
46464,0.001809,172.31.36.0-255,66,100329,8,307973
46465,0.001815,74.125.24.0-255,5738,106067,8,307973
46466,0.001817,172.31.36.0-255,66,106133,8,307973
46467,0.001824,74.125.24.0-255,1484,107617,8,307973
46468,0.001853,172.31.36.0-255,66,107683,8,307973
46469,0.001862,172.31.36.0-255,66,107749,8,307973
46470,0.001879,74.125.24.0-255,2184,109933,8,307973
46471,0.001881,172.31.36.0-255,66,109999,8,307973
46472,0.001981,74.125.24.0-255,1484,111483,8,307973
46473,0.001988,74.125.24.0-255,2902,114385,8,307973
46474,0.001991,172.31.36.0-255,66,114451,8,307973
46475,0.001996,74.125.24.0-255,2902,117353,8,307973
46476,0.001997,172.31.36.0-255,66,117419,8,307973
46477,0.002018,74.125.24.0-255,2902,120321,8,307973
46478,0.00202,172.31.36.0-255,66,120387,8,307973
46479,0.00203,172.31.36.0-255,66,120453,8,307973
46480,0.002059,74.125.24.0-255,4320,124773,8,307973
46481,0.002064,172.31.36.0-255,66,124839,8,307973
46482,0.002076,172.31.36.0-255,66,124905,8,307973
46483,0.00223,74.125.24.0-255,1484,126389,8,307973
46484,0.002237,74.125.24.0-255,2902,129291,8,307973
46485,0.002242,172.31.36.0-255,66,129357,8,307973
46486,0.002249,74.125.24.0-255,5738,135095,8,307973
46487,0.002252,172.31.36.0-255,66,135161,8,307973
46488,0.002296,172.31.36.0-255,66,135227,8,307973
46489,0.002336,172.31.36.0-255,66,135293,8,307973
46490,0.004599,74.125.24.0-255,5738,141031,8,307973
46491,0.004605,172.31.36.0-255,66,141097,8,307973
46492,0.006903,74.125.24.0-255,5738,146835,8,307973
46493,0.006909,172.31.36.0-255,66,146901,8,307973
46494,0.009204,74.125.24.0-255,5738,152639,8,307973
46495,0.009211,172.31.36.0-255,66,152705,8,307973
46496,0.011461,74.125.24.0-255,5738,158443,8,307973
46497,0.011469,172.31.36.0-255,66,158509,8,307973
46498,0.013735,74.125.24.0-255,5738,164247,8,307973
46499,0.013743,172.31.36.0-255,66,164313,8,307973
46500,0.016047,74.125.24.0-255,5738,170051,8,307973
46501,0.016055,172.31.36.0-255,66,170117,8,307973
46502,0.018362,74.125.24.0-255,5738,175855,8,307973
46503,0.018373,172.31.36.0-255,66,175921,8,307973
46504,0.020624,74.125.24.0-255,5738,181659,8,307973
46505,0.02063,172.31.36.0-255,66,181725,8,307973
46506,0.022944,74.125.24.0-255,5738,187463,8,307973
46507,0.02295,172.31.36.0-255,66,187529,8,307973
46508,0.025262,74.125.24.0-255,5738,193267,8,307973
46509,0.025269,172.31.36.0-255,66,193333,8,307973
46510,0.027548,74.125.24.0-255,5738,199071,8,307973
46511,0.027554,172.31.36.0-255,66,199137,8,307973
46512,0.029906,74.125.24.0-255,5738,204875,8,307973
46513,0.029915,172.31.36.0-255,66,204941,8,307973
46514,0.032195,74.125.24.0-255,5738,210679,8,307973
46515,0.032203,172.31.36.0-255,66,210745,8,307973
46516,0.03447,74.125.24.0-255,5738,216483,8,307973
46517,0.034479,172.31.36.0-255,66,216549,8,307973
46518,0.036764,74.125.24.0-255,5738,222287,8,307973
46519,0.036772,172.31.36.0-255,66,222353,8,307973
46520,0.039028,74.125.24.0-255,5738,228091,8,307973
46521,0.039036,172.31.36.0-255,66,228157,8,307973
46522,0.04133,74.125.24.0-255,5738,233895,8,307973
46523,0.041344,172.31.36.0-255,66,233961,8,307973
46524,0.042791,172.31.36.0-255,172,234133,8,307973
46525,0.042824,172.31.36.0-255,1109,235242,8,307973
46526,0.042891,172.31.36.0-255,1514,236756,8,307973
46527,0.042893,172.31.36.0-255,1371,238127,8,307973
46528,0.04366,74.125.24.0-255,5738,243865,8,307973
46529,0.043667,172.31.36.0-255,66,243931,8,307973
46530,0.044341,104.244.42.0-255,66,243997,8,307973
46531,0.044524,104.244.42.0-255,66,244063,8,307973
46532,0.04453,104.244.42.0-255,66,244129,8,307973
46533,0.045949,74.125.24.0-255,5738,249867,8,307973
46534,0.045956,172.31.36.0-255,66,249933,8,307973
46535,0.048226,74.125.24.0-255,5738,255671,8,307973
46536,0.048232,172.31.36.0-255,66,255737,8,307973
46537,0.050521,74.125.24.0-255,5738,261475,8,307973
46538,0.05054,172.31.36.0-255,66,261541,8,307973
46539,0.052858,74.125.24.0-255,5738,267279,8,307973
46540,0.052865,172.31.36.0-255,66,267345,8,307973
46541,0.055202,74.125.24.0-255,5738,273083,8,307973
46542,0.055208,172.31.36.0-255,66,273149,8,307973
46543,0.057525,74.125.24.0-255,5738,278887,8,307973
46544,0.057532,172.31.36.0-255,66,278953,8,307973
46545,0.059851,74.125.24.0-255,5738,284691,8,307973
46546,0.059857,172.31.36.0-255,66,284757,8,307973
46547,0.062162,74.125.24.0-255,5738,290495,8,307973
46548,0.062168,172.31.36.0-255,66,290561,8,307973
46549,0.064472,74.125.24.0-255,5738,296299,8,307973
46550,0.064479,172.31.36.0-255,66,296365,8,307973
46551,0.066754,74.125.24.0-255,5738,302103,8,307973
46552,0.06676,172.31.36.0-255,66,302169,8,307973
46553,0.069031,74.125.24.0-255,5738,307907,8,307973
46554,0.069037,172.31.36.0-255,66,307973,8,307973
46555,0.0,172.217.194.0-255,153,153,8,205034
46556,2.7e-05,172.31.36.0-255,66,219,8,205034
46557,3.3e-05,172.217.194.0-255,1484,1703,8,205034
46558,3.7e-05,172.31.36.0-255,66,1769,8,205034
46559,5e-05,172.217.194.0-255,2902,4671,8,205034
46560,5.3e-05,172.31.36.0-255,66,4737,8,205034
46561,8.5e-05,172.217.194.0-255,4320,9057,8,205034
46562,8.9e-05,172.31.36.0-255,66,9123,8,205034
46563,0.000121,172.217.194.0-255,4874,13997,8,205034
46564,0.000125,172.31.36.0-255,66,14063,8,205034
46565,0.000141,172.217.194.0-255,4320,18383,8,205034
46566,0.000147,172.31.36.0-255,66,18449,8,205034
46567,0.00017,172.217.194.0-255,1484,19933,8,205034
46568,0.000172,172.31.36.0-255,66,19999,8,205034
46569,0.000179,172.217.194.0-255,7156,27155,8,205034
46570,0.000182,172.31.36.0-255,66,27221,8,205034
46571,0.000208,172.217.194.0-255,3961,31182,8,205034
46572,0.000212,172.31.36.0-255,66,31248,8,205034
46573,0.000236,172.217.194.0-255,4320,35568,8,205034
46574,0.00024,172.31.36.0-255,66,35634,8,205034
46575,0.000246,172.217.194.0-255,5738,41372,8,205034
46576,0.000248,172.31.36.0-255,66,41438,8,205034
46577,0.000278,172.217.194.0-255,4320,45758,8,205034
46578,0.000281,172.31.36.0-255,66,45824,8,205034
46579,0.000286,172.217.194.0-255,2543,48367,8,205034
46580,0.000289,172.31.36.0-255,66,48433,8,205034
46581,0.00095,172.217.194.0-255,1484,49917,8,205034
46582,0.000956,172.31.36.0-255,66,49983,8,205034
46583,0.000966,172.217.194.0-255,2902,52885,8,205034
46584,0.000968,172.31.36.0-255,66,52951,8,205034
46585,0.000981,172.217.194.0-255,5738,58689,8,205034
46586,0.000984,172.31.36.0-255,66,58755,8,205034
46587,0.000991,172.217.194.0-255,6797,65552,8,205034
46588,0.000993,172.31.36.0-255,66,65618,8,205034
46589,0.000997,172.217.194.0-255,646,66264,8,205034
46590,0.001569,172.217.194.0-255,1484,67748,8,205034
46591,0.001574,172.31.36.0-255,66,67814,8,205034
46592,0.001594,172.217.194.0-255,2902,70716,8,205034
46593,0.001596,172.31.36.0-255,66,70782,8,205034
46594,0.001602,172.217.194.0-255,5738,76520,8,205034
46595,0.001604,172.31.36.0-255,66,76586,8,205034
46596,0.001614,172.31.36.0-255,66,76652,8,205034
46597,0.001647,172.217.194.0-255,4320,80972,8,205034
46598,0.00165,172.31.36.0-255,66,81038,8,205034
46599,0.00166,172.31.36.0-255,66,81104,8,205034
46600,0.001663,172.217.194.0-255,766,81870,8,205034
46601,0.002238,172.217.194.0-255,1484,83354,8,205034
46602,0.002241,172.31.36.0-255,66,83420,8,205034
46603,0.002265,172.217.194.0-255,2902,86322,8,205034
46604,0.002267,172.31.36.0-255,66,86388,8,205034
46605,0.002273,172.217.194.0-255,5738,92126,8,205034
46606,0.002276,172.31.36.0-255,66,92192,8,205034
46607,0.002279,172.217.194.0-255,1484,93676,8,205034
46608,0.002309,172.31.36.0-255,66,93742,8,205034
46609,0.002334,172.217.194.0-255,4320,98062,8,205034
46610,0.002338,172.31.36.0-255,66,98128,8,205034
46611,0.002374,172.31.36.0-255,66,98194,8,205034
46612,0.002396,172.217.194.0-255,1484,99678,8,205034
46613,0.002399,172.217.194.0-255,1484,101162,8,205034
46614,0.002401,172.31.36.0-255,66,101228,8,205034
46615,0.002425,172.217.194.0-255,1484,102712,8,205034
46616,0.002431,172.217.194.0-255,5738,108450,8,205034
46617,0.002433,172.31.36.0-255,66,108516,8,205034
46618,0.00244,172.217.194.0-255,7156,115672,8,205034
46619,0.002442,172.31.36.0-255,66,115738,8,205034
46620,0.002447,172.217.194.0-255,5738,121476,8,205034
46621,0.002449,172.31.36.0-255,66,121542,8,205034
46622,0.002452,172.217.194.0-255,1484,123026,8,205034
46623,0.002486,172.31.36.0-255,66,123092,8,205034
46624,0.002525,172.217.194.0-255,5738,128830,8,205034
46625,0.00254,172.217.194.0-255,1484,130314,8,205034
46626,0.00259,172.217.194.0-255,766,131080,8,205034
46627,0.002716,172.31.36.0-255,66,131146,8,205034
46628,0.002847,172.217.194.0-255,1484,132630,8,205034
46629,0.002852,172.217.194.0-255,2902,135532,8,205034
46630,0.002862,172.217.194.0-255,1484,137016,8,205034
46631,0.002868,172.31.36.0-255,66,137082,8,205034
46632,0.002879,172.217.194.0-255,4320,141402,8,205034
46633,0.002888,172.31.36.0-255,66,141468,8,205034
46634,0.002907,172.31.36.0-255,66,141534,8,205034
46635,0.002921,172.217.194.0-255,2902,144436,8,205034
46636,0.002933,172.31.36.0-255,66,144502,8,205034
46637,0.002961,172.31.36.0-255,66,144568,8,205034
46638,0.003034,172.31.36.0-255,66,144634,8,205034
46639,0.003039,172.31.36.0-255,66,144700,8,205034
46640,0.003087,172.31.36.0-255,66,144766,8,205034
46641,0.003126,172.217.194.0-255,2902,147668,8,205034
46642,0.00313,172.31.36.0-255,66,147734,8,205034
46643,0.003173,172.31.36.0-255,66,147800,8,205034
46644,0.003179,172.217.194.0-255,1484,149284,8,205034
46645,0.003188,172.31.36.0-255,66,149350,8,205034
46646,0.003215,172.31.36.0-255,66,149416,8,205034
46647,0.003275,172.217.194.0-255,1484,150900,8,205034
46648,0.003281,172.217.194.0-255,2902,153802,8,205034
46649,0.003291,172.31.36.0-255,66,153868,8,205034
46650,0.003321,172.217.194.0-255,5738,159606,8,205034
46651,0.003325,172.31.36.0-255,66,159672,8,205034
46652,0.003346,172.31.36.0-255,66,159738,8,205034
46653,0.003381,172.217.194.0-255,2902,162640,8,205034
46654,0.003389,172.31.36.0-255,66,162706,8,205034
46655,0.003427,172.31.36.0-255,66,162772,8,205034
46656,0.003533,172.217.194.0-255,1484,164256,8,205034
46657,0.003539,172.217.194.0-255,2902,167158,8,205034
46658,0.003542,172.31.36.0-255,66,167224,8,205034
46659,0.00355,172.217.194.0-255,5738,172962,8,205034
46660,0.003561,172.31.36.0-255,66,173028,8,205034
46661,0.003574,172.217.194.0-255,5738,178766,8,205034
46662,0.003586,172.31.36.0-255,66,178832,8,205034
46663,0.0036,172.217.194.0-255,2902,181734,8,205034
46664,0.003612,172.31.36.0-255,66,181800,8,205034
46665,0.003625,172.217.194.0-255,7156,188956,8,205034
46666,0.003637,172.31.36.0-255,66,189022,8,205034
46667,0.003659,172.31.36.0-255,66,189088,8,205034
46668,0.003687,172.31.36.0-255,66,189154,8,205034
46669,0.003705,172.217.194.0-255,2902,192056,8,205034
46670,0.003709,172.217.194.0-255,1484,193540,8,205034
46671,0.00371,172.31.36.0-255,66,193606,8,205034
46672,0.003743,172.31.36.0-255,66,193672,8,205034
46673,0.003759,172.217.194.0-255,5020,198692,8,205034
46674,0.003762,172.217.194.0-255,1484,200176,8,205034
46675,0.003768,172.31.36.0-255,66,200242,8,205034
46676,0.003797,172.217.194.0-255,105,200347,8,205034
46677,0.003802,172.31.36.0-255,66,200413,8,205034
46678,0.004323,172.31.36.0-255,101,200514,8,205034
46679,0.005656,172.31.36.0-255,105,200619,8,205034
46680,0.006597,172.217.194.0-255,66,200685,8,205034
46681,0.007896,172.217.194.0-255,66,200751,8,205034
46682,0.023598,172.31.36.0-255,167,200918,8,205034
46683,0.023634,172.31.36.0-255,1112,202030,8,205034
46684,0.023674,172.31.36.0-255,1514,203544,8,205034
46685,0.023675,172.31.36.0-255,1292,204836,8,205034
46686,0.025149,104.244.42.0-255,66,204902,8,205034
46687,0.025346,104.244.42.0-255,66,204968,8,205034
46688,0.025348,104.244.42.0-255,66,205034,8,205034
46689,0.0,74.125.68.0-255,153,153,8,290442
46690,2.7e-05,172.31.36.0-255,66,219,8,290442
46691,4.7e-05,74.125.68.0-255,1484,1703,8,290442
46692,5.1e-05,172.31.36.0-255,66,1769,8,290442
46693,5.6e-05,74.125.68.0-255,2902,4671,8,290442
46694,5.8e-05,172.31.36.0-255,66,4737,8,290442
46695,6.1e-05,74.125.68.0-255,1484,6221,8,290442
46696,6.4e-05,172.31.36.0-255,66,6287,8,290442
46697,9.2e-05,74.125.68.0-255,4320,10607,8,290442
46698,9.6e-05,172.31.36.0-255,66,10673,8,290442
46699,9.9e-05,74.125.68.0-255,1484,12157,8,290442
46700,0.000101,172.31.36.0-255,66,12223,8,290442
46701,0.000128,74.125.68.0-255,1484,13707,8,290442
46702,0.00013,172.31.36.0-255,66,13773,8,290442
46703,0.000165,74.125.68.0-255,2054,15827,8,290442
46704,0.000168,172.31.36.0-255,66,15893,8,290442
46705,0.000173,74.125.68.0-255,4320,20213,8,290442
46706,0.000176,172.31.36.0-255,66,20279,8,290442
46707,0.000191,74.125.68.0-255,1484,21763,8,290442
46708,0.000193,172.31.36.0-255,66,21829,8,290442
46709,0.000197,74.125.68.0-255,2902,24731,8,290442
46710,0.0002,172.31.36.0-255,66,24797,8,290442
46711,0.000204,74.125.68.0-255,4320,29117,8,290442
46712,0.000207,172.31.36.0-255,66,29183,8,290442
46713,0.000242,74.125.68.0-255,2543,31726,8,290442
46714,0.000244,172.31.36.0-255,66,31792,8,290442
46715,0.000313,74.125.68.0-255,1484,33276,8,290442
46716,0.000318,172.31.36.0-255,66,33342,8,290442
46717,0.000326,74.125.68.0-255,2902,36244,8,290442
46718,0.000329,172.31.36.0-255,66,36310,8,290442
46719,0.000356,74.125.68.0-255,2902,39212,8,290442
46720,0.000359,172.31.36.0-255,66,39278,8,290442
46721,0.000364,74.125.68.0-255,4320,43598,8,290442
46722,0.000367,74.125.68.0-255,1484,45082,8,290442
46723,0.000379,172.31.36.0-255,66,45148,8,290442
46724,0.000391,74.125.68.0-255,7156,52304,8,290442
46725,0.000395,74.125.68.0-255,2902,55206,8,290442
46726,0.000399,74.125.68.0-255,2902,58108,8,290442
46727,0.000399,172.31.36.0-255,66,58174,8,290442
46728,0.000405,172.31.36.0-255,66,58240,8,290442
46729,0.000416,74.125.68.0-255,1484,59724,8,290442
46730,0.000448,74.125.68.0-255,4320,64044,8,290442
46731,0.000458,172.31.36.0-255,66,64110,8,290442
46732,0.000464,74.125.68.0-255,2184,66294,8,290442
46733,0.000466,172.31.36.0-255,66,66360,8,290442
46734,0.000476,74.125.68.0-255,401,66761,8,290442
46735,0.000513,74.125.68.0-255,110,66871,8,290442
46736,0.000602,74.125.68.0-255,1484,68355,8,290442
46737,0.000617,172.31.36.0-255,66,68421,8,290442
46738,0.000635,74.125.68.0-255,2902,71323,8,290442
46739,0.000642,172.31.36.0-255,66,71389,8,290442
46740,0.000713,74.125.68.0-255,1484,72873,8,290442
46741,0.000786,74.125.68.0-255,1484,74357,8,290442
46742,0.00079,172.31.36.0-255,66,74423,8,290442
46743,0.000803,74.125.68.0-255,1484,75907,8,290442
46744,0.000816,74.125.68.0-255,2902,78809,8,290442
46745,0.00082,172.31.36.0-255,66,78875,8,290442
46746,0.000835,74.125.68.0-255,1484,80359,8,290442
46747,0.00085,74.125.68.0-255,4320,84679,8,290442
46748,0.000853,172.31.36.0-255,66,84745,8,290442
46749,0.000857,74.125.68.0-255,1484,86229,8,290442
46750,0.00087,74.125.68.0-255,2902,89131,8,290442
46751,0.000887,172.31.36.0-255,66,89197,8,290442
46752,0.00091,74.125.68.0-255,5738,94935,8,290442
46753,0.000919,172.31.36.0-255,66,95001,8,290442
46754,0.000958,74.125.68.0-255,4320,99321,8,290442
46755,0.000966,172.31.36.0-255,66,99387,8,290442
46756,0.001013,74.125.68.0-255,2184,101571,8,290442
46757,0.001016,172.31.36.0-255,66,101637,8,290442
46758,0.001553,74.125.68.0-255,1484,103121,8,290442
46759,0.001577,74.125.68.0-255,1484,104605,8,290442
46760,0.001582,172.31.36.0-255,66,104671,8,290442
46761,0.001615,74.125.68.0-255,1484,106155,8,290442
46762,0.00162,74.125.68.0-255,2902,109057,8,290442
46763,0.00166,74.125.68.0-255,2902,111959,8,290442
46764,0.001678,74.125.68.0-255,2902,114861,8,290442
46765,0.001681,74.125.68.0-255,1484,116345,8,290442
46766,0.001727,74.125.68.0-255,2902,119247,8,290442
46767,0.00173,74.125.68.0-255,1484,120731,8,290442
46768,0.001767,74.125.68.0-255,2902,123633,8,290442
46769,0.001834,74.125.68.0-255,1484,125117,8,290442
46770,0.001899,74.125.68.0-255,1484,126601,8,290442
46771,0.001924,74.125.68.0-255,1484,128085,8,290442
46772,0.001955,74.125.68.0-255,2902,130987,8,290442
46773,0.001989,74.125.68.0-255,2902,133889,8,290442
46774,0.002037,74.125.68.0-255,2184,136073,8,290442
46775,0.002419,74.125.68.0-255,1484,137557,8,290442
46776,0.002422,74.125.68.0-255,1484,139041,8,290442
46777,0.002437,74.125.68.0-255,1484,140525,8,290442
46778,0.00244,74.125.68.0-255,1484,142009,8,290442
46779,0.002565,74.125.68.0-255,1484,143493,8,290442
46780,0.002596,74.125.68.0-255,1484,144977,8,290442
46781,0.003685,172.31.36.0-255,66,145043,8,290442
46782,0.0063,74.125.68.0-255,4320,149363,8,290442
46783,0.006305,172.31.36.0-255,66,149429,8,290442
46784,0.00633,74.125.68.0-255,1484,150913,8,290442
46785,0.008903,74.125.68.0-255,4320,155233,8,290442
46786,0.008911,172.31.36.0-255,66,155299,8,290442
46787,0.01153,74.125.68.0-255,5738,161037,8,290442
46788,0.011767,172.31.36.0-255,66,161103,8,290442
46789,0.0144,74.125.68.0-255,5738,166841,8,290442
46790,0.01441,172.31.36.0-255,66,166907,8,290442
46791,0.017025,74.125.68.0-255,5738,172645,8,290442
46792,0.017033,172.31.36.0-255,66,172711,8,290442
46793,0.019653,74.125.68.0-255,5738,178449,8,290442
46794,0.019661,172.31.36.0-255,66,178515,8,290442
46795,0.022273,74.125.68.0-255,5738,184253,8,290442
46796,0.022281,172.31.36.0-255,66,184319,8,290442
46797,0.024925,74.125.68.0-255,5738,190057,8,290442
46798,0.024933,172.31.36.0-255,66,190123,8,290442
46799,0.026352,172.31.36.0-255,172,190295,8,290442
46800,0.02638,172.31.36.0-255,1112,191407,8,290442
46801,0.026428,172.31.36.0-255,1514,192921,8,290442
46802,0.026429,172.31.36.0-255,1293,194214,8,290442
46803,0.027537,74.125.68.0-255,5738,199952,8,290442
46804,0.027544,172.31.36.0-255,66,200018,8,290442
46805,0.027882,104.244.42.0-255,66,200084,8,290442
46806,0.02789,104.244.42.0-255,66,200150,8,290442
46807,0.027993,104.244.42.0-255,66,200216,8,290442
46808,0.030148,74.125.68.0-255,5738,205954,8,290442
46809,0.030153,172.31.36.0-255,66,206020,8,290442
46810,0.032751,74.125.68.0-255,5738,211758,8,290442
46811,0.032756,172.31.36.0-255,66,211824,8,290442
46812,0.035357,74.125.68.0-255,1484,213308,8,290442
46813,0.035395,74.125.68.0-255,4320,217628,8,290442
46814,0.0354,172.31.36.0-255,66,217694,8,290442
46815,0.038003,74.125.68.0-255,5738,223432,8,290442
46816,0.038008,172.31.36.0-255,66,223498,8,290442
46817,0.040615,74.125.68.0-255,5738,229236,8,290442
46818,0.040622,172.31.36.0-255,66,229302,8,290442
46819,0.043227,74.125.68.0-255,5738,235040,8,290442
46820,0.043232,172.31.36.0-255,66,235106,8,290442
46821,0.045829,74.125.68.0-255,5738,240844,8,290442
46822,0.045834,172.31.36.0-255,66,240910,8,290442
46823,0.048423,74.125.68.0-255,4320,245230,8,290442
46824,0.048428,172.31.36.0-255,66,245296,8,290442
46825,0.048457,74.125.68.0-255,1484,246780,8,290442
46826,0.051033,74.125.68.0-255,4320,251100,8,290442
46827,0.05104,172.31.36.0-255,66,251166,8,290442
46828,0.053638,74.125.68.0-255,5738,256904,8,290442
46829,0.0537,172.31.36.0-255,66,256970,8,290442
46830,0.056298,74.125.68.0-255,4320,261290,8,290442
46831,0.056305,172.31.36.0-255,66,261356,8,290442
46832,0.056335,74.125.68.0-255,1484,262840,8,290442
46833,0.058896,74.125.68.0-255,4320,267160,8,290442
46834,0.058902,172.31.36.0-255,66,267226,8,290442
46835,0.061502,74.125.68.0-255,5738,272964,8,290442
46836,0.061563,172.31.36.0-255,66,273030,8,290442
46837,0.064164,74.125.68.0-255,5738,278768,8,290442
46838,0.064169,172.31.36.0-255,66,278834,8,290442
46839,0.06677,74.125.68.0-255,5738,284572,8,290442
46840,0.066775,172.31.36.0-255,66,284638,8,290442
46841,0.069372,74.125.68.0-255,5738,290376,8,290442
46842,0.069377,172.31.36.0-255,66,290442,8,290442
46843,0.0,172.217.194.0-255,156,156,8,262598
46844,1.6e-05,172.31.36.0-255,66,222,8,262598
46845,2.3e-05,172.217.194.0-255,1484,1706,8,262598
46846,2.7e-05,172.31.36.0-255,66,1772,8,262598
46847,3.2e-05,172.217.194.0-255,2902,4674,8,262598
46848,3.6e-05,172.31.36.0-255,66,4740,8,262598
46849,4e-05,172.217.194.0-255,2902,7642,8,262598
46850,4.3e-05,172.31.36.0-255,66,7708,8,262598
46851,6.9e-05,172.217.194.0-255,2902,10610,8,262598
46852,7.3e-05,172.31.36.0-255,66,10676,8,262598
46853,9.6e-05,172.217.194.0-255,3494,14170,8,262598
46854,9.9e-05,172.31.36.0-255,66,14236,8,262598
46855,0.000104,172.217.194.0-255,4320,18556,8,262598
46856,0.000107,172.31.36.0-255,66,18622,8,262598
46857,0.000141,172.31.36.0-255,66,18688,8,262598
46858,0.000147,172.217.194.0-255,4320,23008,8,262598
46859,0.000149,172.31.36.0-255,66,23074,8,262598
46860,0.000194,172.217.194.0-255,4320,27394,8,262598
46861,0.000198,172.31.36.0-255,66,27460,8,262598
46862,0.000228,172.31.36.0-255,66,27526,8,262598
46863,0.000686,172.217.194.0-255,1484,29010,8,262598
46864,0.000692,172.31.36.0-255,66,29076,8,262598
46865,0.000698,172.217.194.0-255,2902,31978,8,262598
46866,0.0007,172.31.36.0-255,66,32044,8,262598
46867,0.000717,172.217.194.0-255,4320,36364,8,262598
46868,0.00072,172.31.36.0-255,66,36430,8,262598
46869,0.00074,172.217.194.0-255,1484,37914,8,262598
46870,0.000743,172.31.36.0-255,66,37980,8,262598
46871,0.000764,172.217.194.0-255,2902,40882,8,262598
46872,0.000766,172.31.36.0-255,66,40948,8,262598
46873,0.000786,172.217.194.0-255,4213,45161,8,262598
46874,0.00079,172.217.194.0-255,120,45281,8,262598
46875,0.000792,172.217.194.0-255,379,45660,8,262598
46876,0.000798,172.31.36.0-255,66,45726,8,262598
46877,0.00104,172.217.194.0-255,1484,47210,8,262598
46878,0.001046,172.217.194.0-255,2902,50112,8,262598
46879,0.001049,172.31.36.0-255,66,50178,8,262598
46880,0.001075,172.217.194.0-255,5738,55916,8,262598
46881,0.001081,172.217.194.0-255,4320,60236,8,262598
46882,0.001085,172.31.36.0-255,66,60302,8,262598
46883,0.001125,172.31.36.0-255,66,60368,8,262598
46884,0.001136,172.217.194.0-255,1484,61852,8,262598
46885,0.001175,172.31.36.0-255,66,61918,8,262598
46886,0.003153,172.217.194.0-255,5738,67656,8,262598
46887,0.003164,172.31.36.0-255,66,67722,8,262598
46888,0.005128,172.217.194.0-255,5738,73460,8,262598
46889,0.008046,172.31.36.0-255,66,73526,8,262598
46890,0.010023,172.217.194.0-255,5738,79264,8,262598
46891,0.010032,172.31.36.0-255,66,79330,8,262598
46892,0.012001,172.217.194.0-255,5738,85068,8,262598
46893,0.012013,172.31.36.0-255,66,85134,8,262598
46894,0.013978,172.217.194.0-255,5738,90872,8,262598
46895,0.013988,172.31.36.0-255,66,90938,8,262598
46896,0.015984,172.217.194.0-255,5738,96676,8,262598
46897,0.015997,172.31.36.0-255,66,96742,8,262598
46898,0.017939,172.217.194.0-255,5738,102480,8,262598
46899,0.017947,172.31.36.0-255,66,102546,8,262598
46900,0.019915,172.217.194.0-255,5738,108284,8,262598
46901,0.019934,172.31.36.0-255,66,108350,8,262598
46902,0.021921,172.217.194.0-255,5738,114088,8,262598
46903,0.021928,172.31.36.0-255,66,114154,8,262598
46904,0.023873,172.217.194.0-255,5738,119892,8,262598
46905,0.023884,172.31.36.0-255,66,119958,8,262598
46906,0.025837,172.217.194.0-255,5738,125696,8,262598
46907,0.025847,172.31.36.0-255,66,125762,8,262598
46908,0.027813,172.217.194.0-255,5738,131500,8,262598
46909,0.027821,172.31.36.0-255,66,131566,8,262598
46910,0.02978,172.217.194.0-255,5738,137304,8,262598
46911,0.029789,172.31.36.0-255,66,137370,8,262598
46912,0.031771,172.217.194.0-255,5738,143108,8,262598
46913,0.03178,172.31.36.0-255,66,143174,8,262598
46914,0.033757,172.217.194.0-255,5738,148912,8,262598
46915,0.033764,172.31.36.0-255,66,148978,8,262598
46916,0.035733,172.217.194.0-255,5738,154716,8,262598
46917,0.035745,172.31.36.0-255,66,154782,8,262598
46918,0.037724,172.217.194.0-255,5738,160520,8,262598
46919,0.037731,172.31.36.0-255,66,160586,8,262598
46920,0.039694,172.217.194.0-255,5738,166324,8,262598
46921,0.040008,172.31.36.0-255,66,166390,8,262598
46922,0.040337,172.31.36.0-255,172,166562,8,262598
46923,0.040362,172.31.36.0-255,1111,167673,8,262598
46924,0.040418,172.31.36.0-255,1514,169187,8,262598
46925,0.04042,172.31.36.0-255,1514,170701,8,262598
46926,0.040421,172.31.36.0-255,1514,172215,8,262598
46927,0.040446,172.31.36.0-255,773,172988,8,262598
46928,0.041904,104.244.42.0-255,66,173054,8,262598
46929,0.041911,104.244.42.0-255,66,173120,8,262598
46930,0.041964,172.217.194.0-255,2902,176022,8,262598
46931,0.041967,172.31.36.0-255,66,176088,8,262598
46932,0.042003,172.217.194.0-255,2902,178990,8,262598
46933,0.042008,104.244.42.0-255,66,179056,8,262598
46934,0.042012,104.244.42.0-255,66,179122,8,262598
46935,0.042025,172.31.36.0-255,66,179188,8,262598
46936,0.042712,104.244.42.0-255,108,179296,8,262598
46937,0.042718,172.31.36.0-255,66,179362,8,262598
46938,0.043936,172.217.194.0-255,2902,182264,8,262598
46939,0.043941,172.31.36.0-255,66,182330,8,262598
46940,0.043983,172.217.194.0-255,2902,185232,8,262598
46941,0.044012,172.31.36.0-255,66,185298,8,262598
46942,0.045911,172.217.194.0-255,2902,188200,8,262598
46943,0.045917,172.31.36.0-255,66,188266,8,262598
46944,0.045934,172.217.194.0-255,1484,189750,8,262598
46945,0.045945,172.217.194.0-255,1484,191234,8,262598
46946,0.045967,172.31.36.0-255,66,191300,8,262598
46947,0.047868,172.217.194.0-255,2902,194202,8,262598
46948,0.047875,172.31.36.0-255,66,194268,8,262598
46949,0.047907,172.217.194.0-255,2902,197170,8,262598
46950,0.047936,172.31.36.0-255,66,197236,8,262598
46951,0.049834,172.217.194.0-255,2902,200138,8,262598
46952,0.04984,172.31.36.0-255,66,200204,8,262598
46953,0.049883,172.217.194.0-255,2902,203106,8,262598
46954,0.0499,172.31.36.0-255,66,203172,8,262598
46955,0.051784,172.217.194.0-255,2902,206074,8,262598
46956,0.051793,172.31.36.0-255,66,206140,8,262598
46957,0.051846,172.217.194.0-255,2902,209042,8,262598
46958,0.051857,172.31.36.0-255,66,209108,8,262598
46959,0.053779,172.217.194.0-255,2902,212010,8,262598
46960,0.053785,172.31.36.0-255,66,212076,8,262598
46961,0.053823,172.217.194.0-255,2902,214978,8,262598
46962,0.053839,172.31.36.0-255,66,215044,8,262598
46963,0.055741,172.217.194.0-255,2902,217946,8,262598
46964,0.055746,172.31.36.0-255,66,218012,8,262598
46965,0.055775,172.217.194.0-255,1484,219496,8,262598
46966,0.055787,172.217.194.0-255,1484,220980,8,262598
46967,0.055796,172.31.36.0-255,66,221046,8,262598
46968,0.057721,172.217.194.0-255,2902,223948,8,262598
46969,0.057726,172.31.36.0-255,66,224014,8,262598
46970,0.057785,172.217.194.0-255,2902,226916,8,262598
46971,0.057806,172.31.36.0-255,66,226982,8,262598
46972,0.059681,172.217.194.0-255,2902,229884,8,262598
46973,0.059686,172.31.36.0-255,66,229950,8,262598
46974,0.059767,172.217.194.0-255,2902,232852,8,262598
46975,0.059776,172.31.36.0-255,66,232918,8,262598
46976,0.061656,172.217.194.0-255,2902,235820,8,262598
46977,0.061662,172.31.36.0-255,66,235886,8,262598
46978,0.061742,172.217.194.0-255,2902,238788,8,262598
46979,0.061773,172.31.36.0-255,66,238854,8,262598
46980,0.063642,172.217.194.0-255,2902,241756,8,262598
46981,0.063648,172.31.36.0-255,66,241822,8,262598
46982,0.06372,172.217.194.0-255,2902,244724,8,262598
46983,0.063731,172.31.36.0-255,66,244790,8,262598
46984,0.065599,172.217.194.0-255,2902,247692,8,262598
46985,0.065606,172.31.36.0-255,66,247758,8,262598
46986,0.065666,172.217.194.0-255,2902,250660,8,262598
46987,0.065713,172.31.36.0-255,66,250726,8,262598
46988,0.067555,172.217.194.0-255,2902,253628,8,262598
46989,0.06756,172.31.36.0-255,66,253694,8,262598
46990,0.067685,172.217.194.0-255,2902,256596,8,262598
46991,0.06769,172.31.36.0-255,66,256662,8,262598
46992,0.06951,172.217.194.0-255,2902,259564,8,262598
46993,0.069516,172.31.36.0-255,66,259630,8,262598
46994,0.069674,172.217.194.0-255,2902,262532,8,262598
46995,0.06968,172.31.36.0-255,66,262598,8,262598
46996,0.0,74.125.200.0-255,150,150,8,314530
46997,3.2e-05,172.31.36.0-255,66,216,8,314530
46998,3.9e-05,74.125.200.0-255,1484,1700,8,314530
46999,4.3e-05,172.31.36.0-255,66,1766,8,314530
47000,4.6e-05,74.125.200.0-255,1484,3250,8,314530
47001,4.9e-05,172.31.36.0-255,66,3316,8,314530
47002,5.4e-05,74.125.200.0-255,2902,6218,8,314530
47003,5.7e-05,172.31.36.0-255,66,6284,8,314530
47004,9.2e-05,74.125.200.0-255,5738,12022,8,314530
47005,9.5e-05,172.31.36.0-255,66,12088,8,314530
47006,0.000115,74.125.200.0-255,2039,14127,8,314530
47007,0.000117,172.31.36.0-255,66,14193,8,314530
47008,0.00014,74.125.200.0-255,1484,15677,8,314530
47009,0.000143,172.31.36.0-255,66,15743,8,314530
47010,0.000163,74.125.200.0-255,2902,18645,8,314530
47011,0.000166,172.31.36.0-255,66,18711,8,314530
47012,0.000178,74.125.200.0-255,1484,20195,8,314530
47013,0.00018,172.31.36.0-255,66,20261,8,314530
47014,0.0002,74.125.200.0-255,4320,24581,8,314530
47015,0.000203,172.31.36.0-255,66,24647,8,314530
47016,0.000206,74.125.200.0-255,1484,26131,8,314530
47017,0.000207,172.31.36.0-255,66,26197,8,314530
47018,0.000243,74.125.200.0-255,1484,27681,8,314530
47019,0.000246,172.31.36.0-255,66,27747,8,314530
47020,0.00028,74.125.200.0-255,3961,31708,8,314530
47021,0.000284,172.31.36.0-255,66,31774,8,314530
47022,0.000443,74.125.200.0-255,1484,33258,8,314530
47023,0.000448,172.31.36.0-255,66,33324,8,314530
47024,0.000453,74.125.200.0-255,2902,36226,8,314530
47025,0.000455,172.31.36.0-255,66,36292,8,314530
47026,0.000473,74.125.200.0-255,5738,42030,8,314530
47027,0.000476,172.31.36.0-255,66,42096,8,314530
47028,0.000518,74.125.200.0-255,5738,47834,8,314530
47029,0.000522,172.31.36.0-255,66,47900,8,314530
47030,0.000541,74.125.200.0-255,3961,51861,8,314530
47031,0.000544,172.31.36.0-255,66,51927,8,314530
47032,0.000551,74.125.200.0-255,7156,59083,8,314530
47033,0.000554,172.31.36.0-255,66,59149,8,314530
47034,0.000569,74.125.200.0-255,2902,62051,8,314530
47035,0.000572,172.31.36.0-255,66,62117,8,314530
47036,0.000578,74.125.200.0-255,3961,66078,8,314530
47037,0.00058,172.31.36.0-255,66,66144,8,314530
47038,0.001125,74.125.200.0-255,647,66791,8,314530
47039,0.00128,74.125.200.0-255,1484,68275,8,314530
47040,0.001285,172.31.36.0-255,66,68341,8,314530
47041,0.00129,74.125.200.0-255,1484,69825,8,314530
47042,0.001305,74.125.200.0-255,1484,71309,8,314530
47043,0.001307,172.31.36.0-255,66,71375,8,314530
47044,0.00131,74.125.200.0-255,1484,72859,8,314530
47045,0.001313,74.125.200.0-255,1484,74343,8,314530
47046,0.001314,172.31.36.0-255,66,74409,8,314530
47047,0.001327,74.125.200.0-255,1484,75893,8,314530
47048,0.001333,74.125.200.0-255,2902,78795,8,314530
47049,0.001336,172.31.36.0-255,66,78861,8,314530
47050,0.001359,74.125.200.0-255,2902,81763,8,314530
47051,0.001362,172.31.36.0-255,66,81829,8,314530
47052,0.001369,74.125.200.0-255,5738,87567,8,314530
47053,0.00137,172.31.36.0-255,66,87633,8,314530
47054,0.001384,74.125.200.0-255,2902,90535,8,314530
47055,0.001386,172.31.36.0-255,66,90601,8,314530
47056,0.001393,74.125.200.0-255,7156,97757,8,314530
47057,0.001395,172.31.36.0-255,66,97823,8,314530
47058,0.001418,74.125.200.0-255,2902,100725,8,314530
47059,0.00142,74.125.200.0-255,766,101491,8,314530
47060,0.001422,172.31.36.0-255,66,101557,8,314530
47061,0.001604,172.31.36.0-255,66,101623,8,314530
47062,0.003299,74.125.200.0-255,1484,103107,8,314530
47063,0.003335,74.125.200.0-255,2902,106009,8,314530
47064,0.00334,172.31.36.0-255,66,106075,8,314530
47065,0.003508,74.125.200.0-255,1484,107559,8,314530
47066,0.005253,74.125.200.0-255,4320,111879,8,314530
47067,0.005257,172.31.36.0-255,66,111945,8,314530
47068,0.007173,74.125.200.0-255,5738,117683,8,314530
47069,0.007179,172.31.36.0-255,66,117749,8,314530
47070,0.009127,74.125.200.0-255,5738,123487,8,314530
47071,0.009134,172.31.36.0-255,66,123553,8,314530
47072,0.011047,74.125.200.0-255,5738,129291,8,314530
47073,0.011053,172.31.36.0-255,66,129357,8,314530
47074,0.013006,74.125.200.0-255,5738,135095,8,314530
47075,0.013013,172.31.36.0-255,66,135161,8,314530
47076,0.015041,74.125.200.0-255,5738,140899,8,314530
47077,0.015049,172.31.36.0-255,66,140965,8,314530
47078,0.016965,74.125.200.0-255,5738,146703,8,314530
47079,0.016971,172.31.36.0-255,66,146769,8,314530
47080,0.018888,74.125.200.0-255,5738,152507,8,314530
47081,0.018895,172.31.36.0-255,66,152573,8,314530
47082,0.020808,74.125.200.0-255,5738,158311,8,314530
47083,0.020816,172.31.36.0-255,66,158377,8,314530
47084,0.020888,172.31.36.0-255,172,158549,8,314530
47085,0.020935,172.31.36.0-255,1110,159659,8,314530
47086,0.021017,172.31.36.0-255,1514,161173,8,314530
47087,0.02102,172.31.36.0-255,1514,162687,8,314530
47088,0.021024,172.31.36.0-255,1514,164201,8,314530
47089,0.021025,172.31.36.0-255,1514,165715,8,314530
47090,0.021053,172.31.36.0-255,1514,167229,8,314530
47091,0.021055,172.31.36.0-255,995,168224,8,314530
47092,0.022487,104.244.42.0-255,66,168290,8,314530
47093,0.022496,104.244.42.0-255,66,168356,8,314530
47094,0.022588,104.244.42.0-255,66,168422,8,314530
47095,0.022625,104.244.42.0-255,66,168488,8,314530
47096,0.022747,74.125.200.0-255,5738,174226,8,314530
47097,0.022754,172.31.36.0-255,66,174292,8,314530
47098,0.02326,104.244.42.0-255,108,174400,8,314530
47099,0.023275,172.31.36.0-255,66,174466,8,314530
47100,0.024673,74.125.200.0-255,5738,180204,8,314530
47101,0.02468,172.31.36.0-255,66,180270,8,314530
47102,0.026607,74.125.200.0-255,5738,186008,8,314530
47103,0.026614,172.31.36.0-255,66,186074,8,314530
47104,0.028534,74.125.200.0-255,5738,191812,8,314530
47105,0.028541,172.31.36.0-255,66,191878,8,314530
47106,0.03046,74.125.200.0-255,5738,197616,8,314530
47107,0.030468,172.31.36.0-255,66,197682,8,314530
47108,0.032409,74.125.200.0-255,5738,203420,8,314530
47109,0.032417,172.31.36.0-255,66,203486,8,314530
47110,0.034338,74.125.200.0-255,5738,209224,8,314530
47111,0.034348,172.31.36.0-255,66,209290,8,314530
47112,0.036298,74.125.200.0-255,5738,215028,8,314530
47113,0.036307,172.31.36.0-255,66,215094,8,314530
47114,0.038226,74.125.200.0-255,5738,220832,8,314530
47115,0.038232,172.31.36.0-255,66,220898,8,314530
47116,0.038811,172.31.36.0-255,108,221006,8,314530
47117,0.040281,74.125.200.0-255,5738,226744,8,314530
47118,0.040333,172.31.36.0-255,66,226810,8,314530
47119,0.042262,74.125.200.0-255,5738,232548,8,314530
47120,0.042269,172.31.36.0-255,66,232614,8,314530
47121,0.044188,74.125.200.0-255,5738,238352,8,314530
47122,0.044195,172.31.36.0-255,66,238418,8,314530
47123,0.046115,74.125.200.0-255,5738,244156,8,314530
47124,0.046123,172.31.36.0-255,66,244222,8,314530
47125,0.048043,74.125.200.0-255,5738,249960,8,314530
47126,0.048051,172.31.36.0-255,66,250026,8,314530
47127,0.049974,74.125.200.0-255,2902,252928,8,314530
47128,0.04998,172.31.36.0-255,66,252994,8,314530
47129,0.05,74.125.200.0-255,2902,255896,8,314530
47130,0.050003,172.31.36.0-255,66,255962,8,314530
47131,0.051898,74.125.200.0-255,2902,258864,8,314530
47132,0.051903,172.31.36.0-255,66,258930,8,314530
47133,0.051923,74.125.200.0-255,2902,261832,8,314530
47134,0.051926,172.31.36.0-255,66,261898,8,314530
47135,0.053831,74.125.200.0-255,2902,264800,8,314530
47136,0.053838,172.31.36.0-255,66,264866,8,314530
47137,0.053859,74.125.200.0-255,2902,267768,8,314530
47138,0.053862,172.31.36.0-255,66,267834,8,314530
47139,0.055753,74.125.200.0-255,2902,270736,8,314530
47140,0.055758,172.31.36.0-255,66,270802,8,314530
47141,0.055781,74.125.200.0-255,2902,273704,8,314530
47142,0.055784,172.31.36.0-255,66,273770,8,314530
47143,0.057671,74.125.200.0-255,2902,276672,8,314530
47144,0.057677,172.31.36.0-255,66,276738,8,314530
47145,0.057698,74.125.200.0-255,2902,279640,8,314530
47146,0.057701,172.31.36.0-255,66,279706,8,314530
47147,0.059611,74.125.200.0-255,5738,285444,8,314530
47148,0.05962,172.31.36.0-255,66,285510,8,314530
47149,0.061536,74.125.200.0-255,5738,291248,8,314530
47150,0.061545,172.31.36.0-255,66,291314,8,314530
47151,0.063467,74.125.200.0-255,5738,297052,8,314530
47152,0.063475,172.31.36.0-255,66,297118,8,314530
47153,0.065401,74.125.200.0-255,5738,302856,8,314530
47154,0.065409,172.31.36.0-255,66,302922,8,314530
47155,0.067338,74.125.200.0-255,5738,308660,8,314530
47156,0.067346,172.31.36.0-255,66,308726,8,314530
47157,0.069267,74.125.200.0-255,5738,314464,8,314530
47158,0.069275,172.31.36.0-255,66,314530,8,314530
47159,0.0,172.217.194.0-255,153,153,8,186977
47160,1.5e-05,172.31.36.0-255,66,219,8,186977
47161,2.2e-05,172.217.194.0-255,1484,1703,8,186977
47162,2.6e-05,172.31.36.0-255,66,1769,8,186977
47163,3.2e-05,172.217.194.0-255,2902,4671,8,186977
47164,3.5e-05,172.31.36.0-255,66,4737,8,186977
47165,4.4e-05,172.217.194.0-255,7156,11893,8,186977
47166,4.7e-05,172.31.36.0-255,66,11959,8,186977
47167,7e-05,172.217.194.0-255,2902,14861,8,186977
47168,7.2e-05,172.31.36.0-255,66,14927,8,186977
47169,0.00011,172.31.36.0-255,66,14993,8,186977
47170,0.000115,172.217.194.0-255,2543,17536,8,186977
47171,0.000117,172.31.36.0-255,66,17602,8,186977
47172,0.000149,172.31.36.0-255,66,17668,8,186977
47173,0.000177,172.217.194.0-255,2902,20570,8,186977
47174,0.00018,172.31.36.0-255,66,20636,8,186977
47175,0.000202,172.217.194.0-255,3961,24597,8,186977
47176,0.000204,172.31.36.0-255,66,24663,8,186977
47177,0.000349,172.217.194.0-255,1484,26147,8,186977
47178,0.000354,172.31.36.0-255,66,26213,8,186977
47179,0.000359,172.217.194.0-255,2902,29115,8,186977
47180,0.000362,172.31.36.0-255,66,29181,8,186977
47181,0.000368,172.217.194.0-255,5738,34919,8,186977
47182,0.000372,172.31.36.0-255,66,34985,8,186977
47183,0.000378,172.217.194.0-255,5738,40723,8,186977
47184,0.000381,172.31.36.0-255,66,40789,8,186977
47185,0.000423,172.217.194.0-255,1705,42494,8,186977
47186,0.000426,172.31.36.0-255,66,42560,8,186977
47187,0.000451,172.217.194.0-255,2902,45462,8,186977
47188,0.000453,172.31.36.0-255,66,45528,8,186977
47189,0.000471,172.217.194.0-255,2902,48430,8,186977
47190,0.000473,172.31.36.0-255,66,48496,8,186977
47191,0.00049,172.217.194.0-255,4320,52816,8,186977
47192,0.000492,172.31.36.0-255,66,52882,8,186977
47193,0.000495,172.217.194.0-255,1484,54366,8,186977
47194,0.000503,172.217.194.0-255,7156,61522,8,186977
47195,0.000506,172.31.36.0-255,66,61588,8,186977
47196,0.000521,172.217.194.0-255,2902,64490,8,186977
47197,0.000523,172.31.36.0-255,66,64556,8,186977
47198,0.000558,172.31.36.0-255,66,64622,8,186977
47199,0.000589,172.31.36.0-255,66,64688,8,186977
47200,0.000598,172.217.194.0-255,2902,67590,8,186977
47201,0.0006,172.31.36.0-255,66,67656,8,186977
47202,0.000605,172.217.194.0-255,3412,71068,8,186977
47203,0.000608,172.31.36.0-255,66,71134,8,186977
47204,0.000627,172.217.194.0-255,4320,75454,8,186977
47205,0.00063,172.31.36.0-255,66,75520,8,186977
47206,0.000659,172.31.36.0-255,66,75586,8,186977
47207,0.000674,172.31.36.0-255,66,75652,8,186977
47208,0.00072,172.217.194.0-255,1484,77136,8,186977
47209,0.000726,172.217.194.0-255,2902,80038,8,186977
47210,0.000728,172.31.36.0-255,66,80104,8,186977
47211,0.000734,172.217.194.0-255,5738,85842,8,186977
47212,0.000737,172.31.36.0-255,66,85908,8,186977
47213,0.000744,172.217.194.0-255,7156,93064,8,186977
47214,0.000746,172.31.36.0-255,66,93130,8,186977
47215,0.000766,172.217.194.0-255,5738,98868,8,186977
47216,0.000769,172.31.36.0-255,66,98934,8,186977
47217,0.000805,172.31.36.0-255,66,99000,8,186977
47218,0.000822,172.217.194.0-255,4320,103320,8,186977
47219,0.000852,172.217.194.0-255,1484,104804,8,186977
47220,0.000859,172.217.194.0-255,6438,111242,8,186977
47221,0.000863,172.31.36.0-255,66,111308,8,186977
47222,0.000894,172.217.194.0-255,4320,115628,8,186977
47223,0.000912,172.31.36.0-255,66,115694,8,186977
47224,0.000934,172.31.36.0-255,66,115760,8,186977
47225,0.000945,172.217.194.0-255,2902,118662,8,186977
47226,0.000978,172.31.36.0-255,66,118728,8,186977
47227,0.000988,172.217.194.0-255,2543,121271,8,186977
47228,0.00102,172.217.194.0-255,5738,127009,8,186977
47229,0.001022,172.217.194.0-255,766,127775,8,186977
47230,0.001037,172.31.36.0-255,66,127841,8,186977
47231,0.001068,172.217.194.0-255,1484,129325,8,186977
47232,0.001072,172.217.194.0-255,2902,132227,8,186977
47233,0.001078,172.31.36.0-255,66,132293,8,186977
47234,0.001099,172.217.194.0-255,5738,138031,8,186977
47235,0.001106,172.217.194.0-255,5738,143769,8,186977
47236,0.001117,172.31.36.0-255,66,143835,8,186977
47237,0.001153,172.217.194.0-255,4320,148155,8,186977
47238,0.001196,172.217.194.0-255,4320,152475,8,186977
47239,0.001211,172.217.194.0-255,6438,158913,8,186977
47240,0.001216,172.31.36.0-255,66,158979,8,186977
47241,0.001226,172.31.36.0-255,66,159045,8,186977
47242,0.001288,172.217.194.0-255,5738,164783,8,186977
47243,0.001302,172.217.194.0-255,2543,167326,8,186977
47244,0.001334,172.31.36.0-255,66,167392,8,186977
47245,0.001352,172.217.194.0-255,1484,168876,8,186977
47246,0.001384,172.31.36.0-255,66,168942,8,186977
47247,0.001409,172.217.194.0-255,2184,171126,8,186977
47248,0.001448,172.217.194.0-255,1484,172610,8,186977
47249,0.001461,172.31.36.0-255,66,172676,8,186977
47250,0.001468,172.217.194.0-255,4423,177099,8,186977
47251,0.001478,172.31.36.0-255,66,177165,8,186977
47252,0.001481,172.217.194.0-255,105,177270,8,186977
47253,0.010942,172.31.36.0-255,66,177336,8,186977
47254,0.01099,172.31.36.0-255,105,177441,8,186977
47255,0.013555,172.217.194.0-255,66,177507,8,186977
47256,0.038062,172.31.36.0-255,172,177679,8,186977
47257,0.038097,172.31.36.0-255,1111,178790,8,186977
47258,0.038179,172.31.36.0-255,1514,180304,8,186977
47259,0.038181,172.31.36.0-255,1514,181818,8,186977
47260,0.038187,172.31.36.0-255,1514,183332,8,186977
47261,0.038188,172.31.36.0-255,1514,184846,8,186977
47262,0.038208,172.31.36.0-255,1514,186360,8,186977
47263,0.038209,172.31.36.0-255,353,186713,8,186977
47264,0.039596,104.244.42.0-255,66,186779,8,186977
47265,0.039692,104.244.42.0-255,66,186845,8,186977
47266,0.039742,104.244.42.0-255,66,186911,8,186977
47267,0.039745,104.244.42.0-255,66,186977,8,186977
47268,0.0,172.31.36.0-255,232,232,8,298
47269,0.006459,172.217.194.0-255,66,298,8,298
47270,0.0,74.125.24.0-255,153,153,8,227874
47271,3.4e-05,172.31.36.0-255,66,219,8,227874
47272,4.1e-05,74.125.24.0-255,1484,1703,8,227874
47273,4.5e-05,172.31.36.0-255,66,1769,8,227874
47274,5e-05,74.125.24.0-255,2902,4671,8,227874
47275,5.3e-05,172.31.36.0-255,66,4737,8,227874
47276,5.8e-05,74.125.24.0-255,2902,7639,8,227874
47277,6.1e-05,172.31.36.0-255,66,7705,8,227874
47278,8.3e-05,74.125.24.0-255,6282,13987,8,227874
47279,8.6e-05,172.31.36.0-255,66,14053,8,227874
47280,0.000223,74.125.24.0-255,1484,15537,8,227874
47281,0.000227,172.31.36.0-255,66,15603,8,227874
47282,0.000233,74.125.24.0-255,2902,18505,8,227874
47283,0.000235,172.31.36.0-255,66,18571,8,227874
47284,0.000241,74.125.24.0-255,5738,24309,8,227874
47285,0.000243,172.31.36.0-255,66,24375,8,227874
47286,0.000288,172.31.36.0-255,66,24441,8,227874
47287,0.000298,172.31.36.0-255,66,24507,8,227874
47288,0.000341,74.125.24.0-255,5738,30245,8,227874
47289,0.000343,172.31.36.0-255,66,30311,8,227874
47290,0.000382,172.31.36.0-255,66,30377,8,227874
47291,0.000385,74.125.24.0-255,111,30488,8,227874
47292,0.000388,172.31.36.0-255,66,30554,8,227874
47293,0.000573,74.125.24.0-255,1484,32038,8,227874
47294,0.000578,172.31.36.0-255,66,32104,8,227874
47295,0.000583,74.125.24.0-255,2902,35006,8,227874
47296,0.000585,172.31.36.0-255,66,35072,8,227874
47297,0.000592,74.125.24.0-255,5738,40810,8,227874
47298,0.000594,172.31.36.0-255,66,40876,8,227874
47299,0.000625,74.125.24.0-255,5738,46614,8,227874
47300,0.000628,172.31.36.0-255,66,46680,8,227874
47301,0.000653,74.125.24.0-255,7156,53836,8,227874
47302,0.000659,172.31.36.0-255,66,53902,8,227874
47303,0.000665,172.31.36.0-255,66,53968,8,227874
47304,0.000876,74.125.24.0-255,1484,55452,8,227874
47305,0.000883,74.125.24.0-255,2902,58354,8,227874
47306,0.000886,172.31.36.0-255,66,58420,8,227874
47307,0.000911,74.125.24.0-255,5738,64158,8,227874
47308,0.000914,172.31.36.0-255,66,64224,8,227874
47309,0.000925,172.31.36.0-255,66,64290,8,227874
47310,0.000942,74.125.24.0-255,4320,68610,8,227874
47311,0.000946,172.31.36.0-255,66,68676,8,227874
47312,0.000949,74.125.24.0-255,7156,75832,8,227874
47313,0.000952,172.31.36.0-255,66,75898,8,227874
47314,0.000976,74.125.24.0-255,3602,79500,8,227874
47315,0.000979,172.31.36.0-255,66,79566,8,227874
47316,0.001996,74.125.24.0-255,1484,81050,8,227874
47317,0.002016,74.125.24.0-255,2902,83952,8,227874
47318,0.002023,172.31.36.0-255,66,84018,8,227874
47319,0.002032,74.125.24.0-255,5738,89756,8,227874
47320,0.002034,172.31.36.0-255,66,89822,8,227874
47321,0.002045,172.31.36.0-255,66,89888,8,227874
47322,0.002086,172.31.36.0-255,66,89954,8,227874
47323,0.002264,74.125.24.0-255,1484,91438,8,227874
47324,0.00227,74.125.24.0-255,2902,94340,8,227874
47325,0.002275,74.125.24.0-255,5738,100078,8,227874
47326,0.002287,172.31.36.0-255,66,100144,8,227874
47327,0.00229,172.31.36.0-255,66,100210,8,227874
47328,0.002296,74.125.24.0-255,4320,104530,8,227874
47329,0.002298,172.31.36.0-255,66,104596,8,227874
47330,0.002338,172.31.36.0-255,66,104662,8,227874
47331,0.002351,172.31.36.0-255,66,104728,8,227874
47332,0.002409,74.125.24.0-255,7156,111884,8,227874
47333,0.002412,172.31.36.0-255,66,111950,8,227874
47334,0.00244,172.31.36.0-255,66,112016,8,227874
47335,0.00245,172.31.36.0-255,66,112082,8,227874
47336,0.002455,74.125.24.0-255,4320,116402,8,227874
47337,0.002458,172.31.36.0-255,66,116468,8,227874
47338,0.002464,74.125.24.0-255,5738,122206,8,227874
47339,0.002468,172.31.36.0-255,66,122272,8,227874
47340,0.002486,172.31.36.0-255,66,122338,8,227874
47341,0.002499,172.31.36.0-255,66,122404,8,227874
47342,0.002522,172.31.36.0-255,66,122470,8,227874
47343,0.002537,74.125.24.0-255,4320,126790,8,227874
47344,0.002539,172.31.36.0-255,66,126856,8,227874
47345,0.002561,74.125.24.0-255,7156,134012,8,227874
47346,0.002564,172.31.36.0-255,66,134078,8,227874
47347,0.002572,74.125.24.0-255,7156,141234,8,227874
47348,0.002574,172.31.36.0-255,66,141300,8,227874
47349,0.002618,172.31.36.0-255,66,141366,8,227874
47350,0.002629,172.31.36.0-255,66,141432,8,227874
47351,0.002635,74.125.24.0-255,5738,147170,8,227874
47352,0.002636,172.31.36.0-255,66,147236,8,227874
47353,0.002668,172.31.36.0-255,66,147302,8,227874
47354,0.005277,74.125.24.0-255,5738,153040,8,227874
47355,0.005294,172.31.36.0-255,66,153106,8,227874
47356,0.007917,74.125.24.0-255,5738,158844,8,227874
47357,0.007931,172.31.36.0-255,66,158910,8,227874
47358,0.010574,74.125.24.0-255,5738,164648,8,227874
47359,0.010593,172.31.36.0-255,66,164714,8,227874
47360,0.013189,74.125.24.0-255,5738,170452,8,227874
47361,0.013207,172.31.36.0-255,66,170518,8,227874
47362,0.015823,74.125.24.0-255,5738,176256,8,227874
47363,0.015839,172.31.36.0-255,66,176322,8,227874
47364,0.016009,172.31.36.0-255,101,176423,8,227874
47365,0.018423,74.125.24.0-255,5738,182161,8,227874
47366,0.018439,172.31.36.0-255,66,182227,8,227874
47367,0.018571,74.125.24.0-255,66,182293,8,227874
47368,0.02104,74.125.24.0-255,5738,188031,8,227874
47369,0.021057,172.31.36.0-255,66,188097,8,227874
47370,0.02367,74.125.24.0-255,5738,193835,8,227874
47371,0.023683,172.31.36.0-255,66,193901,8,227874
47372,0.026294,74.125.24.0-255,5738,199639,8,227874
47373,0.026313,172.31.36.0-255,66,199705,8,227874
47374,0.028934,74.125.24.0-255,5738,205443,8,227874
47375,0.028952,172.31.36.0-255,66,205509,8,227874
47376,0.031598,74.125.24.0-255,5738,211247,8,227874
47377,0.031618,172.31.36.0-255,66,211313,8,227874
47378,0.034248,74.125.24.0-255,4320,215633,8,227874
47379,0.034261,172.31.36.0-255,66,215699,8,227874
47380,0.034296,74.125.24.0-255,1484,217183,8,227874
47381,0.03468,172.31.36.0-255,172,217355,8,227874
47382,0.034723,172.31.36.0-255,1110,218465,8,227874
47383,0.034817,172.31.36.0-255,1514,219979,8,227874
47384,0.034819,172.31.36.0-255,1514,221493,8,227874
47385,0.03482,172.31.36.0-255,1514,223007,8,227874
47386,0.034821,172.31.36.0-255,1514,224521,8,227874
47387,0.034822,172.31.36.0-255,1514,226035,8,227874
47388,0.034853,172.31.36.0-255,269,226304,8,227874
47389,0.036238,104.244.42.0-255,66,226370,8,227874
47390,0.036252,104.244.42.0-255,66,226436,8,227874
47391,0.036371,104.244.42.0-255,66,226502,8,227874
47392,0.036376,104.244.42.0-255,66,226568,8,227874
47393,0.03686,74.125.24.0-255,895,227463,8,227874
47394,0.036869,172.31.36.0-255,66,227529,8,227874
47395,0.037035,104.244.42.0-255,108,227637,8,227874
47396,0.03704,172.31.36.0-255,66,227703,8,227874
47397,0.037861,172.31.36.0-255,105,227808,8,227874
47398,0.044631,74.125.24.0-255,66,227874,8,227874
47399,0.0,74.125.24.0-255,153,153,8,253992
47400,2.9e-05,172.31.36.0-255,66,219,8,253992
47401,3.6e-05,74.125.24.0-255,1484,1703,8,253992
47402,4e-05,172.31.36.0-255,66,1769,8,253992
47403,4.5e-05,74.125.24.0-255,2902,4671,8,253992
47404,4.7e-05,172.31.36.0-255,66,4737,8,253992
47405,5e-05,74.125.24.0-255,1484,6221,8,253992
47406,5.2e-05,172.31.36.0-255,66,6287,8,253992
47407,8e-05,172.31.36.0-255,66,6353,8,253992
47408,9.3e-05,74.125.24.0-255,2902,9255,8,253992
47409,9.6e-05,172.31.36.0-255,66,9321,8,253992
47410,0.000116,172.31.36.0-255,66,9387,8,253992
47411,0.00014,74.125.24.0-255,3961,13348,8,253992
47412,0.000143,172.31.36.0-255,66,13414,8,253992
47413,0.000187,74.125.24.0-255,1484,14898,8,253992
47414,0.000189,172.31.36.0-255,66,14964,8,253992
47415,0.000195,74.125.24.0-255,2902,17866,8,253992
47416,0.000197,172.31.36.0-255,66,17932,8,253992
47417,0.000233,74.125.24.0-255,4320,22252,8,253992
47418,0.000236,172.31.36.0-255,66,22318,8,253992
47419,0.000258,74.125.24.0-255,1484,23802,8,253992
47420,0.00026,172.31.36.0-255,66,23868,8,253992
47421,0.000274,172.31.36.0-255,66,23934,8,253992
47422,0.000323,74.125.24.0-255,7156,31090,8,253992
47423,0.000328,172.31.36.0-255,66,31156,8,253992
47424,0.000348,74.125.24.0-255,3978,35134,8,253992
47425,0.000352,172.31.36.0-255,66,35200,8,253992
47426,0.000468,74.125.24.0-255,1484,36684,8,253992
47427,0.000472,172.31.36.0-255,66,36750,8,253992
47428,0.000478,74.125.24.0-255,2902,39652,8,253992
47429,0.00048,172.31.36.0-255,66,39718,8,253992
47430,0.000511,74.125.24.0-255,2902,42620,8,253992
47431,0.000514,172.31.36.0-255,66,42686,8,253992
47432,0.000521,74.125.24.0-255,5738,48424,8,253992
47433,0.000523,172.31.36.0-255,66,48490,8,253992
47434,0.00055,74.125.24.0-255,1484,49974,8,253992
47435,0.000565,172.31.36.0-255,66,50040,8,253992
47436,0.000579,74.125.24.0-255,4320,54360,8,253992
47437,0.000582,172.31.36.0-255,66,54426,8,253992
47438,0.000598,74.125.24.0-255,1484,55910,8,253992
47439,0.000618,74.125.24.0-255,5020,60930,8,253992
47440,0.000622,172.31.36.0-255,66,60996,8,253992
47441,0.000625,74.125.24.0-255,331,61327,8,253992
47442,0.001083,172.31.36.0-255,66,61393,8,253992
47443,0.001483,74.125.24.0-255,1484,62877,8,253992
47444,0.001493,74.125.24.0-255,2902,65779,8,253992
47445,0.001497,172.31.36.0-255,66,65845,8,253992
47446,0.001505,74.125.24.0-255,5738,71583,8,253992
47447,0.001508,172.31.36.0-255,66,71649,8,253992
47448,0.001513,74.125.24.0-255,2902,74551,8,253992
47449,0.001515,172.31.36.0-255,66,74617,8,253992
47450,0.001529,74.125.24.0-255,4320,78937,8,253992
47451,0.001532,172.31.36.0-255,66,79003,8,253992
47452,0.001568,172.31.36.0-255,66,79069,8,253992
47453,0.001572,74.125.24.0-255,2184,81253,8,253992
47454,0.001574,172.31.36.0-255,66,81319,8,253992
47455,0.002272,74.125.24.0-255,1484,82803,8,253992
47456,0.002289,74.125.24.0-255,2902,85705,8,253992
47457,0.002293,172.31.36.0-255,66,85771,8,253992
47458,0.002297,74.125.24.0-255,1484,87255,8,253992
47459,0.002308,74.125.24.0-255,4320,91575,8,253992
47460,0.00231,172.31.36.0-255,66,91641,8,253992
47461,0.002345,172.31.36.0-255,66,91707,8,253992
47462,0.002354,172.31.36.0-255,66,91773,8,253992
47463,0.002358,74.125.24.0-255,2184,93957,8,253992
47464,0.00236,172.31.36.0-255,66,94023,8,253992
47465,0.004665,74.125.24.0-255,5738,99761,8,253992
47466,0.004669,172.31.36.0-255,66,99827,8,253992
47467,0.007002,74.125.24.0-255,5738,105565,8,253992
47468,0.007008,172.31.36.0-255,66,105631,8,253992
47469,0.009342,74.125.24.0-255,5738,111369,8,253992
47470,0.00935,172.31.36.0-255,66,111435,8,253992
47471,0.011692,74.125.24.0-255,5738,117173,8,253992
47472,0.0117,172.31.36.0-255,66,117239,8,253992
47473,0.014036,74.125.24.0-255,5738,122977,8,253992
47474,0.014043,172.31.36.0-255,66,123043,8,253992
47475,0.016359,74.125.24.0-255,5738,128781,8,253992
47476,0.016365,172.31.36.0-255,66,128847,8,253992
47477,0.018685,74.125.24.0-255,5738,134585,8,253992
47478,0.018694,172.31.36.0-255,66,134651,8,253992
47479,0.021032,74.125.24.0-255,5738,140389,8,253992
47480,0.02104,172.31.36.0-255,66,140455,8,253992
47481,0.023365,74.125.24.0-255,5738,146193,8,253992
47482,0.023372,172.31.36.0-255,66,146259,8,253992
47483,0.025157,172.31.36.0-255,167,146426,8,253992
47484,0.025188,172.31.36.0-255,1112,147538,8,253992
47485,0.025225,172.31.36.0-255,1514,149052,8,253992
47486,0.025227,172.31.36.0-255,1292,150344,8,253992
47487,0.025745,74.125.24.0-255,5738,156082,8,253992
47488,0.025753,172.31.36.0-255,66,156148,8,253992
47489,0.026713,104.244.42.0-255,66,156214,8,253992
47490,0.026772,104.244.42.0-255,66,156280,8,253992
47491,0.026814,104.244.42.0-255,66,156346,8,253992
47492,0.028069,74.125.24.0-255,4320,160666,8,253992
47493,0.028074,172.31.36.0-255,66,160732,8,253992
47494,0.0281,74.125.24.0-255,1484,162216,8,253992
47495,0.030417,74.125.24.0-255,2902,165118,8,253992
47496,0.030422,172.31.36.0-255,66,165184,8,253992
47497,0.032776,74.125.24.0-255,4320,169504,8,253992
47498,0.032782,172.31.36.0-255,66,169570,8,253992
47499,0.032814,74.125.24.0-255,1484,171054,8,253992
47500,0.035166,74.125.24.0-255,4320,175374,8,253992
47501,0.035171,172.31.36.0-255,66,175440,8,253992
47502,0.037512,74.125.24.0-255,5738,181178,8,253992
47503,0.037519,172.31.36.0-255,66,181244,8,253992
47504,0.039861,74.125.24.0-255,5738,186982,8,253992
47505,0.039868,172.31.36.0-255,66,187048,8,253992
47506,0.042207,74.125.24.0-255,5738,192786,8,253992
47507,0.042213,172.31.36.0-255,66,192852,8,253992
47508,0.044549,74.125.24.0-255,5738,198590,8,253992
47509,0.044553,172.31.36.0-255,66,198656,8,253992
47510,0.046896,74.125.24.0-255,5738,204394,8,253992
47511,0.046901,172.31.36.0-255,66,204460,8,253992
47512,0.049253,74.125.24.0-255,5738,210198,8,253992
47513,0.049258,172.31.36.0-255,66,210264,8,253992
47514,0.051576,74.125.24.0-255,4320,214584,8,253992
47515,0.051581,172.31.36.0-255,66,214650,8,253992
47516,0.051611,74.125.24.0-255,1484,216134,8,253992
47517,0.053904,74.125.24.0-255,4320,220454,8,253992
47518,0.053909,172.31.36.0-255,66,220520,8,253992
47519,0.056244,74.125.24.0-255,5738,226258,8,253992
47520,0.056249,172.31.36.0-255,66,226324,8,253992
47521,0.058559,74.125.24.0-255,5738,232062,8,253992
47522,0.058565,172.31.36.0-255,66,232128,8,253992
47523,0.060911,74.125.24.0-255,5738,237866,8,253992
47524,0.060916,172.31.36.0-255,66,237932,8,253992
47525,0.063258,74.125.24.0-255,5738,243670,8,253992
47526,0.063263,172.31.36.0-255,66,243736,8,253992
47527,0.065594,74.125.24.0-255,4320,248056,8,253992
47528,0.065599,172.31.36.0-255,66,248122,8,253992
47529,0.065635,74.125.24.0-255,1484,249606,8,253992
47530,0.067921,74.125.24.0-255,4320,253926,8,253992
47531,0.067927,172.31.36.0-255,66,253992,8,253992
47532,0.0,172.31.36.0-255,66,66,8,66
47533,0.0,74.125.24.0-255,146,146,8,231546
47534,2.3e-05,172.31.36.0-255,66,212,8,231546
47535,3.1e-05,74.125.24.0-255,1484,1696,8,231546
47536,3.5e-05,172.31.36.0-255,66,1762,8,231546
47537,4.1e-05,74.125.24.0-255,2902,4664,8,231546
47538,4.5e-05,172.31.36.0-255,66,4730,8,231546
47539,5.4e-05,74.125.24.0-255,7156,11886,8,231546
47540,5.7e-05,172.31.36.0-255,66,11952,8,231546
47541,0.000172,172.31.36.0-255,66,12018,8,231546
47542,0.000329,74.125.24.0-255,6797,18815,8,231546
47543,0.000334,172.31.36.0-255,66,18881,8,231546
47544,0.00043,74.125.24.0-255,7156,26037,8,231546
47545,0.000435,172.31.36.0-255,66,26103,8,231546
47546,0.000461,172.31.36.0-255,66,26169,8,231546
47547,0.000729,172.31.36.0-255,66,26235,8,231546
47548,0.000861,74.125.24.0-255,413,26648,8,231546
47549,0.000865,172.31.36.0-255,66,26714,8,231546
47550,0.000884,74.125.24.0-255,331,27045,8,231546
47551,0.000886,172.31.36.0-255,66,27111,8,231546
47552,0.001118,74.125.24.0-255,1484,28595,8,231546
47553,0.001123,172.31.36.0-255,66,28661,8,231546
47554,0.001128,74.125.24.0-255,2902,31563,8,231546
47555,0.001131,172.31.36.0-255,66,31629,8,231546
47556,0.001155,74.125.24.0-255,4320,35949,8,231546
47557,0.001157,172.31.36.0-255,66,36015,8,231546
47558,0.001174,74.125.24.0-255,1484,37499,8,231546
47559,0.001177,172.31.36.0-255,66,37565,8,231546
47560,0.001243,74.125.24.0-255,4320,41885,8,231546
47561,0.001248,172.31.36.0-255,66,41951,8,231546
47562,0.001322,172.31.36.0-255,66,42017,8,231546
47563,0.001456,74.125.24.0-255,5738,47755,8,231546
47564,0.001461,172.31.36.0-255,66,47821,8,231546
47565,0.00148,74.125.24.0-255,2184,50005,8,231546
47566,0.001514,172.31.36.0-255,66,50071,8,231546
47567,0.001712,74.125.24.0-255,1484,51555,8,231546
47568,0.001721,74.125.24.0-255,2902,54457,8,231546
47569,0.001725,172.31.36.0-255,66,54523,8,231546
47570,0.001762,74.125.24.0-255,5738,60261,8,231546
47571,0.001848,74.125.24.0-255,2902,63163,8,231546
47572,0.002028,74.125.24.0-255,2184,65347,8,231546
47573,0.002173,74.125.24.0-255,2902,68249,8,231546
47574,0.002321,74.125.24.0-255,4320,72569,8,231546
47575,0.002627,74.125.24.0-255,7156,79725,8,231546
47576,0.008876,172.31.36.0-255,66,79791,8,231546
47577,0.011179,74.125.24.0-255,5738,85529,8,231546
47578,0.011187,172.31.36.0-255,66,85595,8,231546
47579,0.013529,74.125.24.0-255,5738,91333,8,231546
47580,0.013537,172.31.36.0-255,66,91399,8,231546
47581,0.015865,74.125.24.0-255,5738,97137,8,231546
47582,0.015873,172.31.36.0-255,66,97203,8,231546
47583,0.018205,74.125.24.0-255,5738,102941,8,231546
47584,0.018213,172.31.36.0-255,66,103007,8,231546
47585,0.020536,74.125.24.0-255,5738,108745,8,231546
47586,0.020544,172.31.36.0-255,66,108811,8,231546
47587,0.022868,74.125.24.0-255,5738,114549,8,231546
47588,0.022875,172.31.36.0-255,66,114615,8,231546
47589,0.025186,74.125.24.0-255,5738,120353,8,231546
47590,0.025193,172.31.36.0-255,66,120419,8,231546
47591,0.026084,172.31.36.0-255,171,120590,8,231546
47592,0.026121,172.31.36.0-255,614,121204,8,231546
47593,0.02756,74.125.24.0-255,5738,126942,8,231546
47594,0.027568,172.31.36.0-255,66,127008,8,231546
47595,0.028299,104.244.42.0-255,66,127074,8,231546
47596,0.029878,74.125.24.0-255,5738,132812,8,231546
47597,0.029884,172.31.36.0-255,66,132878,8,231546
47598,0.032212,74.125.24.0-255,5738,138616,8,231546
47599,0.032219,172.31.36.0-255,66,138682,8,231546
47600,0.034538,74.125.24.0-255,5738,144420,8,231546
47601,0.034545,172.31.36.0-255,66,144486,8,231546
47602,0.036867,74.125.24.0-255,5738,150224,8,231546
47603,0.036876,172.31.36.0-255,66,150290,8,231546
47604,0.039219,74.125.24.0-255,5738,156028,8,231546
47605,0.039225,172.31.36.0-255,66,156094,8,231546
47606,0.041548,74.125.24.0-255,5738,161832,8,231546
47607,0.041557,172.31.36.0-255,66,161898,8,231546
47608,0.043865,74.125.24.0-255,5738,167636,8,231546
47609,0.043872,172.31.36.0-255,66,167702,8,231546
47610,0.046194,74.125.24.0-255,5738,173440,8,231546
47611,0.046201,172.31.36.0-255,66,173506,8,231546
47612,0.048532,74.125.24.0-255,5738,179244,8,231546
47613,0.048538,172.31.36.0-255,66,179310,8,231546
47614,0.050842,74.125.24.0-255,5738,185048,8,231546
47615,0.050848,172.31.36.0-255,66,185114,8,231546
47616,0.053216,74.125.24.0-255,5738,190852,8,231546
47617,0.053227,172.31.36.0-255,66,190918,8,231546
47618,0.055544,74.125.24.0-255,5738,196656,8,231546
47619,0.055551,172.31.36.0-255,66,196722,8,231546
47620,0.057883,74.125.24.0-255,5738,202460,8,231546
47621,0.057889,172.31.36.0-255,66,202526,8,231546
47622,0.060221,74.125.24.0-255,5738,208264,8,231546
47623,0.060226,172.31.36.0-255,66,208330,8,231546
47624,0.062552,74.125.24.0-255,5738,214068,8,231546
47625,0.062557,172.31.36.0-255,66,214134,8,231546
47626,0.064863,74.125.24.0-255,5738,219872,8,231546
47627,0.064869,172.31.36.0-255,66,219938,8,231546
47628,0.067193,74.125.24.0-255,5738,225676,8,231546
47629,0.067205,172.31.36.0-255,66,225742,8,231546
47630,0.069543,74.125.24.0-255,5738,231480,8,231546
47631,0.069551,172.31.36.0-255,66,231546,8,231546
47632,0.0,74.125.130.0-255,153,153,8,283189
47633,3.3e-05,172.31.36.0-255,66,219,8,283189
47634,4e-05,74.125.130.0-255,1484,1703,8,283189
47635,4.5e-05,172.31.36.0-255,66,1769,8,283189
47636,6.9e-05,74.125.130.0-255,1484,3253,8,283189
47637,7.1e-05,172.31.36.0-255,66,3319,8,283189
47638,7.7e-05,74.125.130.0-255,2902,6221,8,283189
47639,7.9e-05,172.31.36.0-255,66,6287,8,283189
47640,0.000106,74.125.130.0-255,4320,10607,8,283189
47641,0.000109,172.31.36.0-255,66,10673,8,283189
47642,0.000125,74.125.130.0-255,1484,12157,8,283189
47643,0.000128,172.31.36.0-255,66,12223,8,283189
47644,0.000131,74.125.130.0-255,1484,13707,8,283189
47645,0.000133,172.31.36.0-255,66,13773,8,283189
47646,0.000136,74.125.130.0-255,635,14408,8,283189
47647,0.000139,172.31.36.0-255,66,14474,8,283189
47648,0.000589,74.125.130.0-255,1484,15958,8,283189
47649,0.000595,172.31.36.0-255,66,16024,8,283189
47650,0.000605,74.125.130.0-255,2902,18926,8,283189
47651,0.000608,172.31.36.0-255,66,18992,8,283189
47652,0.000636,74.125.130.0-255,2902,21894,8,283189
47653,0.000639,172.31.36.0-255,66,21960,8,283189
47654,0.000653,74.125.130.0-255,1484,23444,8,283189
47655,0.000655,172.31.36.0-255,66,23510,8,283189
47656,0.00066,74.125.130.0-255,2902,26412,8,283189
47657,0.000662,172.31.36.0-255,66,26478,8,283189
47658,0.000684,74.125.130.0-255,2902,29380,8,283189
47659,0.000686,172.31.36.0-255,66,29446,8,283189
47660,0.000709,74.125.130.0-255,2543,31989,8,283189
47661,0.000713,172.31.36.0-255,66,32055,8,283189
47662,0.001129,74.125.130.0-255,1484,33539,8,283189
47663,0.001136,172.31.36.0-255,66,33605,8,283189
47664,0.001144,74.125.130.0-255,2902,36507,8,283189
47665,0.001146,172.31.36.0-255,66,36573,8,283189
47666,0.00115,74.125.130.0-255,1484,38057,8,283189
47667,0.001174,74.125.130.0-255,4320,42377,8,283189
47668,0.001176,172.31.36.0-255,66,42443,8,283189
47669,0.001183,74.125.130.0-255,6797,49240,8,283189
47670,0.001185,172.31.36.0-255,66,49306,8,283189
47671,0.001215,74.125.130.0-255,2902,52208,8,283189
47672,0.001218,172.31.36.0-255,66,52274,8,283189
47673,0.00124,74.125.130.0-255,5738,58012,8,283189
47674,0.001243,172.31.36.0-255,66,58078,8,283189
47675,0.001261,74.125.130.0-255,1484,59562,8,283189
47676,0.001285,74.125.130.0-255,7088,66650,8,283189
47677,0.001288,172.31.36.0-255,66,66716,8,283189
47678,0.001351,74.125.130.0-255,363,67079,8,283189
47679,0.001548,172.31.36.0-255,66,67145,8,283189
47680,0.001579,74.125.130.0-255,1484,68629,8,283189
47681,0.001598,74.125.130.0-255,2902,71531,8,283189
47682,0.001601,172.31.36.0-255,66,71597,8,283189
47683,0.001606,74.125.130.0-255,4320,75917,8,283189
47684,0.001608,172.31.36.0-255,66,75983,8,283189
47685,0.001621,74.125.130.0-255,1484,77467,8,283189
47686,0.001624,74.125.130.0-255,1484,78951,8,283189
47687,0.001626,172.31.36.0-255,66,79017,8,283189
47688,0.00163,74.125.130.0-255,2902,81919,8,283189
47689,0.001633,172.31.36.0-255,66,81985,8,283189
47690,0.001667,74.125.130.0-255,2902,84887,8,283189
47691,0.00167,172.31.36.0-255,66,84953,8,283189
47692,0.001689,74.125.130.0-255,1125,86078,8,283189
47693,0.001694,74.125.130.0-255,4320,90398,8,283189
47694,0.001696,172.31.36.0-255,66,90464,8,283189
47695,0.001712,74.125.130.0-255,5738,96202,8,283189
47696,0.001714,172.31.36.0-255,66,96268,8,283189
47697,0.001741,74.125.130.0-255,4320,100588,8,283189
47698,0.001744,172.31.36.0-255,66,100654,8,283189
47699,0.001746,74.125.130.0-255,1125,101779,8,283189
47700,0.001979,172.31.36.0-255,66,101845,8,283189
47701,0.00381,74.125.130.0-255,4320,106165,8,283189
47702,0.003815,172.31.36.0-255,66,106231,8,283189
47703,0.004045,74.125.130.0-255,1484,107715,8,283189
47704,0.005882,74.125.130.0-255,4320,112035,8,283189
47705,0.005903,172.31.36.0-255,66,112101,8,283189
47706,0.007973,74.125.130.0-255,5738,117839,8,283189
47707,0.00798,172.31.36.0-255,66,117905,8,283189
47708,0.010075,74.125.130.0-255,5738,123643,8,283189
47709,0.010083,172.31.36.0-255,66,123709,8,283189
47710,0.012159,74.125.130.0-255,5738,129447,8,283189
47711,0.012166,172.31.36.0-255,66,129513,8,283189
47712,0.014235,74.125.130.0-255,4320,133833,8,283189
47713,0.014242,172.31.36.0-255,66,133899,8,283189
47714,0.014261,74.125.130.0-255,1484,135383,8,283189
47715,0.01631,74.125.130.0-255,4320,139703,8,283189
47716,0.016318,172.31.36.0-255,66,139769,8,283189
47717,0.018398,74.125.130.0-255,5738,145507,8,283189
47718,0.018406,172.31.36.0-255,66,145573,8,283189
47719,0.020468,74.125.130.0-255,5738,151311,8,283189
47720,0.020476,172.31.36.0-255,66,151377,8,283189
47721,0.022008,172.31.36.0-255,172,151549,8,283189
47722,0.022047,172.31.36.0-255,1112,152661,8,283189
47723,0.02212,172.31.36.0-255,1514,154175,8,283189
47724,0.022122,172.31.36.0-255,1292,155467,8,283189
47725,0.022537,74.125.130.0-255,5738,161205,8,283189
47726,0.022544,172.31.36.0-255,66,161271,8,283189
47727,0.023577,104.244.42.0-255,66,161337,8,283189
47728,0.023614,104.244.42.0-255,66,161403,8,283189
47729,0.023711,104.244.42.0-255,66,161469,8,283189
47730,0.02461,74.125.130.0-255,4320,165789,8,283189
47731,0.024614,172.31.36.0-255,66,165855,8,283189
47732,0.024643,74.125.130.0-255,1484,167339,8,283189
47733,0.026682,74.125.130.0-255,2902,170241,8,283189
47734,0.026688,172.31.36.0-255,66,170307,8,283189
47735,0.028748,74.125.130.0-255,5738,176045,8,283189
47736,0.028753,172.31.36.0-255,66,176111,8,283189
47737,0.030815,74.125.130.0-255,5738,181849,8,283189
47738,0.03082,172.31.36.0-255,66,181915,8,283189
47739,0.032883,74.125.130.0-255,4320,186235,8,283189
47740,0.032888,172.31.36.0-255,66,186301,8,283189
47741,0.032916,74.125.130.0-255,1484,187785,8,283189
47742,0.034944,74.125.130.0-255,4320,192105,8,283189
47743,0.034949,172.31.36.0-255,66,192171,8,283189
47744,0.037016,74.125.130.0-255,5738,197909,8,283189
47745,0.037022,172.31.36.0-255,66,197975,8,283189
47746,0.039079,74.125.130.0-255,2902,200877,8,283189
47747,0.039084,172.31.36.0-255,66,200943,8,283189
47748,0.039115,74.125.130.0-255,2902,203845,8,283189
47749,0.039117,172.31.36.0-255,66,203911,8,283189
47750,0.041146,74.125.130.0-255,2902,206813,8,283189
47751,0.041154,172.31.36.0-255,66,206879,8,283189
47752,0.041175,74.125.130.0-255,2902,209781,8,283189
47753,0.041178,172.31.36.0-255,66,209847,8,283189
47754,0.043228,74.125.130.0-255,2902,212749,8,283189
47755,0.043233,172.31.36.0-255,66,212815,8,283189
47756,0.043266,74.125.130.0-255,2902,215717,8,283189
47757,0.043269,172.31.36.0-255,66,215783,8,283189
47758,0.0453,74.125.130.0-255,2902,218685,8,283189
47759,0.045305,172.31.36.0-255,66,218751,8,283189
47760,0.045336,74.125.130.0-255,2902,221653,8,283189
47761,0.045339,172.31.36.0-255,66,221719,8,283189
47762,0.047362,74.125.130.0-255,2902,224621,8,283189
47763,0.047368,172.31.36.0-255,66,224687,8,283189
47764,0.047397,74.125.130.0-255,2902,227589,8,283189
47765,0.0474,172.31.36.0-255,66,227655,8,283189
47766,0.04944,74.125.130.0-255,2902,230557,8,283189
47767,0.049446,172.31.36.0-255,66,230623,8,283189
47768,0.049481,74.125.130.0-255,2902,233525,8,283189
47769,0.049484,172.31.36.0-255,66,233591,8,283189
47770,0.051508,74.125.130.0-255,1484,235075,8,283189
47771,0.051544,74.125.130.0-255,2902,237977,8,283189
47772,0.051549,172.31.36.0-255,66,238043,8,283189
47773,0.051567,74.125.130.0-255,1484,239527,8,283189
47774,0.053615,74.125.130.0-255,4320,243847,8,283189
47775,0.05362,172.31.36.0-255,66,243913,8,283189
47776,0.055713,74.125.130.0-255,5738,249651,8,283189
47777,0.05572,172.31.36.0-255,66,249717,8,283189
47778,0.057832,74.125.130.0-255,5738,255455,8,283189
47779,0.057837,172.31.36.0-255,66,255521,8,283189
47780,0.059899,74.125.130.0-255,4320,259841,8,283189
47781,0.059904,172.31.36.0-255,66,259907,8,283189
47782,0.059932,74.125.130.0-255,1484,261391,8,283189
47783,0.061977,74.125.130.0-255,4320,265711,8,283189
47784,0.061982,172.31.36.0-255,66,265777,8,283189
47785,0.064038,74.125.130.0-255,5738,271515,8,283189
47786,0.064042,172.31.36.0-255,66,271581,8,283189
47787,0.066103,74.125.130.0-255,5738,277319,8,283189
47788,0.066108,172.31.36.0-255,66,277385,8,283189
47789,0.068192,74.125.130.0-255,5738,283123,8,283189
47790,0.068197,172.31.36.0-255,66,283189,8,283189
47791,0.0,74.125.130.0-255,146,146,8,349142
47792,3.3e-05,172.31.36.0-255,66,212,8,349142
47793,3.9e-05,74.125.130.0-255,1484,1696,8,349142
47794,4.3e-05,172.31.36.0-255,66,1762,8,349142
47795,6.8e-05,74.125.130.0-255,2902,4664,8,349142
47796,7.1e-05,172.31.36.0-255,66,4730,8,349142
47797,0.000103,74.125.130.0-255,5738,10468,8,349142
47798,0.000107,172.31.36.0-255,66,10534,8,349142
47799,0.000146,74.125.130.0-255,4947,15481,8,349142
47800,0.000152,172.31.36.0-255,66,15547,8,349142
47801,0.000183,74.125.130.0-255,5738,21285,8,349142
47802,0.000186,172.31.36.0-255,66,21351,8,349142
47803,0.000221,74.125.130.0-255,4320,25671,8,349142
47804,0.000224,172.31.36.0-255,66,25737,8,349142
47805,0.000258,74.125.130.0-255,5379,31116,8,349142
47806,0.000262,172.31.36.0-255,66,31182,8,349142
47807,0.000408,74.125.130.0-255,1484,32666,8,349142
47808,0.000413,172.31.36.0-255,66,32732,8,349142
47809,0.000437,74.125.130.0-255,1484,34216,8,349142
47810,0.00044,172.31.36.0-255,66,34282,8,349142
47811,0.00047,74.125.130.0-255,1484,35766,8,349142
47812,0.000474,172.31.36.0-255,66,35832,8,349142
47813,0.000481,74.125.130.0-255,5738,41570,8,349142
47814,0.000487,172.31.36.0-255,66,41636,8,349142
47815,0.000493,74.125.130.0-255,6797,48433,8,349142
47816,0.000496,172.31.36.0-255,66,48499,8,349142
47817,0.0005,74.125.130.0-255,2902,51401,8,349142
47818,0.000503,172.31.36.0-255,66,51467,8,349142
47819,0.000524,74.125.130.0-255,4320,55787,8,349142
47820,0.000528,172.31.36.0-255,66,55853,8,349142
47821,0.000572,172.31.36.0-255,66,55919,8,349142
47822,0.000615,74.125.130.0-255,1714,57633,8,349142
47823,0.000618,172.31.36.0-255,66,57699,8,349142
47824,0.00077,74.125.130.0-255,1484,59183,8,349142
47825,0.000782,74.125.130.0-255,1484,60667,8,349142
47826,0.000785,172.31.36.0-255,66,60733,8,349142
47827,0.000814,74.125.130.0-255,1484,62217,8,349142
47828,0.00082,74.125.130.0-255,4320,66537,8,349142
47829,0.000823,172.31.36.0-255,66,66603,8,349142
47830,0.00083,74.125.130.0-255,5738,72341,8,349142
47831,0.000832,172.31.36.0-255,66,72407,8,349142
47832,0.000859,74.125.130.0-255,3961,76368,8,349142
47833,0.000862,172.31.36.0-255,66,76434,8,349142
47834,0.000889,74.125.130.0-255,4320,80754,8,349142
47835,0.000893,172.31.36.0-255,66,80820,8,349142
47836,0.000914,74.125.130.0-255,5738,86558,8,349142
47837,0.000918,172.31.36.0-255,66,86624,8,349142
47838,0.000971,74.125.130.0-255,5379,92003,8,349142
47839,0.000976,172.31.36.0-255,66,92069,8,349142
47840,0.001603,74.125.130.0-255,1484,93553,8,349142
47841,0.001612,74.125.130.0-255,2902,96455,8,349142
47842,0.001616,172.31.36.0-255,66,96521,8,349142
47843,0.001647,74.125.130.0-255,1484,98005,8,349142
47844,0.00166,74.125.130.0-255,4320,102325,8,349142
47845,0.001663,172.31.36.0-255,66,102391,8,349142
47846,0.001667,74.125.130.0-255,2902,105293,8,349142
47847,0.001669,172.31.36.0-255,66,105359,8,349142
47848,0.001673,74.125.130.0-255,1484,106843,8,349142
47849,0.001704,74.125.130.0-255,2902,109745,8,349142
47850,0.001708,172.31.36.0-255,66,109811,8,349142
47851,0.001713,74.125.130.0-255,1484,111295,8,349142
47852,0.001738,74.125.130.0-255,4320,115615,8,349142
47853,0.00174,172.31.36.0-255,66,115681,8,349142
47854,0.001772,74.125.130.0-255,7156,122837,8,349142
47855,0.001775,172.31.36.0-255,66,122903,8,349142
47856,0.00183,74.125.130.0-255,3602,126505,8,349142
47857,0.001832,172.31.36.0-255,66,126571,8,349142
47858,0.002194,74.125.130.0-255,1484,128055,8,349142
47859,0.002216,74.125.130.0-255,2902,130957,8,349142
47860,0.002218,172.31.36.0-255,66,131023,8,349142
47861,0.00224,74.125.130.0-255,2902,133925,8,349142
47862,0.002242,172.31.36.0-255,66,133991,8,349142
47863,0.002261,74.125.130.0-255,1484,135475,8,349142
47864,0.002278,74.125.130.0-255,5738,141213,8,349142
47865,0.00228,172.31.36.0-255,66,141279,8,349142
47866,0.002306,74.125.130.0-255,1484,142763,8,349142
47867,0.002319,74.125.130.0-255,5738,148501,8,349142
47868,0.002321,172.31.36.0-255,66,148567,8,349142
47869,0.002323,74.125.130.0-255,1484,150051,8,349142
47870,0.002341,74.125.130.0-255,2902,152953,8,349142
47871,0.002343,172.31.36.0-255,66,153019,8,349142
47872,0.002346,74.125.130.0-255,1484,154503,8,349142
47873,0.002364,74.125.130.0-255,4320,158823,8,349142
47874,0.002366,172.31.36.0-255,66,158889,8,349142
47875,0.002391,74.125.130.0-255,2184,161073,8,349142
47876,0.002393,172.31.36.0-255,66,161139,8,349142
47877,0.002424,74.125.130.0-255,1484,162623,8,349142
47878,0.002437,74.125.130.0-255,1484,164107,8,349142
47879,0.002439,172.31.36.0-255,66,164173,8,349142
47880,0.002469,74.125.130.0-255,1484,165657,8,349142
47881,0.002475,74.125.130.0-255,5738,171395,8,349142
47882,0.002477,172.31.36.0-255,66,171461,8,349142
47883,0.002479,74.125.130.0-255,1484,172945,8,349142
47884,0.002502,74.125.130.0-255,5738,178683,8,349142
47885,0.002504,172.31.36.0-255,66,178749,8,349142
47886,0.002508,74.125.130.0-255,4320,183069,8,349142
47887,0.00251,172.31.36.0-255,66,183135,8,349142
47888,0.002539,74.125.130.0-255,4320,187455,8,349142
47889,0.002541,172.31.36.0-255,66,187521,8,349142
47890,0.002545,74.125.130.0-255,2902,190423,8,349142
47891,0.002546,172.31.36.0-255,66,190489,8,349142
47892,0.002551,74.125.130.0-255,4320,194809,8,349142
47893,0.002552,172.31.36.0-255,66,194875,8,349142
47894,0.002572,74.125.130.0-255,766,195641,8,349142
47895,0.00265,74.125.130.0-255,1484,197125,8,349142
47896,0.002652,172.31.36.0-255,66,197191,8,349142
47897,0.005199,74.125.130.0-255,2902,200093,8,349142
47898,0.005209,172.31.36.0-255,66,200159,8,349142
47899,0.005274,74.125.130.0-255,1484,201643,8,349142
47900,0.005285,74.125.130.0-255,1484,203127,8,349142
47901,0.005287,172.31.36.0-255,66,203193,8,349142
47902,0.007855,74.125.130.0-255,2902,206095,8,349142
47903,0.007862,172.31.36.0-255,66,206161,8,349142
47904,0.007908,74.125.130.0-255,2902,209063,8,349142
47905,0.007912,172.31.36.0-255,66,209129,8,349142
47906,0.010557,74.125.130.0-255,2902,212031,8,349142
47907,0.010573,172.31.36.0-255,66,212097,8,349142
47908,0.010619,74.125.130.0-255,2902,214999,8,349142
47909,0.010623,172.31.36.0-255,66,215065,8,349142
47910,0.013232,74.125.130.0-255,2902,217967,8,349142
47911,0.013248,172.31.36.0-255,66,218033,8,349142
47912,0.013292,74.125.130.0-255,2902,220935,8,349142
47913,0.013295,172.31.36.0-255,66,221001,8,349142
47914,0.015895,74.125.130.0-255,2902,223903,8,349142
47915,0.015912,172.31.36.0-255,66,223969,8,349142
47916,0.015946,74.125.130.0-255,2902,226871,8,349142
47917,0.01595,172.31.36.0-255,66,226937,8,349142
47918,0.018612,74.125.130.0-255,5738,232675,8,349142
47919,0.018633,172.31.36.0-255,66,232741,8,349142
47920,0.021313,74.125.130.0-255,5738,238479,8,349142
47921,0.021334,172.31.36.0-255,66,238545,8,349142
47922,0.023251,172.31.36.0-255,172,238717,8,349142
47923,0.023297,172.31.36.0-255,1111,239828,8,349142
47924,0.02335,172.31.36.0-255,1514,241342,8,349142
47925,0.023358,172.31.36.0-255,1514,242856,8,349142
47926,0.023359,172.31.36.0-255,1514,244370,8,349142
47927,0.02336,172.31.36.0-255,1514,245884,8,349142
47928,0.023385,172.31.36.0-255,1358,247242,8,349142
47929,0.024001,74.125.130.0-255,5738,252980,8,349142
47930,0.02401,172.31.36.0-255,66,253046,8,349142
47931,0.024947,104.244.42.0-255,66,253112,8,349142
47932,0.026653,74.125.130.0-255,5738,258850,8,349142
47933,0.026661,172.31.36.0-255,66,258916,8,349142
47934,0.029293,74.125.130.0-255,5738,264654,8,349142
47935,0.029301,172.31.36.0-255,66,264720,8,349142
47936,0.031937,74.125.130.0-255,5738,270458,8,349142
47937,0.031944,172.31.36.0-255,66,270524,8,349142
47938,0.03459,74.125.130.0-255,5738,276262,8,349142
47939,0.034599,172.31.36.0-255,66,276328,8,349142
47940,0.037245,74.125.130.0-255,5738,282066,8,349142
47941,0.03726,172.31.36.0-255,66,282132,8,349142
47942,0.039909,74.125.130.0-255,5738,287870,8,349142
47943,0.03992,172.31.36.0-255,66,287936,8,349142
47944,0.042565,74.125.130.0-255,5738,293674,8,349142
47945,0.042573,172.31.36.0-255,66,293740,8,349142
47946,0.045229,74.125.130.0-255,5738,299478,8,349142
47947,0.045251,172.31.36.0-255,66,299544,8,349142
47948,0.047907,74.125.130.0-255,4320,303864,8,349142
47949,0.04792,172.31.36.0-255,66,303930,8,349142
47950,0.047959,74.125.130.0-255,1484,305414,8,349142
47951,0.050568,74.125.130.0-255,4320,309734,8,349142
47952,0.05058,172.31.36.0-255,66,309800,8,349142
47953,0.053226,74.125.130.0-255,5738,315538,8,349142
47954,0.053234,172.31.36.0-255,66,315604,8,349142
47955,0.05589,74.125.130.0-255,4320,319924,8,349142
47956,0.055898,172.31.36.0-255,66,319990,8,349142
47957,0.055928,74.125.130.0-255,1484,321474,8,349142
47958,0.058527,74.125.130.0-255,4320,325794,8,349142
47959,0.058533,172.31.36.0-255,66,325860,8,349142
47960,0.061171,74.125.130.0-255,5738,331598,8,349142
47961,0.061181,172.31.36.0-255,66,331664,8,349142
47962,0.063835,74.125.130.0-255,5738,337402,8,349142
47963,0.06385,172.31.36.0-255,66,337468,8,349142
47964,0.065211,104.244.42.0-255,66,337534,8,349142
47965,0.066484,74.125.130.0-255,5738,343272,8,349142
47966,0.066491,172.31.36.0-255,66,343338,8,349142
47967,0.069152,74.125.130.0-255,5738,349076,8,349142
47968,0.069164,172.31.36.0-255,66,349142,8,349142
47969,0.0,172.217.194.0-255,146,146,8,199256
47970,3e-05,172.31.36.0-255,66,212,8,199256
47971,3.7e-05,172.217.194.0-255,1484,1696,8,199256
47972,4.1e-05,172.31.36.0-255,66,1762,8,199256
47973,4.6e-05,172.217.194.0-255,2902,4664,8,199256
47974,4.8e-05,172.31.36.0-255,66,4730,8,199256
47975,6.1e-05,172.217.194.0-255,2902,7632,8,199256
47976,6.3e-05,172.31.36.0-255,66,7698,8,199256
47977,8.7e-05,172.217.194.0-255,1484,9182,8,199256
47978,9e-05,172.31.36.0-255,66,9248,8,199256
47979,0.000121,172.217.194.0-255,6268,15516,8,199256
47980,0.000125,172.31.36.0-255,66,15582,8,199256
47981,0.000142,172.31.36.0-255,66,15648,8,199256
47982,0.000176,172.217.194.0-255,6797,22445,8,199256
47983,0.00018,172.31.36.0-255,66,22511,8,199256
47984,0.000215,172.217.194.0-255,1484,23995,8,199256
47985,0.000217,172.31.36.0-255,66,24061,8,199256
47986,0.000222,172.217.194.0-255,2902,26963,8,199256
47987,0.000225,172.31.36.0-255,66,27029,8,199256
47988,0.000228,172.217.194.0-255,1484,28513,8,199256
47989,0.000235,172.31.36.0-255,66,28579,8,199256
47990,0.000267,172.217.194.0-255,4320,32899,8,199256
47991,0.000277,172.31.36.0-255,66,32965,8,199256
47992,0.000286,172.217.194.0-255,6797,39762,8,199256
47993,0.000289,172.31.36.0-255,66,39828,8,199256
47994,0.000304,172.31.36.0-255,66,39894,8,199256
47995,0.000308,172.217.194.0-255,2543,42437,8,199256
47996,0.00031,172.31.36.0-255,66,42503,8,199256
47997,0.000344,172.217.194.0-255,364,42867,8,199256
47998,0.000347,172.31.36.0-255,66,42933,8,199256
47999,0.00035,172.217.194.0-255,382,43315,8,199256
48000,0.000606,172.217.194.0-255,1484,44799,8,199256
48001,0.000611,172.31.36.0-255,66,44865,8,199256
48002,0.000631,172.217.194.0-255,2902,47767,8,199256
48003,0.000634,172.31.36.0-255,66,47833,8,199256
48004,0.000641,172.217.194.0-255,5738,53571,8,199256
48005,0.000643,172.31.36.0-255,66,53637,8,199256
48006,0.000677,172.217.194.0-255,7156,60793,8,199256
48007,0.000682,172.31.36.0-255,66,60859,8,199256
48008,0.000713,172.217.194.0-255,5738,66597,8,199256
48009,0.000717,172.31.36.0-255,66,66663,8,199256
48010,0.000736,172.31.36.0-255,66,66729,8,199256
48011,0.00089,172.217.194.0-255,1484,68213,8,199256
48012,0.000897,172.217.194.0-255,2902,71115,8,199256
48013,0.000902,172.31.36.0-255,66,71181,8,199256
48014,0.000909,172.217.194.0-255,5738,76919,8,199256
48015,0.000911,172.31.36.0-255,66,76985,8,199256
48016,0.000926,172.217.194.0-255,7156,84141,8,199256
48017,0.000929,172.31.36.0-255,66,84207,8,199256
48018,0.000936,172.217.194.0-255,5738,89945,8,199256
48019,0.000938,172.31.36.0-255,66,90011,8,199256
48020,0.000979,172.31.36.0-255,66,90077,8,199256
48021,0.000984,172.217.194.0-255,2184,92261,8,199256
48022,0.000986,172.31.36.0-255,66,92327,8,199256
48023,0.001054,172.217.194.0-255,1484,93811,8,199256
48024,0.001059,172.217.194.0-255,2902,96713,8,199256
48025,0.001063,172.31.36.0-255,66,96779,8,199256
48026,0.001067,172.217.194.0-255,1484,98263,8,199256
48027,0.001099,172.217.194.0-255,4320,102583,8,199256
48028,0.001103,172.31.36.0-255,66,102649,8,199256
48029,0.001122,172.31.36.0-255,66,102715,8,199256
48030,0.001162,172.31.36.0-255,66,102781,8,199256
48031,0.001321,172.217.194.0-255,1484,104265,8,199256
48032,0.001328,172.217.194.0-255,2902,107167,8,199256
48033,0.001332,172.31.36.0-255,66,107233,8,199256
48034,0.001338,172.217.194.0-255,4320,111553,8,199256
48035,0.001342,172.31.36.0-255,66,111619,8,199256
48036,0.001365,172.217.194.0-255,1484,113103,8,199256
48037,0.001383,172.31.36.0-255,66,113169,8,199256
48038,0.001395,172.31.36.0-255,66,113235,8,199256
48039,0.001657,172.217.194.0-255,1484,114719,8,199256
48040,0.001661,172.217.194.0-255,2902,117621,8,199256
48041,0.001664,172.31.36.0-255,66,117687,8,199256
48042,0.00169,172.217.194.0-255,5738,123425,8,199256
48043,0.001692,172.31.36.0-255,66,123491,8,199256
48044,0.001695,172.217.194.0-255,1484,124975,8,199256
48045,0.001725,172.31.36.0-255,66,125041,8,199256
48046,0.001752,172.31.36.0-255,66,125107,8,199256
48047,0.001782,172.217.194.0-255,7156,132263,8,199256
48048,0.001784,172.31.36.0-255,66,132329,8,199256
48049,0.001807,172.217.194.0-255,4320,136649,8,199256
48050,0.001809,172.31.36.0-255,66,136715,8,199256
48051,0.001833,172.31.36.0-255,66,136781,8,199256
48052,0.001873,172.217.194.0-255,5738,142519,8,199256
48053,0.001876,172.31.36.0-255,66,142585,8,199256
48054,0.001908,172.217.194.0-255,3602,146187,8,199256
48055,0.001911,172.31.36.0-255,66,146253,8,199256
48056,0.001914,172.217.194.0-255,1484,147737,8,199256
48057,0.001917,172.217.194.0-255,2902,150639,8,199256
48058,0.001919,172.31.36.0-255,66,150705,8,199256
48059,0.001929,172.217.194.0-255,5738,156443,8,199256
48060,0.001931,172.31.36.0-255,66,156509,8,199256
48061,0.001943,172.31.36.0-255,66,156575,8,199256
48062,0.001954,172.31.36.0-255,66,156641,8,199256
48063,0.001999,172.217.194.0-255,7156,163797,8,199256
48064,0.002002,172.31.36.0-255,66,163863,8,199256
48065,0.002035,172.31.36.0-255,66,163929,8,199256
48066,0.002048,172.217.194.0-255,2184,166113,8,199256
48067,0.002054,172.31.36.0-255,66,166179,8,199256
48068,0.002065,172.31.36.0-255,66,166245,8,199256
48069,0.002117,172.217.194.0-255,1484,167729,8,199256
48070,0.002121,172.217.194.0-255,2902,170631,8,199256
48071,0.002123,172.31.36.0-255,66,170697,8,199256
48072,0.002146,172.217.194.0-255,5738,176435,8,199256
48073,0.002149,172.31.36.0-255,66,176501,8,199256
48074,0.002151,172.217.194.0-255,1484,177985,8,199256
48075,0.00216,172.31.36.0-255,66,178051,8,199256
48076,0.002199,172.217.194.0-255,5738,183789,8,199256
48077,0.002201,172.31.36.0-255,66,183855,8,199256
48078,0.002228,172.31.36.0-255,66,183921,8,199256
48079,0.002239,172.31.36.0-255,66,183987,8,199256
48080,0.002261,172.217.194.0-255,2902,186889,8,199256
48081,0.002263,172.31.36.0-255,66,186955,8,199256
48082,0.002285,172.31.36.0-255,66,187021,8,199256
48083,0.002291,172.217.194.0-255,4950,191971,8,199256
48084,0.002293,172.31.36.0-255,66,192037,8,199256
48085,0.002321,172.217.194.0-255,105,192142,8,199256
48086,0.007729,172.31.36.0-255,66,192208,8,199256
48087,0.007757,172.31.36.0-255,105,192313,8,199256
48088,0.009975,172.217.194.0-255,66,192379,8,199256
48089,0.032664,172.31.36.0-255,188,192567,8,199256
48090,0.032713,172.31.36.0-255,955,193522,8,199256
48091,0.032759,172.31.36.0-255,1514,195036,8,199256
48092,0.032761,172.31.36.0-255,1514,196550,8,199256
48093,0.032765,172.31.36.0-255,1514,198064,8,199256
48094,0.032766,172.31.36.0-255,928,198992,8,199256
48095,0.034229,104.244.42.0-255,66,199058,8,199256
48096,0.034259,104.244.42.0-255,66,199124,8,199256
48097,0.034365,104.244.42.0-255,66,199190,8,199256
48098,0.03438,104.244.42.0-255,66,199256,8,199256
48099,0.0,74.125.200.0-255,146,146,8,294971
48100,3.5e-05,172.31.36.0-255,66,212,8,294971
48101,4.2e-05,74.125.200.0-255,1484,1696,8,294971
48102,4.6e-05,172.31.36.0-255,66,1762,8,294971
48103,5.1e-05,74.125.200.0-255,2902,4664,8,294971
48104,6e-05,172.31.36.0-255,66,4730,8,294971
48105,9.3e-05,74.125.200.0-255,5738,10468,8,294971
48106,9.6e-05,172.31.36.0-255,66,10534,8,294971
48107,0.000123,74.125.200.0-255,3440,13974,8,294971
48108,0.000126,172.31.36.0-255,66,14040,8,294971
48109,0.00016,74.125.200.0-255,1484,15524,8,294971
48110,0.000164,172.31.36.0-255,66,15590,8,294971
48111,0.000169,74.125.200.0-255,2902,18492,8,294971
48112,0.000172,172.31.36.0-255,66,18558,8,294971
48113,0.000182,74.125.200.0-255,5738,24296,8,294971
48114,0.000184,172.31.36.0-255,66,24362,8,294971
48115,0.000191,74.125.200.0-255,4320,28682,8,294971
48116,0.000194,172.31.36.0-255,66,28748,8,294971
48117,0.000223,74.125.200.0-255,2543,31291,8,294971
48118,0.000227,172.31.36.0-255,66,31357,8,294971
48119,0.000281,74.125.200.0-255,1484,32841,8,294971
48120,0.000283,172.31.36.0-255,66,32907,8,294971
48121,0.000287,74.125.200.0-255,1484,34391,8,294971
48122,0.00029,74.125.200.0-255,2902,37293,8,294971
48123,0.000292,172.31.36.0-255,66,37359,8,294971
48124,0.000295,172.31.36.0-255,66,37425,8,294971
48125,0.000324,74.125.200.0-255,5738,43163,8,294971
48126,0.000328,172.31.36.0-255,66,43229,8,294971
48127,0.000365,74.125.200.0-255,4320,47549,8,294971
48128,0.000368,172.31.36.0-255,66,47615,8,294971
48129,0.000395,74.125.200.0-255,3961,51576,8,294971
48130,0.000398,172.31.36.0-255,66,51642,8,294971
48131,0.000405,74.125.200.0-255,7156,58798,8,294971
48132,0.000408,172.31.36.0-255,66,58864,8,294971
48133,0.000436,74.125.200.0-255,1484,60348,8,294971
48134,0.000444,74.125.200.0-255,5691,66039,8,294971
48135,0.000447,172.31.36.0-255,66,66105,8,294971
48136,0.00045,74.125.200.0-255,109,66214,8,294971
48137,0.000493,74.125.200.0-255,333,66547,8,294971
48138,0.000833,74.125.200.0-255,1484,68031,8,294971
48139,0.000837,172.31.36.0-255,66,68097,8,294971
48140,0.000864,74.125.200.0-255,2902,70999,8,294971
48141,0.000867,172.31.36.0-255,66,71065,8,294971
48142,0.000873,74.125.200.0-255,5738,76803,8,294971
48143,0.000876,172.31.36.0-255,66,76869,8,294971
48144,0.000918,74.125.200.0-255,4320,81189,8,294971
48145,0.000922,172.31.36.0-255,66,81255,8,294971
48146,0.000959,172.31.36.0-255,66,81321,8,294971
48147,0.00097,172.31.36.0-255,66,81387,8,294971
48148,0.001116,74.125.200.0-255,1484,82871,8,294971
48149,0.00112,74.125.200.0-255,1484,84355,8,294971
48150,0.001125,172.31.36.0-255,66,84421,8,294971
48151,0.001131,74.125.200.0-255,1484,85905,8,294971
48152,0.001153,74.125.200.0-255,5738,91643,8,294971
48153,0.001156,172.31.36.0-255,66,91709,8,294971
48154,0.001163,74.125.200.0-255,5738,97447,8,294971
48155,0.001165,172.31.36.0-255,66,97513,8,294971
48156,0.001192,74.125.200.0-255,1484,98997,8,294971
48157,0.001197,74.125.200.0-255,2902,101899,8,294971
48158,0.001199,172.31.36.0-255,66,101965,8,294971
48159,0.001236,172.31.36.0-255,66,102031,8,294971
48160,0.001254,74.125.200.0-255,3602,105633,8,294971
48161,0.001257,172.31.36.0-255,66,105699,8,294971
48162,0.001953,74.125.200.0-255,1484,107183,8,294971
48163,0.001976,74.125.200.0-255,2902,110085,8,294971
48164,0.00198,172.31.36.0-255,66,110151,8,294971
48165,0.001985,74.125.200.0-255,1484,111635,8,294971
48166,0.002008,74.125.200.0-255,4320,115955,8,294971
48167,0.002011,172.31.36.0-255,66,116021,8,294971
48168,0.002014,74.125.200.0-255,1484,117505,8,294971
48169,0.00204,74.125.200.0-255,2902,120407,8,294971
48170,0.002042,172.31.36.0-255,66,120473,8,294971
48171,0.002048,74.125.200.0-255,4320,124793,8,294971
48172,0.00205,172.31.36.0-255,66,124859,8,294971
48173,0.002079,74.125.200.0-255,1484,126343,8,294971
48174,0.002094,172.31.36.0-255,66,126409,8,294971
48175,0.002097,74.125.200.0-255,766,127175,8,294971
48176,0.004363,74.125.200.0-255,4320,131495,8,294971
48177,0.004369,172.31.36.0-255,66,131561,8,294971
48178,0.006642,74.125.200.0-255,5738,137299,8,294971
48179,0.006648,172.31.36.0-255,66,137365,8,294971
48180,0.008918,74.125.200.0-255,5738,143103,8,294971
48181,0.008925,172.31.36.0-255,66,143169,8,294971
48182,0.011199,74.125.200.0-255,5738,148907,8,294971
48183,0.011207,172.31.36.0-255,66,148973,8,294971
48184,0.013478,74.125.200.0-255,5738,154711,8,294971
48185,0.013484,172.31.36.0-255,66,154777,8,294971
48186,0.015757,74.125.200.0-255,5738,160515,8,294971
48187,0.015766,172.31.36.0-255,66,160581,8,294971
48188,0.018034,74.125.200.0-255,5738,166319,8,294971
48189,0.018042,172.31.36.0-255,66,166385,8,294971
48190,0.020308,74.125.200.0-255,5738,172123,8,294971
48191,0.020317,172.31.36.0-255,66,172189,8,294971
48192,0.022604,74.125.200.0-255,5738,177927,8,294971
48193,0.022611,172.31.36.0-255,66,177993,8,294971
48194,0.024887,74.125.200.0-255,5738,183731,8,294971
48195,0.024894,172.31.36.0-255,66,183797,8,294971
48196,0.027164,74.125.200.0-255,5738,189535,8,294971
48197,0.027172,172.31.36.0-255,66,189601,8,294971
48198,0.029446,74.125.200.0-255,5738,195339,8,294971
48199,0.029453,172.31.36.0-255,66,195405,8,294971
48200,0.031725,74.125.200.0-255,5738,201143,8,294971
48201,0.031733,172.31.36.0-255,66,201209,8,294971
48202,0.034042,74.125.200.0-255,5738,206947,8,294971
48203,0.034049,172.31.36.0-255,66,207013,8,294971
48204,0.03633,74.125.200.0-255,5738,212751,8,294971
48205,0.036338,172.31.36.0-255,66,212817,8,294971
48206,0.038612,74.125.200.0-255,5738,218555,8,294971
48207,0.038621,172.31.36.0-255,66,218621,8,294971
48208,0.040897,74.125.200.0-255,5738,224359,8,294971
48209,0.040905,172.31.36.0-255,66,224425,8,294971
48210,0.041064,172.31.36.0-255,172,224597,8,294971
48211,0.041092,172.31.36.0-255,1110,225707,8,294971
48212,0.04118,172.31.36.0-255,572,226279,8,294971
48213,0.042607,104.244.42.0-255,66,226345,8,294971
48214,0.042653,104.244.42.0-255,66,226411,8,294971
48215,0.042696,104.244.42.0-255,66,226477,8,294971
48216,0.04317,74.125.200.0-255,5738,232215,8,294971
48217,0.043176,172.31.36.0-255,66,232281,8,294971
48218,0.045448,74.125.200.0-255,5738,238019,8,294971
48219,0.045453,172.31.36.0-255,66,238085,8,294971
48220,0.047759,74.125.200.0-255,5738,243823,8,294971
48221,0.047766,172.31.36.0-255,66,243889,8,294971
48222,0.050037,74.125.200.0-255,5738,249627,8,294971
48223,0.050043,172.31.36.0-255,66,249693,8,294971
48224,0.052316,74.125.200.0-255,5738,255431,8,294971
48225,0.052323,172.31.36.0-255,66,255497,8,294971
48226,0.054581,74.125.200.0-255,4320,259817,8,294971
48227,0.054586,172.31.36.0-255,66,259883,8,294971
48228,0.054623,74.125.200.0-255,1484,261367,8,294971
48229,0.056861,74.125.200.0-255,4320,265687,8,294971
48230,0.056867,172.31.36.0-255,66,265753,8,294971
48231,0.059121,74.125.200.0-255,5738,271491,8,294971
48232,0.059126,172.31.36.0-255,66,271557,8,294971
48233,0.061391,74.125.200.0-255,5738,277295,8,294971
48234,0.061396,172.31.36.0-255,66,277361,8,294971
48235,0.063653,74.125.200.0-255,5738,283099,8,294971
48236,0.063658,172.31.36.0-255,66,283165,8,294971
48237,0.065926,74.125.200.0-255,2902,286067,8,294971
48238,0.065932,172.31.36.0-255,66,286133,8,294971
48239,0.065962,74.125.200.0-255,2902,289035,8,294971
48240,0.065965,172.31.36.0-255,66,289101,8,294971
48241,0.068205,74.125.200.0-255,4320,293421,8,294971
48242,0.068209,172.31.36.0-255,66,293487,8,294971
48243,0.068241,74.125.200.0-255,1484,294971,8,294971
48244,0.0,172.217.194.0-255,153,153,8,247394
48245,2.3e-05,172.31.36.0-255,66,219,8,247394
48246,3e-05,172.217.194.0-255,1484,1703,8,247394
48247,3.4e-05,172.31.36.0-255,66,1769,8,247394
48248,6.7e-05,172.217.194.0-255,2902,4671,8,247394
48249,6.9e-05,172.217.194.0-255,1484,6155,8,247394
48250,7.2e-05,172.31.36.0-255,66,6221,8,247394
48251,7.6e-05,172.31.36.0-255,66,6287,8,247394
48252,8.1e-05,172.217.194.0-255,2902,9189,8,247394
48253,8.3e-05,172.31.36.0-255,66,9255,8,247394
48254,0.000104,172.217.194.0-255,4872,14127,8,247394
48255,0.000107,172.31.36.0-255,66,14193,8,247394
48256,0.000144,172.31.36.0-255,66,14259,8,247394
48257,0.000147,172.217.194.0-255,1484,15743,8,247394
48258,0.00015,172.31.36.0-255,66,15809,8,247394
48259,0.000167,172.217.194.0-255,3961,19770,8,247394
48260,0.00017,172.31.36.0-255,66,19836,8,247394
48261,0.000259,172.217.194.0-255,1484,21320,8,247394
48262,0.000264,172.31.36.0-255,66,21386,8,247394
48263,0.000268,172.217.194.0-255,1484,22870,8,247394
48264,0.00027,172.31.36.0-255,66,22936,8,247394
48265,0.000285,172.217.194.0-255,1484,24420,8,247394
48266,0.000288,172.31.36.0-255,66,24486,8,247394
48267,0.000295,172.217.194.0-255,5738,30224,8,247394
48268,0.000297,172.31.36.0-255,66,30290,8,247394
48269,0.0003,172.217.194.0-255,1484,31774,8,247394
48270,0.000303,172.31.36.0-255,66,31840,8,247394
48271,0.000344,172.31.36.0-255,66,31906,8,247394
48272,0.000361,172.217.194.0-255,1484,33390,8,247394
48273,0.000364,172.31.36.0-255,66,33456,8,247394
48274,0.000396,172.31.36.0-255,66,33522,8,247394
48275,0.000434,172.217.194.0-255,1484,35006,8,247394
48276,0.000441,172.217.194.0-255,2902,37908,8,247394
48277,0.000443,172.31.36.0-255,66,37974,8,247394
48278,0.00047,172.217.194.0-255,1484,39458,8,247394
48279,0.000475,172.217.194.0-255,2902,42360,8,247394
48280,0.000477,172.31.36.0-255,66,42426,8,247394
48281,0.000484,172.217.194.0-255,5738,48164,8,247394
48282,0.000486,172.31.36.0-255,66,48230,8,247394
48283,0.000524,172.31.36.0-255,66,48296,8,247394
48284,0.000528,172.217.194.0-255,2902,51198,8,247394
48285,0.000531,172.31.36.0-255,66,51264,8,247394
48286,0.00057,172.217.194.0-255,3917,55181,8,247394
48287,0.000574,172.31.36.0-255,66,55247,8,247394
48288,0.000914,172.217.194.0-255,1484,56731,8,247394
48289,0.00092,172.217.194.0-255,2902,59633,8,247394
48290,0.000923,172.31.36.0-255,66,59699,8,247394
48291,0.000947,172.217.194.0-255,5738,65437,8,247394
48292,0.00095,172.31.36.0-255,66,65503,8,247394
48293,0.000956,172.217.194.0-255,4320,69823,8,247394
48294,0.000958,172.31.36.0-255,66,69889,8,247394
48295,0.001,172.31.36.0-255,66,69955,8,247394
48296,0.001007,172.217.194.0-255,7156,77111,8,247394
48297,0.001009,172.31.36.0-255,66,77177,8,247394
48298,0.001015,172.217.194.0-255,3602,80779,8,247394
48299,0.001019,172.31.36.0-255,66,80845,8,247394
48300,0.001179,172.217.194.0-255,1484,82329,8,247394
48301,0.001194,172.217.194.0-255,2902,85231,8,247394
48302,0.001198,172.31.36.0-255,66,85297,8,247394
48303,0.001204,172.217.194.0-255,4320,89617,8,247394
48304,0.001206,172.31.36.0-255,66,89683,8,247394
48305,0.001221,172.217.194.0-255,1484,91167,8,247394
48306,0.001227,172.217.194.0-255,4320,95487,8,247394
48307,0.001229,172.31.36.0-255,66,95553,8,247394
48308,0.001254,172.217.194.0-255,2902,98455,8,247394
48309,0.001257,172.31.36.0-255,66,98521,8,247394
48310,0.001267,172.31.36.0-255,66,98587,8,247394
48311,0.001271,172.217.194.0-255,4320,102907,8,247394
48312,0.001275,172.31.36.0-255,66,102973,8,247394
48313,0.001294,172.217.194.0-255,3602,106575,8,247394
48314,0.001296,172.31.36.0-255,66,106641,8,247394
48315,0.001333,172.31.36.0-255,66,106707,8,247394
48316,0.00134,172.217.194.0-255,5738,112445,8,247394
48317,0.001342,172.31.36.0-255,66,112511,8,247394
48318,0.001347,172.217.194.0-255,4320,116831,8,247394
48319,0.00135,172.31.36.0-255,66,116897,8,247394
48320,0.001383,172.31.36.0-255,66,116963,8,247394
48321,0.001388,172.217.194.0-255,3602,120565,8,247394
48322,0.00139,172.31.36.0-255,66,120631,8,247394
48323,0.001675,172.217.194.0-255,1484,122115,8,247394
48324,0.001695,172.217.194.0-255,2902,125017,8,247394
48325,0.001698,172.31.36.0-255,66,125083,8,247394
48326,0.001705,172.217.194.0-255,5738,130821,8,247394
48327,0.001707,172.31.36.0-255,66,130887,8,247394
48328,0.001729,172.217.194.0-255,5738,136625,8,247394
48329,0.001732,172.31.36.0-255,66,136691,8,247394
48330,0.001753,172.217.194.0-255,7156,143847,8,247394
48331,0.001756,172.31.36.0-255,66,143913,8,247394
48332,0.001787,172.217.194.0-255,2902,146815,8,247394
48333,0.001791,172.31.36.0-255,66,146881,8,247394
48334,0.001818,172.31.36.0-255,66,146947,8,247394
48335,0.001904,172.217.194.0-255,1484,148431,8,247394
48336,0.001934,172.217.194.0-255,2902,151333,8,247394
48337,0.001937,172.31.36.0-255,66,151399,8,247394
48338,0.001957,172.217.194.0-255,4320,155719,8,247394
48339,0.001961,172.31.36.0-255,66,155785,8,247394
48340,0.001978,172.217.194.0-255,1484,157269,8,247394
48341,0.001982,172.217.194.0-255,1484,158753,8,247394
48342,0.001984,172.31.36.0-255,66,158819,8,247394
48343,0.002016,172.31.36.0-255,66,158885,8,247394
48344,0.002024,172.217.194.0-255,7156,166041,8,247394
48345,0.002026,172.31.36.0-255,66,166107,8,247394
48346,0.002046,172.217.194.0-255,4320,170427,8,247394
48347,0.002049,172.31.36.0-255,66,170493,8,247394
48348,0.002052,172.217.194.0-255,2184,172677,8,247394
48349,0.002054,172.31.36.0-255,66,172743,8,247394
48350,0.0021,172.217.194.0-255,1484,174227,8,247394
48351,0.002105,172.217.194.0-255,2902,177129,8,247394
48352,0.002107,172.31.36.0-255,66,177195,8,247394
48353,0.00211,172.217.194.0-255,1484,178679,8,247394
48354,0.002129,172.217.194.0-255,4320,182999,8,247394
48355,0.002131,172.31.36.0-255,66,183065,8,247394
48356,0.002137,172.217.194.0-255,4320,187385,8,247394
48357,0.002139,172.31.36.0-255,66,187451,8,247394
48358,0.00216,172.217.194.0-255,2902,190353,8,247394
48359,0.002163,172.31.36.0-255,66,190419,8,247394
48360,0.002169,172.217.194.0-255,5738,196157,8,247394
48361,0.002171,172.31.36.0-255,66,196223,8,247394
48362,0.002204,172.217.194.0-255,2184,198407,8,247394
48363,0.002205,172.31.36.0-255,66,198473,8,247394
48364,0.002207,172.217.194.0-255,2902,201375,8,247394
48365,0.002208,172.31.36.0-255,66,201441,8,247394
48366,0.002211,172.31.36.0-255,66,201507,8,247394
48367,0.002244,172.217.194.0-255,7156,208663,8,247394
48368,0.002248,172.31.36.0-255,66,208729,8,247394
48369,0.002253,172.217.194.0-255,4320,213049,8,247394
48370,0.002256,172.31.36.0-255,66,213115,8,247394
48371,0.002279,172.31.36.0-255,66,213181,8,247394
48372,0.002282,172.217.194.0-255,1484,214665,8,247394
48373,0.002316,172.31.36.0-255,66,214731,8,247394
48374,0.002338,172.217.194.0-255,3602,218333,8,247394
48375,0.002341,172.31.36.0-255,66,218399,8,247394
48376,0.002356,172.31.36.0-255,66,218465,8,247394
48377,0.002367,172.31.36.0-255,66,218531,8,247394
48378,0.002411,172.217.194.0-255,4320,222851,8,247394
48379,0.002415,172.31.36.0-255,66,222917,8,247394
48380,0.002458,172.31.36.0-255,66,222983,8,247394
48381,0.002461,172.217.194.0-255,1484,224467,8,247394
48382,0.0025,172.217.194.0-255,7156,231623,8,247394
48383,0.002503,172.31.36.0-255,66,231689,8,247394
48384,0.002526,172.217.194.0-255,5131,236820,8,247394
48385,0.002529,172.31.36.0-255,66,236886,8,247394
48386,0.002533,172.217.194.0-255,105,236991,8,247394
48387,0.003631,172.31.36.0-255,66,237057,8,247394
48388,0.003658,172.31.36.0-255,105,237162,8,247394
48389,0.006272,172.217.194.0-255,66,237228,8,247394
48390,0.038847,172.31.36.0-255,172,237400,8,247394
48391,0.038879,172.31.36.0-255,1110,238510,8,247394
48392,0.039108,172.31.36.0-255,1514,240024,8,247394
48393,0.03911,172.31.36.0-255,1514,241538,8,247394
48394,0.039116,172.31.36.0-255,1514,243052,8,247394
48395,0.039118,172.31.36.0-255,1514,244566,8,247394
48396,0.039142,172.31.36.0-255,1514,246080,8,247394
48397,0.039144,172.31.36.0-255,876,246956,8,247394
48398,0.040367,104.244.42.0-255,66,247022,8,247394
48399,0.040406,104.244.42.0-255,66,247088,8,247394
48400,0.040678,104.244.42.0-255,66,247154,8,247394
48401,0.040733,104.244.42.0-255,66,247220,8,247394
48402,0.048421,172.31.36.0-255,108,247328,8,247394
48403,0.049975,104.244.42.0-255,66,247394,8,247394
48404,0.0,74.125.24.0-255,153,153,8,163437
48405,2.7e-05,172.31.36.0-255,66,219,8,163437
48406,3.3e-05,74.125.24.0-255,1484,1703,8,163437
48407,3.8e-05,172.31.36.0-255,66,1769,8,163437
48408,4.3e-05,74.125.24.0-255,2902,4671,8,163437
48409,4.6e-05,172.31.36.0-255,66,4737,8,163437
48410,5.7e-05,74.125.24.0-255,1484,6221,8,163437
48411,6e-05,172.31.36.0-255,66,6287,8,163437
48412,6.5e-05,74.125.24.0-255,2902,9189,8,163437
48413,6.8e-05,172.31.36.0-255,66,9255,8,163437
48414,0.000104,74.125.24.0-255,4913,14168,8,163437
48415,0.000107,172.31.36.0-255,66,14234,8,163437
48416,0.00011,74.125.24.0-255,1484,15718,8,163437
48417,0.000112,172.31.36.0-255,66,15784,8,163437
48418,0.000136,74.125.24.0-255,4320,20104,8,163437
48419,0.000139,172.31.36.0-255,66,20170,8,163437
48420,0.000151,74.125.24.0-255,7156,27326,8,163437
48421,0.000153,172.31.36.0-255,66,27392,8,163437
48422,0.000199,172.31.36.0-255,66,27458,8,163437
48423,0.000205,74.125.24.0-255,5738,33196,8,163437
48424,0.000207,172.31.36.0-255,66,33262,8,163437
48425,0.000271,74.125.24.0-255,766,34028,8,163437
48426,0.000275,172.31.36.0-255,66,34094,8,163437
48427,0.0003,74.125.24.0-255,1484,35578,8,163437
48428,0.000304,74.125.24.0-255,2902,38480,8,163437
48429,0.000305,172.31.36.0-255,66,38546,8,163437
48430,0.00031,74.125.24.0-255,5738,44284,8,163437
48431,0.00031,172.31.36.0-255,66,44350,8,163437
48432,0.000313,172.31.36.0-255,66,44416,8,163437
48433,0.000348,74.125.24.0-255,7105,51521,8,163437
48434,0.000352,172.31.36.0-255,66,51587,8,163437
48435,0.000653,74.125.24.0-255,1484,53071,8,163437
48436,0.000658,74.125.24.0-255,1484,54555,8,163437
48437,0.000661,172.31.36.0-255,66,54621,8,163437
48438,0.000693,74.125.24.0-255,1484,56105,8,163437
48439,0.000699,74.125.24.0-255,5738,61843,8,163437
48440,0.000702,172.31.36.0-255,66,61909,8,163437
48441,0.000709,74.125.24.0-255,6797,68706,8,163437
48442,0.000711,172.31.36.0-255,66,68772,8,163437
48443,0.000731,172.31.36.0-255,66,68838,8,163437
48444,0.00076,74.125.24.0-255,2902,71740,8,163437
48445,0.000763,172.31.36.0-255,66,71806,8,163437
48446,0.000768,74.125.24.0-255,2543,74349,8,163437
48447,0.00077,172.31.36.0-255,66,74415,8,163437
48448,0.000789,74.125.24.0-255,2902,77317,8,163437
48449,0.000792,172.31.36.0-255,66,77383,8,163437
48450,0.000824,74.125.24.0-255,2902,80285,8,163437
48451,0.000828,172.31.36.0-255,66,80351,8,163437
48452,0.000835,74.125.24.0-255,7156,87507,8,163437
48453,0.000838,172.31.36.0-255,66,87573,8,163437
48454,0.000859,172.31.36.0-255,66,87639,8,163437
48455,0.000866,74.125.24.0-255,6438,94077,8,163437
48456,0.000868,172.31.36.0-255,66,94143,8,163437
48457,0.000898,74.125.24.0-255,1484,95627,8,163437
48458,0.000916,74.125.24.0-255,2902,98529,8,163437
48459,0.000919,172.31.36.0-255,66,98595,8,163437
48460,0.000923,74.125.24.0-255,1484,100079,8,163437
48461,0.000943,74.125.24.0-255,4320,104399,8,163437
48462,0.000947,172.31.36.0-255,66,104465,8,163437
48463,0.000954,74.125.24.0-255,7156,111621,8,163437
48464,0.000956,172.31.36.0-255,66,111687,8,163437
48465,0.000992,172.31.36.0-255,66,111753,8,163437
48466,0.001027,74.125.24.0-255,5738,117491,8,163437
48467,0.001031,172.31.36.0-255,66,117557,8,163437
48468,0.001035,74.125.24.0-255,2184,119741,8,163437
48469,0.001039,172.31.36.0-255,66,119807,8,163437
48470,0.001215,74.125.24.0-255,1484,121291,8,163437
48471,0.001219,74.125.24.0-255,1484,122775,8,163437
48472,0.001222,172.31.36.0-255,66,122841,8,163437
48473,0.001247,74.125.24.0-255,1484,124325,8,163437
48474,0.001253,74.125.24.0-255,5738,130063,8,163437
48475,0.001256,172.31.36.0-255,66,130129,8,163437
48476,0.001262,74.125.24.0-255,4320,134449,8,163437
48477,0.001265,172.31.36.0-255,66,134515,8,163437
48478,0.001286,172.31.36.0-255,66,134581,8,163437
48479,0.001322,172.31.36.0-255,66,134647,8,163437
48480,0.001449,74.125.24.0-255,1484,136131,8,163437
48481,0.001469,74.125.24.0-255,2902,139033,8,163437
48482,0.001473,172.31.36.0-255,66,139099,8,163437
48483,0.001481,74.125.24.0-255,5738,144837,8,163437
48484,0.001483,172.31.36.0-255,66,144903,8,163437
48485,0.001501,172.31.36.0-255,66,144969,8,163437
48486,0.001537,74.125.24.0-255,2902,147871,8,163437
48487,0.001541,172.31.36.0-255,66,147937,8,163437
48488,0.001558,172.31.36.0-255,66,148003,8,163437
48489,0.001648,172.31.36.0-255,66,148069,8,163437
48490,0.001667,172.31.36.0-255,66,148135,8,163437
48491,0.001684,172.31.36.0-255,66,148201,8,163437
48492,0.001717,74.125.24.0-255,5020,153221,8,163437
48493,0.00172,172.31.36.0-255,66,153287,8,163437
48494,0.001739,172.31.36.0-255,66,153353,8,163437
48495,0.001752,172.31.36.0-255,66,153419,8,163437
48496,0.001801,172.31.36.0-255,66,153485,8,163437
48497,0.001844,172.31.36.0-255,66,153551,8,163437
48498,0.001858,172.31.36.0-255,66,153617,8,163437
48499,0.001892,74.125.24.0-255,2184,155801,8,163437
48500,0.001895,172.31.36.0-255,66,155867,8,163437
48501,0.00192,172.31.36.0-255,66,155933,8,163437
48502,0.001923,74.125.24.0-255,105,156038,8,163437
48503,0.003531,172.31.36.0-255,66,156104,8,163437
48504,0.003558,172.31.36.0-255,105,156209,8,163437
48505,0.005545,74.125.24.0-255,66,156275,8,163437
48506,0.029553,172.31.36.0-255,172,156447,8,163437
48507,0.029584,172.31.36.0-255,1111,157558,8,163437
48508,0.029635,172.31.36.0-255,1514,159072,8,163437
48509,0.029637,172.31.36.0-255,1514,160586,8,163437
48510,0.029638,172.31.36.0-255,1514,162100,8,163437
48511,0.029639,172.31.36.0-255,1073,163173,8,163437
48512,0.031078,104.244.42.0-255,66,163239,8,163437
48513,0.031132,104.244.42.0-255,66,163305,8,163437
48514,0.031177,104.244.42.0-255,66,163371,8,163437
48515,0.031182,104.244.42.0-255,66,163437,8,163437
48516,0.0,74.125.24.0-255,153,153,8,281012
48517,2.5e-05,172.31.36.0-255,66,219,8,281012
48518,3.2e-05,74.125.24.0-255,1484,1703,8,281012
48519,3.6e-05,172.31.36.0-255,66,1769,8,281012
48520,4.2e-05,74.125.24.0-255,2902,4671,8,281012
48521,4.6e-05,172.31.36.0-255,66,4737,8,281012
48522,6.2e-05,74.125.24.0-255,7156,11893,8,281012
48523,6.6e-05,172.31.36.0-255,66,11959,8,281012
48524,7.7e-05,172.31.36.0-255,66,12025,8,281012
48525,8e-05,74.125.24.0-255,1484,13509,8,281012
48526,8.3e-05,172.31.36.0-255,66,13575,8,281012
48527,0.000126,172.31.36.0-255,66,13641,8,281012
48528,0.000225,74.125.24.0-255,1484,15125,8,281012
48529,0.000228,172.31.36.0-255,66,15191,8,281012
48530,0.000233,74.125.24.0-255,2902,18093,8,281012
48531,0.000235,172.31.36.0-255,66,18159,8,281012
48532,0.00024,74.125.24.0-255,2902,21061,8,281012
48533,0.000248,172.31.36.0-255,66,21127,8,281012
48534,0.000277,74.125.24.0-255,2902,24029,8,281012
48535,0.000279,172.31.36.0-255,66,24095,8,281012
48536,0.000307,172.31.36.0-255,66,24161,8,281012
48537,0.00032,172.31.36.0-255,66,24227,8,281012
48538,0.000561,74.125.24.0-255,125,24352,8,281012
48539,0.000567,172.31.36.0-255,66,24418,8,281012
48540,0.000628,74.125.24.0-255,1484,25902,8,281012
48541,0.000632,172.31.36.0-255,66,25968,8,281012
48542,0.000637,74.125.24.0-255,2902,28870,8,281012
48543,0.00064,172.31.36.0-255,66,28936,8,281012
48544,0.000643,74.125.24.0-255,1484,30420,8,281012
48545,0.000677,74.125.24.0-255,2902,33322,8,281012
48546,0.00068,172.31.36.0-255,66,33388,8,281012
48547,0.000687,74.125.24.0-255,5738,39126,8,281012
48548,0.000689,172.31.36.0-255,66,39192,8,281012
48549,0.000715,74.125.24.0-255,1484,40676,8,281012
48550,0.00074,74.125.24.0-255,1125,41801,8,281012
48551,0.000742,172.31.36.0-255,66,41867,8,281012
48552,0.000747,74.125.24.0-255,2902,44769,8,281012
48553,0.00075,172.31.36.0-255,66,44835,8,281012
48554,0.000757,74.125.24.0-255,7156,51991,8,281012
48555,0.000763,74.125.24.0-255,4320,56311,8,281012
48556,0.000797,74.125.24.0-255,2543,58854,8,281012
48557,0.000804,172.31.36.0-255,66,58920,8,281012
48558,0.000887,74.125.24.0-255,1484,60404,8,281012
48559,0.000893,74.125.24.0-255,2902,63306,8,281012
48560,0.000899,74.125.24.0-255,4320,67626,8,281012
48561,0.000914,74.125.24.0-255,1484,69110,8,281012
48562,0.000919,74.125.24.0-255,4320,73430,8,281012
48563,0.000927,172.31.36.0-255,66,73496,8,281012
48564,0.000963,74.125.24.0-255,5738,79234,8,281012
48565,0.000978,74.125.24.0-255,5020,84254,8,281012
48566,0.000985,172.31.36.0-255,66,84320,8,281012
48567,0.001082,74.125.24.0-255,1484,85804,8,281012
48568,0.001088,74.125.24.0-255,2902,88706,8,281012
48569,0.001091,172.31.36.0-255,66,88772,8,281012
48570,0.001095,74.125.24.0-255,1484,90256,8,281012
48571,0.001124,74.125.24.0-255,4320,94576,8,281012
48572,0.00113,74.125.24.0-255,5738,100314,8,281012
48573,0.001136,74.125.24.0-255,4320,104634,8,281012
48574,0.001163,172.31.36.0-255,66,104700,8,281012
48575,0.001173,74.125.24.0-255,5020,109720,8,281012
48576,0.001179,172.31.36.0-255,66,109786,8,281012
48577,0.001672,74.125.24.0-255,1484,111270,8,281012
48578,0.001678,74.125.24.0-255,2902,114172,8,281012
48579,0.001681,172.31.36.0-255,66,114238,8,281012
48580,0.001685,74.125.24.0-255,1484,115722,8,281012
48581,0.001714,74.125.24.0-255,4320,120042,8,281012
48582,0.001722,172.31.36.0-255,66,120108,8,281012
48583,0.00175,74.125.24.0-255,1484,121592,8,281012
48584,0.001767,172.31.36.0-255,66,121658,8,281012
48585,0.001775,74.125.24.0-255,1484,123142,8,281012
48586,0.001807,172.31.36.0-255,66,123208,8,281012
48587,0.00189,74.125.24.0-255,1484,124692,8,281012
48588,0.001908,74.125.24.0-255,2902,127594,8,281012
48589,0.001914,74.125.24.0-255,5738,133332,8,281012
48590,0.00193,74.125.24.0-255,4320,137652,8,281012
48591,0.00194,172.31.36.0-255,66,137718,8,281012
48592,0.001951,74.125.24.0-255,4320,142038,8,281012
48593,0.001961,172.31.36.0-255,66,142104,8,281012
48594,0.002013,74.125.24.0-255,7156,149260,8,281012
48595,0.002017,74.125.24.0-255,2902,152162,8,281012
48596,0.002025,172.31.36.0-255,66,152228,8,281012
48597,0.002123,74.125.24.0-255,1484,153712,8,281012
48598,0.002127,74.125.24.0-255,2902,156614,8,281012
48599,0.002133,74.125.24.0-255,5738,162352,8,281012
48600,0.002191,74.125.24.0-255,4320,166672,8,281012
48601,0.008846,172.31.36.0-255,66,166738,8,281012
48602,0.011115,74.125.24.0-255,5738,172476,8,281012
48603,0.011123,172.31.36.0-255,66,172542,8,281012
48604,0.013413,74.125.24.0-255,5738,178280,8,281012
48605,0.013422,172.31.36.0-255,66,178346,8,281012
48606,0.015687,74.125.24.0-255,5738,184084,8,281012
48607,0.015695,172.31.36.0-255,66,184150,8,281012
48608,0.017965,74.125.24.0-255,5738,189888,8,281012
48609,0.017975,172.31.36.0-255,66,189954,8,281012
48610,0.020273,74.125.24.0-255,5738,195692,8,281012
48611,0.020282,172.31.36.0-255,66,195758,8,281012
48612,0.022557,74.125.24.0-255,5738,201496,8,281012
48613,0.022563,172.31.36.0-255,66,201562,8,281012
48614,0.02482,74.125.24.0-255,5738,207300,8,281012
48615,0.024828,172.31.36.0-255,66,207366,8,281012
48616,0.027082,74.125.24.0-255,5738,213104,8,281012
48617,0.027089,172.31.36.0-255,66,213170,8,281012
48618,0.029368,74.125.24.0-255,5738,218908,8,281012
48619,0.029377,172.31.36.0-255,66,218974,8,281012
48620,0.031646,74.125.24.0-255,5738,224712,8,281012
48621,0.031653,172.31.36.0-255,66,224778,8,281012
48622,0.033929,74.125.24.0-255,5738,230516,8,281012
48623,0.033936,172.31.36.0-255,66,230582,8,281012
48624,0.035652,172.31.36.0-255,172,230754,8,281012
48625,0.035685,172.31.36.0-255,1112,231866,8,281012
48626,0.035748,172.31.36.0-255,1514,233380,8,281012
48627,0.03575,172.31.36.0-255,1292,234672,8,281012
48628,0.036206,74.125.24.0-255,5738,240410,8,281012
48629,0.036214,172.31.36.0-255,66,240476,8,281012
48630,0.037214,104.244.42.0-255,66,240542,8,281012
48631,0.03726,104.244.42.0-255,66,240608,8,281012
48632,0.037287,104.244.42.0-255,66,240674,8,281012
48633,0.03851,74.125.24.0-255,5738,246412,8,281012
48634,0.038516,172.31.36.0-255,66,246478,8,281012
48635,0.040765,74.125.24.0-255,5738,252216,8,281012
48636,0.040776,172.31.36.0-255,66,252282,8,281012
48637,0.043075,74.125.24.0-255,5738,258020,8,281012
48638,0.043082,172.31.36.0-255,66,258086,8,281012
48639,0.04536,74.125.24.0-255,5738,263824,8,281012
48640,0.045367,172.31.36.0-255,66,263890,8,281012
48641,0.047636,74.125.24.0-255,5738,269628,8,281012
48642,0.047644,172.31.36.0-255,66,269694,8,281012
48643,0.049945,74.125.24.0-255,5738,275432,8,281012
48644,0.049952,172.31.36.0-255,66,275498,8,281012
48645,0.052219,74.125.24.0-255,5277,280775,8,281012
48646,0.052226,172.31.36.0-255,66,280841,8,281012
48647,0.052429,172.31.36.0-255,105,280946,8,281012
48648,0.054681,74.125.24.0-255,66,281012,8,281012
48649,0.0,74.125.24.0-255,153,153,8,196849
48650,1.3e-05,172.31.36.0-255,66,219,8,196849
48651,2e-05,74.125.24.0-255,1484,1703,8,196849
48652,2.5e-05,172.31.36.0-255,66,1769,8,196849
48653,3.1e-05,74.125.24.0-255,2902,4671,8,196849
48654,3.3e-05,172.31.36.0-255,66,4737,8,196849
48655,4.9e-05,74.125.24.0-255,7156,11893,8,196849
48656,5.3e-05,172.31.36.0-255,66,11959,8,196849
48657,6.5e-05,172.31.36.0-255,66,12025,8,196849
48658,0.000103,74.125.24.0-255,2902,14927,8,196849
48659,0.000106,172.31.36.0-255,66,14993,8,196849
48660,0.000132,172.31.36.0-255,66,15059,8,196849
48661,0.000162,74.125.24.0-255,1484,16543,8,196849
48662,0.000165,172.31.36.0-255,66,16609,8,196849
48663,0.00017,74.125.24.0-255,2902,19511,8,196849
48664,0.000172,172.31.36.0-255,66,19577,8,196849
48665,0.000185,74.125.24.0-255,5738,25315,8,196849
48666,0.000188,172.31.36.0-255,66,25381,8,196849
48667,0.000214,74.125.24.0-255,4320,29701,8,196849
48668,0.000217,172.31.36.0-255,66,29767,8,196849
48669,0.000243,74.125.24.0-255,3961,33728,8,196849
48670,0.00025,172.31.36.0-255,66,33794,8,196849
48671,0.000261,172.31.36.0-255,66,33860,8,196849
48672,0.000295,74.125.24.0-255,7076,40936,8,196849
48673,0.000298,172.31.36.0-255,66,41002,8,196849
48674,0.000325,74.125.24.0-255,131,41133,8,196849
48675,0.000327,172.31.36.0-255,66,41199,8,196849
48676,0.00033,74.125.24.0-255,343,41542,8,196849
48677,0.000332,172.31.36.0-255,66,41608,8,196849
48678,0.00058,74.125.24.0-255,1484,43092,8,196849
48679,0.000588,74.125.24.0-255,2902,45994,8,196849
48680,0.000592,172.31.36.0-255,66,46060,8,196849
48681,0.000599,74.125.24.0-255,5738,51798,8,196849
48682,0.000602,172.31.36.0-255,66,51864,8,196849
48683,0.000615,74.125.24.0-255,5738,57602,8,196849
48684,0.000618,172.31.36.0-255,66,57668,8,196849
48685,0.000653,74.125.24.0-255,7156,64824,8,196849
48686,0.000656,172.31.36.0-255,66,64890,8,196849
48687,0.000667,172.31.36.0-255,66,64956,8,196849
48688,0.000671,74.125.24.0-255,2184,67140,8,196849
48689,0.000674,172.31.36.0-255,66,67206,8,196849
48690,0.000804,74.125.24.0-255,1484,68690,8,196849
48691,0.000824,74.125.24.0-255,2902,71592,8,196849
48692,0.000828,172.31.36.0-255,66,71658,8,196849
48693,0.000835,74.125.24.0-255,4320,75978,8,196849
48694,0.000837,172.31.36.0-255,66,76044,8,196849
48695,0.000863,74.125.24.0-255,1484,77528,8,196849
48696,0.00087,74.125.24.0-255,5738,83266,8,196849
48697,0.000887,74.125.24.0-255,5020,88286,8,196849
48698,0.000907,172.31.36.0-255,66,88352,8,196849
48699,0.000936,74.125.24.0-255,5738,94090,8,196849
48700,0.000944,74.125.24.0-255,5738,99828,8,196849
48701,0.000951,172.31.36.0-255,66,99894,8,196849
48702,0.000959,74.125.24.0-255,1484,101378,8,196849
48703,0.000992,172.31.36.0-255,66,101444,8,196849
48704,0.001029,172.31.36.0-255,66,101510,8,196849
48705,0.001068,74.125.24.0-255,5738,107248,8,196849
48706,0.001089,74.125.24.0-255,4320,111568,8,196849
48707,0.001092,74.125.24.0-255,1484,113052,8,196849
48708,0.001094,172.31.36.0-255,66,113118,8,196849
48709,0.0011,172.31.36.0-255,66,113184,8,196849
48710,0.001153,74.125.24.0-255,7156,120340,8,196849
48711,0.001163,172.31.36.0-255,66,120406,8,196849
48712,0.001232,172.31.36.0-255,66,120472,8,196849
48713,0.001242,74.125.24.0-255,4320,124792,8,196849
48714,0.001249,74.125.24.0-255,766,125558,8,196849
48715,0.00127,172.31.36.0-255,66,125624,8,196849
48716,0.001395,74.125.24.0-255,1484,127108,8,196849
48717,0.001399,74.125.24.0-255,1484,128592,8,196849
48718,0.001412,74.125.24.0-255,1484,130076,8,196849
48719,0.001417,74.125.24.0-255,4320,134396,8,196849
48720,0.001424,172.31.36.0-255,66,134462,8,196849
48721,0.001436,74.125.24.0-255,1484,135946,8,196849
48722,0.00151,172.31.36.0-255,66,136012,8,196849
48723,0.001538,172.31.36.0-255,66,136078,8,196849
48724,0.001571,74.125.24.0-255,1484,137562,8,196849
48725,0.001576,74.125.24.0-255,2902,140464,8,196849
48726,0.001582,74.125.24.0-255,5738,146202,8,196849
48727,0.001591,172.31.36.0-255,66,146268,8,196849
48728,0.001594,74.125.24.0-255,1484,147752,8,196849
48729,0.001652,172.31.36.0-255,66,147818,8,196849
48730,0.001743,74.125.24.0-255,1484,149302,8,196849
48731,0.001748,74.125.24.0-255,2902,152204,8,196849
48732,0.001754,74.125.24.0-255,5738,157942,8,196849
48733,0.001757,74.125.24.0-255,2902,160844,8,196849
48734,0.001771,172.31.36.0-255,66,160910,8,196849
48735,0.001774,74.125.24.0-255,1484,162394,8,196849
48736,0.001848,172.31.36.0-255,66,162460,8,196849
48737,0.00186,74.125.24.0-255,7156,169616,8,196849
48738,0.001865,172.31.36.0-255,66,169682,8,196849
48739,0.001882,74.125.24.0-255,1484,171166,8,196849
48740,0.001907,74.125.24.0-255,1484,172650,8,196849
48741,0.001952,74.125.24.0-255,2184,174834,8,196849
48742,0.001959,74.125.24.0-255,7156,181990,8,196849
48743,0.001962,172.31.36.0-255,66,182056,8,196849
48744,0.001967,172.31.36.0-255,66,182122,8,196849
48745,0.002019,74.125.24.0-255,6438,188560,8,196849
48746,0.002026,74.125.24.0-255,7015,195575,8,196849
48747,0.00207,172.31.36.0-255,66,195641,8,196849
48748,0.002078,74.125.24.0-255,105,195746,8,196849
48749,0.008774,172.31.36.0-255,66,195812,8,196849
48750,0.008814,172.31.36.0-255,105,195917,8,196849
48751,0.010787,74.125.24.0-255,66,195983,8,196849
48752,0.034887,172.31.36.0-255,172,196155,8,196849
48753,0.034922,172.31.36.0-255,562,196717,8,196849
48754,0.036454,104.244.42.0-255,66,196783,8,196849
48755,0.036485,104.244.42.0-255,66,196849,8,196849
48756,0.0,172.217.194.0-255,153,153,8,278554
48757,1.4e-05,172.31.36.0-255,66,219,8,278554
48758,2.1e-05,172.217.194.0-255,1484,1703,8,278554
48759,2.4e-05,172.31.36.0-255,66,1769,8,278554
48760,3e-05,172.217.194.0-255,2902,4671,8,278554
48761,3.3e-05,172.31.36.0-255,66,4737,8,278554
48762,4.9e-05,172.217.194.0-255,7156,11893,8,278554
48763,5.3e-05,172.31.36.0-255,66,11959,8,278554
48764,5.9e-05,172.217.194.0-255,3451,15410,8,278554
48765,6.2e-05,172.31.36.0-255,66,15476,8,278554
48766,6.5e-05,172.217.194.0-255,1484,16960,8,278554
48767,6.8e-05,172.31.36.0-255,66,17026,8,278554
48768,0.000119,172.31.36.0-255,66,17092,8,278554
48769,0.000123,172.217.194.0-255,2543,19635,8,278554
48770,0.000125,172.31.36.0-255,66,19701,8,278554
48771,0.000168,172.217.194.0-255,1484,21185,8,278554
48772,0.000171,172.31.36.0-255,66,21251,8,278554
48773,0.000183,172.217.194.0-255,1484,22735,8,278554
48774,0.00019,172.31.36.0-255,66,22801,8,278554
48775,0.000215,172.217.194.0-255,1484,24285,8,278554
48776,0.000218,172.31.36.0-255,66,24351,8,278554
48777,0.000224,172.217.194.0-255,5738,30089,8,278554
48778,0.000227,172.31.36.0-255,66,30155,8,278554
48779,0.000267,172.31.36.0-255,66,30221,8,278554
48780,0.000283,172.31.36.0-255,66,30287,8,278554
48781,0.000286,172.217.194.0-255,113,30400,8,278554
48782,0.000289,172.31.36.0-255,66,30466,8,278554
48783,0.000329,172.217.194.0-255,387,30853,8,278554
48784,0.000331,172.31.36.0-255,66,30919,8,278554
48785,0.000659,172.217.194.0-255,1484,32403,8,278554
48786,0.000667,172.217.194.0-255,2902,35305,8,278554
48787,0.000672,172.31.36.0-255,66,35371,8,278554
48788,0.000679,172.217.194.0-255,5738,41109,8,278554
48789,0.000681,172.31.36.0-255,66,41175,8,278554
48790,0.000745,172.31.36.0-255,66,41241,8,278554
48791,0.000758,172.31.36.0-255,66,41307,8,278554
48792,0.001082,172.217.194.0-255,1484,42791,8,278554
48793,0.001088,172.217.194.0-255,2902,45693,8,278554
48794,0.001092,172.31.36.0-255,66,45759,8,278554
48795,0.001098,172.217.194.0-255,4320,50079,8,278554
48796,0.0011,172.31.36.0-255,66,50145,8,278554
48797,0.001117,172.217.194.0-255,1484,51629,8,278554
48798,0.00112,172.217.194.0-255,1484,53113,8,278554
48799,0.001127,172.31.36.0-255,66,53179,8,278554
48800,0.001165,172.31.36.0-255,66,53245,8,278554
48801,0.001178,172.31.36.0-255,66,53311,8,278554
48802,0.001878,172.217.194.0-255,1484,54795,8,278554
48803,0.001887,172.217.194.0-255,2902,57697,8,278554
48804,0.001891,172.31.36.0-255,66,57763,8,278554
48805,0.001898,172.217.194.0-255,5738,63501,8,278554
48806,0.0019,172.31.36.0-255,66,63567,8,278554
48807,0.001936,172.31.36.0-255,66,63633,8,278554
48808,0.001941,172.217.194.0-255,2902,66535,8,278554
48809,0.001943,172.31.36.0-255,66,66601,8,278554
48810,0.00198,172.31.36.0-255,66,66667,8,278554
48811,0.002007,172.217.194.0-255,1484,68151,8,278554
48812,0.002011,172.217.194.0-255,1484,69635,8,278554
48813,0.002013,172.31.36.0-255,66,69701,8,278554
48814,0.002037,172.217.194.0-255,1484,71185,8,278554
48815,0.00204,172.217.194.0-255,1484,72669,8,278554
48816,0.002042,172.31.36.0-255,66,72735,8,278554
48817,0.00207,172.217.194.0-255,4320,77055,8,278554
48818,0.002072,172.31.36.0-255,66,77121,8,278554
48819,0.002087,172.31.36.0-255,66,77187,8,278554
48820,0.002096,172.217.194.0-255,7156,84343,8,278554
48821,0.0021,172.31.36.0-255,66,84409,8,278554
48822,0.002135,172.217.194.0-255,3602,88011,8,278554
48823,0.002137,172.31.36.0-255,66,88077,8,278554
48824,0.002158,172.217.194.0-255,7156,95233,8,278554
48825,0.002163,172.31.36.0-255,66,95299,8,278554
48826,0.002165,172.31.36.0-255,66,95365,8,278554
48827,0.002186,172.217.194.0-255,1484,96849,8,278554
48828,0.002222,172.31.36.0-255,66,96915,8,278554
48829,0.002249,172.217.194.0-255,5738,102653,8,278554
48830,0.002252,172.31.36.0-255,66,102719,8,278554
48831,0.004456,172.217.194.0-255,5738,108457,8,278554
48832,0.004464,172.31.36.0-255,66,108523,8,278554
48833,0.00669,172.217.194.0-255,2902,111425,8,278554
48834,0.006694,172.31.36.0-255,66,111491,8,278554
48835,0.006719,172.217.194.0-255,2902,114393,8,278554
48836,0.006722,172.31.36.0-255,66,114459,8,278554
48837,0.008963,172.217.194.0-255,5738,120197,8,278554
48838,0.008971,172.31.36.0-255,66,120263,8,278554
48839,0.011187,172.217.194.0-255,5738,126001,8,278554
48840,0.011196,172.31.36.0-255,66,126067,8,278554
48841,0.0134,172.217.194.0-255,4320,130387,8,278554
48842,0.013407,172.31.36.0-255,66,130453,8,278554
48843,0.013438,172.217.194.0-255,1484,131937,8,278554
48844,0.015633,172.217.194.0-255,4320,136257,8,278554
48845,0.015644,172.31.36.0-255,66,136323,8,278554
48846,0.017879,172.217.194.0-255,5738,142061,8,278554
48847,0.017888,172.31.36.0-255,66,142127,8,278554
48848,0.020121,172.217.194.0-255,5738,147865,8,278554
48849,0.020134,172.31.36.0-255,66,147931,8,278554
48850,0.022369,172.217.194.0-255,5738,153669,8,278554
48851,0.022379,172.31.36.0-255,66,153735,8,278554
48852,0.024608,172.217.194.0-255,5738,159473,8,278554
48853,0.024616,172.31.36.0-255,66,159539,8,278554
48854,0.026853,172.217.194.0-255,5738,165277,8,278554
48855,0.026863,172.31.36.0-255,66,165343,8,278554
48856,0.029106,172.217.194.0-255,5738,171081,8,278554
48857,0.029113,172.31.36.0-255,66,171147,8,278554
48858,0.031329,172.217.194.0-255,5738,176885,8,278554
48859,0.031339,172.31.36.0-255,66,176951,8,278554
48860,0.033573,172.217.194.0-255,5738,182689,8,278554
48861,0.033582,172.31.36.0-255,66,182755,8,278554
48862,0.035784,172.217.194.0-255,5738,188493,8,278554
48863,0.035792,172.31.36.0-255,66,188559,8,278554
48864,0.038012,172.217.194.0-255,5738,194297,8,278554
48865,0.038019,172.31.36.0-255,66,194363,8,278554
48866,0.040245,172.217.194.0-255,5738,200101,8,278554
48867,0.040253,172.31.36.0-255,66,200167,8,278554
48868,0.042462,172.217.194.0-255,4320,204487,8,278554
48869,0.042469,172.31.36.0-255,66,204553,8,278554
48870,0.042497,172.217.194.0-255,1484,206037,8,278554
48871,0.044676,172.217.194.0-255,4320,210357,8,278554
48872,0.044683,172.31.36.0-255,66,210423,8,278554
48873,0.046936,172.217.194.0-255,5738,216161,8,278554
48874,0.046943,172.31.36.0-255,66,216227,8,278554
48875,0.049184,172.217.194.0-255,5738,221965,8,278554
48876,0.049192,172.31.36.0-255,66,222031,8,278554
48877,0.051434,172.217.194.0-255,5738,227769,8,278554
48878,0.051441,172.31.36.0-255,66,227835,8,278554
48879,0.053673,172.217.194.0-255,5738,233573,8,278554
48880,0.05368,172.31.36.0-255,66,233639,8,278554
48881,0.055861,172.31.36.0-255,188,233827,8,278554
48882,0.05589,172.31.36.0-255,955,234782,8,278554
48883,0.0559,172.217.194.0-255,2902,237684,8,278554
48884,0.055919,172.217.194.0-255,2902,240586,8,278554
48885,0.055924,172.31.36.0-255,66,240652,8,278554
48886,0.055926,172.31.36.0-255,66,240718,8,278554
48887,0.056035,172.31.36.0-255,1514,242232,8,278554
48888,0.056056,172.31.36.0-255,1514,243746,8,278554
48889,0.056075,172.31.36.0-255,77,243823,8,278554
48890,0.057431,104.244.42.0-255,66,243889,8,278554
48891,0.057474,104.244.42.0-255,66,243955,8,278554
48892,0.057615,104.244.42.0-255,66,244021,8,278554
48893,0.057626,104.244.42.0-255,66,244087,8,278554
48894,0.058147,172.217.194.0-255,5738,249825,8,278554
48895,0.058152,172.31.36.0-255,66,249891,8,278554
48896,0.060399,172.217.194.0-255,5738,255629,8,278554
48897,0.060405,172.31.36.0-255,66,255695,8,278554
48898,0.062649,172.217.194.0-255,5738,261433,8,278554
48899,0.062654,172.31.36.0-255,66,261499,8,278554
48900,0.064898,172.217.194.0-255,5738,267237,8,278554
48901,0.064905,172.31.36.0-255,66,267303,8,278554
48902,0.067131,172.217.194.0-255,5738,273041,8,278554
48903,0.067138,172.31.36.0-255,66,273107,8,278554
48904,0.069357,172.217.194.0-255,5276,278383,8,278554
48905,0.069362,172.31.36.0-255,66,278449,8,278554
48906,0.069527,172.31.36.0-255,105,278554,8,278554
48907,0.0,74.125.24.0-255,153,153,8,281955
48908,3.3e-05,172.31.36.0-255,66,219,8,281955
48909,3.9e-05,74.125.24.0-255,1484,1703,8,281955
48910,4.2e-05,172.31.36.0-255,66,1769,8,281955
48911,4.7e-05,74.125.24.0-255,2902,4671,8,281955
48912,5e-05,172.31.36.0-255,66,4737,8,281955
48913,5.6e-05,74.125.24.0-255,7156,11893,8,281955
48914,5.8e-05,172.31.36.0-255,66,11959,8,281955
48915,6.7e-05,172.31.36.0-255,66,12025,8,281955
48916,9.3e-05,172.31.36.0-255,66,12091,8,281955
48917,0.000111,74.125.24.0-255,2543,14634,8,281955
48918,0.000113,172.31.36.0-255,66,14700,8,281955
48919,0.000204,74.125.24.0-255,1484,16184,8,281955
48920,0.000207,172.31.36.0-255,66,16250,8,281955
48921,0.00022,74.125.24.0-255,2902,19152,8,281955
48922,0.000222,172.31.36.0-255,66,19218,8,281955
48923,0.000228,74.125.24.0-255,5738,24956,8,281955
48924,0.00023,172.31.36.0-255,66,25022,8,281955
48925,0.000269,172.31.36.0-255,66,25088,8,281955
48926,0.000286,74.125.24.0-255,1484,26572,8,281955
48927,0.000288,172.31.36.0-255,66,26638,8,281955
48928,0.000319,172.31.36.0-255,66,26704,8,281955
48929,0.000321,74.125.24.0-255,387,27091,8,281955
48930,0.000325,172.31.36.0-255,66,27157,8,281955
48931,0.000424,74.125.24.0-255,1484,28641,8,281955
48932,0.000427,172.31.36.0-255,66,28707,8,281955
48933,0.000432,74.125.24.0-255,2902,31609,8,281955
48934,0.000434,172.31.36.0-255,66,31675,8,281955
48935,0.000437,74.125.24.0-255,1484,33159,8,281955
48936,0.000459,74.125.24.0-255,4320,37479,8,281955
48937,0.000463,172.31.36.0-255,66,37545,8,281955
48938,0.000463,74.125.24.0-255,4320,41865,8,281955
48939,0.000465,172.31.36.0-255,66,41931,8,281955
48940,0.000494,172.31.36.0-255,66,41997,8,281955
48941,0.000506,172.31.36.0-255,66,42063,8,281955
48942,0.001115,74.125.24.0-255,1484,43547,8,281955
48943,0.001124,74.125.24.0-255,2902,46449,8,281955
48944,0.001127,172.31.36.0-255,66,46515,8,281955
48945,0.001134,74.125.24.0-255,5738,52253,8,281955
48946,0.001136,172.31.36.0-255,66,52319,8,281955
48947,0.001186,74.125.24.0-255,6683,59002,8,281955
48948,0.00119,172.31.36.0-255,66,59068,8,281955
48949,0.001552,74.125.24.0-255,1484,60552,8,281955
48950,0.001561,74.125.24.0-255,2902,63454,8,281955
48951,0.001564,172.31.36.0-255,66,63520,8,281955
48952,0.001568,74.125.24.0-255,1484,65004,8,281955
48953,0.001587,74.125.24.0-255,4320,69324,8,281955
48954,0.001589,172.31.36.0-255,66,69390,8,281955
48955,0.001615,74.125.24.0-255,6920,76310,8,281955
48956,0.001617,172.31.36.0-255,66,76376,8,281955
48957,0.001683,74.125.24.0-255,1484,77860,8,281955
48958,0.001707,74.125.24.0-255,2902,80762,8,281955
48959,0.001711,74.125.24.0-255,2902,83664,8,281955
48960,0.001714,172.31.36.0-255,66,83730,8,281955
48961,0.001717,172.31.36.0-255,66,83796,8,281955
48962,0.001727,74.125.24.0-255,2902,86698,8,281955
48963,0.001729,172.31.36.0-255,66,86764,8,281955
48964,0.001743,74.125.24.0-255,2902,89666,8,281955
48965,0.001745,172.31.36.0-255,66,89732,8,281955
48966,0.001772,172.31.36.0-255,66,89798,8,281955
48967,0.001777,74.125.24.0-255,5738,95536,8,281955
48968,0.001778,172.31.36.0-255,66,95602,8,281955
48969,0.001811,74.125.24.0-255,2902,98504,8,281955
48970,0.001813,172.31.36.0-255,66,98570,8,281955
48971,0.00183,74.125.24.0-255,2184,100754,8,281955
48972,0.001832,172.31.36.0-255,66,100820,8,281955
48973,0.004,74.125.24.0-255,2902,103722,8,281955
48974,0.004005,172.31.36.0-255,66,103788,8,281955
48975,0.004051,74.125.24.0-255,2902,106690,8,281955
48976,0.004054,172.31.36.0-255,66,106756,8,281955
48977,0.006196,74.125.24.0-255,2902,109658,8,281955
48978,0.006202,172.31.36.0-255,66,109724,8,281955
48979,0.006258,74.125.24.0-255,2902,112626,8,281955
48980,0.006262,172.31.36.0-255,66,112692,8,281955
48981,0.008432,74.125.24.0-255,2902,115594,8,281955
48982,0.008441,172.31.36.0-255,66,115660,8,281955
48983,0.008494,74.125.24.0-255,2902,118562,8,281955
48984,0.008499,172.31.36.0-255,66,118628,8,281955
48985,0.010642,74.125.24.0-255,2902,121530,8,281955
48986,0.010648,172.31.36.0-255,66,121596,8,281955
48987,0.010747,74.125.24.0-255,2902,124498,8,281955
48988,0.010753,172.31.36.0-255,66,124564,8,281955
48989,0.012879,74.125.24.0-255,2902,127466,8,281955
48990,0.012889,172.31.36.0-255,66,127532,8,281955
48991,0.012932,74.125.24.0-255,2902,130434,8,281955
48992,0.012936,172.31.36.0-255,66,130500,8,281955
48993,0.015116,74.125.24.0-255,2902,133402,8,281955
48994,0.015123,172.31.36.0-255,66,133468,8,281955
48995,0.015175,74.125.24.0-255,2902,136370,8,281955
48996,0.015179,172.31.36.0-255,66,136436,8,281955
48997,0.017335,74.125.24.0-255,2902,139338,8,281955
48998,0.017341,172.31.36.0-255,66,139404,8,281955
48999,0.017418,74.125.24.0-255,2902,142306,8,281955
49000,0.017423,172.31.36.0-255,66,142372,8,281955
49001,0.019585,74.125.24.0-255,2902,145274,8,281955
49002,0.019591,172.31.36.0-255,66,145340,8,281955
49003,0.019653,74.125.24.0-255,2902,148242,8,281955
49004,0.019657,172.31.36.0-255,66,148308,8,281955
49005,0.021882,74.125.24.0-255,5738,154046,8,281955
49006,0.021889,172.31.36.0-255,66,154112,8,281955
49007,0.024169,74.125.24.0-255,5738,159850,8,281955
49008,0.024177,172.31.36.0-255,66,159916,8,281955
49009,0.026376,74.125.24.0-255,5738,165654,8,281955
49010,0.026383,172.31.36.0-255,66,165720,8,281955
49011,0.026631,172.31.36.0-255,172,165892,8,281955
49012,0.026672,172.31.36.0-255,1110,167002,8,281955
49013,0.02675,172.31.36.0-255,1514,168516,8,281955
49014,0.026753,172.31.36.0-255,1514,170030,8,281955
49015,0.026756,172.31.36.0-255,1451,171481,8,281955
49016,0.028211,104.244.42.0-255,66,171547,8,281955
49017,0.028264,104.244.42.0-255,66,171613,8,281955
49018,0.028313,104.244.42.0-255,66,171679,8,281955
49019,0.028659,74.125.24.0-255,5738,177417,8,281955
49020,0.028663,172.31.36.0-255,66,177483,8,281955
49021,0.030904,74.125.24.0-255,5738,183221,8,281955
49022,0.030911,172.31.36.0-255,66,183287,8,281955
49023,0.033109,74.125.24.0-255,5738,189025,8,281955
49024,0.033116,172.31.36.0-255,66,189091,8,281955
49025,0.035336,74.125.24.0-255,5738,194829,8,281955
49026,0.035342,172.31.36.0-255,66,194895,8,281955
49027,0.037565,74.125.24.0-255,5738,200633,8,281955
49028,0.037573,172.31.36.0-255,66,200699,8,281955
49029,0.039766,74.125.24.0-255,5738,206437,8,281955
49030,0.039787,172.31.36.0-255,66,206503,8,281955
49031,0.041985,74.125.24.0-255,5738,212241,8,281955
49032,0.041991,172.31.36.0-255,66,212307,8,281955
49033,0.044219,74.125.24.0-255,5738,218045,8,281955
49034,0.044225,172.31.36.0-255,66,218111,8,281955
49035,0.046459,74.125.24.0-255,5738,223849,8,281955
49036,0.046464,172.31.36.0-255,66,223915,8,281955
49037,0.048706,74.125.24.0-255,5738,229653,8,281955
49038,0.048713,172.31.36.0-255,66,229719,8,281955
49039,0.05102,74.125.24.0-255,5738,235457,8,281955
49040,0.05103,172.31.36.0-255,66,235523,8,281955
49041,0.053275,74.125.24.0-255,5738,241261,8,281955
49042,0.053289,172.31.36.0-255,66,241327,8,281955
49043,0.055476,74.125.24.0-255,5738,247065,8,281955
49044,0.055488,172.31.36.0-255,66,247131,8,281955
49045,0.057737,74.125.24.0-255,5738,252869,8,281955
49046,0.057748,172.31.36.0-255,66,252935,8,281955
49047,0.059985,74.125.24.0-255,5738,258673,8,281955
49048,0.059992,172.31.36.0-255,66,258739,8,281955
49049,0.06223,74.125.24.0-255,5738,264477,8,281955
49050,0.062237,172.31.36.0-255,66,264543,8,281955
49051,0.064455,74.125.24.0-255,5738,270281,8,281955
49052,0.064465,172.31.36.0-255,66,270347,8,281955
49053,0.066687,74.125.24.0-255,5738,276085,8,281955
49054,0.0667,172.31.36.0-255,66,276151,8,281955
49055,0.068929,74.125.24.0-255,5738,281889,8,281955
49056,0.068945,172.31.36.0-255,66,281955,8,281955
49057,0.0,74.125.200.0-255,150,150,8,384199
49058,2.2e-05,172.31.36.0-255,66,216,8,384199
49059,3e-05,74.125.200.0-255,1484,1700,8,384199
49060,3.4e-05,172.31.36.0-255,66,1766,8,384199
49061,4e-05,74.125.200.0-255,2902,4668,8,384199
49062,4.3e-05,172.31.36.0-255,66,4734,8,384199
49063,4.8e-05,74.125.200.0-255,2902,7636,8,384199
49064,5.1e-05,172.31.36.0-255,66,7702,8,384199
49065,7.6e-05,74.125.200.0-255,4320,12022,8,384199
49066,7.9e-05,172.31.36.0-255,66,12088,8,384199
49067,0.000102,74.125.200.0-255,2054,14142,8,384199
49068,0.000104,172.31.36.0-255,66,14208,8,384199
49069,0.000121,74.125.200.0-255,2902,17110,8,384199
49070,0.000123,172.31.36.0-255,66,17176,8,384199
49071,0.000127,74.125.200.0-255,2902,20078,8,384199
49072,0.00013,172.31.36.0-255,66,20144,8,384199
49073,0.000152,74.125.200.0-255,4320,24464,8,384199
49074,0.000154,172.31.36.0-255,66,24530,8,384199
49075,0.000158,74.125.200.0-255,1484,26014,8,384199
49076,0.00016,172.31.36.0-255,66,26080,8,384199
49077,0.000195,172.31.36.0-255,66,26146,8,384199
49078,0.000198,74.125.200.0-255,1484,27630,8,384199
49079,0.0002,172.31.36.0-255,66,27696,8,384199
49080,0.000231,172.31.36.0-255,66,27762,8,384199
49081,0.000255,74.125.200.0-255,1484,29246,8,384199
49082,0.000257,172.31.36.0-255,66,29312,8,384199
49083,0.000278,74.125.200.0-255,2902,32214,8,384199
49084,0.000281,172.31.36.0-255,66,32280,8,384199
49085,0.000295,74.125.200.0-255,1484,33764,8,384199
49086,0.000298,172.31.36.0-255,66,33830,8,384199
49087,0.000325,74.125.200.0-255,4320,38150,8,384199
49088,0.000328,172.31.36.0-255,66,38216,8,384199
49089,0.000332,74.125.200.0-255,2902,41118,8,384199
49090,0.000334,172.31.36.0-255,66,41184,8,384199
49091,0.000367,74.125.200.0-255,1484,42668,8,384199
49092,0.000382,74.125.200.0-255,3122,45790,8,384199
49093,0.000385,172.31.36.0-255,66,45856,8,384199
49094,0.000738,74.125.200.0-255,1484,47340,8,384199
49095,0.000753,74.125.200.0-255,2902,50242,8,384199
49096,0.000757,172.31.36.0-255,66,50308,8,384199
49097,0.000763,74.125.200.0-255,2902,53210,8,384199
49098,0.000765,172.31.36.0-255,66,53276,8,384199
49099,0.000777,74.125.200.0-255,1484,54760,8,384199
49100,0.000808,74.125.200.0-255,5738,60498,8,384199
49101,0.00081,172.31.36.0-255,66,60564,8,384199
49102,0.000836,74.125.200.0-255,2902,63466,8,384199
49103,0.000838,172.31.36.0-255,66,63532,8,384199
49104,0.000846,74.125.200.0-255,5738,69270,8,384199
49105,0.000848,172.31.36.0-255,66,69336,8,384199
49106,0.000855,74.125.200.0-255,7156,76492,8,384199
49107,0.000858,172.31.36.0-255,66,76558,8,384199
49108,0.000863,74.125.200.0-255,3602,80160,8,384199
49109,0.000865,172.31.36.0-255,66,80226,8,384199
49110,0.001149,74.125.200.0-255,1484,81710,8,384199
49111,0.001182,74.125.200.0-255,2902,84612,8,384199
49112,0.001186,172.31.36.0-255,66,84678,8,384199
49113,0.001192,74.125.200.0-255,2902,87580,8,384199
49114,0.001194,172.31.36.0-255,66,87646,8,384199
49115,0.00121,74.125.200.0-255,2902,90548,8,384199
49116,0.001212,172.31.36.0-255,66,90614,8,384199
49117,0.001218,74.125.200.0-255,4320,94934,8,384199
49118,0.00122,172.31.36.0-255,66,95000,8,384199
49119,0.001246,74.125.200.0-255,5738,100738,8,384199
49120,0.001249,172.31.36.0-255,66,100804,8,384199
49121,0.001256,74.125.200.0-255,5738,106542,8,384199
49122,0.001258,172.31.36.0-255,66,106608,8,384199
49123,0.001302,74.125.200.0-255,5738,112346,8,384199
49124,0.001309,172.31.36.0-255,66,112412,8,384199
49125,0.001319,74.125.200.0-255,1484,113896,8,384199
49126,0.001322,74.125.200.0-255,766,114662,8,384199
49127,0.001324,172.31.36.0-255,66,114728,8,384199
49128,0.001429,74.125.200.0-255,1484,116212,8,384199
49129,0.001434,74.125.200.0-255,2902,119114,8,384199
49130,0.001438,172.31.36.0-255,66,119180,8,384199
49131,0.001446,74.125.200.0-255,5738,124918,8,384199
49132,0.001448,172.31.36.0-255,66,124984,8,384199
49133,0.001476,74.125.200.0-255,5738,130722,8,384199
49134,0.001479,172.31.36.0-255,66,130788,8,384199
49135,0.001486,74.125.200.0-255,7156,137944,8,384199
49136,0.001489,172.31.36.0-255,66,138010,8,384199
49137,0.001526,74.125.200.0-255,4320,142330,8,384199
49138,0.001529,172.31.36.0-255,66,142396,8,384199
49139,0.001554,74.125.200.0-255,6438,148834,8,384199
49140,0.001557,172.31.36.0-255,66,148900,8,384199
49141,0.001632,74.125.200.0-255,1484,150384,8,384199
49142,0.001648,74.125.200.0-255,2902,153286,8,384199
49143,0.001651,172.31.36.0-255,66,153352,8,384199
49144,0.001658,74.125.200.0-255,4320,157672,8,384199
49145,0.00166,172.31.36.0-255,66,157738,8,384199
49146,0.001681,74.125.200.0-255,1484,159222,8,384199
49147,0.001688,74.125.200.0-255,5738,164960,8,384199
49148,0.00169,172.31.36.0-255,66,165026,8,384199
49149,0.001696,74.125.200.0-255,5738,170764,8,384199
49150,0.001698,172.31.36.0-255,66,170830,8,384199
49151,0.001718,74.125.200.0-255,1484,172314,8,384199
49152,0.001724,74.125.200.0-255,4320,176634,8,384199
49153,0.001727,172.31.36.0-255,66,176700,8,384199
49154,0.001746,74.125.200.0-255,6438,183138,8,384199
49155,0.001748,172.31.36.0-255,66,183204,8,384199
49156,0.00179,74.125.200.0-255,4320,187524,8,384199
49157,0.001792,172.31.36.0-255,66,187590,8,384199
49158,0.001817,74.125.200.0-255,7156,194746,8,384199
49159,0.001821,172.31.36.0-255,66,194812,8,384199
49160,0.001843,172.31.36.0-255,66,194878,8,384199
49161,0.001865,74.125.200.0-255,2902,197780,8,384199
49162,0.001868,172.31.36.0-255,66,197846,8,384199
49163,0.001872,74.125.200.0-255,1484,199330,8,384199
49164,0.001902,172.31.36.0-255,66,199396,8,384199
49165,0.001918,74.125.200.0-255,1484,200880,8,384199
49166,0.001942,74.125.200.0-255,2902,203782,8,384199
49167,0.001945,172.31.36.0-255,66,203848,8,384199
49168,0.001973,74.125.200.0-255,5738,209586,8,384199
49169,0.001977,172.31.36.0-255,66,209652,8,384199
49170,0.002031,74.125.200.0-255,7156,216808,8,384199
49171,0.002036,172.31.36.0-255,66,216874,8,384199
49172,0.00204,74.125.200.0-255,2902,219776,8,384199
49173,0.002043,172.31.36.0-255,66,219842,8,384199
49174,0.002067,74.125.200.0-255,1484,221326,8,384199
49175,0.002081,74.125.200.0-255,2902,224228,8,384199
49176,0.002084,172.31.36.0-255,66,224294,8,384199
49177,0.002092,74.125.200.0-255,7156,231450,8,384199
49178,0.002094,172.31.36.0-255,66,231516,8,384199
49179,0.002115,74.125.200.0-255,2184,233700,8,384199
49180,0.002117,172.31.36.0-255,66,233766,8,384199
49181,0.002261,74.125.200.0-255,1484,235250,8,384199
49182,0.002267,74.125.200.0-255,2902,238152,8,384199
49183,0.00227,172.31.36.0-255,66,238218,8,384199
49184,0.002283,74.125.200.0-255,1484,239702,8,384199
49185,0.0023,74.125.200.0-255,4320,244022,8,384199
49186,0.002303,172.31.36.0-255,66,244088,8,384199
49187,0.002363,74.125.200.0-255,5738,249826,8,384199
49188,0.002368,172.31.36.0-255,66,249892,8,384199
49189,0.002389,74.125.200.0-255,7156,257048,8,384199
49190,0.002392,172.31.36.0-255,66,257114,8,384199
49191,0.002396,74.125.200.0-255,4320,261434,8,384199
49192,0.002399,172.31.36.0-255,66,261500,8,384199
49193,0.002403,74.125.200.0-255,2902,264402,8,384199
49194,0.002405,172.31.36.0-255,66,264468,8,384199
49195,0.002431,74.125.200.0-255,3602,268070,8,384199
49196,0.002434,172.31.36.0-255,66,268136,8,384199
49197,0.002466,74.125.200.0-255,2902,271038,8,384199
49198,0.002469,172.31.36.0-255,66,271104,8,384199
49199,0.002487,74.125.200.0-255,1484,272588,8,384199
49200,0.00249,74.125.200.0-255,1484,274072,8,384199
49201,0.002493,172.31.36.0-255,66,274138,8,384199
49202,0.002497,74.125.200.0-255,2902,277040,8,384199
49203,0.002499,172.31.36.0-255,66,277106,8,384199
49204,0.002504,74.125.200.0-255,2902,280008,8,384199
49205,0.002507,172.31.36.0-255,66,280074,8,384199
49206,0.002528,74.125.200.0-255,1484,281558,8,384199
49207,0.002531,74.125.200.0-255,1484,283042,8,384199
49208,0.002534,172.31.36.0-255,66,283108,8,384199
49209,0.002538,74.125.200.0-255,1484,284592,8,384199
49210,0.00254,74.125.200.0-255,1484,286076,8,384199
49211,0.002542,172.31.36.0-255,66,286142,8,384199
49212,0.002567,74.125.200.0-255,1484,287626,8,384199
49213,0.002585,74.125.200.0-255,5738,293364,8,384199
49214,0.002589,172.31.36.0-255,66,293430,8,384199
49215,0.002592,74.125.200.0-255,1484,294914,8,384199
49216,0.002606,74.125.200.0-255,1484,296398,8,384199
49217,0.002608,172.31.36.0-255,66,296464,8,384199
49218,0.002611,74.125.200.0-255,1484,297948,8,384199
49219,0.002616,74.125.200.0-255,2902,300850,8,384199
49220,0.002618,172.31.36.0-255,66,300916,8,384199
49221,0.002636,74.125.200.0-255,2184,303100,8,384199
49222,0.002639,172.31.36.0-255,66,303166,8,384199
49223,0.003124,74.125.200.0-255,1484,304650,8,384199
49224,0.003133,74.125.200.0-255,2902,307552,8,384199
49225,0.003137,172.31.36.0-255,66,307618,8,384199
49226,0.003143,74.125.200.0-255,2902,310520,8,384199
49227,0.003145,172.31.36.0-255,66,310586,8,384199
49228,0.003161,74.125.200.0-255,2902,313488,8,384199
49229,0.003164,172.31.36.0-255,66,313554,8,384199
49230,0.003167,74.125.200.0-255,1484,315038,8,384199
49231,0.003172,74.125.200.0-255,4320,319358,8,384199
49232,0.003174,172.31.36.0-255,66,319424,8,384199
49233,0.003203,74.125.200.0-255,7156,326580,8,384199
49234,0.003206,172.31.36.0-255,66,326646,8,384199
49235,0.00321,74.125.200.0-255,2902,329548,8,384199
49236,0.003212,172.31.36.0-255,66,329614,8,384199
49237,0.00326,74.125.200.0-255,4320,333934,8,384199
49238,0.003264,172.31.36.0-255,66,334000,8,384199
49239,0.003286,74.125.200.0-255,3602,337602,8,384199
49240,0.003288,172.31.36.0-255,66,337668,8,384199
49241,0.003321,74.125.200.0-255,1484,339152,8,384199
49242,0.003338,74.125.200.0-255,2902,342054,8,384199
49243,0.00334,172.31.36.0-255,66,342120,8,384199
49244,0.003344,74.125.200.0-255,1484,343604,8,384199
49245,0.003362,74.125.200.0-255,4320,347924,8,384199
49246,0.003364,172.31.36.0-255,66,347990,8,384199
49247,0.003377,74.125.200.0-255,2902,350892,8,384199
49248,0.003379,172.31.36.0-255,66,350958,8,384199
49249,0.003401,74.125.200.0-255,7156,358114,8,384199
49250,0.003404,172.31.36.0-255,66,358180,8,384199
49251,0.003411,74.125.200.0-255,7156,365336,8,384199
49252,0.003414,172.31.36.0-255,66,365402,8,384199
49253,0.003432,74.125.200.0-255,4320,369722,8,384199
49254,0.003435,172.31.36.0-255,66,369788,8,384199
49255,0.003458,74.125.200.0-255,3602,373390,8,384199
49256,0.003461,172.31.36.0-255,66,373456,8,384199
49257,0.003466,74.125.200.0-255,4320,377776,8,384199
49258,0.003468,172.31.36.0-255,66,377842,8,384199
49259,0.003483,74.125.200.0-255,1661,379503,8,384199
49260,0.003485,172.31.36.0-255,66,379569,8,384199
49261,0.003528,74.125.200.0-255,105,379674,8,384199
49262,0.008368,172.31.36.0-255,66,379740,8,384199
49263,0.00841,172.31.36.0-255,105,379845,8,384199
49264,0.010698,74.125.200.0-255,66,379911,8,384199
49265,0.031331,172.31.36.0-255,172,380083,8,384199
49266,0.031377,172.31.36.0-255,1112,381195,8,384199
49267,0.031443,172.31.36.0-255,1514,382709,8,384199
49268,0.031445,172.31.36.0-255,1292,384001,8,384199
49269,0.032877,104.244.42.0-255,66,384067,8,384199
49270,0.032979,104.244.42.0-255,66,384133,8,384199
49271,0.033023,104.244.42.0-255,66,384199,8,384199
49272,0.0,74.125.24.0-255,153,153,8,319728
49273,2.2e-05,172.31.36.0-255,66,219,8,319728
49274,2.9e-05,74.125.24.0-255,1484,1703,8,319728
49275,3.3e-05,172.31.36.0-255,66,1769,8,319728
49276,4.6e-05,74.125.24.0-255,2902,4671,8,319728
49277,4.9e-05,172.31.36.0-255,66,4737,8,319728
49278,5.3e-05,74.125.24.0-255,2902,7639,8,319728
49279,5.6e-05,172.31.36.0-255,66,7705,8,319728
49280,9e-05,74.125.24.0-255,6292,13997,8,319728
49281,9.4e-05,172.31.36.0-255,66,14063,8,319728
49282,0.000121,74.125.24.0-255,7156,21219,8,319728
49283,0.000124,172.31.36.0-255,66,21285,8,319728
49284,0.000126,74.125.24.0-255,1484,22769,8,319728
49285,0.000128,172.31.36.0-255,66,22835,8,319728
49286,0.000182,74.125.24.0-255,5738,28573,8,319728
49287,0.000185,172.31.36.0-255,66,28639,8,319728
49288,0.000202,74.125.24.0-255,2543,31182,8,319728
49289,0.000204,172.31.36.0-255,66,31248,8,319728
49290,0.000233,172.31.36.0-255,66,31314,8,319728
49291,0.000237,74.125.24.0-255,4320,35634,8,319728
49292,0.000239,172.31.36.0-255,66,35700,8,319728
49293,0.00029,74.125.24.0-255,3961,39661,8,319728
49294,0.000292,172.31.36.0-255,66,39727,8,319728
49295,0.000889,74.125.24.0-255,1484,41211,8,319728
49296,0.000894,172.31.36.0-255,66,41277,8,319728
49297,0.000902,74.125.24.0-255,2902,44179,8,319728
49298,0.000903,172.31.36.0-255,66,44245,8,319728
49299,0.000933,74.125.24.0-255,5738,49983,8,319728
49300,0.000935,172.31.36.0-255,66,50049,8,319728
49301,0.000968,74.125.24.0-255,4320,54369,8,319728
49302,0.00097,172.31.36.0-255,66,54435,8,319728
49303,0.001,74.125.24.0-255,5379,59814,8,319728
49304,0.001002,172.31.36.0-255,66,59880,8,319728
49305,0.001012,172.31.36.0-255,66,59946,8,319728
49306,0.001018,74.125.24.0-255,4542,64488,8,319728
49307,0.001023,172.31.36.0-255,66,64554,8,319728
49308,0.001066,74.125.24.0-255,1484,66038,8,319728
49309,0.001068,172.31.36.0-255,66,66104,8,319728
49310,0.001092,74.125.24.0-255,2902,69006,8,319728
49311,0.001094,172.31.36.0-255,66,69072,8,319728
49312,0.001097,74.125.24.0-255,1484,70556,8,319728
49313,0.001099,172.31.36.0-255,66,70622,8,319728
49314,0.001123,74.125.24.0-255,2902,73524,8,319728
49315,0.001125,172.31.36.0-255,66,73590,8,319728
49316,0.001155,172.31.36.0-255,66,73656,8,319728
49317,0.001405,74.125.24.0-255,1484,75140,8,319728
49318,0.001413,172.31.36.0-255,66,75206,8,319728
49319,0.001419,74.125.24.0-255,2902,78108,8,319728
49320,0.001421,172.31.36.0-255,66,78174,8,319728
49321,0.001431,74.125.24.0-255,2902,81076,8,319728
49322,0.001433,172.31.36.0-255,66,81142,8,319728
49323,0.001455,74.125.24.0-255,2902,84044,8,319728
49324,0.001458,172.31.36.0-255,66,84110,8,319728
49325,0.001472,172.31.36.0-255,66,84176,8,319728
49326,0.00148,74.125.24.0-255,7156,91332,8,319728
49327,0.001503,74.125.24.0-255,3602,94934,8,319728
49328,0.001735,74.125.24.0-255,1484,96418,8,319728
49329,0.001741,74.125.24.0-255,1484,97902,8,319728
49330,0.001757,74.125.24.0-255,1484,99386,8,319728
49331,0.001764,74.125.24.0-255,5738,105124,8,319728
49332,0.00177,74.125.24.0-255,4320,109444,8,319728
49333,0.001841,74.125.24.0-255,5738,115182,8,319728
49334,0.001853,74.125.24.0-255,2184,117366,8,319728
49335,0.001996,74.125.24.0-255,1484,118850,8,319728
49336,0.002023,74.125.24.0-255,2902,121752,8,319728
49337,0.002042,74.125.24.0-255,5738,127490,8,319728
49338,0.002057,74.125.24.0-255,1484,128974,8,319728
49339,0.002098,74.125.24.0-255,2902,131876,8,319728
49340,0.002119,74.125.24.0-255,2902,134778,8,319728
49341,0.002159,74.125.24.0-255,2902,137680,8,319728
49342,0.00218,74.125.24.0-255,4320,142000,8,319728
49343,0.002197,74.125.24.0-255,7156,149156,8,319728
49344,0.002206,74.125.24.0-255,1484,150640,8,319728
49345,0.002209,74.125.24.0-255,1484,152124,8,319728
49346,0.002274,74.125.24.0-255,4320,156444,8,319728
49347,0.002289,74.125.24.0-255,3602,160046,8,319728
49348,0.006958,172.31.36.0-255,66,160112,8,319728
49349,0.00923,74.125.24.0-255,5738,165850,8,319728
49350,0.009238,172.31.36.0-255,66,165916,8,319728
49351,0.011514,74.125.24.0-255,5738,171654,8,319728
49352,0.011521,172.31.36.0-255,66,171720,8,319728
49353,0.013781,74.125.24.0-255,5738,177458,8,319728
49354,0.015541,172.31.36.0-255,66,177524,8,319728
49355,0.017815,74.125.24.0-255,5738,183262,8,319728
49356,0.017829,172.31.36.0-255,66,183328,8,319728
49357,0.020101,74.125.24.0-255,5738,189066,8,319728
49358,0.02011,172.31.36.0-255,66,189132,8,319728
49359,0.022371,74.125.24.0-255,5738,194870,8,319728
49360,0.022378,172.31.36.0-255,66,194936,8,319728
49361,0.024619,74.125.24.0-255,5738,200674,8,319728
49362,0.024628,172.31.36.0-255,66,200740,8,319728
49363,0.026858,74.125.24.0-255,5738,206478,8,319728
49364,0.026866,172.31.36.0-255,66,206544,8,319728
49365,0.029184,74.125.24.0-255,5738,212282,8,319728
49366,0.029191,172.31.36.0-255,66,212348,8,319728
49367,0.031478,74.125.24.0-255,5738,218086,8,319728
49368,0.031485,172.31.36.0-255,66,218152,8,319728
49369,0.033727,74.125.24.0-255,5738,223890,8,319728
49370,0.033735,172.31.36.0-255,66,223956,8,319728
49371,0.03497,172.31.36.0-255,172,224128,8,319728
49372,0.035004,172.31.36.0-255,1110,225238,8,319728
49373,0.03506,172.31.36.0-255,1428,226666,8,319728
49374,0.035993,74.125.24.0-255,5738,232404,8,319728
49375,0.036001,172.31.36.0-255,66,232470,8,319728
49376,0.036501,104.244.42.0-255,66,232536,8,319728
49377,0.036548,104.244.42.0-255,66,232602,8,319728
49378,0.036634,104.244.42.0-255,66,232668,8,319728
49379,0.038266,74.125.24.0-255,5738,238406,8,319728
49380,0.038272,172.31.36.0-255,66,238472,8,319728
49381,0.040515,74.125.24.0-255,5738,244210,8,319728
49382,0.040522,172.31.36.0-255,66,244276,8,319728
49383,0.042794,74.125.24.0-255,5738,250014,8,319728
49384,0.042803,172.31.36.0-255,66,250080,8,319728
49385,0.045052,74.125.24.0-255,5738,255818,8,319728
49386,0.045059,172.31.36.0-255,66,255884,8,319728
49387,0.047288,74.125.24.0-255,5738,261622,8,319728
49388,0.047295,172.31.36.0-255,66,261688,8,319728
49389,0.049563,74.125.24.0-255,5738,267426,8,319728
49390,0.049569,172.31.36.0-255,66,267492,8,319728
49391,0.051817,74.125.24.0-255,5738,273230,8,319728
49392,0.051825,172.31.36.0-255,66,273296,8,319728
49393,0.054089,74.125.24.0-255,5738,279034,8,319728
49394,0.054097,172.31.36.0-255,66,279100,8,319728
49395,0.056381,74.125.24.0-255,5738,284838,8,319728
49396,0.056401,172.31.36.0-255,66,284904,8,319728
49397,0.05865,74.125.24.0-255,5738,290642,8,319728
49398,0.058658,172.31.36.0-255,66,290708,8,319728
49399,0.060905,74.125.24.0-255,5738,296446,8,319728
49400,0.060911,172.31.36.0-255,66,296512,8,319728
49401,0.06316,74.125.24.0-255,5738,302250,8,319728
49402,0.063167,172.31.36.0-255,66,302316,8,319728
49403,0.065428,74.125.24.0-255,5738,308054,8,319728
49404,0.065435,172.31.36.0-255,66,308120,8,319728
49405,0.067687,74.125.24.0-255,5738,313858,8,319728
49406,0.067694,172.31.36.0-255,66,313924,8,319728
49407,0.069928,74.125.24.0-255,5738,319662,8,319728
49408,0.069935,172.31.36.0-255,66,319728,8,319728
49409,0.0,74.125.130.0-255,143,143,8,311673
49410,3.6e-05,172.31.36.0-255,66,209,8,311673
49411,4.4e-05,74.125.130.0-255,1484,1693,8,311673
49412,4.8e-05,172.31.36.0-255,66,1759,8,311673
49413,5.4e-05,74.125.130.0-255,2902,4661,8,311673
49414,5.7e-05,172.31.36.0-255,66,4727,8,311673
49415,7.1e-05,74.125.130.0-255,4320,9047,8,311673
49416,7.4e-05,172.31.36.0-255,66,9113,8,311673
49417,0.000104,74.125.130.0-255,4877,13990,8,311673
49418,0.000107,172.31.36.0-255,66,14056,8,311673
49419,0.000135,74.125.130.0-255,1484,15540,8,311673
49420,0.000137,172.31.36.0-255,66,15606,8,311673
49421,0.000142,74.125.130.0-255,1484,17090,8,311673
49422,0.000144,172.31.36.0-255,66,17156,8,311673
49423,0.000164,74.125.130.0-255,1484,18640,8,311673
49424,0.000167,172.31.36.0-255,66,18706,8,311673
49425,0.000176,74.125.130.0-255,5738,24444,8,311673
49426,0.000178,172.31.36.0-255,66,24510,8,311673
49427,0.000181,74.125.130.0-255,1484,25994,8,311673
49428,0.000184,172.31.36.0-255,66,26060,8,311673
49429,0.000214,74.125.130.0-255,1484,27544,8,311673
49430,0.000217,172.31.36.0-255,66,27610,8,311673
49431,0.000223,74.125.130.0-255,4320,31930,8,311673
49432,0.000228,172.31.36.0-255,66,31996,8,311673
49433,0.000235,74.125.130.0-255,7156,39152,8,311673
49434,0.000238,172.31.36.0-255,66,39218,8,311673
49435,0.000264,74.125.130.0-255,1484,40702,8,311673
49436,0.000267,172.31.36.0-255,66,40768,8,311673
49437,0.000272,74.125.130.0-255,2902,43670,8,311673
49438,0.000274,172.31.36.0-255,66,43736,8,311673
49439,0.000279,74.125.130.0-255,4320,48056,8,311673
49440,0.000281,172.31.36.0-255,66,48122,8,311673
49441,0.000284,74.125.130.0-255,766,48888,8,311673
49442,0.000345,74.125.130.0-255,1484,50372,8,311673
49443,0.000349,172.31.36.0-255,66,50438,8,311673
49444,0.000379,74.125.130.0-255,2902,53340,8,311673
49445,0.000383,172.31.36.0-255,66,53406,8,311673
49446,0.00039,74.125.130.0-255,5738,59144,8,311673
49447,0.000392,172.31.36.0-255,66,59210,8,311673
49448,0.000403,74.125.130.0-255,2902,62112,8,311673
49449,0.000405,172.31.36.0-255,66,62178,8,311673
49450,0.000409,74.125.130.0-255,1484,63662,8,311673
49451,0.000432,74.125.130.0-255,2793,66455,8,311673
49452,0.000435,172.31.36.0-255,66,66521,8,311673
49453,0.000451,74.125.130.0-255,119,66640,8,311673
49454,0.000469,74.125.130.0-255,383,67023,8,311673
49455,0.000592,74.125.130.0-255,1484,68507,8,311673
49456,0.000596,172.31.36.0-255,66,68573,8,311673
49457,0.000626,74.125.130.0-255,2902,71475,8,311673
49458,0.00063,172.31.36.0-255,66,71541,8,311673
49459,0.000638,74.125.130.0-255,5738,77279,8,311673
49460,0.00064,172.31.36.0-255,66,77345,8,311673
49461,0.000643,74.125.130.0-255,1484,78829,8,311673
49462,0.000677,74.125.130.0-255,5379,84208,8,311673
49463,0.00068,172.31.36.0-255,66,84274,8,311673
49464,0.000688,74.125.130.0-255,7156,91430,8,311673
49465,0.00069,172.31.36.0-255,66,91496,8,311673
49466,0.000746,74.125.130.0-255,7156,98652,8,311673
49467,0.00075,172.31.36.0-255,66,98718,8,311673
49468,0.000754,74.125.130.0-255,2543,101261,8,311673
49469,0.000759,172.31.36.0-255,66,101327,8,311673
49470,0.001701,74.125.130.0-255,1484,102811,8,311673
49471,0.001722,74.125.130.0-255,2902,105713,8,311673
49472,0.001727,172.31.36.0-255,66,105779,8,311673
49473,0.001735,74.125.130.0-255,2902,108681,8,311673
49474,0.001737,172.31.36.0-255,66,108747,8,311673
49475,0.00176,74.125.130.0-255,2902,111649,8,311673
49476,0.001763,172.31.36.0-255,66,111715,8,311673
49477,0.00177,74.125.130.0-255,4320,116035,8,311673
49478,0.001772,172.31.36.0-255,66,116101,8,311673
49479,0.001777,74.125.130.0-255,4320,120421,8,311673
49480,0.00178,172.31.36.0-255,66,120487,8,311673
49481,0.001809,74.125.130.0-255,1484,121971,8,311673
49482,0.001817,74.125.130.0-255,5738,127709,8,311673
49483,0.00182,172.31.36.0-255,66,127775,8,311673
49484,0.001848,74.125.130.0-255,4320,132095,8,311673
49485,0.001851,172.31.36.0-255,66,132161,8,311673
49486,0.001866,74.125.130.0-255,3602,135763,8,311673
49487,0.001878,172.31.36.0-255,66,135829,8,311673
49488,0.004122,74.125.130.0-255,1484,137313,8,311673
49489,0.004162,74.125.130.0-255,4320,141633,8,311673
49490,0.004167,172.31.36.0-255,66,141699,8,311673
49491,0.006444,74.125.130.0-255,4320,146019,8,311673
49492,0.006448,172.31.36.0-255,66,146085,8,311673
49493,0.006469,74.125.130.0-255,1484,147569,8,311673
49494,0.008735,74.125.130.0-255,4320,151889,8,311673
49495,0.008749,172.31.36.0-255,66,151955,8,311673
49496,0.011033,74.125.130.0-255,5738,157693,8,311673
49497,0.011042,172.31.36.0-255,66,157759,8,311673
49498,0.013322,74.125.130.0-255,5738,163497,8,311673
49499,0.013329,172.31.36.0-255,66,163563,8,311673
49500,0.015619,74.125.130.0-255,5738,169301,8,311673
49501,0.015631,172.31.36.0-255,66,169367,8,311673
49502,0.017909,74.125.130.0-255,5738,175105,8,311673
49503,0.017921,172.31.36.0-255,66,175171,8,311673
49504,0.020219,74.125.130.0-255,5738,180909,8,311673
49505,0.020232,172.31.36.0-255,66,180975,8,311673
49506,0.02253,74.125.130.0-255,5738,186713,8,311673
49507,0.022543,172.31.36.0-255,66,186779,8,311673
49508,0.024825,74.125.130.0-255,4320,191099,8,311673
49509,0.024834,172.31.36.0-255,66,191165,8,311673
49510,0.024875,74.125.130.0-255,1484,192649,8,311673
49511,0.027114,74.125.130.0-255,4320,196969,8,311673
49512,0.027121,172.31.36.0-255,66,197035,8,311673
49513,0.02858,172.31.36.0-255,172,197207,8,311673
49514,0.028614,172.31.36.0-255,1110,198317,8,311673
49515,0.02866,172.31.36.0-255,1514,199831,8,311673
49516,0.028662,172.31.36.0-255,1514,201345,8,311673
49517,0.028668,172.31.36.0-255,1514,202859,8,311673
49518,0.028669,172.31.36.0-255,1514,204373,8,311673
49519,0.028696,172.31.36.0-255,1514,205887,8,311673
49520,0.028697,172.31.36.0-255,876,206763,8,311673
49521,0.029407,74.125.130.0-255,5738,212501,8,311673
49522,0.029415,172.31.36.0-255,66,212567,8,311673
49523,0.03011,104.244.42.0-255,66,212633,8,311673
49524,0.030175,104.244.42.0-255,66,212699,8,311673
49525,0.030262,104.244.42.0-255,66,212765,8,311673
49526,0.030268,104.244.42.0-255,66,212831,8,311673
49527,0.031708,74.125.130.0-255,5738,218569,8,311673
49528,0.031717,172.31.36.0-255,66,218635,8,311673
49529,0.034021,74.125.130.0-255,5738,224373,8,311673
49530,0.03403,172.31.36.0-255,66,224439,8,311673
49531,0.036324,74.125.130.0-255,5738,230177,8,311673
49532,0.036337,172.31.36.0-255,66,230243,8,311673
49533,0.038631,74.125.130.0-255,5738,235981,8,311673
49534,0.038644,172.31.36.0-255,66,236047,8,311673
49535,0.040929,74.125.130.0-255,5738,241785,8,311673
49536,0.040941,172.31.36.0-255,66,241851,8,311673
49537,0.043227,74.125.130.0-255,5738,247589,8,311673
49538,0.043235,172.31.36.0-255,66,247655,8,311673
49539,0.044451,172.31.36.0-255,108,247763,8,311673
49540,0.045544,74.125.130.0-255,5738,253501,8,311673
49541,0.045552,172.31.36.0-255,66,253567,8,311673
49542,0.046002,104.244.42.0-255,66,253633,8,311673
49543,0.047834,74.125.130.0-255,5738,259371,8,311673
49544,0.047842,172.31.36.0-255,66,259437,8,311673
49545,0.050129,74.125.130.0-255,5738,265175,8,311673
49546,0.050139,172.31.36.0-255,66,265241,8,311673
49547,0.052439,74.125.130.0-255,5738,270979,8,311673
49548,0.052448,172.31.36.0-255,66,271045,8,311673
49549,0.054724,74.125.130.0-255,5738,276783,8,311673
49550,0.054737,172.31.36.0-255,66,276849,8,311673
49551,0.057031,74.125.130.0-255,5738,282587,8,311673
49552,0.057041,172.31.36.0-255,66,282653,8,311673
49553,0.059349,74.125.130.0-255,5738,288391,8,311673
49554,0.059357,172.31.36.0-255,66,288457,8,311673
49555,0.061649,74.125.130.0-255,5738,294195,8,311673
49556,0.061655,172.31.36.0-255,66,294261,8,311673
49557,0.063928,74.125.130.0-255,5738,299999,8,311673
49558,0.063935,172.31.36.0-255,66,300065,8,311673
49559,0.06622,74.125.130.0-255,5738,305803,8,311673
49560,0.066229,172.31.36.0-255,66,305869,8,311673
49561,0.068512,74.125.130.0-255,5738,311607,8,311673
49562,0.06852,172.31.36.0-255,66,311673,8,311673
49563,0.0,216.58.203.0-255,152,152,8,323170
49564,2.6e-05,172.31.36.0-255,66,218,8,323170
49565,6.2e-05,216.58.203.0-255,1484,1702,8,323170
49566,6.8e-05,172.31.36.0-255,66,1768,8,323170
49567,7.4e-05,216.58.203.0-255,2902,4670,8,323170
49568,7.6e-05,172.31.36.0-255,66,4736,8,323170
49569,8.2e-05,216.58.203.0-255,4320,9056,8,323170
49570,8.4e-05,172.31.36.0-255,66,9122,8,323170
49571,9.1e-05,216.58.203.0-255,4838,13960,8,323170
49572,9.4e-05,172.31.36.0-255,66,14026,8,323170
49573,0.000256,216.58.203.0-255,1484,15510,8,323170
49574,0.000261,172.31.36.0-255,66,15576,8,323170
49575,0.000266,216.58.203.0-255,2902,18478,8,323170
49576,0.000268,172.31.36.0-255,66,18544,8,323170
49577,0.000271,216.58.203.0-255,1484,20028,8,323170
49578,0.000278,172.31.36.0-255,66,20094,8,323170
49579,0.000309,216.58.203.0-255,2902,22996,8,323170
49580,0.000314,172.31.36.0-255,66,23062,8,323170
49581,0.000319,216.58.203.0-255,4320,27382,8,323170
49582,0.000322,172.31.36.0-255,66,27448,8,323170
49583,0.000326,216.58.203.0-255,3961,31409,8,323170
49584,0.000329,172.31.36.0-255,66,31475,8,323170
49585,0.000375,216.58.203.0-255,4320,35795,8,323170
49586,0.000379,172.31.36.0-255,66,35861,8,323170
49587,0.000382,216.58.203.0-255,1484,37345,8,323170
49588,0.000385,172.31.36.0-255,66,37411,8,323170
49589,0.000389,216.58.203.0-255,2902,40313,8,323170
49590,0.000391,172.31.36.0-255,66,40379,8,323170
49591,0.0004,216.58.203.0-255,1484,41863,8,323170
49592,0.000402,172.31.36.0-255,66,41929,8,323170
49593,0.00043,216.58.203.0-255,4320,46249,8,323170
49594,0.000434,172.31.36.0-255,66,46315,8,323170
49595,0.000438,216.58.203.0-255,2543,48858,8,323170
49596,0.00044,172.31.36.0-255,66,48924,8,323170
49597,0.000493,216.58.203.0-255,1484,50408,8,323170
49598,0.00051,216.58.203.0-255,2902,53310,8,323170
49599,0.000513,172.31.36.0-255,66,53376,8,323170
49600,0.00052,216.58.203.0-255,4320,57696,8,323170
49601,0.000521,172.31.36.0-255,66,57762,8,323170
49602,0.000543,216.58.203.0-255,1484,59246,8,323170
49603,0.000546,216.58.203.0-255,2902,62148,8,323170
49604,0.000549,172.31.36.0-255,66,62214,8,323170
49605,0.000559,216.58.203.0-255,3961,66175,8,323170
49606,0.000561,216.58.203.0-255,394,66569,8,323170
49607,0.000563,172.31.36.0-255,66,66635,8,323170
49608,0.000835,172.31.36.0-255,66,66701,8,323170
49609,0.001566,216.58.203.0-255,351,67052,8,323170
49610,0.001603,216.58.203.0-255,1484,68536,8,323170
49611,0.001608,172.31.36.0-255,66,68602,8,323170
49612,0.001614,216.58.203.0-255,2902,71504,8,323170
49613,0.001616,172.31.36.0-255,66,71570,8,323170
49614,0.001646,216.58.203.0-255,5738,77308,8,323170
49615,0.001649,172.31.36.0-255,66,77374,8,323170
49616,0.001657,216.58.203.0-255,6797,84171,8,323170
49617,0.001667,172.31.36.0-255,66,84237,8,323170
49618,0.001694,216.58.203.0-255,4320,88557,8,323170
49619,0.001696,172.31.36.0-255,66,88623,8,323170
49620,0.001718,216.58.203.0-255,1484,90107,8,323170
49621,0.001721,216.58.203.0-255,1484,91591,8,323170
49622,0.001723,172.31.36.0-255,66,91657,8,323170
49623,0.001733,172.31.36.0-255,66,91723,8,323170
49624,0.00174,216.58.203.0-255,1125,92848,8,323170
49625,0.003412,216.58.203.0-255,4320,97168,8,323170
49626,0.003415,172.31.36.0-255,66,97234,8,323170
49627,0.005088,216.58.203.0-255,5738,102972,8,323170
49628,0.005093,172.31.36.0-255,66,103038,8,323170
49629,0.006766,216.58.203.0-255,5738,108776,8,323170
49630,0.006771,172.31.36.0-255,66,108842,8,323170
49631,0.008439,216.58.203.0-255,5738,114580,8,323170
49632,0.008447,172.31.36.0-255,66,114646,8,323170
49633,0.010131,216.58.203.0-255,5738,120384,8,323170
49634,0.010138,172.31.36.0-255,66,120450,8,323170
49635,0.011811,216.58.203.0-255,1484,121934,8,323170
49636,0.011835,216.58.203.0-255,4320,126254,8,323170
49637,0.011839,172.31.36.0-255,66,126320,8,323170
49638,0.013511,216.58.203.0-255,5738,132058,8,323170
49639,0.013518,172.31.36.0-255,66,132124,8,323170
49640,0.015191,216.58.203.0-255,5738,137862,8,323170
49641,0.0152,172.31.36.0-255,66,137928,8,323170
49642,0.016882,216.58.203.0-255,5738,143666,8,323170
49643,0.016889,172.31.36.0-255,66,143732,8,323170
49644,0.018566,216.58.203.0-255,5738,149470,8,323170
49645,0.018572,172.31.36.0-255,66,149536,8,323170
49646,0.020236,216.58.203.0-255,5738,155274,8,323170
49647,0.02024,172.31.36.0-255,66,155340,8,323170
49648,0.02194,216.58.203.0-255,4320,159660,8,323170
49649,0.021946,172.31.36.0-255,66,159726,8,323170
49650,0.021983,216.58.203.0-255,1484,161210,8,323170
49651,0.023609,216.58.203.0-255,4320,165530,8,323170
49652,0.023615,172.31.36.0-255,66,165596,8,323170
49653,0.025285,216.58.203.0-255,5738,171334,8,323170
49654,0.025292,172.31.36.0-255,66,171400,8,323170
49655,0.026968,216.58.203.0-255,5738,177138,8,323170
49656,0.026976,172.31.36.0-255,66,177204,8,323170
49657,0.028648,216.58.203.0-255,5738,182942,8,323170
49658,0.028656,172.31.36.0-255,66,183008,8,323170
49659,0.030337,216.58.203.0-255,5738,188746,8,323170
49660,0.030344,172.31.36.0-255,66,188812,8,323170
49661,0.032017,216.58.203.0-255,5738,194550,8,323170
49662,0.032023,172.31.36.0-255,66,194616,8,323170
49663,0.03302,172.31.36.0-255,172,194788,8,323170
49664,0.033053,172.31.36.0-255,562,195350,8,323170
49665,0.033692,216.58.203.0-255,5738,201088,8,323170
49666,0.033698,172.31.36.0-255,66,201154,8,323170
49667,0.03456,104.244.42.0-255,66,201220,8,323170
49668,0.034579,104.244.42.0-255,66,201286,8,323170
49669,0.03537,216.58.203.0-255,5738,207024,8,323170
49670,0.035376,172.31.36.0-255,66,207090,8,323170
49671,0.037045,216.58.203.0-255,5738,212828,8,323170
49672,0.037051,172.31.36.0-255,66,212894,8,323170
49673,0.038726,216.58.203.0-255,5738,218632,8,323170
49674,0.038731,172.31.36.0-255,66,218698,8,323170
49675,0.040403,216.58.203.0-255,5738,224436,8,323170
49676,0.040409,172.31.36.0-255,66,224502,8,323170
49677,0.042075,216.58.203.0-255,5738,230240,8,323170
49678,0.042081,172.31.36.0-255,66,230306,8,323170
49679,0.043749,216.58.203.0-255,5738,236044,8,323170
49680,0.043755,172.31.36.0-255,66,236110,8,323170
49681,0.045435,216.58.203.0-255,5738,241848,8,323170
49682,0.04544,172.31.36.0-255,66,241914,8,323170
49683,0.047123,216.58.203.0-255,5738,247652,8,323170
49684,0.04713,172.31.36.0-255,66,247718,8,323170
49685,0.048807,216.58.203.0-255,5738,253456,8,323170
49686,0.048812,172.31.36.0-255,66,253522,8,323170
49687,0.050475,216.58.203.0-255,5738,259260,8,323170
49688,0.050481,172.31.36.0-255,66,259326,8,323170
49689,0.052147,216.58.203.0-255,5738,265064,8,323170
49690,0.052152,172.31.36.0-255,66,265130,8,323170
49691,0.05383,216.58.203.0-255,5738,270868,8,323170
49692,0.053835,172.31.36.0-255,66,270934,8,323170
49693,0.05553,216.58.203.0-255,5738,276672,8,323170
49694,0.055547,172.31.36.0-255,66,276738,8,323170
49695,0.057225,216.58.203.0-255,5738,282476,8,323170
49696,0.057231,172.31.36.0-255,66,282542,8,323170
49697,0.058896,216.58.203.0-255,5738,288280,8,323170
49698,0.0589,172.31.36.0-255,66,288346,8,323170
49699,0.060571,216.58.203.0-255,5738,294084,8,323170
49700,0.060594,172.31.36.0-255,66,294150,8,323170
49701,0.062269,216.58.203.0-255,5738,299888,8,323170
49702,0.062274,172.31.36.0-255,66,299954,8,323170
49703,0.063943,216.58.203.0-255,5738,305692,8,323170
49704,0.063949,172.31.36.0-255,66,305758,8,323170
49705,0.065616,216.58.203.0-255,5738,311496,8,323170
49706,0.065621,172.31.36.0-255,66,311562,8,323170
49707,0.067292,216.58.203.0-255,5738,317300,8,323170
49708,0.067297,172.31.36.0-255,66,317366,8,323170
49709,0.068968,216.58.203.0-255,5738,323104,8,323170
49710,0.068973,172.31.36.0-255,66,323170,8,323170
49711,0.0,74.125.68.0-255,153,153,8,241961
49712,3.4e-05,172.31.36.0-255,66,219,8,241961
49713,4.2e-05,74.125.68.0-255,1484,1703,8,241961
49714,4.7e-05,172.31.36.0-255,66,1769,8,241961
49715,5.1e-05,74.125.68.0-255,2902,4671,8,241961
49716,5.4e-05,172.31.36.0-255,66,4737,8,241961
49717,8.6e-05,74.125.68.0-255,7156,11893,8,241961
49718,9.1e-05,172.31.36.0-255,66,11959,8,241961
49719,0.000212,74.125.68.0-255,2086,14045,8,241961
49720,0.000217,172.31.36.0-255,66,14111,8,241961
49721,0.000234,74.125.68.0-255,1484,15595,8,241961
49722,0.000236,172.31.36.0-255,66,15661,8,241961
49723,0.000258,172.31.36.0-255,66,15727,8,241961
49724,0.000453,74.125.68.0-255,5379,21106,8,241961
49725,0.000458,172.31.36.0-255,66,21172,8,241961
49726,0.000843,74.125.68.0-255,1484,22656,8,241961
49727,0.00085,172.31.36.0-255,66,22722,8,241961
49728,0.000859,74.125.68.0-255,2902,25624,8,241961
49729,0.000862,172.31.36.0-255,66,25690,8,241961
49730,0.000882,74.125.68.0-255,1484,27174,8,241961
49731,0.000885,172.31.36.0-255,66,27240,8,241961
49732,0.00092,74.125.68.0-255,2902,30142,8,241961
49733,0.000923,172.31.36.0-255,66,30208,8,241961
49734,0.000968,74.125.68.0-255,5738,35946,8,241961
49735,0.000971,172.31.36.0-255,66,36012,8,241961
49736,0.001078,74.125.68.0-255,3961,39973,8,241961
49737,0.001082,172.31.36.0-255,66,40039,8,241961
49738,0.001154,74.125.68.0-255,5738,45777,8,241961
49739,0.001157,172.31.36.0-255,66,45843,8,241961
49740,0.001188,172.31.36.0-255,66,45909,8,241961
49741,0.001404,74.125.68.0-255,129,46038,8,241961
49742,0.001431,74.125.68.0-255,2902,48940,8,241961
49743,0.001451,74.125.68.0-255,5738,54678,8,241961
49744,0.001625,74.125.68.0-255,2902,57580,8,241961
49745,0.002068,74.125.68.0-255,4320,61900,8,241961
49746,0.002134,74.125.68.0-255,5303,67203,8,241961
49747,0.002768,74.125.68.0-255,5738,72941,8,241961
49748,0.005636,172.31.36.0-255,66,73007,8,241961
49749,0.007722,74.125.68.0-255,5738,78745,8,241961
49750,0.007729,172.31.36.0-255,66,78811,8,241961
49751,0.009851,74.125.68.0-255,5738,84549,8,241961
49752,0.012834,172.31.36.0-255,66,84615,8,241961
49753,0.014944,74.125.68.0-255,5738,90353,8,241961
49754,0.014953,172.31.36.0-255,66,90419,8,241961
49755,0.017038,74.125.68.0-255,5738,96157,8,241961
49756,0.017043,172.31.36.0-255,66,96223,8,241961
49757,0.01912,74.125.68.0-255,5738,101961,8,241961
49758,0.019126,172.31.36.0-255,66,102027,8,241961
49759,0.021216,74.125.68.0-255,5738,107765,8,241961
49760,0.021222,172.31.36.0-255,66,107831,8,241961
49761,0.023348,74.125.68.0-255,5738,113569,8,241961
49762,0.023355,172.31.36.0-255,66,113635,8,241961
49763,0.025433,74.125.68.0-255,5738,119373,8,241961
49764,0.025441,172.31.36.0-255,66,119439,8,241961
49765,0.027552,74.125.68.0-255,5738,125177,8,241961
49766,0.027558,172.31.36.0-255,66,125243,8,241961
49767,0.029654,74.125.68.0-255,5738,130981,8,241961
49768,0.029662,172.31.36.0-255,66,131047,8,241961
49769,0.031745,74.125.68.0-255,5738,136785,8,241961
49770,0.031752,172.31.36.0-255,66,136851,8,241961
49771,0.033842,74.125.68.0-255,5738,142589,8,241961
49772,0.033849,172.31.36.0-255,66,142655,8,241961
49773,0.035938,74.125.68.0-255,5738,148393,8,241961
49774,0.035949,172.31.36.0-255,66,148459,8,241961
49775,0.038033,74.125.68.0-255,5738,154197,8,241961
49776,0.038042,172.31.36.0-255,66,154263,8,241961
49777,0.039726,172.31.36.0-255,172,154435,8,241961
49778,0.039816,172.31.36.0-255,1109,155544,8,241961
49779,0.040085,172.31.36.0-255,1514,157058,8,241961
49780,0.040088,172.31.36.0-255,1371,158429,8,241961
49781,0.040131,74.125.68.0-255,5738,164167,8,241961
49782,0.040137,172.31.36.0-255,66,164233,8,241961
49783,0.041264,104.244.42.0-255,66,164299,8,241961
49784,0.041355,104.244.42.0-255,66,164365,8,241961
49785,0.041666,104.244.42.0-255,66,164431,8,241961
49786,0.04223,74.125.68.0-255,5738,170169,8,241961
49787,0.042235,172.31.36.0-255,66,170235,8,241961
49788,0.044318,74.125.68.0-255,5738,175973,8,241961
49789,0.044323,172.31.36.0-255,66,176039,8,241961
49790,0.046408,74.125.68.0-255,5738,181777,8,241961
49791,0.046413,172.31.36.0-255,66,181843,8,241961
49792,0.048497,74.125.68.0-255,2902,184745,8,241961
49793,0.048505,172.31.36.0-255,66,184811,8,241961
49794,0.048525,74.125.68.0-255,2902,187713,8,241961
49795,0.050593,74.125.68.0-255,2902,190615,8,241961
49796,0.050959,172.31.36.0-255,66,190681,8,241961
49797,0.053042,74.125.68.0-255,4320,195001,8,241961
49798,0.053048,172.31.36.0-255,66,195067,8,241961
49799,0.053084,74.125.68.0-255,1484,196551,8,241961
49800,0.055127,74.125.68.0-255,4320,200871,8,241961
49801,0.055132,172.31.36.0-255,66,200937,8,241961
49802,0.057214,74.125.68.0-255,5738,206675,8,241961
49803,0.057263,172.31.36.0-255,66,206741,8,241961
49804,0.059348,74.125.68.0-255,5738,212479,8,241961
49805,0.059352,172.31.36.0-255,66,212545,8,241961
49806,0.061428,74.125.68.0-255,5738,218283,8,241961
49807,0.061433,172.31.36.0-255,66,218349,8,241961
49808,0.063519,74.125.68.0-255,5738,224087,8,241961
49809,0.063525,172.31.36.0-255,66,224153,8,241961
49810,0.065595,74.125.68.0-255,2902,227055,8,241961
49811,0.065599,172.31.36.0-255,66,227121,8,241961
49812,0.065628,74.125.68.0-255,2902,230023,8,241961
49813,0.065645,172.31.36.0-255,66,230089,8,241961
49814,0.067669,74.125.68.0-255,2902,232991,8,241961
49815,0.067674,172.31.36.0-255,66,233057,8,241961
49816,0.067722,74.125.68.0-255,2902,235959,8,241961
49817,0.067732,172.31.36.0-255,66,236025,8,241961
49818,0.069757,74.125.68.0-255,2902,238927,8,241961
49819,0.069761,172.31.36.0-255,66,238993,8,241961
49820,0.069798,74.125.68.0-255,2902,241895,8,241961
49821,0.069806,172.31.36.0-255,66,241961,8,241961
49822,0.0,74.125.24.0-255,153,153,8,304308
49823,2.5e-05,172.31.36.0-255,66,219,8,304308
49824,3.2e-05,74.125.24.0-255,1484,1703,8,304308
49825,3.6e-05,172.31.36.0-255,66,1769,8,304308
49826,5.1e-05,74.125.24.0-255,2902,4671,8,304308
49827,5.4e-05,172.31.36.0-255,66,4737,8,304308
49828,5.8e-05,74.125.24.0-255,2902,7639,8,304308
49829,6e-05,172.31.36.0-255,66,7705,8,304308
49830,7.2e-05,172.31.36.0-255,66,7771,8,304308
49831,9.6e-05,74.125.24.0-255,2091,9862,8,304308
49832,0.000104,172.31.36.0-255,66,9928,8,304308
49833,0.000112,74.125.24.0-255,7156,17084,8,304308
49834,0.000115,172.31.36.0-255,66,17150,8,304308
49835,0.000149,74.125.24.0-255,5379,22529,8,304308
49836,0.000153,172.31.36.0-255,66,22595,8,304308
49837,0.000598,74.125.24.0-255,1484,24079,8,304308
49838,0.000604,172.31.36.0-255,66,24145,8,304308
49839,0.000611,74.125.24.0-255,2902,27047,8,304308
49840,0.000614,172.31.36.0-255,66,27113,8,304308
49841,0.000626,74.125.24.0-255,5738,32851,8,304308
49842,0.000629,172.31.36.0-255,66,32917,8,304308
49843,0.000632,74.125.24.0-255,1484,34401,8,304308
49844,0.000634,172.31.36.0-255,66,34467,8,304308
49845,0.000671,74.125.24.0-255,4320,38787,8,304308
49846,0.000674,172.31.36.0-255,66,38853,8,304308
49847,0.000677,74.125.24.0-255,1484,40337,8,304308
49848,0.000679,172.31.36.0-255,66,40403,8,304308
49849,0.00071,74.125.24.0-255,5738,46141,8,304308
49850,0.000713,172.31.36.0-255,66,46207,8,304308
49851,0.000748,172.31.36.0-255,66,46273,8,304308
49852,0.000776,74.125.24.0-255,358,46631,8,304308
49853,0.000806,74.125.24.0-255,135,46766,8,304308
49854,0.000895,74.125.24.0-255,1484,48250,8,304308
49855,0.0009,74.125.24.0-255,1484,49734,8,304308
49856,0.000915,74.125.24.0-255,1484,51218,8,304308
49857,0.000917,74.125.24.0-255,1484,52702,8,304308
49858,0.000921,172.31.36.0-255,66,52768,8,304308
49859,0.000931,172.31.36.0-255,66,52834,8,304308
49860,0.00094,74.125.24.0-255,4320,57154,8,304308
49861,0.001024,172.31.36.0-255,66,57220,8,304308
49862,0.001044,74.125.24.0-255,3602,60822,8,304308
49863,0.001065,172.31.36.0-255,66,60888,8,304308
49864,0.001076,74.125.24.0-255,346,61234,8,304308
49865,0.001101,74.125.24.0-255,1484,62718,8,304308
49866,0.00112,74.125.24.0-255,4320,67038,8,304308
49867,0.001124,172.31.36.0-255,66,67104,8,304308
49868,0.001133,74.125.24.0-255,1484,68588,8,304308
49869,0.001141,172.31.36.0-255,66,68654,8,304308
49870,0.001153,74.125.24.0-255,5738,74392,8,304308
49871,0.001168,74.125.24.0-255,1484,75876,8,304308
49872,0.001197,172.31.36.0-255,66,75942,8,304308
49873,0.001222,172.31.36.0-255,66,76008,8,304308
49874,0.001415,74.125.24.0-255,1484,77492,8,304308
49875,0.001422,74.125.24.0-255,2902,80394,8,304308
49876,0.001424,74.125.24.0-255,1484,81878,8,304308
49877,0.001438,74.125.24.0-255,4320,86198,8,304308
49878,0.001447,172.31.36.0-255,66,86264,8,304308
49879,0.001464,74.125.24.0-255,5738,92002,8,304308
49880,0.001471,74.125.24.0-255,5738,97740,8,304308
49881,0.001489,74.125.24.0-255,7156,104896,8,304308
49882,0.001493,74.125.24.0-255,2902,107798,8,304308
49883,0.001502,172.31.36.0-255,66,107864,8,304308
49884,0.001511,74.125.24.0-255,2184,110048,8,304308
49885,0.001515,172.31.36.0-255,66,110114,8,304308
49886,0.001554,74.125.24.0-255,1484,111598,8,304308
49887,0.001575,74.125.24.0-255,2902,114500,8,304308
49888,0.001578,172.31.36.0-255,66,114566,8,304308
49889,0.001584,74.125.24.0-255,4320,118886,8,304308
49890,0.001604,74.125.24.0-255,1484,120370,8,304308
49891,0.00161,74.125.24.0-255,5738,126108,8,304308
49892,0.001619,172.31.36.0-255,66,126174,8,304308
49893,0.001651,74.125.24.0-255,7156,133330,8,304308
49894,0.001657,74.125.24.0-255,4320,137650,8,304308
49895,0.001667,172.31.36.0-255,66,137716,8,304308
49896,0.001679,74.125.24.0-255,6438,144154,8,304308
49897,0.001689,172.31.36.0-255,66,144220,8,304308
49898,0.001698,74.125.24.0-255,2902,147122,8,304308
49899,0.001724,74.125.24.0-255,5738,152860,8,304308
49900,0.001746,172.31.36.0-255,66,152926,8,304308
49901,0.001792,172.31.36.0-255,66,152992,8,304308
49902,0.001819,74.125.24.0-255,5020,158012,8,304308
49903,0.001822,74.125.24.0-255,1484,159496,8,304308
49904,0.001844,74.125.24.0-255,2902,162398,8,304308
49905,0.001846,74.125.24.0-255,1484,163882,8,304308
49906,0.001856,172.31.36.0-255,66,163948,8,304308
49907,0.001867,74.125.24.0-255,4320,168268,8,304308
49908,0.001876,74.125.24.0-255,4320,172588,8,304308
49909,0.001887,74.125.24.0-255,1484,174072,8,304308
49910,0.001895,172.31.36.0-255,66,174138,8,304308
49911,0.001905,74.125.24.0-255,2902,177040,8,304308
49912,0.001924,74.125.24.0-255,7156,184196,8,304308
49913,0.001943,74.125.24.0-255,4320,188516,8,304308
49914,0.001951,172.31.36.0-255,66,188582,8,304308
49915,0.00197,74.125.24.0-255,3602,192184,8,304308
49916,0.002038,74.125.24.0-255,1484,193668,8,304308
49917,0.002043,74.125.24.0-255,2902,196570,8,304308
49918,0.002049,74.125.24.0-255,5738,202308,8,304308
49919,0.002066,74.125.24.0-255,7156,209464,8,304308
49920,0.002085,74.125.24.0-255,5020,214484,8,304308
49921,0.002148,74.125.24.0-255,1484,215968,8,304308
49922,0.002165,74.125.24.0-255,2902,218870,8,304308
49923,0.002187,74.125.24.0-255,5738,224608,8,304308
49924,0.002209,74.125.24.0-255,4320,228928,8,304308
49925,0.002267,74.125.24.0-255,4320,233248,8,304308
49926,0.002284,74.125.24.0-255,3602,236850,8,304308
49927,0.002337,74.125.24.0-255,1484,238334,8,304308
49928,0.00236,74.125.24.0-255,2902,241236,8,304308
49929,0.002394,74.125.24.0-255,4320,245556,8,304308
49930,0.002413,74.125.24.0-255,1484,247040,8,304308
49931,0.002417,74.125.24.0-255,2902,249942,8,304308
49932,0.00242,74.125.24.0-255,1484,251426,8,304308
49933,0.002431,74.125.24.0-255,1484,252910,8,304308
49934,0.002434,74.125.24.0-255,1484,254394,8,304308
49935,0.002459,74.125.24.0-255,4320,258714,8,304308
49936,0.002474,74.125.24.0-255,2902,261616,8,304308
49937,0.002492,74.125.24.0-255,4320,265936,8,304308
49938,0.002513,74.125.24.0-255,2902,268838,8,304308
49939,0.00252,74.125.24.0-255,5738,274576,8,304308
49940,0.002538,74.125.24.0-255,7156,281732,8,304308
49941,0.002554,74.125.24.0-255,2184,283916,8,304308
49942,0.002557,74.125.24.0-255,1484,285400,8,304308
49943,0.00257,74.125.24.0-255,1484,286884,8,304308
49944,0.002607,74.125.24.0-255,5020,291904,8,304308
49945,0.002622,74.125.24.0-255,1484,293388,8,304308
49946,0.002638,74.125.24.0-255,6295,299683,8,304308
49947,0.002691,74.125.24.0-255,105,299788,8,304308
49948,0.008747,172.31.36.0-255,66,299854,8,304308
49949,0.011368,172.31.36.0-255,105,299959,8,304308
49950,0.013626,74.125.24.0-255,66,300025,8,304308
49951,0.033489,172.31.36.0-255,167,300192,8,304308
49952,0.033529,172.31.36.0-255,1112,301304,8,304308
49953,0.033592,172.31.36.0-255,1514,302818,8,304308
49954,0.033594,172.31.36.0-255,1292,304110,8,304308
49955,0.035083,104.244.42.0-255,66,304176,8,304308
49956,0.035117,104.244.42.0-255,66,304242,8,304308
49957,0.035178,104.244.42.0-255,66,304308,8,304308
49958,0.0,74.125.68.0-255,150,150,8,321895
49959,1.9e-05,172.31.36.0-255,66,216,8,321895
49960,2.6e-05,74.125.68.0-255,1484,1700,8,321895
49961,3e-05,172.31.36.0-255,66,1766,8,321895
49962,3.6e-05,74.125.68.0-255,2902,4668,8,321895
49963,3.9e-05,172.31.36.0-255,66,4734,8,321895
49964,5.1e-05,74.125.68.0-255,1484,6218,8,321895
49965,5.3e-05,172.31.36.0-255,66,6284,8,321895
49966,5.8e-05,74.125.68.0-255,2902,9186,8,321895
49967,6.1e-05,172.31.36.0-255,66,9252,8,321895
49968,9.9e-05,74.125.68.0-255,4893,14145,8,321895
49969,0.000102,172.31.36.0-255,66,14211,8,321895
49970,0.000192,74.125.68.0-255,1484,15695,8,321895
49971,0.000196,172.31.36.0-255,66,15761,8,321895
49972,0.000222,74.125.68.0-255,2902,18663,8,321895
49973,0.000225,172.31.36.0-255,66,18729,8,321895
49974,0.000231,74.125.68.0-255,5738,24467,8,321895
49975,0.000233,172.31.36.0-255,66,24533,8,321895
49976,0.000262,74.125.68.0-255,4320,28853,8,321895
49977,0.000264,172.31.36.0-255,66,28919,8,321895
49978,0.000268,74.125.68.0-255,1484,30403,8,321895
49979,0.00027,172.31.36.0-255,66,30469,8,321895
49980,0.000301,74.125.68.0-255,3961,34430,8,321895
49981,0.000304,172.31.36.0-255,66,34496,8,321895
49982,0.000309,74.125.68.0-255,4320,38816,8,321895
49983,0.000311,172.31.36.0-255,66,38882,8,321895
49984,0.000341,74.125.68.0-255,5738,44620,8,321895
49985,0.000344,172.31.36.0-255,66,44686,8,321895
49986,0.000358,74.125.68.0-255,3961,48647,8,321895
49987,0.000361,172.31.36.0-255,66,48713,8,321895
49988,0.001346,74.125.68.0-255,1484,50197,8,321895
49989,0.001353,172.31.36.0-255,66,50263,8,321895
49990,0.001362,74.125.68.0-255,2902,53165,8,321895
49991,0.001365,172.31.36.0-255,66,53231,8,321895
49992,0.001376,74.125.68.0-255,4320,57551,8,321895
49993,0.001378,172.31.36.0-255,66,57617,8,321895
49994,0.001415,172.31.36.0-255,66,57683,8,321895
49995,0.001449,172.31.36.0-255,66,57749,8,321895
49996,0.001502,74.125.68.0-255,5738,63487,8,321895
49997,0.001504,172.31.36.0-255,66,63553,8,321895
49998,0.001511,74.125.68.0-255,4320,67873,8,321895
49999,0.001513,172.31.36.0-255,66,67939,8,321895
50000,0.001542,74.125.68.0-255,2902,70841,8,321895
50001,0.001544,172.31.36.0-255,66,70907,8,321895
50002,0.001555,172.31.36.0-255,66,70973,8,321895
50003,0.001583,74.125.68.0-255,3602,74575,8,321895
50004,0.001587,172.31.36.0-255,66,74641,8,321895
50005,0.001618,74.125.68.0-255,1484,76125,8,321895
50006,0.001647,172.31.36.0-255,66,76191,8,321895
50007,0.00169,74.125.68.0-255,3843,80034,8,321895
50008,0.001693,172.31.36.0-255,66,80100,8,321895
50009,0.001743,74.125.68.0-255,1484,81584,8,321895
50010,0.001762,74.125.68.0-255,2902,84486,8,321895
50011,0.001766,172.31.36.0-255,66,84552,8,321895
50012,0.001772,74.125.68.0-255,5738,90290,8,321895
50013,0.001775,172.31.36.0-255,66,90356,8,321895
50014,0.001801,74.125.68.0-255,2902,93258,8,321895
50015,0.001804,172.31.36.0-255,66,93324,8,321895
50016,0.001832,74.125.68.0-255,4658,97982,8,321895
50017,0.001834,172.31.36.0-255,66,98048,8,321895
50018,0.001842,74.125.68.0-255,7156,105204,8,321895
50019,0.001845,172.31.36.0-255,66,105270,8,321895
50020,0.001865,74.125.68.0-255,1484,106754,8,321895
50021,0.001886,74.125.68.0-255,5738,112492,8,321895
50022,0.00189,172.31.36.0-255,66,112558,8,321895
50023,0.001915,74.125.68.0-255,2902,115460,8,321895
50024,0.001918,172.31.36.0-255,66,115526,8,321895
50025,0.001943,74.125.68.0-255,4320,119846,8,321895
50026,0.001945,172.31.36.0-255,66,119912,8,321895
50027,0.001975,172.31.36.0-255,66,119978,8,321895
50028,0.002052,74.125.68.0-255,1484,121462,8,321895
50029,0.002057,74.125.68.0-255,2902,124364,8,321895
50030,0.00206,172.31.36.0-255,66,124430,8,321895
50031,0.002087,74.125.68.0-255,5738,130168,8,321895
50032,0.00209,172.31.36.0-255,66,130234,8,321895
50033,0.002126,74.125.68.0-255,7156,137390,8,321895
50034,0.002129,172.31.36.0-255,66,137456,8,321895
50035,0.002164,172.31.36.0-255,66,137522,8,321895
50036,0.00219,74.125.68.0-255,4320,141842,8,321895
50037,0.002193,172.31.36.0-255,66,141908,8,321895
50038,0.002217,74.125.68.0-255,3602,145510,8,321895
50039,0.00222,172.31.36.0-255,66,145576,8,321895
50040,0.004485,74.125.68.0-255,1484,147060,8,321895
50041,0.004517,74.125.68.0-255,4320,151380,8,321895
50042,0.004524,172.31.36.0-255,66,151446,8,321895
50043,0.006828,74.125.68.0-255,5738,157184,8,321895
50044,0.006834,172.31.36.0-255,66,157250,8,321895
50045,0.009129,74.125.68.0-255,2902,160152,8,321895
50046,0.009135,172.31.36.0-255,66,160218,8,321895
50047,0.009164,74.125.68.0-255,2902,163120,8,321895
50048,0.009166,172.31.36.0-255,66,163186,8,321895
50049,0.011446,74.125.68.0-255,2902,166088,8,321895
50050,0.011454,172.31.36.0-255,66,166154,8,321895
50051,0.011482,74.125.68.0-255,2902,169056,8,321895
50052,0.011485,172.31.36.0-255,66,169122,8,321895
50053,0.013751,74.125.68.0-255,2902,172024,8,321895
50054,0.01376,172.31.36.0-255,66,172090,8,321895
50055,0.013791,74.125.68.0-255,2902,174992,8,321895
50056,0.013794,172.31.36.0-255,66,175058,8,321895
50057,0.016056,74.125.68.0-255,2902,177960,8,321895
50058,0.016062,172.31.36.0-255,66,178026,8,321895
50059,0.016089,74.125.68.0-255,2902,180928,8,321895
50060,0.016091,172.31.36.0-255,66,180994,8,321895
50061,0.018377,74.125.68.0-255,2902,183896,8,321895
50062,0.018388,172.31.36.0-255,66,183962,8,321895
50063,0.01842,74.125.68.0-255,2902,186864,8,321895
50064,0.018424,172.31.36.0-255,66,186930,8,321895
50065,0.020681,74.125.68.0-255,2902,189832,8,321895
50066,0.020688,172.31.36.0-255,66,189898,8,321895
50067,0.020721,74.125.68.0-255,2902,192800,8,321895
50068,0.020723,172.31.36.0-255,66,192866,8,321895
50069,0.02301,74.125.68.0-255,2902,195768,8,321895
50070,0.023016,172.31.36.0-255,66,195834,8,321895
50071,0.02304,74.125.68.0-255,2902,198736,8,321895
50072,0.023043,172.31.36.0-255,66,198802,8,321895
50073,0.025343,74.125.68.0-255,2902,201704,8,321895
50074,0.025352,172.31.36.0-255,66,201770,8,321895
50075,0.025385,74.125.68.0-255,2902,204672,8,321895
50076,0.025388,172.31.36.0-255,66,204738,8,321895
50077,0.027666,74.125.68.0-255,2902,207640,8,321895
50078,0.027675,172.31.36.0-255,66,207706,8,321895
50079,0.027731,74.125.68.0-255,2902,210608,8,321895
50080,0.027734,172.31.36.0-255,66,210674,8,321895
50081,0.029977,74.125.68.0-255,2902,213576,8,321895
50082,0.029986,172.31.36.0-255,66,213642,8,321895
50083,0.030015,74.125.68.0-255,1484,215126,8,321895
50084,0.03003,74.125.68.0-255,1484,216610,8,321895
50085,0.030033,172.31.36.0-255,66,216676,8,321895
50086,0.032301,74.125.68.0-255,2902,219578,8,321895
50087,0.03231,172.31.36.0-255,66,219644,8,321895
50088,0.032342,74.125.68.0-255,2902,222546,8,321895
50089,0.032345,172.31.36.0-255,66,222612,8,321895
50090,0.034635,74.125.68.0-255,5738,228350,8,321895
50091,0.034644,172.31.36.0-255,66,228416,8,321895
50092,0.036796,172.31.36.0-255,172,228588,8,321895
50093,0.036829,172.31.36.0-255,1112,229700,8,321895
50094,0.036902,172.31.36.0-255,1514,231214,8,321895
50095,0.036904,172.31.36.0-255,1514,232728,8,321895
50096,0.036905,172.31.36.0-255,1514,234242,8,321895
50097,0.036906,172.31.36.0-255,1514,235756,8,321895
50098,0.036907,172.31.36.0-255,167,235923,8,321895
50099,0.03699,74.125.68.0-255,4320,240243,8,321895
50100,0.036995,172.31.36.0-255,66,240309,8,321895
50101,0.037025,74.125.68.0-255,1484,241793,8,321895
50102,0.038329,104.244.42.0-255,66,241859,8,321895
50103,0.038435,104.244.42.0-255,66,241925,8,321895
50104,0.038477,104.244.42.0-255,66,241991,8,321895
50105,0.038481,104.244.42.0-255,66,242057,8,321895
50106,0.039298,74.125.68.0-255,4320,246377,8,321895
50107,0.039306,172.31.36.0-255,66,246443,8,321895
50108,0.041599,74.125.68.0-255,5738,252181,8,321895
50109,0.041606,172.31.36.0-255,66,252247,8,321895
50110,0.04393,74.125.68.0-255,5738,257985,8,321895
50111,0.043938,172.31.36.0-255,66,258051,8,321895
50112,0.046256,74.125.68.0-255,5738,263789,8,321895
50113,0.046263,172.31.36.0-255,66,263855,8,321895
50114,0.048571,74.125.68.0-255,5738,269593,8,321895
50115,0.048578,172.31.36.0-255,66,269659,8,321895
50116,0.050886,74.125.68.0-255,5738,275397,8,321895
50117,0.050894,172.31.36.0-255,66,275463,8,321895
50118,0.053235,74.125.68.0-255,5738,281201,8,321895
50119,0.053241,172.31.36.0-255,66,281267,8,321895
50120,0.055542,74.125.68.0-255,5738,287005,8,321895
50121,0.055548,172.31.36.0-255,66,287071,8,321895
50122,0.057842,74.125.68.0-255,5738,292809,8,321895
50123,0.057849,172.31.36.0-255,66,292875,8,321895
50124,0.060164,74.125.68.0-255,5738,298613,8,321895
50125,0.060171,172.31.36.0-255,66,298679,8,321895
50126,0.062487,74.125.68.0-255,5738,304417,8,321895
50127,0.062493,172.31.36.0-255,66,304483,8,321895
50128,0.064805,74.125.68.0-255,5738,310221,8,321895
50129,0.064812,172.31.36.0-255,66,310287,8,321895
50130,0.067119,74.125.68.0-255,5738,316025,8,321895
50131,0.067126,172.31.36.0-255,66,316091,8,321895
50132,0.06944,74.125.68.0-255,5738,321829,8,321895
50133,0.069447,172.31.36.0-255,66,321895,8,321895
50134,0.0,172.217.194.0-255,152,152,8,285418
50135,3.6e-05,172.31.36.0-255,66,218,8,285418
50136,4.4e-05,172.217.194.0-255,1484,1702,8,285418
50137,4.9e-05,172.31.36.0-255,66,1768,8,285418
50138,6.2e-05,172.217.194.0-255,2902,4670,8,285418
50139,6.5e-05,172.31.36.0-255,66,4736,8,285418
50140,7.4e-05,172.217.194.0-255,7156,11892,8,285418
50141,7.7e-05,172.31.36.0-255,66,11958,8,285418
50142,0.000102,172.217.194.0-255,2067,14025,8,285418
50143,0.000104,172.31.36.0-255,66,14091,8,285418
50144,0.000284,172.217.194.0-255,1484,15575,8,285418
50145,0.000289,172.31.36.0-255,66,15641,8,285418
50146,0.000295,172.217.194.0-255,2902,18543,8,285418
50147,0.000297,172.31.36.0-255,66,18609,8,285418
50148,0.000333,172.217.194.0-255,5738,24347,8,285418
50149,0.000337,172.31.36.0-255,66,24413,8,285418
50150,0.000345,172.217.194.0-255,6797,31210,8,285418
50151,0.000348,172.31.36.0-255,66,31276,8,285418
50152,0.000392,172.31.36.0-255,66,31342,8,285418
50153,0.000397,172.217.194.0-255,2543,33885,8,285418
50154,0.0004,172.31.36.0-255,66,33951,8,285418
50155,0.00109,172.217.194.0-255,1484,35435,8,285418
50156,0.001096,172.31.36.0-255,66,35501,8,285418
50157,0.001107,172.217.194.0-255,2902,38403,8,285418
50158,0.001116,172.31.36.0-255,66,38469,8,285418
50159,0.001123,172.217.194.0-255,5738,44207,8,285418
50160,0.001125,172.31.36.0-255,66,44273,8,285418
50161,0.001129,172.217.194.0-255,2902,47175,8,285418
50162,0.001132,172.31.36.0-255,66,47241,8,285418
50163,0.001163,172.217.194.0-255,4271,51512,8,285418
50164,0.001166,172.31.36.0-255,66,51578,8,285418
50165,0.001169,172.217.194.0-255,366,51944,8,285418
50166,0.001453,172.217.194.0-255,1484,53428,8,285418
50167,0.001458,172.31.36.0-255,66,53494,8,285418
50168,0.001464,172.217.194.0-255,2902,56396,8,285418
50169,0.001467,172.31.36.0-255,66,56462,8,285418
50170,0.001478,172.217.194.0-255,5738,62200,8,285418
50171,0.00148,172.31.36.0-255,66,62266,8,285418
50172,0.001511,172.31.36.0-255,66,62332,8,285418
50173,0.001522,172.31.36.0-255,66,62398,8,285418
50174,0.001548,172.217.194.0-255,2184,64582,8,285418
50175,0.001551,172.31.36.0-255,66,64648,8,285418
50176,0.002024,172.217.194.0-255,1484,66132,8,285418
50177,0.002032,172.217.194.0-255,2902,69034,8,285418
50178,0.002036,172.31.36.0-255,66,69100,8,285418
50179,0.00204,172.217.194.0-255,1484,70584,8,285418
50180,0.002067,172.217.194.0-255,4320,74904,8,285418
50181,0.002071,172.31.36.0-255,66,74970,8,285418
50182,0.002079,172.217.194.0-255,7156,82126,8,285418
50183,0.002081,172.31.36.0-255,66,82192,8,285418
50184,0.002089,172.217.194.0-255,7156,89348,8,285418
50185,0.002092,172.31.36.0-255,66,89414,8,285418
50186,0.002126,172.217.194.0-255,7156,96570,8,285418
50187,0.00213,172.31.36.0-255,66,96636,8,285418
50188,0.002134,172.217.194.0-255,2184,98820,8,285418
50189,0.002136,172.31.36.0-255,66,98886,8,285418
50190,0.004201,172.217.194.0-255,5738,104624,8,285418
50191,0.004207,172.31.36.0-255,66,104690,8,285418
50192,0.006283,172.217.194.0-255,5738,110428,8,285418
50193,0.00629,172.31.36.0-255,66,110494,8,285418
50194,0.008397,172.217.194.0-255,5738,116232,8,285418
50195,0.008409,172.31.36.0-255,66,116298,8,285418
50196,0.010531,172.217.194.0-255,5738,122036,8,285418
50197,0.010549,172.31.36.0-255,66,122102,8,285418
50198,0.012648,172.217.194.0-255,5738,127840,8,285418
50199,0.012665,172.31.36.0-255,66,127906,8,285418
50200,0.014741,172.217.194.0-255,5738,133644,8,285418
50201,0.014754,172.31.36.0-255,66,133710,8,285418
50202,0.016814,172.217.194.0-255,5738,139448,8,285418
50203,0.016831,172.31.36.0-255,66,139514,8,285418
50204,0.018897,172.217.194.0-255,5738,145252,8,285418
50205,0.018914,172.31.36.0-255,66,145318,8,285418
50206,0.02099,172.217.194.0-255,5738,151056,8,285418
50207,0.021004,172.31.36.0-255,66,151122,8,285418
50208,0.023098,172.217.194.0-255,5738,156860,8,285418
50209,0.023109,172.31.36.0-255,66,156926,8,285418
50210,0.025203,172.217.194.0-255,5738,162664,8,285418
50211,0.02522,172.31.36.0-255,66,162730,8,285418
50212,0.0273,172.217.194.0-255,5738,168468,8,285418
50213,0.027313,172.31.36.0-255,66,168534,8,285418
50214,0.029407,172.217.194.0-255,5738,174272,8,285418
50215,0.029418,172.31.36.0-255,66,174338,8,285418
50216,0.030449,172.31.36.0-255,176,174514,8,285418
50217,0.030482,172.31.36.0-255,562,175076,8,285418
50218,0.031489,172.217.194.0-255,5738,180814,8,285418
50219,0.031497,172.31.36.0-255,66,180880,8,285418
50220,0.032804,104.244.42.0-255,66,180946,8,285418
50221,0.033609,172.217.194.0-255,5738,186684,8,285418
50222,0.033616,172.31.36.0-255,66,186750,8,285418
50223,0.035719,172.217.194.0-255,5738,192488,8,285418
50224,0.035727,172.31.36.0-255,66,192554,8,285418
50225,0.037781,172.217.194.0-255,5738,198292,8,285418
50226,0.037789,172.31.36.0-255,66,198358,8,285418
50227,0.039861,172.217.194.0-255,5738,204096,8,285418
50228,0.039867,172.31.36.0-255,66,204162,8,285418
50229,0.041928,172.217.194.0-255,5738,209900,8,285418
50230,0.041938,172.31.36.0-255,66,209966,8,285418
50231,0.044024,172.217.194.0-255,5738,215704,8,285418
50232,0.044031,172.31.36.0-255,66,215770,8,285418
50233,0.046139,172.217.194.0-255,5738,221508,8,285418
50234,0.046147,172.31.36.0-255,66,221574,8,285418
50235,0.048243,172.217.194.0-255,5738,227312,8,285418
50236,0.04825,172.31.36.0-255,66,227378,8,285418
50237,0.050335,172.217.194.0-255,5738,233116,8,285418
50238,0.050343,172.31.36.0-255,66,233182,8,285418
50239,0.052436,172.217.194.0-255,5738,238920,8,285418
50240,0.052443,172.31.36.0-255,66,238986,8,285418
50241,0.054551,172.217.194.0-255,5738,244724,8,285418
50242,0.054559,172.31.36.0-255,66,244790,8,285418
50243,0.056647,172.217.194.0-255,5738,250528,8,285418
50244,0.056654,172.31.36.0-255,66,250594,8,285418
50245,0.058717,172.217.194.0-255,5738,256332,8,285418
50246,0.058724,172.31.36.0-255,66,256398,8,285418
50247,0.060785,172.217.194.0-255,5738,262136,8,285418
50248,0.060792,172.31.36.0-255,66,262202,8,285418
50249,0.062843,172.217.194.0-255,5738,267940,8,285418
50250,0.06285,172.31.36.0-255,66,268006,8,285418
50251,0.064941,172.217.194.0-255,5738,273744,8,285418
50252,0.064948,172.31.36.0-255,66,273810,8,285418
50253,0.06702,172.217.194.0-255,5738,279548,8,285418
50254,0.067026,172.31.36.0-255,66,279614,8,285418
50255,0.069099,172.217.194.0-255,5738,285352,8,285418
50256,0.069107,172.31.36.0-255,66,285418,8,285418
50257,0.0,172.31.36.0-255,176,176,8,242
50258,0.006537,74.125.24.0-255,66,242,8,242
50259,0.0,172.253.118.0-255,153,153,8,332440
50260,1.5e-05,172.31.36.0-255,66,219,8,332440
50261,2.2e-05,172.253.118.0-255,1484,1703,8,332440
50262,2.6e-05,172.31.36.0-255,66,1769,8,332440
50263,3.2e-05,172.253.118.0-255,2902,4671,8,332440
50264,3.5e-05,172.31.36.0-255,66,4737,8,332440
50265,4.4e-05,172.253.118.0-255,7156,11893,8,332440
50266,4.8e-05,172.31.36.0-255,66,11959,8,332440
50267,5.4e-05,172.253.118.0-255,1996,13955,8,332440
50268,5.7e-05,172.31.36.0-255,66,14021,8,332440
50269,6.3e-05,172.253.118.0-255,4320,18341,8,332440
50270,6.7e-05,172.31.36.0-255,66,18407,8,332440
50271,9.5e-05,172.253.118.0-255,7156,25563,8,332440
50272,9.8e-05,172.31.36.0-255,66,25629,8,332440
50273,0.000104,172.253.118.0-255,5379,31008,8,332440
50274,0.000107,172.31.36.0-255,66,31074,8,332440
50275,0.00014,172.253.118.0-255,1484,32558,8,332440
50276,0.000143,172.31.36.0-255,66,32624,8,332440
50277,0.000169,172.253.118.0-255,2902,35526,8,332440
50278,0.000172,172.31.36.0-255,66,35592,8,332440
50279,0.000178,172.253.118.0-255,4320,39912,8,332440
50280,0.000181,172.31.36.0-255,66,39978,8,332440
50281,0.000203,172.253.118.0-255,1484,41462,8,332440
50282,0.000206,172.31.36.0-255,66,41528,8,332440
50283,0.000212,172.253.118.0-255,5738,47266,8,332440
50284,0.000214,172.31.36.0-255,66,47332,8,332440
50285,0.000261,172.253.118.0-255,1125,48457,8,332440
50286,0.000263,172.31.36.0-255,66,48523,8,332440
50287,0.000387,172.253.118.0-255,1484,50007,8,332440
50288,0.000393,172.31.36.0-255,66,50073,8,332440
50289,0.000398,172.253.118.0-255,2902,52975,8,332440
50290,0.000401,172.31.36.0-255,66,53041,8,332440
50291,0.000408,172.253.118.0-255,5738,58779,8,332440
50292,0.00041,172.31.36.0-255,66,58845,8,332440
50293,0.000418,172.253.118.0-255,7126,65971,8,332440
50294,0.000421,172.31.36.0-255,66,66037,8,332440
50295,0.000572,172.253.118.0-255,349,66386,8,332440
50296,0.00069,172.253.118.0-255,1484,67870,8,332440
50297,0.000696,172.31.36.0-255,66,67936,8,332440
50298,0.000702,172.253.118.0-255,2902,70838,8,332440
50299,0.000705,172.31.36.0-255,66,70904,8,332440
50300,0.000709,172.253.118.0-255,2902,73806,8,332440
50301,0.000711,172.31.36.0-255,66,73872,8,332440
50302,0.000718,172.253.118.0-255,7156,81028,8,332440
50303,0.000722,172.31.36.0-255,66,81094,8,332440
50304,0.000767,172.253.118.0-255,2543,83637,8,332440
50305,0.000771,172.31.36.0-255,66,83703,8,332440
50306,0.00086,172.253.118.0-255,1484,85187,8,332440
50307,0.000867,172.253.118.0-255,2902,88089,8,332440
50308,0.000871,172.31.36.0-255,66,88155,8,332440
50309,0.000902,172.253.118.0-255,5738,93893,8,332440
50310,0.000906,172.31.36.0-255,66,93959,8,332440
50311,0.000915,172.253.118.0-255,6797,100756,8,332440
50312,0.000918,172.31.36.0-255,66,100822,8,332440
50313,0.001075,172.253.118.0-255,1484,102306,8,332440
50314,0.001082,172.253.118.0-255,2902,105208,8,332440
50315,0.001086,172.31.36.0-255,66,105274,8,332440
50316,0.001093,172.253.118.0-255,4320,109594,8,332440
50317,0.001095,172.31.36.0-255,66,109660,8,332440
50318,0.001112,172.253.118.0-255,1484,111144,8,332440
50319,0.001117,172.253.118.0-255,4320,115464,8,332440
50320,0.001119,172.31.36.0-255,66,115530,8,332440
50321,0.001123,172.253.118.0-255,1484,117014,8,332440
50322,0.001163,172.31.36.0-255,66,117080,8,332440
50323,0.001167,172.253.118.0-255,1484,118564,8,332440
50324,0.001189,172.253.118.0-255,6438,125002,8,332440
50325,0.001193,172.31.36.0-255,66,125068,8,332440
50326,0.001824,172.253.118.0-255,1484,126552,8,332440
50327,0.001829,172.253.118.0-255,2902,129454,8,332440
50328,0.001834,172.253.118.0-255,5738,135192,8,332440
50329,0.001842,172.31.36.0-255,66,135258,8,332440
50330,0.00185,172.31.36.0-255,66,135324,8,332440
50331,0.001854,172.253.118.0-255,2902,138226,8,332440
50332,0.001856,172.31.36.0-255,66,138292,8,332440
50333,0.001895,172.31.36.0-255,66,138358,8,332440
50334,0.00193,172.253.118.0-255,5738,144096,8,332440
50335,0.001933,172.31.36.0-255,66,144162,8,332440
50336,0.001953,172.253.118.0-255,5020,149182,8,332440
50337,0.001956,172.31.36.0-255,66,149248,8,332440
50338,0.002234,172.253.118.0-255,1484,150732,8,332440
50339,0.002237,172.253.118.0-255,1484,152216,8,332440
50340,0.002242,172.31.36.0-255,66,152282,8,332440
50341,0.002249,172.253.118.0-255,1484,153766,8,332440
50342,0.002255,172.253.118.0-255,4320,158086,8,332440
50343,0.002256,172.31.36.0-255,66,158152,8,332440
50344,0.002267,172.253.118.0-255,1484,159636,8,332440
50345,0.00227,172.253.118.0-255,1484,161120,8,332440
50346,0.002272,172.31.36.0-255,66,161186,8,332440
50347,0.0023,172.31.36.0-255,66,161252,8,332440
50348,0.002333,172.253.118.0-255,2902,164154,8,332440
50349,0.002336,172.31.36.0-255,66,164220,8,332440
50350,0.002364,172.31.36.0-255,66,164286,8,332440
50351,0.00472,172.253.118.0-255,4320,168606,8,332440
50352,0.004726,172.31.36.0-255,66,168672,8,332440
50353,0.004744,172.253.118.0-255,1484,170156,8,332440
50354,0.007087,172.253.118.0-255,4320,174476,8,332440
50355,0.007099,172.31.36.0-255,66,174542,8,332440
50356,0.009483,172.253.118.0-255,5738,180280,8,332440
50357,0.009492,172.31.36.0-255,66,180346,8,332440
50358,0.011899,172.253.118.0-255,5738,186084,8,332440
50359,0.01191,172.31.36.0-255,66,186150,8,332440
50360,0.014275,172.253.118.0-255,5738,191888,8,332440
50361,0.014288,172.31.36.0-255,66,191954,8,332440
50362,0.016676,172.253.118.0-255,5738,197692,8,332440
50363,0.01669,172.31.36.0-255,66,197758,8,332440
50364,0.019034,172.253.118.0-255,5738,203496,8,332440
50365,0.01904,172.31.36.0-255,66,203562,8,332440
50366,0.021402,172.253.118.0-255,5738,209300,8,332440
50367,0.02141,172.31.36.0-255,66,209366,8,332440
50368,0.023795,172.253.118.0-255,5738,215104,8,332440
50369,0.023802,172.31.36.0-255,66,215170,8,332440
50370,0.026172,172.253.118.0-255,5738,220908,8,332440
50371,0.02618,172.31.36.0-255,66,220974,8,332440
50372,0.028535,172.253.118.0-255,5738,226712,8,332440
50373,0.028543,172.31.36.0-255,66,226778,8,332440
50374,0.030413,172.31.36.0-255,172,226950,8,332440
50375,0.030444,172.31.36.0-255,1113,228063,8,332440
50376,0.03051,172.31.36.0-255,1514,229577,8,332440
50377,0.030512,172.31.36.0-255,1514,231091,8,332440
50378,0.030513,172.31.36.0-255,1514,232605,8,332440
50379,0.030514,172.31.36.0-255,771,233376,8,332440
50380,0.030898,172.253.118.0-255,5738,239114,8,332440
50381,0.030905,172.31.36.0-255,66,239180,8,332440
50382,0.031975,104.244.42.0-255,66,239246,8,332440
50383,0.032008,104.244.42.0-255,66,239312,8,332440
50384,0.032111,104.244.42.0-255,66,239378,8,332440
50385,0.032134,104.244.42.0-255,66,239444,8,332440
50386,0.032145,104.244.42.0-255,66,239510,8,332440
50387,0.03326,172.253.118.0-255,5738,245248,8,332440
50388,0.033268,172.31.36.0-255,66,245314,8,332440
50389,0.035648,172.253.118.0-255,5738,251052,8,332440
50390,0.035655,172.31.36.0-255,66,251118,8,332440
50391,0.038061,172.253.118.0-255,5738,256856,8,332440
50392,0.038068,172.31.36.0-255,66,256922,8,332440
50393,0.040427,172.253.118.0-255,5738,262660,8,332440
50394,0.040434,172.31.36.0-255,66,262726,8,332440
50395,0.042782,172.253.118.0-255,5738,268464,8,332440
50396,0.042791,172.31.36.0-255,66,268530,8,332440
50397,0.045146,172.253.118.0-255,5738,274268,8,332440
50398,0.045153,172.31.36.0-255,66,274334,8,332440
50399,0.04753,172.253.118.0-255,5738,280072,8,332440
50400,0.047544,172.31.36.0-255,66,280138,8,332440
50401,0.049918,172.253.118.0-255,5738,285876,8,332440
50402,0.049926,172.31.36.0-255,66,285942,8,332440
50403,0.052274,172.253.118.0-255,5738,291680,8,332440
50404,0.052282,172.31.36.0-255,66,291746,8,332440
50405,0.054649,172.253.118.0-255,5738,297484,8,332440
50406,0.054655,172.31.36.0-255,66,297550,8,332440
50407,0.057023,172.253.118.0-255,5738,303288,8,332440
50408,0.057029,172.31.36.0-255,66,303354,8,332440
50409,0.059368,172.253.118.0-255,5738,309092,8,332440
50410,0.059374,172.31.36.0-255,66,309158,8,332440
50411,0.061726,172.253.118.0-255,5738,314896,8,332440
50412,0.061733,172.31.36.0-255,66,314962,8,332440
50413,0.064084,172.253.118.0-255,5738,320700,8,332440
50414,0.064091,172.31.36.0-255,66,320766,8,332440
50415,0.066442,172.253.118.0-255,5738,326504,8,332440
50416,0.066447,172.31.36.0-255,66,326570,8,332440
50417,0.068791,172.253.118.0-255,4320,330890,8,332440
50418,0.068796,172.31.36.0-255,66,330956,8,332440
50419,0.068841,172.253.118.0-255,1484,332440,8,332440
50420,0.0,172.217.194.0-255,153,153,8,198779
50421,2.8e-05,172.31.36.0-255,66,219,8,198779
50422,3.5e-05,172.217.194.0-255,1484,1703,8,198779
50423,3.9e-05,172.31.36.0-255,66,1769,8,198779
50424,4.4e-05,172.217.194.0-255,2902,4671,8,198779
50425,4.7e-05,172.31.36.0-255,66,4737,8,198779
50426,6.1e-05,172.217.194.0-255,7156,11893,8,198779
50427,6.3e-05,172.31.36.0-255,66,11959,8,198779
50428,6.8e-05,172.217.194.0-255,2002,13961,8,198779
50429,7.1e-05,172.31.36.0-255,66,14027,8,198779
50430,7.4e-05,172.217.194.0-255,1484,15511,8,198779
50431,7.6e-05,172.31.36.0-255,66,15577,8,198779
50432,0.000123,172.31.36.0-255,66,15643,8,198779
50433,0.000129,172.217.194.0-255,5379,21022,8,198779
50434,0.000131,172.31.36.0-255,66,21088,8,198779
50435,0.000158,172.217.194.0-255,1484,22572,8,198779
50436,0.000161,172.31.36.0-255,66,22638,8,198779
50437,0.000167,172.217.194.0-255,2902,25540,8,198779
50438,0.000172,172.31.36.0-255,66,25606,8,198779
50439,0.000185,172.217.194.0-255,4320,29926,8,198779
50440,0.000188,172.31.36.0-255,66,29992,8,198779
50441,0.000216,172.217.194.0-255,1484,31476,8,198779
50442,0.000218,172.31.36.0-255,66,31542,8,198779
50443,0.000238,172.31.36.0-255,66,31608,8,198779
50444,0.000247,172.31.36.0-255,66,31674,8,198779
50445,0.00028,172.217.194.0-255,2797,34471,8,198779
50446,0.000283,172.31.36.0-255,66,34537,8,198779
50447,0.000321,172.217.194.0-255,1484,36021,8,198779
50448,0.000324,172.31.36.0-255,66,36087,8,198779
50449,0.00033,172.217.194.0-255,2902,38989,8,198779
50450,0.000332,172.31.36.0-255,66,39055,8,198779
50451,0.000364,172.217.194.0-255,5738,44793,8,198779
50452,0.000367,172.31.36.0-255,66,44859,8,198779
50453,0.00038,172.31.36.0-255,66,44925,8,198779
50454,0.000406,172.217.194.0-255,2902,47827,8,198779
50455,0.00041,172.31.36.0-255,66,47893,8,198779
50456,0.00042,172.31.36.0-255,66,47959,8,198779
50457,0.000426,172.217.194.0-255,2184,50143,8,198779
50458,0.000428,172.31.36.0-255,66,50209,8,198779
50459,0.000812,172.217.194.0-255,1484,51693,8,198779
50460,0.000816,172.217.194.0-255,1484,53177,8,198779
50461,0.000819,172.31.36.0-255,66,53243,8,198779
50462,0.000845,172.217.194.0-255,1484,54727,8,198779
50463,0.000852,172.217.194.0-255,5738,60465,8,198779
50464,0.000856,172.31.36.0-255,66,60531,8,198779
50465,0.000861,172.217.194.0-255,2902,63433,8,198779
50466,0.000862,172.31.36.0-255,66,63499,8,198779
50467,0.000894,172.217.194.0-255,4320,67819,8,198779
50468,0.000897,172.31.36.0-255,66,67885,8,198779
50469,0.000925,172.217.194.0-255,5738,73623,8,198779
50470,0.000928,172.31.36.0-255,66,73689,8,198779
50471,0.000946,172.31.36.0-255,66,73755,8,198779
50472,0.00106,172.217.194.0-255,1484,75239,8,198779
50473,0.001064,172.217.194.0-255,1484,76723,8,198779
50474,0.001068,172.31.36.0-255,66,76789,8,198779
50475,0.001094,172.217.194.0-255,1484,78273,8,198779
50476,0.001101,172.217.194.0-255,5738,84011,8,198779
50477,0.001104,172.31.36.0-255,66,84077,8,198779
50478,0.001117,172.31.36.0-255,66,84143,8,198779
50479,0.001149,172.217.194.0-255,1484,85627,8,198779
50480,0.001162,172.31.36.0-255,66,85693,8,198779
50481,0.001218,172.217.194.0-255,1484,87177,8,198779
50482,0.001222,172.217.194.0-255,1484,88661,8,198779
50483,0.001224,172.31.36.0-255,66,88727,8,198779
50484,0.001242,172.217.194.0-255,1484,90211,8,198779
50485,0.001249,172.217.194.0-255,5738,95949,8,198779
50486,0.001251,172.31.36.0-255,66,96015,8,198779
50487,0.001307,172.31.36.0-255,66,96081,8,198779
50488,0.001317,172.31.36.0-255,66,96147,8,198779
50489,0.001352,172.217.194.0-255,2184,98331,8,198779
50490,0.001356,172.31.36.0-255,66,98397,8,198779
50491,0.001572,172.217.194.0-255,1484,99881,8,198779
50492,0.001588,172.217.194.0-255,2902,102783,8,198779
50493,0.001593,172.31.36.0-255,66,102849,8,198779
50494,0.001599,172.217.194.0-255,5738,108587,8,198779
50495,0.001602,172.31.36.0-255,66,108653,8,198779
50496,0.00165,172.31.36.0-255,66,108719,8,198779
50497,0.001662,172.217.194.0-255,1484,110203,8,198779
50498,0.001672,172.217.194.0-255,5738,115941,8,198779
50499,0.001675,172.31.36.0-255,66,116007,8,198779
50500,0.001711,172.217.194.0-255,5020,121027,8,198779
50501,0.001715,172.31.36.0-255,66,121093,8,198779
50502,0.001815,172.217.194.0-255,1484,122577,8,198779
50503,0.001821,172.217.194.0-255,2902,125479,8,198779
50504,0.001824,172.31.36.0-255,66,125545,8,198779
50505,0.001845,172.217.194.0-255,5738,131283,8,198779
50506,0.001849,172.31.36.0-255,66,131349,8,198779
50507,0.001855,172.217.194.0-255,5738,137087,8,198779
50508,0.001857,172.31.36.0-255,66,137153,8,198779
50509,0.001912,172.31.36.0-255,66,137219,8,198779
50510,0.001918,172.217.194.0-255,5020,142239,8,198779
50511,0.001921,172.31.36.0-255,66,142305,8,198779
50512,0.002006,172.217.194.0-255,1484,143789,8,198779
50513,0.00201,172.217.194.0-255,1484,145273,8,198779
50514,0.002014,172.31.36.0-255,66,145339,8,198779
50515,0.002039,172.217.194.0-255,1484,146823,8,198779
50516,0.002046,172.217.194.0-255,5738,152561,8,198779
50517,0.002049,172.31.36.0-255,66,152627,8,198779
50518,0.002056,172.217.194.0-255,7156,159783,8,198779
50519,0.002059,172.31.36.0-255,66,159849,8,198779
50520,0.002106,172.31.36.0-255,66,159915,8,198779
50521,0.002111,172.217.194.0-255,2184,162099,8,198779
50522,0.002113,172.31.36.0-255,66,162165,8,198779
50523,0.002116,172.217.194.0-255,1484,163649,8,198779
50524,0.002134,172.217.194.0-255,1484,165133,8,198779
50525,0.002137,172.31.36.0-255,66,165199,8,198779
50526,0.002144,172.217.194.0-255,7156,172355,8,198779
50527,0.002146,172.31.36.0-255,66,172421,8,198779
50528,0.00215,172.217.194.0-255,2902,175323,8,198779
50529,0.002152,172.31.36.0-255,66,175389,8,198779
50530,0.002187,172.217.194.0-255,7156,182545,8,198779
50531,0.002189,172.31.36.0-255,66,182611,8,198779
50532,0.002201,172.31.36.0-255,66,182677,8,198779
50533,0.00224,172.31.36.0-255,66,182743,8,198779
50534,0.002252,172.31.36.0-255,66,182809,8,198779
50535,0.002329,172.31.36.0-255,66,182875,8,198779
50536,0.002345,172.31.36.0-255,66,182941,8,198779
50537,0.002365,172.217.194.0-255,4320,187261,8,198779
50538,0.002367,172.31.36.0-255,66,187327,8,198779
50539,0.004609,172.217.194.0-255,5738,193065,8,198779
50540,0.004615,172.31.36.0-255,66,193131,8,198779
50541,0.006856,172.217.194.0-255,899,194030,8,198779
50542,0.0092,172.31.36.0-255,66,194096,8,198779
50543,0.009227,172.31.36.0-255,105,194201,8,198779
50544,0.011436,172.217.194.0-255,66,194267,8,198779
50545,0.046845,172.31.36.0-255,188,194455,8,198779
50546,0.046875,172.31.36.0-255,955,195410,8,198779
50547,0.046943,172.31.36.0-255,1514,196924,8,198779
50548,0.046945,172.31.36.0-255,1514,198438,8,198779
50549,0.046969,172.31.36.0-255,77,198515,8,198779
50550,0.048382,104.244.42.0-255,66,198581,8,198779
50551,0.048438,104.244.42.0-255,66,198647,8,198779
50552,0.048485,104.244.42.0-255,66,198713,8,198779
50553,0.04849,104.244.42.0-255,66,198779,8,198779
50554,0.0,74.125.24.0-255,146,146,8,284406
50555,3.2e-05,172.31.36.0-255,66,212,8,284406
50556,3.9e-05,74.125.24.0-255,1484,1696,8,284406
50557,4.3e-05,172.31.36.0-255,66,1762,8,284406
50558,4.9e-05,74.125.24.0-255,2902,4664,8,284406
50559,6e-05,172.31.36.0-255,66,4730,8,284406
50560,6.6e-05,74.125.24.0-255,7156,11886,8,284406
50561,7e-05,172.31.36.0-255,66,11952,8,284406
50562,7.3e-05,74.125.24.0-255,2087,14039,8,284406
50563,7.5e-05,172.31.36.0-255,66,14105,8,284406
50564,8.7e-05,172.31.36.0-255,66,14171,8,284406
50565,0.000117,74.125.24.0-255,1484,15655,8,284406
50566,0.00012,172.31.36.0-255,66,15721,8,284406
50567,0.000138,74.125.24.0-255,3961,19682,8,284406
50568,0.000146,172.31.36.0-255,66,19748,8,284406
50569,0.00018,74.125.24.0-255,1484,21232,8,284406
50570,0.000183,172.31.36.0-255,66,21298,8,284406
50571,0.000211,74.125.24.0-255,2902,24200,8,284406
50572,0.000214,172.31.36.0-255,66,24266,8,284406
50573,0.00022,74.125.24.0-255,5738,30004,8,284406
50574,0.000222,172.31.36.0-255,66,30070,8,284406
50575,0.000253,172.31.36.0-255,66,30136,8,284406
50576,0.000276,74.125.24.0-255,3961,34097,8,284406
50577,0.00028,172.31.36.0-255,66,34163,8,284406
50578,0.000297,74.125.24.0-255,4320,38483,8,284406
50579,0.000306,172.31.36.0-255,66,38549,8,284406
50580,0.000324,74.125.24.0-255,5652,44201,8,284406
50581,0.000327,172.31.36.0-255,66,44267,8,284406
50582,0.000364,74.125.24.0-255,131,44398,8,284406
50583,0.000367,172.31.36.0-255,66,44464,8,284406
50584,0.000533,74.125.24.0-255,1484,45948,8,284406
50585,0.000553,74.125.24.0-255,2902,48850,8,284406
50586,0.000557,172.31.36.0-255,66,48916,8,284406
50587,0.000562,74.125.24.0-255,2902,51818,8,284406
50588,0.000564,172.31.36.0-255,66,51884,8,284406
50589,0.000587,74.125.24.0-255,2902,54786,8,284406
50590,0.000595,172.31.36.0-255,66,54852,8,284406
50591,0.000631,172.31.36.0-255,66,54918,8,284406
50592,0.000642,172.31.36.0-255,66,54984,8,284406
50593,0.000663,74.125.24.0-255,2902,57886,8,284406
50594,0.000667,172.31.36.0-255,66,57952,8,284406
50595,0.00067,74.125.24.0-255,1125,59077,8,284406
50596,0.000889,74.125.24.0-255,349,59426,8,284406
50597,0.001038,172.31.36.0-255,66,59492,8,284406
50598,0.001321,74.125.24.0-255,1484,60976,8,284406
50599,0.00133,74.125.24.0-255,2902,63878,8,284406
50600,0.001334,172.31.36.0-255,66,63944,8,284406
50601,0.001368,74.125.24.0-255,5738,69682,8,284406
50602,0.001371,172.31.36.0-255,66,69748,8,284406
50603,0.001376,74.125.24.0-255,4320,74068,8,284406
50604,0.001378,172.31.36.0-255,66,74134,8,284406
50605,0.001395,172.31.36.0-255,66,74200,8,284406
50606,0.001422,74.125.24.0-255,2902,77102,8,284406
50607,0.001424,172.31.36.0-255,66,77168,8,284406
50608,0.001434,172.31.36.0-255,66,77234,8,284406
50609,0.002036,74.125.24.0-255,1484,78718,8,284406
50610,0.002053,74.125.24.0-255,2902,81620,8,284406
50611,0.002056,172.31.36.0-255,66,81686,8,284406
50612,0.002087,74.125.24.0-255,5738,87424,8,284406
50613,0.002089,172.31.36.0-255,66,87490,8,284406
50614,0.002094,74.125.24.0-255,2902,90392,8,284406
50615,0.002096,172.31.36.0-255,66,90458,8,284406
50616,0.002125,74.125.24.0-255,7156,97614,8,284406
50617,0.002127,172.31.36.0-255,66,97680,8,284406
50618,0.002137,172.31.36.0-255,66,97746,8,284406
50619,0.002181,74.125.24.0-255,3602,101348,8,284406
50620,0.002183,172.31.36.0-255,66,101414,8,284406
50621,0.004362,74.125.24.0-255,1484,102898,8,284406
50622,0.004403,74.125.24.0-255,2902,105800,8,284406
50623,0.004407,172.31.36.0-255,66,105866,8,284406
50624,0.004432,74.125.24.0-255,1484,107350,8,284406
50625,0.006644,74.125.24.0-255,4320,111670,8,284406
50626,0.006652,172.31.36.0-255,66,111736,8,284406
50627,0.008886,74.125.24.0-255,5738,117474,8,284406
50628,0.008894,172.31.36.0-255,66,117540,8,284406
50629,0.011108,74.125.24.0-255,5738,123278,8,284406
50630,0.011116,172.31.36.0-255,66,123344,8,284406
50631,0.013335,74.125.24.0-255,5738,129082,8,284406
50632,0.013342,172.31.36.0-255,66,129148,8,284406
50633,0.015632,74.125.24.0-255,5738,134886,8,284406
50634,0.015642,172.31.36.0-255,66,134952,8,284406
50635,0.017889,74.125.24.0-255,5738,140690,8,284406
50636,0.017895,172.31.36.0-255,66,140756,8,284406
50637,0.020176,74.125.24.0-255,5738,146494,8,284406
50638,0.020186,172.31.36.0-255,66,146560,8,284406
50639,0.022443,74.125.24.0-255,5738,152298,8,284406
50640,0.022453,172.31.36.0-255,66,152364,8,284406
50641,0.02467,74.125.24.0-255,5738,158102,8,284406
50642,0.024677,172.31.36.0-255,66,158168,8,284406
50643,0.026917,74.125.24.0-255,5738,163906,8,284406
50644,0.026925,172.31.36.0-255,66,163972,8,284406
50645,0.029181,74.125.24.0-255,5738,169710,8,284406
50646,0.029189,172.31.36.0-255,66,169776,8,284406
50647,0.031429,74.125.24.0-255,5738,175514,8,284406
50648,0.031436,172.31.36.0-255,66,175580,8,284406
50649,0.03348,172.31.36.0-255,164,175744,8,284406
50650,0.033524,172.31.36.0-255,1118,176862,8,284406
50651,0.033599,172.31.36.0-255,1514,178376,8,284406
50652,0.033601,172.31.36.0-255,1514,179890,8,284406
50653,0.033606,172.31.36.0-255,1514,181404,8,284406
50654,0.033607,172.31.36.0-255,1514,182918,8,284406
50655,0.03363,172.31.36.0-255,1514,184432,8,284406
50656,0.03364,172.31.36.0-255,868,185300,8,284406
50657,0.033675,74.125.24.0-255,5738,191038,8,284406
50658,0.03368,172.31.36.0-255,66,191104,8,284406
50659,0.035057,104.244.42.0-255,66,191170,8,284406
50660,0.035091,104.244.42.0-255,66,191236,8,284406
50661,0.035197,104.244.42.0-255,66,191302,8,284406
50662,0.035203,104.244.42.0-255,66,191368,8,284406
50663,0.035916,74.125.24.0-255,5738,197106,8,284406
50664,0.035924,172.31.36.0-255,66,197172,8,284406
50665,0.038161,74.125.24.0-255,5738,202910,8,284406
50666,0.038169,172.31.36.0-255,66,202976,8,284406
50667,0.040408,74.125.24.0-255,5738,208714,8,284406
50668,0.040415,172.31.36.0-255,66,208780,8,284406
50669,0.042554,172.31.36.0-255,108,208888,8,284406
50670,0.04265,74.125.24.0-255,5738,214626,8,284406
50671,0.042658,172.31.36.0-255,66,214692,8,284406
50672,0.044086,104.244.42.0-255,66,214758,8,284406
50673,0.044881,74.125.24.0-255,5738,220496,8,284406
50674,0.044889,172.31.36.0-255,66,220562,8,284406
50675,0.047132,74.125.24.0-255,5738,226300,8,284406
50676,0.04714,172.31.36.0-255,66,226366,8,284406
50677,0.049413,74.125.24.0-255,5738,232104,8,284406
50678,0.049421,172.31.36.0-255,66,232170,8,284406
50679,0.051645,74.125.24.0-255,5738,237908,8,284406
50680,0.051653,172.31.36.0-255,66,237974,8,284406
50681,0.053875,74.125.24.0-255,5738,243712,8,284406
50682,0.053882,172.31.36.0-255,66,243778,8,284406
50683,0.056087,74.125.24.0-255,5738,249516,8,284406
50684,0.056091,172.31.36.0-255,66,249582,8,284406
50685,0.058325,74.125.24.0-255,5738,255320,8,284406
50686,0.05833,172.31.36.0-255,66,255386,8,284406
50687,0.06058,74.125.24.0-255,5738,261124,8,284406
50688,0.060586,172.31.36.0-255,66,261190,8,284406
50689,0.062825,74.125.24.0-255,5738,266928,8,284406
50690,0.062832,172.31.36.0-255,66,266994,8,284406
50691,0.065055,74.125.24.0-255,5738,272732,8,284406
50692,0.065062,172.31.36.0-255,66,272798,8,284406
50693,0.067292,74.125.24.0-255,5738,278536,8,284406
50694,0.067298,172.31.36.0-255,66,278602,8,284406
50695,0.069535,74.125.24.0-255,5738,284340,8,284406
50696,0.069542,172.31.36.0-255,66,284406,8,284406
50697,0.0,172.217.160.0-255,153,153,8,294158
50698,2.6e-05,172.31.36.0-255,66,219,8,294158
50699,3.3e-05,172.217.160.0-255,1484,1703,8,294158
50700,3.7e-05,172.31.36.0-255,66,1769,8,294158
50701,4.2e-05,172.217.160.0-255,2902,4671,8,294158
50702,5.2e-05,172.31.36.0-255,66,4737,8,294158
50703,5.7e-05,172.217.160.0-255,2902,7639,8,294158
50704,6e-05,172.31.36.0-255,66,7705,8,294158
50705,6.7e-05,172.217.160.0-255,6293,13998,8,294158
50706,6.9e-05,172.31.36.0-255,66,14064,8,294158
50707,7.5e-05,172.217.160.0-255,4320,18384,8,294158
50708,7.9e-05,172.31.36.0-255,66,18450,8,294158
50709,0.00011,172.217.160.0-255,7156,25606,8,294158
50710,0.000114,172.31.36.0-255,66,25672,8,294158
50711,0.000119,172.217.160.0-255,5379,31051,8,294158
50712,0.000122,172.31.36.0-255,66,31117,8,294158
50713,0.000172,172.217.160.0-255,1484,32601,8,294158
50714,0.000176,172.31.36.0-255,66,32667,8,294158
50715,0.000181,172.217.160.0-255,2902,35569,8,294158
50716,0.000184,172.31.36.0-255,66,35635,8,294158
50717,0.00019,172.217.160.0-255,5738,41373,8,294158
50718,0.000198,172.31.36.0-255,66,41439,8,294158
50719,0.000243,172.31.36.0-255,66,41505,8,294158
50720,0.000254,172.31.36.0-255,66,41571,8,294158
50721,0.000276,172.217.160.0-255,1408,42979,8,294158
50722,0.000279,172.31.36.0-255,66,43045,8,294158
50723,0.00096,172.217.160.0-255,104,43149,8,294158
50724,0.000966,172.31.36.0-255,66,43215,8,294158
50725,0.001008,172.217.160.0-255,1484,44699,8,294158
50726,0.001012,172.31.36.0-255,66,44765,8,294158
50727,0.001018,172.217.160.0-255,2902,47667,8,294158
50728,0.001025,172.217.160.0-255,7156,54823,8,294158
50729,0.001048,172.217.160.0-255,5379,60202,8,294158
50730,0.001069,172.217.160.0-255,5738,65940,8,294158
50731,0.001107,172.217.160.0-255,4320,70260,8,294158
50732,0.00113,172.217.160.0-255,6797,77057,8,294158
50733,0.001786,172.217.160.0-255,1484,78541,8,294158
50734,0.001794,172.217.160.0-255,2902,81443,8,294158
50735,0.001826,172.217.160.0-255,2902,84345,8,294158
50736,0.00184,172.217.160.0-255,2902,87247,8,294158
50737,0.001853,172.217.160.0-255,2902,90149,8,294158
50738,0.001903,172.217.160.0-255,2184,92333,8,294158
50739,0.00193,172.217.160.0-255,5738,98071,8,294158
50740,0.001951,172.217.160.0-255,6438,104509,8,294158
50741,0.002207,172.31.36.0-255,66,104575,8,294158
50742,0.004153,172.217.160.0-255,5738,110313,8,294158
50743,0.004159,172.31.36.0-255,66,110379,8,294158
50744,0.006106,172.217.160.0-255,4320,114699,8,294158
50745,0.006111,172.31.36.0-255,66,114765,8,294158
50746,0.006145,172.217.160.0-255,1484,116249,8,294158
50747,0.008044,172.217.160.0-255,4320,120569,8,294158
50748,0.00805,172.31.36.0-255,66,120635,8,294158
50749,0.009993,172.217.160.0-255,5738,126373,8,294158
50750,0.013943,172.31.36.0-255,66,126439,8,294158
50751,0.015891,172.217.160.0-255,5738,132177,8,294158
50752,0.015901,172.31.36.0-255,66,132243,8,294158
50753,0.017842,172.217.160.0-255,5738,137981,8,294158
50754,0.017851,172.31.36.0-255,66,138047,8,294158
50755,0.019791,172.217.160.0-255,5738,143785,8,294158
50756,0.019798,172.31.36.0-255,66,143851,8,294158
50757,0.021763,172.217.160.0-255,5738,149589,8,294158
50758,0.02177,172.31.36.0-255,66,149655,8,294158
50759,0.023705,172.217.160.0-255,5738,155393,8,294158
50760,0.023713,172.31.36.0-255,66,155459,8,294158
50761,0.025647,172.217.160.0-255,5738,161197,8,294158
50762,0.025654,172.31.36.0-255,66,161263,8,294158
50763,0.026154,172.31.36.0-255,167,161430,8,294158
50764,0.026187,172.31.36.0-255,1112,162542,8,294158
50765,0.026223,172.31.36.0-255,1514,164056,8,294158
50766,0.026225,172.31.36.0-255,1292,165348,8,294158
50767,0.027619,172.217.160.0-255,5738,171086,8,294158
50768,0.027624,172.31.36.0-255,66,171152,8,294158
50769,0.027693,104.244.42.0-255,66,171218,8,294158
50770,0.027735,104.244.42.0-255,66,171284,8,294158
50771,0.027788,104.244.42.0-255,66,171350,8,294158
50772,0.029557,172.217.160.0-255,5738,177088,8,294158
50773,0.029562,172.31.36.0-255,66,177154,8,294158
50774,0.031504,172.217.160.0-255,5738,182892,8,294158
50775,0.03151,172.31.36.0-255,66,182958,8,294158
50776,0.03344,172.217.160.0-255,5738,188696,8,294158
50777,0.033447,172.31.36.0-255,66,188762,8,294158
50778,0.035398,172.217.160.0-255,5738,194500,8,294158
50779,0.035404,172.31.36.0-255,66,194566,8,294158
50780,0.037348,172.217.160.0-255,5738,200304,8,294158
50781,0.037354,172.31.36.0-255,66,200370,8,294158
50782,0.039291,172.217.160.0-255,5738,206108,8,294158
50783,0.039297,172.31.36.0-255,66,206174,8,294158
50784,0.04124,172.217.160.0-255,5738,211912,8,294158
50785,0.041246,172.31.36.0-255,66,211978,8,294158
50786,0.043177,172.217.160.0-255,5738,217716,8,294158
50787,0.043183,172.31.36.0-255,66,217782,8,294158
50788,0.045117,172.217.160.0-255,5738,223520,8,294158
50789,0.045122,172.31.36.0-255,66,223586,8,294158
50790,0.047055,172.217.160.0-255,5738,229324,8,294158
50791,0.04706,172.31.36.0-255,66,229390,8,294158
50792,0.049038,172.217.160.0-255,5738,235128,8,294158
50793,0.049044,172.31.36.0-255,66,235194,8,294158
50794,0.050981,172.217.160.0-255,5738,240932,8,294158
50795,0.051001,172.31.36.0-255,66,240998,8,294158
50796,0.052935,172.217.160.0-255,5738,246736,8,294158
50797,0.052941,172.31.36.0-255,66,246802,8,294158
50798,0.054874,172.217.160.0-255,5738,252540,8,294158
50799,0.054881,172.31.36.0-255,66,252606,8,294158
50800,0.056824,172.217.160.0-255,2902,255508,8,294158
50801,0.05683,172.31.36.0-255,66,255574,8,294158
50802,0.056864,172.217.160.0-255,2902,258476,8,294158
50803,0.056887,172.31.36.0-255,66,258542,8,294158
50804,0.058758,172.217.160.0-255,2902,261444,8,294158
50805,0.058763,172.31.36.0-255,66,261510,8,294158
50806,0.05881,172.217.160.0-255,2902,264412,8,294158
50807,0.05882,172.31.36.0-255,66,264478,8,294158
50808,0.060697,172.217.160.0-255,2902,267380,8,294158
50809,0.060701,172.31.36.0-255,66,267446,8,294158
50810,0.060758,172.217.160.0-255,2902,270348,8,294158
50811,0.060788,172.31.36.0-255,66,270414,8,294158
50812,0.062635,172.217.160.0-255,2902,273316,8,294158
50813,0.062641,172.31.36.0-255,66,273382,8,294158
50814,0.062706,172.217.160.0-255,2902,276284,8,294158
50815,0.062718,172.31.36.0-255,66,276350,8,294158
50816,0.064565,172.217.160.0-255,2902,279252,8,294158
50817,0.06457,172.31.36.0-255,66,279318,8,294158
50818,0.064647,172.217.160.0-255,2902,282220,8,294158
50819,0.064655,172.31.36.0-255,66,282286,8,294158
50820,0.066497,172.217.160.0-255,2902,285188,8,294158
50821,0.066502,172.31.36.0-255,66,285254,8,294158
50822,0.066583,172.217.160.0-255,2902,288156,8,294158
50823,0.066593,172.31.36.0-255,66,288222,8,294158
50824,0.068442,172.217.160.0-255,2902,291124,8,294158
50825,0.06845,172.31.36.0-255,66,291190,8,294158
50826,0.068514,172.217.160.0-255,2902,294092,8,294158
50827,0.068644,172.31.36.0-255,66,294158,8,294158
50828,0.0,172.217.194.0-255,149,149,8,317890
50829,3.6e-05,172.31.36.0-255,66,215,8,317890
50830,4.2e-05,172.217.194.0-255,1484,1699,8,317890
50831,4.7e-05,172.31.36.0-255,66,1765,8,317890
50832,6e-05,172.217.194.0-255,2902,4667,8,317890
50833,6.2e-05,172.31.36.0-255,66,4733,8,317890
50834,7e-05,172.217.194.0-255,7156,11889,8,317890
50835,7.3e-05,172.31.36.0-255,66,11955,8,317890
50836,7.7e-05,172.217.194.0-255,1994,13949,8,317890
50837,7.9e-05,172.31.36.0-255,66,14015,8,317890
50838,0.000135,172.217.194.0-255,1484,15499,8,317890
50839,0.000138,172.31.36.0-255,66,15565,8,317890
50840,0.000142,172.217.194.0-255,1484,17049,8,317890
50841,0.000144,172.31.36.0-255,66,17115,8,317890
50842,0.000164,172.217.194.0-255,1484,18599,8,317890
50843,0.000166,172.31.36.0-255,66,18665,8,317890
50844,0.00018,172.217.194.0-255,5738,24403,8,317890
50845,0.000183,172.31.36.0-255,66,24469,8,317890
50846,0.00019,172.217.194.0-255,6797,31266,8,317890
50847,0.000192,172.31.36.0-255,66,31332,8,317890
50848,0.000196,172.217.194.0-255,2902,34234,8,317890
50849,0.000198,172.31.36.0-255,66,34300,8,317890
50850,0.000231,172.217.194.0-255,4320,38620,8,317890
50851,0.000235,172.31.36.0-255,66,38686,8,317890
50852,0.000259,172.217.194.0-255,4320,43006,8,317890
50853,0.000262,172.31.36.0-255,66,43072,8,317890
50854,0.000284,172.217.194.0-255,5379,48451,8,317890
50855,0.000287,172.217.194.0-255,1484,49935,8,317890
50856,0.00029,172.31.36.0-255,66,50001,8,317890
50857,0.000295,172.31.36.0-255,66,50067,8,317890
50858,0.000312,172.217.194.0-255,2902,52969,8,317890
50859,0.000315,172.31.36.0-255,66,53035,8,317890
50860,0.00032,172.217.194.0-255,2902,55937,8,317890
50861,0.000327,172.31.36.0-255,66,56003,8,317890
50862,0.000347,172.217.194.0-255,2902,58905,8,317890
50863,0.000352,172.217.194.0-255,2902,61807,8,317890
50864,0.000353,172.31.36.0-255,66,61873,8,317890
50865,0.000358,172.31.36.0-255,66,61939,8,317890
50866,0.00039,172.217.194.0-255,4271,66210,8,317890
50867,0.000394,172.217.194.0-255,367,66577,8,317890
50868,0.000396,172.217.194.0-255,1484,68061,8,317890
50869,0.000397,172.31.36.0-255,66,68127,8,317890
50870,0.000421,172.217.194.0-255,4320,72447,8,317890
50871,0.000429,172.31.36.0-255,66,72513,8,317890
50872,0.000436,172.217.194.0-255,4320,76833,8,317890
50873,0.000445,172.31.36.0-255,66,76899,8,317890
50874,0.000463,172.217.194.0-255,5738,82637,8,317890
50875,0.000474,172.31.36.0-255,66,82703,8,317890
50876,0.000482,172.217.194.0-255,2902,85605,8,317890
50877,0.000487,172.31.36.0-255,66,85671,8,317890
50878,0.000518,172.217.194.0-255,1125,86796,8,317890
50879,0.000531,172.31.36.0-255,66,86862,8,317890
50880,0.001008,172.217.194.0-255,1484,88346,8,317890
50881,0.001059,172.217.194.0-255,2902,91248,8,317890
50882,0.001063,172.31.36.0-255,66,91314,8,317890
50883,0.00107,172.217.194.0-255,5738,97052,8,317890
50884,0.001075,172.217.194.0-255,2902,99954,8,317890
50885,0.001079,172.31.36.0-255,66,100020,8,317890
50886,0.001097,172.31.36.0-255,66,100086,8,317890
50887,0.0011,172.217.194.0-255,6438,106524,8,317890
50888,0.001111,172.31.36.0-255,66,106590,8,317890
50889,0.00114,172.217.194.0-255,1484,108074,8,317890
50890,0.001146,172.217.194.0-255,2902,110976,8,317890
50891,0.001148,172.31.36.0-255,66,111042,8,317890
50892,0.001173,172.217.194.0-255,2902,113944,8,317890
50893,0.001183,172.31.36.0-255,66,114010,8,317890
50894,0.001193,172.217.194.0-255,2902,116912,8,317890
50895,0.001197,172.31.36.0-255,66,116978,8,317890
50896,0.001215,172.217.194.0-255,2902,119880,8,317890
50897,0.001221,172.31.36.0-255,66,119946,8,317890
50898,0.001258,172.31.36.0-255,66,120012,8,317890
50899,0.001606,172.217.194.0-255,1484,121496,8,317890
50900,0.001623,172.217.194.0-255,1484,122980,8,317890
50901,0.001626,172.31.36.0-255,66,123046,8,317890
50902,0.001652,172.217.194.0-255,1484,124530,8,317890
50903,0.001659,172.217.194.0-255,5738,130268,8,317890
50904,0.001661,172.31.36.0-255,66,130334,8,317890
50905,0.001667,172.217.194.0-255,4320,134654,8,317890
50906,0.00169,172.31.36.0-255,66,134720,8,317890
50907,0.001705,172.31.36.0-255,66,134786,8,317890
50908,0.001753,172.31.36.0-255,66,134852,8,317890
50909,0.001965,172.217.194.0-255,1484,136336,8,317890
50910,0.001984,172.217.194.0-255,2902,139238,8,317890
50911,0.001989,172.31.36.0-255,66,139304,8,317890
50912,0.001995,172.217.194.0-255,4320,143624,8,317890
50913,0.002004,172.31.36.0-255,66,143690,8,317890
50914,0.002022,172.217.194.0-255,1484,145174,8,317890
50915,0.002051,172.217.194.0-255,7156,152330,8,317890
50916,0.002057,172.217.194.0-255,4320,156650,8,317890
50917,0.002057,172.31.36.0-255,66,156716,8,317890
50918,0.002062,172.31.36.0-255,66,156782,8,317890
50919,0.002069,172.217.194.0-255,4320,161102,8,317890
50920,0.002087,172.31.36.0-255,66,161168,8,317890
50921,0.002116,172.31.36.0-255,66,161234,8,317890
50922,0.002127,172.217.194.0-255,1484,162718,8,317890
50923,0.002136,172.217.194.0-255,2902,165620,8,317890
50924,0.002138,172.31.36.0-255,66,165686,8,317890
50925,0.002165,172.217.194.0-255,5738,171424,8,317890
50926,0.002173,172.31.36.0-255,66,171490,8,317890
50927,0.002179,172.217.194.0-255,1484,172974,8,317890
50928,0.002238,172.217.194.0-255,7156,180130,8,317890
50929,0.002252,172.217.194.0-255,1484,181614,8,317890
50930,0.002291,172.217.194.0-255,2184,183798,8,317890
50931,0.002347,172.217.194.0-255,1484,185282,8,317890
50932,0.002368,172.217.194.0-255,2902,188184,8,317890
50933,0.002374,172.217.194.0-255,5738,193922,8,317890
50934,0.002396,172.217.194.0-255,1484,195406,8,317890
50935,0.002474,172.217.194.0-255,2902,198308,8,317890
50936,0.00261,172.31.36.0-255,66,198374,8,317890
50937,0.004979,172.217.194.0-255,5738,204112,8,317890
50938,0.004986,172.31.36.0-255,66,204178,8,317890
50939,0.00743,172.217.194.0-255,4320,208498,8,317890
50940,0.007435,172.31.36.0-255,66,208564,8,317890
50941,0.007472,172.217.194.0-255,1484,210048,8,317890
50942,0.009842,172.217.194.0-255,4320,214368,8,317890
50943,0.009849,172.31.36.0-255,66,214434,8,317890
50944,0.012302,172.217.194.0-255,5738,220172,8,317890
50945,0.012384,172.31.36.0-255,66,220238,8,317890
50946,0.014808,172.217.194.0-255,5738,225976,8,317890
50947,0.01482,172.31.36.0-255,66,226042,8,317890
50948,0.01726,172.217.194.0-255,5738,231780,8,317890
50949,0.017268,172.31.36.0-255,66,231846,8,317890
50950,0.019687,172.217.194.0-255,5738,237584,8,317890
50951,0.019701,172.31.36.0-255,66,237650,8,317890
50952,0.022097,172.217.194.0-255,4320,241970,8,317890
50953,0.022106,172.31.36.0-255,66,242036,8,317890
50954,0.022145,172.217.194.0-255,1484,243520,8,317890
50955,0.024492,172.217.194.0-255,4320,247840,8,317890
50956,0.024499,172.31.36.0-255,66,247906,8,317890
50957,0.026911,172.217.194.0-255,5738,253644,8,317890
50958,0.026968,172.31.36.0-255,66,253710,8,317890
50959,0.02939,172.217.194.0-255,5738,259448,8,317890
50960,0.029398,172.31.36.0-255,66,259514,8,317890
50961,0.031785,172.217.194.0-255,5738,265252,8,317890
50962,0.031793,172.31.36.0-255,66,265318,8,317890
50963,0.034213,172.217.194.0-255,4320,269638,8,317890
50964,0.03422,172.31.36.0-255,66,269704,8,317890
50965,0.034268,172.217.194.0-255,1484,271188,8,317890
50966,0.034389,172.31.36.0-255,172,271360,8,317890
50967,0.034416,172.31.36.0-255,1110,272470,8,317890
50968,0.034468,172.31.36.0-255,1514,273984,8,317890
50969,0.03447,172.31.36.0-255,1514,275498,8,317890
50970,0.034471,172.31.36.0-255,1514,277012,8,317890
50971,0.034473,172.31.36.0-255,1514,278526,8,317890
50972,0.034499,172.31.36.0-255,1230,279756,8,317890
50973,0.035957,104.244.42.0-255,66,279822,8,317890
50974,0.035984,104.244.42.0-255,66,279888,8,317890
50975,0.036041,104.244.42.0-255,66,279954,8,317890
50976,0.036047,104.244.42.0-255,66,280020,8,317890
50977,0.036657,172.217.194.0-255,4320,284340,8,317890
50978,0.036663,172.31.36.0-255,66,284406,8,317890
50979,0.039027,172.217.194.0-255,5738,290144,8,317890
50980,0.039079,172.31.36.0-255,66,290210,8,317890
50981,0.041493,172.217.194.0-255,5738,295948,8,317890
50982,0.041498,172.31.36.0-255,66,296014,8,317890
50983,0.04393,172.217.194.0-255,5738,301752,8,317890
50984,0.043936,172.31.36.0-255,66,301818,8,317890
50985,0.046327,172.217.194.0-255,2902,304720,8,317890
50986,0.046332,172.31.36.0-255,66,304786,8,317890
50987,0.046365,172.217.194.0-255,2902,307688,8,317890
50988,0.046385,172.31.36.0-255,66,307754,8,317890
50989,0.048742,172.217.194.0-255,5738,313492,8,317890
50990,0.048802,172.31.36.0-255,66,313558,8,317890
50991,0.051151,172.217.194.0-255,4095,317653,8,317890
50992,0.051156,172.31.36.0-255,66,317719,8,317890
50993,0.051355,172.31.36.0-255,105,317824,8,317890
50994,0.053671,172.217.194.0-255,66,317890,8,317890
50995,0.0,74.125.24.0-255,153,153,8,243613
50996,1.3e-05,172.31.36.0-255,66,219,8,243613
50997,1.9e-05,74.125.24.0-255,1484,1703,8,243613
50998,2.3e-05,172.31.36.0-255,66,1769,8,243613
50999,4.5e-05,74.125.24.0-255,2902,4671,8,243613
51000,4.8e-05,172.31.36.0-255,66,4737,8,243613
51001,5.4e-05,74.125.24.0-255,2902,7639,8,243613
51002,7e-05,172.31.36.0-255,66,7705,8,243613
51003,9.9e-05,74.125.24.0-255,4320,12025,8,243613
51004,0.000103,172.31.36.0-255,66,12091,8,243613
51005,0.000107,74.125.24.0-255,2103,14194,8,243613
51006,0.000109,172.31.36.0-255,66,14260,8,243613
51007,0.000446,74.125.24.0-255,1484,15744,8,243613
51008,0.000452,172.31.36.0-255,66,15810,8,243613
51009,0.000459,74.125.24.0-255,2902,18712,8,243613
51010,0.000462,172.31.36.0-255,66,18778,8,243613
51011,0.000467,74.125.24.0-255,2902,21680,8,243613
51012,0.00047,172.31.36.0-255,66,21746,8,243613
51013,0.000492,74.125.24.0-255,1484,23230,8,243613
51014,0.000495,172.31.36.0-255,66,23296,8,243613
51015,0.000498,74.125.24.0-255,1484,24780,8,243613
51016,0.0005,172.31.36.0-255,66,24846,8,243613
51017,0.000527,172.31.36.0-255,66,24912,8,243613
51018,0.000538,172.31.36.0-255,66,24978,8,243613
51019,0.000574,74.125.24.0-255,5738,30716,8,243613
51020,0.000578,172.31.36.0-255,66,30782,8,243613
51021,0.000595,74.125.24.0-255,1125,31907,8,243613
51022,0.000597,172.31.36.0-255,66,31973,8,243613
51023,0.000605,74.125.24.0-255,7156,39129,8,243613
51024,0.000607,172.31.36.0-255,66,39195,8,243613
51025,0.000645,172.31.36.0-255,66,39261,8,243613
51026,0.000663,74.125.24.0-255,358,39619,8,243613
51027,0.000997,172.31.36.0-255,66,39685,8,243613
51028,0.001384,74.125.24.0-255,131,39816,8,243613
51029,0.001417,74.125.24.0-255,1484,41300,8,243613
51030,0.001422,172.31.36.0-255,66,41366,8,243613
51031,0.001429,74.125.24.0-255,2902,44268,8,243613
51032,0.001431,172.31.36.0-255,66,44334,8,243613
51033,0.001435,74.125.24.0-255,1484,45818,8,243613
51034,0.001462,74.125.24.0-255,5738,51556,8,243613
51035,0.001464,172.31.36.0-255,66,51622,8,243613
51036,0.001484,74.125.24.0-255,2902,54524,8,243613
51037,0.001486,172.31.36.0-255,66,54590,8,243613
51038,0.001512,74.125.24.0-255,5379,59969,8,243613
51039,0.001515,172.31.36.0-255,66,60035,8,243613
51040,0.001522,74.125.24.0-255,5738,65773,8,243613
51041,0.001524,172.31.36.0-255,66,65839,8,243613
51042,0.001557,74.125.24.0-255,5738,71577,8,243613
51043,0.00156,172.31.36.0-255,66,71643,8,243613
51044,0.001575,74.125.24.0-255,2543,74186,8,243613
51045,0.001578,172.31.36.0-255,66,74252,8,243613
51046,0.003869,74.125.24.0-255,4320,78572,8,243613
51047,0.003875,172.31.36.0-255,66,78638,8,243613
51048,0.003887,74.125.24.0-255,1484,80122,8,243613
51049,0.006204,74.125.24.0-255,4320,84442,8,243613
51050,0.006212,172.31.36.0-255,66,84508,8,243613
51051,0.008518,74.125.24.0-255,5738,90246,8,243613
51052,0.008525,172.31.36.0-255,66,90312,8,243613
51053,0.010818,74.125.24.0-255,5738,96050,8,243613
51054,0.010828,172.31.36.0-255,66,96116,8,243613
51055,0.013162,74.125.24.0-255,5738,101854,8,243613
51056,0.013172,172.31.36.0-255,66,101920,8,243613
51057,0.015477,74.125.24.0-255,5738,107658,8,243613
51058,0.015487,172.31.36.0-255,66,107724,8,243613
51059,0.017796,74.125.24.0-255,5738,113462,8,243613
51060,0.017802,172.31.36.0-255,66,113528,8,243613
51061,0.02015,74.125.24.0-255,5738,119266,8,243613
51062,0.020158,172.31.36.0-255,66,119332,8,243613
51063,0.022447,74.125.24.0-255,5738,125070,8,243613
51064,0.022455,172.31.36.0-255,66,125136,8,243613
51065,0.024764,74.125.24.0-255,5738,130874,8,243613
51066,0.024773,172.31.36.0-255,66,130940,8,243613
51067,0.027121,74.125.24.0-255,5738,136678,8,243613
51068,0.027127,172.31.36.0-255,66,136744,8,243613
51069,0.027778,172.31.36.0-255,172,136916,8,243613
51070,0.027811,172.31.36.0-255,1111,138027,8,243613
51071,0.027868,172.31.36.0-255,1514,139541,8,243613
51072,0.02787,172.31.36.0-255,754,140295,8,243613
51073,0.029381,104.244.42.0-255,66,140361,8,243613
51074,0.029389,104.244.42.0-255,66,140427,8,243613
51075,0.029439,74.125.24.0-255,4320,144747,8,243613
51076,0.029445,172.31.36.0-255,66,144813,8,243613
51077,0.029464,104.244.42.0-255,66,144879,8,243613
51078,0.029468,74.125.24.0-255,1484,146363,8,243613
51079,0.031763,74.125.24.0-255,4320,150683,8,243613
51080,0.03177,172.31.36.0-255,66,150749,8,243613
51081,0.034064,74.125.24.0-255,5738,156487,8,243613
51082,0.034071,172.31.36.0-255,66,156553,8,243613
51083,0.036403,74.125.24.0-255,5738,162291,8,243613
51084,0.036413,172.31.36.0-255,66,162357,8,243613
51085,0.038733,74.125.24.0-255,5738,168095,8,243613
51086,0.03874,172.31.36.0-255,66,168161,8,243613
51087,0.041041,74.125.24.0-255,5738,173899,8,243613
51088,0.041048,172.31.36.0-255,66,173965,8,243613
51089,0.043386,74.125.24.0-255,5738,179703,8,243613
51090,0.043392,172.31.36.0-255,66,179769,8,243613
51091,0.045709,74.125.24.0-255,5738,185507,8,243613
51092,0.045715,172.31.36.0-255,66,185573,8,243613
51093,0.048063,74.125.24.0-255,5738,191311,8,243613
51094,0.048071,172.31.36.0-255,66,191377,8,243613
51095,0.050401,74.125.24.0-255,5738,197115,8,243613
51096,0.050409,172.31.36.0-255,66,197181,8,243613
51097,0.052709,74.125.24.0-255,5738,202919,8,243613
51098,0.052716,172.31.36.0-255,66,202985,8,243613
51099,0.055085,74.125.24.0-255,5738,208723,8,243613
51100,0.055097,172.31.36.0-255,66,208789,8,243613
51101,0.057392,74.125.24.0-255,5738,214527,8,243613
51102,0.057401,172.31.36.0-255,66,214593,8,243613
51103,0.059697,74.125.24.0-255,5738,220331,8,243613
51104,0.059706,172.31.36.0-255,66,220397,8,243613
51105,0.061999,74.125.24.0-255,5738,226135,8,243613
51106,0.062006,172.31.36.0-255,66,226201,8,243613
51107,0.064301,74.125.24.0-255,5738,231939,8,243613
51108,0.064309,172.31.36.0-255,66,232005,8,243613
51109,0.066648,74.125.24.0-255,5738,237743,8,243613
51110,0.066655,172.31.36.0-255,66,237809,8,243613
51111,0.068959,74.125.24.0-255,5738,243547,8,243613
51112,0.068969,172.31.36.0-255,66,243613,8,243613
51113,0.0,172.217.194.0-255,297,297,8,256419
51114,3.2e-05,172.31.36.0-255,66,363,8,256419
51115,4.1e-05,172.217.194.0-255,1484,1847,8,256419
51116,4.5e-05,172.31.36.0-255,66,1913,8,256419
51117,5.1e-05,172.217.194.0-255,4320,6233,8,256419
51118,5.4e-05,172.31.36.0-255,66,6299,8,256419
51119,5.9e-05,172.217.194.0-255,2902,9201,8,256419
51120,6.2e-05,172.31.36.0-255,66,9267,8,256419
51121,9.5e-05,172.31.36.0-255,66,9333,8,256419
51122,0.000102,172.217.194.0-255,4320,13653,8,256419
51123,0.000104,172.31.36.0-255,66,13719,8,256419
51124,0.000134,172.217.194.0-255,1484,15203,8,256419
51125,0.000137,172.31.36.0-255,66,15269,8,256419
51126,0.000162,172.217.194.0-255,6797,22066,8,256419
51127,0.000165,172.31.36.0-255,66,22132,8,256419
51128,0.000197,172.217.194.0-255,5738,27870,8,256419
51129,0.0002,172.31.36.0-255,66,27936,8,256419
51130,0.000216,172.217.194.0-255,7156,35092,8,256419
51131,0.000219,172.31.36.0-255,66,35158,8,256419
51132,0.000236,172.217.194.0-255,2902,38060,8,256419
51133,0.000239,172.31.36.0-255,66,38126,8,256419
51134,0.000263,172.31.36.0-255,66,38192,8,256419
51135,0.000293,172.217.194.0-255,1484,39676,8,256419
51136,0.000296,172.31.36.0-255,66,39742,8,256419
51137,0.000318,172.217.194.0-255,6783,46525,8,256419
51138,0.000321,172.31.36.0-255,66,46591,8,256419
51139,0.000391,172.217.194.0-255,1484,48075,8,256419
51140,0.000394,172.31.36.0-255,66,48141,8,256419
51141,0.000399,172.217.194.0-255,2902,51043,8,256419
51142,0.000401,172.31.36.0-255,66,51109,8,256419
51143,0.000414,172.217.194.0-255,2902,54011,8,256419
51144,0.000418,172.31.36.0-255,66,54077,8,256419
51145,0.000439,172.217.194.0-255,2902,56979,8,256419
51146,0.000442,172.31.36.0-255,66,57045,8,256419
51147,0.000453,172.31.36.0-255,66,57111,8,256419
51148,0.000471,172.217.194.0-255,2902,60013,8,256419
51149,0.000475,172.31.36.0-255,66,60079,8,256419
51150,0.00048,172.217.194.0-255,5738,65817,8,256419
51151,0.000483,172.31.36.0-255,66,65883,8,256419
51152,0.000507,172.217.194.0-255,6438,72321,8,256419
51153,0.000509,172.31.36.0-255,66,72387,8,256419
51154,0.000512,172.217.194.0-255,365,72752,8,256419
51155,0.001002,172.217.194.0-255,1484,74236,8,256419
51156,0.001006,172.31.36.0-255,66,74302,8,256419
51157,0.001012,172.217.194.0-255,2902,77204,8,256419
51158,0.001014,172.31.36.0-255,66,77270,8,256419
51159,0.001031,172.217.194.0-255,5738,83008,8,256419
51160,0.001034,172.31.36.0-255,66,83074,8,256419
51161,0.001048,172.217.194.0-255,1484,84558,8,256419
51162,0.001063,172.217.194.0-255,2902,87460,8,256419
51163,0.001066,172.31.36.0-255,66,87526,8,256419
51164,0.001071,172.217.194.0-255,2902,90428,8,256419
51165,0.001072,172.31.36.0-255,66,90494,8,256419
51166,0.001086,172.217.194.0-255,2902,93396,8,256419
51167,0.001089,172.31.36.0-255,66,93462,8,256419
51168,0.001126,172.217.194.0-255,7156,100618,8,256419
51169,0.001128,172.31.36.0-255,66,100684,8,256419
51170,0.001146,172.217.194.0-255,4320,105004,8,256419
51171,0.001149,172.31.36.0-255,66,105070,8,256419
51172,0.001153,172.217.194.0-255,2184,107254,8,256419
51173,0.001155,172.31.36.0-255,66,107320,8,256419
51174,0.001239,172.217.194.0-255,1484,108804,8,256419
51175,0.001244,172.217.194.0-255,2902,111706,8,256419
51176,0.001247,172.31.36.0-255,66,111772,8,256419
51177,0.001266,172.217.194.0-255,5738,117510,8,256419
51178,0.001269,172.31.36.0-255,66,117576,8,256419
51179,0.001274,172.217.194.0-255,4320,121896,8,256419
51180,0.001276,172.31.36.0-255,66,121962,8,256419
51181,0.001297,172.217.194.0-255,2902,124864,8,256419
51182,0.0013,172.31.36.0-255,66,124930,8,256419
51183,0.001311,172.31.36.0-255,66,124996,8,256419
51184,0.001326,172.217.194.0-255,5738,130734,8,256419
51185,0.001329,172.31.36.0-255,66,130800,8,256419
51186,0.001331,172.217.194.0-255,1484,132284,8,256419
51187,0.001357,172.217.194.0-255,766,133050,8,256419
51188,0.00136,172.31.36.0-255,66,133116,8,256419
51189,0.001401,172.217.194.0-255,1484,134600,8,256419
51190,0.001413,172.217.194.0-255,2902,137502,8,256419
51191,0.001416,172.31.36.0-255,66,137568,8,256419
51192,0.001439,172.217.194.0-255,5738,143306,8,256419
51193,0.001442,172.31.36.0-255,66,143372,8,256419
51194,0.001445,172.217.194.0-255,1484,144856,8,256419
51195,0.001468,172.31.36.0-255,66,144922,8,256419
51196,0.001487,172.217.194.0-255,2902,147824,8,256419
51197,0.00149,172.31.36.0-255,66,147890,8,256419
51198,0.001494,172.217.194.0-255,2902,150792,8,256419
51199,0.001496,172.31.36.0-255,66,150858,8,256419
51200,0.001508,172.217.194.0-255,1484,152342,8,256419
51201,0.001534,172.217.194.0-255,6438,158780,8,256419
51202,0.001538,172.31.36.0-255,66,158846,8,256419
51203,0.001573,172.217.194.0-255,2902,161748,8,256419
51204,0.001576,172.31.36.0-255,66,161814,8,256419
51205,0.001593,172.217.194.0-255,4320,166134,8,256419
51206,0.001596,172.31.36.0-255,66,166200,8,256419
51207,0.001622,172.31.36.0-255,66,166266,8,256419
51208,0.001651,172.217.194.0-255,7156,173422,8,256419
51209,0.001654,172.31.36.0-255,66,173488,8,256419
51210,0.001684,172.217.194.0-255,4320,177808,8,256419
51211,0.001687,172.31.36.0-255,66,177874,8,256419
51212,0.001704,172.217.194.0-255,6438,184312,8,256419
51213,0.001707,172.31.36.0-255,66,184378,8,256419
51214,0.001834,172.217.194.0-255,1484,185862,8,256419
51215,0.001839,172.217.194.0-255,1484,187346,8,256419
51216,0.001843,172.31.36.0-255,66,187412,8,256419
51217,0.001857,172.217.194.0-255,1484,188896,8,256419
51218,0.001864,172.217.194.0-255,5738,194634,8,256419
51219,0.001867,172.31.36.0-255,66,194700,8,256419
51220,0.001877,172.217.194.0-255,4320,199020,8,256419
51221,0.001879,172.31.36.0-255,66,199086,8,256419
51222,0.001912,172.217.194.0-255,7156,206242,8,256419
51223,0.001915,172.31.36.0-255,66,206308,8,256419
51224,0.001942,172.31.36.0-255,66,206374,8,256419
51225,0.001947,172.217.194.0-255,3602,209976,8,256419
51226,0.00195,172.31.36.0-255,66,210042,8,256419
51227,0.001998,172.217.194.0-255,1484,211526,8,256419
51228,0.002002,172.217.194.0-255,1484,213010,8,256419
51229,0.002004,172.31.36.0-255,66,213076,8,256419
51230,0.002019,172.217.194.0-255,1484,214560,8,256419
51231,0.002025,172.217.194.0-255,5738,220298,8,256419
51232,0.002027,172.31.36.0-255,66,220364,8,256419
51233,0.002059,172.217.194.0-255,2902,223266,8,256419
51234,0.002062,172.31.36.0-255,66,223332,8,256419
51235,0.002094,172.31.36.0-255,66,223398,8,256419
51236,0.002132,172.31.36.0-255,66,223464,8,256419
51237,0.002158,172.217.194.0-255,5020,228484,8,256419
51238,0.002164,172.217.194.0-255,7156,235640,8,256419
51239,0.002164,172.31.36.0-255,66,235706,8,256419
51240,0.002168,172.31.36.0-255,66,235772,8,256419
51241,0.002243,172.31.36.0-255,66,235838,8,256419
51242,0.002248,172.217.194.0-255,3602,239440,8,256419
51243,0.002249,172.31.36.0-255,66,239506,8,256419
51244,0.002271,172.31.36.0-255,66,239572,8,256419
51245,0.002305,172.31.36.0-255,66,239638,8,256419
51246,0.00231,172.217.194.0-255,4320,243958,8,256419
51247,0.002312,172.31.36.0-255,66,244024,8,256419
51248,0.002344,172.31.36.0-255,66,244090,8,256419
51249,0.002361,172.31.36.0-255,66,244156,8,256419
51250,0.002376,172.217.194.0-255,1484,245640,8,256419
51251,0.002388,172.31.36.0-255,66,245706,8,256419
51252,0.002391,172.217.194.0-255,97,245803,8,256419
51253,0.002413,172.217.194.0-255,105,245908,8,256419
51254,0.00371,172.31.36.0-255,66,245974,8,256419
51255,0.003739,172.31.36.0-255,105,246079,8,256419
51256,0.006199,172.217.194.0-255,66,246145,8,256419
51257,0.028395,172.31.36.0-255,172,246317,8,256419
51258,0.028424,172.31.36.0-255,1110,247427,8,256419
51259,0.028463,172.31.36.0-255,1514,248941,8,256419
51260,0.028465,172.31.36.0-255,1514,250455,8,256419
51261,0.028469,172.31.36.0-255,1514,251969,8,256419
51262,0.028471,172.31.36.0-255,1514,253483,8,256419
51263,0.02849,172.31.36.0-255,1514,254997,8,256419
51264,0.028491,172.31.36.0-255,876,255873,8,256419
51265,0.029941,104.244.42.0-255,66,255939,8,256419
51266,0.029952,104.244.42.0-255,66,256005,8,256419
51267,0.029998,104.244.42.0-255,66,256071,8,256419
51268,0.030003,104.244.42.0-255,66,256137,8,256419
51269,0.030814,104.244.42.0-255,108,256245,8,256419
51270,0.030838,172.31.36.0-255,66,256311,8,256419
51271,0.053159,172.31.36.0-255,108,256419,8,256419
51272,0.0,74.125.24.0-255,152,152,8,302332
51273,1.8e-05,172.31.36.0-255,66,218,8,302332
51274,2.5e-05,74.125.24.0-255,1484,1702,8,302332
51275,2.9e-05,172.31.36.0-255,66,1768,8,302332
51276,3.7e-05,74.125.24.0-255,2902,4670,8,302332
51277,4.1e-05,172.31.36.0-255,66,4736,8,302332
51278,4.9e-05,74.125.24.0-255,7156,11892,8,302332
51279,5.2e-05,172.31.36.0-255,66,11958,8,302332
51280,7.7e-05,74.125.24.0-255,4910,16868,8,302332
51281,8e-05,172.31.36.0-255,66,16934,8,302332
51282,8.6e-05,74.125.24.0-255,4320,21254,8,302332
51283,8.8e-05,172.31.36.0-255,66,21320,8,302332
51284,0.000107,74.125.24.0-255,1484,22804,8,302332
51285,0.000109,172.31.36.0-255,66,22870,8,302332
51286,0.000118,74.125.24.0-255,7156,30026,8,302332
51287,0.00012,172.31.36.0-255,66,30092,8,302332
51288,0.000137,74.125.24.0-255,1125,31217,8,302332
51289,0.000139,172.31.36.0-255,66,31283,8,302332
51290,0.000172,74.125.24.0-255,2902,34185,8,302332
51291,0.000174,172.31.36.0-255,66,34251,8,302332
51292,0.000187,74.125.24.0-255,2902,37153,8,302332
51293,0.00019,172.31.36.0-255,66,37219,8,302332
51294,0.000197,74.125.24.0-255,7156,44375,8,302332
51295,0.0002,172.31.36.0-255,66,44441,8,302332
51296,0.000203,74.125.24.0-255,1484,45925,8,302332
51297,0.000206,172.31.36.0-255,66,45991,8,302332
51298,0.000244,172.31.36.0-255,66,46057,8,302332
51299,0.00025,74.125.24.0-255,5379,51436,8,302332
51300,0.000252,172.31.36.0-255,66,51502,8,302332
51301,0.000551,74.125.24.0-255,645,52147,8,302332
51302,0.000556,172.31.36.0-255,66,52213,8,302332
51303,0.000669,74.125.24.0-255,1484,53697,8,302332
51304,0.000675,74.125.24.0-255,2902,56599,8,302332
51305,0.000679,172.31.36.0-255,66,56665,8,302332
51306,0.000701,74.125.24.0-255,5738,62403,8,302332
51307,0.000704,172.31.36.0-255,66,62469,8,302332
51308,0.000729,172.31.36.0-255,66,62535,8,302332
51309,0.000753,74.125.24.0-255,4320,66855,8,302332
51310,0.000755,172.31.36.0-255,66,66921,8,302332
51311,0.000768,172.31.36.0-255,66,66987,8,302332
51312,0.001376,74.125.24.0-255,1484,68471,8,302332
51313,0.001385,74.125.24.0-255,2902,71373,8,302332
51314,0.00139,172.31.36.0-255,66,71439,8,302332
51315,0.001398,74.125.24.0-255,5738,77177,8,302332
51316,0.001401,172.31.36.0-255,66,77243,8,302332
51317,0.001408,74.125.24.0-255,5738,82981,8,302332
51318,0.001411,172.31.36.0-255,66,83047,8,302332
51319,0.001437,74.125.24.0-255,1484,84531,8,302332
51320,0.001452,172.31.36.0-255,66,84597,8,302332
51321,0.001457,74.125.24.0-255,2184,86781,8,302332
51322,0.001459,172.31.36.0-255,66,86847,8,302332
51323,0.001666,74.125.24.0-255,1484,88331,8,302332
51324,0.001674,74.125.24.0-255,2902,91233,8,302332
51325,0.00168,172.31.36.0-255,66,91299,8,302332
51326,0.001686,74.125.24.0-255,5738,97037,8,302332
51327,0.001689,172.31.36.0-255,66,97103,8,302332
51328,0.001723,74.125.24.0-255,1484,98587,8,302332
51329,0.001741,74.125.24.0-255,4320,102907,8,302332
51330,0.001744,172.31.36.0-255,66,102973,8,302332
51331,0.001758,172.31.36.0-255,66,103039,8,302332
51332,0.001764,74.125.24.0-255,5020,108059,8,302332
51333,0.001766,172.31.36.0-255,66,108125,8,302332
51334,0.002096,74.125.24.0-255,1484,109609,8,302332
51335,0.002114,74.125.24.0-255,2902,112511,8,302332
51336,0.002118,172.31.36.0-255,66,112577,8,302332
51337,0.002121,74.125.24.0-255,1484,114061,8,302332
51338,0.002137,74.125.24.0-255,4320,118381,8,302332
51339,0.00214,172.31.36.0-255,66,118447,8,302332
51340,0.002144,74.125.24.0-255,2902,121349,8,302332
51341,0.002146,172.31.36.0-255,66,121415,8,302332
51342,0.002163,74.125.24.0-255,4320,125735,8,302332
51343,0.002165,172.31.36.0-255,66,125801,8,302332
51344,0.00217,74.125.24.0-255,2902,128703,8,302332
51345,0.002172,172.31.36.0-255,66,128769,8,302332
51346,0.002203,172.31.36.0-255,66,128835,8,302332
51347,0.002207,74.125.24.0-255,2184,131019,8,302332
51348,0.002209,172.31.36.0-255,66,131085,8,302332
51349,0.00445,74.125.24.0-255,5738,136823,8,302332
51350,0.004458,172.31.36.0-255,66,136889,8,302332
51351,0.00669,74.125.24.0-255,5738,142627,8,302332
51352,0.006698,172.31.36.0-255,66,142693,8,302332
51353,0.008927,74.125.24.0-255,5738,148431,8,302332
51354,0.008936,172.31.36.0-255,66,148497,8,302332
51355,0.011181,74.125.24.0-255,5738,154235,8,302332
51356,0.011189,172.31.36.0-255,66,154301,8,302332
51357,0.013437,74.125.24.0-255,5738,160039,8,302332
51358,0.013444,172.31.36.0-255,66,160105,8,302332
51359,0.01571,74.125.24.0-255,5738,165843,8,302332
51360,0.015718,172.31.36.0-255,66,165909,8,302332
51361,0.017995,74.125.24.0-255,5738,171647,8,302332
51362,0.018006,172.31.36.0-255,66,171713,8,302332
51363,0.020294,74.125.24.0-255,5738,177451,8,302332
51364,0.020302,172.31.36.0-255,66,177517,8,302332
51365,0.022532,74.125.24.0-255,5738,183255,8,302332
51366,0.022538,172.31.36.0-255,66,183321,8,302332
51367,0.02479,74.125.24.0-255,5738,189059,8,302332
51368,0.024799,172.31.36.0-255,66,189125,8,302332
51369,0.024927,172.31.36.0-255,167,189292,8,302332
51370,0.024957,172.31.36.0-255,1112,190404,8,302332
51371,0.02507,172.31.36.0-255,1514,191918,8,302332
51372,0.025072,172.31.36.0-255,1292,193210,8,302332
51373,0.026479,104.244.42.0-255,66,193276,8,302332
51374,0.02651,104.244.42.0-255,66,193342,8,302332
51375,0.026626,104.244.42.0-255,66,193408,8,302332
51376,0.027065,74.125.24.0-255,5738,199146,8,302332
51377,0.02707,172.31.36.0-255,66,199212,8,302332
51378,0.02932,74.125.24.0-255,5738,204950,8,302332
51379,0.029327,172.31.36.0-255,66,205016,8,302332
51380,0.031606,74.125.24.0-255,5738,210754,8,302332
51381,0.031612,172.31.36.0-255,66,210820,8,302332
51382,0.033877,74.125.24.0-255,5738,216558,8,302332
51383,0.033884,172.31.36.0-255,66,216624,8,302332
51384,0.036147,74.125.24.0-255,5738,222362,8,302332
51385,0.036154,172.31.36.0-255,66,222428,8,302332
51386,0.038432,74.125.24.0-255,5738,228166,8,302332
51387,0.038438,172.31.36.0-255,66,228232,8,302332
51388,0.040724,74.125.24.0-255,5738,233970,8,302332
51389,0.040735,172.31.36.0-255,66,234036,8,302332
51390,0.043015,74.125.24.0-255,5738,239774,8,302332
51391,0.043023,172.31.36.0-255,66,239840,8,302332
51392,0.045288,74.125.24.0-255,5738,245578,8,302332
51393,0.045295,172.31.36.0-255,66,245644,8,302332
51394,0.047546,74.125.24.0-255,5738,251382,8,302332
51395,0.047552,172.31.36.0-255,66,251448,8,302332
51396,0.049856,74.125.24.0-255,5738,257186,8,302332
51397,0.049862,172.31.36.0-255,66,257252,8,302332
51398,0.052117,74.125.24.0-255,5738,262990,8,302332
51399,0.052122,172.31.36.0-255,66,263056,8,302332
51400,0.054354,74.125.24.0-255,5738,268794,8,302332
51401,0.054361,172.31.36.0-255,66,268860,8,302332
51402,0.056615,74.125.24.0-255,5738,274598,8,302332
51403,0.056621,172.31.36.0-255,66,274664,8,302332
51404,0.058909,74.125.24.0-255,5738,280402,8,302332
51405,0.058917,172.31.36.0-255,66,280468,8,302332
51406,0.061234,74.125.24.0-255,4320,284788,8,302332
51407,0.061241,172.31.36.0-255,66,284854,8,302332
51408,0.061263,74.125.24.0-255,1484,286338,8,302332
51409,0.063506,74.125.24.0-255,4320,290658,8,302332
51410,0.063513,172.31.36.0-255,66,290724,8,302332
51411,0.065771,74.125.24.0-255,5738,296462,8,302332
51412,0.065777,172.31.36.0-255,66,296528,8,302332
51413,0.068016,74.125.24.0-255,5738,302266,8,302332
51414,0.068022,172.31.36.0-255,66,302332,8,302332
51415,0.0,172.31.36.0-255,66,66,8,66
