,TIME,SRC,PACKET_SIZE,CUMULATIVE_PACKET_SIZE,PAGE_NUMBER,TOTAL_PACKET_SIZE
0,0.0,74.125.24.0-255,153,153,76,262011
1,1.7e-05,172.31.40.0-255,66,219,76,262011
2,2.3e-05,74.125.24.0-255,1484,1703,76,262011
3,2.8e-05,172.31.40.0-255,66,1769,76,262011
4,3.4e-05,74.125.24.0-255,2902,4671,76,262011
5,3.8e-05,172.31.40.0-255,66,4737,76,262011
6,4.4e-05,74.125.24.0-255,4320,9057,76,262011
7,4.6e-05,172.31.40.0-255,66,9123,76,262011
8,6.5e-05,74.125.24.0-255,2902,12025,76,262011
9,6.8e-05,172.31.40.0-255,66,12091,76,262011
10,7.2e-05,74.125.24.0-255,1484,13575,76,262011
11,7.3e-05,172.31.40.0-255,66,13641,76,262011
12,7.7e-05,74.125.24.0-255,654,14295,76,262011
13,7.9e-05,172.31.40.0-255,66,14361,76,262011
14,0.000142,74.125.24.0-255,1484,15845,76,262011
15,0.000145,172.31.40.0-255,66,15911,76,262011
16,0.000152,74.125.24.0-255,2902,18813,76,262011
17,0.000155,172.31.40.0-255,66,18879,76,262011
18,0.000159,74.125.24.0-255,2902,21781,76,262011
19,0.000162,172.31.40.0-255,66,21847,76,262011
20,0.000186,74.125.24.0-255,2902,24749,76,262011
21,0.000189,172.31.40.0-255,66,24815,76,262011
22,0.000215,74.125.24.0-255,6797,31612,76,262011
23,0.000218,172.31.40.0-255,66,31678,76,262011
24,0.000226,74.125.24.0-255,7156,38834,76,262011
25,0.000228,172.31.40.0-255,66,38900,76,262011
26,0.000284,172.31.40.0-255,66,38966,76,262011
27,0.000303,74.125.24.0-255,1484,40450,76,262011
28,0.000305,172.31.40.0-255,66,40516,76,262011
29,0.00031,74.125.24.0-255,2902,43418,76,262011
30,0.000311,172.31.40.0-255,66,43484,76,262011
31,0.000341,74.125.24.0-255,5738,49222,76,262011
32,0.000343,172.31.40.0-255,66,49288,76,262011
33,0.000346,74.125.24.0-255,1484,50772,76,262011
34,0.000365,74.125.24.0-255,5379,56151,76,262011
35,0.000368,172.31.40.0-255,66,56217,76,262011
36,0.000371,74.125.24.0-255,403,56620,76,262011
37,0.000417,74.125.24.0-255,342,56962,76,262011
38,0.000533,74.125.24.0-255,1484,58446,76,262011
39,0.000538,172.31.40.0-255,66,58512,76,262011
40,0.000544,74.125.24.0-255,2902,61414,76,262011
41,0.000546,172.31.40.0-255,66,61480,76,262011
42,0.000553,74.125.24.0-255,5738,67218,76,262011
43,0.000557,172.31.40.0-255,66,67284,76,262011
44,0.000603,74.125.24.0-255,6797,74081,76,262011
45,0.000607,172.31.40.0-255,66,74147,76,262011
46,0.000625,74.125.24.0-255,1484,75631,76,262011
47,0.000642,74.125.24.0-255,5738,81369,76,262011
48,0.000645,172.31.40.0-255,66,81435,76,262011
49,0.000676,172.31.40.0-255,66,81501,76,262011
50,0.001096,74.125.24.0-255,1484,82985,76,262011
51,0.001103,74.125.24.0-255,2902,85887,76,262011
52,0.001106,172.31.40.0-255,66,85953,76,262011
53,0.001114,74.125.24.0-255,5738,91691,76,262011
54,0.001116,172.31.40.0-255,66,91757,76,262011
55,0.001155,172.31.40.0-255,66,91823,76,262011
56,0.001178,172.31.40.0-255,66,91889,76,262011
57,0.001193,74.125.24.0-255,5020,96909,76,262011
58,0.001195,172.31.40.0-255,66,96975,76,262011
59,0.001422,74.125.24.0-255,1484,98459,76,262011
60,0.001428,74.125.24.0-255,2902,101361,76,262011
61,0.001432,172.31.40.0-255,66,101427,76,262011
62,0.001437,74.125.24.0-255,2902,104329,76,262011
63,0.001439,172.31.40.0-255,66,104395,76,262011
64,0.001454,74.125.24.0-255,2902,107297,76,262011
65,0.001456,172.31.40.0-255,66,107363,76,262011
66,0.001475,74.125.24.0-255,7156,114519,76,262011
67,0.001479,172.31.40.0-255,66,114585,76,262011
68,0.001511,74.125.24.0-255,5738,120323,76,262011
69,0.001513,172.31.40.0-255,66,120389,76,262011
70,0.001525,172.31.40.0-255,66,120455,76,262011
71,0.001556,74.125.24.0-255,1484,121939,76,262011
72,0.001571,74.125.24.0-255,2902,124841,76,262011
73,0.001573,172.31.40.0-255,66,124907,76,262011
74,0.001577,74.125.24.0-255,1484,126391,76,262011
75,0.001598,74.125.24.0-255,4320,130711,76,262011
76,0.0016,172.31.40.0-255,66,130777,76,262011
77,0.001608,74.125.24.0-255,7156,137933,76,262011
78,0.001609,172.31.40.0-255,66,137999,76,262011
79,0.001679,172.31.40.0-255,66,138065,76,262011
80,0.00169,172.31.40.0-255,66,138131,76,262011
81,0.001696,74.125.24.0-255,7156,145287,76,262011
82,0.001699,172.31.40.0-255,66,145353,76,262011
83,0.00174,74.125.24.0-255,3602,148955,76,262011
84,0.001744,172.31.40.0-255,66,149021,76,262011
85,0.001852,74.125.24.0-255,1484,150505,76,262011
86,0.001858,74.125.24.0-255,2902,153407,76,262011
87,0.001861,172.31.40.0-255,66,153473,76,262011
88,0.001888,74.125.24.0-255,5738,159211,76,262011
89,0.001916,74.125.24.0-255,4320,163531,76,262011
90,0.001922,74.125.24.0-255,7156,170687,76,262011
91,0.001939,172.31.40.0-255,66,170753,76,262011
92,0.001957,74.125.24.0-255,1484,172237,76,262011
93,0.001973,74.125.24.0-255,2184,174421,76,262011
94,0.001977,172.31.40.0-255,66,174487,76,262011
95,0.002193,74.125.24.0-255,1484,175971,76,262011
96,0.002199,74.125.24.0-255,2902,178873,76,262011
97,0.002202,172.31.40.0-255,66,178939,76,262011
98,0.002206,74.125.24.0-255,1484,180423,76,262011
99,0.002225,74.125.24.0-255,1484,181907,76,262011
100,0.002231,74.125.24.0-255,5738,187645,76,262011
101,0.002236,172.31.40.0-255,66,187711,76,262011
102,0.002249,74.125.24.0-255,1484,189195,76,262011
103,0.002265,74.125.24.0-255,1484,190679,76,262011
104,0.002333,172.31.40.0-255,66,190745,76,262011
105,0.002339,74.125.24.0-255,3602,194347,76,262011
106,0.002379,74.125.24.0-255,1484,195831,76,262011
107,0.002391,74.125.24.0-255,2902,198733,76,262011
108,0.002393,74.125.24.0-255,1484,200217,76,262011
109,0.002413,74.125.24.0-255,4320,204537,76,262011
110,0.002418,74.125.24.0-255,5738,210275,76,262011
111,0.002444,74.125.24.0-255,7156,217431,76,262011
112,0.002472,74.125.24.0-255,1484,218915,76,262011
113,0.00252,74.125.24.0-255,4320,223235,76,262011
114,0.002543,74.125.24.0-255,1484,224719,76,262011
115,0.00255,74.125.24.0-255,7156,231875,76,262011
116,0.002556,74.125.24.0-255,5738,237613,76,262011
117,0.002609,74.125.24.0-255,2902,240515,76,262011
118,0.002627,74.125.24.0-255,3602,244117,76,262011
119,0.005724,172.31.40.0-255,66,244183,76,262011
120,0.008336,74.125.24.0-255,5738,249921,76,262011
121,0.008343,172.31.40.0-255,66,249987,76,262011
122,0.010918,74.125.24.0-255,5738,255725,76,262011
123,0.010925,172.31.40.0-255,66,255791,76,262011
124,0.013534,74.125.24.0-255,1683,257474,76,262011
125,0.013543,172.31.40.0-255,66,257540,76,262011
126,0.019005,172.31.40.0-255,105,257645,76,262011
127,0.021589,74.125.24.0-255,66,257711,76,262011
128,0.030178,172.31.40.0-255,172,257883,76,262011
129,0.030207,172.31.40.0-255,1109,258992,76,262011
130,0.030263,172.31.40.0-255,1514,260506,76,262011
131,0.030265,172.31.40.0-255,1307,261813,76,262011
132,0.031737,104.244.42.0-255,66,261879,76,262011
133,0.031939,104.244.42.0-255,66,261945,76,262011
134,0.031942,104.244.42.0-255,66,262011,76,262011
135,0.0,172.217.194.0-255,152,152,76,198413
136,1.3e-05,172.31.40.0-255,66,218,76,198413
137,1.9e-05,172.217.194.0-255,1484,1702,76,198413
138,2.3e-05,172.31.40.0-255,66,1768,76,198413
139,5.6e-05,172.217.194.0-255,2902,4670,76,198413
140,5.9e-05,172.31.40.0-255,66,4736,76,198413
141,6.6e-05,172.217.194.0-255,5738,10474,76,198413
142,6.8e-05,172.31.40.0-255,66,10540,76,198413
143,0.000109,172.217.194.0-255,3507,14047,76,198413
144,0.000111,172.31.40.0-255,66,14113,76,198413
145,0.000152,172.217.194.0-255,1484,15597,76,198413
146,0.000155,172.31.40.0-255,66,15663,76,198413
147,0.000159,172.217.194.0-255,2902,18565,76,198413
148,0.000161,172.31.40.0-255,66,18631,76,198413
149,0.000196,172.217.194.0-255,5738,24369,76,198413
150,0.000199,172.31.40.0-255,66,24435,76,198413
151,0.000213,172.217.194.0-255,4320,28755,76,198413
152,0.000218,172.31.40.0-255,66,28821,76,198413
153,0.000232,172.217.194.0-255,5379,34200,76,198413
154,0.000234,172.31.40.0-255,66,34266,76,198413
155,0.000247,172.31.40.0-255,66,34332,76,198413
156,0.00027,172.217.194.0-255,1484,35816,76,198413
157,0.000276,172.31.40.0-255,66,35882,76,198413
158,0.000281,172.217.194.0-255,3961,39843,76,198413
159,0.000282,172.31.40.0-255,66,39909,76,198413
160,0.000583,172.217.194.0-255,1484,41393,76,198413
161,0.000588,172.31.40.0-255,66,41459,76,198413
162,0.000594,172.217.194.0-255,2902,44361,76,198413
163,0.000597,172.31.40.0-255,66,44427,76,198413
164,0.0006,172.217.194.0-255,1484,45911,76,198413
165,0.000603,172.31.40.0-255,66,45977,76,198413
166,0.000635,172.217.194.0-255,4320,50297,76,198413
167,0.000637,172.31.40.0-255,66,50363,76,198413
168,0.000649,172.217.194.0-255,6797,57160,76,198413
169,0.000652,172.31.40.0-255,66,57226,76,198413
170,0.000655,172.217.194.0-255,647,57873,76,198413
171,0.000767,172.217.194.0-255,1484,59357,76,198413
172,0.000771,172.31.40.0-255,66,59423,76,198413
173,0.000777,172.217.194.0-255,2902,62325,76,198413
174,0.000778,172.31.40.0-255,66,62391,76,198413
175,0.000811,172.217.194.0-255,5738,68129,76,198413
176,0.000813,172.31.40.0-255,66,68195,76,198413
177,0.000826,172.31.40.0-255,66,68261,76,198413
178,0.000854,172.217.194.0-255,1484,69745,76,198413
179,0.000876,172.217.194.0-255,4320,74065,76,198413
180,0.00088,172.31.40.0-255,66,74131,76,198413
181,0.000899,172.217.194.0-255,6438,80569,76,198413
182,0.000902,172.31.40.0-255,66,80635,76,198413
183,0.000927,172.217.194.0-255,1484,82119,76,198413
184,0.000933,172.217.194.0-255,2902,85021,76,198413
185,0.000936,172.31.40.0-255,66,85087,76,198413
186,0.000942,172.217.194.0-255,4320,89407,76,198413
187,0.000944,172.31.40.0-255,66,89473,76,198413
188,0.00096,172.217.194.0-255,1484,90957,76,198413
189,0.000963,172.217.194.0-255,1484,92441,76,198413
190,0.00097,172.31.40.0-255,66,92507,76,198413
191,0.00101,172.31.40.0-255,66,92573,76,198413
192,0.001023,172.31.40.0-255,66,92639,76,198413
193,0.001058,172.217.194.0-255,7156,99795,76,198413
194,0.00106,172.31.40.0-255,66,99861,76,198413
195,0.001089,172.31.40.0-255,66,99927,76,198413
196,0.001106,172.31.40.0-255,66,99993,76,198413
197,0.001109,172.217.194.0-255,766,100759,76,198413
198,0.001157,172.31.40.0-255,66,100825,76,198413
199,0.001186,172.31.40.0-255,66,100891,76,198413
200,0.001191,172.217.194.0-255,2902,103793,76,198413
201,0.001194,172.31.40.0-255,66,103859,76,198413
202,0.001233,172.217.194.0-255,7156,111015,76,198413
203,0.001237,172.31.40.0-255,66,111081,76,198413
204,0.00124,172.31.40.0-255,66,111147,76,198413
205,0.001268,172.217.194.0-255,7156,118303,76,198413
206,0.001272,172.31.40.0-255,66,118369,76,198413
207,0.001285,172.31.40.0-255,66,118435,76,198413
208,0.001331,172.31.40.0-255,66,118501,76,198413
209,0.001384,172.217.194.0-255,1484,119985,76,198413
210,0.001401,172.217.194.0-255,2902,122887,76,198413
211,0.001405,172.31.40.0-255,66,122953,76,198413
212,0.001435,172.217.194.0-255,4320,127273,76,198413
213,0.001438,172.31.40.0-255,66,127339,76,198413
214,0.001468,172.217.194.0-255,1484,128823,76,198413
215,0.001473,172.217.194.0-255,5738,134561,76,198413
216,0.001485,172.217.194.0-255,7156,141717,76,198413
217,0.001526,172.31.40.0-255,66,141783,76,198413
218,0.001535,172.31.40.0-255,66,141849,76,198413
219,0.001551,172.31.40.0-255,66,141915,76,198413
220,0.001578,172.217.194.0-255,1484,143399,76,198413
221,0.001588,172.217.194.0-255,2902,146301,76,198413
222,0.001591,172.31.40.0-255,66,146367,76,198413
223,0.001603,172.217.194.0-255,1484,147851,76,198413
224,0.001622,172.217.194.0-255,2902,150753,76,198413
225,0.001625,172.31.40.0-255,66,150819,76,198413
226,0.001631,172.217.194.0-255,5738,156557,76,198413
227,0.001633,172.31.40.0-255,66,156623,76,198413
228,0.001674,172.31.40.0-255,66,156689,76,198413
229,0.001685,172.31.40.0-255,66,156755,76,198413
230,0.00176,172.217.194.0-255,1484,158239,76,198413
231,0.001766,172.217.194.0-255,2902,161141,76,198413
232,0.001769,172.31.40.0-255,66,161207,76,198413
233,0.001773,172.217.194.0-255,1484,162691,76,198413
234,0.001792,172.217.194.0-255,4320,167011,76,198413
235,0.001795,172.31.40.0-255,66,167077,76,198413
236,0.001845,172.31.40.0-255,66,167143,76,198413
237,0.001859,172.31.40.0-255,66,167209,76,198413
238,0.001868,172.217.194.0-255,2902,170111,76,198413
239,0.00187,172.31.40.0-255,66,170177,76,198413
240,0.001876,172.217.194.0-255,4320,174497,76,198413
241,0.001878,172.31.40.0-255,66,174563,76,198413
242,0.001881,172.217.194.0-255,1484,176047,76,198413
243,0.001918,172.217.194.0-255,7156,183203,76,198413
244,0.001921,172.31.40.0-255,66,183269,76,198413
245,0.001925,172.217.194.0-255,1484,184753,76,198413
246,0.001957,172.31.40.0-255,66,184819,76,198413
247,0.001984,172.217.194.0-255,6438,191257,76,198413
248,0.001988,172.31.40.0-255,66,191323,76,198413
249,0.002006,172.31.40.0-255,66,191389,76,198413
250,0.002018,172.31.40.0-255,66,191455,76,198413
251,0.00205,172.217.194.0-255,2184,193639,76,198413
252,0.002052,172.31.40.0-255,66,193705,76,198413
253,0.002069,172.31.40.0-255,66,193771,76,198413
254,0.002072,172.217.194.0-255,105,193876,76,198413
255,0.012065,172.31.40.0-255,66,193942,76,198413
256,0.012108,172.31.40.0-255,105,194047,76,198413
257,0.014802,172.217.194.0-255,66,194113,76,198413
258,0.034359,172.31.40.0-255,172,194285,76,198413
259,0.034386,172.31.40.0-255,1109,195394,76,198413
260,0.034441,172.31.40.0-255,1514,196908,76,198413
261,0.034443,172.31.40.0-255,1307,198215,76,198413
262,0.035999,104.244.42.0-255,66,198281,76,198413
263,0.03604,104.244.42.0-255,66,198347,76,198413
264,0.036087,104.244.42.0-255,66,198413,76,198413
265,0.0,216.58.221.0-255,154,154,76,363995
266,1.8e-05,172.31.40.0-255,66,220,76,363995
267,2.6e-05,216.58.221.0-255,1484,1704,76,363995
268,3e-05,172.31.40.0-255,66,1770,76,363995
269,3.5e-05,216.58.221.0-255,2902,4672,76,363995
270,3.8e-05,172.31.40.0-255,66,4738,76,363995
271,5.2e-05,216.58.221.0-255,7156,11894,76,363995
272,5.5e-05,172.31.40.0-255,66,11960,76,363995
273,5.9e-05,216.58.221.0-255,2094,14054,76,363995
274,6.1e-05,172.31.40.0-255,66,14120,76,363995
275,0.000271,216.58.221.0-255,1484,15604,76,363995
276,0.000277,172.31.40.0-255,66,15670,76,363995
277,0.000283,216.58.221.0-255,2902,18572,76,363995
278,0.000286,172.31.40.0-255,66,18638,76,363995
279,0.000298,216.58.221.0-255,5738,24376,76,363995
280,0.000301,172.31.40.0-255,66,24442,76,363995
281,0.000337,216.58.221.0-255,6797,31239,76,363995
282,0.00034,172.31.40.0-255,66,31305,76,363995
283,0.000347,216.58.221.0-255,7156,38461,76,363995
284,0.000349,172.31.40.0-255,66,38527,76,363995
285,0.000394,172.31.40.0-255,66,38593,76,363995
286,0.000419,216.58.221.0-255,1125,39718,76,363995
287,0.000421,172.31.40.0-255,66,39784,76,363995
288,0.000783,216.58.221.0-255,1484,41268,76,363995
289,0.000787,172.31.40.0-255,66,41334,76,363995
290,0.000792,216.58.221.0-255,1484,42818,76,363995
291,0.000794,172.31.40.0-255,66,42884,76,363995
292,0.000799,216.58.221.0-255,2902,45786,76,363995
293,0.000801,172.31.40.0-255,66,45852,76,363995
294,0.000811,216.58.221.0-255,5738,51590,76,363995
295,0.000813,172.31.40.0-255,66,51656,76,363995
296,0.000866,216.58.221.0-255,5671,57327,76,363995
297,0.000869,172.31.40.0-255,66,57393,76,363995
298,0.00122,216.58.221.0-255,385,57778,76,363995
299,0.001358,216.58.221.0-255,1484,59262,76,363995
300,0.001364,172.31.40.0-255,66,59328,76,363995
301,0.00137,216.58.221.0-255,2902,62230,76,363995
302,0.001371,172.31.40.0-255,66,62296,76,363995
303,0.001381,216.58.221.0-255,2902,65198,76,363995
304,0.001383,172.31.40.0-255,66,65264,76,363995
305,0.001414,216.58.221.0-255,2902,68166,76,363995
306,0.001416,172.31.40.0-255,66,68232,76,363995
307,0.00142,216.58.221.0-255,1484,69716,76,363995
308,0.001447,216.58.221.0-255,5379,75095,76,363995
309,0.001449,172.31.40.0-255,66,75161,76,363995
310,0.001476,216.58.221.0-255,2902,78063,76,363995
311,0.001478,172.31.40.0-255,66,78129,76,363995
312,0.001484,216.58.221.0-255,2902,81031,76,363995
313,0.001486,172.31.40.0-255,66,81097,76,363995
314,0.001514,216.58.221.0-255,1484,82581,76,363995
315,0.001525,172.31.40.0-255,66,82647,76,363995
316,0.001528,216.58.221.0-255,1125,83772,76,363995
317,0.003525,216.58.221.0-255,4320,88092,76,363995
318,0.003532,172.31.40.0-255,66,88158,76,363995
319,0.005553,216.58.221.0-255,5738,93896,76,363995
320,0.00556,172.31.40.0-255,66,93962,76,363995
321,0.007607,216.58.221.0-255,5738,99700,76,363995
322,0.007614,172.31.40.0-255,66,99766,76,363995
323,0.009633,216.58.221.0-255,5738,105504,76,363995
324,0.00964,172.31.40.0-255,66,105570,76,363995
325,0.011665,216.58.221.0-255,5738,111308,76,363995
326,0.011673,172.31.40.0-255,66,111374,76,363995
327,0.013695,216.58.221.0-255,5738,117112,76,363995
328,0.013704,172.31.40.0-255,66,117178,76,363995
329,0.015719,216.58.221.0-255,5738,122916,76,363995
330,0.015727,172.31.40.0-255,66,122982,76,363995
331,0.017771,216.58.221.0-255,4320,127302,76,363995
332,0.017777,172.31.40.0-255,66,127368,76,363995
333,0.017804,216.58.221.0-255,1484,128852,76,363995
334,0.019789,216.58.221.0-255,4320,133172,76,363995
335,0.019796,172.31.40.0-255,66,133238,76,363995
336,0.021853,216.58.221.0-255,5738,138976,76,363995
337,0.02186,172.31.40.0-255,66,139042,76,363995
338,0.023873,216.58.221.0-255,5738,144780,76,363995
339,0.02388,172.31.40.0-255,66,144846,76,363995
340,0.025898,216.58.221.0-255,5738,150584,76,363995
341,0.025905,172.31.40.0-255,66,150650,76,363995
342,0.027819,172.31.40.0-255,172,150822,76,363995
343,0.027848,172.31.40.0-255,1105,151927,76,363995
344,0.027904,216.58.221.0-255,5738,157665,76,363995
345,0.02791,172.31.40.0-255,66,157731,76,363995
346,0.027941,172.31.40.0-255,1514,159245,76,363995
347,0.027943,172.31.40.0-255,1311,160556,76,363995
348,0.02949,104.244.42.0-255,66,160622,76,363995
349,0.029519,104.244.42.0-255,66,160688,76,363995
350,0.029616,104.244.42.0-255,66,160754,76,363995
351,0.029955,216.58.221.0-255,5738,166492,76,363995
352,0.029961,172.31.40.0-255,66,166558,76,363995
353,0.031975,216.58.221.0-255,5738,172296,76,363995
354,0.031981,172.31.40.0-255,66,172362,76,363995
355,0.033996,216.58.221.0-255,5738,178100,76,363995
356,0.034002,172.31.40.0-255,66,178166,76,363995
357,0.036027,216.58.221.0-255,5738,183904,76,363995
358,0.036034,172.31.40.0-255,66,183970,76,363995
359,0.038078,216.58.221.0-255,5738,189708,76,363995
360,0.038083,172.31.40.0-255,66,189774,76,363995
361,0.040131,216.58.221.0-255,5738,195512,76,363995
362,0.040137,172.31.40.0-255,66,195578,76,363995
363,0.04216,216.58.221.0-255,5738,201316,76,363995
364,0.042167,172.31.40.0-255,66,201382,76,363995
365,0.044189,216.58.221.0-255,5738,207120,76,363995
366,0.044195,172.31.40.0-255,66,207186,76,363995
367,0.046243,216.58.221.0-255,5738,212924,76,363995
368,0.04625,172.31.40.0-255,66,212990,76,363995
369,0.048276,216.58.221.0-255,5738,218728,76,363995
370,0.048282,172.31.40.0-255,66,218794,76,363995
371,0.05029,216.58.221.0-255,5738,224532,76,363995
372,0.050296,172.31.40.0-255,66,224598,76,363995
373,0.052352,216.58.221.0-255,5738,230336,76,363995
374,0.052359,172.31.40.0-255,66,230402,76,363995
375,0.054405,216.58.221.0-255,5738,236140,76,363995
376,0.054413,172.31.40.0-255,66,236206,76,363995
377,0.056435,216.58.221.0-255,5738,241944,76,363995
378,0.056442,172.31.40.0-255,66,242010,76,363995
379,0.058451,216.58.221.0-255,5738,247748,76,363995
380,0.058457,172.31.40.0-255,66,247814,76,363995
381,0.060478,216.58.221.0-255,5738,253552,76,363995
382,0.060484,172.31.40.0-255,66,253618,76,363995
383,0.062507,216.58.221.0-255,5738,259356,76,363995
384,0.062512,172.31.40.0-255,66,259422,76,363995
385,0.064527,216.58.221.0-255,5738,265160,76,363995
386,0.064533,172.31.40.0-255,66,265226,76,363995
387,0.06656,216.58.221.0-255,5738,270964,76,363995
388,0.066567,172.31.40.0-255,66,271030,76,363995
389,0.068593,216.58.221.0-255,5738,276768,76,363995
390,0.068598,172.31.40.0-255,66,276834,76,363995
391,0.07062,216.58.221.0-255,5738,282572,76,363995
392,0.070626,172.31.40.0-255,66,282638,76,363995
393,0.072654,216.58.221.0-255,5738,288376,76,363995
394,0.07266,172.31.40.0-255,66,288442,76,363995
395,0.074676,216.58.221.0-255,5738,294180,76,363995
396,0.074681,172.31.40.0-255,66,294246,76,363995
397,0.076703,216.58.221.0-255,5738,299984,76,363995
398,0.07671,172.31.40.0-255,66,300050,76,363995
399,0.078727,216.58.221.0-255,5738,305788,76,363995
400,0.078732,172.31.40.0-255,66,305854,76,363995
401,0.080754,216.58.221.0-255,5738,311592,76,363995
402,0.08076,172.31.40.0-255,66,311658,76,363995
403,0.082857,216.58.221.0-255,5738,317396,76,363995
404,0.082862,172.31.40.0-255,66,317462,76,363995
405,0.08499,216.58.221.0-255,5738,323200,76,363995
406,0.084996,172.31.40.0-255,66,323266,76,363995
407,0.087039,216.58.221.0-255,5738,329004,76,363995
408,0.087045,172.31.40.0-255,66,329070,76,363995
409,0.089158,216.58.221.0-255,5738,334808,76,363995
410,0.089164,172.31.40.0-255,66,334874,76,363995
411,0.091187,216.58.221.0-255,5738,340612,76,363995
412,0.091194,172.31.40.0-255,66,340678,76,363995
413,0.093211,216.58.221.0-255,5738,346416,76,363995
414,0.093217,172.31.40.0-255,66,346482,76,363995
415,0.095237,216.58.221.0-255,5738,352220,76,363995
416,0.095243,172.31.40.0-255,66,352286,76,363995
417,0.097274,216.58.221.0-255,5738,358024,76,363995
418,0.097281,172.31.40.0-255,66,358090,76,363995
419,0.099336,216.58.221.0-255,5738,363828,76,363995
420,0.099342,172.31.40.0-255,66,363894,76,363995
421,0.099452,172.31.40.0-255,101,363995,76,363995
422,0.0,172.217.194.0-255,153,153,76,178000
423,2.5e-05,172.31.40.0-255,66,219,76,178000
424,3.3e-05,172.217.194.0-255,1484,1703,76,178000
425,3.7e-05,172.31.40.0-255,66,1769,76,178000
426,5.1e-05,172.217.194.0-255,2902,4671,76,178000
427,5.3e-05,172.31.40.0-255,66,4737,76,178000
428,5.7e-05,172.217.194.0-255,1484,6221,76,178000
429,6e-05,172.31.40.0-255,66,6287,76,178000
430,6.6e-05,172.217.194.0-255,2902,9189,76,178000
431,6.8e-05,172.31.40.0-255,66,9255,76,178000
432,7.3e-05,172.217.194.0-255,2902,12157,76,178000
433,7.6e-05,172.31.40.0-255,66,12223,76,178000
434,0.000119,172.217.194.0-255,3556,15779,76,178000
435,0.000122,172.31.40.0-255,66,15845,76,178000
436,0.000129,172.217.194.0-255,5738,21583,76,178000
437,0.000132,172.31.40.0-255,66,21649,76,178000
438,0.000138,172.217.194.0-255,5738,27387,76,178000
439,0.00014,172.31.40.0-255,66,27453,76,178000
440,0.000167,172.217.194.0-255,3961,31414,76,178000
441,0.000169,172.31.40.0-255,66,31480,76,178000
442,0.00033,172.217.194.0-255,1484,32964,76,178000
443,0.000335,172.31.40.0-255,66,33030,76,178000
444,0.00034,172.217.194.0-255,2902,35932,76,178000
445,0.000342,172.31.40.0-255,66,35998,76,178000
446,0.000349,172.217.194.0-255,5738,41736,76,178000
447,0.000356,172.31.40.0-255,66,41802,76,178000
448,0.000385,172.31.40.0-255,66,41868,76,178000
449,0.000391,172.217.194.0-255,4320,46188,76,178000
450,0.000393,172.31.40.0-255,66,46254,76,178000
451,0.00042,172.217.194.0-255,5738,51992,76,178000
452,0.000423,172.31.40.0-255,66,52058,76,178000
453,0.000428,172.217.194.0-255,3961,56019,76,178000
454,0.00043,172.31.40.0-255,66,56085,76,178000
455,0.000925,172.217.194.0-255,646,56731,76,178000
456,0.001025,172.217.194.0-255,1484,58215,76,178000
457,0.001029,172.31.40.0-255,66,58281,76,178000
458,0.001035,172.217.194.0-255,2902,61183,76,178000
459,0.001037,172.31.40.0-255,66,61249,76,178000
460,0.001041,172.217.194.0-255,2902,64151,76,178000
461,0.001048,172.31.40.0-255,66,64217,76,178000
462,0.001061,172.217.194.0-255,2902,67119,76,178000
463,0.001063,172.31.40.0-255,66,67185,76,178000
464,0.001092,172.217.194.0-255,2902,70087,76,178000
465,0.001094,172.31.40.0-255,66,70153,76,178000
466,0.001133,172.31.40.0-255,66,70219,76,178000
467,0.001145,172.31.40.0-255,66,70285,76,178000
468,0.001152,172.217.194.0-255,766,71051,76,178000
469,0.001193,172.217.194.0-255,1484,72535,76,178000
470,0.001196,172.31.40.0-255,66,72601,76,178000
471,0.001201,172.217.194.0-255,2902,75503,76,178000
472,0.001202,172.31.40.0-255,66,75569,76,178000
473,0.001238,172.217.194.0-255,5738,81307,76,178000
474,0.00124,172.31.40.0-255,66,81373,76,178000
475,0.00125,172.31.40.0-255,66,81439,76,178000
476,0.001285,172.217.194.0-255,4320,85759,76,178000
477,0.001288,172.31.40.0-255,66,85825,76,178000
478,0.001327,172.31.40.0-255,66,85891,76,178000
479,0.001363,172.217.194.0-255,7156,93047,76,178000
480,0.001366,172.31.40.0-255,66,93113,76,178000
481,0.001398,172.31.40.0-255,66,93179,76,178000
482,0.001414,172.31.40.0-255,66,93245,76,178000
483,0.001417,172.217.194.0-255,766,94011,76,178000
484,0.001487,172.217.194.0-255,1484,95495,76,178000
485,0.001492,172.31.40.0-255,66,95561,76,178000
486,0.001501,172.217.194.0-255,2902,98463,76,178000
487,0.001504,172.31.40.0-255,66,98529,76,178000
488,0.001533,172.217.194.0-255,5738,104267,76,178000
489,0.001536,172.31.40.0-255,66,104333,76,178000
490,0.001539,172.217.194.0-255,1484,105817,76,178000
491,0.001573,172.31.40.0-255,66,105883,76,178000
492,0.001575,172.217.194.0-255,1484,107367,76,178000
493,0.001598,172.217.194.0-255,4320,111687,76,178000
494,0.0016,172.31.40.0-255,66,111753,76,178000
495,0.001627,172.217.194.0-255,5020,116773,76,178000
496,0.00163,172.31.40.0-255,66,116839,76,178000
497,0.001703,172.217.194.0-255,1484,118323,76,178000
498,0.001709,172.217.194.0-255,2902,121225,76,178000
499,0.001712,172.31.40.0-255,66,121291,76,178000
500,0.001719,172.217.194.0-255,5738,127029,76,178000
501,0.001722,172.31.40.0-255,66,127095,76,178000
502,0.001724,172.217.194.0-255,1484,128579,76,178000
503,0.001766,172.217.194.0-255,5738,134317,76,178000
504,0.00177,172.31.40.0-255,66,134383,76,178000
505,0.001773,172.31.40.0-255,66,134449,76,178000
506,0.001796,172.217.194.0-255,2902,137351,76,178000
507,0.001799,172.31.40.0-255,66,137417,76,178000
508,0.001812,172.31.40.0-255,66,137483,76,178000
509,0.001862,172.31.40.0-255,66,137549,76,178000
510,0.001876,172.31.40.0-255,66,137615,76,178000
511,0.001881,172.217.194.0-255,2902,140517,76,178000
512,0.001882,172.31.40.0-255,66,140583,76,178000
513,0.001887,172.217.194.0-255,4320,144903,76,178000
514,0.00189,172.31.40.0-255,66,144969,76,178000
515,0.001901,172.31.40.0-255,66,145035,76,178000
516,0.001961,172.31.40.0-255,66,145101,76,178000
517,0.001967,172.217.194.0-255,4320,149421,76,178000
518,0.001969,172.31.40.0-255,66,149487,76,178000
519,0.002014,172.31.40.0-255,66,149553,76,178000
520,0.002029,172.31.40.0-255,66,149619,76,178000
521,0.002036,172.217.194.0-255,6438,156057,76,178000
522,0.002038,172.31.40.0-255,66,156123,76,178000
523,0.002139,172.31.40.0-255,66,156189,76,178000
524,0.00215,172.31.40.0-255,66,156255,76,178000
525,0.002166,172.31.40.0-255,66,156321,76,178000
526,0.002171,172.217.194.0-255,4320,160641,76,178000
527,0.002174,172.31.40.0-255,66,160707,76,178000
528,0.002218,172.31.40.0-255,66,160773,76,178000
529,0.002225,172.217.194.0-255,5020,165793,76,178000
530,0.002227,172.31.40.0-255,66,165859,76,178000
531,0.002231,172.217.194.0-255,2902,168761,76,178000
532,0.002233,172.31.40.0-255,66,168827,76,178000
533,0.002247,172.217.194.0-255,2902,171729,76,178000
534,0.002249,172.31.40.0-255,66,171795,76,178000
535,0.002254,172.217.194.0-255,2466,174261,76,178000
536,0.00226,172.31.40.0-255,66,174327,76,178000
537,0.002361,172.217.194.0-255,105,174432,76,178000
538,0.018803,172.31.40.0-255,66,174498,76,178000
539,0.018858,172.31.40.0-255,105,174603,76,178000
540,0.021117,172.217.194.0-255,66,174669,76,178000
541,0.038343,172.31.40.0-255,171,174840,76,178000
542,0.038377,172.31.40.0-255,1128,175968,76,178000
543,0.038442,172.31.40.0-255,1514,177482,76,178000
544,0.038444,172.31.40.0-255,320,177802,76,178000
545,0.039915,104.244.42.0-255,66,177868,76,178000
546,0.039939,104.244.42.0-255,66,177934,76,178000
547,0.039986,104.244.42.0-255,66,178000,76,178000
548,0.0,74.125.200.0-255,431,431,76,128213
549,2.7e-05,74.125.200.0-255,1484,1915,76,128213
550,3.7e-05,172.31.40.0-255,66,1981,76,128213
551,4.4e-05,74.125.200.0-255,2902,4883,76,128213
552,4.7e-05,172.31.40.0-255,66,4949,76,128213
553,6.9e-05,74.125.200.0-255,1484,6433,76,128213
554,8.8e-05,74.125.200.0-255,2902,9335,76,128213
555,9e-05,172.31.40.0-255,66,9401,76,128213
556,0.000234,74.125.200.0-255,4909,14310,76,128213
557,0.000239,172.31.40.0-255,66,14376,76,128213
558,0.00048,74.125.200.0-255,4320,18696,76,128213
559,0.000485,172.31.40.0-255,66,18762,76,128213
560,0.00051,74.125.200.0-255,1484,20246,76,128213
561,0.000743,172.31.40.0-255,66,20312,76,128213
562,0.002723,74.125.200.0-255,5738,26050,76,128213
563,0.002828,74.125.200.0-255,4320,30370,76,128213
564,0.003096,172.31.40.0-255,66,30436,76,128213
565,0.003446,172.31.40.0-255,66,30502,76,128213
566,0.003476,74.125.200.0-255,7156,37658,76,128213
567,0.0043,74.125.200.0-255,7156,44814,76,128213
568,0.004902,172.31.40.0-255,66,44880,76,128213
569,0.004995,74.125.200.0-255,5738,50618,76,128213
570,0.005004,172.31.40.0-255,66,50684,76,128213
571,0.005011,74.125.200.0-255,1484,52168,76,128213
572,0.005747,172.31.40.0-255,66,52234,76,128213
573,0.005777,74.125.200.0-255,1484,53718,76,128213
574,0.005866,74.125.200.0-255,2902,56620,76,128213
575,0.005876,172.31.40.0-255,66,56686,76,128213
576,0.005911,172.31.40.0-255,66,56752,76,128213
577,0.006344,74.125.200.0-255,4320,61072,76,128213
578,0.00635,172.31.40.0-255,66,61138,76,128213
579,0.006392,172.31.40.0-255,66,61204,76,128213
580,0.007569,172.31.40.0-255,66,61270,76,128213
581,0.007639,172.31.40.0-255,66,61336,76,128213
582,0.008415,74.125.200.0-255,5738,67074,76,128213
583,0.008423,172.31.40.0-255,66,67140,76,128213
584,0.008441,74.125.200.0-255,5738,72878,76,128213
585,0.00845,172.31.40.0-255,66,72944,76,128213
586,0.008477,74.125.200.0-255,7156,80100,76,128213
587,0.008481,172.31.40.0-255,66,80166,76,128213
588,0.008553,74.125.200.0-255,4320,84486,76,128213
589,0.008558,172.31.40.0-255,66,84552,76,128213
590,0.008606,172.31.40.0-255,66,84618,76,128213
591,0.008912,74.125.200.0-255,4320,88938,76,128213
592,0.008921,172.31.40.0-255,66,89004,76,128213
593,0.008976,172.31.40.0-255,66,89070,76,128213
594,0.009366,172.31.40.0-255,66,89136,76,128213
595,0.009418,172.31.40.0-255,66,89202,76,128213
596,0.009446,74.125.200.0-255,5738,94940,76,128213
597,0.009449,172.31.40.0-255,66,95006,76,128213
598,0.009837,74.125.200.0-255,7156,102162,76,128213
599,0.009843,172.31.40.0-255,66,102228,76,128213
600,0.009892,172.31.40.0-255,66,102294,76,128213
601,0.010013,172.31.40.0-255,66,102360,76,128213
602,0.01109,74.125.200.0-255,7156,109516,76,128213
603,0.011095,172.31.40.0-255,66,109582,76,128213
604,0.011119,172.31.40.0-255,66,109648,76,128213
605,0.011205,172.31.40.0-255,66,109714,76,128213
606,0.01137,74.125.200.0-255,1484,111198,76,128213
607,0.011391,74.125.200.0-255,7156,118354,76,128213
608,0.011394,172.31.40.0-255,66,118420,76,128213
609,0.011407,74.125.200.0-255,1484,119904,76,128213
610,0.011453,172.31.40.0-255,66,119970,76,128213
611,0.011499,172.31.40.0-255,66,120036,76,128213
612,0.011888,74.125.200.0-255,2825,122861,76,128213
613,0.011893,172.31.40.0-255,66,122927,76,128213
614,0.012405,172.31.40.0-255,105,123032,76,128213
615,0.019949,74.125.200.0-255,66,123098,76,128213
616,0.033758,172.31.40.0-255,164,123262,76,128213
617,0.03379,172.31.40.0-255,1117,124379,76,128213
618,0.033848,172.31.40.0-255,1514,125893,76,128213
619,0.03385,172.31.40.0-255,1514,127407,76,128213
620,0.033851,172.31.40.0-255,368,127775,76,128213
621,0.035407,104.244.42.0-255,66,127841,76,128213
622,0.035449,104.244.42.0-255,66,127907,76,128213
623,0.03556,104.244.42.0-255,66,127973,76,128213
624,0.035564,104.244.42.0-255,66,128039,76,128213
625,0.036373,104.244.42.0-255,108,128147,76,128213
626,0.036381,172.31.40.0-255,66,128213,76,128213
627,0.0,74.125.200.0-255,152,152,76,329316
628,2.1e-05,172.31.40.0-255,66,218,76,329316
629,2.9e-05,74.125.200.0-255,1484,1702,76,329316
630,3.3e-05,172.31.40.0-255,66,1768,76,329316
631,3.9e-05,74.125.200.0-255,2902,4670,76,329316
632,4.9e-05,172.31.40.0-255,66,4736,76,329316
633,5.7e-05,74.125.200.0-255,7156,11892,76,329316
634,5.9e-05,172.31.40.0-255,66,11958,76,329316
635,6.2e-05,74.125.200.0-255,1484,13442,76,329316
636,6.5e-05,172.31.40.0-255,66,13508,76,329316
637,7e-05,74.125.200.0-255,2098,15606,76,329316
638,7.3e-05,172.31.40.0-255,66,15672,76,329316
639,0.000114,74.125.200.0-255,5738,21410,76,329316
640,0.000119,172.31.40.0-255,66,21476,76,329316
641,0.000123,74.125.200.0-255,2902,24378,76,329316
642,0.000125,172.31.40.0-255,66,24444,76,329316
643,0.00013,74.125.200.0-255,4320,28764,76,329316
644,0.000132,172.31.40.0-255,66,28830,76,329316
645,0.000159,74.125.200.0-255,2543,31373,76,329316
646,0.000162,172.31.40.0-255,66,31439,76,329316
647,0.000303,74.125.200.0-255,1484,32923,76,329316
648,0.000307,172.31.40.0-255,66,32989,76,329316
649,0.000313,74.125.200.0-255,2902,35891,76,329316
650,0.000315,172.31.40.0-255,66,35957,76,329316
651,0.000345,74.125.200.0-255,5738,41695,76,329316
652,0.000347,172.31.40.0-255,66,41761,76,329316
653,0.000384,74.125.200.0-255,6797,48558,76,329316
654,0.000387,172.31.40.0-255,66,48624,76,329316
655,0.000392,74.125.200.0-255,4320,52944,76,329316
656,0.000393,172.31.40.0-255,66,53010,76,329316
657,0.000427,74.125.200.0-255,2902,55912,76,329316
658,0.00043,172.31.40.0-255,66,55978,76,329316
659,0.000437,74.125.200.0-255,5738,61716,76,329316
660,0.000439,172.31.40.0-255,66,61782,76,329316
661,0.000459,74.125.200.0-255,4239,66021,76,329316
662,0.000466,172.31.40.0-255,66,66087,76,329316
663,0.000468,74.125.200.0-255,376,66463,76,329316
664,0.000537,74.125.200.0-255,1484,67947,76,329316
665,0.00054,172.31.40.0-255,66,68013,76,329316
666,0.000543,74.125.200.0-255,1484,69497,76,329316
667,0.000563,74.125.200.0-255,1484,70981,76,329316
668,0.000566,172.31.40.0-255,66,71047,76,329316
669,0.000569,74.125.200.0-255,1484,72531,76,329316
670,0.000591,74.125.200.0-255,2902,75433,76,329316
671,0.000594,172.31.40.0-255,66,75499,76,329316
672,0.000601,74.125.200.0-255,5738,81237,76,329316
673,0.000603,172.31.40.0-255,66,81303,76,329316
674,0.000609,74.125.200.0-255,4320,85623,76,329316
675,0.000614,172.31.40.0-255,66,85689,76,329316
676,0.000639,74.125.200.0-255,1125,86814,76,329316
677,0.000647,74.125.200.0-255,5738,92552,76,329316
678,0.000649,172.31.40.0-255,66,92618,76,329316
679,0.000693,172.31.40.0-255,66,92684,76,329316
680,0.000727,74.125.200.0-255,1484,94168,76,329316
681,0.000748,74.125.200.0-255,1484,95652,76,329316
682,0.000751,172.31.40.0-255,66,95718,76,329316
683,0.000776,74.125.200.0-255,1484,97202,76,329316
684,0.000783,74.125.200.0-255,5738,102940,76,329316
685,0.000787,74.125.200.0-255,2902,105842,76,329316
686,0.000792,74.125.200.0-255,4320,110162,76,329316
687,0.000798,172.31.40.0-255,66,110228,76,329316
688,0.000806,172.31.40.0-255,66,110294,76,329316
689,0.000809,172.31.40.0-255,66,110360,76,329316
690,0.00082,74.125.200.0-255,7156,117516,76,329316
691,0.000823,172.31.40.0-255,66,117582,76,329316
692,0.000855,74.125.200.0-255,1484,119066,76,329316
693,0.000869,172.31.40.0-255,66,119132,76,329316
694,0.000893,74.125.200.0-255,1484,120616,76,329316
695,0.000907,74.125.200.0-255,2902,123518,76,329316
696,0.00091,172.31.40.0-255,66,123584,76,329316
697,0.00094,74.125.200.0-255,2902,126486,76,329316
698,0.000943,172.31.40.0-255,66,126552,76,329316
699,0.000947,74.125.200.0-255,2902,129454,76,329316
700,0.000949,172.31.40.0-255,66,129520,76,329316
701,0.000982,74.125.200.0-255,1484,131004,76,329316
702,0.000993,172.31.40.0-255,66,131070,76,329316
703,0.000996,74.125.200.0-255,2902,133972,76,329316
704,0.000998,172.31.40.0-255,66,134038,76,329316
705,0.001003,74.125.200.0-255,4320,138358,76,329316
706,0.00101,172.31.40.0-255,66,138424,76,329316
707,0.001033,74.125.200.0-255,6438,144862,76,329316
708,0.001035,172.31.40.0-255,66,144928,76,329316
709,0.001076,74.125.200.0-255,5738,150666,76,329316
710,0.001079,172.31.40.0-255,66,150732,76,329316
711,0.001133,74.125.200.0-255,7156,157888,76,329316
712,0.001135,172.31.40.0-255,66,157954,76,329316
713,0.001142,74.125.200.0-255,7156,165110,76,329316
714,0.001144,172.31.40.0-255,66,165176,76,329316
715,0.001168,74.125.200.0-255,1484,166660,76,329316
716,0.001179,172.31.40.0-255,66,166726,76,329316
717,0.001183,74.125.200.0-255,2184,168910,76,329316
718,0.001185,172.31.40.0-255,66,168976,76,329316
719,0.001435,74.125.200.0-255,1484,170460,76,329316
720,0.00144,74.125.200.0-255,2902,173362,76,329316
721,0.001443,172.31.40.0-255,66,173428,76,329316
722,0.001446,74.125.200.0-255,1484,174912,76,329316
723,0.001474,74.125.200.0-255,4320,179232,76,329316
724,0.001477,172.31.40.0-255,66,179298,76,329316
725,0.001482,74.125.200.0-255,4320,183618,76,329316
726,0.001483,172.31.40.0-255,66,183684,76,329316
727,0.001517,172.31.40.0-255,66,183750,76,329316
728,0.001542,74.125.200.0-255,4320,188070,76,329316
729,0.001544,172.31.40.0-255,66,188136,76,329316
730,0.001563,74.125.200.0-255,6438,194574,76,329316
731,0.001565,172.31.40.0-255,66,194640,76,329316
732,0.00159,74.125.200.0-255,7156,201796,76,329316
733,0.001593,172.31.40.0-255,66,201862,76,329316
734,0.001632,172.31.40.0-255,66,201928,76,329316
735,0.001656,172.31.40.0-255,66,201994,76,329316
736,0.001681,74.125.200.0-255,2902,204896,76,329316
737,0.001683,172.31.40.0-255,66,204962,76,329316
738,0.001687,74.125.200.0-255,2902,207864,76,329316
739,0.001689,172.31.40.0-255,66,207930,76,329316
740,0.001719,74.125.200.0-255,3602,211532,76,329316
741,0.001721,172.31.40.0-255,66,211598,76,329316
742,0.001724,74.125.200.0-255,1484,213082,76,329316
743,0.00175,74.125.200.0-255,5738,218820,76,329316
744,0.001752,172.31.40.0-255,66,218886,76,329316
745,0.001757,74.125.200.0-255,4320,223206,76,329316
746,0.001759,172.31.40.0-255,66,223272,76,329316
747,0.001761,74.125.200.0-255,1484,224756,76,329316
748,0.001799,172.31.40.0-255,66,224822,76,329316
749,0.001809,74.125.200.0-255,5738,230560,76,329316
750,0.001811,172.31.40.0-255,66,230626,76,329316
751,0.001834,74.125.200.0-255,2902,233528,76,329316
752,0.001836,172.31.40.0-255,66,233594,76,329316
753,0.001846,74.125.200.0-255,766,234360,76,329316
754,0.00193,74.125.200.0-255,1484,235844,76,329316
755,0.001935,172.31.40.0-255,66,235910,76,329316
756,0.001966,74.125.200.0-255,2902,238812,76,329316
757,0.001969,172.31.40.0-255,66,238878,76,329316
758,0.001989,74.125.200.0-255,5738,244616,76,329316
759,0.001992,172.31.40.0-255,66,244682,76,329316
760,0.002041,172.31.40.0-255,66,244748,76,329316
761,0.002062,172.31.40.0-255,66,244814,76,329316
762,0.002085,74.125.200.0-255,2184,246998,76,329316
763,0.002088,172.31.40.0-255,66,247064,76,329316
764,0.004081,74.125.200.0-255,2902,249966,76,329316
765,0.004088,172.31.40.0-255,66,250032,76,329316
766,0.004122,74.125.200.0-255,2902,252934,76,329316
767,0.004125,172.31.40.0-255,66,253000,76,329316
768,0.006114,74.125.200.0-255,2902,255902,76,329316
769,0.006121,172.31.40.0-255,66,255968,76,329316
770,0.00615,74.125.200.0-255,2902,258870,76,329316
771,0.006153,172.31.40.0-255,66,258936,76,329316
772,0.008149,74.125.200.0-255,2902,261838,76,329316
773,0.008156,172.31.40.0-255,66,261904,76,329316
774,0.008188,74.125.200.0-255,2902,264806,76,329316
775,0.00819,172.31.40.0-255,66,264872,76,329316
776,0.010191,74.125.200.0-255,2902,267774,76,329316
777,0.010194,172.31.40.0-255,66,267840,76,329316
778,0.010212,74.125.200.0-255,2902,270742,76,329316
779,0.010214,172.31.40.0-255,66,270808,76,329316
780,0.01222,74.125.200.0-255,5738,276546,76,329316
781,0.012227,172.31.40.0-255,66,276612,76,329316
782,0.014248,74.125.200.0-255,5738,282350,76,329316
783,0.014256,172.31.40.0-255,66,282416,76,329316
784,0.016275,74.125.200.0-255,5738,288154,76,329316
785,0.016283,172.31.40.0-255,66,288220,76,329316
786,0.018317,74.125.200.0-255,5738,293958,76,329316
787,0.018326,172.31.40.0-255,66,294024,76,329316
788,0.020355,74.125.200.0-255,5738,299762,76,329316
789,0.020361,172.31.40.0-255,66,299828,76,329316
790,0.022387,74.125.200.0-255,5738,305566,76,329316
791,0.022396,172.31.40.0-255,66,305632,76,329316
792,0.024412,74.125.200.0-255,5738,311370,76,329316
793,0.02442,172.31.40.0-255,66,311436,76,329316
794,0.02643,74.125.200.0-255,2902,314338,76,329316
795,0.026435,172.31.40.0-255,66,314404,76,329316
796,0.026452,74.125.200.0-255,2902,317306,76,329316
797,0.026455,172.31.40.0-255,66,317372,76,329316
798,0.028458,74.125.200.0-255,2902,320274,76,329316
799,0.028465,172.31.40.0-255,66,320340,76,329316
800,0.028494,74.125.200.0-255,2902,323242,76,329316
801,0.028497,172.31.40.0-255,66,323308,76,329316
802,0.030481,74.125.200.0-255,1471,324779,76,329316
803,0.030586,172.31.40.0-255,66,324845,76,329316
804,0.030617,172.31.40.0-255,105,324950,76,329316
805,0.031783,172.31.40.0-255,172,325122,76,329316
806,0.03181,172.31.40.0-255,1107,326229,76,329316
807,0.031861,172.31.40.0-255,1514,327743,76,329316
808,0.03188,172.31.40.0-255,1309,329052,76,329316
809,0.032611,74.125.200.0-255,66,329118,76,329316
810,0.033291,104.244.42.0-255,66,329184,76,329316
811,0.033428,104.244.42.0-255,66,329250,76,329316
812,0.03349,104.244.42.0-255,66,329316,76,329316
813,0.0,172.31.40.0-255,228,228,76,294
814,0.007377,172.217.194.0-255,66,294,76,294
815,0.0,172.217.194.0-255,153,153,76,207412
816,1.4e-05,172.31.40.0-255,66,219,76,207412
817,2.1e-05,172.217.194.0-255,1484,1703,76,207412
818,2.5e-05,172.31.40.0-255,66,1769,76,207412
819,3.1e-05,172.217.194.0-255,2902,4671,76,207412
820,4.4e-05,172.31.40.0-255,66,4737,76,207412
821,5.2e-05,172.217.194.0-255,5738,10475,76,207412
822,5.5e-05,172.31.40.0-255,66,10541,76,207412
823,9.6e-05,172.217.194.0-255,3507,14048,76,207412
824,9.9e-05,172.31.40.0-255,66,14114,76,207412
825,0.00018,172.217.194.0-255,1484,15598,76,207412
826,0.000184,172.31.40.0-255,66,15664,76,207412
827,0.000188,172.217.194.0-255,1484,17148,76,207412
828,0.00019,172.31.40.0-255,66,17214,76,207412
829,0.000211,172.217.194.0-255,1484,18698,76,207412
830,0.000214,172.31.40.0-255,66,18764,76,207412
831,0.00022,172.217.194.0-255,4320,23084,76,207412
832,0.000222,172.31.40.0-255,66,23150,76,207412
833,0.000254,172.217.194.0-255,1484,24634,76,207412
834,0.000257,172.31.40.0-255,66,24700,76,207412
835,0.000265,172.217.194.0-255,6797,31497,76,207412
836,0.000267,172.31.40.0-255,66,31563,76,207412
837,0.000317,172.217.194.0-255,7156,38719,76,207412
838,0.000321,172.31.40.0-255,66,38785,76,207412
839,0.000353,172.217.194.0-255,7156,45941,76,207412
840,0.000356,172.31.40.0-255,66,46007,76,207412
841,0.000381,172.31.40.0-255,66,46073,76,207412
842,0.000392,172.31.40.0-255,66,46139,76,207412
843,0.000415,172.217.194.0-255,2184,48323,76,207412
844,0.000418,172.31.40.0-255,66,48389,76,207412
845,0.000421,172.217.194.0-255,367,48756,76,207412
846,0.000424,172.217.194.0-255,375,49131,76,207412
847,0.000883,172.217.194.0-255,1484,50615,76,207412
848,0.000889,172.31.40.0-255,66,50681,76,207412
849,0.000895,172.217.194.0-255,2902,53583,76,207412
850,0.000897,172.31.40.0-255,66,53649,76,207412
851,0.000929,172.217.194.0-255,5738,59387,76,207412
852,0.000932,172.31.40.0-255,66,59453,76,207412
853,0.000968,172.31.40.0-255,66,59519,76,207412
854,0.001009,172.217.194.0-255,2902,62421,76,207412
855,0.001012,172.31.40.0-255,66,62487,76,207412
856,0.001029,172.31.40.0-255,66,62553,76,207412
857,0.001059,172.217.194.0-255,1484,64037,76,207412
858,0.001064,172.217.194.0-255,2902,66939,76,207412
859,0.001066,172.31.40.0-255,66,67005,76,207412
860,0.001069,172.217.194.0-255,1484,68489,76,207412
861,0.001101,172.217.194.0-255,4320,72809,76,207412
862,0.001103,172.31.40.0-255,66,72875,76,207412
863,0.001116,172.31.40.0-255,66,72941,76,207412
864,0.001155,172.217.194.0-255,2902,75843,76,207412
865,0.001158,172.31.40.0-255,66,75909,76,207412
866,0.001175,172.31.40.0-255,66,75975,76,207412
867,0.001982,172.217.194.0-255,1484,77459,76,207412
868,0.001993,172.217.194.0-255,2902,80361,76,207412
869,0.001997,172.31.40.0-255,66,80427,76,207412
870,0.002004,172.217.194.0-255,4320,84747,76,207412
871,0.002006,172.31.40.0-255,66,84813,76,207412
872,0.002034,172.217.194.0-255,1484,86297,76,207412
873,0.002042,172.217.194.0-255,7156,93453,76,207412
874,0.002045,172.31.40.0-255,66,93519,76,207412
875,0.002059,172.31.40.0-255,66,93585,76,207412
876,0.002063,172.217.194.0-255,2184,95769,76,207412
877,0.002066,172.31.40.0-255,66,95835,76,207412
878,0.002188,172.217.194.0-255,1484,97319,76,207412
879,0.002195,172.217.194.0-255,2902,100221,76,207412
880,0.002199,172.31.40.0-255,66,100287,76,207412
881,0.002204,172.217.194.0-255,2902,103189,76,207412
882,0.002206,172.31.40.0-255,66,103255,76,207412
883,0.002229,172.217.194.0-255,2902,106157,76,207412
884,0.002231,172.31.40.0-255,66,106223,76,207412
885,0.002236,172.217.194.0-255,4320,110543,76,207412
886,0.002238,172.31.40.0-255,66,110609,76,207412
887,0.002284,172.31.40.0-255,66,110675,76,207412
888,0.002296,172.31.40.0-255,66,110741,76,207412
889,0.002314,172.217.194.0-255,766,111507,76,207412
890,0.002426,172.217.194.0-255,1484,112991,76,207412
891,0.00243,172.31.40.0-255,66,113057,76,207412
892,0.002437,172.217.194.0-255,2902,115959,76,207412
893,0.00244,172.31.40.0-255,66,116025,76,207412
894,0.002451,172.217.194.0-255,5738,121763,76,207412
895,0.002453,172.31.40.0-255,66,121829,76,207412
896,0.002456,172.217.194.0-255,1484,123313,76,207412
897,0.002461,172.217.194.0-255,2902,126215,76,207412
898,0.002463,172.31.40.0-255,66,126281,76,207412
899,0.002491,172.217.194.0-255,2902,129183,76,207412
900,0.002494,172.31.40.0-255,66,129249,76,207412
901,0.002514,172.217.194.0-255,4320,133569,76,207412
902,0.002517,172.31.40.0-255,66,133635,76,207412
903,0.002547,172.217.194.0-255,5738,139373,76,207412
904,0.00255,172.31.40.0-255,66,139439,76,207412
905,0.002553,172.217.194.0-255,1484,140923,76,207412
906,0.002559,172.217.194.0-255,5020,145943,76,207412
907,0.002562,172.31.40.0-255,66,146009,76,207412
908,0.002646,172.217.194.0-255,1484,147493,76,207412
909,0.002667,172.217.194.0-255,2902,150395,76,207412
910,0.002671,172.31.40.0-255,66,150461,76,207412
911,0.002678,172.217.194.0-255,5738,156199,76,207412
912,0.002681,172.31.40.0-255,66,156265,76,207412
913,0.002697,172.217.194.0-255,5738,162003,76,207412
914,0.0027,172.31.40.0-255,66,162069,76,207412
915,0.002703,172.217.194.0-255,1484,163553,76,207412
916,0.002708,172.217.194.0-255,5738,169291,76,207412
917,0.002711,172.31.40.0-255,66,169357,76,207412
918,0.002748,172.31.40.0-255,66,169423,76,207412
919,0.002786,172.217.194.0-255,4320,173743,76,207412
920,0.002788,172.31.40.0-255,66,173809,76,207412
921,0.002844,172.217.194.0-255,7156,180965,76,207412
922,0.002847,172.31.40.0-255,66,181031,76,207412
923,0.002851,172.217.194.0-255,2902,183933,76,207412
924,0.002853,172.31.40.0-255,66,183999,76,207412
925,0.002869,172.31.40.0-255,66,184065,76,207412
926,0.00288,172.31.40.0-255,66,184131,76,207412
927,0.002892,172.31.40.0-255,66,184197,76,207412
928,0.002909,172.31.40.0-255,66,184263,76,207412
929,0.002912,172.217.194.0-255,766,185029,76,207412
930,0.002917,172.217.194.0-255,4320,189349,76,207412
931,0.00292,172.31.40.0-255,66,189415,76,207412
932,0.002925,172.217.194.0-255,5738,195153,76,207412
933,0.002928,172.31.40.0-255,66,195219,76,207412
934,0.002984,172.31.40.0-255,66,195285,76,207412
935,0.002997,172.31.40.0-255,66,195351,76,207412
936,0.003,172.217.194.0-255,1484,196835,76,207412
937,0.003007,172.217.194.0-255,5738,202573,76,207412
938,0.003009,172.31.40.0-255,66,202639,76,207412
939,0.003057,172.31.40.0-255,66,202705,76,207412
940,0.003084,172.31.40.0-255,66,202771,76,207412
941,0.003087,172.217.194.0-255,105,202876,76,207412
942,0.006976,172.31.40.0-255,66,202942,76,207412
943,0.007016,172.31.40.0-255,105,203047,76,207412
944,0.009472,172.217.194.0-255,66,203113,76,207412
945,0.031304,172.31.40.0-255,171,203284,76,207412
946,0.031334,172.31.40.0-255,1129,204413,76,207412
947,0.031392,172.31.40.0-255,1514,205927,76,207412
948,0.031394,172.31.40.0-255,1287,207214,76,207412
949,0.032996,104.244.42.0-255,66,207280,76,207412
950,0.033027,104.244.42.0-255,66,207346,76,207412
951,0.033103,104.244.42.0-255,66,207412,76,207412
952,0.0,74.125.68.0-255,152,152,76,365321
953,1.3e-05,172.31.40.0-255,66,218,76,365321
954,2e-05,74.125.68.0-255,1484,1702,76,365321
955,2.5e-05,172.31.40.0-255,66,1768,76,365321
956,5.2e-05,74.125.68.0-255,2902,4670,76,365321
957,5.5e-05,172.31.40.0-255,66,4736,76,365321
958,9.2e-05,74.125.68.0-255,7156,11892,76,365321
959,9.5e-05,172.31.40.0-255,66,11958,76,365321
960,0.0001,74.125.68.0-255,2063,14021,76,365321
961,0.000102,172.31.40.0-255,66,14087,76,365321
962,0.000107,74.125.68.0-255,2902,16989,76,365321
963,0.000109,172.31.40.0-255,66,17055,76,365321
964,0.000121,74.125.68.0-255,7156,24211,76,365321
965,0.000124,172.31.40.0-255,66,24277,76,365321
966,0.000131,74.125.68.0-255,6797,31074,76,365321
967,0.000134,172.31.40.0-255,66,31140,76,365321
968,0.00051,74.125.68.0-255,1484,32624,76,365321
969,0.000516,172.31.40.0-255,66,32690,76,365321
970,0.000523,74.125.68.0-255,2902,35592,76,365321
971,0.000525,172.31.40.0-255,66,35658,76,365321
972,0.000545,74.125.68.0-255,1484,37142,76,365321
973,0.000566,172.31.40.0-255,66,37208,76,365321
974,0.000575,74.125.68.0-255,2902,40110,76,365321
975,0.000578,172.31.40.0-255,66,40176,76,365321
976,0.000588,74.125.68.0-255,5738,45914,76,365321
977,0.000591,172.31.40.0-255,66,45980,76,365321
978,0.000595,74.125.68.0-255,2543,48523,76,365321
979,0.000597,172.31.40.0-255,66,48589,76,365321
980,0.0006,74.125.68.0-255,1484,50073,76,365321
981,0.000602,172.31.40.0-255,66,50139,76,365321
982,0.000632,74.125.68.0-255,1484,51623,76,365321
983,0.000635,172.31.40.0-255,66,51689,76,365321
984,0.000643,74.125.68.0-255,7156,58845,76,365321
985,0.000646,172.31.40.0-255,66,58911,76,365321
986,0.000655,74.125.68.0-255,4320,63231,76,365321
987,0.000657,172.31.40.0-255,66,63297,76,365321
988,0.000682,74.125.68.0-255,2543,65840,76,365321
989,0.000684,172.31.40.0-255,66,65906,76,365321
990,0.000921,74.125.68.0-255,645,66551,76,365321
991,0.001082,172.31.40.0-255,66,66617,76,365321
992,0.001206,74.125.68.0-255,1484,68101,76,365321
993,0.001215,74.125.68.0-255,2902,71003,76,365321
994,0.001219,172.31.40.0-255,66,71069,76,365321
995,0.001225,74.125.68.0-255,2902,73971,76,365321
996,0.001227,172.31.40.0-255,66,74037,76,365321
997,0.00126,74.125.68.0-255,2902,76939,76,365321
998,0.001262,172.31.40.0-255,66,77005,76,365321
999,0.001273,172.31.40.0-255,66,77071,76,365321
1000,0.001289,172.31.40.0-255,66,77137,76,365321
1001,0.001321,74.125.68.0-255,1484,78621,76,365321
1002,0.001328,74.125.68.0-255,5020,83641,76,365321
1003,0.00133,172.31.40.0-255,66,83707,76,365321
1004,0.002014,74.125.68.0-255,1484,85191,76,365321
1005,0.002023,74.125.68.0-255,2902,88093,76,365321
1006,0.002029,172.31.40.0-255,66,88159,76,365321
1007,0.002035,74.125.68.0-255,2902,91061,76,365321
1008,0.002037,172.31.40.0-255,66,91127,76,365321
1009,0.002064,74.125.68.0-255,2902,94029,76,365321
1010,0.002066,172.31.40.0-255,66,94095,76,365321
1011,0.002072,74.125.68.0-255,4320,98415,76,365321
1012,0.002074,172.31.40.0-255,66,98481,76,365321
1013,0.002085,74.125.68.0-255,5738,104219,76,365321
1014,0.002087,172.31.40.0-255,66,104285,76,365321
1015,0.00212,74.125.68.0-255,5738,110023,76,365321
1016,0.002123,172.31.40.0-255,66,110089,76,365321
1017,0.002145,74.125.68.0-255,1484,111573,76,365321
1018,0.002161,74.125.68.0-255,5738,117311,76,365321
1019,0.002164,172.31.40.0-255,66,117377,76,365321
1020,0.002185,74.125.68.0-255,766,118143,76,365321
1021,0.002313,74.125.68.0-255,1484,119627,76,365321
1022,0.002315,172.31.40.0-255,66,119693,76,365321
1023,0.00234,74.125.68.0-255,2902,122595,76,365321
1024,0.002343,172.31.40.0-255,66,122661,76,365321
1025,0.002367,74.125.68.0-255,2902,125563,76,365321
1026,0.002369,172.31.40.0-255,66,125629,76,365321
1027,0.004665,74.125.68.0-255,2902,128531,76,365321
1028,0.004669,172.31.40.0-255,66,128597,76,365321
1029,0.004698,74.125.68.0-255,2902,131499,76,365321
1030,0.004701,172.31.40.0-255,66,131565,76,365321
1031,0.007019,74.125.68.0-255,5738,137303,76,365321
1032,0.007025,172.31.40.0-255,66,137369,76,365321
1033,0.009371,74.125.68.0-255,5738,143107,76,365321
1034,0.009379,172.31.40.0-255,66,143173,76,365321
1035,0.011726,74.125.68.0-255,5738,148911,76,365321
1036,0.011735,172.31.40.0-255,66,148977,76,365321
1037,0.014087,74.125.68.0-255,5738,154715,76,365321
1038,0.014098,172.31.40.0-255,66,154781,76,365321
1039,0.016467,74.125.68.0-255,5738,160519,76,365321
1040,0.016472,172.31.40.0-255,66,160585,76,365321
1041,0.018808,74.125.68.0-255,5738,166323,76,365321
1042,0.018815,172.31.40.0-255,66,166389,76,365321
1043,0.021153,74.125.68.0-255,5738,172127,76,365321
1044,0.021162,172.31.40.0-255,66,172193,76,365321
1045,0.023495,74.125.68.0-255,4320,176513,76,365321
1046,0.023501,172.31.40.0-255,66,176579,76,365321
1047,0.023528,74.125.68.0-255,1484,178063,76,365321
1048,0.025841,74.125.68.0-255,4320,182383,76,365321
1049,0.025849,172.31.40.0-255,66,182449,76,365321
1050,0.02701,172.31.40.0-255,172,182621,76,365321
1051,0.027043,172.31.40.0-255,1107,183728,76,365321
1052,0.027101,172.31.40.0-255,1514,185242,76,365321
1053,0.027103,172.31.40.0-255,1309,186551,76,365321
1054,0.028209,74.125.68.0-255,5738,192289,76,365321
1055,0.028217,172.31.40.0-255,66,192355,76,365321
1056,0.028551,104.244.42.0-255,66,192421,76,365321
1057,0.028595,104.244.42.0-255,66,192487,76,365321
1058,0.028652,104.244.42.0-255,66,192553,76,365321
1059,0.030565,74.125.68.0-255,5738,198291,76,365321
1060,0.030572,172.31.40.0-255,66,198357,76,365321
1061,0.032959,74.125.68.0-255,5738,204095,76,365321
1062,0.032966,172.31.40.0-255,66,204161,76,365321
1063,0.035317,74.125.68.0-255,5738,209899,76,365321
1064,0.035323,172.31.40.0-255,66,209965,76,365321
1065,0.037677,74.125.68.0-255,5738,215703,76,365321
1066,0.037684,172.31.40.0-255,66,215769,76,365321
1067,0.040042,74.125.68.0-255,5738,221507,76,365321
1068,0.040049,172.31.40.0-255,66,221573,76,365321
1069,0.042406,74.125.68.0-255,5738,227311,76,365321
1070,0.042412,172.31.40.0-255,66,227377,76,365321
1071,0.04476,74.125.68.0-255,5738,233115,76,365321
1072,0.044767,172.31.40.0-255,66,233181,76,365321
1073,0.047129,74.125.68.0-255,5738,238919,76,365321
1074,0.047149,172.31.40.0-255,66,238985,76,365321
1075,0.0495,74.125.68.0-255,5738,244723,76,365321
1076,0.049508,172.31.40.0-255,66,244789,76,365321
1077,0.051849,74.125.68.0-255,4320,249109,76,365321
1078,0.051853,172.31.40.0-255,66,249175,76,365321
1079,0.051879,74.125.68.0-255,1484,250659,76,365321
1080,0.054195,74.125.68.0-255,4320,254979,76,365321
1081,0.054201,172.31.40.0-255,66,255045,76,365321
1082,0.056552,74.125.68.0-255,5738,260783,76,365321
1083,0.056559,172.31.40.0-255,66,260849,76,365321
1084,0.058914,74.125.68.0-255,5738,266587,76,365321
1085,0.058921,172.31.40.0-255,66,266653,76,365321
1086,0.061257,74.125.68.0-255,5738,272391,76,365321
1087,0.061262,172.31.40.0-255,66,272457,76,365321
1088,0.063629,74.125.68.0-255,5738,278195,76,365321
1089,0.063636,172.31.40.0-255,66,278261,76,365321
1090,0.065978,74.125.68.0-255,5738,283999,76,365321
1091,0.065985,172.31.40.0-255,66,284065,76,365321
1092,0.068334,74.125.68.0-255,5738,289803,76,365321
1093,0.06834,172.31.40.0-255,66,289869,76,365321
1094,0.070682,74.125.68.0-255,5738,295607,76,365321
1095,0.070689,172.31.40.0-255,66,295673,76,365321
1096,0.073044,74.125.68.0-255,5738,301411,76,365321
1097,0.073051,172.31.40.0-255,66,301477,76,365321
1098,0.075406,74.125.68.0-255,5738,307215,76,365321
1099,0.075413,172.31.40.0-255,66,307281,76,365321
1100,0.077771,74.125.68.0-255,5738,313019,76,365321
1101,0.077778,172.31.40.0-255,66,313085,76,365321
1102,0.080133,74.125.68.0-255,5738,318823,76,365321
1103,0.080138,172.31.40.0-255,66,318889,76,365321
1104,0.082502,74.125.68.0-255,5738,324627,76,365321
1105,0.082509,172.31.40.0-255,66,324693,76,365321
1106,0.084868,74.125.68.0-255,5738,330431,76,365321
1107,0.084875,172.31.40.0-255,66,330497,76,365321
1108,0.087221,74.125.68.0-255,5738,336235,76,365321
1109,0.087227,172.31.40.0-255,66,336301,76,365321
1110,0.089609,74.125.68.0-255,5738,342039,76,365321
1111,0.089619,172.31.40.0-255,66,342105,76,365321
1112,0.091983,74.125.68.0-255,5738,347843,76,365321
1113,0.091989,172.31.40.0-255,66,347909,76,365321
1114,0.094346,74.125.68.0-255,5738,353647,76,365321
1115,0.094353,172.31.40.0-255,66,353713,76,365321
1116,0.096695,74.125.68.0-255,5738,359451,76,365321
1117,0.096701,172.31.40.0-255,66,359517,76,365321
1118,0.099034,74.125.68.0-255,5738,365255,76,365321
1119,0.099042,172.31.40.0-255,66,365321,76,365321
1120,0.0,172.217.194.0-255,152,152,76,357253
1121,2.3e-05,172.31.40.0-255,66,218,76,357253
1122,3e-05,172.217.194.0-255,1484,1702,76,357253
1123,3.5e-05,172.31.40.0-255,66,1768,76,357253
1124,6.9e-05,172.217.194.0-255,1484,3252,76,357253
1125,7.2e-05,172.31.40.0-255,66,3318,76,357253
1126,7.8e-05,172.217.194.0-255,2902,6220,76,357253
1127,8e-05,172.31.40.0-255,66,6286,76,357253
1128,8.7e-05,172.217.194.0-255,5738,12024,76,357253
1129,9e-05,172.31.40.0-255,66,12090,76,357253
1130,9.4e-05,172.217.194.0-255,2165,14255,76,357253
1131,9.7e-05,172.31.40.0-255,66,14321,76,357253
1132,0.000159,172.217.194.0-255,1484,15805,76,357253
1133,0.000162,172.31.40.0-255,66,15871,76,357253
1134,0.000184,172.217.194.0-255,2902,18773,76,357253
1135,0.000187,172.31.40.0-255,66,18839,76,357253
1136,0.000194,172.217.194.0-255,5738,24577,76,357253
1137,0.000196,172.31.40.0-255,66,24643,76,357253
1138,0.000241,172.217.194.0-255,6797,31440,76,357253
1139,0.000244,172.31.40.0-255,66,31506,76,357253
1140,0.000292,172.217.194.0-255,7156,38662,76,357253
1141,0.000296,172.31.40.0-255,66,38728,76,357253
1142,0.0003,172.217.194.0-255,2902,41630,76,357253
1143,0.000302,172.31.40.0-255,66,41696,76,357253
1144,0.000341,172.217.194.0-255,6797,48493,76,357253
1145,0.000345,172.31.40.0-255,66,48559,76,357253
1146,0.000389,172.217.194.0-255,1484,50043,76,357253
1147,0.000391,172.31.40.0-255,66,50109,76,357253
1148,0.000395,172.217.194.0-255,1484,51593,76,357253
1149,0.000397,172.31.40.0-255,66,51659,76,357253
1150,0.000418,172.217.194.0-255,1484,53143,76,357253
1151,0.00042,172.31.40.0-255,66,53209,76,357253
1152,0.000427,172.217.194.0-255,5738,58947,76,357253
1153,0.000429,172.31.40.0-255,66,59013,76,357253
1154,0.000432,172.217.194.0-255,1484,60497,76,357253
1155,0.00046,172.217.194.0-255,5673,66170,76,357253
1156,0.000462,172.31.40.0-255,66,66236,76,357253
1157,0.000465,172.217.194.0-255,382,66618,76,357253
1158,0.000672,172.217.194.0-255,1484,68102,76,357253
1159,0.000677,172.31.40.0-255,66,68168,76,357253
1160,0.000683,172.217.194.0-255,2902,71070,76,357253
1161,0.000685,172.31.40.0-255,66,71136,76,357253
1162,0.000718,172.217.194.0-255,5738,76874,76,357253
1163,0.000721,172.31.40.0-255,66,76940,76,357253
1164,0.000727,172.217.194.0-255,4320,81260,76,357253
1165,0.000729,172.31.40.0-255,66,81326,76,357253
1166,0.000756,172.217.194.0-255,6797,88123,76,357253
1167,0.000759,172.31.40.0-255,66,88189,76,357253
1168,0.000771,172.31.40.0-255,66,88255,76,357253
1169,0.000802,172.217.194.0-255,2543,90798,76,357253
1170,0.000804,172.31.40.0-255,66,90864,76,357253
1171,0.001399,172.217.194.0-255,1484,92348,76,357253
1172,0.001406,172.217.194.0-255,2902,95250,76,357253
1173,0.001411,172.31.40.0-255,66,95316,76,357253
1174,0.001415,172.217.194.0-255,1484,96800,76,357253
1175,0.001446,172.217.194.0-255,4320,101120,76,357253
1176,0.001448,172.31.40.0-255,66,101186,76,357253
1177,0.001483,172.31.40.0-255,66,101252,76,357253
1178,0.001513,172.217.194.0-255,4320,105572,76,357253
1179,0.001515,172.31.40.0-255,66,105638,76,357253
1180,0.001529,172.31.40.0-255,66,105704,76,357253
1181,0.001532,172.217.194.0-255,1484,107188,76,357253
1182,0.001536,172.217.194.0-255,2902,110090,76,357253
1183,0.001539,172.31.40.0-255,66,110156,76,357253
1184,0.001545,172.217.194.0-255,5738,115894,76,357253
1185,0.001547,172.31.40.0-255,66,115960,76,357253
1186,0.001586,172.217.194.0-255,5738,121698,76,357253
1187,0.001588,172.31.40.0-255,66,121764,76,357253
1188,0.001626,172.217.194.0-255,7156,128920,76,357253
1189,0.001629,172.31.40.0-255,66,128986,76,357253
1190,0.001641,172.31.40.0-255,66,129052,76,357253
1191,0.001643,172.217.194.0-255,766,129818,76,357253
1192,0.00242,172.217.194.0-255,1484,131302,76,357253
1193,0.002426,172.217.194.0-255,1484,132786,76,357253
1194,0.002438,172.217.194.0-255,1484,134270,76,357253
1195,0.002443,172.217.194.0-255,2902,137172,76,357253
1196,0.00246,172.217.194.0-255,2902,140074,76,357253
1197,0.00248,172.217.194.0-255,7156,147230,76,357253
1198,0.002505,172.217.194.0-255,5738,152968,76,357253
1199,0.002517,172.217.194.0-255,766,153734,76,357253
1200,0.002545,172.217.194.0-255,1484,155218,76,357253
1201,0.002549,172.217.194.0-255,2902,158120,76,357253
1202,0.002558,172.217.194.0-255,1484,159604,76,357253
1203,0.002588,172.217.194.0-255,2902,162506,76,357253
1204,0.002608,172.217.194.0-255,7156,169662,76,357253
1205,0.002636,172.217.194.0-255,1484,171146,76,357253
1206,0.002664,172.217.194.0-255,6438,177584,76,357253
1207,0.004112,172.31.40.0-255,66,177650,76,357253
1208,0.006755,172.217.194.0-255,2902,180552,76,357253
1209,0.006761,172.31.40.0-255,66,180618,76,357253
1210,0.00678,172.217.194.0-255,2902,183520,76,357253
1211,0.006782,172.31.40.0-255,66,183586,76,357253
1212,0.009382,172.217.194.0-255,5738,189324,76,357253
1213,0.009389,172.31.40.0-255,66,189390,76,357253
1214,0.012034,172.217.194.0-255,5738,195128,76,357253
1215,0.012046,172.31.40.0-255,66,195194,76,357253
1216,0.014685,172.217.194.0-255,5738,200932,76,357253
1217,0.014704,172.31.40.0-255,66,200998,76,357253
1218,0.017328,172.217.194.0-255,5738,206736,76,357253
1219,0.017342,172.31.40.0-255,66,206802,76,357253
1220,0.019999,172.217.194.0-255,5738,212540,76,357253
1221,0.020015,172.31.40.0-255,66,212606,76,357253
1222,0.022622,172.217.194.0-255,5738,218344,76,357253
1223,0.022631,172.31.40.0-255,66,218410,76,357253
1224,0.025324,172.217.194.0-255,5738,224148,76,357253
1225,0.02534,172.31.40.0-255,66,224214,76,357253
1226,0.027966,172.217.194.0-255,5738,229952,76,357253
1227,0.027975,172.31.40.0-255,66,230018,76,357253
1228,0.030582,172.217.194.0-255,5738,235756,76,357253
1229,0.030589,172.31.40.0-255,66,235822,76,357253
1230,0.033217,172.217.194.0-255,5738,241560,76,357253
1231,0.033225,172.31.40.0-255,66,241626,76,357253
1232,0.034934,172.31.40.0-255,172,241798,76,357253
1233,0.034966,172.31.40.0-255,1104,242902,76,357253
1234,0.035025,172.31.40.0-255,1514,244416,76,357253
1235,0.035027,172.31.40.0-255,345,244761,76,357253
1236,0.03586,172.217.194.0-255,5738,250499,76,357253
1237,0.035867,172.31.40.0-255,66,250565,76,357253
1238,0.036564,104.244.42.0-255,66,250631,76,357253
1239,0.036592,104.244.42.0-255,66,250697,76,357253
1240,0.036611,104.244.42.0-255,66,250763,76,357253
1241,0.038473,172.217.194.0-255,5738,256501,76,357253
1242,0.038482,172.31.40.0-255,66,256567,76,357253
1243,0.041105,172.217.194.0-255,5738,262305,76,357253
1244,0.041112,172.31.40.0-255,66,262371,76,357253
1245,0.043746,172.217.194.0-255,5738,268109,76,357253
1246,0.043753,172.31.40.0-255,66,268175,76,357253
1247,0.046361,172.217.194.0-255,5738,273913,76,357253
1248,0.046368,172.31.40.0-255,66,273979,76,357253
1249,0.049034,172.217.194.0-255,5738,279717,76,357253
1250,0.049043,172.31.40.0-255,66,279783,76,357253
1251,0.051669,172.217.194.0-255,5738,285521,76,357253
1252,0.051677,172.31.40.0-255,66,285587,76,357253
1253,0.054318,172.217.194.0-255,5738,291325,76,357253
1254,0.054325,172.31.40.0-255,66,291391,76,357253
1255,0.056936,172.217.194.0-255,5738,297129,76,357253
1256,0.056944,172.31.40.0-255,66,297195,76,357253
1257,0.059571,172.217.194.0-255,5738,302933,76,357253
1258,0.059577,172.31.40.0-255,66,302999,76,357253
1259,0.062246,172.217.194.0-255,5738,308737,76,357253
1260,0.062253,172.31.40.0-255,66,308803,76,357253
1261,0.06492,172.217.194.0-255,5738,314541,76,357253
1262,0.064927,172.31.40.0-255,66,314607,76,357253
1263,0.067553,172.217.194.0-255,5738,320345,76,357253
1264,0.06756,172.31.40.0-255,66,320411,76,357253
1265,0.070191,172.217.194.0-255,5738,326149,76,357253
1266,0.070198,172.31.40.0-255,66,326215,76,357253
1267,0.07284,172.217.194.0-255,5738,331953,76,357253
1268,0.072849,172.31.40.0-255,66,332019,76,357253
1269,0.075465,172.217.194.0-255,5738,337757,76,357253
1270,0.075472,172.31.40.0-255,66,337823,76,357253
1271,0.078112,172.217.194.0-255,5738,343561,76,357253
1272,0.078119,172.31.40.0-255,66,343627,76,357253
1273,0.080749,172.217.194.0-255,5738,349365,76,357253
1274,0.080757,172.31.40.0-255,66,349431,76,357253
1275,0.083396,172.217.194.0-255,5738,355169,76,357253
1276,0.083403,172.31.40.0-255,66,355235,76,357253
1277,0.086023,172.217.194.0-255,1781,357016,76,357253
1278,0.08603,172.31.40.0-255,66,357082,76,357253
1279,0.086215,172.31.40.0-255,105,357187,76,357253
1280,0.088832,172.217.194.0-255,66,357253,76,357253
1281,0.0,74.125.68.0-255,146,146,76,392511
1282,2e-05,172.31.40.0-255,66,212,76,392511
1283,6.7e-05,74.125.68.0-255,1484,1696,76,392511
1284,7.2e-05,172.31.40.0-255,66,1762,76,392511
1285,7.5e-05,74.125.68.0-255,1484,3246,76,392511
1286,7.8e-05,172.31.40.0-255,66,3312,76,392511
1287,8.5e-05,74.125.68.0-255,2902,6214,76,392511
1288,8.7e-05,172.31.40.0-255,66,6280,76,392511
1289,0.000119,74.125.68.0-255,5738,12018,76,392511
1290,0.000121,172.31.40.0-255,66,12084,76,392511
1291,0.000126,74.125.68.0-255,2902,14986,76,392511
1292,0.000128,172.31.40.0-255,66,15052,76,392511
1293,0.000143,74.125.68.0-255,2101,17153,76,392511
1294,0.000145,172.31.40.0-255,66,17219,76,392511
1295,0.000153,74.125.68.0-255,5738,22957,76,392511
1296,0.000155,172.31.40.0-255,66,23023,76,392511
1297,0.000203,172.31.40.0-255,66,23089,76,392511
1298,0.000286,74.125.68.0-255,1484,24573,76,392511
1299,0.000288,172.31.40.0-255,66,24639,76,392511
1300,0.000302,74.125.68.0-255,2902,27541,76,392511
1301,0.000304,172.31.40.0-255,66,27607,76,392511
1302,0.000321,74.125.68.0-255,2902,30509,76,392511
1303,0.000324,172.31.40.0-255,66,30575,76,392511
1304,0.000345,74.125.68.0-255,2902,33477,76,392511
1305,0.000348,172.31.40.0-255,66,33543,76,392511
1306,0.000356,74.125.68.0-255,6797,40340,76,392511
1307,0.000358,172.31.40.0-255,66,40406,76,392511
1308,0.000398,172.31.40.0-255,66,40472,76,392511
1309,0.000431,74.125.68.0-255,4320,44792,76,392511
1310,0.000434,172.31.40.0-255,66,44858,76,392511
1311,0.000457,74.125.68.0-255,4317,49175,76,392511
1312,0.000461,172.31.40.0-255,66,49241,76,392511
1313,0.000579,74.125.68.0-255,331,49572,76,392511
1314,0.000775,74.125.68.0-255,1484,51056,76,392511
1315,0.000779,172.31.40.0-255,66,51122,76,392511
1316,0.000793,74.125.68.0-255,2902,54024,76,392511
1317,0.000796,172.31.40.0-255,66,54090,76,392511
1318,0.000817,74.125.68.0-255,4320,58410,76,392511
1319,0.00082,172.31.40.0-255,66,58476,76,392511
1320,0.000844,74.125.68.0-255,5738,64214,76,392511
1321,0.000847,172.31.40.0-255,66,64280,76,392511
1322,0.000851,74.125.68.0-255,2543,66823,76,392511
1323,0.000853,172.31.40.0-255,66,66889,76,392511
1324,0.000903,74.125.68.0-255,2902,69791,76,392511
1325,0.000906,172.31.40.0-255,66,69857,76,392511
1326,0.000926,74.125.68.0-255,4320,74177,76,392511
1327,0.000928,172.31.40.0-255,66,74243,76,392511
1328,0.000949,74.125.68.0-255,4320,78563,76,392511
1329,0.000952,172.31.40.0-255,66,78629,76,392511
1330,0.000966,74.125.68.0-255,4320,82949,76,392511
1331,0.000969,172.31.40.0-255,66,83015,76,392511
1332,0.000972,74.125.68.0-255,1125,84140,76,392511
1333,0.00138,74.125.68.0-255,1484,85624,76,392511
1334,0.001387,172.31.40.0-255,66,85690,76,392511
1335,0.001392,74.125.68.0-255,1484,87174,76,392511
1336,0.001409,74.125.68.0-255,2902,90076,76,392511
1337,0.001412,172.31.40.0-255,66,90142,76,392511
1338,0.001432,74.125.68.0-255,2902,93044,76,392511
1339,0.001435,172.31.40.0-255,66,93110,76,392511
1340,0.001457,74.125.68.0-255,2902,96012,76,392511
1341,0.001459,172.31.40.0-255,66,96078,76,392511
1342,0.001464,74.125.68.0-255,2902,98980,76,392511
1343,0.001466,172.31.40.0-255,66,99046,76,392511
1344,0.001471,74.125.68.0-255,4320,103366,76,392511
1345,0.001502,74.125.68.0-255,4320,107686,76,392511
1346,0.001505,172.31.40.0-255,66,107752,76,392511
1347,0.001515,74.125.68.0-255,2902,110654,76,392511
1348,0.00152,172.31.40.0-255,66,110720,76,392511
1349,0.00155,74.125.68.0-255,1484,112204,76,392511
1350,0.001574,74.125.68.0-255,6438,118642,76,392511
1351,0.001583,172.31.40.0-255,66,118708,76,392511
1352,0.001654,74.125.68.0-255,1484,120192,76,392511
1353,0.001679,74.125.68.0-255,2902,123094,76,392511
1354,0.001682,172.31.40.0-255,66,123160,76,392511
1355,0.001688,74.125.68.0-255,4320,127480,76,392511
1356,0.001706,74.125.68.0-255,1484,128964,76,392511
1357,0.00171,74.125.68.0-255,2902,131866,76,392511
1358,0.001714,74.125.68.0-255,4320,136186,76,392511
1359,0.001718,172.31.40.0-255,66,136252,76,392511
1360,0.001724,172.31.40.0-255,66,136318,76,392511
1361,0.001744,74.125.68.0-255,1484,137802,76,392511
1362,0.001758,74.125.68.0-255,5738,143540,76,392511
1363,0.001769,172.31.40.0-255,66,143606,76,392511
1364,0.001792,74.125.68.0-255,7156,150762,76,392511
1365,0.00181,172.31.40.0-255,66,150828,76,392511
1366,0.001813,74.125.68.0-255,1484,152312,76,392511
1367,0.001815,74.125.68.0-255,766,153078,76,392511
1368,0.00182,172.31.40.0-255,66,153144,76,392511
1369,0.00187,74.125.68.0-255,1484,154628,76,392511
1370,0.001881,74.125.68.0-255,1484,156112,76,392511
1371,0.001894,74.125.68.0-255,1484,157596,76,392511
1372,0.001897,74.125.68.0-255,1484,159080,76,392511
1373,0.00191,74.125.68.0-255,1484,160564,76,392511
1374,0.001915,172.31.40.0-255,66,160630,76,392511
1375,0.001922,74.125.68.0-255,1484,162114,76,392511
1376,0.001956,74.125.68.0-255,5738,167852,76,392511
1377,0.00196,74.125.68.0-255,1484,169336,76,392511
1378,0.001978,74.125.68.0-255,2902,172238,76,392511
1379,0.002,74.125.68.0-255,4320,176558,76,392511
1380,0.002014,74.125.68.0-255,1484,178042,76,392511
1381,0.002016,74.125.68.0-255,1484,179526,76,392511
1382,0.002065,74.125.68.0-255,4320,183846,76,392511
1383,0.00208,74.125.68.0-255,3602,187448,76,392511
1384,0.002135,74.125.68.0-255,1484,188932,76,392511
1385,0.002164,74.125.68.0-255,2902,191834,76,392511
1386,0.002195,74.125.68.0-255,4320,196154,76,392511
1387,0.002209,74.125.68.0-255,1484,197638,76,392511
1388,0.002229,74.125.68.0-255,2902,200540,76,392511
1389,0.002249,74.125.68.0-255,5738,206278,76,392511
1390,0.002315,74.125.68.0-255,6438,212716,76,392511
1391,0.005986,172.31.40.0-255,66,212782,76,392511
1392,0.006124,172.31.40.0-255,101,212883,76,392511
1393,0.008297,74.125.68.0-255,5738,218621,76,392511
1394,0.008303,172.31.40.0-255,66,218687,76,392511
1395,0.008376,74.125.68.0-255,66,218753,76,392511
1396,0.010589,74.125.68.0-255,5738,224491,76,392511
1397,0.010596,172.31.40.0-255,66,224557,76,392511
1398,0.012893,74.125.68.0-255,5738,230295,76,392511
1399,0.0129,172.31.40.0-255,66,230361,76,392511
1400,0.015202,74.125.68.0-255,5738,236099,76,392511
1401,0.01522,172.31.40.0-255,66,236165,76,392511
1402,0.017552,74.125.68.0-255,5738,241903,76,392511
1403,0.017566,172.31.40.0-255,66,241969,76,392511
1404,0.019864,74.125.68.0-255,5738,247707,76,392511
1405,0.019873,172.31.40.0-255,66,247773,76,392511
1406,0.022156,74.125.68.0-255,5738,253511,76,392511
1407,0.022163,172.31.40.0-255,66,253577,76,392511
1408,0.024478,74.125.68.0-255,5738,259315,76,392511
1409,0.024493,172.31.40.0-255,66,259381,76,392511
1410,0.026804,74.125.68.0-255,5738,265119,76,392511
1411,0.026819,172.31.40.0-255,66,265185,76,392511
1412,0.029113,74.125.68.0-255,5738,270923,76,392511
1413,0.029122,172.31.40.0-255,66,270989,76,392511
1414,0.031423,74.125.68.0-255,5738,276727,76,392511
1415,0.031431,172.31.40.0-255,66,276793,76,392511
1416,0.033718,74.125.68.0-255,5738,282531,76,392511
1417,0.033725,172.31.40.0-255,66,282597,76,392511
1418,0.036013,74.125.68.0-255,5738,288335,76,392511
1419,0.03602,172.31.40.0-255,66,288401,76,392511
1420,0.038309,74.125.68.0-255,5738,294139,76,392511
1421,0.038319,172.31.40.0-255,66,294205,76,392511
1422,0.040614,74.125.68.0-255,5738,299943,76,392511
1423,0.040624,172.31.40.0-255,66,300009,76,392511
1424,0.041517,172.31.40.0-255,200,300209,76,392511
1425,0.04155,172.31.40.0-255,1104,301313,76,392511
1426,0.041613,172.31.40.0-255,1514,302827,76,392511
1427,0.041615,172.31.40.0-255,344,303171,76,392511
1428,0.042935,74.125.68.0-255,5738,308909,76,392511
1429,0.042942,172.31.40.0-255,66,308975,76,392511
1430,0.043167,104.244.42.0-255,66,309041,76,392511
1431,0.045246,74.125.68.0-255,5738,314779,76,392511
1432,0.045253,172.31.40.0-255,66,314845,76,392511
1433,0.047537,74.125.68.0-255,5738,320583,76,392511
1434,0.047544,172.31.40.0-255,66,320649,76,392511
1435,0.049823,74.125.68.0-255,5738,326387,76,392511
1436,0.04983,172.31.40.0-255,66,326453,76,392511
1437,0.052115,74.125.68.0-255,5738,332191,76,392511
1438,0.052123,172.31.40.0-255,66,332257,76,392511
1439,0.054418,74.125.68.0-255,5738,337995,76,392511
1440,0.054426,172.31.40.0-255,66,338061,76,392511
1441,0.056751,74.125.68.0-255,5738,343799,76,392511
1442,0.056758,172.31.40.0-255,66,343865,76,392511
1443,0.059053,74.125.68.0-255,5738,349603,76,392511
1444,0.05906,172.31.40.0-255,66,349669,76,392511
1445,0.061356,74.125.68.0-255,5738,355407,76,392511
1446,0.061362,172.31.40.0-255,66,355473,76,392511
1447,0.06365,74.125.68.0-255,5738,361211,76,392511
1448,0.063656,172.31.40.0-255,66,361277,76,392511
1449,0.065992,74.125.68.0-255,5738,367015,76,392511
1450,0.066006,172.31.40.0-255,66,367081,76,392511
1451,0.068297,74.125.68.0-255,5738,372819,76,392511
1452,0.068303,172.31.40.0-255,66,372885,76,392511
1453,0.070603,74.125.68.0-255,5738,378623,76,392511
1454,0.070613,172.31.40.0-255,66,378689,76,392511
1455,0.072911,74.125.68.0-255,5738,384427,76,392511
1456,0.072918,172.31.40.0-255,66,384493,76,392511
1457,0.075201,74.125.68.0-255,5738,390231,76,392511
1458,0.075209,172.31.40.0-255,66,390297,76,392511
1459,0.077505,74.125.68.0-255,1977,392274,76,392511
1460,0.077515,172.31.40.0-255,66,392340,76,392511
1461,0.077731,172.31.40.0-255,105,392445,76,392511
1462,0.084027,74.125.68.0-255,66,392511,76,392511
1463,0.0,172.253.118.0-255,296,296,76,380746
1464,2e-05,172.31.40.0-255,66,362,76,380746
1465,2.7e-05,172.253.118.0-255,1484,1846,76,380746
1466,3.1e-05,172.31.40.0-255,66,1912,76,380746
1467,3.9e-05,172.253.118.0-255,4320,6232,76,380746
1468,5e-05,172.31.40.0-255,66,6298,76,380746
1469,5.5e-05,172.253.118.0-255,4320,10618,76,380746
1470,5.9e-05,172.31.40.0-255,66,10684,76,380746
1471,7.8e-05,172.253.118.0-255,1484,12168,76,380746
1472,8.5e-05,172.31.40.0-255,66,12234,76,380746
1473,0.000126,172.253.118.0-255,1905,14139,76,380746
1474,0.00013,172.31.40.0-255,66,14205,76,380746
1475,0.000133,172.253.118.0-255,1484,15689,76,380746
1476,0.000136,172.31.40.0-255,66,15755,76,380746
1477,0.000139,172.253.118.0-255,1484,17239,76,380746
1478,0.000141,172.31.40.0-255,66,17305,76,380746
1479,0.000178,172.253.118.0-255,1484,18789,76,380746
1480,0.000182,172.31.40.0-255,66,18855,76,380746
1481,0.000189,172.253.118.0-255,5738,24593,76,380746
1482,0.000191,172.31.40.0-255,66,24659,76,380746
1483,0.000203,172.253.118.0-255,6797,31456,76,380746
1484,0.000206,172.31.40.0-255,66,31522,76,380746
1485,0.000278,172.253.118.0-255,1484,33006,76,380746
1486,0.000281,172.31.40.0-255,66,33072,76,380746
1487,0.000312,172.253.118.0-255,2902,35974,76,380746
1488,0.000314,172.31.40.0-255,66,36040,76,380746
1489,0.000321,172.253.118.0-255,5738,41778,76,380746
1490,0.000324,172.31.40.0-255,66,41844,76,380746
1491,0.000335,172.253.118.0-255,7156,49000,76,380746
1492,0.000338,172.31.40.0-255,66,49066,76,380746
1493,0.000373,172.253.118.0-255,6797,55863,76,380746
1494,0.000376,172.31.40.0-255,66,55929,76,380746
1495,0.000384,172.253.118.0-255,7156,63085,76,380746
1496,0.000414,172.253.118.0-255,1484,64569,76,380746
1497,0.000428,172.253.118.0-255,1437,66006,76,380746
1498,0.000578,172.31.40.0-255,66,66072,76,380746
1499,0.0007,172.253.118.0-255,109,66181,76,380746
1500,0.000824,172.253.118.0-255,1484,67665,76,380746
1501,0.000831,172.253.118.0-255,2902,70567,76,380746
1502,0.000833,172.253.118.0-255,1484,72051,76,380746
1503,0.000847,172.253.118.0-255,4320,76371,76,380746
1504,0.000853,172.31.40.0-255,66,76437,76,380746
1505,0.000894,172.253.118.0-255,1484,77921,76,380746
1506,0.000911,172.253.118.0-255,6797,84718,76,380746
1507,0.000933,172.253.118.0-255,7156,91874,76,380746
1508,0.000943,172.31.40.0-255,66,91940,76,380746
1509,0.000951,172.253.118.0-255,1484,93424,76,380746
1510,0.000962,172.253.118.0-255,6797,100221,76,380746
1511,0.00099,172.31.40.0-255,66,100287,76,380746
1512,0.003005,172.253.118.0-255,5738,106025,76,380746
1513,0.003013,172.31.40.0-255,66,106091,76,380746
1514,0.00504,172.253.118.0-255,5738,111829,76,380746
1515,0.005046,172.31.40.0-255,66,111895,76,380746
1516,0.007075,172.253.118.0-255,5738,117633,76,380746
1517,0.007082,172.31.40.0-255,66,117699,76,380746
1518,0.009102,172.253.118.0-255,5738,123437,76,380746
1519,0.009109,172.31.40.0-255,66,123503,76,380746
1520,0.011116,172.253.118.0-255,5738,129241,76,380746
1521,0.011123,172.31.40.0-255,66,129307,76,380746
1522,0.013138,172.253.118.0-255,5738,135045,76,380746
1523,0.013146,172.31.40.0-255,66,135111,76,380746
1524,0.015154,172.253.118.0-255,5738,140849,76,380746
1525,0.015162,172.31.40.0-255,66,140915,76,380746
1526,0.01718,172.253.118.0-255,5738,146653,76,380746
1527,0.017187,172.31.40.0-255,66,146719,76,380746
1528,0.019215,172.253.118.0-255,5738,152457,76,380746
1529,0.019223,172.31.40.0-255,66,152523,76,380746
1530,0.021234,172.253.118.0-255,5738,158261,76,380746
1531,0.021241,172.31.40.0-255,66,158327,76,380746
1532,0.023255,172.253.118.0-255,5738,164065,76,380746
1533,0.023261,172.31.40.0-255,66,164131,76,380746
1534,0.024797,172.31.40.0-255,190,164321,76,380746
1535,0.024827,172.31.40.0-255,1104,165425,76,380746
1536,0.024889,172.31.40.0-255,1514,166939,76,380746
1537,0.024891,172.31.40.0-255,345,167284,76,380746
1538,0.025273,172.253.118.0-255,5738,173022,76,380746
1539,0.025279,172.31.40.0-255,66,173088,76,380746
1540,0.027099,104.244.42.0-255,66,173154,76,380746
1541,0.027282,172.253.118.0-255,4320,177474,76,380746
1542,0.027288,172.31.40.0-255,66,177540,76,380746
1543,0.027316,172.253.118.0-255,1484,179024,76,380746
1544,0.029316,172.253.118.0-255,4320,183344,76,380746
1545,0.029323,172.31.40.0-255,66,183410,76,380746
1546,0.03136,172.253.118.0-255,5738,189148,76,380746
1547,0.031407,172.31.40.0-255,66,189214,76,380746
1548,0.033435,172.253.118.0-255,5738,194952,76,380746
1549,0.033441,172.31.40.0-255,66,195018,76,380746
1550,0.035476,172.253.118.0-255,5738,200756,76,380746
1551,0.035482,172.31.40.0-255,66,200822,76,380746
1552,0.037499,172.253.118.0-255,5738,206560,76,380746
1553,0.037506,172.31.40.0-255,66,206626,76,380746
1554,0.039529,172.253.118.0-255,5738,212364,76,380746
1555,0.039536,172.31.40.0-255,66,212430,76,380746
1556,0.041556,172.253.118.0-255,5738,218168,76,380746
1557,0.041562,172.31.40.0-255,66,218234,76,380746
1558,0.043591,172.253.118.0-255,5738,223972,76,380746
1559,0.043597,172.31.40.0-255,66,224038,76,380746
1560,0.045617,172.253.118.0-255,5738,229776,76,380746
1561,0.045624,172.31.40.0-255,66,229842,76,380746
1562,0.04764,172.253.118.0-255,5738,235580,76,380746
1563,0.047646,172.31.40.0-255,66,235646,76,380746
1564,0.049661,172.253.118.0-255,5738,241384,76,380746
1565,0.049668,172.31.40.0-255,66,241450,76,380746
1566,0.051703,172.253.118.0-255,5738,247188,76,380746
1567,0.051708,172.31.40.0-255,66,247254,76,380746
1568,0.053776,172.253.118.0-255,5738,252992,76,380746
1569,0.053783,172.31.40.0-255,66,253058,76,380746
1570,0.055823,172.253.118.0-255,5738,258796,76,380746
1571,0.055839,172.31.40.0-255,66,258862,76,380746
1572,0.057871,172.253.118.0-255,5738,264600,76,380746
1573,0.057887,172.31.40.0-255,66,264666,76,380746
1574,0.059924,172.253.118.0-255,5738,270404,76,380746
1575,0.05994,172.31.40.0-255,66,270470,76,380746
1576,0.061963,172.253.118.0-255,5738,276208,76,380746
1577,0.061975,172.31.40.0-255,66,276274,76,380746
1578,0.063985,172.253.118.0-255,5738,282012,76,380746
1579,0.063996,172.31.40.0-255,66,282078,76,380746
1580,0.066041,172.253.118.0-255,5738,287816,76,380746
1581,0.066047,172.31.40.0-255,66,287882,76,380746
1582,0.06807,172.253.118.0-255,5738,293620,76,380746
1583,0.068076,172.31.40.0-255,66,293686,76,380746
1584,0.070094,172.253.118.0-255,5738,299424,76,380746
1585,0.070101,172.31.40.0-255,66,299490,76,380746
1586,0.072145,172.253.118.0-255,5738,305228,76,380746
1587,0.072153,172.31.40.0-255,66,305294,76,380746
1588,0.074164,172.253.118.0-255,5738,311032,76,380746
1589,0.074171,172.31.40.0-255,66,311098,76,380746
1590,0.076183,172.253.118.0-255,5738,316836,76,380746
1591,0.076189,172.31.40.0-255,66,316902,76,380746
1592,0.078205,172.253.118.0-255,5738,322640,76,380746
1593,0.078213,172.31.40.0-255,66,322706,76,380746
1594,0.080224,172.253.118.0-255,5738,328444,76,380746
1595,0.080231,172.31.40.0-255,66,328510,76,380746
1596,0.082246,172.253.118.0-255,5738,334248,76,380746
1597,0.082252,172.31.40.0-255,66,334314,76,380746
1598,0.08426,172.253.118.0-255,5738,340052,76,380746
1599,0.084267,172.31.40.0-255,66,340118,76,380746
1600,0.086276,172.253.118.0-255,5738,345856,76,380746
1601,0.086283,172.31.40.0-255,66,345922,76,380746
1602,0.088302,172.253.118.0-255,5738,351660,76,380746
1603,0.088309,172.31.40.0-255,66,351726,76,380746
1604,0.090332,172.253.118.0-255,5738,357464,76,380746
1605,0.090339,172.31.40.0-255,66,357530,76,380746
1606,0.092348,172.253.118.0-255,5738,363268,76,380746
1607,0.092355,172.31.40.0-255,66,363334,76,380746
1608,0.094366,172.253.118.0-255,5738,369072,76,380746
1609,0.094372,172.31.40.0-255,66,369138,76,380746
1610,0.096377,172.253.118.0-255,5738,374876,76,380746
1611,0.096384,172.31.40.0-255,66,374942,76,380746
1612,0.098418,172.253.118.0-255,5738,380680,76,380746
1613,0.098424,172.31.40.0-255,66,380746,76,380746
1614,0.0,172.217.194.0-255,147,147,76,196428
1615,2.7e-05,172.31.40.0-255,66,213,76,196428
1616,3.4e-05,172.217.194.0-255,1484,1697,76,196428
1617,3.9e-05,172.31.40.0-255,66,1763,76,196428
1618,4.4e-05,172.217.194.0-255,2902,4665,76,196428
1619,4.8e-05,172.31.40.0-255,66,4731,76,196428
1620,6.6e-05,172.217.194.0-255,7156,11887,76,196428
1621,7.1e-05,172.31.40.0-255,66,11953,76,196428
1622,7.5e-05,172.217.194.0-255,2027,13980,76,196428
1623,7.8e-05,172.31.40.0-255,66,14046,76,196428
1624,0.000103,172.217.194.0-255,2902,16948,76,196428
1625,0.000107,172.31.40.0-255,66,17014,76,196428
1626,0.000117,172.217.194.0-255,4320,21334,76,196428
1627,0.000119,172.31.40.0-255,66,21400,76,196428
1628,0.000153,172.31.40.0-255,66,21466,76,196428
1629,0.00019,172.31.40.0-255,66,21532,76,196428
1630,0.000225,172.217.194.0-255,6438,27970,76,196428
1631,0.000228,172.31.40.0-255,66,28036,76,196428
1632,0.000343,172.217.194.0-255,1484,29520,76,196428
1633,0.00035,172.31.40.0-255,66,29586,76,196428
1634,0.000355,172.217.194.0-255,2902,32488,76,196428
1635,0.000357,172.31.40.0-255,66,32554,76,196428
1636,0.000369,172.217.194.0-255,5738,38292,76,196428
1637,0.000371,172.31.40.0-255,66,38358,76,196428
1638,0.000378,172.217.194.0-255,6797,45155,76,196428
1639,0.000381,172.31.40.0-255,66,45221,76,196428
1640,0.000446,172.217.194.0-255,646,45867,76,196428
1641,0.00045,172.31.40.0-255,66,45933,76,196428
1642,0.000796,172.217.194.0-255,1484,47417,76,196428
1643,0.000803,172.31.40.0-255,66,47483,76,196428
1644,0.000809,172.217.194.0-255,2902,50385,76,196428
1645,0.000823,172.217.194.0-255,5738,56123,76,196428
1646,0.00082,172.31.40.0-255,66,56189,76,196428
1647,0.000827,172.217.194.0-255,1484,57673,76,196428
1648,0.000837,172.31.40.0-255,66,57739,76,196428
1649,0.000871,172.217.194.0-255,7156,64895,76,196428
1650,0.000879,172.31.40.0-255,66,64961,76,196428
1651,0.000892,172.217.194.0-255,5738,70699,76,196428
1652,0.000904,172.31.40.0-255,66,70765,76,196428
1653,0.000935,172.31.40.0-255,66,70831,76,196428
1654,0.001211,172.217.194.0-255,1484,72315,76,196428
1655,0.001216,172.217.194.0-255,2902,75217,76,196428
1656,0.001219,172.31.40.0-255,66,75283,76,196428
1657,0.001249,172.217.194.0-255,5738,81021,76,196428
1658,0.001255,172.217.194.0-255,5738,86759,76,196428
1659,0.001257,172.31.40.0-255,66,86825,76,196428
1660,0.001265,172.31.40.0-255,66,86891,76,196428
1661,0.001271,172.217.194.0-255,7156,94047,76,196428
1662,0.001284,172.31.40.0-255,66,94113,76,196428
1663,0.001308,172.217.194.0-255,4320,98433,76,196428
1664,0.001326,172.31.40.0-255,66,98499,76,196428
1665,0.001333,172.217.194.0-255,6438,104937,76,196428
1666,0.001341,172.31.40.0-255,66,105003,76,196428
1667,0.001379,172.217.194.0-255,1484,106487,76,196428
1668,0.001392,172.217.194.0-255,2902,109389,76,196428
1669,0.001401,172.31.40.0-255,66,109455,76,196428
1670,0.001408,172.217.194.0-255,5738,115193,76,196428
1671,0.001414,172.31.40.0-255,66,115259,76,196428
1672,0.001443,172.31.40.0-255,66,115325,76,196428
1673,0.001472,172.217.194.0-255,1484,116809,76,196428
1674,0.001493,172.31.40.0-255,66,116875,76,196428
1675,0.00153,172.217.194.0-255,1484,118359,76,196428
1676,0.001535,172.217.194.0-255,2902,121261,76,196428
1677,0.001539,172.217.194.0-255,4320,125581,76,196428
1678,0.001548,172.217.194.0-255,1484,127065,76,196428
1679,0.001548,172.31.40.0-255,66,127131,76,196428
1680,0.001561,172.217.194.0-255,4320,131451,76,196428
1681,0.001568,172.31.40.0-255,66,131517,76,196428
1682,0.001597,172.31.40.0-255,66,131583,76,196428
1683,0.001614,172.31.40.0-255,66,131649,76,196428
1684,0.001641,172.31.40.0-255,66,131715,76,196428
1685,0.001652,172.217.194.0-255,4320,136035,76,196428
1686,0.001666,172.31.40.0-255,66,136101,76,196428
1687,0.001707,172.217.194.0-255,5738,141839,76,196428
1688,0.001715,172.31.40.0-255,66,141905,76,196428
1689,0.001752,172.31.40.0-255,66,141971,76,196428
1690,0.001765,172.31.40.0-255,66,142037,76,196428
1691,0.001792,172.217.194.0-255,5738,147775,76,196428
1692,0.001797,172.31.40.0-255,66,147841,76,196428
1693,0.001798,172.217.194.0-255,3602,151443,76,196428
1694,0.001802,172.31.40.0-255,66,151509,76,196428
1695,0.001816,172.31.40.0-255,66,151575,76,196428
1696,0.001866,172.31.40.0-255,66,151641,76,196428
1697,0.001868,172.217.194.0-255,1484,153125,76,196428
1698,0.001871,172.217.194.0-255,1484,154609,76,196428
1699,0.001872,172.31.40.0-255,66,154675,76,196428
1700,0.001903,172.217.194.0-255,1484,156159,76,196428
1701,0.001909,172.31.40.0-255,66,156225,76,196428
1702,0.001911,172.217.194.0-255,5738,161963,76,196428
1703,0.001921,172.31.40.0-255,66,162029,76,196428
1704,0.00199,172.31.40.0-255,66,162095,76,196428
1705,0.001991,172.217.194.0-255,4320,166415,76,196428
1706,0.001996,172.31.40.0-255,66,166481,76,196428
1707,0.00201,172.31.40.0-255,66,166547,76,196428
1708,0.002023,172.217.194.0-255,3602,170149,76,196428
1709,0.002027,172.31.40.0-255,66,170215,76,196428
1710,0.002042,172.31.40.0-255,66,170281,76,196428
1711,0.002075,172.31.40.0-255,66,170347,76,196428
1712,0.002099,172.217.194.0-255,2184,172531,76,196428
1713,0.002109,172.31.40.0-255,66,172597,76,196428
1714,0.002199,172.217.194.0-255,1484,174081,76,196428
1715,0.002205,172.217.194.0-255,2902,176983,76,196428
1716,0.00221,172.31.40.0-255,66,177049,76,196428
1717,0.00224,172.217.194.0-255,5738,182787,76,196428
1718,0.002244,172.217.194.0-255,1484,184271,76,196428
1719,0.002247,172.31.40.0-255,66,184337,76,196428
1720,0.002279,172.31.40.0-255,66,184403,76,196428
1721,0.002304,172.31.40.0-255,66,184469,76,196428
1722,0.00231,172.217.194.0-255,1484,185953,76,196428
1723,0.002351,172.217.194.0-255,6933,192886,76,196428
1724,0.002356,172.217.194.0-255,105,192991,76,196428
1725,0.010716,172.31.40.0-255,66,193057,76,196428
1726,0.012746,172.31.40.0-255,105,193162,76,196428
1727,0.015369,172.217.194.0-255,66,193228,76,196428
1728,0.032138,172.31.40.0-255,172,193400,76,196428
1729,0.032169,172.31.40.0-255,1109,194509,76,196428
1730,0.032243,172.31.40.0-255,1514,196023,76,196428
1731,0.032245,172.31.40.0-255,339,196362,76,196428
1732,0.034393,104.244.42.0-255,66,196428,76,196428
1733,0.0,74.125.24.0-255,156,156,76,311657
1734,2.4e-05,172.31.40.0-255,66,222,76,311657
1735,3.2e-05,74.125.24.0-255,1484,1706,76,311657
1736,3.6e-05,172.31.40.0-255,66,1772,76,311657
1737,4.2e-05,74.125.24.0-255,2902,4674,76,311657
1738,5.6e-05,172.31.40.0-255,66,4740,76,311657
1739,0.000101,74.125.24.0-255,1484,6224,76,311657
1740,0.000104,172.31.40.0-255,66,6290,76,311657
1741,0.000122,74.125.24.0-255,2902,9192,76,311657
1742,0.000125,172.31.40.0-255,66,9258,76,311657
1743,0.000129,74.125.24.0-255,2902,12160,76,311657
1744,0.000131,172.31.40.0-255,66,12226,76,311657
1745,0.00018,74.125.24.0-255,2065,14291,76,311657
1746,0.000183,172.31.40.0-255,66,14357,76,311657
1747,0.000328,74.125.24.0-255,1484,15841,76,311657
1748,0.000333,172.31.40.0-255,66,15907,76,311657
1749,0.000339,74.125.24.0-255,2902,18809,76,311657
1750,0.000342,172.31.40.0-255,66,18875,76,311657
1751,0.000347,74.125.24.0-255,4320,23195,76,311657
1752,0.000354,172.31.40.0-255,66,23261,76,311657
1753,0.000381,74.125.24.0-255,1484,24745,76,311657
1754,0.000383,172.31.40.0-255,66,24811,76,311657
1755,0.000392,74.125.24.0-255,6797,31608,76,311657
1756,0.000394,172.31.40.0-255,66,31674,76,311657
1757,0.000416,74.125.24.0-255,5738,37412,76,311657
1758,0.000419,172.31.40.0-255,66,37478,76,311657
1759,0.000456,74.125.24.0-255,1484,38962,76,311657
1760,0.000458,172.31.40.0-255,66,39028,76,311657
1761,0.00047,172.31.40.0-255,66,39094,76,311657
1762,0.001399,74.125.24.0-255,1484,40578,76,311657
1763,0.001406,172.31.40.0-255,66,40644,76,311657
1764,0.001441,74.125.24.0-255,2902,43546,76,311657
1765,0.001449,74.125.24.0-255,5738,49284,76,311657
1766,0.001452,74.125.24.0-255,1484,50768,76,311657
1767,0.001484,74.125.24.0-255,4320,55088,76,311657
1768,0.00152,74.125.24.0-255,5738,60826,76,311657
1769,0.001539,74.125.24.0-255,5738,66564,76,311657
1770,0.001649,74.125.24.0-255,645,67209,76,311657
1771,0.002014,74.125.24.0-255,1484,68693,76,311657
1772,0.002021,74.125.24.0-255,2902,71595,76,311657
1773,0.002045,74.125.24.0-255,5738,77333,76,311657
1774,0.002057,74.125.24.0-255,2902,80235,76,311657
1775,0.002116,74.125.24.0-255,766,81001,76,311657
1776,0.002507,74.125.24.0-255,1484,82485,76,311657
1777,0.00252,74.125.24.0-255,2902,85387,76,311657
1778,0.002535,74.125.24.0-255,5738,91125,76,311657
1779,0.002562,74.125.24.0-255,1484,92609,76,311657
1780,0.002572,74.125.24.0-255,1484,94093,76,311657
1781,0.002587,74.125.24.0-255,7156,101249,76,311657
1782,0.002599,74.125.24.0-255,2902,104151,76,311657
1783,0.007064,172.31.40.0-255,66,104217,76,311657
1784,0.009653,74.125.24.0-255,5738,109955,76,311657
1785,0.009661,172.31.40.0-255,66,110021,76,311657
1786,0.012211,74.125.24.0-255,5738,115759,76,311657
1787,0.012216,172.31.40.0-255,66,115825,76,311657
1788,0.014754,74.125.24.0-255,5738,121563,76,311657
1789,0.014763,172.31.40.0-255,66,121629,76,311657
1790,0.017305,74.125.24.0-255,5738,127367,76,311657
1791,0.017313,172.31.40.0-255,66,127433,76,311657
1792,0.019865,74.125.24.0-255,5738,133171,76,311657
1793,0.019874,172.31.40.0-255,66,133237,76,311657
1794,0.022444,74.125.24.0-255,5738,138975,76,311657
1795,0.023315,172.31.40.0-255,66,139041,76,311657
1796,0.025886,74.125.24.0-255,5738,144779,76,311657
1797,0.025894,172.31.40.0-255,66,144845,76,311657
1798,0.02847,74.125.24.0-255,5738,150583,76,311657
1799,0.028477,172.31.40.0-255,66,150649,76,311657
1800,0.030002,172.31.40.0-255,172,150821,76,311657
1801,0.030029,172.31.40.0-255,1107,151928,76,311657
1802,0.030077,172.31.40.0-255,1514,153442,76,311657
1803,0.030079,172.31.40.0-255,1309,154751,76,311657
1804,0.031022,74.125.24.0-255,5738,160489,76,311657
1805,0.031029,172.31.40.0-255,66,160555,76,311657
1806,0.031506,104.244.42.0-255,66,160621,76,311657
1807,0.031602,104.244.42.0-255,66,160687,76,311657
1808,0.03165,104.244.42.0-255,66,160753,76,311657
1809,0.033616,74.125.24.0-255,5738,166491,76,311657
1810,0.033624,172.31.40.0-255,66,166557,76,311657
1811,0.036149,74.125.24.0-255,5738,172295,76,311657
1812,0.036156,172.31.40.0-255,66,172361,76,311657
1813,0.038721,74.125.24.0-255,5738,178099,76,311657
1814,0.038728,172.31.40.0-255,66,178165,76,311657
1815,0.041293,74.125.24.0-255,5738,183903,76,311657
1816,0.041299,172.31.40.0-255,66,183969,76,311657
1817,0.043865,74.125.24.0-255,5738,189707,76,311657
1818,0.043872,172.31.40.0-255,66,189773,76,311657
1819,0.04646,74.125.24.0-255,5738,195511,76,311657
1820,0.046466,172.31.40.0-255,66,195577,76,311657
1821,0.049036,74.125.24.0-255,5738,201315,76,311657
1822,0.049044,172.31.40.0-255,66,201381,76,311657
1823,0.051592,74.125.24.0-255,5738,207119,76,311657
1824,0.051601,172.31.40.0-255,66,207185,76,311657
1825,0.054197,74.125.24.0-255,5738,212923,76,311657
1826,0.054205,172.31.40.0-255,66,212989,76,311657
1827,0.056763,74.125.24.0-255,5738,218727,76,311657
1828,0.056769,172.31.40.0-255,66,218793,76,311657
1829,0.059353,74.125.24.0-255,5738,224531,76,311657
1830,0.059363,172.31.40.0-255,66,224597,76,311657
1831,0.061905,74.125.24.0-255,5738,230335,76,311657
1832,0.06191,172.31.40.0-255,66,230401,76,311657
1833,0.064453,74.125.24.0-255,5738,236139,76,311657
1834,0.06446,172.31.40.0-255,66,236205,76,311657
1835,0.067039,74.125.24.0-255,5738,241943,76,311657
1836,0.067048,172.31.40.0-255,66,242009,76,311657
1837,0.069615,74.125.24.0-255,5738,247747,76,311657
1838,0.069621,172.31.40.0-255,66,247813,76,311657
1839,0.072162,74.125.24.0-255,5738,253551,76,311657
1840,0.072169,172.31.40.0-255,66,253617,76,311657
1841,0.074708,74.125.24.0-255,5738,259355,76,311657
1842,0.074714,172.31.40.0-255,66,259421,76,311657
1843,0.077254,74.125.24.0-255,5738,265159,76,311657
1844,0.077261,172.31.40.0-255,66,265225,76,311657
1845,0.079847,74.125.24.0-255,5738,270963,76,311657
1846,0.079855,172.31.40.0-255,66,271029,76,311657
1847,0.082407,74.125.24.0-255,5738,276767,76,311657
1848,0.082414,172.31.40.0-255,66,276833,76,311657
1849,0.084938,74.125.24.0-255,5738,282571,76,311657
1850,0.084944,172.31.40.0-255,66,282637,76,311657
1851,0.087491,74.125.24.0-255,5738,288375,76,311657
1852,0.087498,172.31.40.0-255,66,288441,76,311657
1853,0.090038,74.125.24.0-255,5738,294179,76,311657
1854,0.090043,172.31.40.0-255,66,294245,76,311657
1855,0.092586,74.125.24.0-255,5738,299983,76,311657
1856,0.092592,172.31.40.0-255,66,300049,76,311657
1857,0.095176,74.125.24.0-255,5738,305787,76,311657
1858,0.095183,172.31.40.0-255,66,305853,76,311657
1859,0.097734,74.125.24.0-255,5738,311591,76,311657
1860,0.097743,172.31.40.0-255,66,311657,76,311657
1861,0.0,74.125.24.0-255,290,290,76,167993
1862,2.2e-05,172.31.40.0-255,66,356,76,167993
1863,2.9e-05,74.125.24.0-255,1484,1840,76,167993
1864,3.3e-05,172.31.40.0-255,66,1906,76,167993
1865,3.9e-05,74.125.24.0-255,4320,6226,76,167993
1866,4.3e-05,172.31.40.0-255,66,6292,76,167993
1867,5.5e-05,172.31.40.0-255,66,6358,76,167993
1868,7.4e-05,172.31.40.0-255,66,6424,76,167993
1869,8.1e-05,74.125.24.0-255,5738,12162,76,167993
1870,8.4e-05,172.31.40.0-255,66,12228,76,167993
1871,0.000139,172.31.40.0-255,66,12294,76,167993
1872,0.000185,74.125.24.0-255,133,12427,76,167993
1873,0.000187,172.31.40.0-255,66,12493,76,167993
1874,0.00061,74.125.24.0-255,1484,13977,76,167993
1875,0.000616,172.31.40.0-255,66,14043,76,167993
1876,0.000623,74.125.24.0-255,2902,16945,76,167993
1877,0.000624,172.31.40.0-255,66,17011,76,167993
1878,0.000632,74.125.24.0-255,5738,22749,76,167993
1879,0.000633,172.31.40.0-255,66,22815,76,167993
1880,0.000663,172.31.40.0-255,66,22881,76,167993
1881,0.000674,172.31.40.0-255,66,22947,76,167993
1882,0.00069,74.125.24.0-255,2184,25131,76,167993
1883,0.000696,172.31.40.0-255,66,25197,76,167993
1884,0.000725,74.125.24.0-255,343,25540,76,167993
1885,0.000727,172.31.40.0-255,66,25606,76,167993
1886,0.000777,74.125.24.0-255,1484,27090,76,167993
1887,0.000781,172.31.40.0-255,66,27156,76,167993
1888,0.000786,74.125.24.0-255,2902,30058,76,167993
1889,0.000802,74.125.24.0-255,5738,35796,76,167993
1890,0.000822,172.31.40.0-255,66,35862,76,167993
1891,0.000827,74.125.24.0-255,2902,38764,76,167993
1892,0.000832,172.31.40.0-255,66,38830,76,167993
1893,0.000843,74.125.24.0-255,4320,43150,76,167993
1894,0.000858,74.125.24.0-255,5738,48888,76,167993
1895,0.000873,74.125.24.0-255,5738,54626,76,167993
1896,0.000885,74.125.24.0-255,2902,57528,76,167993
1897,0.000888,74.125.24.0-255,2184,59712,76,167993
1898,0.000892,172.31.40.0-255,66,59778,76,167993
1899,0.000898,172.31.40.0-255,66,59844,76,167993
1900,0.000958,74.125.24.0-255,1484,61328,76,167993
1901,0.000977,74.125.24.0-255,2902,64230,76,167993
1902,0.00098,74.125.24.0-255,1484,65714,76,167993
1903,0.001002,74.125.24.0-255,4320,70034,76,167993
1904,0.001039,74.125.24.0-255,4320,74354,76,167993
1905,0.001042,172.31.40.0-255,66,74420,76,167993
1906,0.001049,172.31.40.0-255,66,74486,76,167993
1907,0.001078,74.125.24.0-255,2184,76670,76,167993
1908,0.001082,74.125.24.0-255,2902,79572,76,167993
1909,0.001108,74.125.24.0-255,5738,85310,76,167993
1910,0.001111,172.31.40.0-255,66,85376,76,167993
1911,0.001116,172.31.40.0-255,66,85442,76,167993
1912,0.001129,74.125.24.0-255,1484,86926,76,167993
1913,0.001159,74.125.24.0-255,2902,89828,76,167993
1914,0.001174,172.31.40.0-255,66,89894,76,167993
1915,0.001203,172.31.40.0-255,66,89960,76,167993
1916,0.001217,74.125.24.0-255,7156,97116,76,167993
1917,0.001237,172.31.40.0-255,66,97182,76,167993
1918,0.001247,74.125.24.0-255,1484,98666,76,167993
1919,0.00128,172.31.40.0-255,66,98732,76,167993
1920,0.001299,74.125.24.0-255,1484,100216,76,167993
1921,0.001313,74.125.24.0-255,2902,103118,76,167993
1922,0.001324,172.31.40.0-255,66,103184,76,167993
1923,0.001331,74.125.24.0-255,5738,108922,76,167993
1924,0.001333,74.125.24.0-255,1484,110406,76,167993
1925,0.001339,172.31.40.0-255,66,110472,76,167993
1926,0.001347,74.125.24.0-255,1484,111956,76,167993
1927,0.001392,172.31.40.0-255,66,112022,76,167993
1928,0.00142,172.31.40.0-255,66,112088,76,167993
1929,0.00144,74.125.24.0-255,2902,114990,76,167993
1930,0.001451,172.31.40.0-255,66,115056,76,167993
1931,0.001488,74.125.24.0-255,1484,116540,76,167993
1932,0.001507,74.125.24.0-255,3602,120142,76,167993
1933,0.001511,172.31.40.0-255,66,120208,76,167993
1934,0.001516,172.31.40.0-255,66,120274,76,167993
1935,0.001594,74.125.24.0-255,1484,121758,76,167993
1936,0.001598,74.125.24.0-255,1484,123242,76,167993
1937,0.001609,74.125.24.0-255,1484,124726,76,167993
1938,0.001612,74.125.24.0-255,1484,126210,76,167993
1939,0.001615,172.31.40.0-255,66,126276,76,167993
1940,0.001628,74.125.24.0-255,4320,130596,76,167993
1941,0.001631,74.125.24.0-255,1484,132080,76,167993
1942,0.001635,172.31.40.0-255,66,132146,76,167993
1943,0.001654,74.125.24.0-255,1484,133630,76,167993
1944,0.001685,74.125.24.0-255,1484,135114,76,167993
1945,0.001694,172.31.40.0-255,66,135180,76,167993
1946,0.001779,172.31.40.0-255,66,135246,76,167993
1947,0.001801,74.125.24.0-255,1484,136730,76,167993
1948,0.001807,74.125.24.0-255,2902,139632,76,167993
1949,0.001809,74.125.24.0-255,1484,141116,76,167993
1950,0.001813,172.31.40.0-255,66,141182,76,167993
1951,0.001833,74.125.24.0-255,4320,145502,76,167993
1952,0.001836,74.125.24.0-255,1484,146986,76,167993
1953,0.001845,172.31.40.0-255,66,147052,76,167993
1954,0.001878,172.31.40.0-255,66,147118,76,167993
1955,0.001926,172.31.40.0-255,66,147184,76,167993
1956,0.001958,172.31.40.0-255,66,147250,76,167993
1957,0.001969,74.125.24.0-255,5738,152988,76,167993
1958,0.001993,74.125.24.0-255,2902,155890,76,167993
1959,0.002009,74.125.24.0-255,5020,160910,76,167993
1960,0.002012,172.31.40.0-255,66,160976,76,167993
1961,0.002017,172.31.40.0-255,66,161042,76,167993
1962,0.004027,74.125.24.0-255,2414,163456,76,167993
1963,0.004032,172.31.40.0-255,66,163522,76,167993
1964,0.004458,172.31.40.0-255,105,163627,76,167993
1965,0.006457,74.125.24.0-255,66,163693,76,167993
1966,0.033592,172.31.40.0-255,172,163865,76,167993
1967,0.033626,172.31.40.0-255,1109,164974,76,167993
1968,0.033687,172.31.40.0-255,1514,166488,76,167993
1969,0.033689,172.31.40.0-255,1307,167795,76,167993
1970,0.035163,104.244.42.0-255,66,167861,76,167993
1971,0.035212,104.244.42.0-255,66,167927,76,167993
1972,0.035257,104.244.42.0-255,66,167993,76,167993
1973,0.0,74.125.200.0-255,153,153,76,274276
1974,1.5e-05,172.31.40.0-255,66,219,76,274276
1975,2.1e-05,74.125.200.0-255,1484,1703,76,274276
1976,2.6e-05,172.31.40.0-255,66,1769,76,274276
1977,5.3e-05,74.125.200.0-255,2902,4671,76,274276
1978,5.6e-05,172.31.40.0-255,66,4737,76,274276
1979,6.4e-05,74.125.200.0-255,2902,7639,76,274276
1980,6.6e-05,172.31.40.0-255,66,7705,76,274276
1981,9e-05,74.125.200.0-255,2902,10607,76,274276
1982,9.2e-05,172.31.40.0-255,66,10673,76,274276
1983,9.9e-05,74.125.200.0-255,6329,17002,76,274276
1984,0.000101,172.31.40.0-255,66,17068,76,274276
1985,0.000108,74.125.200.0-255,1484,18552,76,274276
1986,0.00011,172.31.40.0-255,66,18618,76,274276
1987,0.000115,74.125.200.0-255,2902,21520,76,274276
1988,0.000117,172.31.40.0-255,66,21586,76,274276
1989,0.000174,74.125.200.0-255,5738,27324,76,274276
1990,0.000177,172.31.40.0-255,66,27390,76,274276
1991,0.000181,74.125.200.0-255,3961,31351,76,274276
1992,0.000183,172.31.40.0-255,66,31417,76,274276
1993,0.000295,74.125.200.0-255,1484,32901,76,274276
1994,0.000299,172.31.40.0-255,66,32967,76,274276
1995,0.000304,74.125.200.0-255,2902,35869,76,274276
1996,0.000306,172.31.40.0-255,66,35935,76,274276
1997,0.000309,74.125.200.0-255,1484,37419,76,274276
1998,0.000316,172.31.40.0-255,66,37485,76,274276
1999,0.00032,74.125.200.0-255,2902,40387,76,274276
2000,0.000322,172.31.40.0-255,66,40453,76,274276
2001,0.000354,74.125.200.0-255,5738,46191,76,274276
2002,0.000356,172.31.40.0-255,66,46257,76,274276
2003,0.000384,74.125.200.0-255,6797,53054,76,274276
2004,0.000386,172.31.40.0-255,66,53120,76,274276
2005,0.000392,74.125.200.0-255,7156,60276,76,274276
2006,0.000394,172.31.40.0-255,66,60342,76,274276
2007,0.000415,74.125.200.0-255,4320,64662,76,274276
2008,0.000417,172.31.40.0-255,66,64728,76,274276
2009,0.000441,74.125.200.0-255,1398,66126,76,274276
2010,0.000444,74.125.200.0-255,131,66257,76,274276
2011,0.000475,74.125.200.0-255,1484,67741,76,274276
2012,0.000478,172.31.40.0-255,66,67807,76,274276
2013,0.000482,74.125.200.0-255,2902,70709,76,274276
2014,0.000484,172.31.40.0-255,66,70775,76,274276
2015,0.00052,74.125.200.0-255,5738,76513,76,274276
2016,0.000522,172.31.40.0-255,66,76579,76,274276
2017,0.000527,74.125.200.0-255,4320,80899,76,274276
2018,0.000529,172.31.40.0-255,66,80965,76,274276
2019,0.000551,74.125.200.0-255,2543,83508,76,274276
2020,0.000553,172.31.40.0-255,66,83574,76,274276
2021,0.000576,74.125.200.0-255,1484,85058,76,274276
2022,0.000581,74.125.200.0-255,2902,87960,76,274276
2023,0.000583,172.31.40.0-255,66,88026,76,274276
2024,0.000613,74.125.200.0-255,5738,93764,76,274276
2025,0.000615,172.31.40.0-255,66,93830,76,274276
2026,0.00062,74.125.200.0-255,2902,96732,76,274276
2027,0.000622,172.31.40.0-255,66,96798,76,274276
2028,0.000653,74.125.200.0-255,3961,100759,76,274276
2029,0.000655,172.31.40.0-255,66,100825,76,274276
2030,0.000658,74.125.200.0-255,347,101172,76,274276
2031,0.000704,74.125.200.0-255,1484,102656,76,274276
2032,0.000709,172.31.40.0-255,66,102722,76,274276
2033,0.000716,74.125.200.0-255,2902,105624,76,274276
2034,0.000719,172.31.40.0-255,66,105690,76,274276
2035,0.000735,74.125.200.0-255,1484,107174,76,274276
2036,0.000756,74.125.200.0-255,4320,111494,76,274276
2037,0.000758,172.31.40.0-255,66,111560,76,274276
2038,0.000765,74.125.200.0-255,5738,117298,76,274276
2039,0.000766,172.31.40.0-255,66,117364,76,274276
2040,0.000789,74.125.200.0-255,5738,123102,76,274276
2041,0.000795,172.31.40.0-255,66,123168,76,274276
2042,0.000801,74.125.200.0-255,7156,130324,76,274276
2043,0.000804,172.31.40.0-255,66,130390,76,274276
2044,0.00083,74.125.200.0-255,5020,135410,76,274276
2045,0.000837,172.31.40.0-255,66,135476,76,274276
2046,0.00086,74.125.200.0-255,1484,136960,76,274276
2047,0.000873,74.125.200.0-255,2902,139862,76,274276
2048,0.000886,172.31.40.0-255,66,139928,76,274276
2049,0.000892,74.125.200.0-255,4320,144248,76,274276
2050,0.000894,172.31.40.0-255,66,144314,76,274276
2051,0.000912,74.125.200.0-255,1484,145798,76,274276
2052,0.000924,74.125.200.0-255,7156,152954,76,274276
2053,0.000926,172.31.40.0-255,66,153020,76,274276
2054,0.000955,74.125.200.0-255,4320,157340,76,274276
2055,0.000958,172.31.40.0-255,66,157406,76,274276
2056,0.000971,74.125.200.0-255,4320,161726,76,274276
2057,0.000974,172.31.40.0-255,66,161792,76,274276
2058,0.000987,172.31.40.0-255,66,161858,76,274276
2059,0.00104,74.125.200.0-255,1484,163342,76,274276
2060,0.001066,74.125.200.0-255,1484,164826,76,274276
2061,0.001069,172.31.40.0-255,66,164892,76,274276
2062,0.001095,74.125.200.0-255,2902,167794,76,274276
2063,0.001097,172.31.40.0-255,66,167860,76,274276
2064,0.001102,74.125.200.0-255,4320,172180,76,274276
2065,0.001104,172.31.40.0-255,66,172246,76,274276
2066,0.001137,74.125.200.0-255,1484,173730,76,274276
2067,0.001148,172.31.40.0-255,66,173796,76,274276
2068,0.001153,74.125.200.0-255,4320,178116,76,274276
2069,0.001155,172.31.40.0-255,66,178182,76,274276
2070,0.001184,74.125.200.0-255,7156,185338,76,274276
2071,0.001187,172.31.40.0-255,66,185404,76,274276
2072,0.001189,74.125.200.0-255,766,186170,76,274276
2073,0.001246,74.125.200.0-255,1484,187654,76,274276
2074,0.00125,172.31.40.0-255,66,187720,76,274276
2075,0.001259,74.125.200.0-255,2902,190622,76,274276
2076,0.001261,172.31.40.0-255,66,190688,76,274276
2077,0.001285,74.125.200.0-255,2902,193590,76,274276
2078,0.001287,172.31.40.0-255,66,193656,76,274276
2079,0.001311,74.125.200.0-255,2902,196558,76,274276
2080,0.001313,172.31.40.0-255,66,196624,76,274276
2081,0.001316,74.125.200.0-255,1484,198108,76,274276
2082,0.001341,74.125.200.0-255,7156,205264,76,274276
2083,0.001343,172.31.40.0-255,66,205330,76,274276
2084,0.001371,74.125.200.0-255,4320,209650,76,274276
2085,0.001373,172.31.40.0-255,66,209716,76,274276
2086,0.001377,74.125.200.0-255,2902,212618,76,274276
2087,0.001379,172.31.40.0-255,66,212684,76,274276
2088,0.001412,172.31.40.0-255,66,212750,76,274276
2089,0.001438,74.125.200.0-255,2184,214934,76,274276
2090,0.00144,172.31.40.0-255,66,215000,76,274276
2091,0.001444,74.125.200.0-255,4320,219320,76,274276
2092,0.001447,172.31.40.0-255,66,219386,76,274276
2093,0.001472,172.31.40.0-255,66,219452,76,274276
2094,0.001478,74.125.200.0-255,6438,225890,76,274276
2095,0.00148,172.31.40.0-255,66,225956,76,274276
2096,0.001517,74.125.200.0-255,1484,227440,76,274276
2097,0.001528,74.125.200.0-255,1484,228924,76,274276
2098,0.00153,172.31.40.0-255,66,228990,76,274276
2099,0.001543,74.125.200.0-255,1484,230474,76,274276
2100,0.001551,74.125.200.0-255,4320,234794,76,274276
2101,0.001554,172.31.40.0-255,66,234860,76,274276
2102,0.001585,172.31.40.0-255,66,234926,76,274276
2103,0.001595,172.31.40.0-255,66,234992,76,274276
2104,0.001632,74.125.200.0-255,1484,236476,76,274276
2105,0.001652,74.125.200.0-255,5738,242214,76,274276
2106,0.001654,172.31.40.0-255,66,242280,76,274276
2107,0.001677,74.125.200.0-255,766,243046,76,274276
2108,0.001727,74.125.200.0-255,1484,244530,76,274276
2109,0.00173,172.31.40.0-255,66,244596,76,274276
2110,0.001742,74.125.200.0-255,2902,247498,76,274276
2111,0.001745,172.31.40.0-255,66,247564,76,274276
2112,0.001751,74.125.200.0-255,1484,249048,76,274276
2113,0.001773,74.125.200.0-255,1484,250532,76,274276
2114,0.001776,172.31.40.0-255,66,250598,76,274276
2115,0.001803,74.125.200.0-255,4320,254918,76,274276
2116,0.001806,172.31.40.0-255,66,254984,76,274276
2117,0.00181,74.125.200.0-255,2902,257886,76,274276
2118,0.001813,172.31.40.0-255,66,257952,76,274276
2119,0.001851,172.31.40.0-255,66,258018,76,274276
2120,0.001856,74.125.200.0-255,4320,262338,76,274276
2121,0.001859,172.31.40.0-255,66,262404,76,274276
2122,0.001863,74.125.200.0-255,2902,265306,76,274276
2123,0.001866,172.31.40.0-255,66,265372,76,274276
2124,0.00194,172.31.40.0-255,66,265438,76,274276
2125,0.001961,172.31.40.0-255,66,265504,76,274276
2126,0.001966,74.125.200.0-255,2184,267688,76,274276
2127,0.001968,172.31.40.0-255,66,267754,76,274276
2128,0.001972,74.125.200.0-255,1484,269238,76,274276
2129,0.002022,172.31.40.0-255,66,269304,76,274276
2130,0.002043,172.31.40.0-255,66,269370,76,274276
2131,0.002143,172.31.40.0-255,66,269436,76,274276
2132,0.002147,74.125.200.0-255,97,269533,76,274276
2133,0.002149,74.125.200.0-255,105,269638,76,274276
2134,0.002568,172.31.40.0-255,101,269739,76,274276
2135,0.00495,74.125.200.0-255,66,269805,76,274276
2136,0.010858,172.31.40.0-255,105,269910,76,274276
2137,0.013255,74.125.200.0-255,66,269976,76,274276
2138,0.031754,172.31.40.0-255,172,270148,76,274276
2139,0.031787,172.31.40.0-255,1109,271257,76,274276
2140,0.031848,172.31.40.0-255,1514,272771,76,274276
2141,0.03185,172.31.40.0-255,1307,274078,76,274276
2142,0.033458,104.244.42.0-255,66,274144,76,274276
2143,0.033496,104.244.42.0-255,66,274210,76,274276
2144,0.033522,104.244.42.0-255,66,274276,76,274276
2145,0.0,172.217.194.0-255,153,153,76,323804
2146,2.2e-05,172.31.40.0-255,66,219,76,323804
2147,2.9e-05,172.217.194.0-255,1484,1703,76,323804
2148,3.4e-05,172.31.40.0-255,66,1769,76,323804
2149,3.9e-05,172.217.194.0-255,2902,4671,76,323804
2150,4.1e-05,172.31.40.0-255,66,4737,76,323804
2151,5.7e-05,172.217.194.0-255,7156,11893,76,323804
2152,6e-05,172.31.40.0-255,66,11959,76,323804
2153,6.4e-05,172.217.194.0-255,2138,14097,76,323804
2154,6.6e-05,172.31.40.0-255,66,14163,76,323804
2155,0.000106,172.31.40.0-255,66,14229,76,323804
2156,0.000129,172.217.194.0-255,2902,17131,76,323804
2157,0.000131,172.31.40.0-255,66,17197,76,323804
2158,0.000144,172.31.40.0-255,66,17263,76,323804
2159,0.000191,172.31.40.0-255,66,17329,76,323804
2160,0.000202,172.31.40.0-255,66,17395,76,323804
2161,0.000209,172.217.194.0-255,5631,23026,76,323804
2162,0.000211,172.31.40.0-255,66,23092,76,323804
2163,0.000454,172.217.194.0-255,118,23210,76,323804
2164,0.000459,172.31.40.0-255,66,23276,76,323804
2165,0.000487,172.217.194.0-255,1484,24760,76,323804
2166,0.00049,172.31.40.0-255,66,24826,76,323804
2167,0.000495,172.217.194.0-255,2902,27728,76,323804
2168,0.000497,172.31.40.0-255,66,27794,76,323804
2169,0.000508,172.217.194.0-255,5738,33532,76,323804
2170,0.000511,172.31.40.0-255,66,33598,76,323804
2171,0.000535,172.217.194.0-255,1484,35082,76,323804
2172,0.000537,172.31.40.0-255,66,35148,76,323804
2173,0.000568,172.217.194.0-255,5673,40821,76,323804
2174,0.00057,172.31.40.0-255,66,40887,76,323804
2175,0.000613,172.217.194.0-255,1484,42371,76,323804
2176,0.00062,172.217.194.0-255,2902,45273,76,323804
2177,0.000623,172.31.40.0-255,66,45339,76,323804
2178,0.000629,172.217.194.0-255,4320,49659,76,323804
2179,0.000631,172.31.40.0-255,66,49725,76,323804
2180,0.000651,172.217.194.0-255,1484,51209,76,323804
2181,0.000662,172.217.194.0-255,6797,58006,76,323804
2182,0.000664,172.31.40.0-255,66,58072,76,323804
2183,0.001174,172.217.194.0-255,1484,59556,76,323804
2184,0.001179,172.217.194.0-255,2902,62458,76,323804
2185,0.001182,172.31.40.0-255,66,62524,76,323804
2186,0.001185,172.217.194.0-255,1484,64008,76,323804
2187,0.001201,172.217.194.0-255,4320,68328,76,323804
2188,0.001203,172.31.40.0-255,66,68394,76,323804
2189,0.001227,172.217.194.0-255,2902,71296,76,323804
2190,0.001229,172.31.40.0-255,66,71362,76,323804
2191,0.001265,172.31.40.0-255,66,71428,76,323804
2192,0.00128,172.31.40.0-255,66,71494,76,323804
2193,0.001586,172.217.194.0-255,1484,72978,76,323804
2194,0.001591,172.217.194.0-255,2902,75880,76,323804
2195,0.001594,172.31.40.0-255,66,75946,76,323804
2196,0.001599,172.217.194.0-255,2902,78848,76,323804
2197,0.0016,172.31.40.0-255,66,78914,76,323804
2198,0.001622,172.217.194.0-255,2902,81816,76,323804
2199,0.001624,172.31.40.0-255,66,81882,76,323804
2200,0.001631,172.217.194.0-255,7156,89038,76,323804
2201,0.001636,172.31.40.0-255,66,89104,76,323804
2202,0.001655,172.217.194.0-255,2902,92006,76,323804
2203,0.00166,172.31.40.0-255,66,92072,76,323804
2204,0.001682,172.217.194.0-255,2902,94974,76,323804
2205,0.001684,172.31.40.0-255,66,95040,76,323804
2206,0.001718,172.31.40.0-255,66,95106,76,323804
2207,0.00216,172.217.194.0-255,1484,96590,76,323804
2208,0.002185,172.217.194.0-255,2902,99492,76,323804
2209,0.00219,172.31.40.0-255,66,99558,76,323804
2210,0.002198,172.217.194.0-255,4320,103878,76,323804
2211,0.0022,172.31.40.0-255,66,103944,76,323804
2212,0.00223,172.217.194.0-255,1484,105428,76,323804
2213,0.002242,172.31.40.0-255,66,105494,76,323804
2214,0.002279,172.217.194.0-255,4320,109814,76,323804
2215,0.002282,172.31.40.0-255,66,109880,76,323804
2216,0.002321,172.31.40.0-255,66,109946,76,323804
2217,0.002324,172.217.194.0-255,1484,111430,76,323804
2218,0.004605,172.217.194.0-255,4320,115750,76,323804
2219,0.004611,172.31.40.0-255,66,115816,76,323804
2220,0.006914,172.217.194.0-255,5738,121554,76,323804
2221,0.00692,172.31.40.0-255,66,121620,76,323804
2222,0.009195,172.217.194.0-255,5738,127358,76,323804
2223,0.009202,172.31.40.0-255,66,127424,76,323804
2224,0.011477,172.217.194.0-255,5738,133162,76,323804
2225,0.011484,172.31.40.0-255,66,133228,76,323804
2226,0.013786,172.217.194.0-255,5738,138966,76,323804
2227,0.013793,172.31.40.0-255,66,139032,76,323804
2228,0.016085,172.217.194.0-255,5738,144770,76,323804
2229,0.016092,172.31.40.0-255,66,144836,76,323804
2230,0.018387,172.217.194.0-255,5738,150574,76,323804
2231,0.018395,172.31.40.0-255,66,150640,76,323804
2232,0.020682,172.217.194.0-255,5738,156378,76,323804
2233,0.02069,172.31.40.0-255,66,156444,76,323804
2234,0.022981,172.217.194.0-255,5738,162182,76,323804
2235,0.022987,172.31.40.0-255,66,162248,76,323804
2236,0.025275,172.217.194.0-255,5738,167986,76,323804
2237,0.025291,172.31.40.0-255,66,168052,76,323804
2238,0.027596,172.217.194.0-255,5738,173790,76,323804
2239,0.027611,172.31.40.0-255,66,173856,76,323804
2240,0.029929,172.217.194.0-255,5738,179594,76,323804
2241,0.029974,172.31.40.0-255,66,179660,76,323804
2242,0.032298,172.217.194.0-255,5738,185398,76,323804
2243,0.032306,172.31.40.0-255,66,185464,76,323804
2244,0.034622,172.217.194.0-255,5738,191202,76,323804
2245,0.034633,172.31.40.0-255,66,191268,76,323804
2246,0.03694,172.217.194.0-255,5738,197006,76,323804
2247,0.036956,172.31.40.0-255,66,197072,76,323804
2248,0.039247,172.217.194.0-255,5738,202810,76,323804
2249,0.039254,172.31.40.0-255,66,202876,76,323804
2250,0.041525,172.217.194.0-255,5738,208614,76,323804
2251,0.041531,172.31.40.0-255,66,208680,76,323804
2252,0.043811,172.217.194.0-255,5738,214418,76,323804
2253,0.043822,172.31.40.0-255,66,214484,76,323804
2254,0.044615,172.31.40.0-255,172,214656,76,323804
2255,0.044649,172.31.40.0-255,1104,215760,76,323804
2256,0.04471,172.31.40.0-255,1514,217274,76,323804
2257,0.044713,172.31.40.0-255,344,217618,76,323804
2258,0.046091,172.217.194.0-255,5738,223356,76,323804
2259,0.046098,172.31.40.0-255,66,223422,76,323804
2260,0.046821,104.244.42.0-255,66,223488,76,323804
2261,0.048437,172.217.194.0-255,4320,227808,76,323804
2262,0.048444,172.31.40.0-255,66,227874,76,323804
2263,0.048472,172.217.194.0-255,1484,229358,76,323804
2264,0.050713,172.217.194.0-255,4320,233678,76,323804
2265,0.05072,172.31.40.0-255,66,233744,76,323804
2266,0.053003,172.217.194.0-255,5738,239482,76,323804
2267,0.05301,172.31.40.0-255,66,239548,76,323804
2268,0.055286,172.217.194.0-255,5738,245286,76,323804
2269,0.055292,172.31.40.0-255,66,245352,76,323804
2270,0.057557,172.217.194.0-255,5738,251090,76,323804
2271,0.057562,172.31.40.0-255,66,251156,76,323804
2272,0.059844,172.217.194.0-255,5738,256894,76,323804
2273,0.05985,172.31.40.0-255,66,256960,76,323804
2274,0.062149,172.217.194.0-255,5738,262698,76,323804
2275,0.062156,172.31.40.0-255,66,262764,76,323804
2276,0.064453,172.217.194.0-255,5738,268502,76,323804
2277,0.064461,172.31.40.0-255,66,268568,76,323804
2278,0.06676,172.217.194.0-255,5738,274306,76,323804
2279,0.066767,172.31.40.0-255,66,274372,76,323804
2280,0.069078,172.217.194.0-255,5738,280110,76,323804
2281,0.069089,172.31.40.0-255,66,280176,76,323804
2282,0.071413,172.217.194.0-255,5738,285914,76,323804
2283,0.071418,172.31.40.0-255,66,285980,76,323804
2284,0.073725,172.217.194.0-255,5738,291718,76,323804
2285,0.073732,172.31.40.0-255,66,291784,76,323804
2286,0.076049,172.217.194.0-255,5738,297522,76,323804
2287,0.076055,172.31.40.0-255,66,297588,76,323804
2288,0.07835,172.217.194.0-255,5738,303326,76,323804
2289,0.078357,172.31.40.0-255,66,303392,76,323804
2290,0.08066,172.217.194.0-255,5738,309130,76,323804
2291,0.080666,172.31.40.0-255,66,309196,76,323804
2292,0.082947,172.217.194.0-255,5738,314934,76,323804
2293,0.082954,172.31.40.0-255,66,315000,76,323804
2294,0.085254,172.217.194.0-255,5738,320738,76,323804
2295,0.085261,172.31.40.0-255,66,320804,76,323804
2296,0.087554,172.217.194.0-255,2763,323567,76,323804
2297,0.087566,172.31.40.0-255,66,323633,76,323804
2298,0.087746,172.31.40.0-255,105,323738,76,323804
2299,0.090008,172.217.194.0-255,66,323804,76,323804
2300,0.0,74.125.24.0-255,153,153,76,268738
2301,2.1e-05,172.31.40.0-255,66,219,76,268738
2302,2.7e-05,74.125.24.0-255,1484,1703,76,268738
2303,3.1e-05,172.31.40.0-255,66,1769,76,268738
2304,3.4e-05,74.125.24.0-255,1484,3253,76,268738
2305,3.7e-05,172.31.40.0-255,66,3319,76,268738
2306,6.8e-05,74.125.24.0-255,1484,4803,76,268738
2307,7.1e-05,172.31.40.0-255,66,4869,76,268738
2308,7.4e-05,74.125.24.0-255,1484,6353,76,268738
2309,7.6e-05,172.31.40.0-255,66,6419,76,268738
2310,9.4e-05,74.125.24.0-255,2902,9321,76,268738
2311,9.7e-05,172.31.40.0-255,66,9387,76,268738
2312,0.000124,74.125.24.0-255,2902,12289,76,268738
2313,0.000126,172.31.40.0-255,66,12355,76,268738
2314,0.00013,74.125.24.0-255,2095,14450,76,268738
2315,0.000132,172.31.40.0-255,66,14516,76,268738
2316,0.000167,74.125.24.0-255,2902,17418,76,268738
2317,0.00017,172.31.40.0-255,66,17484,76,268738
2318,0.000201,74.125.24.0-255,7156,24640,76,268738
2319,0.000203,172.31.40.0-255,66,24706,76,268738
2320,0.000275,74.125.24.0-255,1484,26190,76,268738
2321,0.000277,172.31.40.0-255,66,26256,76,268738
2322,0.000297,74.125.24.0-255,5379,31635,76,268738
2323,0.000299,172.31.40.0-255,66,31701,76,268738
2324,0.000392,74.125.24.0-255,1484,33185,76,268738
2325,0.000394,172.31.40.0-255,66,33251,76,268738
2326,0.0004,74.125.24.0-255,2902,36153,76,268738
2327,0.000402,172.31.40.0-255,66,36219,76,268738
2328,0.00045,74.125.24.0-255,4320,40539,76,268738
2329,0.000453,172.31.40.0-255,66,40605,76,268738
2330,0.000478,74.125.24.0-255,1484,42089,76,268738
2331,0.00048,172.31.40.0-255,66,42155,76,268738
2332,0.000486,74.125.24.0-255,5738,47893,76,268738
2333,0.000488,172.31.40.0-255,66,47959,76,268738
2334,0.000517,74.125.24.0-255,7156,55115,76,268738
2335,0.00052,172.31.40.0-255,66,55181,76,268738
2336,0.00055,74.125.24.0-255,6797,61978,76,268738
2337,0.000552,172.31.40.0-255,66,62044,76,268738
2338,0.000555,74.125.24.0-255,1484,63528,76,268738
2339,0.000578,74.125.24.0-255,2813,66341,76,268738
2340,0.00058,172.31.40.0-255,66,66407,76,268738
2341,0.000627,74.125.24.0-255,130,66537,76,268738
2342,0.00076,74.125.24.0-255,1484,68021,76,268738
2343,0.000763,172.31.40.0-255,66,68087,76,268738
2344,0.000768,74.125.24.0-255,2902,70989,76,268738
2345,0.000771,172.31.40.0-255,66,71055,76,268738
2346,0.000803,74.125.24.0-255,5738,76793,76,268738
2347,0.000806,172.31.40.0-255,66,76859,76,268738
2348,0.000814,74.125.24.0-255,7156,84015,76,268738
2349,0.000816,172.31.40.0-255,66,84081,76,268738
2350,0.000845,74.125.24.0-255,5738,89819,76,268738
2351,0.000848,172.31.40.0-255,66,89885,76,268738
2352,0.000851,74.125.24.0-255,1484,91369,76,268738
2353,0.000856,74.125.24.0-255,2902,94271,76,268738
2354,0.000858,172.31.40.0-255,66,94337,76,268738
2355,0.000884,74.125.24.0-255,6144,100481,76,268738
2356,0.000886,172.31.40.0-255,66,100547,76,268738
2357,0.000906,74.125.24.0-255,5738,106285,76,268738
2358,0.000909,172.31.40.0-255,66,106351,76,268738
2359,0.000939,74.125.24.0-255,2902,109253,76,268738
2360,0.000941,172.31.40.0-255,66,109319,76,268738
2361,0.000953,172.31.40.0-255,66,109385,76,268738
2362,0.000964,74.125.24.0-255,5738,115123,76,268738
2363,0.000967,172.31.40.0-255,66,115189,76,268738
2364,0.000995,74.125.24.0-255,7156,122345,76,268738
2365,0.000998,172.31.40.0-255,66,122411,76,268738
2366,0.001024,74.125.24.0-255,1484,123895,76,268738
2367,0.001027,74.125.24.0-255,766,124661,76,268738
2368,0.001029,172.31.40.0-255,66,124727,76,268738
2369,0.001032,74.125.24.0-255,1484,126211,76,268738
2370,0.001056,74.125.24.0-255,4320,130531,76,268738
2371,0.001059,172.31.40.0-255,66,130597,76,268738
2372,0.001064,74.125.24.0-255,2902,133499,76,268738
2373,0.001066,172.31.40.0-255,66,133565,76,268738
2374,0.001096,74.125.24.0-255,5738,139303,76,268738
2375,0.0011,172.31.40.0-255,66,139369,76,268738
2376,0.00113,74.125.24.0-255,1484,140853,76,268738
2377,0.001138,74.125.24.0-255,7156,148009,76,268738
2378,0.001141,172.31.40.0-255,66,148075,76,268738
2379,0.001144,74.125.24.0-255,1484,149559,76,268738
2380,0.001175,74.125.24.0-255,7156,156715,76,268738
2381,0.001178,172.31.40.0-255,66,156781,76,268738
2382,0.001213,74.125.24.0-255,2184,158965,76,268738
2383,0.001217,172.31.40.0-255,66,159031,76,268738
2384,0.00123,172.31.40.0-255,66,159097,76,268738
2385,0.001261,74.125.24.0-255,4320,163417,76,268738
2386,0.001264,172.31.40.0-255,66,163483,76,268738
2387,0.001301,172.31.40.0-255,66,163549,76,268738
2388,0.001335,74.125.24.0-255,7156,170705,76,268738
2389,0.001338,172.31.40.0-255,66,170771,76,268738
2390,0.001367,74.125.24.0-255,2184,172955,76,268738
2391,0.001369,172.31.40.0-255,66,173021,76,268738
2392,0.001507,74.125.24.0-255,1484,174505,76,268738
2393,0.001514,74.125.24.0-255,2902,177407,76,268738
2394,0.001517,172.31.40.0-255,66,177473,76,268738
2395,0.001523,74.125.24.0-255,4320,181793,76,268738
2396,0.001526,172.31.40.0-255,66,181859,76,268738
2397,0.001562,74.125.24.0-255,1484,183343,76,268738
2398,0.001569,74.125.24.0-255,4320,187663,76,268738
2399,0.001572,172.31.40.0-255,66,187729,76,268738
2400,0.0016,172.31.40.0-255,66,187795,76,268738
2401,0.001645,74.125.24.0-255,5738,193533,76,268738
2402,0.001648,172.31.40.0-255,66,193599,76,268738
2403,0.001677,74.125.24.0-255,2902,196501,76,268738
2404,0.001683,172.31.40.0-255,66,196567,76,268738
2405,0.001688,74.125.24.0-255,2184,198751,76,268738
2406,0.001691,172.31.40.0-255,66,198817,76,268738
2407,0.001694,74.125.24.0-255,2902,201719,76,268738
2408,0.001697,172.31.40.0-255,66,201785,76,268738
2409,0.001704,74.125.24.0-255,7156,208941,76,268738
2410,0.001706,172.31.40.0-255,66,209007,76,268738
2411,0.001766,172.31.40.0-255,66,209073,76,268738
2412,0.001772,74.125.24.0-255,5738,214811,76,268738
2413,0.001775,172.31.40.0-255,66,214877,76,268738
2414,0.00181,74.125.24.0-255,2184,217061,76,268738
2415,0.001812,172.31.40.0-255,66,217127,76,268738
2416,0.001971,74.125.24.0-255,1484,218611,76,268738
2417,0.001979,74.125.24.0-255,2902,221513,76,268738
2418,0.001983,172.31.40.0-255,66,221579,76,268738
2419,0.001989,74.125.24.0-255,5738,227317,76,268738
2420,0.001992,172.31.40.0-255,66,227383,76,268738
2421,0.002013,172.31.40.0-255,66,227449,76,268738
2422,0.002026,172.31.40.0-255,66,227515,76,268738
2423,0.002034,74.125.24.0-255,7156,234671,76,268738
2424,0.002036,172.31.40.0-255,66,234737,76,268738
2425,0.002071,74.125.24.0-255,4320,239057,76,268738
2426,0.002074,172.31.40.0-255,66,239123,76,268738
2427,0.002096,172.31.40.0-255,66,239189,76,268738
2428,0.002107,172.31.40.0-255,66,239255,76,268738
2429,0.002163,172.31.40.0-255,66,239321,76,268738
2430,0.002174,172.31.40.0-255,66,239387,76,268738
2431,0.002177,74.125.24.0-255,1484,240871,76,268738
2432,0.002223,74.125.24.0-255,4320,245191,76,268738
2433,0.002277,74.125.24.0-255,7156,252347,76,268738
2434,0.002305,74.125.24.0-255,2184,254531,76,268738
2435,0.00231,74.125.24.0-255,2902,257433,76,268738
2436,0.002336,74.125.24.0-255,1484,258917,76,268738
2437,0.002383,74.125.24.0-255,1484,260401,76,268738
2438,0.002403,74.125.24.0-255,3695,264096,76,268738
2439,0.002407,74.125.24.0-255,105,264201,76,268738
2440,0.002673,172.31.40.0-255,66,264267,76,268738
2441,0.005679,172.31.40.0-255,105,264372,76,268738
2442,0.008164,74.125.24.0-255,66,264438,76,268738
2443,0.033604,172.31.40.0-255,172,264610,76,268738
2444,0.033635,172.31.40.0-255,1105,265715,76,268738
2445,0.033697,172.31.40.0-255,1514,267229,76,268738
2446,0.033698,172.31.40.0-255,1311,268540,76,268738
2447,0.035292,104.244.42.0-255,66,268606,76,268738
2448,0.035309,104.244.42.0-255,66,268672,76,268738
2449,0.035384,104.244.42.0-255,66,268738,76,268738
2450,0.0,172.217.194.0-255,146,146,76,295171
2451,1.9e-05,172.31.40.0-255,66,212,76,295171
2452,2.6e-05,172.217.194.0-255,1484,1696,76,295171
2453,3e-05,172.31.40.0-255,66,1762,76,295171
2454,3.6e-05,172.217.194.0-255,2902,4664,76,295171
2455,4e-05,172.31.40.0-255,66,4730,76,295171
2456,4.9e-05,172.217.194.0-255,7156,11886,76,295171
2457,5.2e-05,172.31.40.0-255,66,11952,76,295171
2458,5.6e-05,172.217.194.0-255,2073,14025,76,295171
2459,5.9e-05,172.31.40.0-255,66,14091,76,295171
2460,8.7e-05,172.217.194.0-255,7156,21247,76,295171
2461,9e-05,172.31.40.0-255,66,21313,76,295171
2462,0.000108,172.217.194.0-255,4320,25633,76,295171
2463,0.000111,172.31.40.0-255,66,25699,76,295171
2464,0.000117,172.217.194.0-255,5379,31078,76,295171
2465,0.00012,172.31.40.0-255,66,31144,76,295171
2466,0.000429,172.217.194.0-255,1484,32628,76,295171
2467,0.000435,172.31.40.0-255,66,32694,76,295171
2468,0.000439,172.217.194.0-255,1484,34178,76,295171
2469,0.000441,172.31.40.0-255,66,34244,76,295171
2470,0.000457,172.217.194.0-255,1484,35728,76,295171
2471,0.000459,172.31.40.0-255,66,35794,76,295171
2472,0.000465,172.217.194.0-255,5738,41532,76,295171
2473,0.000468,172.31.40.0-255,66,41598,76,295171
2474,0.000497,172.217.194.0-255,6797,48395,76,295171
2475,0.0005,172.31.40.0-255,66,48461,76,295171
2476,0.000502,172.217.194.0-255,1484,49945,76,295171
2477,0.000504,172.31.40.0-255,66,50011,76,295171
2478,0.000524,172.217.194.0-255,5738,55749,76,295171
2479,0.000527,172.31.40.0-255,66,55815,76,295171
2480,0.000537,172.31.40.0-255,66,55881,76,295171
2481,0.000549,172.217.194.0-255,1382,57263,76,295171
2482,0.000647,172.217.194.0-255,119,57382,76,295171
2483,0.000864,172.31.40.0-255,66,57448,76,295171
2484,0.001232,172.217.194.0-255,1484,58932,76,295171
2485,0.001242,172.217.194.0-255,2902,61834,76,295171
2486,0.001246,172.31.40.0-255,66,61900,76,295171
2487,0.001272,172.217.194.0-255,5738,67638,76,295171
2488,0.001274,172.31.40.0-255,66,67704,76,295171
2489,0.001278,172.217.194.0-255,2902,70606,76,295171
2490,0.00128,172.31.40.0-255,66,70672,76,295171
2491,0.001309,172.31.40.0-255,66,70738,76,295171
2492,0.001342,172.31.40.0-255,66,70804,76,295171
2493,0.00136,172.217.194.0-255,766,71570,76,295171
2494,0.003897,172.217.194.0-255,4320,75890,76,295171
2495,0.003905,172.31.40.0-255,66,75956,76,295171
2496,0.00645,172.217.194.0-255,5738,81694,76,295171
2497,0.006458,172.31.40.0-255,66,81760,76,295171
2498,0.009041,172.217.194.0-255,5738,87498,76,295171
2499,0.009051,172.31.40.0-255,66,87564,76,295171
2500,0.011638,172.217.194.0-255,5738,93302,76,295171
2501,0.011646,172.31.40.0-255,66,93368,76,295171
2502,0.014229,172.217.194.0-255,5738,99106,76,295171
2503,0.014241,172.31.40.0-255,66,99172,76,295171
2504,0.016821,172.217.194.0-255,5738,104910,76,295171
2505,0.016829,172.31.40.0-255,66,104976,76,295171
2506,0.019396,172.217.194.0-255,5738,110714,76,295171
2507,0.019404,172.31.40.0-255,66,110780,76,295171
2508,0.021975,172.217.194.0-255,5738,116518,76,295171
2509,0.021983,172.31.40.0-255,66,116584,76,295171
2510,0.024548,172.217.194.0-255,5738,122322,76,295171
2511,0.024557,172.31.40.0-255,66,122388,76,295171
2512,0.027116,172.217.194.0-255,5738,128126,76,295171
2513,0.027124,172.31.40.0-255,66,128192,76,295171
2514,0.027271,172.31.40.0-255,172,128364,76,295171
2515,0.027301,172.31.40.0-255,1109,129473,76,295171
2516,0.027354,172.31.40.0-255,1514,130987,76,295171
2517,0.027356,172.31.40.0-255,1307,132294,76,295171
2518,0.028781,104.244.42.0-255,66,132360,76,295171
2519,0.028853,104.244.42.0-255,66,132426,76,295171
2520,0.028957,104.244.42.0-255,66,132492,76,295171
2521,0.02971,172.217.194.0-255,5738,138230,76,295171
2522,0.029715,172.31.40.0-255,66,138296,76,295171
2523,0.03231,172.217.194.0-255,5738,144034,76,295171
2524,0.032317,172.31.40.0-255,66,144100,76,295171
2525,0.034918,172.217.194.0-255,5738,149838,76,295171
2526,0.034926,172.31.40.0-255,66,149904,76,295171
2527,0.03751,172.217.194.0-255,5738,155642,76,295171
2528,0.037517,172.31.40.0-255,66,155708,76,295171
2529,0.040081,172.217.194.0-255,5738,161446,76,295171
2530,0.040087,172.31.40.0-255,66,161512,76,295171
2531,0.042638,172.217.194.0-255,5738,167250,76,295171
2532,0.042646,172.31.40.0-255,66,167316,76,295171
2533,0.045211,172.217.194.0-255,5738,173054,76,295171
2534,0.045218,172.31.40.0-255,66,173120,76,295171
2535,0.047784,172.217.194.0-255,5738,178858,76,295171
2536,0.04779,172.31.40.0-255,66,178924,76,295171
2537,0.050359,172.217.194.0-255,5738,184662,76,295171
2538,0.050364,172.31.40.0-255,66,184728,76,295171
2539,0.052955,172.217.194.0-255,5738,190466,76,295171
2540,0.052961,172.31.40.0-255,66,190532,76,295171
2541,0.055514,172.217.194.0-255,5738,196270,76,295171
2542,0.05552,172.31.40.0-255,66,196336,76,295171
2543,0.058106,172.217.194.0-255,5738,202074,76,295171
2544,0.058111,172.31.40.0-255,66,202140,76,295171
2545,0.060703,172.217.194.0-255,5738,207878,76,295171
2546,0.060709,172.31.40.0-255,66,207944,76,295171
2547,0.063285,172.217.194.0-255,5738,213682,76,295171
2548,0.063291,172.31.40.0-255,66,213748,76,295171
2549,0.065872,172.217.194.0-255,5738,219486,76,295171
2550,0.06588,172.31.40.0-255,66,219552,76,295171
2551,0.068453,172.217.194.0-255,5738,225290,76,295171
2552,0.068459,172.31.40.0-255,66,225356,76,295171
2553,0.071032,172.217.194.0-255,5738,231094,76,295171
2554,0.071039,172.31.40.0-255,66,231160,76,295171
2555,0.073622,172.217.194.0-255,5738,236898,76,295171
2556,0.073629,172.31.40.0-255,66,236964,76,295171
2557,0.076219,172.217.194.0-255,5738,242702,76,295171
2558,0.076225,172.31.40.0-255,66,242768,76,295171
2559,0.078792,172.217.194.0-255,5738,248506,76,295171
2560,0.078798,172.31.40.0-255,66,248572,76,295171
2561,0.078893,172.31.40.0-255,101,248673,76,295171
2562,0.081346,172.217.194.0-255,5738,254411,76,295171
2563,0.081352,172.31.40.0-255,66,254477,76,295171
2564,0.081423,172.217.194.0-255,66,254543,76,295171
2565,0.083926,172.217.194.0-255,5738,260281,76,295171
2566,0.083932,172.31.40.0-255,66,260347,76,295171
2567,0.086516,172.217.194.0-255,5738,266085,76,295171
2568,0.086523,172.31.40.0-255,66,266151,76,295171
2569,0.089114,172.217.194.0-255,5738,271889,76,295171
2570,0.089122,172.31.40.0-255,66,271955,76,295171
2571,0.091691,172.217.194.0-255,5738,277693,76,295171
2572,0.091698,172.31.40.0-255,66,277759,76,295171
2573,0.094266,172.217.194.0-255,5738,283497,76,295171
2574,0.094273,172.31.40.0-255,66,283563,76,295171
2575,0.096853,172.217.194.0-255,5738,289301,76,295171
2576,0.09686,172.31.40.0-255,66,289367,76,295171
2577,0.099429,172.217.194.0-255,5738,295105,76,295171
2578,0.099436,172.31.40.0-255,66,295171,76,295171
2579,0.0,74.125.200.0-255,150,150,76,361590
2580,2.1e-05,172.31.40.0-255,66,216,76,361590
2581,4.7e-05,74.125.200.0-255,1484,1700,76,361590
2582,5.2e-05,172.31.40.0-255,66,1766,76,361590
2583,5.7e-05,74.125.200.0-255,2902,4668,76,361590
2584,6e-05,172.31.40.0-255,66,4734,76,361590
2585,6.5e-05,74.125.200.0-255,4320,9054,76,361590
2586,6.7e-05,172.31.40.0-255,66,9120,76,361590
2587,9.4e-05,74.125.200.0-255,1484,10604,76,361590
2588,9.6e-05,172.31.40.0-255,66,10670,76,361590
2589,0.000108,172.31.40.0-255,66,10736,76,361590
2590,0.000138,74.125.200.0-255,2902,13638,76,361590
2591,0.00014,172.31.40.0-255,66,13704,76,361590
2592,0.000155,74.125.200.0-255,1484,15188,76,361590
2593,0.000157,172.31.40.0-255,66,15254,76,361590
2594,0.000175,74.125.200.0-255,3961,19215,76,361590
2595,0.000177,172.31.40.0-255,66,19281,76,361590
2596,0.000224,74.125.200.0-255,1484,20765,76,361590
2597,0.000226,172.31.40.0-255,66,20831,76,361590
2598,0.000231,74.125.200.0-255,2902,23733,76,361590
2599,0.000233,172.31.40.0-255,66,23799,76,361590
2600,0.000255,74.125.200.0-255,5738,29537,76,361590
2601,0.000257,172.31.40.0-255,66,29603,76,361590
2602,0.00027,74.125.200.0-255,2902,32505,76,361590
2603,0.000272,172.31.40.0-255,66,32571,76,361590
2604,0.000289,74.125.200.0-255,3961,36532,76,361590
2605,0.000292,172.31.40.0-255,66,36598,76,361590
2606,0.000503,74.125.200.0-255,1484,38082,76,361590
2607,0.000507,172.31.40.0-255,66,38148,76,361590
2608,0.00052,74.125.200.0-255,1484,39632,76,361590
2609,0.000522,172.31.40.0-255,66,39698,76,361590
2610,0.000538,74.125.200.0-255,1484,41182,76,361590
2611,0.000545,74.125.200.0-255,5738,46920,76,361590
2612,0.000548,172.31.40.0-255,66,46986,76,361590
2613,0.000554,74.125.200.0-255,5738,52724,76,361590
2614,0.000556,172.31.40.0-255,66,52790,76,361590
2615,0.000572,74.125.200.0-255,1125,53915,76,361590
2616,0.000649,74.125.200.0-255,1484,55399,76,361590
2617,0.000652,172.31.40.0-255,66,55465,76,361590
2618,0.000658,74.125.200.0-255,2902,58367,76,361590
2619,0.00066,172.31.40.0-255,66,58433,76,361590
2620,0.000683,74.125.200.0-255,5738,64171,76,361590
2621,0.000686,172.31.40.0-255,66,64237,76,361590
2622,0.000738,74.125.200.0-255,4320,68557,76,361590
2623,0.000742,172.31.40.0-255,66,68623,76,361590
2624,0.000758,74.125.200.0-255,2543,71166,76,361590
2625,0.00076,172.31.40.0-255,66,71232,76,361590
2626,0.000776,74.125.200.0-255,4320,75552,76,361590
2627,0.000778,172.31.40.0-255,66,75618,76,361590
2628,0.000798,74.125.200.0-255,2902,78520,76,361590
2629,0.000801,74.125.200.0-255,2902,81422,76,361590
2630,0.000803,74.125.200.0-255,1484,82906,76,361590
2631,0.000806,172.31.40.0-255,66,82972,76,361590
2632,0.000809,172.31.40.0-255,66,83038,76,361590
2633,0.000826,172.31.40.0-255,66,83104,76,361590
2634,0.000829,74.125.200.0-255,2902,86006,76,361590
2635,0.000831,172.31.40.0-255,66,86072,76,361590
2636,0.000863,74.125.200.0-255,4320,90392,76,361590
2637,0.000866,172.31.40.0-255,66,90458,76,361590
2638,0.000884,74.125.200.0-255,4903,95361,76,361590
2639,0.000886,172.31.40.0-255,66,95427,76,361590
2640,0.000984,74.125.200.0-255,1484,96911,76,361590
2641,0.000987,74.125.200.0-255,2902,99813,76,361590
2642,0.000989,74.125.200.0-255,1484,101297,76,361590
2643,0.000994,172.31.40.0-255,66,101363,76,361590
2644,0.001004,74.125.200.0-255,4320,105683,76,361590
2645,0.001006,172.31.40.0-255,66,105749,76,361590
2646,0.001012,74.125.200.0-255,5738,111487,76,361590
2647,0.001013,172.31.40.0-255,66,111553,76,361590
2648,0.001036,74.125.200.0-255,7156,118709,76,361590
2649,0.001038,172.31.40.0-255,66,118775,76,361590
2650,0.001043,74.125.200.0-255,4320,123095,76,361590
2651,0.001045,172.31.40.0-255,66,123161,76,361590
2652,0.001086,74.125.200.0-255,6572,129733,76,361590
2653,0.001089,172.31.40.0-255,66,129799,76,361590
2654,0.00133,74.125.200.0-255,1484,131283,76,361590
2655,0.001335,74.125.200.0-255,1484,132767,76,361590
2656,0.001339,172.31.40.0-255,66,132833,76,361590
2657,0.001359,74.125.200.0-255,1484,134317,76,361590
2658,0.001375,74.125.200.0-255,2902,137219,76,361590
2659,0.001378,172.31.40.0-255,66,137285,76,361590
2660,0.001399,74.125.200.0-255,2902,140187,76,361590
2661,0.001401,172.31.40.0-255,66,140253,76,361590
2662,0.001437,74.125.200.0-255,4320,144573,76,361590
2663,0.001439,172.31.40.0-255,66,144639,76,361590
2664,0.001473,172.31.40.0-255,66,144705,76,361590
2665,0.001487,172.31.40.0-255,66,144771,76,361590
2666,0.001489,74.125.200.0-255,1484,146255,76,361590
2667,0.001519,74.125.200.0-255,2902,149157,76,361590
2668,0.001522,172.31.40.0-255,66,149223,76,361590
2669,0.001528,74.125.200.0-255,5738,154961,76,361590
2670,0.00153,172.31.40.0-255,66,155027,76,361590
2671,0.001574,74.125.200.0-255,1484,156511,76,361590
2672,0.001596,74.125.200.0-255,5738,162249,76,361590
2673,0.0016,172.31.40.0-255,66,162315,76,361590
2674,0.00163,172.31.40.0-255,66,162381,76,361590
2675,0.001642,74.125.200.0-255,2902,165283,76,361590
2676,0.001644,172.31.40.0-255,66,165349,76,361590
2677,0.001649,74.125.200.0-255,3602,168951,76,361590
2678,0.001651,172.31.40.0-255,66,169017,76,361590
2679,0.001786,74.125.200.0-255,1484,170501,76,361590
2680,0.00179,74.125.200.0-255,1484,171985,76,361590
2681,0.001793,172.31.40.0-255,66,172051,76,361590
2682,0.001811,74.125.200.0-255,1484,173535,76,361590
2683,0.001815,74.125.200.0-255,2902,176437,76,361590
2684,0.001819,172.31.40.0-255,66,176503,76,361590
2685,0.001837,74.125.200.0-255,2902,179405,76,361590
2686,0.001839,172.31.40.0-255,66,179471,76,361590
2687,0.001863,74.125.200.0-255,2902,182373,76,361590
2688,0.001865,172.31.40.0-255,66,182439,76,361590
2689,0.001887,74.125.200.0-255,1484,183923,76,361590
2690,0.001894,74.125.200.0-255,5738,189661,76,361590
2691,0.001896,172.31.40.0-255,66,189727,76,361590
2692,0.001904,74.125.200.0-255,7156,196883,76,361590
2693,0.001906,172.31.40.0-255,66,196949,76,361590
2694,0.001935,74.125.200.0-255,1484,198433,76,361590
2695,0.001961,74.125.200.0-255,5020,203453,76,361590
2696,0.001966,172.31.40.0-255,66,203519,76,361590
2697,0.002036,74.125.200.0-255,1484,205003,76,361590
2698,0.002042,74.125.200.0-255,2902,207905,76,361590
2699,0.002046,172.31.40.0-255,66,207971,76,361590
2700,0.00205,74.125.200.0-255,1484,209455,76,361590
2701,0.002055,74.125.200.0-255,2902,212357,76,361590
2702,0.002057,172.31.40.0-255,66,212423,76,361590
2703,0.002064,74.125.200.0-255,5738,218161,76,361590
2704,0.002066,172.31.40.0-255,66,218227,76,361590
2705,0.002093,74.125.200.0-255,5738,223965,76,361590
2706,0.002096,172.31.40.0-255,66,224031,76,361590
2707,0.002117,74.125.200.0-255,4320,228351,76,361590
2708,0.00212,172.31.40.0-255,66,228417,76,361590
2709,0.002139,74.125.200.0-255,2902,231319,76,361590
2710,0.002142,172.31.40.0-255,66,231385,76,361590
2711,0.002149,74.125.200.0-255,6438,237823,76,361590
2712,0.002151,172.31.40.0-255,66,237889,76,361590
2713,0.002256,74.125.200.0-255,1484,239373,76,361590
2714,0.002262,74.125.200.0-255,2902,242275,76,361590
2715,0.002265,172.31.40.0-255,66,242341,76,361590
2716,0.002272,74.125.200.0-255,5738,248079,76,361590
2717,0.002274,172.31.40.0-255,66,248145,76,361590
2718,0.00228,74.125.200.0-255,4320,252465,76,361590
2719,0.002283,172.31.40.0-255,66,252531,76,361590
2720,0.002311,74.125.200.0-255,5738,258269,76,361590
2721,0.002314,172.31.40.0-255,66,258335,76,361590
2722,0.00235,74.125.200.0-255,1484,259819,76,361590
2723,0.002379,172.31.40.0-255,66,259885,76,361590
2724,0.002384,74.125.200.0-255,2184,262069,76,361590
2725,0.002386,172.31.40.0-255,66,262135,76,361590
2726,0.004702,74.125.200.0-255,5738,267873,76,361590
2727,0.004709,172.31.40.0-255,66,267939,76,361590
2728,0.007026,74.125.200.0-255,2902,270841,76,361590
2729,0.00703,172.31.40.0-255,66,270907,76,361590
2730,0.007046,74.125.200.0-255,2902,273809,76,361590
2731,0.007048,172.31.40.0-255,66,273875,76,361590
2732,0.009336,74.125.200.0-255,2902,276777,76,361590
2733,0.009341,172.31.40.0-255,66,276843,76,361590
2734,0.009362,74.125.200.0-255,2902,279745,76,361590
2735,0.009364,172.31.40.0-255,66,279811,76,361590
2736,0.01167,74.125.200.0-255,5738,285549,76,361590
2737,0.011678,172.31.40.0-255,66,285615,76,361590
2738,0.01407,74.125.200.0-255,5738,291353,76,361590
2739,0.014079,172.31.40.0-255,66,291419,76,361590
2740,0.016406,74.125.200.0-255,5738,297157,76,361590
2741,0.016418,172.31.40.0-255,66,297223,76,361590
2742,0.018745,74.125.200.0-255,5738,302961,76,361590
2743,0.018754,172.31.40.0-255,66,303027,76,361590
2744,0.021084,74.125.200.0-255,5738,308765,76,361590
2745,0.021092,172.31.40.0-255,66,308831,76,361590
2746,0.02341,74.125.200.0-255,5738,314569,76,361590
2747,0.023416,172.31.40.0-255,66,314635,76,361590
2748,0.025742,74.125.200.0-255,5738,320373,76,361590
2749,0.025751,172.31.40.0-255,66,320439,76,361590
2750,0.028067,74.125.200.0-255,5738,326177,76,361590
2751,0.028074,172.31.40.0-255,66,326243,76,361590
2752,0.029719,172.31.40.0-255,172,326415,76,361590
2753,0.029752,172.31.40.0-255,1105,327520,76,361590
2754,0.02981,172.31.40.0-255,1514,329034,76,361590
2755,0.029812,172.31.40.0-255,1311,330345,76,361590
2756,0.030399,74.125.200.0-255,5738,336083,76,361590
2757,0.030404,172.31.40.0-255,66,336149,76,361590
2758,0.031393,104.244.42.0-255,66,336215,76,361590
2759,0.031424,104.244.42.0-255,66,336281,76,361590
2760,0.031482,104.244.42.0-255,66,336347,76,361590
2761,0.032145,104.244.42.0-255,108,336455,76,361590
2762,0.032155,172.31.40.0-255,66,336521,76,361590
2763,0.032733,74.125.200.0-255,5738,342259,76,361590
2764,0.03274,172.31.40.0-255,66,342325,76,361590
2765,0.035073,74.125.200.0-255,5738,348063,76,361590
2766,0.035079,172.31.40.0-255,66,348129,76,361590
2767,0.037403,74.125.200.0-255,5738,353867,76,361590
2768,0.03741,172.31.40.0-255,66,353933,76,361590
2769,0.03974,74.125.200.0-255,5738,359671,76,361590
2770,0.039747,172.31.40.0-255,66,359737,76,361590
2771,0.042086,74.125.200.0-255,1616,361353,76,361590
2772,0.042095,172.31.40.0-255,66,361419,76,361590
2773,0.042265,172.31.40.0-255,105,361524,76,361590
2774,0.044544,74.125.200.0-255,66,361590,76,361590
2775,0.0,172.253.118.0-255,150,150,76,355223
2776,1.4e-05,172.31.40.0-255,66,216,76,355223
2777,2.1e-05,172.253.118.0-255,1484,1700,76,355223
2778,2.6e-05,172.31.40.0-255,66,1766,76,355223
2779,3.2e-05,172.253.118.0-255,2902,4668,76,355223
2780,3.5e-05,172.31.40.0-255,66,4734,76,355223
2781,6.6e-05,172.253.118.0-255,7156,11890,76,355223
2782,6.9e-05,172.31.40.0-255,66,11956,76,355223
2783,8.7e-05,172.253.118.0-255,2126,14082,76,355223
2784,9e-05,172.31.40.0-255,66,14148,76,355223
2785,0.000195,172.253.118.0-255,1484,15632,76,355223
2786,0.000199,172.31.40.0-255,66,15698,76,355223
2787,0.000204,172.253.118.0-255,2902,18600,76,355223
2788,0.000207,172.31.40.0-255,66,18666,76,355223
2789,0.000213,172.253.118.0-255,5738,24404,76,355223
2790,0.000215,172.31.40.0-255,66,24470,76,355223
2791,0.000254,172.253.118.0-255,6797,31267,76,355223
2792,0.000257,172.31.40.0-255,66,31333,76,355223
2793,0.000356,172.253.118.0-255,1484,32817,76,355223
2794,0.000359,172.31.40.0-255,66,32883,76,355223
2795,0.000365,172.253.118.0-255,2902,35785,76,355223
2796,0.000367,172.31.40.0-255,66,35851,76,355223
2797,0.000397,172.253.118.0-255,5738,41589,76,355223
2798,0.0004,172.31.40.0-255,66,41655,76,355223
2799,0.000408,172.253.118.0-255,6797,48452,76,355223
2800,0.00041,172.31.40.0-255,66,48518,76,355223
2801,0.000454,172.31.40.0-255,66,48584,76,355223
2802,0.000458,172.253.118.0-255,2857,51441,76,355223
2803,0.00046,172.31.40.0-255,66,51507,76,355223
2804,0.000539,172.253.118.0-255,108,51615,76,355223
2805,0.000543,172.31.40.0-255,66,51681,76,355223
2806,0.000653,172.253.118.0-255,1484,53165,76,355223
2807,0.000661,172.253.118.0-255,2902,56067,76,355223
2808,0.000664,172.31.40.0-255,66,56133,76,355223
2809,0.000688,172.253.118.0-255,5738,61871,76,355223
2810,0.000691,172.31.40.0-255,66,61937,76,355223
2811,0.000696,172.253.118.0-255,2902,64839,76,355223
2812,0.000698,172.31.40.0-255,66,64905,76,355223
2813,0.000723,172.253.118.0-255,3961,68866,76,355223
2814,0.000727,172.31.40.0-255,66,68932,76,355223
2815,0.000748,172.253.118.0-255,7156,76088,76,355223
2816,0.000751,172.31.40.0-255,66,76154,76,355223
2817,0.000756,172.253.118.0-255,2902,79056,76,355223
2818,0.000758,172.31.40.0-255,66,79122,76,355223
2819,0.000776,172.253.118.0-255,5738,84860,76,355223
2820,0.000778,172.31.40.0-255,66,84926,76,355223
2821,0.000804,172.253.118.0-255,1391,86317,76,355223
2822,0.001404,172.31.40.0-255,66,86383,76,355223
2823,0.001513,172.253.118.0-255,1484,87867,76,355223
2824,0.001522,172.253.118.0-255,2902,90769,76,355223
2825,0.001525,172.31.40.0-255,66,90835,76,355223
2826,0.001551,172.253.118.0-255,5738,96573,76,355223
2827,0.001554,172.31.40.0-255,66,96639,76,355223
2828,0.001569,172.253.118.0-255,5738,102377,76,355223
2829,0.001571,172.31.40.0-255,66,102443,76,355223
2830,0.001594,172.253.118.0-255,4320,106763,76,355223
2831,0.001597,172.31.40.0-255,66,106829,76,355223
2832,0.00161,172.31.40.0-255,66,106895,76,355223
2833,0.001613,172.253.118.0-255,1484,108379,76,355223
2834,0.001632,172.253.118.0-255,766,109145,76,355223
2835,0.001634,172.31.40.0-255,66,109211,76,355223
2836,0.003884,172.253.118.0-255,2902,112113,76,355223
2837,0.003896,172.31.40.0-255,66,112179,76,355223
2838,0.003915,172.253.118.0-255,2902,115081,76,355223
2839,0.003917,172.31.40.0-255,66,115147,76,355223
2840,0.006177,172.253.118.0-255,2902,118049,76,355223
2841,0.006185,172.31.40.0-255,66,118115,76,355223
2842,0.006207,172.253.118.0-255,2902,121017,76,355223
2843,0.00621,172.31.40.0-255,66,121083,76,355223
2844,0.008474,172.253.118.0-255,4320,125403,76,355223
2845,0.008487,172.31.40.0-255,66,125469,76,355223
2846,0.008506,172.253.118.0-255,1484,126953,76,355223
2847,0.010776,172.253.118.0-255,4320,131273,76,355223
2848,0.010808,172.31.40.0-255,66,131339,76,355223
2849,0.013163,172.253.118.0-255,5738,137077,76,355223
2850,0.013178,172.31.40.0-255,66,137143,76,355223
2851,0.015468,172.253.118.0-255,5738,142881,76,355223
2852,0.015483,172.31.40.0-255,66,142947,76,355223
2853,0.017793,172.253.118.0-255,5738,148685,76,355223
2854,0.01781,172.31.40.0-255,66,148751,76,355223
2855,0.02009,172.253.118.0-255,5738,154489,76,355223
2856,0.020099,172.31.40.0-255,66,154555,76,355223
2857,0.022403,172.253.118.0-255,5738,160293,76,355223
2858,0.022415,172.31.40.0-255,66,160359,76,355223
2859,0.024693,172.253.118.0-255,5738,166097,76,355223
2860,0.024703,172.31.40.0-255,66,166163,76,355223
2861,0.025333,172.31.40.0-255,171,166334,76,355223
2862,0.02537,172.31.40.0-255,1128,167462,76,355223
2863,0.025431,172.31.40.0-255,1514,168976,76,355223
2864,0.025433,172.31.40.0-255,321,169297,76,355223
2865,0.026934,104.244.42.0-255,66,169363,76,355223
2866,0.026981,104.244.42.0-255,66,169429,76,355223
2867,0.027008,104.244.42.0-255,66,169495,76,355223
2868,0.027032,172.253.118.0-255,5738,175233,76,355223
2869,0.027042,172.31.40.0-255,66,175299,76,355223
2870,0.029348,172.253.118.0-255,5738,181037,76,355223
2871,0.02936,172.31.40.0-255,66,181103,76,355223
2872,0.031675,172.253.118.0-255,5738,186841,76,355223
2873,0.031682,172.31.40.0-255,66,186907,76,355223
2874,0.033988,172.253.118.0-255,5738,192645,76,355223
2875,0.033995,172.31.40.0-255,66,192711,76,355223
2876,0.036262,172.253.118.0-255,5738,198449,76,355223
2877,0.03627,172.31.40.0-255,66,198515,76,355223
2878,0.038576,172.253.118.0-255,5738,204253,76,355223
2879,0.038586,172.31.40.0-255,66,204319,76,355223
2880,0.040882,172.253.118.0-255,5738,210057,76,355223
2881,0.040891,172.31.40.0-255,66,210123,76,355223
2882,0.043171,172.253.118.0-255,5738,215861,76,355223
2883,0.043178,172.31.40.0-255,66,215927,76,355223
2884,0.045474,172.253.118.0-255,5738,221665,76,355223
2885,0.045482,172.31.40.0-255,66,221731,76,355223
2886,0.047773,172.253.118.0-255,5738,227469,76,355223
2887,0.047785,172.31.40.0-255,66,227535,76,355223
2888,0.050091,172.253.118.0-255,5738,233273,76,355223
2889,0.050111,172.31.40.0-255,66,233339,76,355223
2890,0.052406,172.253.118.0-255,5738,239077,76,355223
2891,0.052427,172.31.40.0-255,66,239143,76,355223
2892,0.054727,172.253.118.0-255,5738,244881,76,355223
2893,0.054744,172.31.40.0-255,66,244947,76,355223
2894,0.057027,172.253.118.0-255,5738,250685,76,355223
2895,0.05704,172.31.40.0-255,66,250751,76,355223
2896,0.059362,172.253.118.0-255,5738,256489,76,355223
2897,0.059374,172.31.40.0-255,66,256555,76,355223
2898,0.061666,172.253.118.0-255,5738,262293,76,355223
2899,0.061674,172.31.40.0-255,66,262359,76,355223
2900,0.063954,172.253.118.0-255,5738,268097,76,355223
2901,0.063961,172.31.40.0-255,66,268163,76,355223
2902,0.066264,172.253.118.0-255,5738,273901,76,355223
2903,0.066275,172.31.40.0-255,66,273967,76,355223
2904,0.068576,172.253.118.0-255,5738,279705,76,355223
2905,0.068587,172.31.40.0-255,66,279771,76,355223
2906,0.070874,172.253.118.0-255,5738,285509,76,355223
2907,0.070882,172.31.40.0-255,66,285575,76,355223
2908,0.073193,172.253.118.0-255,5738,291313,76,355223
2909,0.073205,172.31.40.0-255,66,291379,76,355223
2910,0.075472,172.253.118.0-255,5738,297117,76,355223
2911,0.075483,172.31.40.0-255,66,297183,76,355223
2912,0.077788,172.253.118.0-255,5738,302921,76,355223
2913,0.077796,172.31.40.0-255,66,302987,76,355223
2914,0.080092,172.253.118.0-255,5738,308725,76,355223
2915,0.080102,172.31.40.0-255,66,308791,76,355223
2916,0.082398,172.253.118.0-255,5738,314529,76,355223
2917,0.082406,172.31.40.0-255,66,314595,76,355223
2918,0.0847,172.253.118.0-255,5738,320333,76,355223
2919,0.084707,172.31.40.0-255,66,320399,76,355223
2920,0.086999,172.253.118.0-255,5738,326137,76,355223
2921,0.087007,172.31.40.0-255,66,326203,76,355223
2922,0.089339,172.253.118.0-255,5738,331941,76,355223
2923,0.089347,172.31.40.0-255,66,332007,76,355223
2924,0.09164,172.253.118.0-255,5738,337745,76,355223
2925,0.09165,172.31.40.0-255,66,337811,76,355223
2926,0.09394,172.253.118.0-255,5738,343549,76,355223
2927,0.093948,172.31.40.0-255,66,343615,76,355223
2928,0.09624,172.253.118.0-255,5738,349353,76,355223
2929,0.096247,172.31.40.0-255,66,349419,76,355223
2930,0.098534,172.253.118.0-255,5738,355157,76,355223
2931,0.098541,172.31.40.0-255,66,355223,76,355223
2932,0.0,74.125.24.0-255,294,294,76,193048
2933,2e-05,172.31.40.0-255,66,360,76,193048
2934,2.6e-05,74.125.24.0-255,1484,1844,76,193048
2935,3e-05,172.31.40.0-255,66,1910,76,193048
2936,3.6e-05,74.125.24.0-255,4320,6230,76,193048
2937,4.8e-05,172.31.40.0-255,66,6296,76,193048
2938,8.4e-05,172.31.40.0-255,66,6362,76,193048
2939,0.000165,74.125.24.0-255,1484,7846,76,193048
2940,0.000169,172.31.40.0-255,66,7912,76,193048
2941,0.000181,74.125.24.0-255,2902,10814,76,193048
2942,0.000192,172.31.40.0-255,66,10880,76,193048
2943,0.000219,74.125.24.0-255,4320,15200,76,193048
2944,0.000222,172.31.40.0-255,66,15266,76,193048
2945,0.000236,74.125.24.0-255,1484,16750,76,193048
2946,0.000238,172.31.40.0-255,66,16816,76,193048
2947,0.000344,74.125.24.0-255,6797,23613,76,193048
2948,0.00035,172.31.40.0-255,66,23679,76,193048
2949,0.00038,74.125.24.0-255,1484,25163,76,193048
2950,0.000382,172.31.40.0-255,66,25229,76,193048
2951,0.000416,74.125.24.0-255,5738,30967,76,193048
2952,0.00042,172.31.40.0-255,66,31033,76,193048
2953,0.000484,74.125.24.0-255,4320,35353,76,193048
2954,0.000487,172.31.40.0-255,66,35419,76,193048
2955,0.000516,172.31.40.0-255,66,35485,76,193048
2956,0.000686,74.125.24.0-255,2902,38387,76,193048
2957,0.000689,172.31.40.0-255,66,38453,76,193048
2958,0.000728,172.31.40.0-255,66,38519,76,193048
2959,0.000788,74.125.24.0-255,356,38875,76,193048
2960,0.000791,172.31.40.0-255,66,38941,76,193048
2961,0.000833,74.125.24.0-255,1484,40425,76,193048
2962,0.000837,172.31.40.0-255,78,40503,76,193048
2963,0.000849,74.125.24.0-255,1484,41987,76,193048
2964,0.000851,172.31.40.0-255,78,42065,76,193048
2965,0.000855,74.125.24.0-255,417,42482,76,193048
2966,0.000915,74.125.24.0-255,7156,49638,76,193048
2967,0.000959,74.125.24.0-255,4320,53958,76,193048
2968,0.000975,74.125.24.0-255,2902,56860,76,193048
2969,0.000994,74.125.24.0-255,5738,62598,76,193048
2970,0.001006,74.125.24.0-255,2902,65500,76,193048
2971,0.001248,74.125.24.0-255,4320,69820,76,193048
2972,0.001263,74.125.24.0-255,4320,74140,76,193048
2973,0.001372,74.125.24.0-255,7156,81296,76,193048
2974,0.001605,74.125.24.0-255,6438,87734,76,193048
2975,0.002041,74.125.24.0-255,6438,94172,76,193048
2976,0.002109,74.125.24.0-255,5738,99910,76,193048
2977,0.002123,74.125.24.0-255,1484,101394,76,193048
2978,0.002196,74.125.24.0-255,1484,102878,76,193048
2979,0.002212,74.125.24.0-255,4320,107198,76,193048
2980,0.002402,74.125.24.0-255,5738,112936,76,193048
2981,0.002423,74.125.24.0-255,5020,117956,76,193048
2982,0.002541,74.125.24.0-255,5738,123694,76,193048
2983,0.002579,74.125.24.0-255,4320,128014,76,193048
2984,0.002646,172.31.40.0-255,66,128080,76,193048
2985,0.002793,74.125.24.0-255,5738,133818,76,193048
2986,0.0028,172.31.40.0-255,66,133884,76,193048
2987,0.00283,172.31.40.0-255,66,133950,76,193048
2988,0.003036,74.125.24.0-255,4320,138270,76,193048
2989,0.003044,172.31.40.0-255,66,138336,76,193048
2990,0.003053,74.125.24.0-255,5738,144074,76,193048
2991,0.003058,172.31.40.0-255,66,144140,76,193048
2992,0.003105,172.31.40.0-255,66,144206,76,193048
2993,0.003258,74.125.24.0-255,4320,148526,76,193048
2994,0.003263,172.31.40.0-255,66,148592,76,193048
2995,0.003274,74.125.24.0-255,4320,152912,76,193048
2996,0.003287,172.31.40.0-255,66,152978,76,193048
2997,0.003361,74.125.24.0-255,2184,155162,76,193048
2998,0.003365,172.31.40.0-255,66,155228,76,193048
2999,0.003406,74.125.24.0-255,2902,158130,76,193048
3000,0.003414,172.31.40.0-255,66,158196,76,193048
3001,0.003416,74.125.24.0-255,1484,159680,76,193048
3002,0.003442,74.125.24.0-255,2902,162582,76,193048
3003,0.003445,172.31.40.0-255,66,162648,76,193048
3004,0.003479,74.125.24.0-255,4320,166968,76,193048
3005,0.003491,172.31.40.0-255,66,167034,76,193048
3006,0.003506,74.125.24.0-255,1484,168518,76,193048
3007,0.003525,74.125.24.0-255,1484,170002,76,193048
3008,0.003534,172.31.40.0-255,66,170068,76,193048
3009,0.003538,74.125.24.0-255,2902,172970,76,193048
3010,0.003547,172.31.40.0-255,66,173036,76,193048
3011,0.003606,74.125.24.0-255,5020,178056,76,193048
3012,0.003606,172.31.40.0-255,66,178122,76,193048
3013,0.00361,172.31.40.0-255,66,178188,76,193048
3014,0.004143,74.125.24.0-255,5738,183926,76,193048
3015,0.004147,172.31.40.0-255,66,183992,76,193048
3016,0.004213,172.31.40.0-255,66,184058,76,193048
3017,0.004683,74.125.24.0-255,4320,188378,76,193048
3018,0.004688,172.31.40.0-255,66,188444,76,193048
3019,0.004731,172.31.40.0-255,66,188510,76,193048
3020,0.004774,172.31.40.0-255,66,188576,76,193048
3021,0.005068,172.31.40.0-255,105,188681,76,193048
3022,0.007431,74.125.24.0-255,66,188747,76,193048
3023,0.0337,172.31.40.0-255,172,188919,76,193048
3024,0.03373,172.31.40.0-255,1109,190028,76,193048
3025,0.033802,172.31.40.0-255,1514,191542,76,193048
3026,0.033803,172.31.40.0-255,1308,192850,76,193048
3027,0.035386,104.244.42.0-255,66,192916,76,193048
3028,0.035467,104.244.42.0-255,66,192982,76,193048
3029,0.035508,104.244.42.0-255,66,193048,76,193048
3030,0.0,74.125.24.0-255,153,153,76,299797
3031,1.7e-05,172.31.40.0-255,66,219,76,299797
3032,2.4e-05,74.125.24.0-255,1484,1703,76,299797
3033,2.8e-05,172.31.40.0-255,66,1769,76,299797
3034,3.4e-05,74.125.24.0-255,2902,4671,76,299797
3035,3.7e-05,172.31.40.0-255,66,4737,76,299797
3036,4.5e-05,74.125.24.0-255,7156,11893,76,299797
3037,4.7e-05,172.31.40.0-255,66,11959,76,299797
3038,5.2e-05,74.125.24.0-255,2902,14861,76,299797
3039,5.5e-05,172.31.40.0-255,66,14927,76,299797
3040,9.9e-05,74.125.24.0-255,2037,16964,76,299797
3041,0.000102,172.31.40.0-255,66,17030,76,299797
3042,0.000116,172.31.40.0-255,66,17096,76,299797
3043,0.000189,74.125.24.0-255,1484,18580,76,299797
3044,0.000192,172.31.40.0-255,66,18646,76,299797
3045,0.000195,74.125.24.0-255,1484,20130,76,299797
3046,0.000198,172.31.40.0-255,66,20196,76,299797
3047,0.00021,74.125.24.0-255,1484,21680,76,299797
3048,0.000212,172.31.40.0-255,66,21746,76,299797
3049,0.000219,74.125.24.0-255,5738,27484,76,299797
3050,0.000221,172.31.40.0-255,66,27550,76,299797
3051,0.000242,74.125.24.0-255,4320,31870,76,299797
3052,0.000244,172.31.40.0-255,66,31936,76,299797
3053,0.000274,172.31.40.0-255,66,32002,76,299797
3054,0.000285,172.31.40.0-255,66,32068,76,299797
3055,0.000287,74.125.24.0-255,413,32481,76,299797
3056,0.000289,172.31.40.0-255,66,32547,76,299797
3057,0.000334,74.125.24.0-255,330,32877,76,299797
3058,0.000337,172.31.40.0-255,66,32943,76,299797
3059,0.000641,74.125.24.0-255,1484,34427,76,299797
3060,0.00066,74.125.24.0-255,2902,37329,76,299797
3061,0.000667,74.125.24.0-255,5738,43067,76,299797
3062,0.000673,172.31.40.0-255,66,43133,76,299797
3063,0.000681,172.31.40.0-255,66,43199,76,299797
3064,0.000684,74.125.24.0-255,1484,44683,76,299797
3065,0.000692,74.125.24.0-255,7156,51839,76,299797
3066,0.000694,172.31.40.0-255,66,51905,76,299797
3067,0.000723,74.125.24.0-255,5738,57643,76,299797
3068,0.000726,172.31.40.0-255,66,57709,76,299797
3069,0.000734,74.125.24.0-255,7156,64865,76,299797
3070,0.000736,172.31.40.0-255,66,64931,76,299797
3071,0.000758,74.125.24.0-255,2184,67115,76,299797
3072,0.00076,172.31.40.0-255,66,67181,76,299797
3073,0.001054,74.125.24.0-255,1484,68665,76,299797
3074,0.001072,74.125.24.0-255,2902,71567,76,299797
3075,0.001075,172.31.40.0-255,66,71633,76,299797
3076,0.00108,74.125.24.0-255,2902,74535,76,299797
3077,0.001082,172.31.40.0-255,66,74601,76,299797
3078,0.001095,74.125.24.0-255,2902,77503,76,299797
3079,0.001097,172.31.40.0-255,66,77569,76,299797
3080,0.001103,74.125.24.0-255,5738,83307,76,299797
3081,0.001106,172.31.40.0-255,66,83373,76,299797
3082,0.001136,74.125.24.0-255,7156,90529,76,299797
3083,0.001151,172.31.40.0-255,66,90595,76,299797
3084,0.001154,172.31.40.0-255,66,90661,76,299797
3085,0.002002,74.125.24.0-255,1484,92145,76,299797
3086,0.002013,74.125.24.0-255,2902,95047,76,299797
3087,0.002017,172.31.40.0-255,66,95113,76,299797
3088,0.002025,74.125.24.0-255,5738,100851,76,299797
3089,0.002027,172.31.40.0-255,66,100917,76,299797
3090,0.002055,74.125.24.0-255,4320,105237,76,299797
3091,0.002057,172.31.40.0-255,66,105303,76,299797
3092,0.002077,172.31.40.0-255,66,105369,76,299797
3093,0.002109,172.31.40.0-255,66,105435,76,299797
3094,0.002155,74.125.24.0-255,1484,106919,76,299797
3095,0.002179,74.125.24.0-255,2902,109821,76,299797
3096,0.002182,172.31.40.0-255,66,109887,76,299797
3097,0.002188,74.125.24.0-255,5738,115625,76,299797
3098,0.00219,172.31.40.0-255,66,115691,76,299797
3099,0.002196,74.125.24.0-255,4320,120011,76,299797
3100,0.002198,172.31.40.0-255,66,120077,76,299797
3101,0.002218,74.125.24.0-255,4320,124397,76,299797
3102,0.002221,172.31.40.0-255,66,124463,76,299797
3103,0.002243,74.125.24.0-255,1484,125947,76,299797
3104,0.002273,172.31.40.0-255,66,126013,76,299797
3105,0.002293,74.125.24.0-255,2902,128915,76,299797
3106,0.002295,172.31.40.0-255,66,128981,76,299797
3107,0.002301,74.125.24.0-255,4320,133301,76,299797
3108,0.002303,172.31.40.0-255,66,133367,76,299797
3109,0.002325,172.31.40.0-255,66,133433,76,299797
3110,0.002382,172.31.40.0-255,66,133499,76,299797
3111,0.002396,172.31.40.0-255,66,133565,76,299797
3112,0.002419,74.125.24.0-255,766,134331,76,299797
3113,0.002426,74.125.24.0-255,5738,140069,76,299797
3114,0.002428,172.31.40.0-255,66,140135,76,299797
3115,0.002449,172.31.40.0-255,66,140201,76,299797
3116,0.002471,74.125.24.0-255,7156,147357,76,299797
3117,0.002473,172.31.40.0-255,66,147423,76,299797
3118,0.00249,74.125.24.0-255,2184,149607,76,299797
3119,0.002493,172.31.40.0-255,66,149673,76,299797
3120,0.005062,74.125.24.0-255,2902,152575,76,299797
3121,0.005073,172.31.40.0-255,66,152641,76,299797
3122,0.005098,74.125.24.0-255,2902,155543,76,299797
3123,0.005102,172.31.40.0-255,66,155609,76,299797
3124,0.007652,74.125.24.0-255,2902,158511,76,299797
3125,0.007659,172.31.40.0-255,66,158577,76,299797
3126,0.007689,74.125.24.0-255,2902,161479,76,299797
3127,0.007692,172.31.40.0-255,66,161545,76,299797
3128,0.010254,74.125.24.0-255,2902,164447,76,299797
3129,0.010265,172.31.40.0-255,66,164513,76,299797
3130,0.010289,74.125.24.0-255,2902,167415,76,299797
3131,0.010292,172.31.40.0-255,66,167481,76,299797
3132,0.01288,74.125.24.0-255,5738,173219,76,299797
3133,0.012893,172.31.40.0-255,66,173285,76,299797
3134,0.015531,74.125.24.0-255,5738,179023,76,299797
3135,0.015546,172.31.40.0-255,66,179089,76,299797
3136,0.018143,74.125.24.0-255,5738,184827,76,299797
3137,0.018161,172.31.40.0-255,66,184893,76,299797
3138,0.020774,74.125.24.0-255,5738,190631,76,299797
3139,0.020791,172.31.40.0-255,66,190697,76,299797
3140,0.02341,74.125.24.0-255,5738,196435,76,299797
3141,0.023428,172.31.40.0-255,66,196501,76,299797
3142,0.026054,74.125.24.0-255,5738,202239,76,299797
3143,0.026072,172.31.40.0-255,66,202305,76,299797
3144,0.028677,74.125.24.0-255,5738,208043,76,299797
3145,0.028689,172.31.40.0-255,66,208109,76,299797
3146,0.031307,74.125.24.0-255,5738,213847,76,299797
3147,0.031325,172.31.40.0-255,66,213913,76,299797
3148,0.033951,74.125.24.0-255,5738,219651,76,299797
3149,0.033966,172.31.40.0-255,66,219717,76,299797
3150,0.035792,172.31.40.0-255,172,219889,76,299797
3151,0.03582,172.31.40.0-255,1109,220998,76,299797
3152,0.03587,172.31.40.0-255,1514,222512,76,299797
3153,0.035872,172.31.40.0-255,1309,223821,76,299797
3154,0.036566,74.125.24.0-255,5738,229559,76,299797
3155,0.036574,172.31.40.0-255,66,229625,76,299797
3156,0.037337,104.244.42.0-255,66,229691,76,299797
3157,0.037346,104.244.42.0-255,66,229757,76,299797
3158,0.037448,104.244.42.0-255,66,229823,76,299797
3159,0.039151,74.125.24.0-255,5738,235561,76,299797
3160,0.039162,172.31.40.0-255,66,235627,76,299797
3161,0.041776,74.125.24.0-255,5738,241365,76,299797
3162,0.041788,172.31.40.0-255,66,241431,76,299797
3163,0.044419,74.125.24.0-255,5738,247169,76,299797
3164,0.044436,172.31.40.0-255,66,247235,76,299797
3165,0.047038,74.125.24.0-255,5738,252973,76,299797
3166,0.047048,172.31.40.0-255,66,253039,76,299797
3167,0.049674,74.125.24.0-255,5738,258777,76,299797
3168,0.049683,172.31.40.0-255,66,258843,76,299797
3169,0.052292,74.125.24.0-255,5738,264581,76,299797
3170,0.052304,172.31.40.0-255,66,264647,76,299797
3171,0.054911,74.125.24.0-255,5738,270385,76,299797
3172,0.054921,172.31.40.0-255,66,270451,76,299797
3173,0.057538,74.125.24.0-255,5738,276189,76,299797
3174,0.057553,172.31.40.0-255,66,276255,76,299797
3175,0.060144,74.125.24.0-255,5738,281993,76,299797
3176,0.060159,172.31.40.0-255,66,282059,76,299797
3177,0.06284,74.125.24.0-255,5738,287797,76,299797
3178,0.062857,172.31.40.0-255,66,287863,76,299797
3179,0.065482,74.125.24.0-255,5738,293601,76,299797
3180,0.065492,172.31.40.0-255,66,293667,76,299797
3181,0.068115,74.125.24.0-255,5738,299405,76,299797
3182,0.068129,172.31.40.0-255,66,299471,76,299797
3183,0.070715,74.125.24.0-255,89,299560,76,299797
3184,0.070776,172.31.40.0-255,66,299626,76,299797
3185,0.070825,172.31.40.0-255,105,299731,76,299797
3186,0.073378,74.125.24.0-255,66,299797,76,299797
3187,0.0,74.125.24.0-255,146,146,76,192235
3188,2.1e-05,172.31.40.0-255,66,212,76,192235
3189,2.8e-05,74.125.24.0-255,1484,1696,76,192235
3190,3.3e-05,172.31.40.0-255,66,1762,76,192235
3191,3.6e-05,74.125.24.0-255,1484,3246,76,192235
3192,4e-05,172.31.40.0-255,66,3312,76,192235
3193,6.5e-05,74.125.24.0-255,1484,4796,76,192235
3194,6.8e-05,172.31.40.0-255,66,4862,76,192235
3195,7.6e-05,74.125.24.0-255,7156,12018,76,192235
3196,7.8e-05,172.31.40.0-255,66,12084,76,192235
3197,8.2e-05,74.125.24.0-255,2065,14149,76,192235
3198,8.4e-05,172.31.40.0-255,66,14215,76,192235
3199,0.000211,74.125.24.0-255,1484,15699,76,192235
3200,0.000216,172.31.40.0-255,66,15765,76,192235
3201,0.000233,74.125.24.0-255,2902,18667,76,192235
3202,0.000235,172.31.40.0-255,66,18733,76,192235
3203,0.000264,74.125.24.0-255,5738,24471,76,192235
3204,0.000267,172.31.40.0-255,66,24537,76,192235
3205,0.000283,74.125.24.0-255,2902,27439,76,192235
3206,0.000285,172.31.40.0-255,66,27505,76,192235
3207,0.00032,172.31.40.0-255,66,27571,76,192235
3208,0.000345,172.31.40.0-255,66,27637,76,192235
3209,0.000374,74.125.24.0-255,4320,31957,76,192235
3210,0.000376,172.31.40.0-255,66,32023,76,192235
3211,0.000391,172.31.40.0-255,66,32089,76,192235
3212,0.000673,74.125.24.0-255,401,32490,76,192235
3213,0.000677,172.31.40.0-255,66,32556,76,192235
3214,0.000936,74.125.24.0-255,109,32665,76,192235
3215,0.00094,172.31.40.0-255,66,32731,76,192235
3216,0.000969,74.125.24.0-255,1484,34215,76,192235
3217,0.000987,74.125.24.0-255,1484,35699,76,192235
3218,0.000989,172.31.40.0-255,66,35765,76,192235
3219,0.001006,74.125.24.0-255,1484,37249,76,192235
3220,0.001009,74.125.24.0-255,1484,38733,76,192235
3221,0.001011,172.31.40.0-255,66,38799,76,192235
3222,0.001034,74.125.24.0-255,2902,41701,76,192235
3223,0.001036,172.31.40.0-255,66,41767,76,192235
3224,0.001043,74.125.24.0-255,7156,48923,76,192235
3225,0.001045,172.31.40.0-255,66,48989,76,192235
3226,0.001076,74.125.24.0-255,4320,53309,76,192235
3227,0.001078,172.31.40.0-255,66,53375,76,192235
3228,0.001088,172.31.40.0-255,66,53441,76,192235
3229,0.001094,74.125.24.0-255,5020,58461,76,192235
3230,0.001095,172.31.40.0-255,66,58527,76,192235
3231,0.001173,74.125.24.0-255,1484,60011,76,192235
3232,0.001179,74.125.24.0-255,2902,62913,76,192235
3233,0.001181,172.31.40.0-255,66,62979,76,192235
3234,0.001198,74.125.24.0-255,5738,68717,76,192235
3235,0.0012,172.31.40.0-255,66,68783,76,192235
3236,0.001203,74.125.24.0-255,1484,70267,76,192235
3237,0.001229,74.125.24.0-255,5738,76005,76,192235
3238,0.001231,172.31.40.0-255,66,76071,76,192235
3239,0.001234,74.125.24.0-255,1484,77555,76,192235
3240,0.00126,172.31.40.0-255,66,77621,76,192235
3241,0.001267,74.125.24.0-255,5738,83359,76,192235
3242,0.001269,172.31.40.0-255,66,83425,76,192235
3243,0.001294,74.125.24.0-255,6438,89863,76,192235
3244,0.001297,172.31.40.0-255,66,89929,76,192235
3245,0.001312,74.125.24.0-255,2902,92831,76,192235
3246,0.001316,172.31.40.0-255,66,92897,76,192235
3247,0.001346,172.31.40.0-255,66,92963,76,192235
3248,0.001374,172.31.40.0-255,66,93029,76,192235
3249,0.001389,74.125.24.0-255,1484,94513,76,192235
3250,0.001399,74.125.24.0-255,1484,95997,76,192235
3251,0.001401,172.31.40.0-255,66,96063,76,192235
3252,0.001421,172.31.40.0-255,66,96129,76,192235
3253,0.001441,74.125.24.0-255,4320,100449,76,192235
3254,0.001444,172.31.40.0-255,66,100515,76,192235
3255,0.001465,74.125.24.0-255,7156,107671,76,192235
3256,0.001467,172.31.40.0-255,66,107737,76,192235
3257,0.001485,172.31.40.0-255,66,107803,76,192235
3258,0.001487,74.125.24.0-255,766,108569,76,192235
3259,0.001493,74.125.24.0-255,5738,114307,76,192235
3260,0.001495,172.31.40.0-255,66,114373,76,192235
3261,0.001536,172.31.40.0-255,66,114439,76,192235
3262,0.001566,74.125.24.0-255,7156,121595,76,192235
3263,0.001568,172.31.40.0-255,66,121661,76,192235
3264,0.001603,172.31.40.0-255,66,121727,76,192235
3265,0.00162,172.31.40.0-255,66,121793,76,192235
3266,0.001645,74.125.24.0-255,5738,127531,76,192235
3267,0.001648,172.31.40.0-255,66,127597,76,192235
3268,0.001651,74.125.24.0-255,1484,129081,76,192235
3269,0.00166,172.31.40.0-255,66,129147,76,192235
3270,0.001681,74.125.24.0-255,1484,130631,76,192235
3271,0.001717,74.125.24.0-255,1484,132115,76,192235
3272,0.00172,172.31.40.0-255,66,132181,76,192235
3273,0.001739,74.125.24.0-255,1484,133665,76,192235
3274,0.001745,74.125.24.0-255,4320,137985,76,192235
3275,0.001747,172.31.40.0-255,66,138051,76,192235
3276,0.001752,74.125.24.0-255,4320,142371,76,192235
3277,0.001753,172.31.40.0-255,66,142437,76,192235
3278,0.001774,74.125.24.0-255,4320,146757,76,192235
3279,0.001777,172.31.40.0-255,66,146823,76,192235
3280,0.001782,74.125.24.0-255,5738,152561,76,192235
3281,0.001784,172.31.40.0-255,66,152627,76,192235
3282,0.001819,74.125.24.0-255,1484,154111,76,192235
3283,0.001868,172.31.40.0-255,66,154177,76,192235
3284,0.001979,74.125.24.0-255,1484,155661,76,192235
3285,0.001984,74.125.24.0-255,1484,157145,76,192235
3286,0.001987,172.31.40.0-255,66,157211,76,192235
3287,0.002007,74.125.24.0-255,1484,158695,76,192235
3288,0.002014,74.125.24.0-255,5738,164433,76,192235
3289,0.002017,172.31.40.0-255,66,164499,76,192235
3290,0.002021,74.125.24.0-255,2902,167401,76,192235
3291,0.002023,172.31.40.0-255,66,167467,76,192235
3292,0.002048,74.125.24.0-255,5738,173205,76,192235
3293,0.002051,172.31.40.0-255,66,173271,76,192235
3294,0.002069,74.125.24.0-255,5738,179009,76,192235
3295,0.002072,172.31.40.0-255,66,179075,76,192235
3296,0.002096,172.31.40.0-255,66,179141,76,192235
3297,0.002107,172.31.40.0-255,66,179207,76,192235
3298,0.00214,74.125.24.0-255,1484,180691,76,192235
3299,0.002167,172.31.40.0-255,66,180757,76,192235
3300,0.0022,172.31.40.0-255,66,180823,76,192235
3301,0.002212,172.31.40.0-255,66,180889,76,192235
3302,0.002242,172.31.40.0-255,66,180955,76,192235
3303,0.002248,74.125.24.0-255,5738,186693,76,192235
3304,0.00225,172.31.40.0-255,66,186759,76,192235
3305,0.002289,172.31.40.0-255,66,186825,76,192235
3306,0.002292,74.125.24.0-255,769,187594,76,192235
3307,0.002337,74.125.24.0-255,105,187699,76,192235
3308,0.004391,172.31.40.0-255,66,187765,76,192235
3309,0.004428,172.31.40.0-255,105,187870,76,192235
3310,0.006829,74.125.24.0-255,66,187936,76,192235
3311,0.032745,172.31.40.0-255,171,188107,76,192235
3312,0.032776,172.31.40.0-255,1131,189238,76,192235
3313,0.032837,172.31.40.0-255,1514,190752,76,192235
3314,0.032839,172.31.40.0-255,1285,192037,76,192235
3315,0.034407,104.244.42.0-255,66,192103,76,192235
3316,0.034449,104.244.42.0-255,66,192169,76,192235
3317,0.034493,104.244.42.0-255,66,192235,76,192235
3318,0.0,74.125.68.0-255,152,152,76,360776
3319,2.1e-05,172.31.40.0-255,66,218,76,360776
3320,4.5e-05,74.125.68.0-255,1484,1702,76,360776
3321,4.9e-05,172.31.40.0-255,66,1768,76,360776
3322,6.6e-05,74.125.68.0-255,1484,3252,76,360776
3323,6.9e-05,172.31.40.0-255,66,3318,76,360776
3324,9.2e-05,74.125.68.0-255,2902,6220,76,360776
3325,9.5e-05,172.31.40.0-255,66,6286,76,360776
3326,0.000106,74.125.68.0-255,1484,7770,76,360776
3327,0.000108,172.31.40.0-255,66,7836,76,360776
3328,0.000112,74.125.68.0-255,1484,9320,76,360776
3329,0.000114,172.31.40.0-255,66,9386,76,360776
3330,0.000133,74.125.68.0-255,1484,10870,76,360776
3331,0.000135,172.31.40.0-255,66,10936,76,360776
3332,0.000162,74.125.68.0-255,3482,14418,76,360776
3333,0.000165,172.31.40.0-255,66,14484,76,360776
3334,0.000439,74.125.68.0-255,1484,15968,76,360776
3335,0.000444,172.31.40.0-255,66,16034,76,360776
3336,0.000448,74.125.68.0-255,1484,17518,76,360776
3337,0.000451,172.31.40.0-255,66,17584,76,360776
3338,0.000465,74.125.68.0-255,1484,19068,76,360776
3339,0.000466,172.31.40.0-255,66,19134,76,360776
3340,0.000473,74.125.68.0-255,4320,23454,76,360776
3341,0.000476,172.31.40.0-255,66,23520,76,360776
3342,0.000499,74.125.68.0-255,1484,25004,76,360776
3343,0.000502,172.31.40.0-255,66,25070,76,360776
3344,0.000528,74.125.68.0-255,6797,31867,76,360776
3345,0.000542,172.31.40.0-255,66,31933,76,360776
3346,0.000546,74.125.68.0-255,2902,34835,76,360776
3347,0.000548,172.31.40.0-255,66,34901,76,360776
3348,0.000567,74.125.68.0-255,5738,40639,76,360776
3349,0.000569,172.31.40.0-255,66,40705,76,360776
3350,0.000573,74.125.68.0-255,2902,43607,76,360776
3351,0.000574,172.31.40.0-255,66,43673,76,360776
3352,0.000579,74.125.68.0-255,4320,47993,76,360776
3353,0.000581,172.31.40.0-255,66,48059,76,360776
3354,0.000605,74.125.68.0-255,1125,49184,76,360776
3355,0.000651,74.125.68.0-255,1484,50668,76,360776
3356,0.000654,172.31.40.0-255,66,50734,76,360776
3357,0.000657,74.125.68.0-255,1484,52218,76,360776
3358,0.00069,74.125.68.0-255,1484,53702,76,360776
3359,0.000692,172.31.40.0-255,66,53768,76,360776
3360,0.000708,74.125.68.0-255,1484,55252,76,360776
3361,0.000712,74.125.68.0-255,1484,56736,76,360776
3362,0.000713,172.31.40.0-255,66,56802,76,360776
3363,0.00074,74.125.68.0-255,1484,58286,76,360776
3364,0.000746,74.125.68.0-255,4320,62606,76,360776
3365,0.000748,172.31.40.0-255,66,62672,76,360776
3366,0.00077,74.125.68.0-255,3961,66633,76,360776
3367,0.000772,172.31.40.0-255,66,66699,76,360776
3368,0.001321,74.125.68.0-255,412,67111,76,360776
3369,0.001348,74.125.68.0-255,1484,68595,76,360776
3370,0.001352,172.31.40.0-255,66,68661,76,360776
3371,0.001372,74.125.68.0-255,2902,71563,76,360776
3372,0.001374,172.31.40.0-255,66,71629,76,360776
3373,0.001397,74.125.68.0-255,4320,75949,76,360776
3374,0.001399,172.31.40.0-255,66,76015,76,360776
3375,0.001424,74.125.68.0-255,2902,78917,76,360776
3376,0.001426,172.31.40.0-255,66,78983,76,360776
3377,0.001441,74.125.68.0-255,4320,83303,76,360776
3378,0.001442,172.31.40.0-255,66,83369,76,360776
3379,0.001446,74.125.68.0-255,2902,86271,76,360776
3380,0.001448,172.31.40.0-255,66,86337,76,360776
3381,0.001475,74.125.68.0-255,5738,92075,76,360776
3382,0.001477,172.31.40.0-255,66,92141,76,360776
3383,0.001486,172.31.40.0-255,66,92207,76,360776
3384,0.001497,74.125.68.0-255,766,92973,76,360776
3385,0.001522,74.125.68.0-255,331,93304,76,360776
3386,0.003599,74.125.68.0-255,2902,96206,76,360776
3387,0.003605,172.31.40.0-255,66,96272,76,360776
3388,0.005711,74.125.68.0-255,5738,102010,76,360776
3389,0.005714,172.31.40.0-255,66,102076,76,360776
3390,0.007827,74.125.68.0-255,5738,107814,76,360776
3391,0.007834,172.31.40.0-255,66,107880,76,360776
3392,0.009956,74.125.68.0-255,4320,112200,76,360776
3393,0.009964,172.31.40.0-255,66,112266,76,360776
3394,0.00998,74.125.68.0-255,1484,113750,76,360776
3395,0.012138,74.125.68.0-255,4320,118070,76,360776
3396,0.012146,172.31.40.0-255,66,118136,76,360776
3397,0.014272,74.125.68.0-255,5738,123874,76,360776
3398,0.014279,172.31.40.0-255,66,123940,76,360776
3399,0.0164,74.125.68.0-255,5738,129678,76,360776
3400,0.016407,172.31.40.0-255,66,129744,76,360776
3401,0.018527,74.125.68.0-255,5738,135482,76,360776
3402,0.018535,172.31.40.0-255,66,135548,76,360776
3403,0.020652,74.125.68.0-255,5738,141286,76,360776
3404,0.020659,172.31.40.0-255,66,141352,76,360776
3405,0.022791,74.125.68.0-255,5738,147090,76,360776
3406,0.022798,172.31.40.0-255,66,147156,76,360776
3407,0.024917,74.125.68.0-255,5738,152894,76,360776
3408,0.024923,172.31.40.0-255,66,152960,76,360776
3409,0.026819,172.31.40.0-255,176,153136,76,360776
3410,0.02685,172.31.40.0-255,1107,154243,76,360776
3411,0.026898,172.31.40.0-255,1514,155757,76,360776
3412,0.026899,172.31.40.0-255,1309,157066,76,360776
3413,0.027042,74.125.68.0-255,1484,158550,76,360776
3414,0.027065,74.125.68.0-255,4320,162870,76,360776
3415,0.027069,172.31.40.0-255,66,162936,76,360776
3416,0.028467,104.244.42.0-255,66,163002,76,360776
3417,0.028515,104.244.42.0-255,66,163068,76,360776
3418,0.028556,104.244.42.0-255,66,163134,76,360776
3419,0.029217,74.125.68.0-255,5738,168872,76,360776
3420,0.029223,172.31.40.0-255,66,168938,76,360776
3421,0.029396,104.244.42.0-255,108,169046,76,360776
3422,0.029404,172.31.40.0-255,66,169112,76,360776
3423,0.031379,74.125.68.0-255,5738,174850,76,360776
3424,0.031386,172.31.40.0-255,66,174916,76,360776
3425,0.033531,74.125.68.0-255,5738,180654,76,360776
3426,0.033537,172.31.40.0-255,66,180720,76,360776
3427,0.035686,74.125.68.0-255,5738,186458,76,360776
3428,0.035692,172.31.40.0-255,66,186524,76,360776
3429,0.037825,74.125.68.0-255,5738,192262,76,360776
3430,0.037832,172.31.40.0-255,66,192328,76,360776
3431,0.040012,74.125.68.0-255,5738,198066,76,360776
3432,0.040018,172.31.40.0-255,66,198132,76,360776
3433,0.042139,74.125.68.0-255,5738,203870,76,360776
3434,0.042145,172.31.40.0-255,66,203936,76,360776
3435,0.044265,74.125.68.0-255,5738,209674,76,360776
3436,0.044271,172.31.40.0-255,66,209740,76,360776
3437,0.046401,74.125.68.0-255,5738,215478,76,360776
3438,0.046407,172.31.40.0-255,66,215544,76,360776
3439,0.04854,74.125.68.0-255,5738,221282,76,360776
3440,0.048547,172.31.40.0-255,66,221348,76,360776
3441,0.050662,74.125.68.0-255,5738,227086,76,360776
3442,0.050668,172.31.40.0-255,66,227152,76,360776
3443,0.052805,74.125.68.0-255,5738,232890,76,360776
3444,0.05281,172.31.40.0-255,66,232956,76,360776
3445,0.054935,74.125.68.0-255,5738,238694,76,360776
3446,0.054942,172.31.40.0-255,66,238760,76,360776
3447,0.057075,74.125.68.0-255,5738,244498,76,360776
3448,0.057082,172.31.40.0-255,66,244564,76,360776
3449,0.059221,74.125.68.0-255,5738,250302,76,360776
3450,0.059231,172.31.40.0-255,66,250368,76,360776
3451,0.061358,74.125.68.0-255,5738,256106,76,360776
3452,0.061363,172.31.40.0-255,66,256172,76,360776
3453,0.063551,74.125.68.0-255,5738,261910,76,360776
3454,0.063557,172.31.40.0-255,66,261976,76,360776
3455,0.065676,74.125.68.0-255,5738,267714,76,360776
3456,0.065684,172.31.40.0-255,66,267780,76,360776
3457,0.067816,74.125.68.0-255,5738,273518,76,360776
3458,0.067821,172.31.40.0-255,66,273584,76,360776
3459,0.069948,74.125.68.0-255,5738,279322,76,360776
3460,0.069955,172.31.40.0-255,66,279388,76,360776
3461,0.072083,74.125.68.0-255,5738,285126,76,360776
3462,0.072088,172.31.40.0-255,66,285192,76,360776
3463,0.074215,74.125.68.0-255,2902,288094,76,360776
3464,0.074221,172.31.40.0-255,66,288160,76,360776
3465,0.074243,74.125.68.0-255,2902,291062,76,360776
3466,0.074246,172.31.40.0-255,66,291128,76,360776
3467,0.076356,74.125.68.0-255,5738,296866,76,360776
3468,0.076363,172.31.40.0-255,66,296932,76,360776
3469,0.078479,74.125.68.0-255,5738,302670,76,360776
3470,0.078484,172.31.40.0-255,66,302736,76,360776
3471,0.08063,74.125.68.0-255,5738,308474,76,360776
3472,0.080637,172.31.40.0-255,66,308540,76,360776
3473,0.082771,74.125.68.0-255,5738,314278,76,360776
3474,0.082778,172.31.40.0-255,66,314344,76,360776
3475,0.0849,74.125.68.0-255,5738,320082,76,360776
3476,0.084906,172.31.40.0-255,66,320148,76,360776
3477,0.087032,74.125.68.0-255,5738,325886,76,360776
3478,0.087037,172.31.40.0-255,66,325952,76,360776
3479,0.089159,74.125.68.0-255,5738,331690,76,360776
3480,0.089165,172.31.40.0-255,66,331756,76,360776
3481,0.091293,74.125.68.0-255,5738,337494,76,360776
3482,0.091299,172.31.40.0-255,66,337560,76,360776
3483,0.093432,74.125.68.0-255,5738,343298,76,360776
3484,0.093439,172.31.40.0-255,66,343364,76,360776
3485,0.095557,74.125.68.0-255,5738,349102,76,360776
3486,0.095563,172.31.40.0-255,66,349168,76,360776
3487,0.09771,74.125.68.0-255,5738,354906,76,360776
3488,0.097717,172.31.40.0-255,66,354972,76,360776
3489,0.099839,74.125.68.0-255,5738,360710,76,360776
3490,0.099846,172.31.40.0-255,66,360776,76,360776
3491,0.0,74.125.68.0-255,153,153,76,339618
3492,2.6e-05,172.31.40.0-255,66,219,76,339618
3493,3.4e-05,74.125.68.0-255,1484,1703,76,339618
3494,3.9e-05,172.31.40.0-255,66,1769,76,339618
3495,4.4e-05,74.125.68.0-255,2902,4671,76,339618
3496,4.8e-05,172.31.40.0-255,66,4737,76,339618
3497,7.4e-05,74.125.68.0-255,7156,11893,76,339618
3498,7.7e-05,172.31.40.0-255,66,11959,76,339618
3499,8e-05,74.125.68.0-255,1484,13443,76,339618
3500,8.3e-05,172.31.40.0-255,66,13509,76,339618
3501,0.000106,74.125.68.0-255,4320,17829,76,339618
3502,0.000109,172.31.40.0-255,66,17895,76,339618
3503,0.000135,74.125.68.0-255,6317,24212,76,339618
3504,0.000138,172.31.40.0-255,66,24278,76,339618
3505,0.000145,74.125.68.0-255,6797,31075,76,339618
3506,0.000147,172.31.40.0-255,66,31141,76,339618
3507,0.00023,74.125.68.0-255,1484,32625,76,339618
3508,0.000234,172.31.40.0-255,66,32691,76,339618
3509,0.000239,74.125.68.0-255,2902,35593,76,339618
3510,0.000242,172.31.40.0-255,66,35659,76,339618
3511,0.000257,74.125.68.0-255,1484,37143,76,339618
3512,0.000259,172.31.40.0-255,66,37209,76,339618
3513,0.000281,74.125.68.0-255,4320,41529,76,339618
3514,0.000284,172.31.40.0-255,66,41595,76,339618
3515,0.000289,74.125.68.0-255,4320,45915,76,339618
3516,0.000292,172.31.40.0-255,66,45981,76,339618
3517,0.000296,74.125.68.0-255,2902,48883,76,339618
3518,0.000299,172.31.40.0-255,66,48949,76,339618
3519,0.00032,74.125.68.0-255,2543,51492,76,339618
3520,0.000322,172.31.40.0-255,66,51558,76,339618
3521,0.000329,74.125.68.0-255,5738,57296,76,339618
3522,0.000331,172.31.40.0-255,66,57362,76,339618
3523,0.000344,74.125.68.0-255,2902,60264,76,339618
3524,0.000346,172.31.40.0-255,66,60330,76,339618
3525,0.000383,74.125.68.0-255,5734,66064,76,339618
3526,0.000386,172.31.40.0-255,66,66130,76,339618
3527,0.000466,74.125.68.0-255,1484,67614,76,339618
3528,0.000472,74.125.68.0-255,1484,69098,76,339618
3529,0.000475,172.31.40.0-255,66,69164,76,339618
3530,0.000492,74.125.68.0-255,1484,70648,76,339618
3531,0.000509,74.125.68.0-255,1484,72132,76,339618
3532,0.000511,172.31.40.0-255,66,72198,76,339618
3533,0.000517,74.125.68.0-255,4320,76518,76,339618
3534,0.00052,172.31.40.0-255,66,76584,76,339618
3535,0.000532,74.125.68.0-255,1484,78068,76,339618
3536,0.000552,74.125.68.0-255,7040,85108,76,339618
3537,0.000555,172.31.40.0-255,66,85174,76,339618
3538,0.000562,74.125.68.0-255,7156,92330,76,339618
3539,0.000564,172.31.40.0-255,66,92396,76,339618
3540,0.000575,74.125.68.0-255,1484,93880,76,339618
3541,0.000591,74.125.68.0-255,6797,100677,76,339618
3542,0.000593,172.31.40.0-255,66,100743,76,339618
3543,0.001005,74.125.68.0-255,1484,102227,76,339618
3544,0.001028,74.125.68.0-255,2902,105129,76,339618
3545,0.001032,172.31.40.0-255,66,105195,76,339618
3546,0.001039,74.125.68.0-255,5738,110933,76,339618
3547,0.001041,172.31.40.0-255,66,110999,76,339618
3548,0.001045,74.125.68.0-255,2902,113901,76,339618
3549,0.001048,172.31.40.0-255,66,113967,76,339618
3550,0.001052,74.125.68.0-255,4320,118287,76,339618
3551,0.001055,172.31.40.0-255,66,118353,76,339618
3552,0.001091,172.31.40.0-255,66,118419,76,339618
3553,0.001098,74.125.68.0-255,5738,124157,76,339618
3554,0.001101,172.31.40.0-255,66,124223,76,339618
3555,0.001141,74.125.68.0-255,2184,126407,76,339618
3556,0.001149,172.31.40.0-255,66,126473,76,339618
3557,0.001169,74.125.68.0-255,2902,129375,76,339618
3558,0.001172,172.31.40.0-255,66,129441,76,339618
3559,0.001196,74.125.68.0-255,7156,136597,76,339618
3560,0.001198,172.31.40.0-255,66,136663,76,339618
3561,0.001219,74.125.68.0-255,4320,140983,76,339618
3562,0.001221,172.31.40.0-255,66,141049,76,339618
3563,0.001246,74.125.68.0-255,4320,145369,76,339618
3564,0.001248,172.31.40.0-255,66,145435,76,339618
3565,0.00126,172.31.40.0-255,66,145501,76,339618
3566,0.001283,74.125.68.0-255,2902,148403,76,339618
3567,0.001285,172.31.40.0-255,66,148469,76,339618
3568,0.001291,74.125.68.0-255,3602,152071,76,339618
3569,0.001293,172.31.40.0-255,66,152137,76,339618
3570,0.001356,74.125.68.0-255,1484,153621,76,339618
3571,0.00137,74.125.68.0-255,2902,156523,76,339618
3572,0.001374,172.31.40.0-255,66,156589,76,339618
3573,0.001396,74.125.68.0-255,5738,162327,76,339618
3574,0.001399,172.31.40.0-255,66,162393,76,339618
3575,0.001424,74.125.68.0-255,7156,169549,76,339618
3576,0.001441,172.31.40.0-255,66,169615,76,339618
3577,0.001453,74.125.68.0-255,5738,175353,76,339618
3578,0.001458,172.31.40.0-255,66,175419,76,339618
3579,0.001468,74.125.68.0-255,7156,182575,76,339618
3580,0.001488,172.31.40.0-255,66,182641,76,339618
3581,0.0015,74.125.68.0-255,3602,186243,76,339618
3582,0.001529,172.31.40.0-255,66,186309,76,339618
3583,0.001631,74.125.68.0-255,1484,187793,76,339618
3584,0.001644,74.125.68.0-255,1484,189277,76,339618
3585,0.001647,172.31.40.0-255,66,189343,76,339618
3586,0.001652,74.125.68.0-255,2902,192245,76,339618
3587,0.001657,172.31.40.0-255,66,192311,76,339618
3588,0.001678,74.125.68.0-255,5738,198049,76,339618
3589,0.001691,74.125.68.0-255,1484,199533,76,339618
3590,0.001699,172.31.40.0-255,66,199599,76,339618
3591,0.001712,74.125.68.0-255,7156,206755,76,339618
3592,0.001736,172.31.40.0-255,66,206821,76,339618
3593,0.001756,74.125.68.0-255,3602,210423,76,339618
3594,0.001762,172.31.40.0-255,66,210489,76,339618
3595,0.001842,74.125.68.0-255,1484,211973,76,339618
3596,0.001856,74.125.68.0-255,2902,214875,76,339618
3597,0.001874,74.125.68.0-255,5738,220613,76,339618
3598,0.001911,172.31.40.0-255,66,220679,76,339618
3599,0.001949,74.125.68.0-255,2184,222863,76,339618
3600,0.001966,172.31.40.0-255,66,222929,76,339618
3601,0.001971,74.125.68.0-255,2902,225831,76,339618
3602,0.001974,74.125.68.0-255,1484,227315,76,339618
3603,0.00198,172.31.40.0-255,66,227381,76,339618
3604,0.001991,74.125.68.0-255,5738,233119,76,339618
3605,0.002006,74.125.68.0-255,7156,240275,76,339618
3606,0.002047,74.125.68.0-255,1484,241759,76,339618
3607,0.00205,172.31.40.0-255,66,241825,76,339618
3608,0.002067,74.125.68.0-255,6438,248263,76,339618
3609,0.002083,74.125.68.0-255,4320,252583,76,339618
3610,0.002096,74.125.68.0-255,4320,256903,76,339618
3611,0.002102,74.125.68.0-255,4320,261223,76,339618
3612,0.002112,172.31.40.0-255,66,261289,76,339618
3613,0.002115,74.125.68.0-255,1484,262773,76,339618
3614,0.002128,74.125.68.0-255,4320,267093,76,339618
3615,0.002149,74.125.68.0-255,5738,272831,76,339618
3616,0.002164,74.125.68.0-255,5738,278569,76,339618
3617,0.002169,74.125.68.0-255,3602,282171,76,339618
3618,0.002182,172.31.40.0-255,66,282237,76,339618
3619,0.002211,74.125.68.0-255,1484,283721,76,339618
3620,0.002232,74.125.68.0-255,5738,289459,76,339618
3621,0.002246,172.31.40.0-255,66,289525,76,339618
3622,0.00226,74.125.68.0-255,1484,291009,76,339618
3623,0.002284,172.31.40.0-255,66,291075,76,339618
3624,0.002301,74.125.68.0-255,2902,293977,76,339618
3625,0.002321,172.31.40.0-255,66,294043,76,339618
3626,0.002334,74.125.68.0-255,4320,298363,76,339618
3627,0.00234,172.31.40.0-255,66,298429,76,339618
3628,0.002359,74.125.68.0-255,2902,301331,76,339618
3629,0.002376,74.125.68.0-255,7156,308487,76,339618
3630,0.002389,74.125.68.0-255,4320,312807,76,339618
3631,0.002392,172.31.40.0-255,66,312873,76,339618
3632,0.002396,172.31.40.0-255,66,312939,76,339618
3633,0.004711,74.125.68.0-255,1484,314423,76,339618
3634,0.004735,74.125.68.0-255,4320,318743,76,339618
3635,0.00474,172.31.40.0-255,66,318809,76,339618
3636,0.007071,74.125.68.0-255,5738,324547,76,339618
3637,0.007078,172.31.40.0-255,66,324613,76,339618
3638,0.009408,74.125.68.0-255,5738,330351,76,339618
3639,0.009412,172.31.40.0-255,66,330417,76,339618
3640,0.01174,74.125.68.0-255,4664,335081,76,339618
3641,0.011747,172.31.40.0-255,66,335147,76,339618
3642,0.01224,172.31.40.0-255,105,335252,76,339618
3643,0.014532,74.125.68.0-255,66,335318,76,339618
3644,0.0326,172.31.40.0-255,172,335490,76,339618
3645,0.032632,172.31.40.0-255,1107,336597,76,339618
3646,0.032693,172.31.40.0-255,1514,338111,76,339618
3647,0.032695,172.31.40.0-255,1309,339420,76,339618
3648,0.034165,104.244.42.0-255,66,339486,76,339618
3649,0.034176,104.244.42.0-255,66,339552,76,339618
3650,0.034259,104.244.42.0-255,66,339618,76,339618
3651,0.0,172.217.194.0-255,152,152,76,253504
3652,1.3e-05,172.31.40.0-255,66,218,76,253504
3653,2e-05,172.217.194.0-255,1484,1702,76,253504
3654,2.5e-05,172.31.40.0-255,66,1768,76,253504
3655,3.1e-05,172.217.194.0-255,2902,4670,76,253504
3656,4.1e-05,172.31.40.0-255,66,4736,76,253504
3657,4.4e-05,172.217.194.0-255,1484,6220,76,253504
3658,4.7e-05,172.31.40.0-255,66,6286,76,253504
3659,9e-05,172.217.194.0-255,4320,10606,76,253504
3660,9.3e-05,172.31.40.0-255,66,10672,76,253504
3661,0.000111,172.217.194.0-255,3516,14188,76,253504
3662,0.000114,172.31.40.0-255,66,14254,76,253504
3663,0.000166,172.217.194.0-255,1484,15738,76,253504
3664,0.000168,172.31.40.0-255,66,15804,76,253504
3665,0.000172,172.217.194.0-255,1484,17288,76,253504
3666,0.000174,172.31.40.0-255,66,17354,76,253504
3667,0.000204,172.217.194.0-255,1484,18838,76,253504
3668,0.000206,172.31.40.0-255,66,18904,76,253504
3669,0.000213,172.217.194.0-255,5738,24642,76,253504
3670,0.000216,172.31.40.0-255,66,24708,76,253504
3671,0.000267,172.217.194.0-255,6797,31505,76,253504
3672,0.00027,172.31.40.0-255,66,31571,76,253504
3673,0.000362,172.217.194.0-255,1484,33055,76,253504
3674,0.000365,172.31.40.0-255,66,33121,76,253504
3675,0.000371,172.217.194.0-255,2902,36023,76,253504
3676,0.000374,172.31.40.0-255,66,36089,76,253504
3677,0.000385,172.217.194.0-255,5738,41827,76,253504
3678,0.000388,172.31.40.0-255,66,41893,76,253504
3679,0.000416,172.217.194.0-255,5738,47631,76,253504
3680,0.000418,172.31.40.0-255,66,47697,76,253504
3681,0.000443,172.217.194.0-255,5379,53076,76,253504
3682,0.000445,172.31.40.0-255,66,53142,76,253504
3683,0.000458,172.31.40.0-255,66,53208,76,253504
3684,0.00071,172.217.194.0-255,122,53330,76,253504
3685,0.00073,172.217.194.0-255,375,53705,76,253504
3686,0.001244,172.217.194.0-255,1484,55189,76,253504
3687,0.001251,172.31.40.0-255,66,55255,76,253504
3688,0.001258,172.217.194.0-255,2902,58157,76,253504
3689,0.00126,172.31.40.0-255,66,58223,76,253504
3690,0.001264,172.217.194.0-255,2902,61125,76,253504
3691,0.001266,172.31.40.0-255,66,61191,76,253504
3692,0.001296,172.217.194.0-255,2902,64093,76,253504
3693,0.001298,172.31.40.0-255,66,64159,76,253504
3694,0.001312,172.31.40.0-255,66,64225,76,253504
3695,0.001325,172.31.40.0-255,66,64291,76,253504
3696,0.001364,172.217.194.0-255,1484,65775,76,253504
3697,0.00137,172.217.194.0-255,2902,68677,76,253504
3698,0.001373,172.31.40.0-255,66,68743,76,253504
3699,0.001402,172.217.194.0-255,5738,74481,76,253504
3700,0.001405,172.31.40.0-255,66,74547,76,253504
3701,0.00142,172.31.40.0-255,66,74613,76,253504
3702,0.001463,172.217.194.0-255,4320,78933,76,253504
3703,0.001466,172.31.40.0-255,66,78999,76,253504
3704,0.001508,172.31.40.0-255,66,79065,76,253504
3705,0.002221,172.217.194.0-255,1484,80549,76,253504
3706,0.002228,172.217.194.0-255,1484,82033,76,253504
3707,0.002232,172.31.40.0-255,66,82099,76,253504
3708,0.002245,172.217.194.0-255,1484,83583,76,253504
3709,0.002257,172.217.194.0-255,5738,89321,76,253504
3710,0.00226,172.31.40.0-255,66,89387,76,253504
3711,0.002267,172.217.194.0-255,5738,95125,76,253504
3712,0.002269,172.31.40.0-255,66,95191,76,253504
3713,0.00231,172.217.194.0-255,7156,102347,76,253504
3714,0.002313,172.31.40.0-255,66,102413,76,253504
3715,0.002325,172.31.40.0-255,66,102479,76,253504
3716,0.002434,172.217.194.0-255,1484,103963,76,253504
3717,0.002451,172.217.194.0-255,2902,106865,76,253504
3718,0.002453,172.31.40.0-255,66,106931,76,253504
3719,0.002458,172.217.194.0-255,4320,111251,76,253504
3720,0.00246,172.31.40.0-255,66,111317,76,253504
3721,0.002478,172.217.194.0-255,1484,112801,76,253504
3722,0.00248,172.217.194.0-255,1484,114285,76,253504
3723,0.002482,172.31.40.0-255,66,114351,76,253504
3724,0.00252,172.31.40.0-255,66,114417,76,253504
3725,0.002523,172.217.194.0-255,1484,115901,76,253504
3726,0.00254,172.217.194.0-255,7156,123057,76,253504
3727,0.002543,172.31.40.0-255,66,123123,76,253504
3728,0.002559,172.217.194.0-255,2184,125307,76,253504
3729,0.002561,172.31.40.0-255,66,125373,76,253504
3730,0.002596,172.217.194.0-255,1484,126857,76,253504
3731,0.002613,172.217.194.0-255,1484,128341,76,253504
3732,0.002615,172.31.40.0-255,66,128407,76,253504
3733,0.002628,172.217.194.0-255,4320,132727,76,253504
3734,0.002634,172.31.40.0-255,66,132793,76,253504
3735,0.002636,172.217.194.0-255,1484,134277,76,253504
3736,0.002656,172.217.194.0-255,1484,135761,76,253504
3737,0.002658,172.31.40.0-255,66,135827,76,253504
3738,0.002695,172.217.194.0-255,5738,141565,76,253504
3739,0.002697,172.31.40.0-255,66,141631,76,253504
3740,0.002723,172.217.194.0-255,5738,147369,76,253504
3741,0.002725,172.31.40.0-255,66,147435,76,253504
3742,0.002736,172.31.40.0-255,66,147501,76,253504
3743,0.002763,172.217.194.0-255,7156,154657,76,253504
3744,0.002766,172.31.40.0-255,66,154723,76,253504
3745,0.002768,172.217.194.0-255,1484,156207,76,253504
3746,0.002771,172.217.194.0-255,1484,157691,76,253504
3747,0.002772,172.31.40.0-255,66,157757,76,253504
3748,0.002808,172.31.40.0-255,66,157823,76,253504
3749,0.002814,172.217.194.0-255,5738,163561,76,253504
3750,0.002816,172.31.40.0-255,66,163627,76,253504
3751,0.002847,172.31.40.0-255,66,163693,76,253504
3752,0.002849,172.217.194.0-255,766,164459,76,253504
3753,0.002853,172.217.194.0-255,2902,167361,76,253504
3754,0.002855,172.31.40.0-255,66,167427,76,253504
3755,0.002889,172.31.40.0-255,66,167493,76,253504
3756,0.002895,172.217.194.0-255,5738,173231,76,253504
3757,0.002898,172.31.40.0-255,66,173297,76,253504
3758,0.002919,172.31.40.0-255,66,173363,76,253504
3759,0.002924,172.217.194.0-255,5020,178383,76,253504
3760,0.002926,172.31.40.0-255,66,178449,76,253504
3761,0.003046,172.217.194.0-255,1484,179933,76,253504
3762,0.00305,172.217.194.0-255,1484,181417,76,253504
3763,0.003052,172.31.40.0-255,66,181483,76,253504
3764,0.003079,172.217.194.0-255,1484,182967,76,253504
3765,0.003086,172.217.194.0-255,5738,188705,76,253504
3766,0.003088,172.31.40.0-255,66,188771,76,253504
3767,0.003096,172.217.194.0-255,7156,195927,76,253504
3768,0.003098,172.31.40.0-255,66,195993,76,253504
3769,0.003128,172.217.194.0-255,5738,201731,76,253504
3770,0.00313,172.31.40.0-255,66,201797,76,253504
3771,0.003133,172.217.194.0-255,1484,203281,76,253504
3772,0.00347,172.217.194.0-255,1484,204765,76,253504
3773,0.003474,172.217.194.0-255,1484,206249,76,253504
3774,0.003494,172.217.194.0-255,1484,207733,76,253504
3775,0.0035,172.217.194.0-255,5738,213471,76,253504
3776,0.003527,172.217.194.0-255,5738,219209,76,253504
3777,0.003542,172.217.194.0-255,1484,220693,76,253504
3778,0.003569,172.217.194.0-255,5738,226431,76,253504
3779,0.003573,172.217.194.0-255,2184,228615,76,253504
3780,0.003741,172.217.194.0-255,1484,230099,76,253504
3781,0.003765,172.217.194.0-255,2902,233001,76,253504
3782,0.003771,172.217.194.0-255,5738,238739,76,253504
3783,0.003793,172.217.194.0-255,1484,240223,76,253504
3784,0.003831,172.217.194.0-255,5738,245961,76,253504
3785,0.003876,172.217.194.0-255,2902,248863,76,253504
3786,0.003902,172.217.194.0-255,105,248968,76,253504
3787,0.006011,172.31.40.0-255,66,249034,76,253504
3788,0.008547,172.31.40.0-255,105,249139,76,253504
3789,0.011103,172.217.194.0-255,66,249205,76,253504
3790,0.029603,172.31.40.0-255,171,249376,76,253504
3791,0.029639,172.31.40.0-255,1131,250507,76,253504
3792,0.029702,172.31.40.0-255,1514,252021,76,253504
3793,0.029722,172.31.40.0-255,1285,253306,76,253504
3794,0.031165,104.244.42.0-255,66,253372,76,253504
3795,0.03122,104.244.42.0-255,66,253438,76,253504
3796,0.031262,104.244.42.0-255,66,253504,76,253504
3797,0.0,172.217.194.0-255,147,147,76,239711
3798,1.5e-05,172.31.40.0-255,66,213,76,239711
3799,2.1e-05,172.217.194.0-255,1484,1697,76,239711
3800,2.5e-05,172.31.40.0-255,66,1763,76,239711
3801,3e-05,172.217.194.0-255,2902,4665,76,239711
3802,3.9e-05,172.31.40.0-255,66,4731,76,239711
3803,4.1e-05,172.217.194.0-255,1484,6215,76,239711
3804,4.4e-05,172.31.40.0-255,66,6281,76,239711
3805,7.6e-05,172.217.194.0-255,4320,10601,76,239711
3806,7.9e-05,172.31.40.0-255,66,10667,76,239711
3807,0.000135,172.217.194.0-255,3475,14142,76,239711
3808,0.000138,172.31.40.0-255,66,14208,76,239711
3809,0.000188,172.217.194.0-255,4320,18528,76,239711
3810,0.00019,172.31.40.0-255,66,18594,76,239711
3811,0.000251,172.217.194.0-255,2902,21496,76,239711
3812,0.000254,172.31.40.0-255,66,21562,76,239711
3813,0.00028,172.217.194.0-255,7156,28718,76,239711
3814,0.000282,172.31.40.0-255,66,28784,76,239711
3815,0.0004,172.217.194.0-255,2543,31327,76,239711
3816,0.00041,172.31.40.0-255,66,31393,76,239711
3817,0.000447,172.31.40.0-255,66,31459,76,239711
3818,0.000468,172.217.194.0-255,6797,38256,76,239711
3819,0.00047,172.31.40.0-255,66,38322,76,239711
3820,0.000688,172.217.194.0-255,4320,42642,76,239711
3821,0.000692,172.31.40.0-255,66,42708,76,239711
3822,0.000727,172.31.40.0-255,66,42774,76,239711
3823,0.000927,172.217.194.0-255,367,43141,76,239711
3824,0.00093,172.31.40.0-255,66,43207,76,239711
3825,0.000957,172.217.194.0-255,4320,47527,76,239711
3826,0.000961,172.31.40.0-255,66,47593,76,239711
3827,0.000999,172.31.40.0-255,66,47659,76,239711
3828,0.001025,172.217.194.0-255,3961,51620,76,239711
3829,0.001027,172.31.40.0-255,66,51686,76,239711
3830,0.001235,172.217.194.0-255,1484,53170,76,239711
3831,0.00127,172.31.40.0-255,66,53236,76,239711
3832,0.001802,172.217.194.0-255,1484,54720,76,239711
3833,0.001822,172.217.194.0-255,2902,57622,76,239711
3834,0.001845,172.217.194.0-255,1484,59106,76,239711
3835,0.001858,172.217.194.0-255,2902,62008,76,239711
3836,0.001868,172.217.194.0-255,1484,63492,76,239711
3837,0.00192,172.217.194.0-255,1484,64976,76,239711
3838,0.001936,172.217.194.0-255,1484,66460,76,239711
3839,0.001951,172.217.194.0-255,5738,72198,76,239711
3840,0.001962,172.217.194.0-255,2902,75100,76,239711
3841,0.00209,172.217.194.0-255,2902,78002,76,239711
3842,0.002265,172.217.194.0-255,2902,80904,76,239711
3843,0.00228,172.217.194.0-255,2902,83806,76,239711
3844,0.002299,172.217.194.0-255,7156,90962,76,239711
3845,0.002482,172.217.194.0-255,4320,95282,76,239711
3846,0.002493,172.217.194.0-255,4320,99602,76,239711
3847,0.002856,172.217.194.0-255,4320,103922,76,239711
3848,0.002943,172.217.194.0-255,5738,109660,76,239711
3849,0.002962,172.217.194.0-255,3602,113262,76,239711
3850,0.003671,172.217.194.0-255,2902,116164,76,239711
3851,0.004164,172.31.40.0-255,66,116230,76,239711
3852,0.00664,172.217.194.0-255,5738,121968,76,239711
3853,0.006646,172.31.40.0-255,66,122034,76,239711
3854,0.009111,172.217.194.0-255,2902,124936,76,239711
3855,0.009127,172.217.194.0-255,2902,127838,76,239711
3856,0.009648,172.31.40.0-255,66,127904,76,239711
3857,0.012081,172.217.194.0-255,5738,133642,76,239711
3858,0.012088,172.31.40.0-255,66,133708,76,239711
3859,0.014535,172.217.194.0-255,5738,139446,76,239711
3860,0.014625,172.31.40.0-255,66,139512,76,239711
3861,0.017083,172.217.194.0-255,5738,145250,76,239711
3862,0.017093,172.31.40.0-255,66,145316,76,239711
3863,0.019552,172.217.194.0-255,5738,151054,76,239711
3864,0.019561,172.31.40.0-255,66,151120,76,239711
3865,0.022034,172.217.194.0-255,5738,156858,76,239711
3866,0.02204,172.31.40.0-255,66,156924,76,239711
3867,0.024497,172.217.194.0-255,4320,161244,76,239711
3868,0.024504,172.31.40.0-255,66,161310,76,239711
3869,0.024534,172.217.194.0-255,1484,162794,76,239711
3870,0.026971,172.217.194.0-255,4320,167114,76,239711
3871,0.026978,172.31.40.0-255,66,167180,76,239711
3872,0.029438,172.217.194.0-255,5738,172918,76,239711
3873,0.03001,172.31.40.0-255,66,172984,76,239711
3874,0.030399,172.31.40.0-255,172,173156,76,239711
3875,0.03043,172.31.40.0-255,1109,174265,76,239711
3876,0.030493,172.31.40.0-255,1514,175779,76,239711
3877,0.030495,172.31.40.0-255,1307,177086,76,239711
3878,0.032073,104.244.42.0-255,66,177152,76,239711
3879,0.03211,104.244.42.0-255,66,177218,76,239711
3880,0.032156,104.244.42.0-255,66,177284,76,239711
3881,0.032459,172.217.194.0-255,5738,183022,76,239711
3882,0.032465,172.31.40.0-255,66,183088,76,239711
3883,0.034909,172.217.194.0-255,5738,188826,76,239711
3884,0.034916,172.31.40.0-255,66,188892,76,239711
3885,0.037387,172.217.194.0-255,5738,194630,76,239711
3886,0.037393,172.31.40.0-255,66,194696,76,239711
3887,0.039869,172.217.194.0-255,5738,200434,76,239711
3888,0.039876,172.31.40.0-255,66,200500,76,239711
3889,0.042391,172.217.194.0-255,5738,206238,76,239711
3890,0.042397,172.31.40.0-255,66,206304,76,239711
3891,0.044893,172.217.194.0-255,5738,212042,76,239711
3892,0.044899,172.31.40.0-255,66,212108,76,239711
3893,0.047342,172.217.194.0-255,5738,217846,76,239711
3894,0.047348,172.31.40.0-255,66,217912,76,239711
3895,0.049797,172.217.194.0-255,5738,223650,76,239711
3896,0.049802,172.31.40.0-255,66,223716,76,239711
3897,0.052257,172.217.194.0-255,5738,229454,76,239711
3898,0.052263,172.31.40.0-255,66,229520,76,239711
3899,0.054737,172.217.194.0-255,5738,235258,76,239711
3900,0.054744,172.31.40.0-255,66,235324,76,239711
3901,0.057213,172.217.194.0-255,4150,239474,76,239711
3902,0.057219,172.31.40.0-255,66,239540,76,239711
3903,0.057395,172.31.40.0-255,105,239645,76,239711
3904,0.059794,172.217.194.0-255,66,239711,76,239711
3905,0.0,74.125.68.0-255,145,145,76,379348
3906,1.8e-05,172.31.40.0-255,66,211,76,379348
3907,4.5e-05,74.125.68.0-255,1484,1695,76,379348
3908,5e-05,172.31.40.0-255,66,1761,76,379348
3909,6.5e-05,74.125.68.0-255,2902,4663,76,379348
3910,6.8e-05,172.31.40.0-255,66,4729,76,379348
3911,8.9e-05,74.125.68.0-255,2902,7631,76,379348
3912,9.2e-05,172.31.40.0-255,66,7697,76,379348
3913,0.000118,74.125.68.0-255,2902,10599,76,379348
3914,0.000121,172.31.40.0-255,66,10665,76,379348
3915,0.000126,74.125.68.0-255,2902,13567,76,379348
3916,0.000128,172.31.40.0-255,66,13633,76,379348
3917,0.000133,74.125.68.0-255,3481,17114,76,379348
3918,0.000135,172.31.40.0-255,66,17180,76,379348
3919,0.000141,74.125.68.0-255,4320,21500,76,379348
3920,0.000144,172.31.40.0-255,66,21566,76,379348
3921,0.000182,74.125.68.0-255,5738,27304,76,379348
3922,0.000187,172.31.40.0-255,66,27370,76,379348
3923,0.000191,74.125.68.0-255,2902,30272,76,379348
3924,0.000193,172.31.40.0-255,66,30338,76,379348
3925,0.000207,74.125.68.0-255,1125,31463,76,379348
3926,0.000209,172.31.40.0-255,66,31529,76,379348
3927,0.000289,74.125.68.0-255,1484,33013,76,379348
3928,0.000294,172.31.40.0-255,66,33079,76,379348
3929,0.000315,74.125.68.0-255,1484,34563,76,379348
3930,0.000318,172.31.40.0-255,66,34629,76,379348
3931,0.000322,74.125.68.0-255,1484,36113,76,379348
3932,0.000324,172.31.40.0-255,66,36179,76,379348
3933,0.000342,74.125.68.0-255,1484,37663,76,379348
3934,0.000345,172.31.40.0-255,66,37729,76,379348
3935,0.000353,74.125.68.0-255,5738,43467,76,379348
3936,0.000355,172.31.40.0-255,66,43533,76,379348
3937,0.000383,74.125.68.0-255,4320,47853,76,379348
3938,0.00039,74.125.68.0-255,5738,53591,76,379348
3939,0.000397,74.125.68.0-255,5738,59329,76,379348
3940,0.000441,74.125.68.0-255,1484,60813,76,379348
3941,0.000456,74.125.68.0-255,5020,65833,76,379348
3942,0.000479,74.125.68.0-255,400,66233,76,379348
3943,0.000509,74.125.68.0-255,109,66342,76,379348
3944,0.000574,172.31.40.0-255,66,66408,76,379348
3945,0.000646,74.125.68.0-255,1484,67892,76,379348
3946,0.000653,74.125.68.0-255,2902,70794,76,379348
3947,0.00067,172.31.40.0-255,66,70860,76,379348
3948,0.000674,74.125.68.0-255,1484,72344,76,379348
3949,0.000697,74.125.68.0-255,4320,76664,76,379348
3950,0.000703,74.125.68.0-255,2902,79566,76,379348
3951,0.000734,74.125.68.0-255,2902,82468,76,379348
3952,0.000744,74.125.68.0-255,1484,83952,76,379348
3953,0.000753,172.31.40.0-255,66,84018,76,379348
3954,0.000767,74.125.68.0-255,1484,85502,76,379348
3955,0.000773,74.125.68.0-255,2902,88404,76,379348
3956,0.000799,74.125.68.0-255,4320,92724,76,379348
3957,0.000823,74.125.68.0-255,1484,94208,76,379348
3958,0.000831,74.125.68.0-255,6438,100646,76,379348
3959,0.000846,74.125.68.0-255,2902,103548,76,379348
3960,0.000852,172.31.40.0-255,66,103614,76,379348
3961,0.000871,74.125.68.0-255,1484,105098,76,379348
3962,0.000886,74.125.68.0-255,2902,108000,76,379348
3963,0.000898,74.125.68.0-255,1484,109484,76,379348
3964,0.000923,74.125.68.0-255,1484,110968,76,379348
3965,0.000937,74.125.68.0-255,1484,112452,76,379348
3966,0.000942,172.31.40.0-255,66,112518,76,379348
3967,0.00096,74.125.68.0-255,1484,114002,76,379348
3968,0.000982,74.125.68.0-255,3646,117648,76,379348
3969,0.001009,172.31.40.0-255,66,117714,76,379348
3970,0.00129,74.125.68.0-255,1484,119198,76,379348
3971,0.001308,74.125.68.0-255,2902,122100,76,379348
3972,0.001332,74.125.68.0-255,4320,126420,76,379348
3973,0.001345,172.31.40.0-255,66,126486,76,379348
3974,0.001361,74.125.68.0-255,4320,130806,76,379348
3975,0.001383,74.125.68.0-255,2902,133708,76,379348
3976,0.001388,74.125.68.0-255,5738,139446,76,379348
3977,0.001401,74.125.68.0-255,2902,142348,76,379348
3978,0.00142,74.125.68.0-255,1484,143832,76,379348
3979,0.001423,172.31.40.0-255,66,143898,76,379348
3980,0.001445,74.125.68.0-255,2902,146800,76,379348
3981,0.001471,172.31.40.0-255,66,146866,76,379348
3982,0.001519,74.125.68.0-255,1484,148350,76,379348
3983,0.001525,74.125.68.0-255,2902,151252,76,379348
3984,0.001527,74.125.68.0-255,766,152018,76,379348
3985,0.001537,172.31.40.0-255,66,152084,76,379348
3986,0.001707,74.125.68.0-255,1484,153568,76,379348
3987,0.001713,74.125.68.0-255,2902,156470,76,379348
3988,0.001734,74.125.68.0-255,4320,160790,76,379348
3989,0.001744,172.31.40.0-255,66,160856,76,379348
3990,0.001758,74.125.68.0-255,4320,165176,76,379348
3991,0.001777,172.31.40.0-255,66,165242,76,379348
3992,0.001782,74.125.68.0-255,2902,168144,76,379348
3993,0.001786,74.125.68.0-255,2902,171046,76,379348
3994,0.001797,74.125.68.0-255,4320,175366,76,379348
3995,0.001802,172.31.40.0-255,66,175432,76,379348
3996,0.001812,74.125.68.0-255,1484,176916,76,379348
3997,0.001816,74.125.68.0-255,4320,181236,76,379348
3998,0.00183,74.125.68.0-255,5020,186256,76,379348
3999,0.001847,172.31.40.0-255,66,186322,76,379348
4000,0.001984,74.125.68.0-255,1484,187806,76,379348
4001,0.002015,74.125.68.0-255,2902,190708,76,379348
4002,0.002026,172.31.40.0-255,66,190774,76,379348
4003,0.002046,74.125.68.0-255,4320,195094,76,379348
4004,0.00205,172.31.40.0-255,66,195160,76,379348
4005,0.002115,172.31.40.0-255,66,195226,76,379348
4006,0.002133,74.125.68.0-255,2902,198128,76,379348
4007,0.002136,172.31.40.0-255,66,198194,76,379348
4008,0.002147,74.125.68.0-255,766,198960,76,379348
4009,0.002161,172.31.40.0-255,66,199026,76,379348
4010,0.002201,74.125.68.0-255,1484,200510,76,379348
4011,0.002217,74.125.68.0-255,1484,201994,76,379348
4012,0.002233,74.125.68.0-255,1484,203478,76,379348
4013,0.002236,172.31.40.0-255,66,203544,76,379348
4014,0.002265,74.125.68.0-255,2902,206446,76,379348
4015,0.002276,74.125.68.0-255,1484,207930,76,379348
4016,0.00229,172.31.40.0-255,66,207996,76,379348
4017,0.002296,74.125.68.0-255,4320,212316,76,379348
4018,0.002301,172.31.40.0-255,66,212382,76,379348
4019,0.002318,74.125.68.0-255,1484,213866,76,379348
4020,0.002334,74.125.68.0-255,1484,215350,76,379348
4021,0.002353,74.125.68.0-255,4320,219670,76,379348
4022,0.00236,172.31.40.0-255,66,219736,76,379348
4023,0.002367,74.125.68.0-255,1484,221220,76,379348
4024,0.002381,74.125.68.0-255,4320,225540,76,379348
4025,0.002391,74.125.68.0-255,5738,231278,76,379348
4026,0.002406,74.125.68.0-255,2184,233462,76,379348
4027,0.002417,74.125.68.0-255,1484,234946,76,379348
4028,0.00242,172.31.40.0-255,66,235012,76,379348
4029,0.002433,74.125.68.0-255,2902,237914,76,379348
4030,0.002436,74.125.68.0-255,1484,239398,76,379348
4031,0.002454,74.125.68.0-255,1484,240882,76,379348
4032,0.002458,74.125.68.0-255,1484,242366,76,379348
4033,0.002466,172.31.40.0-255,66,242432,76,379348
4034,0.00247,74.125.68.0-255,2902,245334,76,379348
4035,0.002475,172.31.40.0-255,66,245400,76,379348
4036,0.002489,74.125.68.0-255,2902,248302,76,379348
4037,0.002494,74.125.68.0-255,4320,252622,76,379348
4038,0.002503,172.31.40.0-255,66,252688,76,379348
4039,0.002511,74.125.68.0-255,1484,254172,76,379348
4040,0.002539,74.125.68.0-255,2902,257074,76,379348
4041,0.00255,172.31.40.0-255,66,257140,76,379348
4042,0.002566,74.125.68.0-255,766,257906,76,379348
4043,0.00257,172.31.40.0-255,66,257972,76,379348
4044,0.002618,74.125.68.0-255,1484,259456,76,379348
4045,0.002623,74.125.68.0-255,2902,262358,76,379348
4046,0.002636,74.125.68.0-255,2902,265260,76,379348
4047,0.002639,172.31.40.0-255,66,265326,76,379348
4048,0.002649,172.31.40.0-255,66,265392,76,379348
4049,0.002669,74.125.68.0-255,4320,269712,76,379348
4050,0.002687,172.31.40.0-255,66,269778,76,379348
4051,0.002698,74.125.68.0-255,5738,275516,76,379348
4052,0.002727,74.125.68.0-255,7156,282672,76,379348
4053,0.002732,172.31.40.0-255,66,282738,76,379348
4054,0.002744,74.125.68.0-255,4320,287058,76,379348
4055,0.00276,172.31.40.0-255,66,287124,76,379348
4056,0.00278,74.125.68.0-255,5020,292144,76,379348
4057,0.002786,172.31.40.0-255,66,292210,76,379348
4058,0.002876,74.125.68.0-255,1484,293694,76,379348
4059,0.002898,74.125.68.0-255,2902,296596,76,379348
4060,0.002903,74.125.68.0-255,2902,299498,76,379348
4061,0.002907,172.31.40.0-255,66,299564,76,379348
4062,0.002916,74.125.68.0-255,2902,302466,76,379348
4063,0.002935,74.125.68.0-255,4320,306786,76,379348
4064,0.00295,74.125.68.0-255,4320,311106,76,379348
4065,0.002954,172.31.40.0-255,66,311172,76,379348
4066,0.002958,172.31.40.0-255,66,311238,76,379348
4067,0.002984,74.125.68.0-255,2902,314140,76,379348
4068,0.002989,172.31.40.0-255,66,314206,76,379348
4069,0.003011,74.125.68.0-255,1484,315690,76,379348
4070,0.003014,74.125.68.0-255,766,316456,76,379348
4071,0.003016,74.125.68.0-255,1484,317940,76,379348
4072,0.00302,74.125.68.0-255,4320,322260,76,379348
4073,0.003023,74.125.68.0-255,1484,323744,76,379348
4074,0.003034,172.31.40.0-255,66,323810,76,379348
4075,0.003039,74.125.68.0-255,4320,328130,76,379348
4076,0.003044,172.31.40.0-255,66,328196,76,379348
4077,0.003053,74.125.68.0-255,1484,329680,76,379348
4078,0.003086,74.125.68.0-255,4320,334000,76,379348
4079,0.003096,74.125.68.0-255,2902,336902,76,379348
4080,0.003106,172.31.40.0-255,66,336968,76,379348
4081,0.003117,74.125.68.0-255,4320,341288,76,379348
4082,0.003119,74.125.68.0-255,766,342054,76,379348
4083,0.003166,74.125.68.0-255,1484,343538,76,379348
4084,0.003171,74.125.68.0-255,2902,346440,76,379348
4085,0.003173,74.125.68.0-255,1484,347924,76,379348
4086,0.003193,74.125.68.0-255,1484,349408,76,379348
4087,0.003203,74.125.68.0-255,1484,350892,76,379348
4088,0.003208,74.125.68.0-255,5738,356630,76,379348
4089,0.003213,172.31.40.0-255,66,356696,76,379348
4090,0.003224,172.31.40.0-255,66,356762,76,379348
4091,0.003227,74.125.68.0-255,1484,358246,76,379348
4092,0.003242,74.125.68.0-255,4320,362566,76,379348
4093,0.003253,172.31.40.0-255,66,362632,76,379348
4094,0.003264,74.125.68.0-255,5738,368370,76,379348
4095,0.003273,172.31.40.0-255,66,368436,76,379348
4096,0.003285,74.125.68.0-255,2721,371157,76,379348
4097,0.003301,172.31.40.0-255,66,371223,76,379348
4098,0.003313,74.125.68.0-255,105,371328,76,379348
4099,0.005145,172.31.40.0-255,66,371394,76,379348
4100,0.005178,172.31.40.0-255,105,371499,76,379348
4101,0.007258,74.125.68.0-255,66,371565,76,379348
4102,0.025253,172.31.40.0-255,171,371736,76,379348
4103,0.025306,172.31.40.0-255,1145,372881,76,379348
4104,0.025441,172.31.40.0-255,1514,374395,76,379348
4105,0.025443,172.31.40.0-255,1514,375909,76,379348
4106,0.025444,172.31.40.0-255,1514,377423,76,379348
4107,0.025445,172.31.40.0-255,1514,378937,76,379348
4108,0.025487,172.31.40.0-255,147,379084,76,379348
4109,0.0269,104.244.42.0-255,66,379150,76,379348
4110,0.026951,104.244.42.0-255,66,379216,76,379348
4111,0.027146,104.244.42.0-255,66,379282,76,379348
4112,0.02715,104.244.42.0-255,66,379348,76,379348
4113,0.0,172.217.194.0-255,146,146,76,236998
4114,2.2e-05,172.31.40.0-255,66,212,76,236998
4115,2.8e-05,172.217.194.0-255,1484,1696,76,236998
4116,3.3e-05,172.31.40.0-255,66,1762,76,236998
4117,3.9e-05,172.217.194.0-255,2902,4664,76,236998
4118,5.2e-05,172.31.40.0-255,66,4730,76,236998
4119,6.1e-05,172.217.194.0-255,7156,11886,76,236998
4120,6.4e-05,172.31.40.0-255,66,11952,76,236998
4121,6.9e-05,172.217.194.0-255,2119,14071,76,236998
4122,7.2e-05,172.31.40.0-255,66,14137,76,236998
4123,0.000102,172.217.194.0-255,1484,15621,76,236998
4124,0.000104,172.31.40.0-255,66,15687,76,236998
4125,0.000113,172.217.194.0-255,2902,18589,76,236998
4126,0.000116,172.31.40.0-255,66,18655,76,236998
4127,0.000121,172.217.194.0-255,4320,22975,76,236998
4128,0.000124,172.31.40.0-255,66,23041,76,236998
4129,0.000156,172.217.194.0-255,1484,24525,76,236998
4130,0.000158,172.31.40.0-255,66,24591,76,236998
4131,0.000165,172.217.194.0-255,5738,30329,76,236998
4132,0.000168,172.31.40.0-255,66,30395,76,236998
4133,0.000171,172.217.194.0-255,1125,31520,76,236998
4134,0.000173,172.31.40.0-255,66,31586,76,236998
4135,0.000232,172.217.194.0-255,1484,33070,76,236998
4136,0.000235,172.31.40.0-255,66,33136,76,236998
4137,0.000262,172.217.194.0-255,2902,36038,76,236998
4138,0.000266,172.31.40.0-255,66,36104,76,236998
4139,0.000289,172.217.194.0-255,1484,37588,76,236998
4140,0.000291,172.31.40.0-255,66,37654,76,236998
4141,0.000294,172.217.194.0-255,1484,39138,76,236998
4142,0.000296,172.31.40.0-255,66,39204,76,236998
4143,0.000303,172.217.194.0-255,7156,46360,76,236998
4144,0.000305,172.31.40.0-255,66,46426,76,236998
4145,0.000342,172.217.194.0-255,2543,48969,76,236998
4146,0.000345,172.31.40.0-255,66,49035,76,236998
4147,0.00035,172.217.194.0-255,2902,51937,76,236998
4148,0.000352,172.31.40.0-255,66,52003,76,236998
4149,0.000359,172.217.194.0-255,7156,59159,76,236998
4150,0.000362,172.31.40.0-255,66,59225,76,236998
4151,0.000366,172.217.194.0-255,2902,62127,76,236998
4152,0.000368,172.31.40.0-255,66,62193,76,236998
4153,0.000401,172.217.194.0-255,4253,66446,76,236998
4154,0.000404,172.31.40.0-255,66,66512,76,236998
4155,0.000415,172.217.194.0-255,385,66897,76,236998
4156,0.000571,172.217.194.0-255,1484,68381,76,236998
4157,0.000576,172.31.40.0-255,66,68447,76,236998
4158,0.000581,172.217.194.0-255,2902,71349,76,236998
4159,0.000583,172.31.40.0-255,66,71415,76,236998
4160,0.000586,172.217.194.0-255,1484,72899,76,236998
4161,0.000606,172.217.194.0-255,4320,77219,76,236998
4162,0.000612,172.31.40.0-255,66,77285,76,236998
4163,0.000617,172.217.194.0-255,2902,80187,76,236998
4164,0.000619,172.31.40.0-255,66,80253,76,236998
4165,0.000656,172.217.194.0-255,2902,83155,76,236998
4166,0.000665,172.31.40.0-255,66,83221,76,236998
4167,0.000668,172.31.40.0-255,66,83287,76,236998
4168,0.000679,172.31.40.0-255,66,83353,76,236998
4169,0.000714,172.217.194.0-255,1484,84837,76,236998
4170,0.000719,172.217.194.0-255,2902,87739,76,236998
4171,0.000722,172.31.40.0-255,66,87805,76,236998
4172,0.000746,172.217.194.0-255,5738,93543,76,236998
4173,0.00075,172.31.40.0-255,66,93609,76,236998
4174,0.000767,172.217.194.0-255,4320,97929,76,236998
4175,0.000769,172.31.40.0-255,66,97995,76,236998
4176,0.00079,172.31.40.0-255,66,98061,76,236998
4177,0.000792,172.217.194.0-255,1484,99545,76,236998
4178,0.000823,172.31.40.0-255,66,99611,76,236998
4179,0.000855,172.31.40.0-255,66,99677,76,236998
4180,0.000858,172.217.194.0-255,1484,101161,76,236998
4181,0.000887,172.31.40.0-255,66,101227,76,236998
4182,0.000945,172.31.40.0-255,66,101293,76,236998
4183,0.000957,172.31.40.0-255,66,101359,76,236998
4184,0.000974,172.31.40.0-255,66,101425,76,236998
4185,0.001037,172.217.194.0-255,5020,106445,76,236998
4186,0.001039,172.31.40.0-255,66,106511,76,236998
4187,0.001045,172.217.194.0-255,5738,112249,76,236998
4188,0.001046,172.31.40.0-255,66,112315,76,236998
4189,0.001058,172.31.40.0-255,66,112381,76,236998
4190,0.001064,172.217.194.0-255,7156,119537,76,236998
4191,0.001067,172.31.40.0-255,66,119603,76,236998
4192,0.001094,172.217.194.0-255,5738,125341,76,236998
4193,0.001097,172.31.40.0-255,66,125407,76,236998
4194,0.001101,172.217.194.0-255,2184,127591,76,236998
4195,0.001102,172.31.40.0-255,66,127657,76,236998
4196,0.001143,172.217.194.0-255,2902,130559,76,236998
4197,0.001146,172.31.40.0-255,66,130625,76,236998
4198,0.001151,172.217.194.0-255,4320,134945,76,236998
4199,0.001153,172.31.40.0-255,66,135011,76,236998
4200,0.001194,172.31.40.0-255,66,135077,76,236998
4201,0.001227,172.31.40.0-255,66,135143,76,236998
4202,0.00125,172.31.40.0-255,66,135209,76,236998
4203,0.001274,172.217.194.0-255,1484,136693,76,236998
4204,0.001279,172.217.194.0-255,2902,139595,76,236998
4205,0.001281,172.31.40.0-255,66,139661,76,236998
4206,0.001284,172.217.194.0-255,1484,141145,76,236998
4207,0.001312,172.217.194.0-255,4320,145465,76,236998
4208,0.001315,172.31.40.0-255,66,145531,76,236998
4209,0.001321,172.217.194.0-255,7156,152687,76,236998
4210,0.001323,172.31.40.0-255,66,152753,76,236998
4211,0.001341,172.217.194.0-255,1484,154237,76,236998
4212,0.001377,172.31.40.0-255,66,154303,76,236998
4213,0.00138,172.217.194.0-255,2184,156487,76,236998
4214,0.001382,172.31.40.0-255,66,156553,76,236998
4215,0.001442,172.217.194.0-255,1484,158037,76,236998
4216,0.001454,172.217.194.0-255,2902,160939,76,236998
4217,0.001457,172.31.40.0-255,66,161005,76,236998
4218,0.001487,172.217.194.0-255,5738,166743,76,236998
4219,0.00149,172.31.40.0-255,66,166809,76,236998
4220,0.001496,172.217.194.0-255,5738,172547,76,236998
4221,0.001498,172.31.40.0-255,66,172613,76,236998
4222,0.001537,172.217.194.0-255,7156,179769,76,236998
4223,0.00154,172.31.40.0-255,66,179835,76,236998
4224,0.00155,172.31.40.0-255,66,179901,76,236998
4225,0.001571,172.217.194.0-255,2184,182085,76,236998
4226,0.001573,172.31.40.0-255,66,182151,76,236998
4227,0.00176,172.217.194.0-255,1484,183635,76,236998
4228,0.001764,172.217.194.0-255,1484,185119,76,236998
4229,0.001768,172.31.40.0-255,66,185185,76,236998
4230,0.001792,172.217.194.0-255,1484,186669,76,236998
4231,0.001798,172.217.194.0-255,5738,192407,76,236998
4232,0.001801,172.31.40.0-255,66,192473,76,236998
4233,0.001829,172.217.194.0-255,1484,193957,76,236998
4234,0.001844,172.217.194.0-255,4320,198277,76,236998
4235,0.001846,172.31.40.0-255,66,198343,76,236998
4236,0.001862,172.217.194.0-255,2902,201245,76,236998
4237,0.001864,172.31.40.0-255,66,201311,76,236998
4238,0.001891,172.217.194.0-255,4320,205631,76,236998
4239,0.001893,172.31.40.0-255,66,205697,76,236998
4240,0.001899,172.217.194.0-255,7156,212853,76,236998
4241,0.001901,172.31.40.0-255,66,212919,76,236998
4242,0.001903,172.217.194.0-255,1484,214403,76,236998
4243,0.001917,172.217.194.0-255,2184,216587,76,236998
4244,0.001919,172.31.40.0-255,66,216653,76,236998
4245,0.001927,172.217.194.0-255,4320,220973,76,236998
4246,0.001929,172.31.40.0-255,66,221039,76,236998
4247,0.001934,172.217.194.0-255,4320,225359,76,236998
4248,0.001936,172.31.40.0-255,66,225425,76,236998
4249,0.002001,172.31.40.0-255,66,225491,76,236998
4250,0.002026,172.217.194.0-255,4320,229811,76,236998
4251,0.002028,172.31.40.0-255,66,229877,76,236998
4252,0.002061,172.31.40.0-255,66,229943,76,236998
4253,0.002087,172.217.194.0-255,2184,232127,76,236998
4254,0.002089,172.31.40.0-255,66,232193,76,236998
4255,0.0021,172.31.40.0-255,66,232259,76,236998
4256,0.002103,172.217.194.0-255,97,232356,76,236998
4257,0.002111,172.217.194.0-255,105,232461,76,236998
4258,0.007347,172.31.40.0-255,66,232527,76,236998
4259,0.00738,172.31.40.0-255,105,232632,76,236998
4260,0.009785,172.217.194.0-255,66,232698,76,236998
4261,0.027526,172.31.40.0-255,172,232870,76,236998
4262,0.027562,172.31.40.0-255,1105,233975,76,236998
4263,0.027623,172.31.40.0-255,1514,235489,76,236998
4264,0.027625,172.31.40.0-255,1311,236800,76,236998
4265,0.029126,104.244.42.0-255,66,236866,76,236998
4266,0.029208,104.244.42.0-255,66,236932,76,236998
4267,0.02934,104.244.42.0-255,66,236998,76,236998
4268,0.0,172.217.194.0-255,146,146,76,206628
4269,1.6e-05,172.31.40.0-255,66,212,76,206628
4270,2.4e-05,172.217.194.0-255,1484,1696,76,206628
4271,2.8e-05,172.31.40.0-255,66,1762,76,206628
4272,4.3e-05,172.217.194.0-255,2902,4664,76,206628
4273,4.7e-05,172.31.40.0-255,66,4730,76,206628
4274,5.3e-05,172.217.194.0-255,4320,9050,76,206628
4275,5.6e-05,172.31.40.0-255,66,9116,76,206628
4276,9e-05,172.217.194.0-255,4999,14115,76,206628
4277,9.3e-05,172.31.40.0-255,66,14181,76,206628
4278,0.000424,172.217.194.0-255,1484,15665,76,206628
4279,0.000429,172.31.40.0-255,66,15731,76,206628
4280,0.000436,172.217.194.0-255,2902,18633,76,206628
4281,0.000438,172.31.40.0-255,66,18699,76,206628
4282,0.000459,172.217.194.0-255,5738,24437,76,206628
4283,0.000463,172.31.40.0-255,66,24503,76,206628
4284,0.000491,172.217.194.0-255,4320,28823,76,206628
4285,0.000494,172.31.40.0-255,66,28889,76,206628
4286,0.000523,172.217.194.0-255,2543,31432,76,206628
4287,0.000525,172.31.40.0-255,66,31498,76,206628
4288,0.000531,172.217.194.0-255,4320,35818,76,206628
4289,0.000533,172.31.40.0-255,66,35884,76,206628
4290,0.000555,172.217.194.0-255,2902,38786,76,206628
4291,0.000557,172.31.40.0-255,66,38852,76,206628
4292,0.000572,172.31.40.0-255,66,38918,76,206628
4293,0.000615,172.31.40.0-255,66,38984,76,206628
4294,0.000784,172.217.194.0-255,119,39103,76,206628
4295,0.000788,172.31.40.0-255,66,39169,76,206628
4296,0.000868,172.217.194.0-255,1484,40653,76,206628
4297,0.000872,172.31.40.0-255,66,40719,76,206628
4298,0.000903,172.217.194.0-255,2902,43621,76,206628
4299,0.000906,172.31.40.0-255,66,43687,76,206628
4300,0.000912,172.217.194.0-255,4320,48007,76,206628
4301,0.000914,172.31.40.0-255,66,48073,76,206628
4302,0.000936,172.217.194.0-255,4320,52393,76,206628
4303,0.000939,172.31.40.0-255,66,52459,76,206628
4304,0.000981,172.31.40.0-255,66,52525,76,206628
4305,0.000993,172.31.40.0-255,66,52591,76,206628
4306,0.000997,172.217.194.0-255,2543,55134,76,206628
4307,0.001,172.31.40.0-255,66,55200,76,206628
4308,0.001312,172.217.194.0-255,1484,56684,76,206628
4309,0.001317,172.217.194.0-255,1484,58168,76,206628
4310,0.001321,172.31.40.0-255,66,58234,76,206628
4311,0.001352,172.217.194.0-255,1484,59718,76,206628
4312,0.001358,172.217.194.0-255,5738,65456,76,206628
4313,0.001361,172.31.40.0-255,66,65522,76,206628
4314,0.001378,172.31.40.0-255,66,65588,76,206628
4315,0.001389,172.31.40.0-255,66,65654,76,206628
4316,0.001456,172.31.40.0-255,66,65720,76,206628
4317,0.001474,172.31.40.0-255,66,65786,76,206628
4318,0.001485,172.31.40.0-255,66,65852,76,206628
4319,0.001543,172.217.194.0-255,1484,67336,76,206628
4320,0.001556,172.217.194.0-255,2902,70238,76,206628
4321,0.001559,172.31.40.0-255,66,70304,76,206628
4322,0.001564,172.217.194.0-255,2902,73206,76,206628
4323,0.001567,172.31.40.0-255,66,73272,76,206628
4324,0.0016,172.217.194.0-255,2902,76174,76,206628
4325,0.001603,172.31.40.0-255,66,76240,76,206628
4326,0.001622,172.31.40.0-255,66,76306,76,206628
4327,0.001635,172.31.40.0-255,66,76372,76,206628
4328,0.001725,172.31.40.0-255,101,76473,76,206628
4329,0.001752,172.217.194.0-255,1484,77957,76,206628
4330,0.001767,172.217.194.0-255,2902,80859,76,206628
4331,0.001772,172.31.40.0-255,66,80925,76,206628
4332,0.001777,172.217.194.0-255,2902,83827,76,206628
4333,0.001779,172.31.40.0-255,66,83893,76,206628
4334,0.001814,172.217.194.0-255,2902,86795,76,206628
4335,0.001817,172.31.40.0-255,66,86861,76,206628
4336,0.001835,172.31.40.0-255,66,86927,76,206628
4337,0.001841,172.217.194.0-255,5738,92665,76,206628
4338,0.001844,172.31.40.0-255,66,92731,76,206628
4339,0.001895,172.31.40.0-255,66,92797,76,206628
4340,0.001921,172.31.40.0-255,66,92863,76,206628
4341,0.001928,172.217.194.0-255,6438,99301,76,206628
4342,0.00193,172.31.40.0-255,66,99367,76,206628
4343,0.001933,172.217.194.0-255,1484,100851,76,206628
4344,0.001971,172.217.194.0-255,5738,106589,76,206628
4345,0.001976,172.31.40.0-255,66,106655,76,206628
4346,0.002014,172.31.40.0-255,66,106721,76,206628
4347,0.002021,172.217.194.0-255,6438,113159,76,206628
4348,0.002023,172.31.40.0-255,66,113225,76,206628
4349,0.002099,172.31.40.0-255,66,113291,76,206628
4350,0.00213,172.217.194.0-255,5738,119029,76,206628
4351,0.002133,172.31.40.0-255,66,119095,76,206628
4352,0.00214,172.217.194.0-255,7156,126251,76,206628
4353,0.002143,172.31.40.0-255,66,126317,76,206628
4354,0.003711,172.217.194.0-255,66,126383,76,206628
4355,0.004165,172.217.194.0-255,5738,132121,76,206628
4356,0.004172,172.31.40.0-255,66,132187,76,206628
4357,0.00618,172.217.194.0-255,5738,137925,76,206628
4358,0.006186,172.31.40.0-255,66,137991,76,206628
4359,0.008195,172.217.194.0-255,5738,143729,76,206628
4360,0.008202,172.31.40.0-255,66,143795,76,206628
4361,0.010203,172.217.194.0-255,5738,149533,76,206628
4362,0.010208,172.31.40.0-255,66,149599,76,206628
4363,0.012238,172.217.194.0-255,5738,155337,76,206628
4364,0.012245,172.31.40.0-255,66,155403,76,206628
4365,0.014242,172.217.194.0-255,5738,161141,76,206628
4366,0.014249,172.31.40.0-255,66,161207,76,206628
4367,0.016259,172.217.194.0-255,5738,166945,76,206628
4368,0.016265,172.31.40.0-255,66,167011,76,206628
4369,0.018278,172.217.194.0-255,5738,172749,76,206628
4370,0.018285,172.31.40.0-255,66,172815,76,206628
4371,0.020271,172.217.194.0-255,5738,178553,76,206628
4372,0.020278,172.31.40.0-255,66,178619,76,206628
4373,0.022285,172.217.194.0-255,5738,184357,76,206628
4374,0.022292,172.31.40.0-255,66,184423,76,206628
4375,0.0243,172.217.194.0-255,5738,190161,76,206628
4376,0.024306,172.31.40.0-255,66,190227,76,206628
4377,0.026336,172.217.194.0-255,5738,195965,76,206628
4378,0.026343,172.31.40.0-255,66,196031,76,206628
4379,0.028389,172.217.194.0-255,5738,201769,76,206628
4380,0.028395,172.31.40.0-255,66,201835,76,206628
4381,0.030408,172.217.194.0-255,1419,203254,76,206628
4382,0.03143,172.31.40.0-255,105,203359,76,206628
4383,0.034484,172.31.40.0-255,172,203531,76,206628
4384,0.034515,172.31.40.0-255,1104,204635,76,206628
4385,0.034576,172.31.40.0-255,1514,206149,76,206628
4386,0.034578,172.31.40.0-255,347,206496,76,206628
4387,0.036671,104.244.42.0-255,66,206562,76,206628
4388,0.038195,172.217.194.0-255,66,206628,76,206628
4389,0.0,74.125.24.0-255,153,153,76,390000
4390,3.4e-05,172.31.40.0-255,66,219,76,390000
4391,4.2e-05,74.125.24.0-255,1484,1703,76,390000
4392,4.7e-05,172.31.40.0-255,66,1769,76,390000
4393,5.3e-05,74.125.24.0-255,2902,4671,76,390000
4394,5.6e-05,172.31.40.0-255,66,4737,76,390000
4395,8.3e-05,74.125.24.0-255,5738,10475,76,390000
4396,8.6e-05,172.31.40.0-255,66,10541,76,390000
4397,0.000108,74.125.24.0-255,3496,14037,76,390000
4398,0.00011,172.31.40.0-255,66,14103,76,390000
4399,0.000134,74.125.24.0-255,5738,19841,76,390000
4400,0.000137,172.31.40.0-255,66,19907,76,390000
4401,0.000156,74.125.24.0-255,5738,25645,76,390000
4402,0.000159,172.31.40.0-255,66,25711,76,390000
4403,0.000176,74.125.24.0-255,5379,31090,76,390000
4404,0.000178,172.31.40.0-255,66,31156,76,390000
4405,0.000372,74.125.24.0-255,1484,32640,76,390000
4406,0.000378,172.31.40.0-255,66,32706,76,390000
4407,0.00039,74.125.24.0-255,1484,34190,76,390000
4408,0.000392,172.31.40.0-255,66,34256,76,390000
4409,0.000404,74.125.24.0-255,1484,35740,76,390000
4410,0.000407,172.31.40.0-255,66,35806,76,390000
4411,0.000414,74.125.24.0-255,5738,41544,76,390000
4412,0.000417,172.31.40.0-255,66,41610,76,390000
4413,0.000449,74.125.24.0-255,6797,48407,76,390000
4414,0.000452,172.31.40.0-255,66,48473,76,390000
4415,0.000473,74.125.24.0-255,1484,49957,76,390000
4416,0.000476,172.31.40.0-255,66,50023,76,390000
4417,0.000492,74.125.24.0-255,7156,57179,76,390000
4418,0.000495,172.31.40.0-255,66,57245,76,390000
4419,0.000519,74.125.24.0-255,1484,58729,76,390000
4420,0.000523,172.31.40.0-255,66,58795,76,390000
4421,0.000541,74.125.24.0-255,6797,65592,76,390000
4422,0.000571,172.31.40.0-255,66,65658,76,390000
4423,0.000601,74.125.24.0-255,646,66304,76,390000
4424,0.000713,74.125.24.0-255,1484,67788,76,390000
4425,0.000719,74.125.24.0-255,2902,70690,76,390000
4426,0.000729,172.31.40.0-255,66,70756,76,390000
4427,0.000743,74.125.24.0-255,5738,76494,76,390000
4428,0.000764,172.31.40.0-255,66,76560,76,390000
4429,0.000779,74.125.24.0-255,1484,78044,76,390000
4430,0.000793,74.125.24.0-255,5379,83423,76,390000
4431,0.000808,172.31.40.0-255,66,83489,76,390000
4432,0.000825,74.125.24.0-255,4320,87809,76,390000
4433,0.000842,74.125.24.0-255,2902,90711,76,390000
4434,0.000846,74.125.24.0-255,2902,93613,76,390000
4435,0.000852,172.31.40.0-255,66,93679,76,390000
4436,0.000865,74.125.24.0-255,5738,99417,76,390000
4437,0.000878,74.125.24.0-255,1125,100542,76,390000
4438,0.000887,172.31.40.0-255,66,100608,76,390000
4439,0.001521,74.125.24.0-255,1484,102092,76,390000
4440,0.00153,74.125.24.0-255,2902,104994,76,390000
4441,0.001534,172.31.40.0-255,66,105060,76,390000
4442,0.001541,74.125.24.0-255,5738,110798,76,390000
4443,0.001547,74.125.24.0-255,4320,115118,76,390000
4444,0.00156,74.125.24.0-255,1484,116602,76,390000
4445,0.001617,74.125.24.0-255,5020,121622,76,390000
4446,0.002086,74.125.24.0-255,1484,123106,76,390000
4447,0.002104,74.125.24.0-255,2902,126008,76,390000
4448,0.002109,74.125.24.0-255,2902,128910,76,390000
4449,0.002119,74.125.24.0-255,1484,130394,76,390000
4450,0.002138,74.125.24.0-255,1484,131878,76,390000
4451,0.002156,74.125.24.0-255,7156,139034,76,390000
4452,0.002158,74.125.24.0-255,1484,140518,76,390000
4453,0.002171,74.125.24.0-255,2902,143420,76,390000
4454,0.00218,74.125.24.0-255,1484,144904,76,390000
4455,0.002228,74.125.24.0-255,4320,149224,76,390000
4456,0.002249,74.125.24.0-255,6438,155662,76,390000
4457,0.002473,74.125.24.0-255,1484,157146,76,390000
4458,0.002486,74.125.24.0-255,2902,160048,76,390000
4459,0.00251,74.125.24.0-255,1484,161532,76,390000
4460,0.002531,74.125.24.0-255,4320,165852,76,390000
4461,0.002535,74.125.24.0-255,2902,168754,76,390000
4462,0.00744,172.31.40.0-255,66,168820,76,390000
4463,0.009882,74.125.24.0-255,5738,174558,76,390000
4464,0.009897,172.31.40.0-255,66,174624,76,390000
4465,0.012386,74.125.24.0-255,5738,180362,76,390000
4466,0.013291,172.31.40.0-255,66,180428,76,390000
4467,0.015701,74.125.24.0-255,5738,186166,76,390000
4468,0.01572,172.31.40.0-255,66,186232,76,390000
4469,0.018155,74.125.24.0-255,5738,191970,76,390000
4470,0.01817,172.31.40.0-255,66,192036,76,390000
4471,0.020601,74.125.24.0-255,5738,197774,76,390000
4472,0.020615,172.31.40.0-255,66,197840,76,390000
4473,0.023023,74.125.24.0-255,5738,203578,76,390000
4474,0.023038,172.31.40.0-255,66,203644,76,390000
4475,0.025456,74.125.24.0-255,5738,209382,76,390000
4476,0.025472,172.31.40.0-255,66,209448,76,390000
4477,0.027905,74.125.24.0-255,4320,213768,76,390000
4478,0.027913,172.31.40.0-255,66,213834,76,390000
4479,0.02793,74.125.24.0-255,1484,215318,76,390000
4480,0.029173,172.31.40.0-255,172,215490,76,390000
4481,0.029213,172.31.40.0-255,1109,216599,76,390000
4482,0.029278,172.31.40.0-255,1514,218113,76,390000
4483,0.029279,172.31.40.0-255,1514,219627,76,390000
4484,0.029281,172.31.40.0-255,1514,221141,76,390000
4485,0.029282,172.31.40.0-255,1514,222655,76,390000
4486,0.029311,172.31.40.0-255,183,222838,76,390000
4487,0.030374,74.125.24.0-255,4320,227158,76,390000
4488,0.030383,172.31.40.0-255,66,227224,76,390000
4489,0.030835,104.244.42.0-255,66,227290,76,390000
4490,0.030891,104.244.42.0-255,66,227356,76,390000
4491,0.030998,104.244.42.0-255,66,227422,76,390000
4492,0.031003,104.244.42.0-255,66,227488,76,390000
4493,0.032872,74.125.24.0-255,5738,233226,76,390000
4494,0.032957,172.31.40.0-255,66,233292,76,390000
4495,0.035399,74.125.24.0-255,5738,239030,76,390000
4496,0.03541,172.31.40.0-255,66,239096,76,390000
4497,0.037841,74.125.24.0-255,5738,244834,76,390000
4498,0.037853,172.31.40.0-255,66,244900,76,390000
4499,0.040275,74.125.24.0-255,5738,250638,76,390000
4500,0.040289,172.31.40.0-255,66,250704,76,390000
4501,0.042702,74.125.24.0-255,5738,256442,76,390000
4502,0.042726,172.31.40.0-255,66,256508,76,390000
4503,0.045164,74.125.24.0-255,5738,262246,76,390000
4504,0.045173,172.31.40.0-255,66,262312,76,390000
4505,0.047631,74.125.24.0-255,5738,268050,76,390000
4506,0.04764,172.31.40.0-255,66,268116,76,390000
4507,0.050135,74.125.24.0-255,5738,273854,76,390000
4508,0.050145,172.31.40.0-255,66,273920,76,390000
4509,0.052671,74.125.24.0-255,5738,279658,76,390000
4510,0.052681,172.31.40.0-255,66,279724,76,390000
4511,0.055117,74.125.24.0-255,5738,285462,76,390000
4512,0.055125,172.31.40.0-255,66,285528,76,390000
4513,0.05752,74.125.24.0-255,5738,291266,76,390000
4514,0.057532,172.31.40.0-255,66,291332,76,390000
4515,0.059986,74.125.24.0-255,5738,297070,76,390000
4516,0.059996,172.31.40.0-255,66,297136,76,390000
4517,0.062515,74.125.24.0-255,5738,302874,76,390000
4518,0.062526,172.31.40.0-255,66,302940,76,390000
4519,0.065043,74.125.24.0-255,5738,308678,76,390000
4520,0.065056,172.31.40.0-255,66,308744,76,390000
4521,0.067507,74.125.24.0-255,5738,314482,76,390000
4522,0.067518,172.31.40.0-255,66,314548,76,390000
4523,0.069998,74.125.24.0-255,5738,320286,76,390000
4524,0.070008,172.31.40.0-255,66,320352,76,390000
4525,0.072414,74.125.24.0-255,5738,326090,76,390000
4526,0.072428,172.31.40.0-255,66,326156,76,390000
4527,0.07485,74.125.24.0-255,5738,331894,76,390000
4528,0.07486,172.31.40.0-255,66,331960,76,390000
4529,0.077369,74.125.24.0-255,5738,337698,76,390000
4530,0.077377,172.31.40.0-255,66,337764,76,390000
4531,0.079793,74.125.24.0-255,5738,343502,76,390000
4532,0.079803,172.31.40.0-255,66,343568,76,390000
4533,0.08232,74.125.24.0-255,5738,349306,76,390000
4534,0.08233,172.31.40.0-255,66,349372,76,390000
4535,0.084771,74.125.24.0-255,5738,355110,76,390000
4536,0.08478,172.31.40.0-255,66,355176,76,390000
4537,0.087245,74.125.24.0-255,5738,360914,76,390000
4538,0.087257,172.31.40.0-255,66,360980,76,390000
4539,0.089742,74.125.24.0-255,5738,366718,76,390000
4540,0.089752,172.31.40.0-255,66,366784,76,390000
4541,0.092225,74.125.24.0-255,5738,372522,76,390000
4542,0.092237,172.31.40.0-255,66,372588,76,390000
4543,0.094701,74.125.24.0-255,5738,378326,76,390000
4544,0.09471,172.31.40.0-255,66,378392,76,390000
4545,0.097174,74.125.24.0-255,5738,384130,76,390000
4546,0.097182,172.31.40.0-255,66,384196,76,390000
4547,0.099639,74.125.24.0-255,5738,389934,76,390000
4548,0.099645,172.31.40.0-255,66,390000,76,390000
4549,0.0,172.217.194.0-255,155,155,76,170198
4550,1.8e-05,172.31.40.0-255,66,221,76,170198
4551,2.5e-05,172.217.194.0-255,1484,1705,76,170198
4552,2.8e-05,172.31.40.0-255,66,1771,76,170198
4553,3.3e-05,172.217.194.0-255,2902,4673,76,170198
4554,3.6e-05,172.31.40.0-255,66,4739,76,170198
4555,6.6e-05,172.217.194.0-255,7156,11895,76,170198
4556,6.8e-05,172.31.40.0-255,66,11961,76,170198
4557,7.2e-05,172.217.194.0-255,2902,14863,76,170198
4558,7.4e-05,172.31.40.0-255,66,14929,76,170198
4559,8.8e-05,172.217.194.0-255,2101,17030,76,170198
4560,9e-05,172.31.40.0-255,66,17096,76,170198
4561,9.6e-05,172.217.194.0-255,5738,22834,76,170198
4562,9.8e-05,172.31.40.0-255,66,22900,76,170198
4563,0.000128,172.217.194.0-255,4320,27220,76,170198
4564,0.00013,172.31.40.0-255,66,27286,76,170198
4565,0.00015,172.217.194.0-255,3961,31247,76,170198
4566,0.000153,172.31.40.0-255,66,31313,76,170198
4567,0.000248,172.217.194.0-255,1484,32797,76,170198
4568,0.000252,172.31.40.0-255,66,32863,76,170198
4569,0.000257,172.217.194.0-255,2902,35765,76,170198
4570,0.000259,172.31.40.0-255,66,35831,76,170198
4571,0.000272,172.217.194.0-255,2902,38733,76,170198
4572,0.000274,172.31.40.0-255,66,38799,76,170198
4573,0.000305,172.217.194.0-255,2902,41701,76,170198
4574,0.000307,172.31.40.0-255,66,41767,76,170198
4575,0.000314,172.217.194.0-255,6797,48564,76,170198
4576,0.000326,172.31.40.0-255,66,48630,76,170198
4577,0.000338,172.31.40.0-255,66,48696,76,170198
4578,0.00036,172.217.194.0-255,4320,53016,76,170198
4579,0.000362,172.31.40.0-255,66,53082,76,170198
4580,0.000375,172.217.194.0-255,2794,55876,76,170198
4581,0.000377,172.31.40.0-255,66,55942,76,170198
4582,0.000419,172.217.194.0-255,121,56063,76,170198
4583,0.000544,172.217.194.0-255,1484,57547,76,170198
4584,0.000549,172.31.40.0-255,66,57613,76,170198
4585,0.000554,172.217.194.0-255,2902,60515,76,170198
4586,0.000556,172.31.40.0-255,66,60581,76,170198
4587,0.000571,172.217.194.0-255,2902,63483,76,170198
4588,0.000573,172.31.40.0-255,66,63549,76,170198
4589,0.000591,172.217.194.0-255,2902,66451,76,170198
4590,0.000593,172.31.40.0-255,66,66517,76,170198
4591,0.000596,172.217.194.0-255,2902,69419,76,170198
4592,0.000598,172.31.40.0-255,66,69485,76,170198
4593,0.000617,172.217.194.0-255,4320,73805,76,170198
4594,0.000619,172.31.40.0-255,66,73871,76,170198
4595,0.000643,172.217.194.0-255,6797,80668,76,170198
4596,0.000646,172.31.40.0-255,66,80734,76,170198
4597,0.000655,172.31.40.0-255,66,80800,76,170198
4598,0.001339,172.217.194.0-255,1484,82284,76,170198
4599,0.00136,172.217.194.0-255,2902,85186,76,170198
4600,0.001363,172.31.40.0-255,66,85252,76,170198
4601,0.001367,172.217.194.0-255,1484,86736,76,170198
4602,0.001386,172.217.194.0-255,4320,91056,76,170198
4603,0.001388,172.31.40.0-255,66,91122,76,170198
4604,0.001419,172.31.40.0-255,66,91188,76,170198
4605,0.001465,172.217.194.0-255,7156,98344,76,170198
4606,0.001468,172.31.40.0-255,66,98410,76,170198
4607,0.001496,172.31.40.0-255,66,98476,76,170198
4608,0.001534,172.217.194.0-255,4320,102796,76,170198
4609,0.001537,172.31.40.0-255,66,102862,76,170198
4610,0.001572,172.31.40.0-255,66,102928,76,170198
4611,0.001587,172.31.40.0-255,66,102994,76,170198
4612,0.001857,172.217.194.0-255,1484,104478,76,170198
4613,0.001864,172.217.194.0-255,2902,107380,76,170198
4614,0.001867,172.31.40.0-255,66,107446,76,170198
4615,0.001891,172.217.194.0-255,5738,113184,76,170198
4616,0.001894,172.31.40.0-255,66,113250,76,170198
4617,0.001897,172.217.194.0-255,1484,114734,76,170198
4618,0.001911,172.217.194.0-255,4320,119054,76,170198
4619,0.001913,172.31.40.0-255,66,119120,76,170198
4620,0.001947,172.217.194.0-255,7156,126276,76,170198
4621,0.00195,172.31.40.0-255,66,126342,76,170198
4622,0.001976,172.217.194.0-255,5738,132080,76,170198
4623,0.001978,172.31.40.0-255,66,132146,76,170198
4624,0.001984,172.217.194.0-255,5020,137166,76,170198
4625,0.001987,172.31.40.0-255,66,137232,76,170198
4626,0.002018,172.217.194.0-255,4320,141552,76,170198
4627,0.002021,172.31.40.0-255,66,141618,76,170198
4628,0.002027,172.217.194.0-255,5738,147356,76,170198
4629,0.002029,172.31.40.0-255,66,147422,76,170198
4630,0.002032,172.217.194.0-255,1484,148906,76,170198
4631,0.00206,172.31.40.0-255,66,148972,76,170198
4632,0.002065,172.217.194.0-255,2902,151874,76,170198
4633,0.002068,172.31.40.0-255,66,151940,76,170198
4634,0.002096,172.31.40.0-255,66,152006,76,170198
4635,0.002151,172.31.40.0-255,66,152072,76,170198
4636,0.002165,172.31.40.0-255,66,152138,76,170198
4637,0.002189,172.217.194.0-255,2902,155040,76,170198
4638,0.002191,172.31.40.0-255,66,155106,76,170198
4639,0.002237,172.31.40.0-255,66,155172,76,170198
4640,0.002249,172.31.40.0-255,66,155238,76,170198
4641,0.002275,172.31.40.0-255,66,155304,76,170198
4642,0.00233,172.31.40.0-255,66,155370,76,170198
4643,0.002371,172.217.194.0-255,6438,161808,76,170198
4644,0.00243,172.217.194.0-255,105,161913,76,170198
4645,0.002439,172.31.40.0-255,66,161979,76,170198
4646,0.008026,172.31.40.0-255,66,162045,76,170198
4647,0.008033,172.31.40.0-255,66,162111,76,170198
4648,0.008036,172.31.40.0-255,66,162177,76,170198
4649,0.010137,172.31.40.0-255,66,162243,76,170198
4650,0.010174,172.31.40.0-255,105,162348,76,170198
4651,0.012812,172.217.194.0-255,66,162414,76,170198
4652,0.03657,172.31.40.0-255,172,162586,76,170198
4653,0.036604,172.31.40.0-255,1107,163693,76,170198
4654,0.036672,172.31.40.0-255,1514,165207,76,170198
4655,0.036674,172.31.40.0-255,1514,166721,76,170198
4656,0.03668,172.31.40.0-255,1514,168235,76,170198
4657,0.036681,172.31.40.0-255,1514,169749,76,170198
4658,0.0367,172.31.40.0-255,185,169934,76,170198
4659,0.038254,104.244.42.0-255,66,170000,76,170198
4660,0.038284,104.244.42.0-255,66,170066,76,170198
4661,0.03835,104.244.42.0-255,66,170132,76,170198
4662,0.038364,104.244.42.0-255,66,170198,76,170198
4663,0.0,172.217.194.0-255,153,153,76,269284
4664,1.6e-05,172.31.40.0-255,66,219,76,269284
4665,2.2e-05,172.217.194.0-255,1484,1703,76,269284
4666,2.6e-05,172.31.40.0-255,66,1769,76,269284
4667,5.4e-05,172.217.194.0-255,2902,4671,76,269284
4668,5.8e-05,172.31.40.0-255,66,4737,76,269284
4669,0.000165,172.217.194.0-255,7156,11893,76,269284
4670,0.000168,172.31.40.0-255,66,11959,76,269284
4671,0.000423,172.217.194.0-255,2103,14062,76,269284
4672,0.000429,172.31.40.0-255,66,14128,76,269284
4673,0.000505,172.31.40.0-255,66,14194,76,269284
4674,0.000532,172.217.194.0-255,2902,17096,76,269284
4675,0.000535,172.31.40.0-255,66,17162,76,269284
4676,0.000918,172.217.194.0-255,5379,22541,76,269284
4677,0.000924,172.31.40.0-255,66,22607,76,269284
4678,0.001129,172.31.40.0-255,66,22673,76,269284
4679,0.001161,172.31.40.0-255,66,22739,76,269284
4680,0.001945,172.31.40.0-255,66,22805,76,269284
4681,0.002352,172.217.194.0-255,1484,24289,76,269284
4682,0.002358,172.31.40.0-255,66,24355,76,269284
4683,0.002403,172.31.40.0-255,66,24421,76,269284
4684,0.002431,172.217.194.0-255,5738,30159,76,269284
4685,0.002434,172.31.40.0-255,66,30225,76,269284
4686,0.003367,172.31.40.0-255,66,30291,76,269284
4687,0.003414,172.31.40.0-255,66,30357,76,269284
4688,0.005708,172.217.194.0-255,5738,36095,76,269284
4689,0.006141,172.31.40.0-255,66,36161,76,269284
4690,0.008422,172.217.194.0-255,5738,41899,76,269284
4691,0.008429,172.31.40.0-255,66,41965,76,269284
4692,0.010702,172.217.194.0-255,5738,47703,76,269284
4693,0.013192,172.31.40.0-255,66,47769,76,269284
4694,0.01551,172.217.194.0-255,5738,53507,76,269284
4695,0.01552,172.31.40.0-255,66,53573,76,269284
4696,0.017793,172.217.194.0-255,5738,59311,76,269284
4697,0.0178,172.31.40.0-255,66,59377,76,269284
4698,0.020106,172.217.194.0-255,5738,65115,76,269284
4699,0.020113,172.31.40.0-255,66,65181,76,269284
4700,0.020842,172.31.40.0-255,172,65353,76,269284
4701,0.020874,172.31.40.0-255,1104,66457,76,269284
4702,0.020935,172.31.40.0-255,1514,67971,76,269284
4703,0.020937,172.31.40.0-255,347,68318,76,269284
4704,0.022399,172.217.194.0-255,5738,74056,76,269284
4705,0.022405,172.31.40.0-255,66,74122,76,269284
4706,0.023064,104.244.42.0-255,66,74188,76,269284
4707,0.024674,172.217.194.0-255,5738,79926,76,269284
4708,0.024679,172.31.40.0-255,66,79992,76,269284
4709,0.026979,172.217.194.0-255,5738,85730,76,269284
4710,0.026985,172.31.40.0-255,66,85796,76,269284
4711,0.029308,172.217.194.0-255,5738,91534,76,269284
4712,0.029315,172.31.40.0-255,66,91600,76,269284
4713,0.031603,172.217.194.0-255,5738,97338,76,269284
4714,0.031611,172.31.40.0-255,66,97404,76,269284
4715,0.033913,172.217.194.0-255,5738,103142,76,269284
4716,0.033921,172.31.40.0-255,66,103208,76,269284
4717,0.036186,172.217.194.0-255,5738,108946,76,269284
4718,0.036193,172.31.40.0-255,66,109012,76,269284
4719,0.038498,172.217.194.0-255,2902,111914,76,269284
4720,0.038504,172.31.40.0-255,66,111980,76,269284
4721,0.038532,172.217.194.0-255,2902,114882,76,269284
4722,0.038572,172.31.40.0-255,66,114948,76,269284
4723,0.040813,172.217.194.0-255,2902,117850,76,269284
4724,0.040819,172.31.40.0-255,66,117916,76,269284
4725,0.04086,172.217.194.0-255,2902,120818,76,269284
4726,0.040888,172.31.40.0-255,66,120884,76,269284
4727,0.04312,172.217.194.0-255,2902,123786,76,269284
4728,0.043125,172.31.40.0-255,66,123852,76,269284
4729,0.043177,172.217.194.0-255,2902,126754,76,269284
4730,0.043205,172.31.40.0-255,66,126820,76,269284
4731,0.045449,172.217.194.0-255,2902,129722,76,269284
4732,0.045455,172.31.40.0-255,66,129788,76,269284
4733,0.045505,172.217.194.0-255,2902,132690,76,269284
4734,0.045521,172.31.40.0-255,66,132756,76,269284
4735,0.04775,172.217.194.0-255,2902,135658,76,269284
4736,0.047756,172.31.40.0-255,66,135724,76,269284
4737,0.047822,172.217.194.0-255,2902,138626,76,269284
4738,0.04785,172.31.40.0-255,66,138692,76,269284
4739,0.050049,172.217.194.0-255,2902,141594,76,269284
4740,0.050054,172.31.40.0-255,66,141660,76,269284
4741,0.050132,172.217.194.0-255,2902,144562,76,269284
4742,0.05017,172.31.40.0-255,66,144628,76,269284
4743,0.052321,172.217.194.0-255,2902,147530,76,269284
4744,0.052327,172.31.40.0-255,66,147596,76,269284
4745,0.05245,172.217.194.0-255,2902,150498,76,269284
4746,0.052502,172.31.40.0-255,66,150564,76,269284
4747,0.054595,172.217.194.0-255,2902,153466,76,269284
4748,0.054602,172.31.40.0-255,66,153532,76,269284
4749,0.054782,172.217.194.0-255,2902,156434,76,269284
4750,0.054787,172.31.40.0-255,66,156500,76,269284
4751,0.056863,172.217.194.0-255,2902,159402,76,269284
4752,0.056869,172.31.40.0-255,66,159468,76,269284
4753,0.057083,172.217.194.0-255,2902,162370,76,269284
4754,0.057089,172.31.40.0-255,66,162436,76,269284
4755,0.059167,172.217.194.0-255,2902,165338,76,269284
4756,0.059173,172.31.40.0-255,66,165404,76,269284
4757,0.05937,172.217.194.0-255,2902,168306,76,269284
4758,0.05962,172.31.40.0-255,66,168372,76,269284
4759,0.061455,172.217.194.0-255,2902,171274,76,269284
4760,0.06147,172.31.40.0-255,66,171340,76,269284
4761,0.061884,172.217.194.0-255,2902,174242,76,269284
4762,0.062202,172.31.40.0-255,66,174308,76,269284
4763,0.063801,172.217.194.0-255,2902,177210,76,269284
4764,0.063813,172.31.40.0-255,66,177276,76,269284
4765,0.064495,172.217.194.0-255,2902,180178,76,269284
4766,0.0645,172.31.40.0-255,66,180244,76,269284
4767,0.066162,172.217.194.0-255,2902,183146,76,269284
4768,0.066172,172.31.40.0-255,66,183212,76,269284
4769,0.066792,172.217.194.0-255,2902,186114,76,269284
4770,0.066799,172.31.40.0-255,66,186180,76,269284
4771,0.068477,172.217.194.0-255,2902,189082,76,269284
4772,0.068486,172.31.40.0-255,66,189148,76,269284
4773,0.069114,172.217.194.0-255,2902,192050,76,269284
4774,0.06912,172.31.40.0-255,66,192116,76,269284
4775,0.070799,172.217.194.0-255,2902,195018,76,269284
4776,0.070807,172.31.40.0-255,66,195084,76,269284
4777,0.071401,172.217.194.0-255,2902,197986,76,269284
4778,0.071407,172.31.40.0-255,66,198052,76,269284
4779,0.073141,172.217.194.0-255,2902,200954,76,269284
4780,0.073147,172.31.40.0-255,66,201020,76,269284
4781,0.073724,172.217.194.0-255,2902,203922,76,269284
4782,0.073731,172.31.40.0-255,66,203988,76,269284
4783,0.075443,172.217.194.0-255,2902,206890,76,269284
4784,0.07545,172.31.40.0-255,66,206956,76,269284
4785,0.076049,172.217.194.0-255,2902,209858,76,269284
4786,0.076055,172.31.40.0-255,66,209924,76,269284
4787,0.077752,172.217.194.0-255,2902,212826,76,269284
4788,0.077759,172.31.40.0-255,66,212892,76,269284
4789,0.078339,172.217.194.0-255,2902,215794,76,269284
4790,0.078346,172.31.40.0-255,66,215860,76,269284
4791,0.080046,172.217.194.0-255,2902,218762,76,269284
4792,0.080052,172.31.40.0-255,66,218828,76,269284
4793,0.080655,172.217.194.0-255,2902,221730,76,269284
4794,0.080662,172.31.40.0-255,66,221796,76,269284
4795,0.082345,172.217.194.0-255,2902,224698,76,269284
4796,0.082352,172.31.40.0-255,66,224764,76,269284
4797,0.082952,172.217.194.0-255,2902,227666,76,269284
4798,0.082959,172.31.40.0-255,66,227732,76,269284
4799,0.084685,172.217.194.0-255,2902,230634,76,269284
4800,0.084691,172.31.40.0-255,66,230700,76,269284
4801,0.08527,172.217.194.0-255,2902,233602,76,269284
4802,0.085276,172.31.40.0-255,66,233668,76,269284
4803,0.086997,172.217.194.0-255,2902,236570,76,269284
4804,0.087004,172.31.40.0-255,66,236636,76,269284
4805,0.087595,172.217.194.0-255,2902,239538,76,269284
4806,0.087602,172.31.40.0-255,66,239604,76,269284
4807,0.089306,172.217.194.0-255,2902,242506,76,269284
4808,0.089312,172.31.40.0-255,66,242572,76,269284
4809,0.089902,172.217.194.0-255,2902,245474,76,269284
4810,0.089909,172.31.40.0-255,66,245540,76,269284
4811,0.091602,172.217.194.0-255,2902,248442,76,269284
4812,0.091609,172.31.40.0-255,66,248508,76,269284
4813,0.092224,172.217.194.0-255,2902,251410,76,269284
4814,0.09223,172.31.40.0-255,66,251476,76,269284
4815,0.093892,172.217.194.0-255,2902,254378,76,269284
4816,0.093897,172.31.40.0-255,66,254444,76,269284
4817,0.094511,172.217.194.0-255,2902,257346,76,269284
4818,0.094517,172.31.40.0-255,66,257412,76,269284
4819,0.096201,172.217.194.0-255,2902,260314,76,269284
4820,0.096207,172.31.40.0-255,66,260380,76,269284
4821,0.096815,172.217.194.0-255,2902,263282,76,269284
4822,0.096821,172.31.40.0-255,66,263348,76,269284
4823,0.098503,172.217.194.0-255,2902,266250,76,269284
4824,0.098512,172.31.40.0-255,66,266316,76,269284
4825,0.099093,172.217.194.0-255,2902,269218,76,269284
4826,0.099099,172.31.40.0-255,66,269284,76,269284
4827,0.0,172.217.194.0-255,153,153,76,278521
4828,2.1e-05,172.31.40.0-255,66,219,76,278521
4829,2.7e-05,172.217.194.0-255,1484,1703,76,278521
4830,3.1e-05,172.31.40.0-255,66,1769,76,278521
4831,3.6e-05,172.217.194.0-255,2902,4671,76,278521
4832,4.6e-05,172.31.40.0-255,66,4737,76,278521
4833,5.2e-05,172.217.194.0-255,5738,10475,76,278521
4834,5.5e-05,172.31.40.0-255,66,10541,76,278521
4835,8e-05,172.217.194.0-255,3494,14035,76,278521
4836,8.6e-05,172.31.40.0-255,66,14101,76,278521
4837,0.000125,172.217.194.0-255,1484,15585,76,278521
4838,0.000128,172.31.40.0-255,66,15651,76,278521
4839,0.000131,172.217.194.0-255,1484,17135,76,278521
4840,0.000132,172.31.40.0-255,66,17201,76,278521
4841,0.000159,172.217.194.0-255,1484,18685,76,278521
4842,0.000161,172.31.40.0-255,66,18751,76,278521
4843,0.000167,172.217.194.0-255,4320,23071,76,278521
4844,0.000169,172.31.40.0-255,66,23137,76,278521
4845,0.000197,172.217.194.0-255,1484,24621,76,278521
4846,0.0002,172.31.40.0-255,66,24687,76,278521
4847,0.000209,172.31.40.0-255,66,24753,76,278521
4848,0.000213,172.217.194.0-255,2902,27655,76,278521
4849,0.000215,172.31.40.0-255,66,27721,76,278521
4850,0.000248,172.217.194.0-255,5738,33459,76,278521
4851,0.00025,172.31.40.0-255,66,33525,76,278521
4852,0.000257,172.217.194.0-255,6797,40322,76,278521
4853,0.000259,172.31.40.0-255,66,40388,76,278521
4854,0.000261,172.217.194.0-255,1484,41872,76,278521
4855,0.000263,172.31.40.0-255,66,41938,76,278521
4856,0.000297,172.217.194.0-255,5738,47676,76,278521
4857,0.0003,172.31.40.0-255,66,47742,76,278521
4858,0.00031,172.31.40.0-255,66,47808,76,278521
4859,0.000902,172.217.194.0-255,360,48168,76,278521
4860,0.000908,172.217.194.0-255,382,48550,76,278521
4861,0.001096,172.217.194.0-255,1484,50034,76,278521
4862,0.001102,172.31.40.0-255,66,50100,76,278521
4863,0.001109,172.217.194.0-255,2902,53002,76,278521
4864,0.001111,172.31.40.0-255,66,53068,76,278521
4865,0.001116,172.217.194.0-255,4320,57388,76,278521
4866,0.001118,172.31.40.0-255,66,57454,76,278521
4867,0.001139,172.217.194.0-255,1484,58938,76,278521
4868,0.001172,172.31.40.0-255,66,59004,76,278521
4869,0.00121,172.217.194.0-255,1484,60488,76,278521
4870,0.001241,172.31.40.0-255,66,60554,76,278521
4871,0.001245,172.217.194.0-255,1484,62038,76,278521
4872,0.001282,172.31.40.0-255,66,62104,76,278521
4873,0.001292,172.31.40.0-255,66,62170,76,278521
4874,0.001335,172.31.40.0-255,66,62236,76,278521
4875,0.001361,172.217.194.0-255,3602,65838,76,278521
4876,0.001363,172.31.40.0-255,66,65904,76,278521
4877,0.001376,172.31.40.0-255,66,65970,76,278521
4878,0.001391,172.31.40.0-255,66,66036,76,278521
4879,0.001415,172.217.194.0-255,1636,67672,76,278521
4880,0.001418,172.31.40.0-255,66,67738,76,278521
4881,0.00191,172.217.194.0-255,1484,69222,76,278521
4882,0.001918,172.217.194.0-255,2902,72124,76,278521
4883,0.001924,172.31.40.0-255,66,72190,76,278521
4884,0.001932,172.217.194.0-255,5738,77928,76,278521
4885,0.001934,172.31.40.0-255,66,77994,76,278521
4886,0.002013,172.31.40.0-255,66,78060,76,278521
4887,0.002026,172.31.40.0-255,66,78126,76,278521
4888,0.002127,172.217.194.0-255,1484,79610,76,278521
4889,0.002143,172.217.194.0-255,2902,82512,76,278521
4890,0.002146,172.31.40.0-255,66,82578,76,278521
4891,0.002152,172.217.194.0-255,4320,86898,76,278521
4892,0.002155,172.31.40.0-255,66,86964,76,278521
4893,0.002169,172.217.194.0-255,1484,88448,76,278521
4894,0.002174,172.217.194.0-255,2902,91350,76,278521
4895,0.002176,172.31.40.0-255,66,91416,76,278521
4896,0.002219,172.31.40.0-255,66,91482,76,278521
4897,0.002235,172.31.40.0-255,66,91548,76,278521
4898,0.002237,172.217.194.0-255,766,92314,76,278521
4899,0.004685,172.217.194.0-255,2902,95216,76,278521
4900,0.004688,172.31.40.0-255,66,95282,76,278521
4901,0.004708,172.217.194.0-255,1484,96766,76,278521
4902,0.00716,172.217.194.0-255,4320,101086,76,278521
4903,0.007166,172.31.40.0-255,66,101152,76,278521
4904,0.009619,172.217.194.0-255,5738,106890,76,278521
4905,0.009626,172.31.40.0-255,66,106956,76,278521
4906,0.012174,172.217.194.0-255,5738,112694,76,278521
4907,0.012182,172.31.40.0-255,66,112760,76,278521
4908,0.014643,172.217.194.0-255,5738,118498,76,278521
4909,0.014653,172.31.40.0-255,66,118564,76,278521
4910,0.01709,172.217.194.0-255,5738,124302,76,278521
4911,0.017098,172.31.40.0-255,66,124368,76,278521
4912,0.01956,172.217.194.0-255,5738,130106,76,278521
4913,0.019568,172.31.40.0-255,66,130172,76,278521
4914,0.022023,172.217.194.0-255,5738,135910,76,278521
4915,0.02203,172.31.40.0-255,66,135976,76,278521
4916,0.024478,172.217.194.0-255,5738,141714,76,278521
4917,0.024484,172.31.40.0-255,66,141780,76,278521
4918,0.026924,172.217.194.0-255,5738,147518,76,278521
4919,0.026932,172.31.40.0-255,66,147584,76,278521
4920,0.029446,172.217.194.0-255,5738,153322,76,278521
4921,0.029454,172.31.40.0-255,66,153388,76,278521
4922,0.031903,172.217.194.0-255,5738,159126,76,278521
4923,0.031911,172.31.40.0-255,66,159192,76,278521
4924,0.033563,172.31.40.0-255,172,159364,76,278521
4925,0.033611,172.31.40.0-255,1109,160473,76,278521
4926,0.033668,172.31.40.0-255,1514,161987,76,278521
4927,0.03367,172.31.40.0-255,1307,163294,76,278521
4928,0.034368,172.217.194.0-255,2902,166196,76,278521
4929,0.034374,172.31.40.0-255,66,166262,76,278521
4930,0.034403,172.217.194.0-255,2902,169164,76,278521
4931,0.034406,172.31.40.0-255,66,169230,76,278521
4932,0.035214,104.244.42.0-255,66,169296,76,278521
4933,0.03527,104.244.42.0-255,66,169362,76,278521
4934,0.03539,104.244.42.0-255,66,169428,76,278521
4935,0.036862,172.217.194.0-255,5738,175166,76,278521
4936,0.036866,172.31.40.0-255,66,175232,76,278521
4937,0.039347,172.217.194.0-255,5738,180970,76,278521
4938,0.039352,172.31.40.0-255,66,181036,76,278521
4939,0.041789,172.217.194.0-255,5738,186774,76,278521
4940,0.041799,172.31.40.0-255,66,186840,76,278521
4941,0.044249,172.217.194.0-255,5738,192578,76,278521
4942,0.044256,172.31.40.0-255,66,192644,76,278521
4943,0.046723,172.217.194.0-255,5738,198382,76,278521
4944,0.04673,172.31.40.0-255,66,198448,76,278521
4945,0.049211,172.217.194.0-255,5738,204186,76,278521
4946,0.049218,172.31.40.0-255,66,204252,76,278521
4947,0.051698,172.217.194.0-255,5738,209990,76,278521
4948,0.051705,172.31.40.0-255,66,210056,76,278521
4949,0.054141,172.217.194.0-255,5738,215794,76,278521
4950,0.054147,172.31.40.0-255,66,215860,76,278521
4951,0.056715,172.217.194.0-255,5738,221598,76,278521
4952,0.056721,172.31.40.0-255,66,221664,76,278521
4953,0.059195,172.217.194.0-255,5738,227402,76,278521
4954,0.059202,172.31.40.0-255,66,227468,76,278521
4955,0.061692,172.217.194.0-255,5738,233206,76,278521
4956,0.061698,172.31.40.0-255,66,233272,76,278521
4957,0.064173,172.217.194.0-255,5738,239010,76,278521
4958,0.064179,172.31.40.0-255,66,239076,76,278521
4959,0.066634,172.217.194.0-255,5738,244814,76,278521
4960,0.066641,172.31.40.0-255,66,244880,76,278521
4961,0.069108,172.217.194.0-255,5738,250618,76,278521
4962,0.069114,172.31.40.0-255,66,250684,76,278521
4963,0.071863,172.217.194.0-255,5738,256422,76,278521
4964,0.071871,172.31.40.0-255,66,256488,76,278521
4965,0.074368,172.217.194.0-255,5738,262226,76,278521
4966,0.074377,172.31.40.0-255,66,262292,76,278521
4967,0.076853,172.217.194.0-255,5738,268030,76,278521
4968,0.07686,172.31.40.0-255,66,268096,76,278521
4969,0.079321,172.217.194.0-255,5738,273834,76,278521
4970,0.079328,172.31.40.0-255,66,273900,76,278521
4971,0.081768,172.217.194.0-255,4384,278284,76,278521
4972,0.081776,172.31.40.0-255,66,278350,76,278521
4973,0.082865,172.31.40.0-255,105,278455,76,278521
4974,0.0853,172.217.194.0-255,66,278521,76,278521
4975,0.0,172.217.24.0-255,153,153,76,374409
4976,2.4e-05,172.31.40.0-255,66,219,76,374409
4977,3.1e-05,172.217.24.0-255,1484,1703,76,374409
4978,3.6e-05,172.31.40.0-255,66,1769,76,374409
4979,3.9e-05,172.217.24.0-255,1484,3253,76,374409
4980,4.2e-05,172.31.40.0-255,66,3319,76,374409
4981,4.9e-05,172.217.24.0-255,2902,6221,76,374409
4982,5.1e-05,172.31.40.0-255,66,6287,76,374409
4983,5.8e-05,172.217.24.0-255,5738,12025,76,374409
4984,6.1e-05,172.31.40.0-255,66,12091,76,374409
4985,6.5e-05,172.217.24.0-255,2056,14147,76,374409
4986,6.8e-05,172.31.40.0-255,66,14213,76,374409
4987,9.3e-05,172.217.24.0-255,1484,15697,76,374409
4988,9.7e-05,172.31.40.0-255,66,15763,76,374409
4989,0.000102,172.217.24.0-255,2902,18665,76,374409
4990,0.000105,172.31.40.0-255,66,18731,76,374409
4991,0.000127,172.217.24.0-255,5738,24469,76,374409
4992,0.000129,172.31.40.0-255,66,24535,76,374409
4993,0.000152,172.217.24.0-255,6797,31332,76,374409
4994,0.000155,172.31.40.0-255,66,31398,76,374409
4995,0.000495,172.217.24.0-255,1484,32882,76,374409
4996,0.000502,172.31.40.0-255,66,32948,76,374409
4997,0.000529,172.217.24.0-255,1484,34432,76,374409
4998,0.000532,172.31.40.0-255,66,34498,76,374409
4999,0.000547,172.217.24.0-255,2902,37400,76,374409
5000,0.000549,172.31.40.0-255,66,37466,76,374409
5001,0.000552,172.217.24.0-255,1484,38950,76,374409
5002,0.000555,172.31.40.0-255,66,39016,76,374409
5003,0.000559,172.217.24.0-255,2902,41918,76,374409
5004,0.000562,172.31.40.0-255,66,41984,76,374409
5005,0.000577,172.217.24.0-255,4320,46304,76,374409
5006,0.000579,172.31.40.0-255,66,46370,76,374409
5007,0.000604,172.217.24.0-255,1484,47854,76,374409
5008,0.000607,172.217.24.0-255,1125,48979,76,374409
5009,0.000633,172.31.40.0-255,66,49045,76,374409
5010,0.000692,172.217.24.0-255,1484,50529,76,374409
5011,0.00071,172.217.24.0-255,1484,52013,76,374409
5012,0.000727,172.217.24.0-255,2902,54915,76,374409
5013,0.000742,172.217.24.0-255,1484,56399,76,374409
5014,0.000767,172.217.24.0-255,4320,60719,76,374409
5015,0.000771,172.217.24.0-255,2902,63621,76,374409
5016,0.000808,172.217.24.0-255,2543,66164,76,374409
5017,0.000845,172.217.24.0-255,390,66554,76,374409
5018,0.000901,172.31.40.0-255,66,66620,76,374409
5019,0.001342,172.217.24.0-255,352,66972,76,374409
5020,0.001433,172.217.24.0-255,1484,68456,76,374409
5021,0.001438,172.31.40.0-255,66,68522,76,374409
5022,0.001444,172.217.24.0-255,2902,71424,76,374409
5023,0.001463,172.217.24.0-255,5738,77162,76,374409
5024,0.001477,172.31.40.0-255,66,77228,76,374409
5025,0.001514,172.217.24.0-255,6797,84025,76,374409
5026,0.00154,172.31.40.0-255,66,84091,76,374409
5027,0.001552,172.217.24.0-255,4320,88411,76,374409
5028,0.001566,172.217.24.0-255,2902,91313,76,374409
5029,0.00157,172.217.24.0-255,2902,94215,76,374409
5030,0.001594,172.217.24.0-255,1484,95699,76,374409
5031,0.001597,172.31.40.0-255,66,95765,76,374409
5032,0.00162,172.217.24.0-255,5379,101144,76,374409
5033,0.00163,172.31.40.0-255,66,101210,76,374409
5034,0.003655,172.217.24.0-255,5738,106948,76,374409
5035,0.003663,172.31.40.0-255,66,107014,76,374409
5036,0.00569,172.217.24.0-255,5738,112752,76,374409
5037,0.006251,172.31.40.0-255,66,112818,76,374409
5038,0.008276,172.217.24.0-255,5738,118556,76,374409
5039,0.008282,172.31.40.0-255,66,118622,76,374409
5040,0.010306,172.217.24.0-255,5738,124360,76,374409
5041,0.010312,172.31.40.0-255,66,124426,76,374409
5042,0.012342,172.217.24.0-255,5738,130164,76,374409
5043,0.01235,172.31.40.0-255,66,130230,76,374409
5044,0.014378,172.217.24.0-255,5738,135968,76,374409
5045,0.014385,172.31.40.0-255,66,136034,76,374409
5046,0.016418,172.217.24.0-255,5738,141772,76,374409
5047,0.016427,172.31.40.0-255,66,141838,76,374409
5048,0.018445,172.217.24.0-255,5738,147576,76,374409
5049,0.018453,172.31.40.0-255,66,147642,76,374409
5050,0.020495,172.217.24.0-255,5738,153380,76,374409
5051,0.020505,172.31.40.0-255,66,153446,76,374409
5052,0.022534,172.217.24.0-255,5738,159184,76,374409
5053,0.022543,172.31.40.0-255,66,159250,76,374409
5054,0.024566,172.217.24.0-255,5738,164988,76,374409
5055,0.024571,172.31.40.0-255,66,165054,76,374409
5056,0.026604,172.217.24.0-255,5738,170792,76,374409
5057,0.026612,172.31.40.0-255,66,170858,76,374409
5058,0.028641,172.217.24.0-255,5738,176596,76,374409
5059,0.028649,172.31.40.0-255,66,176662,76,374409
5060,0.030707,172.217.24.0-255,5738,182400,76,374409
5061,0.030716,172.31.40.0-255,66,182466,76,374409
5062,0.032756,172.217.24.0-255,5738,188204,76,374409
5063,0.032761,172.31.40.0-255,66,188270,76,374409
5064,0.0342,172.31.40.0-255,172,188442,76,374409
5065,0.034231,172.31.40.0-255,1109,189551,76,374409
5066,0.034291,172.31.40.0-255,1514,191065,76,374409
5067,0.034293,172.31.40.0-255,1307,192372,76,374409
5068,0.034784,172.217.24.0-255,5738,198110,76,374409
5069,0.034791,172.31.40.0-255,66,198176,76,374409
5070,0.035842,104.244.42.0-255,66,198242,76,374409
5071,0.035916,104.244.42.0-255,66,198308,76,374409
5072,0.035953,104.244.42.0-255,66,198374,76,374409
5073,0.036812,172.217.24.0-255,4320,202694,76,374409
5074,0.036817,172.31.40.0-255,66,202760,76,374409
5075,0.036834,172.217.24.0-255,1484,204244,76,374409
5076,0.038833,172.217.24.0-255,4320,208564,76,374409
5077,0.038839,172.31.40.0-255,66,208630,76,374409
5078,0.040866,172.217.24.0-255,5738,214368,76,374409
5079,0.041512,172.31.40.0-255,66,214434,76,374409
5080,0.043545,172.217.24.0-255,5738,220172,76,374409
5081,0.043551,172.31.40.0-255,66,220238,76,374409
5082,0.045582,172.217.24.0-255,5738,225976,76,374409
5083,0.045588,172.31.40.0-255,66,226042,76,374409
5084,0.047615,172.217.24.0-255,5738,231780,76,374409
5085,0.04762,172.31.40.0-255,66,231846,76,374409
5086,0.049638,172.217.24.0-255,5738,237584,76,374409
5087,0.049644,172.31.40.0-255,66,237650,76,374409
5088,0.051672,172.217.24.0-255,5738,243388,76,374409
5089,0.05168,172.31.40.0-255,66,243454,76,374409
5090,0.053711,172.217.24.0-255,5738,249192,76,374409
5091,0.053719,172.31.40.0-255,66,249258,76,374409
5092,0.055759,172.217.24.0-255,5738,254996,76,374409
5093,0.055766,172.31.40.0-255,66,255062,76,374409
5094,0.05783,172.217.24.0-255,5738,260800,76,374409
5095,0.057837,172.31.40.0-255,66,260866,76,374409
5096,0.059889,172.217.24.0-255,5738,266604,76,374409
5097,0.059895,172.31.40.0-255,66,266670,76,374409
5098,0.061949,172.217.24.0-255,5738,272408,76,374409
5099,0.061956,172.31.40.0-255,66,272474,76,374409
5100,0.06399,172.217.24.0-255,5738,278212,76,374409
5101,0.063996,172.31.40.0-255,66,278278,76,374409
5102,0.066043,172.217.24.0-255,4320,282598,76,374409
5103,0.06605,172.31.40.0-255,66,282664,76,374409
5104,0.066072,172.217.24.0-255,1484,284148,76,374409
5105,0.068105,172.217.24.0-255,4320,288468,76,374409
5106,0.068111,172.31.40.0-255,66,288534,76,374409
5107,0.070166,172.217.24.0-255,5738,294272,76,374409
5108,0.070223,172.31.40.0-255,66,294338,76,374409
5109,0.070312,172.31.40.0-255,101,294439,76,374409
5110,0.072273,172.217.24.0-255,5738,300177,76,374409
5111,0.072279,172.31.40.0-255,66,300243,76,374409
5112,0.072301,172.217.24.0-255,66,300309,76,374409
5113,0.074322,172.217.24.0-255,5738,306047,76,374409
5114,0.074328,172.31.40.0-255,66,306113,76,374409
5115,0.076362,172.217.24.0-255,5738,311851,76,374409
5116,0.076369,172.31.40.0-255,66,311917,76,374409
5117,0.078409,172.217.24.0-255,4320,316237,76,374409
5118,0.078416,172.31.40.0-255,66,316303,76,374409
5119,0.078435,172.217.24.0-255,1484,317787,76,374409
5120,0.080447,172.217.24.0-255,4320,322107,76,374409
5121,0.080454,172.31.40.0-255,66,322173,76,374409
5122,0.082491,172.217.24.0-255,5738,327911,76,374409
5123,0.082546,172.31.40.0-255,66,327977,76,374409
5124,0.084591,172.217.24.0-255,5738,333715,76,374409
5125,0.084597,172.31.40.0-255,66,333781,76,374409
5126,0.086641,172.217.24.0-255,5738,339519,76,374409
5127,0.086648,172.31.40.0-255,66,339585,76,374409
5128,0.08868,172.217.24.0-255,5738,345323,76,374409
5129,0.088687,172.31.40.0-255,66,345389,76,374409
5130,0.090718,172.217.24.0-255,5738,351127,76,374409
5131,0.090725,172.31.40.0-255,66,351193,76,374409
5132,0.092746,172.217.24.0-255,5738,356931,76,374409
5133,0.092753,172.31.40.0-255,66,356997,76,374409
5134,0.094782,172.217.24.0-255,5738,362735,76,374409
5135,0.094788,172.31.40.0-255,66,362801,76,374409
5136,0.096822,172.217.24.0-255,5738,368539,76,374409
5137,0.096827,172.31.40.0-255,66,368605,76,374409
5138,0.098847,172.217.24.0-255,5738,374343,76,374409
5139,0.098853,172.31.40.0-255,66,374409,76,374409
5140,0.0,74.125.68.0-255,153,153,76,379618
5141,2.2e-05,172.31.40.0-255,66,219,76,379618
5142,2.9e-05,74.125.68.0-255,1484,1703,76,379618
5143,3.4e-05,172.31.40.0-255,66,1769,76,379618
5144,4e-05,74.125.68.0-255,2902,4671,76,379618
5145,4.3e-05,172.31.40.0-255,66,4737,76,379618
5146,4.6e-05,74.125.68.0-255,1484,6221,76,379618
5147,4.8e-05,172.31.40.0-255,66,6287,76,379618
5148,5.4e-05,74.125.68.0-255,2902,9189,76,379618
5149,5.6e-05,172.31.40.0-255,66,9255,76,379618
5150,8.9e-05,74.125.68.0-255,6391,15646,76,379618
5151,9.2e-05,172.31.40.0-255,66,15712,76,379618
5152,9.6e-05,74.125.68.0-255,2902,18614,76,379618
5153,9.8e-05,172.31.40.0-255,66,18680,76,379618
5154,0.000104,74.125.68.0-255,4320,23000,76,379618
5155,0.000107,172.31.40.0-255,66,23066,76,379618
5156,0.000129,74.125.68.0-255,2902,25968,76,379618
5157,0.000131,172.31.40.0-255,66,26034,76,379618
5158,0.00016,74.125.68.0-255,5379,31413,76,379618
5159,0.000163,172.31.40.0-255,66,31479,76,379618
5160,0.000247,74.125.68.0-255,1484,32963,76,379618
5161,0.000251,172.31.40.0-255,66,33029,76,379618
5162,0.000256,74.125.68.0-255,2902,35931,76,379618
5163,0.000259,172.31.40.0-255,66,35997,76,379618
5164,0.00027,74.125.68.0-255,1484,37481,76,379618
5165,0.000272,172.31.40.0-255,66,37547,76,379618
5166,0.000291,74.125.68.0-255,4320,41867,76,379618
5167,0.000293,172.31.40.0-255,66,41933,76,379618
5168,0.0003,74.125.68.0-255,6797,48730,76,379618
5169,0.000303,172.31.40.0-255,66,48796,76,379618
5170,0.000334,74.125.68.0-255,2902,51698,76,379618
5171,0.000337,172.31.40.0-255,66,51764,76,379618
5172,0.000358,74.125.68.0-255,7156,58920,76,379618
5173,0.00036,172.31.40.0-255,66,58986,76,379618
5174,0.000393,74.125.68.0-255,7071,66057,76,379618
5175,0.000395,172.31.40.0-255,66,66123,76,379618
5176,0.000412,74.125.68.0-255,414,66537,76,379618
5177,0.000669,74.125.68.0-255,1484,68021,76,379618
5178,0.000675,172.31.40.0-255,66,68087,76,379618
5179,0.000681,74.125.68.0-255,2902,70989,76,379618
5180,0.000683,172.31.40.0-255,66,71055,76,379618
5181,0.000686,74.125.68.0-255,1484,72539,76,379618
5182,0.000716,74.125.68.0-255,2902,75441,76,379618
5183,0.000719,172.31.40.0-255,66,75507,76,379618
5184,0.000753,74.125.68.0-255,5738,81245,76,379618
5185,0.000756,172.31.40.0-255,66,81311,76,379618
5186,0.000777,74.125.68.0-255,2902,84213,76,379618
5187,0.000783,74.125.68.0-255,5738,89951,76,379618
5188,0.00079,74.125.68.0-255,7156,97107,76,379618
5189,0.000794,74.125.68.0-255,3602,100709,76,379618
5190,0.000804,172.31.40.0-255,66,100775,76,379618
5191,0.000807,172.31.40.0-255,66,100841,76,379618
5192,0.00081,172.31.40.0-255,66,100907,76,379618
5193,0.000812,172.31.40.0-255,66,100973,76,379618
5194,0.000853,74.125.68.0-255,1484,102457,76,379618
5195,0.000867,74.125.68.0-255,2902,105359,76,379618
5196,0.00087,172.31.40.0-255,66,105425,76,379618
5197,0.000894,74.125.68.0-255,4320,109745,76,379618
5198,0.000897,172.31.40.0-255,66,109811,76,379618
5199,0.000901,74.125.68.0-255,2902,112713,76,379618
5200,0.000903,172.31.40.0-255,66,112779,76,379618
5201,0.000918,74.125.68.0-255,2902,115681,76,379618
5202,0.000921,172.31.40.0-255,66,115747,76,379618
5203,0.000939,74.125.68.0-255,5738,121485,76,379618
5204,0.000942,172.31.40.0-255,66,121551,76,379618
5205,0.000971,74.125.68.0-255,5738,127289,76,379618
5206,0.000975,172.31.40.0-255,66,127355,76,379618
5207,0.000993,74.125.68.0-255,2902,130257,76,379618
5208,0.000996,172.31.40.0-255,66,130323,76,379618
5209,0.001014,74.125.68.0-255,5020,135343,76,379618
5210,0.001017,172.31.40.0-255,66,135409,76,379618
5211,0.001054,74.125.68.0-255,1484,136893,76,379618
5212,0.001058,74.125.68.0-255,2902,139795,76,379618
5213,0.001061,172.31.40.0-255,66,139861,76,379618
5214,0.00109,74.125.68.0-255,5738,145599,76,379618
5215,0.001093,172.31.40.0-255,66,145665,76,379618
5216,0.001097,74.125.68.0-255,2902,148567,76,379618
5217,0.001099,172.31.40.0-255,66,148633,76,379618
5218,0.001104,74.125.68.0-255,4320,152953,76,379618
5219,0.001106,172.31.40.0-255,66,153019,76,379618
5220,0.001131,74.125.68.0-255,4320,157339,76,379618
5221,0.001134,172.31.40.0-255,66,157405,76,379618
5222,0.001154,74.125.68.0-255,4320,161725,76,379618
5223,0.001157,172.31.40.0-255,66,161791,76,379618
5224,0.001162,74.125.68.0-255,4320,166111,76,379618
5225,0.001164,172.31.40.0-255,66,166177,76,379618
5226,0.001193,74.125.68.0-255,3602,169779,76,379618
5227,0.001197,172.31.40.0-255,66,169845,76,379618
5228,0.001221,74.125.68.0-255,4320,174165,76,379618
5229,0.001223,172.31.40.0-255,66,174231,76,379618
5230,0.001244,74.125.68.0-255,5738,179969,76,379618
5231,0.001248,172.31.40.0-255,66,180035,76,379618
5232,0.001251,74.125.68.0-255,1484,181519,76,379618
5233,0.001296,74.125.68.0-255,5738,187257,76,379618
5234,0.001299,172.31.40.0-255,66,187323,76,379618
5235,0.001314,172.31.40.0-255,66,187389,76,379618
5236,0.001335,74.125.68.0-255,1484,188873,76,379618
5237,0.001347,74.125.68.0-255,2184,191057,76,379618
5238,0.00135,172.31.40.0-255,66,191123,76,379618
5239,0.001393,74.125.68.0-255,2902,194025,76,379618
5240,0.001396,172.31.40.0-255,66,194091,76,379618
5241,0.001424,74.125.68.0-255,4320,198411,76,379618
5242,0.001428,172.31.40.0-255,66,198477,76,379618
5243,0.001445,74.125.68.0-255,1484,199961,76,379618
5244,0.001464,74.125.68.0-255,7156,207117,76,379618
5245,0.001466,172.31.40.0-255,66,207183,76,379618
5246,0.001472,74.125.68.0-255,4320,211503,76,379618
5247,0.001474,172.31.40.0-255,66,211569,76,379618
5248,0.001494,74.125.68.0-255,5738,217307,76,379618
5249,0.001496,172.31.40.0-255,66,217373,76,379618
5250,0.001502,74.125.68.0-255,5738,223111,76,379618
5251,0.001504,172.31.40.0-255,66,223177,76,379618
5252,0.001522,74.125.68.0-255,2184,225361,76,379618
5253,0.001524,172.31.40.0-255,66,225427,76,379618
5254,0.001651,74.125.68.0-255,1484,226911,76,379618
5255,0.001656,74.125.68.0-255,1484,228395,76,379618
5256,0.001659,172.31.40.0-255,66,228461,76,379618
5257,0.001674,74.125.68.0-255,1484,229945,76,379618
5258,0.001681,74.125.68.0-255,5738,235683,76,379618
5259,0.001683,172.31.40.0-255,66,235749,76,379618
5260,0.001704,74.125.68.0-255,4320,240069,76,379618
5261,0.001706,172.31.40.0-255,66,240135,76,379618
5262,0.001718,74.125.68.0-255,2902,243037,76,379618
5263,0.001721,172.31.40.0-255,66,243103,76,379618
5264,0.001733,172.31.40.0-255,66,243169,76,379618
5265,0.001764,172.31.40.0-255,66,243235,76,379618
5266,0.001843,74.125.68.0-255,1484,244719,76,379618
5267,0.001859,74.125.68.0-255,2902,247621,76,379618
5268,0.001885,74.125.68.0-255,5738,253359,76,379618
5269,0.001911,74.125.68.0-255,4320,257679,76,379618
5270,0.001928,74.125.68.0-255,7156,264835,76,379618
5271,0.001934,74.125.68.0-255,5738,270573,76,379618
5272,0.001958,74.125.68.0-255,6438,277011,76,379618
5273,0.001961,74.125.68.0-255,1484,278495,76,379618
5274,0.001965,74.125.68.0-255,2902,281397,76,379618
5275,0.001993,74.125.68.0-255,5738,287135,76,379618
5276,0.002009,74.125.68.0-255,4320,291455,76,379618
5277,0.002045,74.125.68.0-255,5738,297193,76,379618
5278,0.002049,74.125.68.0-255,2902,300095,76,379618
5279,0.002073,74.125.68.0-255,4320,304415,76,379618
5280,0.002099,74.125.68.0-255,2902,307317,76,379618
5281,0.002133,74.125.68.0-255,3602,310919,76,379618
5282,0.002156,74.125.68.0-255,7156,318075,76,379618
5283,0.002159,74.125.68.0-255,1484,319559,76,379618
5284,0.002229,74.125.68.0-255,1484,321043,76,379618
5285,0.002253,74.125.68.0-255,4320,325363,76,379618
5286,0.002268,74.125.68.0-255,7156,332519,76,379618
5287,0.002271,74.125.68.0-255,1484,334003,76,379618
5288,0.002317,74.125.68.0-255,2184,336187,76,379618
5289,0.002336,74.125.68.0-255,1484,337671,76,379618
5290,0.009744,172.31.40.0-255,66,337737,76,379618
5291,0.011084,74.125.68.0-255,1484,339221,76,379618
5292,0.012076,74.125.68.0-255,4320,343541,76,379618
5293,0.012081,172.31.40.0-255,66,343607,76,379618
5294,0.014399,74.125.68.0-255,5738,349345,76,379618
5295,0.014406,172.31.40.0-255,66,349411,76,379618
5296,0.016743,74.125.68.0-255,5738,355149,76,379618
5297,0.016761,172.31.40.0-255,66,355215,76,379618
5298,0.01909,74.125.68.0-255,5738,360953,76,379618
5299,0.019099,172.31.40.0-255,66,361019,76,379618
5300,0.021418,74.125.68.0-255,5738,366757,76,379618
5301,0.021425,172.31.40.0-255,66,366823,76,379618
5302,0.023769,74.125.68.0-255,5738,372561,76,379618
5303,0.023787,172.31.40.0-255,66,372627,76,379618
5304,0.026104,74.125.68.0-255,3552,376179,76,379618
5305,0.026117,172.31.40.0-255,66,376245,76,379618
5306,0.026738,172.31.40.0-255,105,376350,76,379618
5307,0.029029,74.125.68.0-255,66,376416,76,379618
5308,0.037524,172.31.40.0-255,171,376587,76,379618
5309,0.037557,172.31.40.0-255,1128,377715,76,379618
5310,0.037625,172.31.40.0-255,1514,379229,76,379618
5311,0.037627,172.31.40.0-255,323,379552,76,379618
5312,0.039758,104.244.42.0-255,66,379618,76,379618
5313,0.0,74.125.200.0-255,147,147,76,299520
5314,1.8e-05,172.31.40.0-255,66,213,76,299520
5315,2.5e-05,74.125.200.0-255,1484,1697,76,299520
5316,2.9e-05,172.31.40.0-255,66,1763,76,299520
5317,4.9e-05,74.125.200.0-255,2902,4665,76,299520
5318,5.2e-05,172.31.40.0-255,66,4731,76,299520
5319,8.2e-05,74.125.200.0-255,5738,10469,76,299520
5320,8.4e-05,172.31.40.0-255,66,10535,76,299520
5321,8.7e-05,74.125.200.0-255,1484,12019,76,299520
5322,9.1e-05,172.31.40.0-255,66,12085,76,299520
5323,9.6e-05,74.125.200.0-255,2019,14104,76,299520
5324,9.8e-05,172.31.40.0-255,66,14170,76,299520
5325,0.000123,74.125.200.0-255,1484,15654,76,299520
5326,0.000125,172.31.40.0-255,66,15720,76,299520
5327,0.000148,74.125.200.0-255,4320,20040,76,299520
5328,0.00015,172.31.40.0-255,66,20106,76,299520
5329,0.000156,74.125.200.0-255,4320,24426,76,299520
5330,0.000158,172.31.40.0-255,66,24492,76,299520
5331,0.000172,74.125.200.0-255,2902,27394,76,299520
5332,0.000175,172.31.40.0-255,66,27460,76,299520
5333,0.000177,74.125.200.0-255,1484,28944,76,299520
5334,0.000179,172.31.40.0-255,66,29010,76,299520
5335,0.0002,74.125.200.0-255,2543,31553,76,299520
5336,0.000203,172.31.40.0-255,66,31619,76,299520
5337,0.001392,74.125.200.0-255,1484,33103,76,299520
5338,0.001399,172.31.40.0-255,66,33169,76,299520
5339,0.001408,74.125.200.0-255,2902,36071,76,299520
5340,0.001411,172.31.40.0-255,66,36137,76,299520
5341,0.001416,74.125.200.0-255,2902,39039,76,299520
5342,0.001418,172.31.40.0-255,66,39105,76,299520
5343,0.001423,74.125.200.0-255,4320,43425,76,299520
5344,0.001425,172.31.40.0-255,66,43491,76,299520
5345,0.001454,74.125.200.0-255,1484,44975,76,299520
5346,0.001467,74.125.200.0-255,1484,46459,76,299520
5347,0.00148,74.125.200.0-255,1484,47943,76,299520
5348,0.001483,74.125.200.0-255,1484,49427,76,299520
5349,0.001506,74.125.200.0-255,4320,53747,76,299520
5350,0.00151,74.125.200.0-255,2543,56290,76,299520
5351,0.001534,74.125.200.0-255,366,56656,76,299520
5352,0.001551,74.125.200.0-255,377,57033,76,299520
5353,0.001712,74.125.200.0-255,1484,58517,76,299520
5354,0.001727,74.125.200.0-255,2902,61419,76,299520
5355,0.001747,74.125.200.0-255,2902,64321,76,299520
5356,0.001751,74.125.200.0-255,4320,68641,76,299520
5357,0.001832,74.125.200.0-255,1484,70125,76,299520
5358,0.001851,74.125.200.0-255,1125,71250,76,299520
5359,0.005414,172.31.40.0-255,66,71316,76,299520
5360,0.007719,74.125.200.0-255,5738,77054,76,299520
5361,0.007726,172.31.40.0-255,66,77120,76,299520
5362,0.010006,74.125.200.0-255,5738,82858,76,299520
5363,0.013097,172.31.40.0-255,66,82924,76,299520
5364,0.015382,74.125.200.0-255,5738,88662,76,299520
5365,0.015391,172.31.40.0-255,66,88728,76,299520
5366,0.017663,74.125.200.0-255,5738,94466,76,299520
5367,0.017669,172.31.40.0-255,66,94532,76,299520
5368,0.019959,74.125.200.0-255,5738,100270,76,299520
5369,0.019967,172.31.40.0-255,66,100336,76,299520
5370,0.021984,172.31.40.0-255,172,100508,76,299520
5371,0.022014,172.31.40.0-255,1109,101617,76,299520
5372,0.022071,172.31.40.0-255,1514,103131,76,299520
5373,0.022073,172.31.40.0-255,339,103470,76,299520
5374,0.022237,74.125.200.0-255,4320,107790,76,299520
5375,0.022242,172.31.40.0-255,66,107856,76,299520
5376,0.022266,74.125.200.0-255,1484,109340,76,299520
5377,0.024214,104.244.42.0-255,66,109406,76,299520
5378,0.024513,74.125.200.0-255,4320,113726,76,299520
5379,0.024519,172.31.40.0-255,66,113792,76,299520
5380,0.026814,74.125.200.0-255,5738,119530,76,299520
5381,0.026861,172.31.40.0-255,66,119596,76,299520
5382,0.029146,74.125.200.0-255,5738,125334,76,299520
5383,0.029153,172.31.40.0-255,66,125400,76,299520
5384,0.031446,74.125.200.0-255,5738,131138,76,299520
5385,0.031452,172.31.40.0-255,66,131204,76,299520
5386,0.033754,74.125.200.0-255,5738,136942,76,299520
5387,0.033761,172.31.40.0-255,66,137008,76,299520
5388,0.036054,74.125.200.0-255,5738,142746,76,299520
5389,0.03606,172.31.40.0-255,66,142812,76,299520
5390,0.038347,74.125.200.0-255,5738,148550,76,299520
5391,0.038354,172.31.40.0-255,66,148616,76,299520
5392,0.040654,74.125.200.0-255,5738,154354,76,299520
5393,0.040661,172.31.40.0-255,66,154420,76,299520
5394,0.042951,74.125.200.0-255,5738,160158,76,299520
5395,0.042958,172.31.40.0-255,66,160224,76,299520
5396,0.04525,74.125.200.0-255,5738,165962,76,299520
5397,0.045257,172.31.40.0-255,66,166028,76,299520
5398,0.047549,74.125.200.0-255,5738,171766,76,299520
5399,0.047556,172.31.40.0-255,66,171832,76,299520
5400,0.049838,74.125.200.0-255,5738,177570,76,299520
5401,0.049845,172.31.40.0-255,66,177636,76,299520
5402,0.052129,74.125.200.0-255,5738,183374,76,299520
5403,0.052136,172.31.40.0-255,66,183440,76,299520
5404,0.054449,74.125.200.0-255,5738,189178,76,299520
5405,0.054456,172.31.40.0-255,66,189244,76,299520
5406,0.056733,74.125.200.0-255,5738,194982,76,299520
5407,0.05674,172.31.40.0-255,66,195048,76,299520
5408,0.059024,74.125.200.0-255,5738,200786,76,299520
5409,0.059031,172.31.40.0-255,66,200852,76,299520
5410,0.061311,74.125.200.0-255,5738,206590,76,299520
5411,0.061318,172.31.40.0-255,66,206656,76,299520
5412,0.063616,74.125.200.0-255,5738,212394,76,299520
5413,0.063622,172.31.40.0-255,66,212460,76,299520
5414,0.065906,74.125.200.0-255,5738,218198,76,299520
5415,0.065916,172.31.40.0-255,66,218264,76,299520
5416,0.068225,74.125.200.0-255,5738,224002,76,299520
5417,0.068231,172.31.40.0-255,66,224068,76,299520
5418,0.070526,74.125.200.0-255,5738,229806,76,299520
5419,0.070533,172.31.40.0-255,66,229872,76,299520
5420,0.072828,74.125.200.0-255,5738,235610,76,299520
5421,0.072834,172.31.40.0-255,66,235676,76,299520
5422,0.075122,74.125.200.0-255,5738,241414,76,299520
5423,0.075127,172.31.40.0-255,66,241480,76,299520
5424,0.077409,74.125.200.0-255,5738,247218,76,299520
5425,0.077416,172.31.40.0-255,66,247284,76,299520
5426,0.07972,74.125.200.0-255,5738,253022,76,299520
5427,0.079725,172.31.40.0-255,66,253088,76,299520
5428,0.082004,74.125.200.0-255,5738,258826,76,299520
5429,0.082009,172.31.40.0-255,66,258892,76,299520
5430,0.08429,74.125.200.0-255,5738,264630,76,299520
5431,0.084296,172.31.40.0-255,66,264696,76,299520
5432,0.086587,74.125.200.0-255,5738,270434,76,299520
5433,0.086594,172.31.40.0-255,66,270500,76,299520
5434,0.088881,74.125.200.0-255,5738,276238,76,299520
5435,0.088888,172.31.40.0-255,66,276304,76,299520
5436,0.091181,74.125.200.0-255,5738,282042,76,299520
5437,0.091188,172.31.40.0-255,66,282108,76,299520
5438,0.093466,74.125.200.0-255,5738,287846,76,299520
5439,0.093473,172.31.40.0-255,66,287912,76,299520
5440,0.095751,74.125.200.0-255,5738,293650,76,299520
5441,0.095758,172.31.40.0-255,66,293716,76,299520
5442,0.098041,74.125.200.0-255,5738,299454,76,299520
5443,0.098048,172.31.40.0-255,66,299520,76,299520
5444,0.0,172.217.160.0-255,153,153,76,410754
5445,1.9e-05,172.31.40.0-255,66,219,76,410754
5446,2.6e-05,172.217.160.0-255,1484,1703,76,410754
5447,3e-05,172.31.40.0-255,66,1769,76,410754
5448,3.6e-05,172.217.160.0-255,2902,4671,76,410754
5449,3.9e-05,172.31.40.0-255,66,4737,76,410754
5450,4.7e-05,172.217.160.0-255,7156,11893,76,410754
5451,4.9e-05,172.31.40.0-255,66,11959,76,410754
5452,5.3e-05,172.217.160.0-255,2076,14035,76,410754
5453,5.7e-05,172.31.40.0-255,66,14101,76,410754
5454,0.000178,172.217.160.0-255,1484,15585,76,410754
5455,0.000183,172.31.40.0-255,66,15651,76,410754
5456,0.000189,172.217.160.0-255,2902,18553,76,410754
5457,0.000193,172.31.40.0-255,66,18619,76,410754
5458,0.000197,172.217.160.0-255,2902,21521,76,410754
5459,0.0002,172.31.40.0-255,66,21587,76,410754
5460,0.000253,172.217.160.0-255,1484,23071,76,410754
5461,0.000256,172.31.40.0-255,66,23137,76,410754
5462,0.000259,172.217.160.0-255,1484,24621,76,410754
5463,0.000261,172.31.40.0-255,66,24687,76,410754
5464,0.000279,172.217.160.0-255,1484,26171,76,410754
5465,0.000281,172.31.40.0-255,66,26237,76,410754
5466,0.000301,172.217.160.0-255,5379,31616,76,410754
5467,0.000303,172.31.40.0-255,66,31682,76,410754
5468,0.000324,172.217.160.0-255,1484,33166,76,410754
5469,0.000327,172.31.40.0-255,66,33232,76,410754
5470,0.000331,172.217.160.0-255,2902,36134,76,410754
5471,0.000333,172.31.40.0-255,66,36200,76,410754
5472,0.000346,172.217.160.0-255,4320,40520,76,410754
5473,0.000348,172.31.40.0-255,66,40586,76,410754
5474,0.000367,172.217.160.0-255,1484,42070,76,410754
5475,0.000369,172.31.40.0-255,66,42136,76,410754
5476,0.000373,172.217.160.0-255,1484,43620,76,410754
5477,0.000378,172.217.160.0-255,2902,46522,76,410754
5478,0.00038,172.31.40.0-255,66,46588,76,410754
5479,0.000397,172.217.160.0-255,2902,49490,76,410754
5480,0.000399,172.31.40.0-255,66,49556,76,410754
5481,0.000427,172.217.160.0-255,3961,53517,76,410754
5482,0.00043,172.31.40.0-255,66,53583,76,410754
5483,0.000437,172.217.160.0-255,7156,60739,76,410754
5484,0.000439,172.31.40.0-255,66,60805,76,410754
5485,0.000465,172.217.160.0-255,4320,65125,76,410754
5486,0.000467,172.31.40.0-255,66,65191,76,410754
5487,0.000488,172.217.160.0-255,1394,66585,76,410754
5488,0.000804,172.217.160.0-255,407,66992,76,410754
5489,0.00081,172.31.40.0-255,66,67058,76,410754
5490,0.000896,172.217.160.0-255,1484,68542,76,410754
5491,0.000902,172.217.160.0-255,2902,71444,76,410754
5492,0.000905,172.31.40.0-255,66,71510,76,410754
5493,0.000923,172.217.160.0-255,1484,72994,76,410754
5494,0.000939,172.217.160.0-255,4320,77314,76,410754
5495,0.000945,172.31.40.0-255,66,77380,76,410754
5496,0.000965,172.217.160.0-255,4320,81700,76,410754
5497,0.000968,172.31.40.0-255,66,81766,76,410754
5498,0.000991,172.217.160.0-255,6797,88563,76,410754
5499,0.000994,172.31.40.0-255,66,88629,76,410754
5500,0.00102,172.31.40.0-255,66,88695,76,410754
5501,0.001022,172.217.160.0-255,577,89272,76,410754
5502,0.001114,172.217.160.0-255,1484,90756,76,410754
5503,0.001118,172.31.40.0-255,66,90822,76,410754
5504,0.001123,172.217.160.0-255,2902,93724,76,410754
5505,0.001126,172.31.40.0-255,66,93790,76,410754
5506,0.001133,172.217.160.0-255,5738,99528,76,410754
5507,0.001135,172.31.40.0-255,66,99594,76,410754
5508,0.001137,172.217.160.0-255,1484,101078,76,410754
5509,0.001159,172.217.160.0-255,5738,106816,76,410754
5510,0.001162,172.31.40.0-255,66,106882,76,410754
5511,0.001183,172.217.160.0-255,5738,112620,76,410754
5512,0.001186,172.31.40.0-255,66,112686,76,410754
5513,0.001191,172.217.160.0-255,4320,117006,76,410754
5514,0.001193,172.31.40.0-255,66,117072,76,410754
5515,0.001224,172.217.160.0-255,6438,123510,76,410754
5516,0.001228,172.31.40.0-255,66,123576,76,410754
5517,0.001465,172.217.160.0-255,1484,125060,76,410754
5518,0.001472,172.217.160.0-255,2902,127962,76,410754
5519,0.001476,172.31.40.0-255,66,128028,76,410754
5520,0.001483,172.217.160.0-255,5738,133766,76,410754
5521,0.001486,172.31.40.0-255,66,133832,76,410754
5522,0.001488,172.217.160.0-255,1484,135316,76,410754
5523,0.001515,172.217.160.0-255,5738,141054,76,410754
5524,0.001518,172.31.40.0-255,66,141120,76,410754
5525,0.001535,172.217.160.0-255,7156,148276,76,410754
5526,0.001538,172.31.40.0-255,66,148342,76,410754
5527,0.001568,172.217.160.0-255,7156,155498,76,410754
5528,0.001571,172.31.40.0-255,66,155564,76,410754
5529,0.001575,172.217.160.0-255,2184,157748,76,410754
5530,0.001577,172.31.40.0-255,66,157814,76,410754
5531,0.003338,172.217.160.0-255,5738,163552,76,410754
5532,0.003346,172.31.40.0-255,66,163618,76,410754
5533,0.005116,172.217.160.0-255,5738,169356,76,410754
5534,0.00512,172.31.40.0-255,66,169422,76,410754
5535,0.006905,172.217.160.0-255,5738,175160,76,410754
5536,0.00691,172.31.40.0-255,66,175226,76,410754
5537,0.008702,172.217.160.0-255,5738,180964,76,410754
5538,0.008709,172.31.40.0-255,66,181030,76,410754
5539,0.010484,172.217.160.0-255,5738,186768,76,410754
5540,0.010491,172.31.40.0-255,66,186834,76,410754
5541,0.012286,172.217.160.0-255,4320,191154,76,410754
5542,0.012294,172.31.40.0-255,66,191220,76,410754
5543,0.012366,172.217.160.0-255,1484,192704,76,410754
5544,0.014069,172.217.160.0-255,4320,197024,76,410754
5545,0.014078,172.31.40.0-255,66,197090,76,410754
5546,0.015872,172.217.160.0-255,5738,202828,76,410754
5547,0.015879,172.31.40.0-255,66,202894,76,410754
5548,0.017653,172.217.160.0-255,5738,208632,76,410754
5549,0.017661,172.31.40.0-255,66,208698,76,410754
5550,0.019441,172.217.160.0-255,5738,214436,76,410754
5551,0.019449,172.31.40.0-255,66,214502,76,410754
5552,0.021219,172.217.160.0-255,5738,220240,76,410754
5553,0.021225,172.31.40.0-255,66,220306,76,410754
5554,0.023005,172.217.160.0-255,5738,226044,76,410754
5555,0.023016,172.31.40.0-255,66,226110,76,410754
5556,0.024805,172.217.160.0-255,5738,231848,76,410754
5557,0.024811,172.31.40.0-255,66,231914,76,410754
5558,0.026582,172.217.160.0-255,4320,236234,76,410754
5559,0.026588,172.31.40.0-255,66,236300,76,410754
5560,0.026608,172.217.160.0-255,1484,237784,76,410754
5561,0.027347,172.31.40.0-255,172,237956,76,410754
5562,0.027373,172.31.40.0-255,1105,239061,76,410754
5563,0.027424,172.31.40.0-255,1514,240575,76,410754
5564,0.027425,172.31.40.0-255,1311,241886,76,410754
5565,0.028359,172.217.160.0-255,4320,246206,76,410754
5566,0.028365,172.31.40.0-255,66,246272,76,410754
5567,0.029035,104.244.42.0-255,66,246338,76,410754
5568,0.029042,104.244.42.0-255,66,246404,76,410754
5569,0.029143,104.244.42.0-255,66,246470,76,410754
5570,0.030427,172.217.160.0-255,5738,252208,76,410754
5571,0.030432,172.31.40.0-255,66,252274,76,410754
5572,0.032213,172.217.160.0-255,5738,258012,76,410754
5573,0.032219,172.31.40.0-255,66,258078,76,410754
5574,0.033991,172.217.160.0-255,5738,263816,76,410754
5575,0.033996,172.31.40.0-255,66,263882,76,410754
5576,0.035798,172.217.160.0-255,5738,269620,76,410754
5577,0.035804,172.31.40.0-255,66,269686,76,410754
5578,0.037592,172.217.160.0-255,5738,275424,76,410754
5579,0.037598,172.31.40.0-255,66,275490,76,410754
5580,0.039385,172.217.160.0-255,5738,281228,76,410754
5581,0.039392,172.31.40.0-255,66,281294,76,410754
5582,0.041163,172.217.160.0-255,5738,287032,76,410754
5583,0.04117,172.31.40.0-255,66,287098,76,410754
5584,0.042947,172.217.160.0-255,5738,292836,76,410754
5585,0.042953,172.31.40.0-255,66,292902,76,410754
5586,0.044745,172.217.160.0-255,5738,298640,76,410754
5587,0.044752,172.31.40.0-255,66,298706,76,410754
5588,0.046559,172.217.160.0-255,5738,304444,76,410754
5589,0.046565,172.31.40.0-255,66,304510,76,410754
5590,0.048349,172.217.160.0-255,5738,310248,76,410754
5591,0.048355,172.31.40.0-255,66,310314,76,410754
5592,0.050141,172.217.160.0-255,5738,316052,76,410754
5593,0.050147,172.31.40.0-255,66,316118,76,410754
5594,0.051934,172.217.160.0-255,5738,321856,76,410754
5595,0.05194,172.31.40.0-255,66,321922,76,410754
5596,0.053735,172.217.160.0-255,5738,327660,76,410754
5597,0.053742,172.31.40.0-255,66,327726,76,410754
5598,0.055515,172.217.160.0-255,5738,333464,76,410754
5599,0.05552,172.31.40.0-255,66,333530,76,410754
5600,0.057297,172.217.160.0-255,5738,339268,76,410754
5601,0.057303,172.31.40.0-255,66,339334,76,410754
5602,0.059084,172.217.160.0-255,5738,345072,76,410754
5603,0.059091,172.31.40.0-255,66,345138,76,410754
5604,0.06091,172.217.160.0-255,5738,350876,76,410754
5605,0.060917,172.31.40.0-255,66,350942,76,410754
5606,0.062685,172.217.160.0-255,2902,353844,76,410754
5607,0.062691,172.31.40.0-255,66,353910,76,410754
5608,0.062711,172.217.160.0-255,2902,356812,76,410754
5609,0.062714,172.31.40.0-255,66,356878,76,410754
5610,0.064482,172.217.160.0-255,5738,362616,76,410754
5611,0.064487,172.31.40.0-255,66,362682,76,410754
5612,0.066264,172.217.160.0-255,5738,368420,76,410754
5613,0.066272,172.31.40.0-255,66,368486,76,410754
5614,0.068059,172.217.160.0-255,5738,374224,76,410754
5615,0.068066,172.31.40.0-255,66,374290,76,410754
5616,0.069846,172.217.160.0-255,5738,380028,76,410754
5617,0.069853,172.31.40.0-255,66,380094,76,410754
5618,0.071631,172.217.160.0-255,5738,385832,76,410754
5619,0.071637,172.31.40.0-255,66,385898,76,410754
5620,0.073403,172.217.160.0-255,4320,390218,76,410754
5621,0.07341,172.31.40.0-255,66,390284,76,410754
5622,0.073428,172.217.160.0-255,1484,391768,76,410754
5623,0.075192,172.217.160.0-255,4320,396088,76,410754
5624,0.075198,172.31.40.0-255,66,396154,76,410754
5625,0.076965,172.217.160.0-255,4320,400474,76,410754
5626,0.076971,172.31.40.0-255,66,400540,76,410754
5627,0.076988,172.217.160.0-255,1484,402024,76,410754
5628,0.078748,172.217.160.0-255,4320,406344,76,410754
5629,0.078753,172.31.40.0-255,66,406410,76,410754
5630,0.08053,172.217.160.0-255,4107,410517,76,410754
5631,0.080536,172.31.40.0-255,66,410583,76,410754
5632,0.080696,172.31.40.0-255,105,410688,76,410754
5633,0.082443,172.217.160.0-255,66,410754,76,410754
5634,0.0,172.217.194.0-255,152,152,76,364001
5635,1.6e-05,172.31.40.0-255,66,218,76,364001
5636,2.3e-05,172.217.194.0-255,1484,1702,76,364001
5637,2.8e-05,172.31.40.0-255,66,1768,76,364001
5638,3.3e-05,172.217.194.0-255,2902,4670,76,364001
5639,3.6e-05,172.31.40.0-255,66,4736,76,364001
5640,4.4e-05,172.217.194.0-255,7156,11892,76,364001
5641,4.6e-05,172.31.40.0-255,66,11958,76,364001
5642,7.2e-05,172.217.194.0-255,2166,14124,76,364001
5643,7.5e-05,172.31.40.0-255,66,14190,76,364001
5644,0.000107,172.217.194.0-255,1484,15674,76,364001
5645,0.00011,172.31.40.0-255,66,15740,76,364001
5646,0.000115,172.217.194.0-255,2902,18642,76,364001
5647,0.000117,172.31.40.0-255,66,18708,76,364001
5648,0.000142,172.217.194.0-255,5738,24446,76,364001
5649,0.000145,172.31.40.0-255,66,24512,76,364001
5650,0.000154,172.217.194.0-255,6797,31309,76,364001
5651,0.000156,172.31.40.0-255,66,31375,76,364001
5652,0.000208,172.31.40.0-255,66,31441,76,364001
5653,0.000226,172.217.194.0-255,2902,34343,76,364001
5654,0.000229,172.31.40.0-255,66,34409,76,364001
5655,0.000247,172.217.194.0-255,5379,39788,76,364001
5656,0.000251,172.31.40.0-255,66,39854,76,364001
5657,0.000508,172.217.194.0-255,1484,41338,76,364001
5658,0.000513,172.31.40.0-255,66,41404,76,364001
5659,0.000519,172.217.194.0-255,2902,44306,76,364001
5660,0.000522,172.31.40.0-255,66,44372,76,364001
5661,0.000528,172.217.194.0-255,2902,47274,76,364001
5662,0.000531,172.31.40.0-255,66,47340,76,364001
5663,0.000548,172.217.194.0-255,2902,50242,76,364001
5664,0.000551,172.31.40.0-255,66,50308,76,364001
5665,0.000555,172.217.194.0-255,2902,53210,76,364001
5666,0.000557,172.31.40.0-255,66,53276,76,364001
5667,0.00058,172.217.194.0-255,4542,57818,76,364001
5668,0.000589,172.31.40.0-255,66,57884,76,364001
5669,0.000596,172.217.194.0-255,5738,63622,76,364001
5670,0.000598,172.31.40.0-255,66,63688,76,364001
5671,0.00062,172.31.40.0-255,66,63754,76,364001
5672,0.000623,172.217.194.0-255,1125,64879,76,364001
5673,0.000675,172.31.40.0-255,66,64945,76,364001
5674,0.000702,172.31.40.0-255,66,65011,76,364001
5675,0.000925,172.217.194.0-255,1484,66495,76,364001
5676,0.00094,172.217.194.0-255,2902,69397,76,364001
5677,0.000943,172.31.40.0-255,66,69463,76,364001
5678,0.000951,172.217.194.0-255,5738,75201,76,364001
5679,0.000953,172.31.40.0-255,66,75267,76,364001
5680,0.000956,172.217.194.0-255,1484,76751,76,364001
5681,0.000975,172.217.194.0-255,4815,81566,76,364001
5682,0.000978,172.31.40.0-255,66,81632,76,364001
5683,0.001044,172.217.194.0-255,1484,83116,76,364001
5684,0.001048,172.217.194.0-255,1484,84600,76,364001
5685,0.001051,172.31.40.0-255,66,84666,76,364001
5686,0.00107,172.217.194.0-255,1484,86150,76,364001
5687,0.001077,172.217.194.0-255,5738,91888,76,364001
5688,0.001079,172.31.40.0-255,66,91954,76,364001
5689,0.001086,172.217.194.0-255,7156,99110,76,364001
5690,0.001089,172.31.40.0-255,66,99176,76,364001
5691,0.001116,172.217.194.0-255,5738,104914,76,364001
5692,0.001119,172.31.40.0-255,66,104980,76,364001
5693,0.001124,172.217.194.0-255,4320,109300,76,364001
5694,0.001126,172.31.40.0-255,66,109366,76,364001
5695,0.001171,172.217.194.0-255,6438,115804,76,364001
5696,0.001174,172.31.40.0-255,66,115870,76,364001
5697,0.001214,172.217.194.0-255,1484,117354,76,364001
5698,0.00122,172.217.194.0-255,2902,120256,76,364001
5699,0.001223,172.31.40.0-255,66,120322,76,364001
5700,0.00123,172.217.194.0-255,5738,126060,76,364001
5701,0.001232,172.31.40.0-255,66,126126,76,364001
5702,0.001285,172.217.194.0-255,5787,131913,76,364001
5703,0.001288,172.31.40.0-255,66,131979,76,364001
5704,0.001331,172.217.194.0-255,1484,133463,76,364001
5705,0.001344,172.217.194.0-255,2902,136365,76,364001
5706,0.001347,172.31.40.0-255,66,136431,76,364001
5707,0.001354,172.217.194.0-255,5738,142169,76,364001
5708,0.001356,172.31.40.0-255,66,142235,76,364001
5709,0.001371,172.217.194.0-255,5738,147973,76,364001
5710,0.001374,172.31.40.0-255,66,148039,76,364001
5711,0.001385,172.217.194.0-255,1484,149523,76,364001
5712,0.001429,172.217.194.0-255,7156,156679,76,364001
5713,0.001433,172.31.40.0-255,66,156745,76,364001
5714,0.001462,172.31.40.0-255,66,156811,76,364001
5715,0.001601,172.217.194.0-255,1484,158295,76,364001
5716,0.001607,172.217.194.0-255,2902,161197,76,364001
5717,0.00161,172.31.40.0-255,66,161263,76,364001
5718,0.001633,172.217.194.0-255,5738,167001,76,364001
5719,0.001637,172.31.40.0-255,66,167067,76,364001
5720,0.001694,172.217.194.0-255,6797,173864,76,364001
5721,0.001697,172.31.40.0-255,66,173930,76,364001
5722,0.001735,172.217.194.0-255,1484,175414,76,364001
5723,0.001749,172.217.194.0-255,2902,178316,76,364001
5724,0.001752,172.31.40.0-255,66,178382,76,364001
5725,0.001757,172.217.194.0-255,2902,181284,76,364001
5726,0.001758,172.31.40.0-255,66,181350,76,364001
5727,0.001774,172.217.194.0-255,2902,184252,76,364001
5728,0.001776,172.31.40.0-255,66,184318,76,364001
5729,0.001781,172.217.194.0-255,4320,188638,76,364001
5730,0.001783,172.31.40.0-255,66,188704,76,364001
5731,0.001814,172.31.40.0-255,66,188770,76,364001
5732,0.001836,172.217.194.0-255,5738,194508,76,364001
5733,0.001838,172.31.40.0-255,66,194574,76,364001
5734,0.001867,172.217.194.0-255,5020,199594,76,364001
5735,0.00187,172.31.40.0-255,66,199660,76,364001
5736,0.004146,172.217.194.0-255,5738,205398,76,364001
5737,0.004153,172.31.40.0-255,66,205464,76,364001
5738,0.006424,172.217.194.0-255,5738,211202,76,364001
5739,0.006432,172.31.40.0-255,66,211268,76,364001
5740,0.00869,172.217.194.0-255,5738,217006,76,364001
5741,0.008695,172.31.40.0-255,66,217072,76,364001
5742,0.010965,172.217.194.0-255,5738,222810,76,364001
5743,0.010971,172.31.40.0-255,66,222876,76,364001
5744,0.01322,172.217.194.0-255,5738,228614,76,364001
5745,0.013228,172.31.40.0-255,66,228680,76,364001
5746,0.015499,172.217.194.0-255,5738,234418,76,364001
5747,0.015507,172.31.40.0-255,66,234484,76,364001
5748,0.01775,172.217.194.0-255,5738,240222,76,364001
5749,0.017758,172.31.40.0-255,66,240288,76,364001
5750,0.020017,172.217.194.0-255,5738,246026,76,364001
5751,0.020026,172.31.40.0-255,66,246092,76,364001
5752,0.022291,172.217.194.0-255,5738,251830,76,364001
5753,0.022298,172.31.40.0-255,66,251896,76,364001
5754,0.024576,172.217.194.0-255,5738,257634,76,364001
5755,0.024583,172.31.40.0-255,66,257700,76,364001
5756,0.026836,172.217.194.0-255,5738,263438,76,364001
5757,0.026843,172.31.40.0-255,66,263504,76,364001
5758,0.027718,172.31.40.0-255,172,263676,76,364001
5759,0.027751,172.31.40.0-255,1104,264780,76,364001
5760,0.027809,172.31.40.0-255,1514,266294,76,364001
5761,0.027811,172.31.40.0-255,346,266640,76,364001
5762,0.029106,172.217.194.0-255,5738,272378,76,364001
5763,0.029113,172.31.40.0-255,66,272444,76,364001
5764,0.029827,104.244.42.0-255,66,272510,76,364001
5765,0.03138,172.217.194.0-255,5738,278248,76,364001
5766,0.031385,172.31.40.0-255,66,278314,76,364001
5767,0.033647,172.217.194.0-255,5738,284052,76,364001
5768,0.033653,172.31.40.0-255,66,284118,76,364001
5769,0.035908,172.217.194.0-255,5738,289856,76,364001
5770,0.035914,172.31.40.0-255,66,289922,76,364001
5771,0.038273,172.217.194.0-255,5738,295660,76,364001
5772,0.03828,172.31.40.0-255,66,295726,76,364001
5773,0.040525,172.217.194.0-255,5738,301464,76,364001
5774,0.04053,172.31.40.0-255,66,301530,76,364001
5775,0.042789,172.217.194.0-255,5738,307268,76,364001
5776,0.042799,172.31.40.0-255,66,307334,76,364001
5777,0.045076,172.217.194.0-255,5738,313072,76,364001
5778,0.045082,172.31.40.0-255,66,313138,76,364001
5779,0.047362,172.217.194.0-255,5738,318876,76,364001
5780,0.047369,172.31.40.0-255,66,318942,76,364001
5781,0.049682,172.217.194.0-255,5738,324680,76,364001
5782,0.049689,172.31.40.0-255,66,324746,76,364001
5783,0.051984,172.217.194.0-255,5738,330484,76,364001
5784,0.05199,172.31.40.0-255,66,330550,76,364001
5785,0.054284,172.217.194.0-255,5738,336288,76,364001
5786,0.054291,172.31.40.0-255,66,336354,76,364001
5787,0.056563,172.217.194.0-255,5738,342092,76,364001
5788,0.056567,172.31.40.0-255,66,342158,76,364001
5789,0.058847,172.217.194.0-255,5738,347896,76,364001
5790,0.058853,172.31.40.0-255,66,347962,76,364001
5791,0.061112,172.217.194.0-255,5738,353700,76,364001
5792,0.061119,172.31.40.0-255,66,353766,76,364001
5793,0.063388,172.217.194.0-255,5738,359504,76,364001
5794,0.063394,172.31.40.0-255,66,359570,76,364001
5795,0.065658,172.217.194.0-255,4194,363764,76,364001
5796,0.065665,172.31.40.0-255,66,363830,76,364001
5797,0.065823,172.31.40.0-255,105,363935,76,364001
5798,0.068061,172.217.194.0-255,66,364001,76,364001
5799,0.0,74.125.68.0-255,153,153,76,318441
5800,2e-05,172.31.40.0-255,66,219,76,318441
5801,2.7e-05,74.125.68.0-255,1484,1703,76,318441
5802,3.2e-05,172.31.40.0-255,66,1769,76,318441
5803,3.5e-05,74.125.68.0-255,1484,3253,76,318441
5804,3.7e-05,172.31.40.0-255,66,3319,76,318441
5805,5e-05,74.125.68.0-255,2902,6221,76,318441
5806,5.4e-05,172.31.40.0-255,66,6287,76,318441
5807,6.1e-05,74.125.68.0-255,5738,12025,76,318441
5808,6.4e-05,172.31.40.0-255,66,12091,76,318441
5809,9.9e-05,74.125.68.0-255,3457,15548,76,318441
5810,0.000102,172.31.40.0-255,66,15614,76,318441
5811,0.000107,74.125.68.0-255,4320,19934,76,318441
5812,0.00011,172.31.40.0-255,66,20000,76,318441
5813,0.00015,172.31.40.0-255,66,20066,76,318441
5814,0.000174,74.125.68.0-255,1125,21191,76,318441
5815,0.000177,172.31.40.0-255,66,21257,76,318441
5816,0.000244,74.125.68.0-255,1484,22741,76,318441
5817,0.000247,172.31.40.0-255,66,22807,76,318441
5818,0.000252,74.125.68.0-255,2902,25709,76,318441
5819,0.000255,172.31.40.0-255,66,25775,76,318441
5820,0.000286,74.125.68.0-255,5738,31513,76,318441
5821,0.000289,172.31.40.0-255,66,31579,76,318441
5822,0.000295,74.125.68.0-255,5738,37317,76,318441
5823,0.000297,172.31.40.0-255,66,37383,76,318441
5824,0.000326,74.125.68.0-255,6797,44180,76,318441
5825,0.000329,172.31.40.0-255,66,44246,76,318441
5826,0.000334,74.125.68.0-255,2902,47148,76,318441
5827,0.000336,172.31.40.0-255,66,47214,76,318441
5828,0.000359,74.125.68.0-255,4320,51534,76,318441
5829,0.000361,172.31.40.0-255,66,51600,76,318441
5830,0.000391,74.125.68.0-255,4272,55872,76,318441
5831,0.000393,172.31.40.0-255,66,55938,76,318441
5832,0.000413,74.125.68.0-255,111,56049,76,318441
5833,0.00045,74.125.68.0-255,1484,57533,76,318441
5834,0.000453,172.31.40.0-255,66,57599,76,318441
5835,0.000456,74.125.68.0-255,1484,59083,76,318441
5836,0.00048,74.125.68.0-255,1484,60567,76,318441
5837,0.000482,172.31.40.0-255,66,60633,76,318441
5838,0.000489,74.125.68.0-255,5738,66371,76,318441
5839,0.000492,172.31.40.0-255,66,66437,76,318441
5840,0.000511,74.125.68.0-255,1484,67921,76,318441
5841,0.000516,74.125.68.0-255,2902,70823,76,318441
5842,0.000519,172.31.40.0-255,66,70889,76,318441
5843,0.000525,74.125.68.0-255,4320,75209,76,318441
5844,0.000527,172.31.40.0-255,66,75275,76,318441
5845,0.000538,172.31.40.0-255,66,75341,76,318441
5846,0.000543,74.125.68.0-255,4320,79661,76,318441
5847,0.000591,74.125.68.0-255,1868,81529,76,318441
5848,0.000595,74.125.68.0-255,1484,83013,76,318441
5849,0.000609,74.125.68.0-255,1484,84497,76,318441
5850,0.000621,74.125.68.0-255,1484,85981,76,318441
5851,0.000642,74.125.68.0-255,5738,91719,76,318441
5852,0.000667,74.125.68.0-255,6783,98502,76,318441
5853,0.000719,172.31.40.0-255,66,98568,76,318441
5854,0.000811,74.125.68.0-255,1484,100052,76,318441
5855,0.000815,74.125.68.0-255,1484,101536,76,318441
5856,0.000822,172.31.40.0-255,66,101602,76,318441
5857,0.000829,74.125.68.0-255,1484,103086,76,318441
5858,0.000836,74.125.68.0-255,5738,108824,76,318441
5859,0.000848,172.31.40.0-255,66,108890,76,318441
5860,0.000859,74.125.68.0-255,4320,113210,76,318441
5861,0.000868,74.125.68.0-255,2902,116112,76,318441
5862,0.000887,74.125.68.0-255,2902,119014,76,318441
5863,0.000893,74.125.68.0-255,4320,123334,76,318441
5864,0.000898,172.31.40.0-255,66,123400,76,318441
5865,0.000928,74.125.68.0-255,7156,130556,76,318441
5866,0.000932,74.125.68.0-255,2184,132740,76,318441
5867,0.000937,172.31.40.0-255,66,132806,76,318441
5868,0.000981,172.31.40.0-255,66,132872,76,318441
5869,0.001,74.125.68.0-255,5738,138610,76,318441
5870,0.001003,74.125.68.0-255,115,138725,76,318441
5871,0.001046,74.125.68.0-255,1484,140209,76,318441
5872,0.00105,74.125.68.0-255,2902,143111,76,318441
5873,0.001057,74.125.68.0-255,7156,150267,76,318441
5874,0.001106,74.125.68.0-255,4320,154587,76,318441
5875,0.00111,172.31.40.0-255,66,154653,76,318441
5876,0.001115,172.31.40.0-255,66,154719,76,318441
5877,0.001127,74.125.68.0-255,2902,157621,76,318441
5878,0.001154,172.31.40.0-255,66,157687,76,318441
5879,0.001165,74.125.68.0-255,2902,160589,76,318441
5880,0.001184,74.125.68.0-255,3602,164191,76,318441
5881,0.001196,172.31.40.0-255,66,164257,76,318441
5882,0.001369,74.125.68.0-255,1484,165741,76,318441
5883,0.00139,74.125.68.0-255,2902,168643,76,318441
5884,0.001394,74.125.68.0-255,2902,171545,76,318441
5885,0.001408,74.125.68.0-255,2902,174447,76,318441
5886,0.001413,74.125.68.0-255,2902,177349,76,318441
5887,0.001418,172.31.40.0-255,66,177415,76,318441
5888,0.001429,74.125.68.0-255,4320,181735,76,318441
5889,0.001448,74.125.68.0-255,1484,183219,76,318441
5890,0.001451,172.31.40.0-255,66,183285,76,318441
5891,0.001486,74.125.68.0-255,7156,190441,76,318441
5892,0.001493,74.125.68.0-255,5738,196179,76,318441
5893,0.001508,172.31.40.0-255,66,196245,76,318441
5894,0.001531,74.125.68.0-255,2184,198429,76,318441
5895,0.001545,172.31.40.0-255,66,198495,76,318441
5896,0.00157,74.125.68.0-255,2902,201397,76,318441
5897,0.001573,74.125.68.0-255,1484,202881,76,318441
5898,0.00158,172.31.40.0-255,66,202947,76,318441
5899,0.001588,74.125.68.0-255,2902,205849,76,318441
5900,0.001607,74.125.68.0-255,4320,210169,76,318441
5901,0.001611,172.31.40.0-255,66,210235,76,318441
5902,0.001637,74.125.68.0-255,4320,214555,76,318441
5903,0.001648,74.125.68.0-255,4320,218875,76,318441
5904,0.001671,74.125.68.0-255,4320,223195,76,318441
5905,0.001677,172.31.40.0-255,66,223261,76,318441
5906,0.001723,172.31.40.0-255,66,223327,76,318441
5907,0.001726,74.125.68.0-255,1484,224811,76,318441
5908,0.001752,74.125.68.0-255,2902,227713,76,318441
5909,0.001759,74.125.68.0-255,5738,233451,76,318441
5910,0.001768,172.31.40.0-255,66,233517,76,318441
5911,0.001776,74.125.68.0-255,2902,236419,76,318441
5912,0.001787,172.31.40.0-255,66,236485,76,318441
5913,0.001794,74.125.68.0-255,1484,237969,76,318441
5914,0.001847,172.31.40.0-255,66,238035,76,318441
5915,0.001874,74.125.68.0-255,2184,240219,76,318441
5916,0.001895,74.125.68.0-255,2902,243121,76,318441
5917,0.0019,172.31.40.0-255,66,243187,76,318441
5918,0.001928,74.125.68.0-255,7156,250343,76,318441
5919,0.001931,74.125.68.0-255,1484,251827,76,318441
5920,0.001945,172.31.40.0-255,66,251893,76,318441
5921,0.001966,74.125.68.0-255,7156,259049,76,318441
5922,0.001971,74.125.68.0-255,2902,261951,76,318441
5923,0.001984,74.125.68.0-255,7156,269107,76,318441
5924,0.001996,74.125.68.0-255,1484,270591,76,318441
5925,0.002056,74.125.68.0-255,4320,274911,76,318441
5926,0.002127,74.125.68.0-255,2184,277095,76,318441
5927,0.002146,74.125.68.0-255,1484,278579,76,318441
5928,0.002165,74.125.68.0-255,2902,281481,76,318441
5929,0.002178,74.125.68.0-255,2902,284383,76,318441
5930,0.002202,74.125.68.0-255,2902,287285,76,318441
5931,0.002206,74.125.68.0-255,2902,290187,76,318441
5932,0.002219,74.125.68.0-255,4320,294507,76,318441
5933,0.002235,74.125.68.0-255,5738,300245,76,318441
5934,0.002238,74.125.68.0-255,1484,301729,76,318441
5935,0.002253,74.125.68.0-255,4320,306049,76,318441
5936,0.002275,74.125.68.0-255,5020,311069,76,318441
5937,0.002292,74.125.68.0-255,2730,313799,76,318441
5938,0.002351,74.125.68.0-255,105,313904,76,318441
5939,0.006048,172.31.40.0-255,66,313970,76,318441
5940,0.008648,172.31.40.0-255,105,314075,76,318441
5941,0.011004,74.125.68.0-255,66,314141,76,318441
5942,0.032533,172.31.40.0-255,172,314313,76,318441
5943,0.032568,172.31.40.0-255,1109,315422,76,318441
5944,0.032627,172.31.40.0-255,1514,316936,76,318441
5945,0.032629,172.31.40.0-255,1307,318243,76,318441
5946,0.03405,104.244.42.0-255,66,318309,76,318441
5947,0.034141,104.244.42.0-255,66,318375,76,318441
5948,0.034192,104.244.42.0-255,66,318441,76,318441
5949,0.0,172.217.194.0-255,153,153,76,338849
5950,1.8e-05,172.31.40.0-255,66,219,76,338849
5951,2.5e-05,172.217.194.0-255,1484,1703,76,338849
5952,2.9e-05,172.31.40.0-255,66,1769,76,338849
5953,3.6e-05,172.217.194.0-255,2902,4671,76,338849
5954,3.9e-05,172.31.40.0-255,66,4737,76,338849
5955,4.6e-05,172.217.194.0-255,5738,10475,76,338849
5956,4.9e-05,172.31.40.0-255,66,10541,76,338849
5957,8.9e-05,172.217.194.0-255,3583,14124,76,338849
5958,9.1e-05,172.31.40.0-255,66,14190,76,338849
5959,0.000148,172.217.194.0-255,1484,15674,76,338849
5960,0.000152,172.31.40.0-255,66,15740,76,338849
5961,0.000165,172.217.194.0-255,1484,17224,76,338849
5962,0.000167,172.31.40.0-255,66,17290,76,338849
5963,0.000191,172.217.194.0-255,1484,18774,76,338849
5964,0.000194,172.31.40.0-255,66,18840,76,338849
5965,0.000201,172.217.194.0-255,5738,24578,76,338849
5966,0.000203,172.31.40.0-255,66,24644,76,338849
5967,0.00021,172.217.194.0-255,6797,31441,76,338849
5968,0.000213,172.31.40.0-255,66,31507,76,338849
5969,0.000254,172.217.194.0-255,5738,37245,76,338849
5970,0.000257,172.31.40.0-255,66,37311,76,338849
5971,0.000288,172.31.40.0-255,66,37377,76,338849
5972,0.000293,172.217.194.0-255,2543,39920,76,338849
5973,0.000295,172.31.40.0-255,66,39986,76,338849
5974,0.001027,172.217.194.0-255,1484,41470,76,338849
5975,0.001034,172.31.40.0-255,66,41536,76,338849
5976,0.001043,172.217.194.0-255,2902,44438,76,338849
5977,0.001045,172.31.40.0-255,66,44504,76,338849
5978,0.001049,172.217.194.0-255,1484,45988,76,338849
5979,0.001051,172.31.40.0-255,66,46054,76,338849
5980,0.001095,172.217.194.0-255,4320,50374,76,338849
5981,0.001098,172.31.40.0-255,66,50440,76,338849
5982,0.001115,172.217.194.0-255,1484,51924,76,338849
5983,0.001136,172.217.194.0-255,5958,57882,76,338849
5984,0.001138,172.31.40.0-255,66,57948,76,338849
5985,0.001154,172.217.194.0-255,1484,59432,76,338849
5986,0.00117,172.217.194.0-255,5738,65170,76,338849
5987,0.001173,172.31.40.0-255,66,65236,76,338849
5988,0.00119,172.217.194.0-255,2902,68138,76,338849
5989,0.001192,172.31.40.0-255,66,68204,76,338849
5990,0.001217,172.217.194.0-255,5738,73942,76,338849
5991,0.001219,172.31.40.0-255,66,74008,76,338849
5992,0.001225,172.217.194.0-255,5738,79746,76,338849
5993,0.001227,172.31.40.0-255,66,79812,76,338849
5994,0.001239,172.217.194.0-255,2902,82714,76,338849
5995,0.001241,172.31.40.0-255,66,82780,76,338849
5996,0.001274,172.31.40.0-255,66,82846,76,338849
5997,0.001277,172.217.194.0-255,1125,83971,76,338849
5998,0.001485,172.217.194.0-255,1484,85455,76,338849
5999,0.001491,172.31.40.0-255,66,85521,76,338849
6000,0.001497,172.217.194.0-255,2902,88423,76,338849
6001,0.001499,172.31.40.0-255,66,88489,76,338849
6002,0.001513,172.217.194.0-255,2902,91391,76,338849
6003,0.001515,172.31.40.0-255,66,91457,76,338849
6004,0.001537,172.217.194.0-255,2902,94359,76,338849
6005,0.001539,172.31.40.0-255,66,94425,76,338849
6006,0.001542,172.217.194.0-255,1484,95909,76,338849
6007,0.001571,172.217.194.0-255,2902,98811,76,338849
6008,0.001574,172.31.40.0-255,66,98877,76,338849
6009,0.00159,172.217.194.0-255,1981,100858,76,338849
6010,0.001592,172.31.40.0-255,66,100924,76,338849
6011,0.001667,172.217.194.0-255,1484,102408,76,338849
6012,0.001673,172.217.194.0-255,2902,105310,76,338849
6013,0.001676,172.31.40.0-255,66,105376,76,338849
6014,0.001704,172.217.194.0-255,5738,111114,76,338849
6015,0.001707,172.31.40.0-255,66,111180,76,338849
6016,0.001734,172.217.194.0-255,4320,115500,76,338849
6017,0.001736,172.31.40.0-255,66,115566,76,338849
6018,0.00176,172.31.40.0-255,66,115632,76,338849
6019,0.001763,172.217.194.0-255,1484,117116,76,338849
6020,0.001791,172.31.40.0-255,66,117182,76,338849
6021,0.004365,172.217.194.0-255,5738,122920,76,338849
6022,0.004372,172.31.40.0-255,66,122986,76,338849
6023,0.00694,172.217.194.0-255,5738,128724,76,338849
6024,0.006946,172.31.40.0-255,66,128790,76,338849
6025,0.009534,172.217.194.0-255,5738,134528,76,338849
6026,0.009542,172.31.40.0-255,66,134594,76,338849
6027,0.012145,172.217.194.0-255,5738,140332,76,338849
6028,0.012151,172.31.40.0-255,66,140398,76,338849
6029,0.014744,172.217.194.0-255,5738,146136,76,338849
6030,0.014751,172.31.40.0-255,66,146202,76,338849
6031,0.017333,172.217.194.0-255,5738,151940,76,338849
6032,0.017341,172.31.40.0-255,66,152006,76,338849
6033,0.019904,172.217.194.0-255,5738,157744,76,338849
6034,0.019911,172.31.40.0-255,66,157810,76,338849
6035,0.022491,172.217.194.0-255,5738,163548,76,338849
6036,0.022497,172.31.40.0-255,66,163614,76,338849
6037,0.023283,172.31.40.0-255,172,163786,76,338849
6038,0.023313,172.31.40.0-255,1104,164890,76,338849
6039,0.023373,172.31.40.0-255,1514,166404,76,338849
6040,0.023375,172.31.40.0-255,1514,167918,76,338849
6041,0.023376,172.31.40.0-255,1514,169432,76,338849
6042,0.023377,172.31.40.0-255,670,170102,76,338849
6043,0.024843,104.244.42.0-255,66,170168,76,338849
6044,0.024878,104.244.42.0-255,66,170234,76,338849
6045,0.024937,104.244.42.0-255,66,170300,76,338849
6046,0.024958,104.244.42.0-255,66,170366,76,338849
6047,0.025081,172.217.194.0-255,5738,176104,76,338849
6048,0.025085,172.31.40.0-255,66,176170,76,338849
6049,0.027656,172.217.194.0-255,5738,181908,76,338849
6050,0.027662,172.31.40.0-255,66,181974,76,338849
6051,0.030243,172.217.194.0-255,5738,187712,76,338849
6052,0.030249,172.31.40.0-255,66,187778,76,338849
6053,0.03282,172.217.194.0-255,5738,193516,76,338849
6054,0.032827,172.31.40.0-255,66,193582,76,338849
6055,0.035434,172.217.194.0-255,5738,199320,76,338849
6056,0.035442,172.31.40.0-255,66,199386,76,338849
6057,0.037999,172.217.194.0-255,5738,205124,76,338849
6058,0.038005,172.31.40.0-255,66,205190,76,338849
6059,0.040615,172.217.194.0-255,5738,210928,76,338849
6060,0.040624,172.31.40.0-255,66,210994,76,338849
6061,0.043237,172.217.194.0-255,5738,216732,76,338849
6062,0.043243,172.31.40.0-255,66,216798,76,338849
6063,0.045821,172.217.194.0-255,5738,222536,76,338849
6064,0.045827,172.31.40.0-255,66,222602,76,338849
6065,0.048444,172.217.194.0-255,5738,228340,76,338849
6066,0.048464,172.31.40.0-255,66,228406,76,338849
6067,0.051065,172.217.194.0-255,5738,234144,76,338849
6068,0.051087,172.31.40.0-255,66,234210,76,338849
6069,0.053714,172.217.194.0-255,5738,239948,76,338849
6070,0.053736,172.31.40.0-255,66,240014,76,338849
6071,0.056311,172.217.194.0-255,5738,245752,76,338849
6072,0.05632,172.31.40.0-255,66,245818,76,338849
6073,0.058939,172.217.194.0-255,5738,251556,76,338849
6074,0.058946,172.31.40.0-255,66,251622,76,338849
6075,0.061526,172.217.194.0-255,5738,257360,76,338849
6076,0.061532,172.31.40.0-255,66,257426,76,338849
6077,0.0641,172.217.194.0-255,5738,263164,76,338849
6078,0.064108,172.31.40.0-255,66,263230,76,338849
6079,0.066713,172.217.194.0-255,5738,268968,76,338849
6080,0.066721,172.31.40.0-255,66,269034,76,338849
6081,0.069282,172.217.194.0-255,5738,274772,76,338849
6082,0.069289,172.31.40.0-255,66,274838,76,338849
6083,0.071855,172.217.194.0-255,5738,280576,76,338849
6084,0.071861,172.31.40.0-255,66,280642,76,338849
6085,0.07449,172.217.194.0-255,5738,286380,76,338849
6086,0.074497,172.31.40.0-255,66,286446,76,338849
6087,0.077089,172.217.194.0-255,5738,292184,76,338849
6088,0.077095,172.31.40.0-255,66,292250,76,338849
6089,0.079708,172.217.194.0-255,5738,297988,76,338849
6090,0.079714,172.31.40.0-255,66,298054,76,338849
6091,0.079823,172.31.40.0-255,101,298155,76,338849
6092,0.082291,172.217.194.0-255,5738,303893,76,338849
6093,0.082298,172.31.40.0-255,66,303959,76,338849
6094,0.082379,172.217.194.0-255,66,304025,76,338849
6095,0.084884,172.217.194.0-255,5738,309763,76,338849
6096,0.08489,172.31.40.0-255,66,309829,76,338849
6097,0.08749,172.217.194.0-255,5738,315567,76,338849
6098,0.087496,172.31.40.0-255,66,315633,76,338849
6099,0.090071,172.217.194.0-255,5738,321371,76,338849
6100,0.090075,172.31.40.0-255,66,321437,76,338849
6101,0.092651,172.217.194.0-255,5738,327175,76,338849
6102,0.092656,172.31.40.0-255,66,327241,76,338849
6103,0.095242,172.217.194.0-255,5738,332979,76,338849
6104,0.09525,172.31.40.0-255,66,333045,76,338849
6105,0.097838,172.217.194.0-255,5738,338783,76,338849
6106,0.097847,172.31.40.0-255,66,338849,76,338849
6107,0.0,172.217.194.0-255,146,146,76,289800
6108,2.3e-05,172.31.40.0-255,66,212,76,289800
6109,3e-05,172.217.194.0-255,1484,1696,76,289800
6110,3.4e-05,172.31.40.0-255,66,1762,76,289800
6111,4e-05,172.217.194.0-255,2902,4664,76,289800
6112,4.3e-05,172.31.40.0-255,66,4730,76,289800
6113,4.9e-05,172.217.194.0-255,5738,10468,76,289800
6114,5.1e-05,172.31.40.0-255,66,10534,76,289800
6115,8.7e-05,172.217.194.0-255,3554,14088,76,289800
6116,9e-05,172.31.40.0-255,66,14154,76,289800
6117,9.6e-05,172.217.194.0-255,4320,18474,76,289800
6118,9.9e-05,172.31.40.0-255,66,18540,76,289800
6119,0.000129,172.31.40.0-255,66,18606,76,289800
6120,0.000153,172.217.194.0-255,2543,21149,76,289800
6121,0.000155,172.31.40.0-255,66,21215,76,289800
6122,0.000333,172.217.194.0-255,1484,22699,76,289800
6123,0.000339,172.31.40.0-255,66,22765,76,289800
6124,0.000344,172.217.194.0-255,2902,25667,76,289800
6125,0.000346,172.31.40.0-255,66,25733,76,289800
6126,0.00035,172.217.194.0-255,2902,28635,76,289800
6127,0.000352,172.31.40.0-255,66,28701,76,289800
6128,0.000375,172.217.194.0-255,2902,31603,76,289800
6129,0.000378,172.31.40.0-255,66,31669,76,289800
6130,0.000403,172.217.194.0-255,6797,38466,76,289800
6131,0.000405,172.31.40.0-255,66,38532,76,289800
6132,0.000471,172.217.194.0-255,1484,40016,76,289800
6133,0.000475,172.31.40.0-255,66,40082,76,289800
6134,0.00048,172.217.194.0-255,2902,42984,76,289800
6135,0.000482,172.31.40.0-255,66,43050,76,289800
6136,0.000511,172.217.194.0-255,1484,44534,76,289800
6137,0.000513,172.31.40.0-255,66,44600,76,289800
6138,0.000535,172.217.194.0-255,4320,48920,76,289800
6139,0.000538,172.31.40.0-255,66,48986,76,289800
6140,0.000545,172.217.194.0-255,6797,55783,76,289800
6141,0.000547,172.31.40.0-255,66,55849,76,289800
6142,0.00055,172.217.194.0-255,678,56527,76,289800
6143,0.000628,172.217.194.0-255,1484,58011,76,289800
6144,0.000632,172.31.40.0-255,66,58077,76,289800
6145,0.000638,172.217.194.0-255,2902,60979,76,289800
6146,0.00064,172.31.40.0-255,66,61045,76,289800
6147,0.000646,172.217.194.0-255,5738,66783,76,289800
6148,0.000649,172.31.40.0-255,66,66849,76,289800
6149,0.000654,172.217.194.0-255,4320,71169,76,289800
6150,0.000658,172.31.40.0-255,66,71235,76,289800
6151,0.000682,172.217.194.0-255,2543,73778,76,289800
6152,0.000685,172.31.40.0-255,66,73844,76,289800
6153,0.000692,172.217.194.0-255,5738,79582,76,289800
6154,0.000694,172.31.40.0-255,66,79648,76,289800
6155,0.000717,172.31.40.0-255,66,79714,76,289800
6156,0.000721,172.217.194.0-255,2543,82257,76,289800
6157,0.000723,172.31.40.0-255,66,82323,76,289800
6158,0.001139,172.217.194.0-255,1484,83807,76,289800
6159,0.001146,172.217.194.0-255,2902,86709,76,289800
6160,0.00115,172.31.40.0-255,66,86775,76,289800
6161,0.001154,172.217.194.0-255,1484,88259,76,289800
6162,0.001174,172.217.194.0-255,4320,92579,76,289800
6163,0.001177,172.31.40.0-255,66,92645,76,289800
6164,0.001217,172.31.40.0-255,66,92711,76,289800
6165,0.001229,172.31.40.0-255,66,92777,76,289800
6166,0.001281,172.31.40.0-255,101,92878,76,289800
6167,0.001753,172.217.194.0-255,1484,94362,76,289800
6168,0.001761,172.217.194.0-255,2902,97264,76,289800
6169,0.001765,172.31.40.0-255,66,97330,76,289800
6170,0.001772,172.217.194.0-255,5738,103068,76,289800
6171,0.001774,172.31.40.0-255,66,103134,76,289800
6172,0.001806,172.31.40.0-255,66,103200,76,289800
6173,0.001821,172.217.194.0-255,1484,104684,76,289800
6174,0.001824,172.217.194.0-255,1484,106168,76,289800
6175,0.001826,172.31.40.0-255,66,106234,76,289800
6176,0.001862,172.31.40.0-255,66,106300,76,289800
6177,0.001874,172.31.40.0-255,66,106366,76,289800
6178,0.001877,172.217.194.0-255,1484,107850,76,289800
6179,0.001902,172.31.40.0-255,66,107916,76,289800
6180,0.001926,172.217.194.0-255,5738,113654,76,289800
6181,0.001929,172.31.40.0-255,66,113720,76,289800
6182,0.001931,172.217.194.0-255,766,114486,76,289800
6183,0.001934,172.217.194.0-255,1484,115970,76,289800
6184,0.001935,172.31.40.0-255,66,116036,76,289800
6185,0.001941,172.217.194.0-255,4320,120356,76,289800
6186,0.001943,172.31.40.0-255,66,120422,76,289800
6187,0.001954,172.31.40.0-255,66,120488,76,289800
6188,0.001968,172.217.194.0-255,1484,121972,76,289800
6189,0.001989,172.217.194.0-255,7156,129128,76,289800
6190,0.001991,172.31.40.0-255,66,129194,76,289800
6191,0.00202,172.31.40.0-255,66,129260,76,289800
6192,0.002069,172.217.194.0-255,1484,130744,76,289800
6193,0.002075,172.217.194.0-255,2902,133646,76,289800
6194,0.002077,172.31.40.0-255,66,133712,76,289800
6195,0.002084,172.217.194.0-255,5738,139450,76,289800
6196,0.002086,172.31.40.0-255,66,139516,76,289800
6197,0.002129,172.31.40.0-255,66,139582,76,289800
6198,0.002141,172.31.40.0-255,66,139648,76,289800
6199,0.002159,172.217.194.0-255,2184,141832,76,289800
6200,0.002161,172.31.40.0-255,66,141898,76,289800
6201,0.002261,172.217.194.0-255,1484,143382,76,289800
6202,0.002266,172.217.194.0-255,2902,146284,76,289800
6203,0.00227,172.31.40.0-255,66,146350,76,289800
6204,0.002277,172.217.194.0-255,5738,152088,76,289800
6205,0.002279,172.31.40.0-255,66,152154,76,289800
6206,0.002282,172.217.194.0-255,1484,153638,76,289800
6207,0.003501,172.217.194.0-255,66,153704,76,289800
6208,0.004543,172.217.194.0-255,4320,158024,76,289800
6209,0.004554,172.31.40.0-255,66,158090,76,289800
6210,0.006823,172.217.194.0-255,5738,163828,76,289800
6211,0.006834,172.31.40.0-255,66,163894,76,289800
6212,0.009106,172.217.194.0-255,5738,169632,76,289800
6213,0.00911,172.31.40.0-255,66,169698,76,289800
6214,0.011391,172.217.194.0-255,5738,175436,76,289800
6215,0.011399,172.31.40.0-255,66,175502,76,289800
6216,0.013687,172.217.194.0-255,5738,181240,76,289800
6217,0.013702,172.31.40.0-255,66,181306,76,289800
6218,0.015983,172.217.194.0-255,5738,187044,76,289800
6219,0.015997,172.31.40.0-255,66,187110,76,289800
6220,0.018273,172.217.194.0-255,5738,192848,76,289800
6221,0.01828,172.31.40.0-255,66,192914,76,289800
6222,0.02054,172.217.194.0-255,5738,198652,76,289800
6223,0.020547,172.31.40.0-255,66,198718,76,289800
6224,0.022814,172.217.194.0-255,5738,204456,76,289800
6225,0.022826,172.31.40.0-255,66,204522,76,289800
6226,0.025094,172.217.194.0-255,5738,210260,76,289800
6227,0.025103,172.31.40.0-255,66,210326,76,289800
6228,0.027378,172.217.194.0-255,5738,216064,76,289800
6229,0.027387,172.31.40.0-255,66,216130,76,289800
6230,0.029654,172.217.194.0-255,5738,221868,76,289800
6231,0.029661,172.31.40.0-255,66,221934,76,289800
6232,0.031912,172.217.194.0-255,5738,227672,76,289800
6233,0.031919,172.31.40.0-255,66,227738,76,289800
6234,0.034194,172.217.194.0-255,5738,233476,76,289800
6235,0.034201,172.31.40.0-255,66,233542,76,289800
6236,0.036465,172.217.194.0-255,5738,239280,76,289800
6237,0.036473,172.31.40.0-255,66,239346,76,289800
6238,0.038746,172.217.194.0-255,5738,245084,76,289800
6239,0.038754,172.31.40.0-255,66,245150,76,289800
6240,0.038895,172.31.40.0-255,172,245322,76,289800
6241,0.038923,172.31.40.0-255,1104,246426,76,289800
6242,0.039034,172.31.40.0-255,1514,247940,76,289800
6243,0.039036,172.31.40.0-255,347,248287,76,289800
6244,0.040554,104.244.42.0-255,66,248353,76,289800
6245,0.040999,172.217.194.0-255,5738,254091,76,289800
6246,0.041004,172.31.40.0-255,66,254157,76,289800
6247,0.043276,172.217.194.0-255,5738,259895,76,289800
6248,0.043285,172.31.40.0-255,66,259961,76,289800
6249,0.045557,172.217.194.0-255,5738,265699,76,289800
6250,0.045563,172.31.40.0-255,66,265765,76,289800
6251,0.047842,172.217.194.0-255,5738,271503,76,289800
6252,0.047849,172.31.40.0-255,66,271569,76,289800
6253,0.050111,172.217.194.0-255,5738,277307,76,289800
6254,0.050116,172.31.40.0-255,66,277373,76,289800
6255,0.052369,172.217.194.0-255,5738,283111,76,289800
6256,0.052375,172.31.40.0-255,66,283177,76,289800
6257,0.054658,172.217.194.0-255,5738,288915,76,289800
6258,0.054664,172.31.40.0-255,66,288981,76,289800
6259,0.056911,172.217.194.0-255,648,289629,76,289800
6260,0.057052,172.31.40.0-255,105,289734,76,289800
6261,0.063264,172.217.194.0-255,66,289800,76,289800
6262,0.0,74.125.24.0-255,217,217,76,177282
6263,2.2e-05,172.31.40.0-255,66,283,76,177282
6264,2.9e-05,74.125.24.0-255,1484,1767,76,177282
6265,3.2e-05,172.31.40.0-255,66,1833,76,177282
6266,4.7e-05,74.125.24.0-255,4320,6153,76,177282
6267,5.1e-05,172.31.40.0-255,66,6219,76,177282
6268,8.9e-05,172.31.40.0-255,66,6285,76,177282
6269,0.0001,172.31.40.0-255,66,6351,76,177282
6270,0.000131,74.125.24.0-255,2902,9253,76,177282
6271,0.000134,172.31.40.0-255,66,9319,76,177282
6272,0.00016,74.125.24.0-255,2543,11862,76,177282
6273,0.000162,172.31.40.0-255,66,11928,76,177282
6274,0.000192,74.125.24.0-255,1484,13412,76,177282
6275,0.000195,172.31.40.0-255,66,13478,76,177282
6276,0.000199,74.125.24.0-255,2902,16380,76,177282
6277,0.000201,172.31.40.0-255,66,16446,76,177282
6278,0.000204,74.125.24.0-255,1484,17930,76,177282
6279,0.000206,172.31.40.0-255,66,17996,76,177282
6280,0.000237,74.125.24.0-255,4320,22316,76,177282
6281,0.000239,172.31.40.0-255,66,22382,76,177282
6282,0.000246,74.125.24.0-255,6797,29179,76,177282
6283,0.000249,172.31.40.0-255,66,29245,76,177282
6284,0.000253,74.125.24.0-255,2902,32147,76,177282
6285,0.000256,172.31.40.0-255,66,32213,76,177282
6286,0.000293,74.125.24.0-255,4320,36533,76,177282
6287,0.000297,172.31.40.0-255,66,36599,76,177282
6288,0.000308,172.31.40.0-255,66,36665,76,177282
6289,0.000373,74.125.24.0-255,381,37046,76,177282
6290,0.000376,172.31.40.0-255,66,37112,76,177282
6291,0.00052,74.125.24.0-255,1484,38596,76,177282
6292,0.000528,74.125.24.0-255,2902,41498,76,177282
6293,0.000531,172.31.40.0-255,66,41564,76,177282
6294,0.000537,74.125.24.0-255,4320,45884,76,177282
6295,0.000539,172.31.40.0-255,66,45950,76,177282
6296,0.000559,74.125.24.0-255,1484,47434,76,177282
6297,0.000563,74.125.24.0-255,2902,50336,76,177282
6298,0.000566,172.31.40.0-255,66,50402,76,177282
6299,0.000595,172.31.40.0-255,66,50468,76,177282
6300,0.000649,172.31.40.0-255,66,50534,76,177282
6301,0.000759,74.125.24.0-255,1484,52018,76,177282
6302,0.00078,74.125.24.0-255,2902,54920,76,177282
6303,0.000783,172.31.40.0-255,66,54986,76,177282
6304,0.000789,74.125.24.0-255,5738,60724,76,177282
6305,0.000793,172.31.40.0-255,66,60790,76,177282
6306,0.000821,74.125.24.0-255,2902,63692,76,177282
6307,0.000824,172.31.40.0-255,66,63758,76,177282
6308,0.000861,172.31.40.0-255,66,63824,76,177282
6309,0.000866,74.125.24.0-255,4320,68144,76,177282
6310,0.000869,172.31.40.0-255,66,68210,76,177282
6311,0.000872,74.125.24.0-255,1484,69694,76,177282
6312,0.000909,74.125.24.0-255,5020,74714,76,177282
6313,0.000912,172.31.40.0-255,66,74780,76,177282
6314,0.000975,74.125.24.0-255,1484,76264,76,177282
6315,0.00099,74.125.24.0-255,2902,79166,76,177282
6316,0.000994,172.31.40.0-255,66,79232,76,177282
6317,0.000998,74.125.24.0-255,2902,82134,76,177282
6318,0.001001,172.31.40.0-255,66,82200,76,177282
6319,0.00102,74.125.24.0-255,2902,85102,76,177282
6320,0.001024,74.125.24.0-255,2902,88004,76,177282
6321,0.001034,172.31.40.0-255,66,88070,76,177282
6322,0.001036,172.31.40.0-255,66,88136,76,177282
6323,0.001061,172.31.40.0-255,66,88202,76,177282
6324,0.001068,74.125.24.0-255,7156,95358,76,177282
6325,0.001071,172.31.40.0-255,66,95424,76,177282
6326,0.001103,74.125.24.0-255,7156,102580,76,177282
6327,0.001106,172.31.40.0-255,66,102646,76,177282
6328,0.001131,172.31.40.0-255,66,102712,76,177282
6329,0.001151,172.31.40.0-255,66,102778,76,177282
6330,0.001154,74.125.24.0-255,1484,104262,76,177282
6331,0.001179,74.125.24.0-255,5020,109282,76,177282
6332,0.001182,172.31.40.0-255,66,109348,76,177282
6333,0.001223,74.125.24.0-255,1484,110832,76,177282
6334,0.001259,74.125.24.0-255,2902,113734,76,177282
6335,0.001262,172.31.40.0-255,66,113800,76,177282
6336,0.001267,74.125.24.0-255,2902,116702,76,177282
6337,0.001269,172.31.40.0-255,66,116768,76,177282
6338,0.001293,74.125.24.0-255,2902,119670,76,177282
6339,0.001296,172.31.40.0-255,66,119736,76,177282
6340,0.001311,172.31.40.0-255,66,119802,76,177282
6341,0.001314,74.125.24.0-255,1484,121286,76,177282
6342,0.001354,172.31.40.0-255,66,121352,76,177282
6343,0.001492,74.125.24.0-255,1484,122836,76,177282
6344,0.001496,74.125.24.0-255,1484,124320,76,177282
6345,0.0015,172.31.40.0-255,66,124386,76,177282
6346,0.001521,74.125.24.0-255,1484,125870,76,177282
6347,0.001528,74.125.24.0-255,5738,131608,76,177282
6348,0.001532,172.31.40.0-255,66,131674,76,177282
6349,0.001568,172.31.40.0-255,66,131740,76,177282
6350,0.001604,74.125.24.0-255,2902,134642,76,177282
6351,0.001607,172.31.40.0-255,66,134708,76,177282
6352,0.001621,172.31.40.0-255,66,134774,76,177282
6353,0.001625,74.125.24.0-255,2902,137676,76,177282
6354,0.001627,172.31.40.0-255,66,137742,76,177282
6355,0.001679,172.31.40.0-255,66,137808,76,177282
6356,0.001708,74.125.24.0-255,4320,142128,76,177282
6357,0.001712,172.31.40.0-255,66,142194,76,177282
6358,0.001725,172.31.40.0-255,66,142260,76,177282
6359,0.001728,74.125.24.0-255,1484,143744,76,177282
6360,0.001733,74.125.24.0-255,2902,146646,76,177282
6361,0.001735,172.31.40.0-255,66,146712,76,177282
6362,0.001741,74.125.24.0-255,5738,152450,76,177282
6363,0.001743,172.31.40.0-255,66,152516,76,177282
6364,0.001755,172.31.40.0-255,66,152582,76,177282
6365,0.001792,74.125.24.0-255,2902,155484,76,177282
6366,0.001795,172.31.40.0-255,66,155550,76,177282
6367,0.001804,172.31.40.0-255,66,155616,76,177282
6368,0.00182,74.125.24.0-255,4320,159936,76,177282
6369,0.001826,172.31.40.0-255,66,160002,76,177282
6370,0.001871,172.31.40.0-255,66,160068,76,177282
6371,0.001879,74.125.24.0-255,7156,167224,76,177282
6372,0.001882,172.31.40.0-255,66,167290,76,177282
6373,0.00192,172.31.40.0-255,66,167356,76,177282
6374,0.001935,172.31.40.0-255,66,167422,76,177282
6375,0.001987,172.31.40.0-255,66,167488,76,177282
6376,0.001993,74.125.24.0-255,5020,172508,76,177282
6377,0.001995,172.31.40.0-255,66,172574,76,177282
6378,0.002008,172.31.40.0-255,66,172640,76,177282
6379,0.00201,74.125.24.0-255,105,172745,76,177282
6380,0.012173,172.31.40.0-255,66,172811,76,177282
6381,0.012217,172.31.40.0-255,105,172916,76,177282
6382,0.0146,74.125.24.0-255,66,172982,76,177282
6383,0.030676,172.31.40.0-255,172,173154,76,177282
6384,0.030702,172.31.40.0-255,1107,174261,76,177282
6385,0.030752,172.31.40.0-255,1514,175775,76,177282
6386,0.030754,172.31.40.0-255,1309,177084,76,177282
6387,0.032319,104.244.42.0-255,66,177150,76,177282
6388,0.032361,104.244.42.0-255,66,177216,76,177282
6389,0.032404,104.244.42.0-255,66,177282,76,177282
6390,0.0,172.217.194.0-255,296,296,76,182046
6391,2.4e-05,172.31.40.0-255,66,362,76,182046
6392,3.1e-05,172.217.194.0-255,1484,1846,76,182046
6393,3.6e-05,172.31.40.0-255,66,1912,76,182046
6394,4.2e-05,172.217.194.0-255,4320,6232,76,182046
6395,5.2e-05,172.31.40.0-255,66,6298,76,182046
6396,6.4e-05,172.31.40.0-255,66,6364,76,182046
6397,6.9e-05,172.217.194.0-255,2902,9266,76,182046
6398,7.1e-05,172.31.40.0-255,66,9332,76,182046
6399,0.000124,172.31.40.0-255,66,9398,76,182046
6400,0.000127,172.217.194.0-255,1125,10523,76,182046
6401,0.000129,172.31.40.0-255,66,10589,76,182046
6402,0.000132,172.217.194.0-255,1484,12073,76,182046
6403,0.000134,172.31.40.0-255,66,12139,76,182046
6404,0.000146,172.217.194.0-255,4320,16459,76,182046
6405,0.000148,172.31.40.0-255,66,16525,76,182046
6406,0.00016,172.31.40.0-255,66,16591,76,182046
6407,0.000173,172.217.194.0-255,1484,18075,76,182046
6408,0.000175,172.31.40.0-255,66,18141,76,182046
6409,0.000183,172.217.194.0-255,7156,25297,76,182046
6410,0.000189,172.31.40.0-255,66,25363,76,182046
6411,0.000211,172.217.194.0-255,1484,26847,76,182046
6412,0.000213,172.31.40.0-255,66,26913,76,182046
6413,0.000245,172.31.40.0-255,66,26979,76,182046
6414,0.000304,172.217.194.0-255,1484,28463,76,182046
6415,0.000307,172.31.40.0-255,66,28529,76,182046
6416,0.00031,172.217.194.0-255,1484,30013,76,182046
6417,0.000313,172.31.40.0-255,66,30079,76,182046
6418,0.000334,172.217.194.0-255,1484,31563,76,182046
6419,0.000345,172.217.194.0-255,5738,37301,76,182046
6420,0.000348,172.31.40.0-255,66,37367,76,182046
6421,0.000404,172.217.194.0-255,6797,44164,76,182046
6422,0.000406,172.31.40.0-255,66,44230,76,182046
6423,0.000413,172.217.194.0-255,5738,49968,76,182046
6424,0.000416,172.31.40.0-255,66,50034,76,182046
6425,0.000442,172.217.194.0-255,1484,51518,76,182046
6426,0.000455,172.31.40.0-255,66,51584,76,182046
6427,0.000458,172.217.194.0-255,577,52161,76,182046
6428,0.000651,172.217.194.0-255,1484,53645,76,182046
6429,0.000655,172.31.40.0-255,66,53711,76,182046
6430,0.000661,172.217.194.0-255,2902,56613,76,182046
6431,0.000665,172.31.40.0-255,66,56679,76,182046
6432,0.000676,172.217.194.0-255,5738,62417,76,182046
6433,0.000679,172.31.40.0-255,66,62483,76,182046
6434,0.000686,172.217.194.0-255,7156,69639,76,182046
6435,0.000689,172.31.40.0-255,66,69705,76,182046
6436,0.000736,172.31.40.0-255,66,69771,76,182046
6437,0.00074,172.217.194.0-255,2184,71955,76,182046
6438,0.000742,172.31.40.0-255,66,72021,76,182046
6439,0.000881,172.217.194.0-255,1484,73505,76,182046
6440,0.000887,172.217.194.0-255,2902,76407,76,182046
6441,0.000891,172.31.40.0-255,66,76473,76,182046
6442,0.000895,172.217.194.0-255,1484,77957,76,182046
6443,0.000924,172.217.194.0-255,4320,82277,76,182046
6444,0.000927,172.31.40.0-255,66,82343,76,182046
6445,0.000941,172.31.40.0-255,66,82409,76,182046
6446,0.000957,172.31.40.0-255,66,82475,76,182046
6447,0.000985,172.217.194.0-255,2184,84659,76,182046
6448,0.000989,172.31.40.0-255,66,84725,76,182046
6449,0.001217,172.217.194.0-255,1484,86209,76,182046
6450,0.00123,172.217.194.0-255,1484,87693,76,182046
6451,0.001233,172.31.40.0-255,66,87759,76,182046
6452,0.001239,172.217.194.0-255,2902,90661,76,182046
6453,0.001241,172.31.40.0-255,66,90727,76,182046
6454,0.001268,172.217.194.0-255,4320,95047,76,182046
6455,0.00127,172.31.40.0-255,66,95113,76,182046
6456,0.001307,172.217.194.0-255,1484,96597,76,182046
6457,0.001331,172.31.40.0-255,66,96663,76,182046
6458,0.001338,172.31.40.0-255,66,96729,76,182046
6459,0.00137,172.31.40.0-255,66,96795,76,182046
6460,0.001398,172.217.194.0-255,4320,101115,76,182046
6461,0.0014,172.31.40.0-255,66,101181,76,182046
6462,0.001413,172.31.40.0-255,66,101247,76,182046
6463,0.001444,172.217.194.0-255,5738,106985,76,182046
6464,0.001447,172.31.40.0-255,66,107051,76,182046
6465,0.001452,172.217.194.0-255,3602,110653,76,182046
6466,0.001454,172.31.40.0-255,66,110719,76,182046
6467,0.001457,172.217.194.0-255,1484,112203,76,182046
6468,0.001507,172.31.40.0-255,66,112269,76,182046
6469,0.001512,172.217.194.0-255,2902,115171,76,182046
6470,0.001514,172.31.40.0-255,66,115237,76,182046
6471,0.001531,172.31.40.0-255,66,115303,76,182046
6472,0.001929,172.217.194.0-255,1484,116787,76,182046
6473,0.001936,172.217.194.0-255,2902,119689,76,182046
6474,0.00194,172.31.40.0-255,66,119755,76,182046
6475,0.001943,172.217.194.0-255,1484,121239,76,182046
6476,0.001968,172.217.194.0-255,4320,125559,76,182046
6477,0.001971,172.31.40.0-255,66,125625,76,182046
6478,0.001974,172.217.194.0-255,1484,127109,76,182046
6479,0.002004,172.217.194.0-255,7156,134265,76,182046
6480,0.002007,172.31.40.0-255,66,134331,76,182046
6481,0.002032,172.217.194.0-255,1484,135815,76,182046
6482,0.002036,172.217.194.0-255,2902,138717,76,182046
6483,0.002041,172.31.40.0-255,66,138783,76,182046
6484,0.002054,172.217.194.0-255,7156,145939,76,182046
6485,0.002061,172.31.40.0-255,66,146005,76,182046
6486,0.002064,172.217.194.0-255,1484,147489,76,182046
6487,0.002089,172.217.194.0-255,2184,149673,76,182046
6488,0.002091,172.31.40.0-255,66,149739,76,182046
6489,0.002155,172.217.194.0-255,1484,151223,76,182046
6490,0.002173,172.217.194.0-255,2902,154125,76,182046
6491,0.002176,172.31.40.0-255,66,154191,76,182046
6492,0.00218,172.217.194.0-255,1484,155675,76,182046
6493,0.002209,172.217.194.0-255,4320,159995,76,182046
6494,0.002212,172.31.40.0-255,66,160061,76,182046
6495,0.002223,172.31.40.0-255,66,160127,76,182046
6496,0.002247,172.217.194.0-255,2902,163029,76,182046
6497,0.00225,172.31.40.0-255,66,163095,76,182046
6498,0.002263,172.31.40.0-255,66,163161,76,182046
6499,0.002299,172.217.194.0-255,1484,164645,76,182046
6500,0.002303,172.217.194.0-255,2902,167547,76,182046
6501,0.002308,172.217.194.0-255,5738,173285,76,182046
6502,0.00231,172.217.194.0-255,1484,174769,76,182046
6503,0.002315,172.31.40.0-255,66,174835,76,182046
6504,0.002318,172.31.40.0-255,66,174901,76,182046
6505,0.002358,172.31.40.0-255,66,174967,76,182046
6506,0.002371,172.31.40.0-255,66,175033,76,182046
6507,0.002419,172.31.40.0-255,66,175099,76,182046
6508,0.002433,172.31.40.0-255,66,175165,76,182046
6509,0.002462,172.217.194.0-255,1484,176649,76,182046
6510,0.002477,172.31.40.0-255,66,176715,76,182046
6511,0.00248,172.217.194.0-255,97,176812,76,182046
6512,0.004682,172.31.40.0-255,66,176878,76,182046
6513,0.00489,172.217.194.0-255,168,177046,76,182046
6514,0.012327,172.31.40.0-255,105,177151,76,182046
6515,0.012374,172.31.40.0-255,105,177256,76,182046
6516,0.012596,172.31.40.0-255,90,177346,76,182046
6517,0.012606,172.31.40.0-255,66,177412,76,182046
6518,0.014721,172.217.194.0-255,66,177478,76,182046
6519,0.014789,172.217.194.0-255,66,177544,76,182046
6520,0.015014,172.217.194.0-255,66,177610,76,182046
6521,0.015031,172.217.194.0-255,66,177676,76,182046
6522,0.015036,172.31.40.0-255,66,177742,76,182046
6523,0.033356,172.31.40.0-255,176,177918,76,182046
6524,0.03339,172.31.40.0-255,1105,179023,76,182046
6525,0.03345,172.31.40.0-255,1514,180537,76,182046
6526,0.033452,172.31.40.0-255,1311,181848,76,182046
6527,0.035038,104.244.42.0-255,66,181914,76,182046
6528,0.03508,104.244.42.0-255,66,181980,76,182046
6529,0.03514,104.244.42.0-255,66,182046,76,182046
6530,0.0,172.217.194.0-255,153,153,76,177656
6531,1.5e-05,172.31.40.0-255,66,219,76,177656
6532,2.1e-05,172.217.194.0-255,1484,1703,76,177656
6533,2.6e-05,172.31.40.0-255,66,1769,76,177656
6534,3.1e-05,172.217.194.0-255,2902,4671,76,177656
6535,3.4e-05,172.31.40.0-255,66,4737,76,177656
6536,4.2e-05,172.217.194.0-255,7156,11893,76,177656
6537,4.4e-05,172.31.40.0-255,66,11959,76,177656
6538,4.9e-05,172.217.194.0-255,3485,15444,76,177656
6539,5.2e-05,172.31.40.0-255,66,15510,76,177656
6540,9.3e-05,172.31.40.0-255,66,15576,76,177656
6541,9.8e-05,172.217.194.0-255,2543,18119,76,177656
6542,0.0001,172.31.40.0-255,66,18185,76,177656
6543,0.000142,172.217.194.0-255,1484,19669,76,177656
6544,0.000145,172.31.40.0-255,66,19735,76,177656
6545,0.000148,172.217.194.0-255,1484,21219,76,177656
6546,0.00015,172.31.40.0-255,66,21285,76,177656
6547,0.000165,172.217.194.0-255,1484,22769,76,177656
6548,0.000168,172.31.40.0-255,66,22835,76,177656
6549,0.000175,172.217.194.0-255,5738,28573,76,177656
6550,0.000177,172.31.40.0-255,66,28639,76,177656
6551,0.00018,172.217.194.0-255,1484,30123,76,177656
6552,0.000182,172.31.40.0-255,66,30189,76,177656
6553,0.000209,172.31.40.0-255,66,30255,76,177656
6554,0.000215,172.217.194.0-255,5738,35993,76,177656
6555,0.000217,172.31.40.0-255,66,36059,76,177656
6556,0.000261,172.217.194.0-255,4252,40311,76,177656
6557,0.000264,172.31.40.0-255,66,40377,76,177656
6558,0.000277,172.217.194.0-255,365,40742,76,177656
6559,0.000279,172.31.40.0-255,66,40808,76,177656
6560,0.000326,172.217.194.0-255,1484,42292,76,177656
6561,0.000341,172.217.194.0-255,4320,46612,76,177656
6562,0.000344,172.31.40.0-255,66,46678,76,177656
6563,0.000351,172.217.194.0-255,5738,52416,76,177656
6564,0.000353,172.31.40.0-255,66,52482,76,177656
6565,0.000415,172.217.194.0-255,5738,58220,76,177656
6566,0.000418,172.31.40.0-255,66,58286,76,177656
6567,0.000445,172.31.40.0-255,66,58352,76,177656
6568,0.000448,172.217.194.0-255,1484,59836,76,177656
6569,0.000473,172.217.194.0-255,5379,65215,76,177656
6570,0.000476,172.31.40.0-255,66,65281,76,177656
6571,0.000962,172.217.194.0-255,1484,66765,76,177656
6572,0.00097,172.217.194.0-255,2902,69667,76,177656
6573,0.000974,172.31.40.0-255,66,69733,76,177656
6574,0.00098,172.217.194.0-255,4320,74053,76,177656
6575,0.000983,172.31.40.0-255,66,74119,76,177656
6576,0.001,172.217.194.0-255,1484,75603,76,177656
6577,0.001014,172.31.40.0-255,66,75669,76,177656
6578,0.001031,172.217.194.0-255,4320,79989,76,177656
6579,0.001033,172.31.40.0-255,66,80055,76,177656
6580,0.001047,172.31.40.0-255,66,80121,76,177656
6581,0.0011,172.31.40.0-255,66,80187,76,177656
6582,0.001125,172.217.194.0-255,7156,87343,76,177656
6583,0.001134,172.217.194.0-255,1484,88827,76,177656
6584,0.001139,172.31.40.0-255,66,88893,76,177656
6585,0.001142,172.31.40.0-255,66,88959,76,177656
6586,0.001166,172.217.194.0-255,2902,91861,76,177656
6587,0.001172,172.217.194.0-255,5738,97599,76,177656
6588,0.001177,172.31.40.0-255,66,97665,76,177656
6589,0.001181,172.31.40.0-255,66,97731,76,177656
6590,0.001203,172.31.40.0-255,66,97797,76,177656
6591,0.001223,172.217.194.0-255,1484,99281,76,177656
6592,0.001229,172.217.194.0-255,4320,103601,76,177656
6593,0.001232,172.31.40.0-255,66,103667,76,177656
6594,0.001263,172.31.40.0-255,66,103733,76,177656
6595,0.001275,172.31.40.0-255,66,103799,76,177656
6596,0.001298,172.217.194.0-255,2902,106701,76,177656
6597,0.0013,172.31.40.0-255,66,106767,76,177656
6598,0.001346,172.31.40.0-255,66,106833,76,177656
6599,0.001354,172.217.194.0-255,7156,113989,76,177656
6600,0.001356,172.31.40.0-255,66,114055,76,177656
6601,0.001367,172.31.40.0-255,66,114121,76,177656
6602,0.001435,172.31.40.0-255,66,114187,76,177656
6603,0.001437,172.217.194.0-255,766,114953,76,177656
6604,0.001467,172.217.194.0-255,1484,116437,76,177656
6605,0.00147,172.31.40.0-255,66,116503,76,177656
6606,0.001475,172.217.194.0-255,2902,119405,76,177656
6607,0.001477,172.31.40.0-255,66,119471,76,177656
6608,0.001492,172.217.194.0-255,4320,123791,76,177656
6609,0.001495,172.31.40.0-255,66,123857,76,177656
6610,0.001512,172.217.194.0-255,1484,125341,76,177656
6611,0.001517,172.217.194.0-255,1484,126825,76,177656
6612,0.001519,172.31.40.0-255,66,126891,76,177656
6613,0.001533,172.31.40.0-255,66,126957,76,177656
6614,0.001538,172.217.194.0-255,2902,129859,76,177656
6615,0.00154,172.31.40.0-255,66,129925,76,177656
6616,0.001568,172.217.194.0-255,6438,136363,76,177656
6617,0.001572,172.31.40.0-255,66,136429,76,177656
6618,0.001606,172.217.194.0-255,1484,137913,76,177656
6619,0.001622,172.217.194.0-255,2902,140815,76,177656
6620,0.001625,172.31.40.0-255,66,140881,76,177656
6621,0.001632,172.217.194.0-255,5738,146619,76,177656
6622,0.001634,172.31.40.0-255,66,146685,76,177656
6623,0.001653,172.217.194.0-255,4320,151005,76,177656
6624,0.001656,172.31.40.0-255,66,151071,76,177656
6625,0.001669,172.217.194.0-255,1484,152555,76,177656
6626,0.001693,172.31.40.0-255,66,152621,76,177656
6627,0.001708,172.217.194.0-255,1484,154105,76,177656
6628,0.001719,172.31.40.0-255,66,154171,76,177656
6629,0.001731,172.31.40.0-255,66,154237,76,177656
6630,0.001742,172.217.194.0-255,1484,155721,76,177656
6631,0.001777,172.31.40.0-255,66,155787,76,177656
6632,0.00179,172.217.194.0-255,2902,158689,76,177656
6633,0.001797,172.217.194.0-255,6438,165127,76,177656
6634,0.001802,172.217.194.0-255,2902,168029,76,177656
6635,0.001821,172.31.40.0-255,66,168095,76,177656
6636,0.001837,172.31.40.0-255,66,168161,76,177656
6637,0.001871,172.217.194.0-255,1484,169645,76,177656
6638,0.001886,172.217.194.0-255,3367,173012,76,177656
6639,0.001889,172.217.194.0-255,105,173117,76,177656
6640,0.001913,172.31.40.0-255,66,173183,76,177656
6641,0.004464,172.31.40.0-255,105,173288,76,177656
6642,0.006837,172.217.194.0-255,66,173354,76,177656
6643,0.029265,172.31.40.0-255,172,173526,76,177656
6644,0.0293,172.31.40.0-255,1107,174633,76,177656
6645,0.029357,172.31.40.0-255,1514,176147,76,177656
6646,0.029359,172.31.40.0-255,1311,177458,76,177656
6647,0.030945,104.244.42.0-255,66,177524,76,177656
6648,0.031109,104.244.42.0-255,66,177590,76,177656
6649,0.031136,104.244.42.0-255,66,177656,76,177656
6650,0.0,74.125.68.0-255,152,152,76,385624
6651,1.9e-05,172.31.40.0-255,66,218,76,385624
6652,2.6e-05,74.125.68.0-255,1484,1702,76,385624
6653,3e-05,172.31.40.0-255,66,1768,76,385624
6654,5.9e-05,74.125.68.0-255,2902,4670,76,385624
6655,6.3e-05,172.31.40.0-255,66,4736,76,385624
6656,7.5e-05,74.125.68.0-255,5738,10474,76,385624
6657,7.9e-05,172.31.40.0-255,66,10540,76,385624
6658,0.000119,74.125.68.0-255,3411,13951,76,385624
6659,0.000122,172.31.40.0-255,66,14017,76,385624
6660,0.000162,74.125.68.0-255,1484,15501,76,385624
6661,0.000165,172.31.40.0-255,66,15567,76,385624
6662,0.000178,74.125.68.0-255,1484,17051,76,385624
6663,0.000184,172.31.40.0-255,66,17117,76,385624
6664,0.000206,74.125.68.0-255,1484,18601,76,385624
6665,0.000209,172.31.40.0-255,66,18667,76,385624
6666,0.000216,74.125.68.0-255,5738,24405,76,385624
6667,0.000218,172.31.40.0-255,66,24471,76,385624
6668,0.000265,74.125.68.0-255,2902,27373,76,385624
6669,0.000267,172.31.40.0-255,66,27439,76,385624
6670,0.000293,74.125.68.0-255,3961,31400,76,385624
6671,0.000296,172.31.40.0-255,66,31466,76,385624
6672,0.000447,74.125.68.0-255,1484,32950,76,385624
6673,0.000451,172.31.40.0-255,66,33016,76,385624
6674,0.000455,74.125.68.0-255,1484,34500,76,385624
6675,0.000457,172.31.40.0-255,66,34566,76,385624
6676,0.000481,74.125.68.0-255,1484,36050,76,385624
6677,0.000484,172.31.40.0-255,66,36116,76,385624
6678,0.000494,74.125.68.0-255,1484,37600,76,385624
6679,0.000496,172.31.40.0-255,66,37666,76,385624
6680,0.000516,74.125.68.0-255,2902,40568,76,385624
6681,0.000519,172.31.40.0-255,66,40634,76,385624
6682,0.000522,74.125.68.0-255,1484,42118,76,385624
6683,0.000547,74.125.68.0-255,4320,46438,76,385624
6684,0.000549,172.31.40.0-255,66,46504,76,385624
6685,0.000553,74.125.68.0-255,2543,49047,76,385624
6686,0.000555,172.31.40.0-255,66,49113,76,385624
6687,0.000826,74.125.68.0-255,1484,50597,76,385624
6688,0.000839,74.125.68.0-255,2902,53499,76,385624
6689,0.000842,172.31.40.0-255,66,53565,76,385624
6690,0.000868,74.125.68.0-255,4320,57885,76,385624
6691,0.00087,172.31.40.0-255,66,57951,76,385624
6692,0.0009,172.31.40.0-255,66,58017,76,385624
6693,0.000936,74.125.68.0-255,112,58129,76,385624
6694,0.00099,74.125.68.0-255,1484,59613,76,385624
6695,0.000993,172.31.40.0-255,66,59679,76,385624
6696,0.001052,74.125.68.0-255,2902,62581,76,385624
6697,0.001055,172.31.40.0-255,66,62647,76,385624
6698,0.00108,74.125.68.0-255,4320,66967,76,385624
6699,0.001085,172.31.40.0-255,66,67033,76,385624
6700,0.001114,172.31.40.0-255,66,67099,76,385624
6701,0.001175,74.125.68.0-255,4320,71419,76,385624
6702,0.001179,172.31.40.0-255,66,71485,76,385624
6703,0.00119,74.125.68.0-255,2902,74387,76,385624
6704,0.001192,172.31.40.0-255,66,74453,76,385624
6705,0.001199,74.125.68.0-255,2902,77355,76,385624
6706,0.001201,172.31.40.0-255,66,77421,76,385624
6707,0.001239,74.125.68.0-255,5738,83159,76,385624
6708,0.001242,172.31.40.0-255,66,83225,76,385624
6709,0.001244,74.125.68.0-255,766,83991,76,385624
6710,0.001247,74.125.68.0-255,329,84320,76,385624
6711,0.001267,74.125.68.0-255,1484,85804,76,385624
6712,0.001269,172.31.40.0-255,66,85870,76,385624
6713,0.001302,74.125.68.0-255,1484,87354,76,385624
6714,0.001319,74.125.68.0-255,2902,90256,76,385624
6715,0.001321,172.31.40.0-255,66,90322,76,385624
6716,0.001348,74.125.68.0-255,5738,96060,76,385624
6717,0.00135,172.31.40.0-255,66,96126,76,385624
6718,0.001362,172.31.40.0-255,66,96192,76,385624
6719,0.001366,74.125.68.0-255,2902,99094,76,385624
6720,0.001372,172.31.40.0-255,66,99160,76,385624
6721,0.001428,74.125.68.0-255,1484,100644,76,385624
6722,0.001453,74.125.68.0-255,6438,107082,76,385624
6723,0.001456,172.31.40.0-255,66,107148,76,385624
6724,0.001625,74.125.68.0-255,1484,108632,76,385624
6725,0.001629,74.125.68.0-255,1484,110116,76,385624
6726,0.001632,172.31.40.0-255,66,110182,76,385624
6727,0.001656,74.125.68.0-255,1484,111666,76,385624
6728,0.00167,74.125.68.0-255,1484,113150,76,385624
6729,0.001672,172.31.40.0-255,66,113216,76,385624
6730,0.001696,74.125.68.0-255,2902,116118,76,385624
6731,0.001699,172.31.40.0-255,66,116184,76,385624
6732,0.001724,74.125.68.0-255,1484,117668,76,385624
6733,0.001728,74.125.68.0-255,2902,120570,76,385624
6734,0.00173,172.31.40.0-255,66,120636,76,385624
6735,0.001757,74.125.68.0-255,5738,126374,76,385624
6736,0.001759,172.31.40.0-255,66,126440,76,385624
6737,0.001763,74.125.68.0-255,4320,130760,76,385624
6738,0.001765,172.31.40.0-255,66,130826,76,385624
6739,0.001792,74.125.68.0-255,4320,135146,76,385624
6740,0.001794,172.31.40.0-255,66,135212,76,385624
6741,0.001805,74.125.68.0-255,1484,136696,76,385624
6742,0.001818,74.125.68.0-255,2902,139598,76,385624
6743,0.00182,172.31.40.0-255,66,139664,76,385624
6744,0.001843,74.125.68.0-255,2184,141848,76,385624
6745,0.001845,172.31.40.0-255,66,141914,76,385624
6746,0.001879,74.125.68.0-255,1484,143398,76,385624
6747,0.001891,74.125.68.0-255,2902,146300,76,385624
6748,0.001893,172.31.40.0-255,66,146366,76,385624
6749,0.00192,74.125.68.0-255,5738,152104,76,385624
6750,0.001922,172.31.40.0-255,66,152170,76,385624
6751,0.001926,74.125.68.0-255,2902,155072,76,385624
6752,0.001928,172.31.40.0-255,66,155138,76,385624
6753,0.001941,74.125.68.0-255,1484,156622,76,385624
6754,0.001968,172.31.40.0-255,66,156688,76,385624
6755,0.001985,74.125.68.0-255,5738,162426,76,385624
6756,0.001987,172.31.40.0-255,66,162492,76,385624
6757,0.002011,74.125.68.0-255,2902,165394,76,385624
6758,0.002013,172.31.40.0-255,66,165460,76,385624
6759,0.002017,74.125.68.0-255,2184,167644,76,385624
6760,0.002019,172.31.40.0-255,66,167710,76,385624
6761,0.004632,74.125.68.0-255,5738,173448,76,385624
6762,0.004639,172.31.40.0-255,66,173514,76,385624
6763,0.007247,74.125.68.0-255,2902,176416,76,385624
6764,0.007253,172.31.40.0-255,66,176482,76,385624
6765,0.007284,74.125.68.0-255,2902,179384,76,385624
6766,0.007287,172.31.40.0-255,66,179450,76,385624
6767,0.009872,74.125.68.0-255,2902,182352,76,385624
6768,0.00988,172.31.40.0-255,66,182418,76,385624
6769,0.009908,74.125.68.0-255,2902,185320,76,385624
6770,0.009911,172.31.40.0-255,66,185386,76,385624
6771,0.012497,74.125.68.0-255,2902,188288,76,385624
6772,0.012505,172.31.40.0-255,66,188354,76,385624
6773,0.012537,74.125.68.0-255,2902,191256,76,385624
6774,0.01254,172.31.40.0-255,66,191322,76,385624
6775,0.015119,74.125.68.0-255,2902,194224,76,385624
6776,0.015126,172.31.40.0-255,66,194290,76,385624
6777,0.015157,74.125.68.0-255,2902,197192,76,385624
6778,0.015159,172.31.40.0-255,66,197258,76,385624
6779,0.017755,74.125.68.0-255,2902,200160,76,385624
6780,0.017763,172.31.40.0-255,66,200226,76,385624
6781,0.017784,74.125.68.0-255,2902,203128,76,385624
6782,0.017787,172.31.40.0-255,66,203194,76,385624
6783,0.02037,74.125.68.0-255,2902,206096,76,385624
6784,0.020377,172.31.40.0-255,66,206162,76,385624
6785,0.020409,74.125.68.0-255,2902,209064,76,385624
6786,0.020412,172.31.40.0-255,66,209130,76,385624
6787,0.022988,74.125.68.0-255,2902,212032,76,385624
6788,0.022995,172.31.40.0-255,66,212098,76,385624
6789,0.023032,74.125.68.0-255,2902,215000,76,385624
6790,0.023035,172.31.40.0-255,66,215066,76,385624
6791,0.025609,74.125.68.0-255,2902,217968,76,385624
6792,0.025618,172.31.40.0-255,66,218034,76,385624
6793,0.025633,74.125.68.0-255,2902,220936,76,385624
6794,0.02564,172.31.40.0-255,66,221002,76,385624
6795,0.026191,172.31.40.0-255,171,221173,76,385624
6796,0.02622,172.31.40.0-255,1133,222306,76,385624
6797,0.026269,172.31.40.0-255,1514,223820,76,385624
6798,0.026271,172.31.40.0-255,314,224134,76,385624
6799,0.027815,104.244.42.0-255,66,224200,76,385624
6800,0.02785,104.244.42.0-255,66,224266,76,385624
6801,0.027877,104.244.42.0-255,66,224332,76,385624
6802,0.028231,74.125.68.0-255,4320,228652,76,385624
6803,0.028237,172.31.40.0-255,66,228718,76,385624
6804,0.028269,74.125.68.0-255,1484,230202,76,385624
6805,0.030865,74.125.68.0-255,4320,234522,76,385624
6806,0.030871,172.31.40.0-255,66,234588,76,385624
6807,0.033512,74.125.68.0-255,5738,240326,76,385624
6808,0.033517,172.31.40.0-255,66,240392,76,385624
6809,0.036132,74.125.68.0-255,2902,243294,76,385624
6810,0.036138,172.31.40.0-255,66,243360,76,385624
6811,0.036162,74.125.68.0-255,2902,246262,76,385624
6812,0.036164,172.31.40.0-255,66,246328,76,385624
6813,0.038762,74.125.68.0-255,5738,252066,76,385624
6814,0.038768,172.31.40.0-255,66,252132,76,385624
6815,0.041387,74.125.68.0-255,5738,257870,76,385624
6816,0.041394,172.31.40.0-255,66,257936,76,385624
6817,0.044026,74.125.68.0-255,5738,263674,76,385624
6818,0.044033,172.31.40.0-255,66,263740,76,385624
6819,0.04665,74.125.68.0-255,5738,269478,76,385624
6820,0.046658,172.31.40.0-255,66,269544,76,385624
6821,0.049281,74.125.68.0-255,5738,275282,76,385624
6822,0.049287,172.31.40.0-255,66,275348,76,385624
6823,0.051901,74.125.68.0-255,5738,281086,76,385624
6824,0.051907,172.31.40.0-255,66,281152,76,385624
6825,0.054526,74.125.68.0-255,5738,286890,76,385624
6826,0.054531,172.31.40.0-255,66,286956,76,385624
6827,0.057153,74.125.68.0-255,5738,292694,76,385624
6828,0.057159,172.31.40.0-255,66,292760,76,385624
6829,0.059781,74.125.68.0-255,5738,298498,76,385624
6830,0.059788,172.31.40.0-255,66,298564,76,385624
6831,0.062411,74.125.68.0-255,5738,304302,76,385624
6832,0.062418,172.31.40.0-255,66,304368,76,385624
6833,0.065036,74.125.68.0-255,5738,310106,76,385624
6834,0.065043,172.31.40.0-255,66,310172,76,385624
6835,0.067671,74.125.68.0-255,5738,315910,76,385624
6836,0.067681,172.31.40.0-255,66,315976,76,385624
6837,0.070298,74.125.68.0-255,5738,321714,76,385624
6838,0.070304,172.31.40.0-255,66,321780,76,385624
6839,0.072925,74.125.68.0-255,5738,327518,76,385624
6840,0.072931,172.31.40.0-255,66,327584,76,385624
6841,0.075555,74.125.68.0-255,5738,333322,76,385624
6842,0.075562,172.31.40.0-255,66,333388,76,385624
6843,0.078181,74.125.68.0-255,5738,339126,76,385624
6844,0.078187,172.31.40.0-255,66,339192,76,385624
6845,0.080812,74.125.68.0-255,5738,344930,76,385624
6846,0.080817,172.31.40.0-255,66,344996,76,385624
6847,0.083438,74.125.68.0-255,5738,350734,76,385624
6848,0.083443,172.31.40.0-255,66,350800,76,385624
6849,0.086059,74.125.68.0-255,5738,356538,76,385624
6850,0.086065,172.31.40.0-255,66,356604,76,385624
6851,0.088692,74.125.68.0-255,5738,362342,76,385624
6852,0.088699,172.31.40.0-255,66,362408,76,385624
6853,0.09133,74.125.68.0-255,5738,368146,76,385624
6854,0.091337,172.31.40.0-255,66,368212,76,385624
6855,0.093962,74.125.68.0-255,5738,373950,76,385624
6856,0.093968,172.31.40.0-255,66,374016,76,385624
6857,0.096607,74.125.68.0-255,5738,379754,76,385624
6858,0.096612,172.31.40.0-255,66,379820,76,385624
6859,0.099236,74.125.68.0-255,5738,385558,76,385624
6860,0.099243,172.31.40.0-255,66,385624,76,385624
6861,0.0,172.217.194.0-255,148,148,76,281148
6862,2.3e-05,172.31.40.0-255,66,214,76,281148
6863,3e-05,172.217.194.0-255,1484,1698,76,281148
6864,3.5e-05,172.31.40.0-255,66,1764,76,281148
6865,4e-05,172.217.194.0-255,2902,4666,76,281148
6866,5.2e-05,172.31.40.0-255,66,4732,76,281148
6867,6e-05,172.217.194.0-255,7156,11888,76,281148
6868,6.3e-05,172.31.40.0-255,66,11954,76,281148
6869,6.8e-05,172.217.194.0-255,2056,14010,76,281148
6870,7e-05,172.31.40.0-255,66,14076,76,281148
6871,0.00011,172.217.194.0-255,1484,15560,76,281148
6872,0.000113,172.31.40.0-255,66,15626,76,281148
6873,0.000117,172.217.194.0-255,1484,17110,76,281148
6874,0.00012,172.31.40.0-255,66,17176,76,281148
6875,0.00014,172.217.194.0-255,1484,18660,76,281148
6876,0.000142,172.31.40.0-255,66,18726,76,281148
6877,0.000149,172.217.194.0-255,5738,24464,76,281148
6878,0.000152,172.31.40.0-255,66,24530,76,281148
6879,0.000186,172.217.194.0-255,6797,31327,76,281148
6880,0.000189,172.31.40.0-255,66,31393,76,281148
6881,0.000232,172.217.194.0-255,1484,32877,76,281148
6882,0.000235,172.31.40.0-255,66,32943,76,281148
6883,0.00024,172.217.194.0-255,2902,35845,76,281148
6884,0.000242,172.31.40.0-255,66,35911,76,281148
6885,0.000248,172.217.194.0-255,5738,41649,76,281148
6886,0.000255,172.31.40.0-255,66,41715,76,281148
6887,0.000297,172.31.40.0-255,66,41781,76,281148
6888,0.000362,172.31.40.0-255,66,41847,76,281148
6889,0.000366,172.217.194.0-255,100,41947,76,281148
6890,0.000368,172.31.40.0-255,66,42013,76,281148
6891,0.000467,172.217.194.0-255,363,42376,76,281148
6892,0.000769,172.217.194.0-255,1484,43860,76,281148
6893,0.000774,172.31.40.0-255,66,43926,76,281148
6894,0.00078,172.217.194.0-255,2902,46828,76,281148
6895,0.000782,172.31.40.0-255,66,46894,76,281148
6896,0.000808,172.217.194.0-255,5738,52632,76,281148
6897,0.00081,172.31.40.0-255,66,52698,76,281148
6898,0.000828,172.31.40.0-255,66,52764,76,281148
6899,0.000854,172.217.194.0-255,1484,54248,76,281148
6900,0.000868,172.31.40.0-255,66,54314,76,281148
6901,0.00175,172.217.194.0-255,1484,55798,76,281148
6902,0.001761,172.217.194.0-255,2902,58700,76,281148
6903,0.001765,172.31.40.0-255,66,58766,76,281148
6904,0.001772,172.217.194.0-255,4320,63086,76,281148
6905,0.001774,172.31.40.0-255,66,63152,76,281148
6906,0.001802,172.217.194.0-255,1484,64636,76,281148
6907,0.00181,172.217.194.0-255,5738,70374,76,281148
6908,0.001812,172.31.40.0-255,66,70440,76,281148
6909,0.001823,172.31.40.0-255,66,70506,76,281148
6910,0.001858,172.217.194.0-255,2902,73408,76,281148
6911,0.001861,172.31.40.0-255,66,73474,76,281148
6912,0.001867,172.217.194.0-255,5020,78494,76,281148
6913,0.001869,172.31.40.0-255,66,78560,76,281148
6914,0.001948,172.217.194.0-255,1484,80044,76,281148
6915,0.001955,172.217.194.0-255,2902,82946,76,281148
6916,0.001958,172.31.40.0-255,66,83012,76,281148
6917,0.001965,172.217.194.0-255,5738,88750,76,281148
6918,0.001967,172.31.40.0-255,66,88816,76,281148
6919,0.00199,172.217.194.0-255,4320,93136,76,281148
6920,0.001992,172.31.40.0-255,66,93202,76,281148
6921,0.002022,172.31.40.0-255,66,93268,76,281148
6922,0.002033,172.217.194.0-255,1484,94752,76,281148
6923,0.002059,172.31.40.0-255,66,94818,76,281148
6924,0.002093,172.31.40.0-255,66,94884,76,281148
6925,0.002099,172.217.194.0-255,7156,102040,76,281148
6926,0.002102,172.31.40.0-255,66,102106,76,281148
6927,0.002158,172.31.40.0-255,66,102172,76,281148
6928,0.00219,172.217.194.0-255,6438,108610,76,281148
6929,0.002193,172.31.40.0-255,66,108676,76,281148
6930,0.002206,172.31.40.0-255,66,108742,76,281148
6931,0.002234,172.217.194.0-255,2902,111644,76,281148
6932,0.002237,172.31.40.0-255,66,111710,76,281148
6933,0.002248,172.31.40.0-255,66,111776,76,281148
6934,0.002255,172.217.194.0-255,6438,118214,76,281148
6935,0.002257,172.31.40.0-255,66,118280,76,281148
6936,0.002337,172.217.194.0-255,1484,119764,76,281148
6937,0.002356,172.217.194.0-255,2902,122666,76,281148
6938,0.002359,172.31.40.0-255,66,122732,76,281148
6939,0.002362,172.217.194.0-255,1484,124216,76,281148
6940,0.002388,172.217.194.0-255,4320,128536,76,281148
6941,0.00239,172.31.40.0-255,66,128602,76,281148
6942,0.002393,172.217.194.0-255,1484,130086,76,281148
6943,0.002438,172.31.40.0-255,66,130152,76,281148
6944,0.002441,172.217.194.0-255,1484,131636,76,281148
6945,0.002477,172.31.40.0-255,66,131702,76,281148
6946,0.004908,172.217.194.0-255,5738,137440,76,281148
6947,0.004914,172.31.40.0-255,66,137506,76,281148
6948,0.00735,172.217.194.0-255,5738,143244,76,281148
6949,0.007356,172.31.40.0-255,66,143310,76,281148
6950,0.009764,172.217.194.0-255,4320,147630,76,281148
6951,0.00977,172.31.40.0-255,66,147696,76,281148
6952,0.009799,172.217.194.0-255,1484,149180,76,281148
6953,0.012205,172.217.194.0-255,4320,153500,76,281148
6954,0.012213,172.31.40.0-255,66,153566,76,281148
6955,0.014668,172.217.194.0-255,5738,159304,76,281148
6956,0.014677,172.31.40.0-255,66,159370,76,281148
6957,0.017094,172.217.194.0-255,5738,165108,76,281148
6958,0.017102,172.31.40.0-255,66,165174,76,281148
6959,0.019561,172.217.194.0-255,5738,170912,76,281148
6960,0.019572,172.31.40.0-255,66,170978,76,281148
6961,0.022006,172.217.194.0-255,5738,176716,76,281148
6962,0.022015,172.31.40.0-255,66,176782,76,281148
6963,0.024466,172.217.194.0-255,5738,182520,76,281148
6964,0.024474,172.31.40.0-255,66,182586,76,281148
6965,0.02691,172.217.194.0-255,5738,188324,76,281148
6966,0.026917,172.31.40.0-255,66,188390,76,281148
6967,0.029352,172.217.194.0-255,5738,194128,76,281148
6968,0.029361,172.31.40.0-255,66,194194,76,281148
6969,0.031774,172.217.194.0-255,5738,199932,76,281148
6970,0.031781,172.31.40.0-255,66,199998,76,281148
6971,0.033502,172.31.40.0-255,176,200174,76,281148
6972,0.03353,172.31.40.0-255,1109,201283,76,281148
6973,0.033581,172.31.40.0-255,1514,202797,76,281148
6974,0.033582,172.31.40.0-255,1307,204104,76,281148
6975,0.034198,172.217.194.0-255,5738,209842,76,281148
6976,0.034206,172.31.40.0-255,66,209908,76,281148
6977,0.035189,104.244.42.0-255,66,209974,76,281148
6978,0.035384,104.244.42.0-255,66,210040,76,281148
6979,0.035411,104.244.42.0-255,66,210106,76,281148
6980,0.036646,172.217.194.0-255,5738,215844,76,281148
6981,0.036651,172.31.40.0-255,66,215910,76,281148
6982,0.039106,172.217.194.0-255,5738,221648,76,281148
6983,0.039114,172.31.40.0-255,66,221714,76,281148
6984,0.041575,172.217.194.0-255,5738,227452,76,281148
6985,0.041582,172.31.40.0-255,66,227518,76,281148
6986,0.044032,172.217.194.0-255,5738,233256,76,281148
6987,0.044039,172.31.40.0-255,66,233322,76,281148
6988,0.04648,172.217.194.0-255,5738,239060,76,281148
6989,0.04649,172.31.40.0-255,66,239126,76,281148
6990,0.04895,172.217.194.0-255,5738,244864,76,281148
6991,0.048957,172.31.40.0-255,66,244930,76,281148
6992,0.051401,172.217.194.0-255,5738,250668,76,281148
6993,0.051407,172.31.40.0-255,66,250734,76,281148
6994,0.053868,172.217.194.0-255,5738,256472,76,281148
6995,0.053874,172.31.40.0-255,66,256538,76,281148
6996,0.0563,172.217.194.0-255,5738,262276,76,281148
6997,0.056306,172.31.40.0-255,66,262342,76,281148
6998,0.05875,172.217.194.0-255,5738,268080,76,281148
6999,0.058757,172.31.40.0-255,66,268146,76,281148
7000,0.061173,172.217.194.0-255,5738,273884,76,281148
7001,0.061178,172.31.40.0-255,66,273950,76,281148
7002,0.063627,172.217.194.0-255,5738,279688,76,281148
7003,0.063634,172.31.40.0-255,66,279754,76,281148
7004,0.066068,172.217.194.0-255,1157,280911,76,281148
7005,0.066217,172.31.40.0-255,66,280977,76,281148
7006,0.066253,172.31.40.0-255,105,281082,76,281148
7007,0.068662,172.217.194.0-255,66,281148,76,281148
7008,0.0,74.125.24.0-255,143,143,76,373424
7009,1e-05,172.31.40.0-255,66,209,76,373424
7010,4e-05,74.125.24.0-255,1484,1693,76,373424
7011,4.5e-05,172.31.40.0-255,66,1759,76,373424
7012,5.1e-05,74.125.24.0-255,2902,4661,76,373424
7013,5.4e-05,172.31.40.0-255,66,4727,76,373424
7014,7e-05,74.125.24.0-255,5738,10465,76,373424
7015,7.3e-05,172.31.40.0-255,66,10531,76,373424
7016,9.8e-05,74.125.24.0-255,4891,15422,76,373424
7017,0.000101,172.31.40.0-255,66,15488,76,373424
7018,0.000105,74.125.24.0-255,2902,18390,76,373424
7019,0.000109,172.31.40.0-255,66,18456,76,373424
7020,0.000122,74.125.24.0-255,2902,21358,76,373424
7021,0.000125,172.31.40.0-255,66,21424,76,373424
7022,0.000161,172.31.40.0-255,66,21490,76,373424
7023,0.00067,74.125.24.0-255,1484,22974,76,373424
7024,0.000676,172.31.40.0-255,66,23040,76,373424
7025,0.000684,74.125.24.0-255,2902,25942,76,373424
7026,0.000686,172.31.40.0-255,66,26008,76,373424
7027,0.000693,74.125.24.0-255,4320,30328,76,373424
7028,0.000695,172.31.40.0-255,66,30394,76,373424
7029,0.000717,74.125.24.0-255,1484,31878,76,373424
7030,0.000719,172.31.40.0-255,66,31944,76,373424
7031,0.000727,74.125.24.0-255,6797,38741,76,373424
7032,0.000729,172.31.40.0-255,66,38807,76,373424
7033,0.000734,74.125.24.0-255,2902,41709,76,373424
7034,0.000736,172.31.40.0-255,66,41775,76,373424
7035,0.000781,172.31.40.0-255,66,41841,76,373424
7036,0.000786,74.125.24.0-255,2543,44384,76,373424
7037,0.000789,172.31.40.0-255,66,44450,76,373424
7038,0.000791,74.125.24.0-255,397,44847,76,373424
7039,0.000868,74.125.24.0-255,1484,46331,76,373424
7040,0.000872,172.31.40.0-255,66,46397,76,373424
7041,0.000877,74.125.24.0-255,2902,49299,76,373424
7042,0.00088,172.31.40.0-255,66,49365,76,373424
7043,0.000893,74.125.24.0-255,2902,52267,76,373424
7044,0.000895,172.31.40.0-255,66,52333,76,373424
7045,0.000919,74.125.24.0-255,2902,55235,76,373424
7046,0.000922,172.31.40.0-255,66,55301,76,373424
7047,0.000929,74.125.24.0-255,5738,61039,76,373424
7048,0.000932,172.31.40.0-255,66,61105,76,373424
7049,0.000938,74.125.24.0-255,5738,66843,76,373424
7050,0.000941,172.31.40.0-255,66,66909,76,373424
7051,0.000968,74.125.24.0-255,7156,74065,76,373424
7052,0.000972,172.31.40.0-255,66,74131,76,373424
7053,0.000978,74.125.24.0-255,5300,79431,76,373424
7054,0.000981,172.31.40.0-255,66,79497,76,373424
7055,0.001648,74.125.24.0-255,1484,80981,76,373424
7056,0.001658,74.125.24.0-255,2902,83883,76,373424
7057,0.001662,172.31.40.0-255,66,83949,76,373424
7058,0.00167,74.125.24.0-255,5738,89687,76,373424
7059,0.001673,172.31.40.0-255,66,89753,76,373424
7060,0.001691,74.125.24.0-255,5738,95491,76,373424
7061,0.001694,172.31.40.0-255,66,95557,76,373424
7062,0.001721,74.125.24.0-255,7156,102713,76,373424
7063,0.001723,172.31.40.0-255,66,102779,76,373424
7064,0.001734,172.31.40.0-255,66,102845,76,373424
7065,0.001758,74.125.24.0-255,2184,105029,76,373424
7066,0.00176,172.31.40.0-255,66,105095,76,373424
7067,0.002076,74.125.24.0-255,1484,106579,76,373424
7068,0.002096,74.125.24.0-255,2902,109481,76,373424
7069,0.002099,172.31.40.0-255,66,109547,76,373424
7070,0.002127,74.125.24.0-255,5738,115285,76,373424
7071,0.00213,172.31.40.0-255,66,115351,76,373424
7072,0.002144,74.125.24.0-255,2902,118253,76,373424
7073,0.002146,172.31.40.0-255,66,118319,76,373424
7074,0.002174,172.31.40.0-255,66,118385,76,373424
7075,0.002184,172.31.40.0-255,66,118451,76,373424
7076,0.004335,74.125.24.0-255,5738,124189,76,373424
7077,0.004342,172.31.40.0-255,66,124255,76,373424
7078,0.006424,74.125.24.0-255,2902,127157,76,373424
7079,0.006429,172.31.40.0-255,66,127223,76,373424
7080,0.006447,74.125.24.0-255,2902,130125,76,373424
7081,0.006449,172.31.40.0-255,66,130191,76,373424
7082,0.008528,74.125.24.0-255,4320,134511,76,373424
7083,0.008533,172.31.40.0-255,66,134577,76,373424
7084,0.008555,74.125.24.0-255,1484,136061,76,373424
7085,0.010633,74.125.24.0-255,4320,140381,76,373424
7086,0.01064,172.31.40.0-255,66,140447,76,373424
7087,0.012745,74.125.24.0-255,5738,146185,76,373424
7088,0.012752,172.31.40.0-255,66,146251,76,373424
7089,0.014858,74.125.24.0-255,5738,151989,76,373424
7090,0.014867,172.31.40.0-255,66,152055,76,373424
7091,0.016965,74.125.24.0-255,5738,157793,76,373424
7092,0.016974,172.31.40.0-255,66,157859,76,373424
7093,0.019076,74.125.24.0-255,5738,163597,76,373424
7094,0.019084,172.31.40.0-255,66,163663,76,373424
7095,0.021182,74.125.24.0-255,5738,169401,76,373424
7096,0.02119,172.31.40.0-255,66,169467,76,373424
7097,0.023315,74.125.24.0-255,5738,175205,76,373424
7098,0.023323,172.31.40.0-255,66,175271,76,373424
7099,0.025482,74.125.24.0-255,5738,181009,76,373424
7100,0.025489,172.31.40.0-255,66,181075,76,373424
7101,0.027574,74.125.24.0-255,5738,186813,76,373424
7102,0.027581,172.31.40.0-255,66,186879,76,373424
7103,0.028725,172.31.40.0-255,172,187051,76,373424
7104,0.028753,172.31.40.0-255,1109,188160,76,373424
7105,0.028813,172.31.40.0-255,1514,189674,76,373424
7106,0.028815,172.31.40.0-255,1307,190981,76,373424
7107,0.029684,74.125.24.0-255,5738,196719,76,373424
7108,0.029691,172.31.40.0-255,66,196785,76,373424
7109,0.030507,104.244.42.0-255,66,196851,76,373424
7110,0.030577,104.244.42.0-255,66,196917,76,373424
7111,0.030644,104.244.42.0-255,66,196983,76,373424
7112,0.031782,74.125.24.0-255,5738,202721,76,373424
7113,0.031787,172.31.40.0-255,66,202787,76,373424
7114,0.033912,74.125.24.0-255,5738,208525,76,373424
7115,0.033917,172.31.40.0-255,66,208591,76,373424
7116,0.036057,74.125.24.0-255,5738,214329,76,373424
7117,0.036063,172.31.40.0-255,66,214395,76,373424
7118,0.03819,74.125.24.0-255,5738,220133,76,373424
7119,0.038196,172.31.40.0-255,66,220199,76,373424
7120,0.04035,74.125.24.0-255,5738,225937,76,373424
7121,0.040357,172.31.40.0-255,66,226003,76,373424
7122,0.042491,74.125.24.0-255,5738,231741,76,373424
7123,0.042501,172.31.40.0-255,66,231807,76,373424
7124,0.04462,74.125.24.0-255,5738,237545,76,373424
7125,0.044626,172.31.40.0-255,66,237611,76,373424
7126,0.046746,74.125.24.0-255,5738,243349,76,373424
7127,0.046753,172.31.40.0-255,66,243415,76,373424
7128,0.048861,74.125.24.0-255,5738,249153,76,373424
7129,0.048867,172.31.40.0-255,66,249219,76,373424
7130,0.050998,74.125.24.0-255,5738,254957,76,373424
7131,0.051005,172.31.40.0-255,66,255023,76,373424
7132,0.053148,74.125.24.0-255,2902,257925,76,373424
7133,0.053155,172.31.40.0-255,66,257991,76,373424
7134,0.05318,74.125.24.0-255,2902,260893,76,373424
7135,0.053184,172.31.40.0-255,66,260959,76,373424
7136,0.055246,74.125.24.0-255,2902,263861,76,373424
7137,0.055253,172.31.40.0-255,66,263927,76,373424
7138,0.055296,74.125.24.0-255,2902,266829,76,373424
7139,0.0553,172.31.40.0-255,66,266895,76,373424
7140,0.057385,74.125.24.0-255,2902,269797,76,373424
7141,0.057391,172.31.40.0-255,66,269863,76,373424
7142,0.057434,74.125.24.0-255,2902,272765,76,373424
7143,0.057437,172.31.40.0-255,66,272831,76,373424
7144,0.059502,74.125.24.0-255,2902,275733,76,373424
7145,0.059508,172.31.40.0-255,66,275799,76,373424
7146,0.059531,74.125.24.0-255,2902,278701,76,373424
7147,0.059534,172.31.40.0-255,66,278767,76,373424
7148,0.061622,74.125.24.0-255,5738,284505,76,373424
7149,0.061628,172.31.40.0-255,66,284571,76,373424
7150,0.063787,74.125.24.0-255,5738,290309,76,373424
7151,0.063792,172.31.40.0-255,66,290375,76,373424
7152,0.065885,74.125.24.0-255,5738,296113,76,373424
7153,0.065891,172.31.40.0-255,66,296179,76,373424
7154,0.068061,74.125.24.0-255,5738,301917,76,373424
7155,0.068067,172.31.40.0-255,66,301983,76,373424
7156,0.070168,74.125.24.0-255,5738,307721,76,373424
7157,0.070175,172.31.40.0-255,66,307787,76,373424
7158,0.072311,74.125.24.0-255,5738,313525,76,373424
7159,0.072317,172.31.40.0-255,66,313591,76,373424
7160,0.074416,74.125.24.0-255,5738,319329,76,373424
7161,0.074422,172.31.40.0-255,66,319395,76,373424
7162,0.076539,74.125.24.0-255,5738,325133,76,373424
7163,0.076545,172.31.40.0-255,66,325199,76,373424
7164,0.078676,74.125.24.0-255,5738,330937,76,373424
7165,0.078682,172.31.40.0-255,66,331003,76,373424
7166,0.080829,74.125.24.0-255,5738,336741,76,373424
7167,0.080836,172.31.40.0-255,66,336807,76,373424
7168,0.082935,74.125.24.0-255,5738,342545,76,373424
7169,0.082945,172.31.40.0-255,66,342611,76,373424
7170,0.085114,74.125.24.0-255,5738,348349,76,373424
7171,0.085119,172.31.40.0-255,66,348415,76,373424
7172,0.087217,74.125.24.0-255,5738,354153,76,373424
7173,0.087224,172.31.40.0-255,66,354219,76,373424
7174,0.089391,74.125.24.0-255,5738,359957,76,373424
7175,0.089398,172.31.40.0-255,66,360023,76,373424
7176,0.091528,74.125.24.0-255,5738,365761,76,373424
7177,0.091534,172.31.40.0-255,66,365827,76,373424
7178,0.093623,74.125.24.0-255,5738,371565,76,373424
7179,0.093629,172.31.40.0-255,66,371631,76,373424
7180,0.095754,74.125.24.0-255,1556,373187,76,373424
7181,0.09576,172.31.40.0-255,66,373253,76,373424
7182,0.095923,172.31.40.0-255,105,373358,76,373424
7183,0.098001,74.125.24.0-255,66,373424,76,373424
7184,0.0,74.125.68.0-255,152,152,76,333363
7185,2.2e-05,172.31.40.0-255,66,218,76,333363
7186,2.9e-05,74.125.68.0-255,1484,1702,76,333363
7187,3.3e-05,172.31.40.0-255,66,1768,76,333363
7188,3.9e-05,74.125.68.0-255,2902,4670,76,333363
7189,5e-05,172.31.40.0-255,66,4736,76,333363
7190,5.9e-05,74.125.68.0-255,7156,11892,76,333363
7191,6.3e-05,172.31.40.0-255,66,11958,76,333363
7192,0.000148,74.125.68.0-255,2062,14020,76,333363
7193,0.000152,172.31.40.0-255,66,14086,76,333363
7194,0.000212,74.125.68.0-255,1484,15570,76,333363
7195,0.000215,172.31.40.0-255,66,15636,76,333363
7196,0.000219,74.125.68.0-255,1484,17120,76,333363
7197,0.000221,172.31.40.0-255,66,17186,76,333363
7198,0.000245,74.125.68.0-255,1484,18670,76,333363
7199,0.000249,172.31.40.0-255,66,18736,76,333363
7200,0.000255,74.125.68.0-255,4320,23056,76,333363
7201,0.000257,172.31.40.0-255,66,23122,76,333363
7202,0.000288,74.125.68.0-255,1484,24606,76,333363
7203,0.00029,172.31.40.0-255,66,24672,76,333363
7204,0.000296,74.125.68.0-255,4320,28992,76,333363
7205,0.000299,172.31.40.0-255,66,29058,76,333363
7206,0.000302,74.125.68.0-255,1484,30542,76,333363
7207,0.000304,172.31.40.0-255,66,30608,76,333363
7208,0.000335,74.125.68.0-255,3961,34569,76,333363
7209,0.000343,172.31.40.0-255,66,34635,76,333363
7210,0.000354,172.31.40.0-255,66,34701,76,333363
7211,0.000365,172.31.40.0-255,66,34767,76,333363
7212,0.000377,172.31.40.0-255,66,34833,76,333363
7213,0.000419,74.125.68.0-255,2520,37353,76,333363
7214,0.000422,172.31.40.0-255,66,37419,76,333363
7215,0.000445,74.125.68.0-255,340,37759,76,333363
7216,0.000667,74.125.68.0-255,1484,39243,76,333363
7217,0.000671,172.31.40.0-255,66,39309,76,333363
7218,0.000675,74.125.68.0-255,1484,40793,76,333363
7219,0.000679,74.125.68.0-255,1484,42277,76,333363
7220,0.000682,172.31.40.0-255,66,42343,76,333363
7221,0.00071,74.125.68.0-255,1484,43827,76,333363
7222,0.000717,74.125.68.0-255,5738,49565,76,333363
7223,0.00072,172.31.40.0-255,66,49631,76,333363
7224,0.000726,74.125.68.0-255,4320,53951,76,333363
7225,0.000729,172.31.40.0-255,66,54017,76,333363
7226,0.000756,74.125.68.0-255,5738,59755,76,333363
7227,0.000759,172.31.40.0-255,66,59821,76,333363
7228,0.000763,74.125.68.0-255,2902,62723,76,333363
7229,0.000765,172.31.40.0-255,66,62789,76,333363
7230,0.000801,172.31.40.0-255,66,62855,76,333363
7231,0.000804,74.125.68.0-255,766,63621,76,333363
7232,0.001463,172.31.40.0-255,66,63687,76,333363
7233,0.001555,74.125.68.0-255,1484,65171,76,333363
7234,0.001564,74.125.68.0-255,2902,68073,76,333363
7235,0.001567,172.31.40.0-255,66,68139,76,333363
7236,0.001599,74.125.68.0-255,4320,72459,76,333363
7237,0.001601,172.31.40.0-255,66,72525,76,333363
7238,0.001608,74.125.68.0-255,5738,78263,76,333363
7239,0.00161,172.31.40.0-255,66,78329,76,333363
7240,0.00166,172.31.40.0-255,66,78395,76,333363
7241,0.001665,74.125.68.0-255,2902,81297,76,333363
7242,0.001667,172.31.40.0-255,66,81363,76,333363
7243,0.00171,74.125.68.0-255,5020,86383,76,333363
7244,0.001713,172.31.40.0-255,66,86449,76,333363
7245,0.004015,74.125.68.0-255,5738,92187,76,333363
7246,0.004021,172.31.40.0-255,66,92253,76,333363
7247,0.006299,74.125.68.0-255,5738,97991,76,333363
7248,0.006303,172.31.40.0-255,66,98057,76,333363
7249,0.008612,74.125.68.0-255,5738,103795,76,333363
7250,0.008619,172.31.40.0-255,66,103861,76,333363
7251,0.010916,74.125.68.0-255,4320,108181,76,333363
7252,0.010924,172.31.40.0-255,66,108247,76,333363
7253,0.010954,74.125.68.0-255,1484,109731,76,333363
7254,0.013226,74.125.68.0-255,4320,114051,76,333363
7255,0.013235,172.31.40.0-255,66,114117,76,333363
7256,0.015544,74.125.68.0-255,5738,119855,76,333363
7257,0.015551,172.31.40.0-255,66,119921,76,333363
7258,0.017844,74.125.68.0-255,5738,125659,76,333363
7259,0.017851,172.31.40.0-255,66,125725,76,333363
7260,0.020187,74.125.68.0-255,5738,131463,76,333363
7261,0.020194,172.31.40.0-255,66,131529,76,333363
7262,0.022489,74.125.68.0-255,5738,137267,76,333363
7263,0.022498,172.31.40.0-255,66,137333,76,333363
7264,0.024802,74.125.68.0-255,5738,143071,76,333363
7265,0.02481,172.31.40.0-255,66,143137,76,333363
7266,0.024943,172.31.40.0-255,172,143309,76,333363
7267,0.024966,172.31.40.0-255,1107,144416,76,333363
7268,0.025063,172.31.40.0-255,1514,145930,76,333363
7269,0.025084,172.31.40.0-255,1309,147239,76,333363
7270,0.02658,104.244.42.0-255,66,147305,76,333363
7271,0.026587,104.244.42.0-255,66,147371,76,333363
7272,0.026659,104.244.42.0-255,66,147437,76,333363
7273,0.027115,74.125.68.0-255,5738,153175,76,333363
7274,0.02712,172.31.40.0-255,66,153241,76,333363
7275,0.029421,74.125.68.0-255,5738,158979,76,333363
7276,0.029428,172.31.40.0-255,66,159045,76,333363
7277,0.031746,74.125.68.0-255,5738,164783,76,333363
7278,0.031753,172.31.40.0-255,66,164849,76,333363
7279,0.034058,74.125.68.0-255,5738,170587,76,333363
7280,0.034063,172.31.40.0-255,66,170653,76,333363
7281,0.03637,74.125.68.0-255,5738,176391,76,333363
7282,0.036378,172.31.40.0-255,66,176457,76,333363
7283,0.03868,74.125.68.0-255,5738,182195,76,333363
7284,0.038686,172.31.40.0-255,66,182261,76,333363
7285,0.040983,74.125.68.0-255,5738,187999,76,333363
7286,0.040989,172.31.40.0-255,66,188065,76,333363
7287,0.043324,74.125.68.0-255,5738,193803,76,333363
7288,0.043329,172.31.40.0-255,66,193869,76,333363
7289,0.045648,74.125.68.0-255,5738,199607,76,333363
7290,0.045653,172.31.40.0-255,66,199673,76,333363
7291,0.047968,74.125.68.0-255,1484,201157,76,333363
7292,0.047987,74.125.68.0-255,4320,205477,76,333363
7293,0.047991,172.31.40.0-255,66,205543,76,333363
7294,0.050299,74.125.68.0-255,5738,211281,76,333363
7295,0.050307,172.31.40.0-255,66,211347,76,333363
7296,0.052604,74.125.68.0-255,5738,217085,76,333363
7297,0.052611,172.31.40.0-255,66,217151,76,333363
7298,0.054931,74.125.68.0-255,5738,222889,76,333363
7299,0.054938,172.31.40.0-255,66,222955,76,333363
7300,0.057228,74.125.68.0-255,5738,228693,76,333363
7301,0.057234,172.31.40.0-255,66,228759,76,333363
7302,0.059555,74.125.68.0-255,5738,234497,76,333363
7303,0.059565,172.31.40.0-255,66,234563,76,333363
7304,0.061862,74.125.68.0-255,5738,240301,76,333363
7305,0.061869,172.31.40.0-255,66,240367,76,333363
7306,0.064269,74.125.68.0-255,5738,246105,76,333363
7307,0.064275,172.31.40.0-255,66,246171,76,333363
7308,0.066584,74.125.68.0-255,5738,251909,76,333363
7309,0.06659,172.31.40.0-255,66,251975,76,333363
7310,0.0689,74.125.68.0-255,5738,257713,76,333363
7311,0.068907,172.31.40.0-255,66,257779,76,333363
7312,0.071219,74.125.68.0-255,5738,263517,76,333363
7313,0.071226,172.31.40.0-255,66,263583,76,333363
7314,0.073543,74.125.68.0-255,5738,269321,76,333363
7315,0.07355,172.31.40.0-255,66,269387,76,333363
7316,0.075852,74.125.68.0-255,5738,275125,76,333363
7317,0.075859,172.31.40.0-255,66,275191,76,333363
7318,0.078164,74.125.68.0-255,5738,280929,76,333363
7319,0.07817,172.31.40.0-255,66,280995,76,333363
7320,0.080481,74.125.68.0-255,5738,286733,76,333363
7321,0.080487,172.31.40.0-255,66,286799,76,333363
7322,0.082784,74.125.68.0-255,5738,292537,76,333363
7323,0.08279,172.31.40.0-255,66,292603,76,333363
7324,0.085087,74.125.68.0-255,5738,298341,76,333363
7325,0.085092,172.31.40.0-255,66,298407,76,333363
7326,0.087389,74.125.68.0-255,5738,304145,76,333363
7327,0.087397,172.31.40.0-255,66,304211,76,333363
7328,0.089702,74.125.68.0-255,5738,309949,76,333363
7329,0.089708,172.31.40.0-255,66,310015,76,333363
7330,0.092031,74.125.68.0-255,5738,315753,76,333363
7331,0.092039,172.31.40.0-255,66,315819,76,333363
7332,0.094376,74.125.68.0-255,2902,318721,76,333363
7333,0.094382,172.31.40.0-255,66,318787,76,333363
7334,0.094397,74.125.68.0-255,2902,321689,76,333363
7335,0.094403,172.31.40.0-255,66,321755,76,333363
7336,0.096727,74.125.68.0-255,5738,327493,76,333363
7337,0.096733,172.31.40.0-255,66,327559,76,333363
7338,0.099039,74.125.68.0-255,5738,333297,76,333363
7339,0.099045,172.31.40.0-255,66,333363,76,333363
7340,0.0,74.125.24.0-255,152,152,76,276604
7341,1.6e-05,172.31.40.0-255,66,218,76,276604
7342,2.3e-05,74.125.24.0-255,1484,1702,76,276604
7343,2.8e-05,172.31.40.0-255,66,1768,76,276604
7344,3.3e-05,74.125.24.0-255,2902,4670,76,276604
7345,4.6e-05,172.31.40.0-255,66,4736,76,276604
7346,5.4e-05,74.125.24.0-255,7156,11892,76,276604
7347,5.7e-05,172.31.40.0-255,66,11958,76,276604
7348,6.1e-05,74.125.24.0-255,2055,14013,76,276604
7349,6.4e-05,172.31.40.0-255,66,14079,76,276604
7350,0.000277,74.125.24.0-255,1484,15563,76,276604
7351,0.000283,172.31.40.0-255,66,15629,76,276604
7352,0.000289,74.125.24.0-255,2902,18531,76,276604
7353,0.000292,172.31.40.0-255,66,18597,76,276604
7354,0.000296,74.125.24.0-255,2902,21499,76,276604
7355,0.000304,172.31.40.0-255,66,21565,76,276604
7356,0.000315,74.125.24.0-255,1484,23049,76,276604
7357,0.000318,172.31.40.0-255,66,23115,76,276604
7358,0.000351,74.125.24.0-255,7156,30271,76,276604
7359,0.000354,172.31.40.0-255,66,30337,76,276604
7360,0.000383,74.125.24.0-255,2543,32880,76,276604
7361,0.000385,172.31.40.0-255,66,32946,76,276604
7362,0.000404,172.31.40.0-255,66,33012,76,276604
7363,0.000408,74.125.24.0-255,2902,35914,76,276604
7364,0.00041,172.31.40.0-255,66,35980,76,276604
7365,0.000463,172.31.40.0-255,66,36046,76,276604
7366,0.000466,74.125.24.0-255,411,36457,76,276604
7367,0.000469,172.31.40.0-255,66,36523,76,276604
7368,0.000496,74.125.24.0-255,331,36854,76,276604
7369,0.000499,172.31.40.0-255,66,36920,76,276604
7370,0.000606,74.125.24.0-255,1484,38404,76,276604
7371,0.000613,74.125.24.0-255,2902,41306,76,276604
7372,0.000617,172.31.40.0-255,66,41372,76,276604
7373,0.000646,74.125.24.0-255,5738,47110,76,276604
7374,0.000651,172.31.40.0-255,66,47176,76,276604
7375,0.00066,74.125.24.0-255,2902,50078,76,276604
7376,0.000663,172.31.40.0-255,66,50144,76,276604
7377,0.000685,74.125.24.0-255,3961,54105,76,276604
7378,0.000687,172.31.40.0-255,66,54171,76,276604
7379,0.00069,74.125.24.0-255,1484,55655,76,276604
7380,0.000723,74.125.24.0-255,5738,61393,76,276604
7381,0.000726,172.31.40.0-255,66,61459,76,276604
7382,0.000733,74.125.24.0-255,7156,68615,76,276604
7383,0.000735,172.31.40.0-255,66,68681,76,276604
7384,0.000757,74.125.24.0-255,2543,71224,76,276604
7385,0.00076,172.31.40.0-255,66,71290,76,276604
7386,0.001098,74.125.24.0-255,1484,72774,76,276604
7387,0.001126,74.125.24.0-255,2902,75676,76,276604
7388,0.00113,172.31.40.0-255,66,75742,76,276604
7389,0.001135,74.125.24.0-255,2902,78644,76,276604
7390,0.001137,172.31.40.0-255,66,78710,76,276604
7391,0.001166,74.125.24.0-255,2902,81612,76,276604
7392,0.001168,172.31.40.0-255,66,81678,76,276604
7393,0.001174,74.125.24.0-255,4320,85998,76,276604
7394,0.001176,172.31.40.0-255,66,86064,76,276604
7395,0.001214,172.31.40.0-255,66,86130,76,276604
7396,0.001258,74.125.24.0-255,7156,93286,76,276604
7397,0.001261,172.31.40.0-255,66,93352,76,276604
7398,0.001284,74.125.24.0-255,3602,96954,76,276604
7399,0.001287,172.31.40.0-255,66,97020,76,276604
7400,0.001518,74.125.24.0-255,1484,98504,76,276604
7401,0.001525,74.125.24.0-255,2902,101406,76,276604
7402,0.001528,172.31.40.0-255,66,101472,76,276604
7403,0.001559,74.125.24.0-255,5738,107210,76,276604
7404,0.001562,172.31.40.0-255,66,107276,76,276604
7405,0.001565,74.125.24.0-255,1484,108760,76,276604
7406,0.001589,74.125.24.0-255,1484,110244,76,276604
7407,0.001591,172.31.40.0-255,66,110310,76,276604
7408,0.001598,74.125.24.0-255,4320,114630,76,276604
7409,0.0016,172.31.40.0-255,66,114696,76,276604
7410,0.001645,74.125.24.0-255,5738,120434,76,276604
7411,0.001649,172.31.40.0-255,66,120500,76,276604
7412,0.001663,172.31.40.0-255,66,120566,76,276604
7413,0.001691,74.125.24.0-255,2184,122750,76,276604
7414,0.001694,172.31.40.0-255,66,122816,76,276604
7415,0.001814,74.125.24.0-255,1484,124300,76,276604
7416,0.00183,74.125.24.0-255,2902,127202,76,276604
7417,0.001833,172.31.40.0-255,66,127268,76,276604
7418,0.001862,74.125.24.0-255,5738,133006,76,276604
7419,0.001865,172.31.40.0-255,66,133072,76,276604
7420,0.001872,74.125.24.0-255,5738,138810,76,276604
7421,0.001874,172.31.40.0-255,66,138876,76,276604
7422,0.001905,74.125.24.0-255,7156,146032,76,276604
7423,0.001918,172.31.40.0-255,66,146098,76,276604
7424,0.001938,172.31.40.0-255,66,146164,76,276604
7425,0.001945,74.125.24.0-255,5738,151902,76,276604
7426,0.001947,172.31.40.0-255,66,151968,76,276604
7427,0.001999,172.31.40.0-255,66,152034,76,276604
7428,0.002013,172.31.40.0-255,66,152100,76,276604
7429,0.002055,172.31.40.0-255,66,152166,76,276604
7430,0.002058,74.125.24.0-255,1484,153650,76,276604
7431,0.002103,172.31.40.0-255,66,153716,76,276604
7432,0.002109,74.125.24.0-255,7156,160872,76,276604
7433,0.002111,172.31.40.0-255,66,160938,76,276604
7434,0.002133,74.125.24.0-255,1484,162422,76,276604
7435,0.002159,74.125.24.0-255,3602,166024,76,276604
7436,0.002161,172.31.40.0-255,66,166090,76,276604
7437,0.00222,74.125.24.0-255,1484,167574,76,276604
7438,0.002235,74.125.24.0-255,2902,170476,76,276604
7439,0.002238,172.31.40.0-255,66,170542,76,276604
7440,0.002263,74.125.24.0-255,5738,176280,76,276604
7441,0.002267,172.31.40.0-255,66,176346,76,276604
7442,0.002304,172.31.40.0-255,66,176412,76,276604
7443,0.002312,74.125.24.0-255,7156,183568,76,276604
7444,0.002314,172.31.40.0-255,66,183634,76,276604
7445,0.00235,74.125.24.0-255,5020,188654,76,276604
7446,0.002353,172.31.40.0-255,66,188720,76,276604
7447,0.002361,74.125.24.0-255,7156,195876,76,276604
7448,0.002364,172.31.40.0-255,66,195942,76,276604
7449,0.002375,172.31.40.0-255,66,196008,76,276604
7450,0.002416,74.125.24.0-255,5738,201746,76,276604
7451,0.002419,172.31.40.0-255,66,201812,76,276604
7452,0.002445,172.31.40.0-255,66,201878,76,276604
7453,0.002448,74.125.24.0-255,766,202644,76,276604
7454,0.002459,172.31.40.0-255,66,202710,76,276604
7455,0.002486,74.125.24.0-255,4320,207030,76,276604
7456,0.002488,172.31.40.0-255,66,207096,76,276604
7457,0.004912,74.125.24.0-255,5738,212834,76,276604
7458,0.004921,172.31.40.0-255,66,212900,76,276604
7459,0.007344,74.125.24.0-255,5738,218638,76,276604
7460,0.007348,172.31.40.0-255,66,218704,76,276604
7461,0.00976,74.125.24.0-255,2902,221606,76,276604
7462,0.009768,172.31.40.0-255,66,221672,76,276604
7463,0.009798,74.125.24.0-255,2902,224574,76,276604
7464,0.009801,172.31.40.0-255,66,224640,76,276604
7465,0.012176,74.125.24.0-255,2902,227542,76,276604
7466,0.012183,172.31.40.0-255,66,227608,76,276604
7467,0.012234,74.125.24.0-255,2902,230510,76,276604
7468,0.012237,172.31.40.0-255,66,230576,76,276604
7469,0.014627,74.125.24.0-255,2902,233478,76,276604
7470,0.014639,172.31.40.0-255,66,233544,76,276604
7471,0.014671,74.125.24.0-255,2902,236446,76,276604
7472,0.014675,172.31.40.0-255,66,236512,76,276604
7473,0.017073,74.125.24.0-255,5738,242250,76,276604
7474,0.017081,172.31.40.0-255,66,242316,76,276604
7475,0.019495,74.125.24.0-255,5738,248054,76,276604
7476,0.019506,172.31.40.0-255,66,248120,76,276604
7477,0.02192,74.125.24.0-255,4320,252440,76,276604
7478,0.021927,172.31.40.0-255,66,252506,76,276604
7479,0.021959,74.125.24.0-255,1484,253990,76,276604
7480,0.024348,74.125.24.0-255,4320,258310,76,276604
7481,0.024358,172.31.40.0-255,66,258376,76,276604
7482,0.026759,74.125.24.0-255,5738,264114,76,276604
7483,0.026768,172.31.40.0-255,66,264180,76,276604
7484,0.029171,74.125.24.0-255,5738,269918,76,276604
7485,0.029178,172.31.40.0-255,66,269984,76,276604
7486,0.031598,74.125.24.0-255,2083,272067,76,276604
7487,0.031605,172.31.40.0-255,66,272133,76,276604
7488,0.031789,172.31.40.0-255,105,272238,76,276604
7489,0.034178,74.125.24.0-255,66,272304,76,276604
7490,0.036266,172.31.40.0-255,172,272476,76,276604
7491,0.036294,172.31.40.0-255,1109,273585,76,276604
7492,0.036343,172.31.40.0-255,1514,275099,76,276604
7493,0.036344,172.31.40.0-255,1307,276406,76,276604
7494,0.037912,104.244.42.0-255,66,276472,76,276604
7495,0.037938,104.244.42.0-255,66,276538,76,276604
7496,0.038014,104.244.42.0-255,66,276604,76,276604
7497,0.0,74.125.24.0-255,155,155,76,365198
7498,1.6e-05,172.31.40.0-255,66,221,76,365198
7499,2.3e-05,74.125.24.0-255,1484,1705,76,365198
7500,2.8e-05,172.31.40.0-255,66,1771,76,365198
7501,5e-05,74.125.24.0-255,2902,4673,76,365198
7502,5.3e-05,172.31.40.0-255,66,4739,76,365198
7503,5.7e-05,74.125.24.0-255,1484,6223,76,365198
7504,5.9e-05,172.31.40.0-255,66,6289,76,365198
7505,9e-05,74.125.24.0-255,5738,12027,76,365198
7506,9.2e-05,172.31.40.0-255,66,12093,76,365198
7507,0.000115,74.125.24.0-255,7156,19249,76,365198
7508,0.000117,172.31.40.0-255,66,19315,76,365198
7509,0.000143,74.125.24.0-255,4938,24253,76,365198
7510,0.000145,172.31.40.0-255,66,24319,76,365198
7511,0.000151,74.125.24.0-255,4320,28639,76,365198
7512,0.000153,172.31.40.0-255,66,28705,76,365198
7513,0.000167,74.125.24.0-255,2543,31248,76,365198
7514,0.00017,172.31.40.0-255,66,31314,76,365198
7515,0.000302,74.125.24.0-255,1484,32798,76,365198
7516,0.000306,172.31.40.0-255,66,32864,76,365198
7517,0.000311,74.125.24.0-255,2902,35766,76,365198
7518,0.000314,172.31.40.0-255,66,35832,76,365198
7519,0.000319,74.125.24.0-255,4320,40152,76,365198
7520,0.000322,172.31.40.0-255,66,40218,76,365198
7521,0.000349,74.125.24.0-255,1484,41702,76,365198
7522,0.000351,172.31.40.0-255,66,41768,76,365198
7523,0.000359,74.125.24.0-255,6797,48565,76,365198
7524,0.000361,172.31.40.0-255,66,48631,76,365198
7525,0.000391,74.125.24.0-255,7156,55787,76,365198
7526,0.000393,172.31.40.0-255,66,55853,76,365198
7527,0.000413,74.125.24.0-255,4320,60173,76,365198
7528,0.000415,172.31.40.0-255,66,60239,76,365198
7529,0.000437,74.125.24.0-255,5648,65887,76,365198
7530,0.00044,172.31.40.0-255,66,65953,76,365198
7531,0.000759,74.125.24.0-255,135,66088,76,365198
7532,0.000953,74.125.24.0-255,1484,67572,76,365198
7533,0.000958,172.31.40.0-255,66,67638,76,365198
7534,0.000965,74.125.24.0-255,2902,70540,76,365198
7535,0.000967,172.31.40.0-255,66,70606,76,365198
7536,0.000986,74.125.24.0-255,1484,72090,76,365198
7537,0.001013,74.125.24.0-255,4320,76410,76,365198
7538,0.001015,172.31.40.0-255,66,76476,76,365198
7539,0.001027,74.125.24.0-255,1484,77960,76,365198
7540,0.001031,74.125.24.0-255,1484,79444,76,365198
7541,0.001033,172.31.40.0-255,66,79510,76,365198
7542,0.001057,74.125.24.0-255,3961,83471,76,365198
7543,0.00106,172.31.40.0-255,66,83537,76,365198
7544,0.001078,74.125.24.0-255,4320,87857,76,365198
7545,0.00108,172.31.40.0-255,66,87923,76,365198
7546,0.001109,172.31.40.0-255,66,87989,76,365198
7547,0.001116,74.125.24.0-255,5738,93727,76,365198
7548,0.001118,172.31.40.0-255,66,93793,76,365198
7549,0.001179,74.125.24.0-255,7156,100949,76,365198
7550,0.001182,172.31.40.0-255,66,101015,76,365198
7551,0.001208,172.31.40.0-255,66,101081,76,365198
7552,0.001392,74.125.24.0-255,1484,102565,76,365198
7553,0.001412,74.125.24.0-255,2902,105467,76,365198
7554,0.001416,172.31.40.0-255,66,105533,76,365198
7555,0.001422,74.125.24.0-255,5738,111271,76,365198
7556,0.001425,172.31.40.0-255,66,111337,76,365198
7557,0.001457,74.125.24.0-255,5738,117075,76,365198
7558,0.00146,172.31.40.0-255,66,117141,76,365198
7559,0.001489,74.125.24.0-255,7156,124297,76,365198
7560,0.001491,172.31.40.0-255,66,124363,76,365198
7561,0.001501,172.31.40.0-255,66,124429,76,365198
7562,0.001505,74.125.24.0-255,2184,126613,76,365198
7563,0.001508,172.31.40.0-255,66,126679,76,365198
7564,0.001626,74.125.24.0-255,1484,128163,76,365198
7565,0.001629,74.125.24.0-255,1484,129647,76,365198
7566,0.001634,172.31.40.0-255,66,129713,76,365198
7567,0.001642,74.125.24.0-255,1484,131197,76,365198
7568,0.001658,74.125.24.0-255,5738,136935,76,365198
7569,0.001661,172.31.40.0-255,66,137001,76,365198
7570,0.001669,74.125.24.0-255,7156,144157,76,365198
7571,0.001671,172.31.40.0-255,66,144223,76,365198
7572,0.001702,172.31.40.0-255,66,144289,76,365198
7573,0.001721,74.125.24.0-255,2902,147191,76,365198
7574,0.001723,172.31.40.0-255,66,147257,76,365198
7575,0.001727,74.125.24.0-255,2184,149441,76,365198
7576,0.001729,172.31.40.0-255,66,149507,76,365198
7577,0.001778,74.125.24.0-255,5738,155245,76,365198
7578,0.001782,172.31.40.0-255,66,155311,76,365198
7579,0.001803,74.125.24.0-255,1484,156795,76,365198
7580,0.00181,74.125.24.0-255,5738,162533,76,365198
7581,0.001813,172.31.40.0-255,66,162599,76,365198
7582,0.00183,74.125.24.0-255,2902,165501,76,365198
7583,0.001832,172.31.40.0-255,66,165567,76,365198
7584,0.001839,74.125.24.0-255,7156,172723,76,365198
7585,0.001841,172.31.40.0-255,66,172789,76,365198
7586,0.001873,172.31.40.0-255,66,172855,76,365198
7587,0.001876,74.125.24.0-255,766,173621,76,365198
7588,0.002294,74.125.24.0-255,1484,175105,76,365198
7589,0.0023,172.31.40.0-255,66,175171,76,365198
7590,0.002306,74.125.24.0-255,2902,178073,76,365198
7591,0.002308,172.31.40.0-255,66,178139,76,365198
7592,0.00233,74.125.24.0-255,5738,183877,76,365198
7593,0.002332,172.31.40.0-255,66,183943,76,365198
7594,0.002336,74.125.24.0-255,2902,186845,76,365198
7595,0.002338,172.31.40.0-255,66,186911,76,365198
7596,0.002358,74.125.24.0-255,2902,189813,76,365198
7597,0.00236,172.31.40.0-255,66,189879,76,365198
7598,0.002398,74.125.24.0-255,7156,197035,76,365198
7599,0.002401,172.31.40.0-255,66,197101,76,365198
7600,0.002417,172.31.40.0-255,66,197167,76,365198
7601,0.00242,74.125.24.0-255,766,197933,76,365198
7602,0.00483,74.125.24.0-255,4320,202253,76,365198
7603,0.004837,172.31.40.0-255,66,202319,76,365198
7604,0.007267,74.125.24.0-255,4320,206639,76,365198
7605,0.007274,172.31.40.0-255,66,206705,76,365198
7606,0.007292,74.125.24.0-255,1484,208189,76,365198
7607,0.009709,74.125.24.0-255,4320,212509,76,365198
7608,0.009718,172.31.40.0-255,66,212575,76,365198
7609,0.01218,74.125.24.0-255,5738,218313,76,365198
7610,0.012192,172.31.40.0-255,66,218379,76,365198
7611,0.014647,74.125.24.0-255,5738,224117,76,365198
7612,0.014653,172.31.40.0-255,66,224183,76,365198
7613,0.017157,74.125.24.0-255,5738,229921,76,365198
7614,0.017169,172.31.40.0-255,66,229987,76,365198
7615,0.019634,74.125.24.0-255,5738,235725,76,365198
7616,0.019642,172.31.40.0-255,66,235791,76,365198
7617,0.022147,74.125.24.0-255,5738,241529,76,365198
7618,0.022154,172.31.40.0-255,66,241595,76,365198
7619,0.024591,74.125.24.0-255,5738,247333,76,365198
7620,0.024599,172.31.40.0-255,66,247399,76,365198
7621,0.02707,74.125.24.0-255,5738,253137,76,365198
7622,0.027079,172.31.40.0-255,66,253203,76,365198
7623,0.029512,74.125.24.0-255,5738,258941,76,365198
7624,0.029519,172.31.40.0-255,66,259007,76,365198
7625,0.029745,172.31.40.0-255,172,259179,76,365198
7626,0.029772,172.31.40.0-255,1107,260286,76,365198
7627,0.029884,172.31.40.0-255,1514,261800,76,365198
7628,0.029886,172.31.40.0-255,1309,263109,76,365198
7629,0.03142,104.244.42.0-255,66,263175,76,365198
7630,0.031428,104.244.42.0-255,66,263241,76,365198
7631,0.03157,104.244.42.0-255,66,263307,76,365198
7632,0.031975,74.125.24.0-255,5738,269045,76,365198
7633,0.031981,172.31.40.0-255,66,269111,76,365198
7634,0.034442,74.125.24.0-255,5738,274849,76,365198
7635,0.03445,172.31.40.0-255,66,274915,76,365198
7636,0.036903,74.125.24.0-255,5738,280653,76,365198
7637,0.036909,172.31.40.0-255,66,280719,76,365198
7638,0.039387,74.125.24.0-255,5738,286457,76,365198
7639,0.039394,172.31.40.0-255,66,286523,76,365198
7640,0.041861,74.125.24.0-255,5738,292261,76,365198
7641,0.041868,172.31.40.0-255,66,292327,76,365198
7642,0.044307,74.125.24.0-255,5738,298065,76,365198
7643,0.044313,172.31.40.0-255,66,298131,76,365198
7644,0.046755,74.125.24.0-255,5738,303869,76,365198
7645,0.046764,172.31.40.0-255,66,303935,76,365198
7646,0.049213,74.125.24.0-255,5738,309673,76,365198
7647,0.04922,172.31.40.0-255,66,309739,76,365198
7648,0.051677,74.125.24.0-255,5738,315477,76,365198
7649,0.051688,172.31.40.0-255,66,315543,76,365198
7650,0.054119,74.125.24.0-255,5738,321281,76,365198
7651,0.054125,172.31.40.0-255,66,321347,76,365198
7652,0.056569,74.125.24.0-255,5738,327085,76,365198
7653,0.056576,172.31.40.0-255,66,327151,76,365198
7654,0.059047,74.125.24.0-255,5738,332889,76,365198
7655,0.059058,172.31.40.0-255,66,332955,76,365198
7656,0.061524,74.125.24.0-255,5738,338693,76,365198
7657,0.06153,172.31.40.0-255,66,338759,76,365198
7658,0.06397,74.125.24.0-255,5738,344497,76,365198
7659,0.063976,172.31.40.0-255,66,344563,76,365198
7660,0.066431,74.125.24.0-255,5738,350301,76,365198
7661,0.066438,172.31.40.0-255,66,350367,76,365198
7662,0.068928,74.125.24.0-255,5738,356105,76,365198
7663,0.068934,172.31.40.0-255,66,356171,76,365198
7664,0.071379,74.125.24.0-255,5738,361909,76,365198
7665,0.071385,172.31.40.0-255,66,361975,76,365198
7666,0.073833,74.125.24.0-255,2986,364961,76,365198
7667,0.07384,172.31.40.0-255,66,365027,76,365198
7668,0.074006,172.31.40.0-255,105,365132,76,365198
7669,0.076396,74.125.24.0-255,66,365198,76,365198
7670,0.0,74.125.68.0-255,150,150,76,401299
7671,1.6e-05,172.31.40.0-255,66,216,76,401299
7672,2.4e-05,74.125.68.0-255,1484,1700,76,401299
7673,2.8e-05,172.31.40.0-255,66,1766,76,401299
7674,3.4e-05,74.125.68.0-255,2902,4668,76,401299
7675,3.7e-05,172.31.40.0-255,66,4734,76,401299
7676,4.1e-05,74.125.68.0-255,2902,7636,76,401299
7677,4.4e-05,172.31.40.0-255,66,7702,76,401299
7678,5.9e-05,74.125.68.0-255,1484,9186,76,401299
7679,6.2e-05,172.31.40.0-255,66,9252,76,401299
7680,0.000101,74.125.68.0-255,4936,14188,76,401299
7681,0.000104,172.31.40.0-255,66,14254,76,401299
7682,0.000301,74.125.68.0-255,1484,15738,76,401299
7683,0.000306,172.31.40.0-255,66,15804,76,401299
7684,0.000313,74.125.68.0-255,2902,18706,76,401299
7685,0.000315,172.31.40.0-255,66,18772,76,401299
7686,0.000336,74.125.68.0-255,4320,23092,76,401299
7687,0.00034,172.31.40.0-255,66,23158,76,401299
7688,0.000399,172.31.40.0-255,66,23224,76,401299
7689,0.000414,74.125.68.0-255,1484,24708,76,401299
7690,0.000417,172.31.40.0-255,66,24774,76,401299
7691,0.000442,74.125.68.0-255,2902,27676,76,401299
7692,0.000445,172.31.40.0-255,66,27742,76,401299
7693,0.000451,74.125.68.0-255,5738,33480,76,401299
7694,0.000454,172.31.40.0-255,66,33546,76,401299
7695,0.000482,74.125.68.0-255,6797,40343,76,401299
7696,0.000485,172.31.40.0-255,66,40409,76,401299
7697,0.000825,74.125.68.0-255,1484,41893,76,401299
7698,0.000829,172.31.40.0-255,66,41959,76,401299
7699,0.000835,74.125.68.0-255,2902,44861,76,401299
7700,0.000837,172.31.40.0-255,66,44927,76,401299
7701,0.000841,74.125.68.0-255,1484,46411,76,401299
7702,0.000854,74.125.68.0-255,1484,47895,76,401299
7703,0.000857,172.31.40.0-255,66,47961,76,401299
7704,0.000879,74.125.68.0-255,4320,52281,76,401299
7705,0.000883,172.31.40.0-255,66,52347,76,401299
7706,0.000904,74.125.68.0-255,5959,58306,76,401299
7707,0.000907,172.31.40.0-255,66,58372,76,401299
7708,0.000982,74.125.68.0-255,1484,59856,76,401299
7709,0.000997,74.125.68.0-255,1484,61340,76,401299
7710,0.001,172.31.40.0-255,66,61406,76,401299
7711,0.001005,74.125.68.0-255,2902,64308,76,401299
7712,0.001007,172.31.40.0-255,66,64374,76,401299
7713,0.00103,74.125.68.0-255,1484,65858,76,401299
7714,0.001051,74.125.68.0-255,4320,70178,76,401299
7715,0.001054,172.31.40.0-255,66,70244,76,401299
7716,0.001058,74.125.68.0-255,2902,73146,76,401299
7717,0.00106,172.31.40.0-255,66,73212,76,401299
7718,0.001078,74.125.68.0-255,4320,77532,76,401299
7719,0.001081,172.31.40.0-255,66,77598,76,401299
7720,0.0011,74.125.68.0-255,4320,81918,76,401299
7721,0.001103,172.31.40.0-255,66,81984,76,401299
7722,0.001121,74.125.68.0-255,4320,86304,76,401299
7723,0.001123,172.31.40.0-255,66,86370,76,401299
7724,0.001147,74.125.68.0-255,1484,87854,76,401299
7725,0.001175,74.125.68.0-255,5020,92874,76,401299
7726,0.001178,172.31.40.0-255,66,92940,76,401299
7727,0.001199,74.125.68.0-255,4320,97260,76,401299
7728,0.001201,172.31.40.0-255,66,97326,76,401299
7729,0.001228,74.125.68.0-255,2902,100228,76,401299
7730,0.00123,172.31.40.0-255,66,100294,76,401299
7731,0.001242,172.31.40.0-255,66,100360,76,401299
7732,0.001245,74.125.68.0-255,461,100821,76,401299
7733,0.001463,74.125.68.0-255,1484,102305,76,401299
7734,0.001467,172.31.40.0-255,66,102371,76,401299
7735,0.001488,74.125.68.0-255,2902,105273,76,401299
7736,0.001491,172.31.40.0-255,66,105339,76,401299
7737,0.001497,74.125.68.0-255,5738,111077,76,401299
7738,0.001499,172.31.40.0-255,66,111143,76,401299
7739,0.001518,74.125.68.0-255,2902,114045,76,401299
7740,0.001521,172.31.40.0-255,66,114111,76,401299
7741,0.001525,74.125.68.0-255,2902,117013,76,401299
7742,0.001528,172.31.40.0-255,66,117079,76,401299
7743,0.001544,74.125.68.0-255,1484,118563,76,401299
7744,0.00158,74.125.68.0-255,7156,125719,76,401299
7745,0.001583,172.31.40.0-255,66,125785,76,401299
7746,0.001604,74.125.68.0-255,1820,127605,76,401299
7747,0.001608,172.31.40.0-255,66,127671,76,401299
7748,0.001614,74.125.68.0-255,5738,133409,76,401299
7749,0.001616,172.31.40.0-255,66,133475,76,401299
7750,0.001636,74.125.68.0-255,4320,137795,76,401299
7751,0.001639,172.31.40.0-255,66,137861,76,401299
7752,0.001645,74.125.68.0-255,5738,143599,76,401299
7753,0.001647,172.31.40.0-255,66,143665,76,401299
7754,0.001654,74.125.68.0-255,7156,150821,76,401299
7755,0.001657,172.31.40.0-255,66,150887,76,401299
7756,0.001661,74.125.68.0-255,2184,153071,76,401299
7757,0.001663,172.31.40.0-255,66,153137,76,401299
7758,0.003964,74.125.68.0-255,5738,158875,76,401299
7759,0.003971,172.31.40.0-255,66,158941,76,401299
7760,0.00628,74.125.68.0-255,5738,164679,76,401299
7761,0.006286,172.31.40.0-255,66,164745,76,401299
7762,0.008606,74.125.68.0-255,5738,170483,76,401299
7763,0.008614,172.31.40.0-255,66,170549,76,401299
7764,0.010933,74.125.68.0-255,5738,176287,76,401299
7765,0.01094,172.31.40.0-255,66,176353,76,401299
7766,0.013249,74.125.68.0-255,5738,182091,76,401299
7767,0.01326,172.31.40.0-255,66,182157,76,401299
7768,0.015578,74.125.68.0-255,5738,187895,76,401299
7769,0.015587,172.31.40.0-255,66,187961,76,401299
7770,0.017901,74.125.68.0-255,5738,193699,76,401299
7771,0.017908,172.31.40.0-255,66,193765,76,401299
7772,0.020227,74.125.68.0-255,5738,199503,76,401299
7773,0.020235,172.31.40.0-255,66,199569,76,401299
7774,0.022544,74.125.68.0-255,5738,205307,76,401299
7775,0.022551,172.31.40.0-255,66,205373,76,401299
7776,0.024855,74.125.68.0-255,5738,211111,76,401299
7777,0.024862,172.31.40.0-255,66,211177,76,401299
7778,0.026267,172.31.40.0-255,266,211443,76,401299
7779,0.026294,172.31.40.0-255,1131,212574,76,401299
7780,0.026347,172.31.40.0-255,1514,214088,76,401299
7781,0.026349,172.31.40.0-255,1285,215373,76,401299
7782,0.027171,74.125.68.0-255,5738,221111,76,401299
7783,0.027177,172.31.40.0-255,66,221177,76,401299
7784,0.027813,104.244.42.0-255,66,221243,76,401299
7785,0.027849,104.244.42.0-255,66,221309,76,401299
7786,0.027908,104.244.42.0-255,66,221375,76,401299
7787,0.029489,74.125.68.0-255,5738,227113,76,401299
7788,0.029496,172.31.40.0-255,66,227179,76,401299
7789,0.031822,74.125.68.0-255,5738,232917,76,401299
7790,0.031829,172.31.40.0-255,66,232983,76,401299
7791,0.034171,74.125.68.0-255,5738,238721,76,401299
7792,0.034177,172.31.40.0-255,66,238787,76,401299
7793,0.036507,74.125.68.0-255,5738,244525,76,401299
7794,0.036512,172.31.40.0-255,66,244591,76,401299
7795,0.038829,74.125.68.0-255,5738,250329,76,401299
7796,0.038839,172.31.40.0-255,66,250395,76,401299
7797,0.041148,74.125.68.0-255,5738,256133,76,401299
7798,0.041154,172.31.40.0-255,66,256199,76,401299
7799,0.043476,74.125.68.0-255,5738,261937,76,401299
7800,0.043484,172.31.40.0-255,66,262003,76,401299
7801,0.045802,74.125.68.0-255,5738,267741,76,401299
7802,0.045809,172.31.40.0-255,66,267807,76,401299
7803,0.048138,74.125.68.0-255,5738,273545,76,401299
7804,0.048145,172.31.40.0-255,66,273611,76,401299
7805,0.050476,74.125.68.0-255,5738,279349,76,401299
7806,0.050483,172.31.40.0-255,66,279415,76,401299
7807,0.052794,74.125.68.0-255,5738,285153,76,401299
7808,0.0528,172.31.40.0-255,66,285219,76,401299
7809,0.055139,74.125.68.0-255,5738,290957,76,401299
7810,0.055146,172.31.40.0-255,66,291023,76,401299
7811,0.057491,74.125.68.0-255,5738,296761,76,401299
7812,0.057497,172.31.40.0-255,66,296827,76,401299
7813,0.059817,74.125.68.0-255,5738,302565,76,401299
7814,0.059823,172.31.40.0-255,66,302631,76,401299
7815,0.062133,74.125.68.0-255,5738,308369,76,401299
7816,0.06214,172.31.40.0-255,66,308435,76,401299
7817,0.064467,74.125.68.0-255,5738,314173,76,401299
7818,0.064473,172.31.40.0-255,66,314239,76,401299
7819,0.066783,74.125.68.0-255,5738,319977,76,401299
7820,0.066789,172.31.40.0-255,66,320043,76,401299
7821,0.069105,74.125.68.0-255,5738,325781,76,401299
7822,0.069112,172.31.40.0-255,66,325847,76,401299
7823,0.071433,74.125.68.0-255,5738,331585,76,401299
7824,0.07144,172.31.40.0-255,66,331651,76,401299
7825,0.073763,74.125.68.0-255,5738,337389,76,401299
7826,0.07377,172.31.40.0-255,66,337455,76,401299
7827,0.076103,74.125.68.0-255,5738,343193,76,401299
7828,0.076109,172.31.40.0-255,66,343259,76,401299
7829,0.078444,74.125.68.0-255,5738,348997,76,401299
7830,0.078451,172.31.40.0-255,66,349063,76,401299
7831,0.080762,74.125.68.0-255,5738,354801,76,401299
7832,0.080769,172.31.40.0-255,66,354867,76,401299
7833,0.083091,74.125.68.0-255,5738,360605,76,401299
7834,0.083097,172.31.40.0-255,66,360671,76,401299
7835,0.085427,74.125.68.0-255,5738,366409,76,401299
7836,0.085433,172.31.40.0-255,66,366475,76,401299
7837,0.087745,74.125.68.0-255,5738,372213,76,401299
7838,0.087751,172.31.40.0-255,66,372279,76,401299
7839,0.090053,74.125.68.0-255,5738,378017,76,401299
7840,0.09006,172.31.40.0-255,66,378083,76,401299
7841,0.092377,74.125.68.0-255,5738,383821,76,401299
7842,0.092383,172.31.40.0-255,66,383887,76,401299
7843,0.09469,74.125.68.0-255,5738,389625,76,401299
7844,0.094695,172.31.40.0-255,66,389691,76,401299
7845,0.097011,74.125.68.0-255,5738,395429,76,401299
7846,0.097018,172.31.40.0-255,66,395495,76,401299
7847,0.099329,74.125.68.0-255,5738,401233,76,401299
7848,0.099336,172.31.40.0-255,66,401299,76,401299
7849,0.0,74.125.68.0-255,190,190,76,288593
7850,2e-05,172.31.40.0-255,66,256,76,288593
7851,2.7e-05,74.125.68.0-255,1484,1740,76,288593
7852,3.2e-05,172.31.40.0-255,66,1806,76,288593
7853,3.7e-05,74.125.68.0-255,2902,4708,76,288593
7854,4.8e-05,172.31.40.0-255,66,4774,76,288593
7855,5.4e-05,74.125.68.0-255,4320,9094,76,288593
7856,5.8e-05,172.31.40.0-255,66,9160,76,288593
7857,9e-05,74.125.68.0-255,4911,14071,76,288593
7858,9.7e-05,172.31.40.0-255,66,14137,76,288593
7859,0.000128,74.125.68.0-255,2902,17039,76,288593
7860,0.000131,172.31.40.0-255,66,17105,76,288593
7861,0.000137,74.125.68.0-255,4320,21425,76,288593
7862,0.000139,172.31.40.0-255,66,21491,76,288593
7863,0.000163,74.125.68.0-255,5738,27229,76,288593
7864,0.000166,172.31.40.0-255,66,27295,76,288593
7865,0.000195,74.125.68.0-255,2902,30197,76,288593
7866,0.000198,172.31.40.0-255,66,30263,76,288593
7867,0.000225,74.125.68.0-255,1125,31388,76,288593
7868,0.000227,172.31.40.0-255,66,31454,76,288593
7869,0.000594,74.125.68.0-255,1484,32938,76,288593
7870,0.000599,172.31.40.0-255,66,33004,76,288593
7871,0.000604,74.125.68.0-255,2902,35906,76,288593
7872,0.000606,172.31.40.0-255,66,35972,76,288593
7873,0.00064,74.125.68.0-255,5738,41710,76,288593
7874,0.000643,172.31.40.0-255,66,41776,76,288593
7875,0.000675,74.125.68.0-255,7156,48932,76,288593
7876,0.000678,172.31.40.0-255,66,48998,76,288593
7877,0.000682,74.125.68.0-255,2902,51900,76,288593
7878,0.000685,172.31.40.0-255,66,51966,76,288593
7879,0.000712,74.125.68.0-255,2902,54868,76,288593
7880,0.000715,172.31.40.0-255,66,54934,76,288593
7881,0.000738,74.125.68.0-255,1484,56418,76,288593
7882,0.000746,74.125.68.0-255,5738,62156,76,288593
7883,0.000762,74.125.68.0-255,2902,65058,76,288593
7884,0.000787,74.125.68.0-255,766,65824,76,288593
7885,0.000802,74.125.68.0-255,427,66251,76,288593
7886,0.000848,74.125.68.0-255,1484,67735,76,288593
7887,0.000863,74.125.68.0-255,1484,69219,76,288593
7888,0.000881,74.125.68.0-255,2902,72121,76,288593
7889,0.000929,74.125.68.0-255,4320,76441,76,288593
7890,0.000948,74.125.68.0-255,1484,77925,76,288593
7891,0.001016,74.125.68.0-255,4320,82245,76,288593
7892,0.001033,74.125.68.0-255,6438,88683,76,288593
7893,0.001094,172.31.40.0-255,66,88749,76,288593
7894,0.001126,74.125.68.0-255,1484,90233,76,288593
7895,0.00113,74.125.68.0-255,1484,91717,76,288593
7896,0.001148,74.125.68.0-255,1484,93201,76,288593
7897,0.001155,172.31.40.0-255,66,93267,76,288593
7898,0.001162,74.125.68.0-255,1484,94751,76,288593
7899,0.001172,74.125.68.0-255,5738,100489,76,288593
7900,0.001175,74.125.68.0-255,1484,101973,76,288593
7901,0.001182,172.31.40.0-255,66,102039,76,288593
7902,0.001205,74.125.68.0-255,7156,109195,76,288593
7903,0.001222,74.125.68.0-255,1484,110679,76,288593
7904,0.001228,172.31.40.0-255,66,110745,76,288593
7905,0.001269,74.125.68.0-255,7156,117901,76,288593
7906,0.00128,172.31.40.0-255,66,117967,76,288593
7907,0.001291,74.125.68.0-255,4320,122287,76,288593
7908,0.001302,172.31.40.0-255,66,122353,76,288593
7909,0.001324,74.125.68.0-255,766,123119,76,288593
7910,0.001572,74.125.68.0-255,1484,124603,76,288593
7911,0.00158,172.31.40.0-255,66,124669,76,288593
7912,0.001593,74.125.68.0-255,2902,127571,76,288593
7913,0.001603,74.125.68.0-255,4320,131891,76,288593
7914,0.001612,74.125.68.0-255,1484,133375,76,288593
7915,0.001627,172.31.40.0-255,66,133441,76,288593
7916,0.001647,74.125.68.0-255,4320,137761,76,288593
7917,0.001658,74.125.68.0-255,2902,140663,76,288593
7918,0.001669,74.125.68.0-255,1484,142147,76,288593
7919,0.001677,172.31.40.0-255,66,142213,76,288593
7920,0.001689,74.125.68.0-255,2902,145115,76,288593
7921,0.001708,172.31.40.0-255,66,145181,76,288593
7922,0.001763,172.31.40.0-255,66,145247,76,288593
7923,0.001806,74.125.68.0-255,4320,149567,76,288593
7924,0.001822,172.31.40.0-255,66,149633,76,288593
7925,0.001845,172.31.40.0-255,66,149699,76,288593
7926,0.001897,74.125.68.0-255,1484,151183,76,288593
7927,0.001956,172.31.40.0-255,66,151249,76,288593
7928,0.002045,74.125.68.0-255,4320,155569,76,288593
7929,0.00205,172.31.40.0-255,66,155635,76,288593
7930,0.00211,172.31.40.0-255,66,155701,76,288593
7931,0.002205,74.125.68.0-255,5738,161439,76,288593
7932,0.002223,74.125.68.0-255,6438,167877,76,288593
7933,0.002239,172.31.40.0-255,66,167943,76,288593
7934,0.002289,74.125.68.0-255,4320,172263,76,288593
7935,0.002334,172.31.40.0-255,66,172329,76,288593
7936,0.002425,172.31.40.0-255,66,172395,76,288593
7937,0.002532,74.125.68.0-255,5738,178133,76,288593
7938,0.002542,172.31.40.0-255,66,178199,76,288593
7939,0.002597,74.125.68.0-255,2184,180383,76,288593
7940,0.002607,172.31.40.0-255,66,180449,76,288593
7941,0.002828,74.125.68.0-255,5738,186187,76,288593
7942,0.002833,172.31.40.0-255,66,186253,76,288593
7943,0.002867,74.125.68.0-255,5738,191991,76,288593
7944,0.002881,172.31.40.0-255,66,192057,76,288593
7945,0.005152,74.125.68.0-255,4320,196377,76,288593
7946,0.005159,172.31.40.0-255,66,196443,76,288593
7947,0.005172,74.125.68.0-255,1484,197927,76,288593
7948,0.007426,74.125.68.0-255,4320,202247,76,288593
7949,0.007451,172.31.40.0-255,66,202313,76,288593
7950,0.009711,74.125.68.0-255,5738,208051,76,288593
7951,0.009717,172.31.40.0-255,66,208117,76,288593
7952,0.012048,74.125.68.0-255,2902,211019,76,288593
7953,0.012056,172.31.40.0-255,66,211085,76,288593
7954,0.012089,74.125.68.0-255,2902,213987,76,288593
7955,0.012092,172.31.40.0-255,66,214053,76,288593
7956,0.014314,74.125.68.0-255,2902,216955,76,288593
7957,0.014323,172.31.40.0-255,66,217021,76,288593
7958,0.014356,74.125.68.0-255,2902,219923,76,288593
7959,0.014359,172.31.40.0-255,66,219989,76,288593
7960,0.016584,74.125.68.0-255,2902,222891,76,288593
7961,0.016596,172.31.40.0-255,66,222957,76,288593
7962,0.016628,74.125.68.0-255,2902,225859,76,288593
7963,0.016632,172.31.40.0-255,66,225925,76,288593
7964,0.018862,74.125.68.0-255,2902,228827,76,288593
7965,0.01887,172.31.40.0-255,66,228893,76,288593
7966,0.018902,74.125.68.0-255,2902,231795,76,288593
7967,0.018905,172.31.40.0-255,66,231861,76,288593
7968,0.021135,74.125.68.0-255,2902,234763,76,288593
7969,0.021143,172.31.40.0-255,66,234829,76,288593
7970,0.021175,74.125.68.0-255,2902,237731,76,288593
7971,0.021179,172.31.40.0-255,66,237797,76,288593
7972,0.023475,74.125.68.0-255,2902,240699,76,288593
7973,0.023483,172.31.40.0-255,66,240765,76,288593
7974,0.02351,74.125.68.0-255,2902,243667,76,288593
7975,0.023513,172.31.40.0-255,66,243733,76,288593
7976,0.025757,74.125.68.0-255,4320,248053,76,288593
7977,0.025764,172.31.40.0-255,66,248119,76,288593
7978,0.02579,74.125.68.0-255,1484,249603,76,288593
7979,0.028025,74.125.68.0-255,4320,253923,76,288593
7980,0.028032,172.31.40.0-255,66,253989,76,288593
7981,0.030292,74.125.68.0-255,5738,259727,76,288593
7982,0.030298,172.31.40.0-255,66,259793,76,288593
7983,0.03257,74.125.68.0-255,4320,264113,76,288593
7984,0.032581,172.31.40.0-255,66,264179,76,288593
7985,0.032613,74.125.68.0-255,1484,265663,76,288593
7986,0.034847,74.125.68.0-255,4320,269983,76,288593
7987,0.034854,172.31.40.0-255,66,270049,76,288593
7988,0.034942,172.31.40.0-255,172,270221,76,288593
7989,0.034968,172.31.40.0-255,1109,271330,76,288593
7990,0.035052,172.31.40.0-255,1514,272844,76,288593
7991,0.035054,172.31.40.0-255,1307,274151,76,288593
7992,0.03648,104.244.42.0-255,66,274217,76,288593
7993,0.036514,104.244.42.0-255,66,274283,76,288593
7994,0.036612,104.244.42.0-255,66,274349,76,288593
7995,0.037142,74.125.68.0-255,5738,280087,76,288593
7996,0.037148,172.31.40.0-255,66,280153,76,288593
7997,0.039418,74.125.68.0-255,5738,285891,76,288593
7998,0.039425,172.31.40.0-255,66,285957,76,288593
7999,0.041692,74.125.68.0-255,2399,288356,76,288593
8000,0.041699,172.31.40.0-255,66,288422,76,288593
8001,0.041852,172.31.40.0-255,105,288527,76,288593
8002,0.044076,74.125.68.0-255,66,288593,76,288593
8003,0.0,74.125.24.0-255,152,152,76,277141
8004,2.2e-05,172.31.40.0-255,66,218,76,277141
8005,2.8e-05,74.125.24.0-255,1484,1702,76,277141
8006,3.2e-05,172.31.40.0-255,66,1768,76,277141
8007,3.8e-05,74.125.24.0-255,2902,4670,76,277141
8008,4e-05,172.31.40.0-255,66,4736,76,277141
8009,4.9e-05,74.125.24.0-255,7156,11892,76,277141
8010,5.2e-05,172.31.40.0-255,66,11958,76,277141
8011,5.5e-05,74.125.24.0-255,2037,13995,76,277141
8012,5.8e-05,172.31.40.0-255,66,14061,76,277141
8013,8.6e-05,74.125.24.0-255,7156,21217,76,277141
8014,8.9e-05,172.31.40.0-255,66,21283,76,277141
8015,0.000104,74.125.24.0-255,4320,25603,76,277141
8016,0.000106,172.31.40.0-255,66,25669,76,277141
8017,0.000112,74.125.24.0-255,5379,31048,76,277141
8018,0.000115,172.31.40.0-255,66,31114,76,277141
8019,0.000189,74.125.24.0-255,1484,32598,76,277141
8020,0.000192,172.31.40.0-255,66,32664,76,277141
8021,0.000196,74.125.24.0-255,2902,35566,76,277141
8022,0.000198,172.31.40.0-255,66,35632,76,277141
8023,0.000213,74.125.24.0-255,5738,41370,76,277141
8024,0.000216,172.31.40.0-255,66,41436,76,277141
8025,0.000238,74.125.24.0-255,2902,44338,76,277141
8026,0.00024,172.31.40.0-255,66,44404,76,277141
8027,0.000265,172.31.40.0-255,66,44470,76,277141
8028,0.000276,172.31.40.0-255,66,44536,76,277141
8029,0.000298,74.125.24.0-255,397,44933,76,277141
8030,0.0003,172.31.40.0-255,66,44999,76,277141
8031,0.000382,74.125.24.0-255,115,45114,76,277141
8032,0.000385,172.31.40.0-255,66,45180,76,277141
8033,0.00053,74.125.24.0-255,1484,46664,76,277141
8034,0.000538,74.125.24.0-255,2902,49566,76,277141
8035,0.000542,172.31.40.0-255,66,49632,76,277141
8036,0.000567,74.125.24.0-255,5738,55370,76,277141
8037,0.00057,172.31.40.0-255,66,55436,76,277141
8038,0.000609,74.125.24.0-255,7156,62592,76,277141
8039,0.000613,172.31.40.0-255,66,62658,76,277141
8040,0.00064,74.125.24.0-255,6797,69455,76,277141
8041,0.000643,172.31.40.0-255,66,69521,76,277141
8042,0.000659,74.125.24.0-255,5738,75259,76,277141
8043,0.000662,172.31.40.0-255,66,75325,76,277141
8044,0.000674,74.125.24.0-255,3643,78968,76,277141
8045,0.000677,172.31.40.0-255,66,79034,76,277141
8046,0.001036,74.125.24.0-255,1484,80518,76,277141
8047,0.001042,74.125.24.0-255,2902,83420,76,277141
8048,0.001045,172.31.40.0-255,66,83486,76,277141
8049,0.001071,74.125.24.0-255,5738,89224,76,277141
8050,0.001074,172.31.40.0-255,66,89290,76,277141
8051,0.001079,74.125.24.0-255,4320,93610,76,277141
8052,0.001081,172.31.40.0-255,66,93676,76,277141
8053,0.001097,74.125.24.0-255,2902,96578,76,277141
8054,0.001099,172.31.40.0-255,66,96644,76,277141
8055,0.001103,74.125.24.0-255,2902,99546,76,277141
8056,0.001105,172.31.40.0-255,66,99612,76,277141
8057,0.001147,172.31.40.0-255,66,99678,76,277141
8058,0.001152,74.125.24.0-255,2184,101862,76,277141
8059,0.001153,172.31.40.0-255,66,101928,76,277141
8060,0.001274,74.125.24.0-255,1484,103412,76,277141
8061,0.001279,74.125.24.0-255,2902,106314,76,277141
8062,0.001282,172.31.40.0-255,66,106380,76,277141
8063,0.001305,74.125.24.0-255,5738,112118,76,277141
8064,0.001307,172.31.40.0-255,66,112184,76,277141
8065,0.001327,74.125.24.0-255,4320,116504,76,277141
8066,0.001329,172.31.40.0-255,66,116570,76,277141
8067,0.001353,74.125.24.0-255,7156,123726,76,277141
8068,0.001356,172.31.40.0-255,66,123792,76,277141
8069,0.001364,74.125.24.0-255,7156,130948,76,277141
8070,0.001366,172.31.40.0-255,66,131014,76,277141
8071,0.001389,74.125.24.0-255,5020,136034,76,277141
8072,0.001392,172.31.40.0-255,66,136100,76,277141
8073,0.001461,74.125.24.0-255,1484,137584,76,277141
8074,0.001466,74.125.24.0-255,1484,139068,76,277141
8075,0.001469,172.31.40.0-255,66,139134,76,277141
8076,0.001491,74.125.24.0-255,1484,140618,76,277141
8077,0.001497,74.125.24.0-255,5738,146356,76,277141
8078,0.0015,172.31.40.0-255,66,146422,76,277141
8079,0.001516,74.125.24.0-255,1484,147906,76,277141
8080,0.001556,74.125.24.0-255,4320,152226,76,277141
8081,0.001561,172.31.40.0-255,66,152292,76,277141
8082,0.001564,172.31.40.0-255,66,152358,76,277141
8083,0.001579,74.125.24.0-255,1484,153842,76,277141
8084,0.001597,74.125.24.0-255,5020,158862,76,277141
8085,0.0016,172.31.40.0-255,66,158928,76,277141
8086,0.001674,74.125.24.0-255,1484,160412,76,277141
8087,0.001679,74.125.24.0-255,2902,163314,76,277141
8088,0.001682,172.31.40.0-255,66,163380,76,277141
8089,0.00171,74.125.24.0-255,5738,169118,76,277141
8090,0.001713,172.31.40.0-255,66,169184,76,277141
8091,0.00174,172.31.40.0-255,66,169250,76,277141
8092,0.001781,74.125.24.0-255,5738,174988,76,277141
8093,0.001783,172.31.40.0-255,66,175054,76,277141
8094,0.001803,74.125.24.0-255,5020,180074,76,277141
8095,0.001805,172.31.40.0-255,66,180140,76,277141
8096,0.00187,74.125.24.0-255,1484,181624,76,277141
8097,0.001875,74.125.24.0-255,1484,183108,76,277141
8098,0.001877,172.31.40.0-255,66,183174,76,277141
8099,0.001896,74.125.24.0-255,1484,184658,76,277141
8100,0.001902,74.125.24.0-255,5738,190396,76,277141
8101,0.001905,172.31.40.0-255,66,190462,76,277141
8102,0.001938,172.31.40.0-255,66,190528,76,277141
8103,0.00195,74.125.24.0-255,1484,192012,76,277141
8104,0.001955,74.125.24.0-255,2902,194914,76,277141
8105,0.001957,172.31.40.0-255,66,194980,76,277141
8106,0.001977,172.31.40.0-255,66,195046,76,277141
8107,0.002002,74.125.24.0-255,1484,196530,76,277141
8108,0.002019,74.125.24.0-255,7156,203686,76,277141
8109,0.002023,172.31.40.0-255,66,203752,76,277141
8110,0.002051,74.125.24.0-255,7156,210908,76,277141
8111,0.002054,172.31.40.0-255,66,210974,76,277141
8112,0.00207,172.31.40.0-255,66,211040,76,277141
8113,0.002089,74.125.24.0-255,766,211806,76,277141
8114,0.002092,74.125.24.0-255,1484,213290,76,277141
8115,0.002095,172.31.40.0-255,66,213356,76,277141
8116,0.0021,74.125.24.0-255,2902,216258,76,277141
8117,0.002103,172.31.40.0-255,66,216324,76,277141
8118,0.002126,74.125.24.0-255,5738,222062,76,277141
8119,0.002129,172.31.40.0-255,66,222128,76,277141
8120,0.002135,74.125.24.0-255,5738,227866,76,277141
8121,0.002137,172.31.40.0-255,66,227932,76,277141
8122,0.002172,74.125.24.0-255,7156,235088,76,277141
8123,0.002175,172.31.40.0-255,66,235154,76,277141
8124,0.002185,172.31.40.0-255,66,235220,76,277141
8125,0.002214,74.125.24.0-255,3602,238822,76,277141
8126,0.002216,172.31.40.0-255,66,238888,76,277141
8127,0.002221,74.125.24.0-255,4320,243208,76,277141
8128,0.002223,172.31.40.0-255,66,243274,76,277141
8129,0.002246,172.31.40.0-255,66,243340,76,277141
8130,0.002289,172.31.40.0-255,66,243406,76,277141
8131,0.002321,172.31.40.0-255,66,243472,76,277141
8132,0.002326,74.125.24.0-255,2902,246374,76,277141
8133,0.002328,172.31.40.0-255,66,246440,76,277141
8134,0.002351,172.31.40.0-255,66,246506,76,277141
8135,0.004652,74.125.24.0-255,5738,252244,76,277141
8136,0.004659,172.31.40.0-255,66,252310,76,277141
8137,0.006981,74.125.24.0-255,5738,258048,76,277141
8138,0.006989,172.31.40.0-255,66,258114,76,277141
8139,0.009301,74.125.24.0-255,5738,263852,76,277141
8140,0.009307,172.31.40.0-255,66,263918,76,277141
8141,0.011638,74.125.24.0-255,5738,269656,76,277141
8142,0.011643,172.31.40.0-255,66,269722,76,277141
8143,0.013921,74.125.24.0-255,2880,272602,76,277141
8144,0.01393,172.31.40.0-255,66,272668,76,277141
8145,0.017802,172.31.40.0-255,105,272773,76,277141
8146,0.020069,74.125.24.0-255,66,272839,76,277141
8147,0.038451,172.31.40.0-255,172,273011,76,277141
8148,0.038509,172.31.40.0-255,1109,274120,76,277141
8149,0.038568,172.31.40.0-255,1514,275634,76,277141
8150,0.03857,172.31.40.0-255,1309,276943,76,277141
8151,0.039984,104.244.42.0-255,66,277009,76,277141
8152,0.040059,104.244.42.0-255,66,277075,76,277141
8153,0.040125,104.244.42.0-255,66,277141,76,277141
8154,0.0,172.217.194.0-255,150,150,76,202996
8155,2.9e-05,172.31.40.0-255,66,216,76,202996
8156,3.5e-05,172.217.194.0-255,1484,1700,76,202996
8157,3.9e-05,172.31.40.0-255,66,1766,76,202996
8158,4.4e-05,172.217.194.0-255,2902,4668,76,202996
8159,4.5e-05,172.31.40.0-255,66,4734,76,202996
8160,5e-05,172.217.194.0-255,4320,9054,76,202996
8161,5.2e-05,172.31.40.0-255,66,9120,76,202996
8162,6.5e-05,172.217.194.0-255,4892,14012,76,202996
8163,6.7e-05,172.31.40.0-255,66,14078,76,202996
8164,0.000117,172.31.40.0-255,66,14144,76,202996
8165,0.000123,172.217.194.0-255,5379,19523,76,202996
8166,0.000125,172.31.40.0-255,66,19589,76,202996
8167,0.000207,172.217.194.0-255,1484,21073,76,202996
8168,0.00021,172.31.40.0-255,66,21139,76,202996
8169,0.000227,172.217.194.0-255,2902,24041,76,202996
8170,0.00023,172.31.40.0-255,66,24107,76,202996
8171,0.000264,172.217.194.0-255,5738,29845,76,202996
8172,0.000268,172.31.40.0-255,66,29911,76,202996
8173,0.000271,172.217.194.0-255,2902,32813,76,202996
8174,0.000275,172.31.40.0-255,66,32879,76,202996
8175,0.000313,172.31.40.0-255,66,32945,76,202996
8176,0.000319,172.217.194.0-255,7156,40101,76,202996
8177,0.000322,172.31.40.0-255,66,40167,76,202996
8178,0.000362,172.217.194.0-255,2866,43033,76,202996
8179,0.000365,172.31.40.0-255,66,43099,76,202996
8180,0.000391,172.217.194.0-255,2902,46001,76,202996
8181,0.000393,172.31.40.0-255,66,46067,76,202996
8182,0.000397,172.217.194.0-255,2902,48969,76,202996
8183,0.0004,172.31.40.0-255,66,49035,76,202996
8184,0.000424,172.217.194.0-255,4320,53355,76,202996
8185,0.000426,172.31.40.0-255,66,53421,76,202996
8186,0.000432,172.217.194.0-255,5738,59159,76,202996
8187,0.000434,172.31.40.0-255,66,59225,76,202996
8188,0.000464,172.217.194.0-255,5738,64963,76,202996
8189,0.000468,172.31.40.0-255,66,65029,76,202996
8190,0.000502,172.31.40.0-255,66,65095,76,202996
8191,0.00053,172.217.194.0-255,1901,66996,76,202996
8192,0.000533,172.31.40.0-255,66,67062,76,202996
8193,0.00054,172.217.194.0-255,7156,74218,76,202996
8194,0.000548,172.31.40.0-255,66,74284,76,202996
8195,0.000556,172.31.40.0-255,66,74350,76,202996
8196,0.000559,172.217.194.0-255,2902,77252,76,202996
8197,0.000561,172.31.40.0-255,66,77318,76,202996
8198,0.000607,172.31.40.0-255,66,77384,76,202996
8199,0.00061,172.217.194.0-255,766,78150,76,202996
8200,0.000696,172.217.194.0-255,1484,79634,76,202996
8201,0.000699,172.31.40.0-255,66,79700,76,202996
8202,0.000703,172.217.194.0-255,1484,81184,76,202996
8203,0.000723,172.217.194.0-255,1484,82668,76,202996
8204,0.000726,172.31.40.0-255,66,82734,76,202996
8205,0.000732,172.217.194.0-255,5738,88472,76,202996
8206,0.000735,172.31.40.0-255,66,88538,76,202996
8207,0.000769,172.31.40.0-255,66,88604,76,202996
8208,0.000777,172.217.194.0-255,5738,94342,76,202996
8209,0.000779,172.31.40.0-255,66,94408,76,202996
8210,0.000811,172.217.194.0-255,5020,99428,76,202996
8211,0.000816,172.31.40.0-255,66,99494,76,202996
8212,0.000828,172.217.194.0-255,4320,103814,76,202996
8213,0.000831,172.31.40.0-255,66,103880,76,202996
8214,0.000848,172.217.194.0-255,7156,111036,76,202996
8215,0.000855,172.31.40.0-255,66,111102,76,202996
8216,0.000858,172.217.194.0-255,1484,112586,76,202996
8217,0.000874,172.217.194.0-255,5738,118324,76,202996
8218,0.000877,172.31.40.0-255,66,118390,76,202996
8219,0.000911,172.31.40.0-255,66,118456,76,202996
8220,0.000917,172.217.194.0-255,6438,124894,76,202996
8221,0.00092,172.31.40.0-255,66,124960,76,202996
8222,0.000925,172.217.194.0-255,5738,130698,76,202996
8223,0.000927,172.31.40.0-255,66,130764,76,202996
8224,0.000938,172.217.194.0-255,1484,132248,76,202996
8225,0.000943,172.217.194.0-255,5738,137986,76,202996
8226,0.000946,172.31.40.0-255,66,138052,76,202996
8227,0.00095,172.217.194.0-255,4320,142372,76,202996
8228,0.000956,172.31.40.0-255,66,142438,76,202996
8229,0.001002,172.31.40.0-255,66,142504,76,202996
8230,0.001009,172.217.194.0-255,6438,148942,76,202996
8231,0.001011,172.31.40.0-255,66,149008,76,202996
8232,0.001015,172.217.194.0-255,2902,151910,76,202996
8233,0.001016,172.31.40.0-255,66,151976,76,202996
8234,0.001039,172.217.194.0-255,4320,156296,76,202996
8235,0.001045,172.31.40.0-255,66,156362,76,202996
8236,0.00105,172.217.194.0-255,4320,160682,76,202996
8237,0.001052,172.31.40.0-255,66,160748,76,202996
8238,0.001068,172.31.40.0-255,66,160814,76,202996
8239,0.001094,172.217.194.0-255,1484,162298,76,202996
8240,0.00111,172.31.40.0-255,66,162364,76,202996
8241,0.00113,172.217.194.0-255,2902,165266,76,202996
8242,0.001132,172.31.40.0-255,66,165332,76,202996
8243,0.00117,172.217.194.0-255,7156,172488,76,202996
8244,0.001173,172.31.40.0-255,66,172554,76,202996
8245,0.001176,172.217.194.0-255,1484,174038,76,202996
8246,0.001188,172.31.40.0-255,66,174104,76,202996
8247,0.001203,172.31.40.0-255,66,174170,76,202996
8248,0.001264,172.217.194.0-255,1484,175654,76,202996
8249,0.001291,172.217.194.0-255,2902,178556,76,202996
8250,0.001295,172.31.40.0-255,66,178622,76,202996
8251,0.001301,172.217.194.0-255,5738,184360,76,202996
8252,0.001303,172.31.40.0-255,66,184426,76,202996
8253,0.001342,172.31.40.0-255,66,184492,76,202996
8254,0.001352,172.31.40.0-255,66,184558,76,202996
8255,0.001381,172.217.194.0-255,1484,186042,76,202996
8256,0.001386,172.217.194.0-255,2902,188944,76,202996
8257,0.00139,172.31.40.0-255,66,189010,76,202996
8258,0.00141,172.217.194.0-255,5738,194748,76,202996
8259,0.001414,172.31.40.0-255,66,194814,76,202996
8260,0.001464,172.31.40.0-255,66,194880,76,202996
8261,0.001475,172.31.40.0-255,66,194946,76,202996
8262,0.001484,172.217.194.0-255,1484,196430,76,202996
8263,0.001519,172.31.40.0-255,66,196496,76,202996
8264,0.001536,172.31.40.0-255,66,196562,76,202996
8265,0.001539,172.217.194.0-255,1484,198046,76,202996
8266,0.001582,172.31.40.0-255,66,198112,76,202996
8267,0.001629,172.31.40.0-255,66,198178,76,202996
8268,0.001632,172.217.194.0-255,105,198283,76,202996
8269,0.003335,172.31.40.0-255,66,198349,76,202996
8270,0.003361,172.31.40.0-255,105,198454,76,202996
8271,0.00582,172.217.194.0-255,66,198520,76,202996
8272,0.029204,172.31.40.0-255,172,198692,76,202996
8273,0.029234,172.31.40.0-255,1105,199797,76,202996
8274,0.029275,172.31.40.0-255,1514,201311,76,202996
8275,0.029295,172.31.40.0-255,1313,202624,76,202996
8276,0.030848,104.244.42.0-255,66,202690,76,202996
8277,0.030888,104.244.42.0-255,66,202756,76,202996
8278,0.030929,104.244.42.0-255,66,202822,76,202996
8279,0.031673,104.244.42.0-255,108,202930,76,202996
8280,0.031692,172.31.40.0-255,66,202996,76,202996
8281,0.0,74.125.68.0-255,153,153,76,348520
8282,2.4e-05,172.31.40.0-255,66,219,76,348520
8283,5.5e-05,74.125.68.0-255,1484,1703,76,348520
8284,6e-05,172.31.40.0-255,66,1769,76,348520
8285,6.7e-05,74.125.68.0-255,2902,4671,76,348520
8286,7e-05,172.31.40.0-255,66,4737,76,348520
8287,7.5e-05,74.125.68.0-255,2902,7639,76,348520
8288,7.8e-05,172.31.40.0-255,66,7705,76,348520
8289,8.4e-05,74.125.68.0-255,4320,12025,76,348520
8290,8.7e-05,172.31.40.0-255,66,12091,76,348520
8291,9.9e-05,172.31.40.0-255,66,12157,76,348520
8292,0.00013,172.31.40.0-255,66,12223,76,348520
8293,0.000237,74.125.68.0-255,1484,13707,76,348520
8294,0.00024,172.31.40.0-255,66,13773,76,348520
8295,0.000246,74.125.68.0-255,2902,16675,76,348520
8296,0.000248,172.31.40.0-255,66,16741,76,348520
8297,0.000255,74.125.68.0-255,5738,22479,76,348520
8298,0.000258,172.31.40.0-255,66,22545,76,348520
8299,0.000278,74.125.68.0-255,1484,24029,76,348520
8300,0.00028,172.31.40.0-255,66,24095,76,348520
8301,0.000284,74.125.68.0-255,2902,26997,76,348520
8302,0.000286,172.31.40.0-255,66,27063,76,348520
8303,0.000294,74.125.68.0-255,5379,32442,76,348520
8304,0.000296,172.31.40.0-255,66,32508,76,348520
8305,0.000325,74.125.68.0-255,5738,38246,76,348520
8306,0.000328,172.31.40.0-255,66,38312,76,348520
8307,0.000377,172.31.40.0-255,66,38378,76,348520
8308,0.000813,74.125.68.0-255,414,38792,76,348520
8309,0.000818,172.31.40.0-255,66,38858,76,348520
8310,0.000912,74.125.68.0-255,1484,40342,76,348520
8311,0.000916,74.125.68.0-255,1484,41826,76,348520
8312,0.000919,172.31.40.0-255,66,41892,76,348520
8313,0.000936,74.125.68.0-255,1484,43376,76,348520
8314,0.000941,74.125.68.0-255,4320,47696,76,348520
8315,0.000955,172.31.40.0-255,66,47762,76,348520
8316,0.000967,74.125.68.0-255,2902,50664,76,348520
8317,0.000978,74.125.68.0-255,1484,52148,76,348520
8318,0.000986,74.125.68.0-255,1484,53632,76,348520
8319,0.000989,172.31.40.0-255,66,53698,76,348520
8320,0.001018,74.125.68.0-255,2543,56241,76,348520
8321,0.001031,172.31.40.0-255,66,56307,76,348520
8322,0.001228,74.125.68.0-255,1484,57791,76,348520
8323,0.001249,74.125.68.0-255,1484,59275,76,348520
8324,0.001252,172.31.40.0-255,66,59341,76,348520
8325,0.001289,74.125.68.0-255,2902,62243,76,348520
8326,0.001312,74.125.68.0-255,4320,66563,76,348520
8327,0.001319,172.31.40.0-255,66,66629,76,348520
8328,0.001353,74.125.68.0-255,1484,68113,76,348520
8329,0.001369,74.125.68.0-255,1484,69597,76,348520
8330,0.001375,172.31.40.0-255,66,69663,76,348520
8331,0.001396,74.125.68.0-255,3961,73624,76,348520
8332,0.0014,172.31.40.0-255,66,73690,76,348520
8333,0.001529,74.125.68.0-255,328,74018,76,348520
8334,0.001712,74.125.68.0-255,1484,75502,76,348520
8335,0.001717,172.31.40.0-255,66,75568,76,348520
8336,0.001749,74.125.68.0-255,1484,77052,76,348520
8337,0.001762,74.125.68.0-255,2902,79954,76,348520
8338,0.001777,74.125.68.0-255,4320,84274,76,348520
8339,0.001786,74.125.68.0-255,1484,85758,76,348520
8340,0.001798,74.125.68.0-255,2902,88660,76,348520
8341,0.001813,74.125.68.0-255,1484,90144,76,348520
8342,0.001829,74.125.68.0-255,2902,93046,76,348520
8343,0.001841,74.125.68.0-255,2902,95948,76,348520
8344,0.001855,74.125.68.0-255,1484,97432,76,348520
8345,0.001874,74.125.68.0-255,7156,104588,76,348520
8346,0.001914,74.125.68.0-255,2902,107490,76,348520
8347,0.001927,74.125.68.0-255,766,108256,76,348520
8348,0.002127,74.125.68.0-255,1484,109740,76,348520
8349,0.002136,74.125.68.0-255,2902,112642,76,348520
8350,0.002159,74.125.68.0-255,5738,118380,76,348520
8351,0.002189,74.125.68.0-255,7156,125536,76,348520
8352,0.002217,74.125.68.0-255,4320,129856,76,348520
8353,0.002232,74.125.68.0-255,4320,134176,76,348520
8354,0.002277,74.125.68.0-255,4320,138496,76,348520
8355,0.002295,74.125.68.0-255,3602,142098,76,348520
8356,0.005124,172.31.40.0-255,66,142164,76,348520
8357,0.007808,74.125.68.0-255,5738,147902,76,348520
8358,0.007815,172.31.40.0-255,66,147968,76,348520
8359,0.010494,74.125.68.0-255,5738,153706,76,348520
8360,0.010502,172.31.40.0-255,66,153772,76,348520
8361,0.013202,74.125.68.0-255,5738,159510,76,348520
8362,0.013213,172.31.40.0-255,66,159576,76,348520
8363,0.015898,74.125.68.0-255,5738,165314,76,348520
8364,0.015908,172.31.40.0-255,66,165380,76,348520
8365,0.018586,74.125.68.0-255,5738,171118,76,348520
8366,0.018595,172.31.40.0-255,66,171184,76,348520
8367,0.021296,74.125.68.0-255,5738,176922,76,348520
8368,0.021305,172.31.40.0-255,66,176988,76,348520
8369,0.023982,74.125.68.0-255,5738,182726,76,348520
8370,0.02399,172.31.40.0-255,66,182792,76,348520
8371,0.026687,74.125.68.0-255,5738,188530,76,348520
8372,0.026695,172.31.40.0-255,66,188596,76,348520
8373,0.028507,172.31.40.0-255,176,188772,76,348520
8374,0.02854,172.31.40.0-255,1109,189881,76,348520
8375,0.028602,172.31.40.0-255,1514,191395,76,348520
8376,0.028604,172.31.40.0-255,1307,192702,76,348520
8377,0.029373,74.125.68.0-255,5738,198440,76,348520
8378,0.029381,172.31.40.0-255,66,198506,76,348520
8379,0.030218,104.244.42.0-255,66,198572,76,348520
8380,0.030261,104.244.42.0-255,66,198638,76,348520
8381,0.030283,104.244.42.0-255,66,198704,76,348520
8382,0.032059,74.125.68.0-255,5738,204442,76,348520
8383,0.032064,172.31.40.0-255,66,204508,76,348520
8384,0.03474,74.125.68.0-255,5738,210246,76,348520
8385,0.034746,172.31.40.0-255,66,210312,76,348520
8386,0.03743,74.125.68.0-255,5738,216050,76,348520
8387,0.037436,172.31.40.0-255,66,216116,76,348520
8388,0.040164,74.125.68.0-255,5738,221854,76,348520
8389,0.040173,172.31.40.0-255,66,221920,76,348520
8390,0.042849,74.125.68.0-255,5738,227658,76,348520
8391,0.042855,172.31.40.0-255,66,227724,76,348520
8392,0.04554,74.125.68.0-255,5738,233462,76,348520
8393,0.045546,172.31.40.0-255,66,233528,76,348520
8394,0.048231,74.125.68.0-255,5738,239266,76,348520
8395,0.048236,172.31.40.0-255,66,239332,76,348520
8396,0.050924,74.125.68.0-255,5738,245070,76,348520
8397,0.050931,172.31.40.0-255,66,245136,76,348520
8398,0.053629,74.125.68.0-255,5738,250874,76,348520
8399,0.053636,172.31.40.0-255,66,250940,76,348520
8400,0.056406,74.125.68.0-255,5738,256678,76,348520
8401,0.056414,172.31.40.0-255,66,256744,76,348520
8402,0.059096,74.125.68.0-255,4320,261064,76,348520
8403,0.059101,172.31.40.0-255,66,261130,76,348520
8404,0.05912,74.125.68.0-255,1484,262614,76,348520
8405,0.061793,74.125.68.0-255,4320,266934,76,348520
8406,0.0618,172.31.40.0-255,66,267000,76,348520
8407,0.064499,74.125.68.0-255,5738,272738,76,348520
8408,0.064549,172.31.40.0-255,66,272804,76,348520
8409,0.067224,74.125.68.0-255,5738,278542,76,348520
8410,0.067229,172.31.40.0-255,66,278608,76,348520
8411,0.069939,74.125.68.0-255,5738,284346,76,348520
8412,0.069946,172.31.40.0-255,66,284412,76,348520
8413,0.072633,74.125.68.0-255,5738,290150,76,348520
8414,0.072641,172.31.40.0-255,66,290216,76,348520
8415,0.075334,74.125.68.0-255,5738,295954,76,348520
8416,0.07534,172.31.40.0-255,66,296020,76,348520
8417,0.078063,74.125.68.0-255,5738,301758,76,348520
8418,0.07807,172.31.40.0-255,66,301824,76,348520
8419,0.080752,74.125.68.0-255,5738,307562,76,348520
8420,0.080759,172.31.40.0-255,66,307628,76,348520
8421,0.083442,74.125.68.0-255,5738,313366,76,348520
8422,0.083448,172.31.40.0-255,66,313432,76,348520
8423,0.086132,74.125.68.0-255,5738,319170,76,348520
8424,0.086139,172.31.40.0-255,66,319236,76,348520
8425,0.08882,74.125.68.0-255,5738,324974,76,348520
8426,0.088827,172.31.40.0-255,66,325040,76,348520
8427,0.09152,74.125.68.0-255,5738,330778,76,348520
8428,0.091527,172.31.40.0-255,66,330844,76,348520
8429,0.094212,74.125.68.0-255,5738,336582,76,348520
8430,0.094219,172.31.40.0-255,66,336648,76,348520
8431,0.096929,74.125.68.0-255,2902,339550,76,348520
8432,0.096935,172.31.40.0-255,66,339616,76,348520
8433,0.096955,74.125.68.0-255,2902,342518,76,348520
8434,0.096978,172.31.40.0-255,66,342584,76,348520
8435,0.099614,74.125.68.0-255,2902,345486,76,348520
8436,0.09962,172.31.40.0-255,66,345552,76,348520
8437,0.09964,74.125.68.0-255,2902,348454,76,348520
8438,0.099666,172.31.40.0-255,66,348520,76,348520
8439,0.0,172.253.118.0-255,297,297,76,268523
8440,1.6e-05,172.31.40.0-255,66,363,76,268523
8441,2.1e-05,172.253.118.0-255,1484,1847,76,268523
8442,2.5e-05,172.31.40.0-255,66,1913,76,268523
8443,3.7e-05,172.253.118.0-255,4320,6233,76,268523
8444,4e-05,172.31.40.0-255,66,6299,76,268523
8445,0.000135,172.253.118.0-255,4320,10619,76,268523
8446,0.000139,172.31.40.0-255,66,10685,76,268523
8447,0.000244,172.253.118.0-255,3285,13970,76,268523
8448,0.000248,172.31.40.0-255,66,14036,76,268523
8449,0.000324,172.253.118.0-255,1484,15520,76,268523
8450,0.000328,172.31.40.0-255,66,15586,76,268523
8451,0.000362,172.31.40.0-255,66,15652,76,268523
8452,0.000566,172.253.118.0-255,6797,22449,76,268523
8453,0.00057,172.31.40.0-255,66,22515,76,268523
8454,0.000731,172.253.118.0-255,7156,29671,76,268523
8455,0.000736,172.31.40.0-255,66,29737,76,268523
8456,0.000915,172.31.40.0-255,66,29803,76,268523
8457,0.000941,172.253.118.0-255,1125,30928,76,268523
8458,0.000943,172.31.40.0-255,66,30994,76,268523
8459,0.001128,172.253.118.0-255,5738,36732,76,268523
8460,0.001133,172.31.40.0-255,66,36798,76,268523
8461,0.00127,172.253.118.0-255,7156,43954,76,268523
8462,0.001276,172.31.40.0-255,66,44020,76,268523
8463,0.001431,172.253.118.0-255,5738,49758,76,268523
8464,0.001437,172.31.40.0-255,66,49824,76,268523
8465,0.001463,172.31.40.0-255,66,49890,76,268523
8466,0.001821,172.31.40.0-255,66,49956,76,268523
8467,0.002297,172.253.118.0-255,1125,51081,76,268523
8468,0.002949,172.253.118.0-255,766,51847,76,268523
8469,0.003173,172.31.40.0-255,66,51913,76,268523
8470,0.003213,172.31.40.0-255,66,51979,76,268523
8471,0.005811,172.253.118.0-255,5738,57717,76,268523
8472,0.005817,172.31.40.0-255,66,57783,76,268523
8473,0.008407,172.253.118.0-255,5738,63521,76,268523
8474,0.008414,172.31.40.0-255,66,63587,76,268523
8475,0.011049,172.253.118.0-255,5738,69325,76,268523
8476,0.011056,172.31.40.0-255,66,69391,76,268523
8477,0.013669,172.253.118.0-255,5738,75129,76,268523
8478,0.013678,172.31.40.0-255,66,75195,76,268523
8479,0.016279,172.253.118.0-255,5738,80933,76,268523
8480,0.016289,172.31.40.0-255,66,80999,76,268523
8481,0.019136,172.253.118.0-255,5738,86737,76,268523
8482,0.019146,172.31.40.0-255,66,86803,76,268523
8483,0.021735,172.253.118.0-255,5738,92541,76,268523
8484,0.021743,172.31.40.0-255,66,92607,76,268523
8485,0.024359,172.253.118.0-255,5738,98345,76,268523
8486,0.024369,172.31.40.0-255,66,98411,76,268523
8487,0.026974,172.253.118.0-255,5738,104149,76,268523
8488,0.02698,172.31.40.0-255,66,104215,76,268523
8489,0.028078,172.31.40.0-255,172,104387,76,268523
8490,0.028106,172.31.40.0-255,1107,105494,76,268523
8491,0.028179,172.31.40.0-255,1514,107008,76,268523
8492,0.028181,172.31.40.0-255,1309,108317,76,268523
8493,0.029616,104.244.42.0-255,66,108383,76,268523
8494,0.029686,172.253.118.0-255,5738,114121,76,268523
8495,0.029691,172.31.40.0-255,66,114187,76,268523
8496,0.029721,104.244.42.0-255,66,114253,76,268523
8497,0.029751,104.244.42.0-255,66,114319,76,268523
8498,0.032298,172.253.118.0-255,5738,120057,76,268523
8499,0.032304,172.31.40.0-255,66,120123,76,268523
8500,0.034881,172.253.118.0-255,2902,123025,76,268523
8501,0.034887,172.31.40.0-255,66,123091,76,268523
8502,0.034916,172.253.118.0-255,2902,125993,76,268523
8503,0.034929,172.31.40.0-255,66,126059,76,268523
8504,0.037485,172.253.118.0-255,2902,128961,76,268523
8505,0.037491,172.31.40.0-255,66,129027,76,268523
8506,0.03752,172.253.118.0-255,2902,131929,76,268523
8507,0.03755,172.31.40.0-255,66,131995,76,268523
8508,0.040103,172.253.118.0-255,2902,134897,76,268523
8509,0.04011,172.31.40.0-255,66,134963,76,268523
8510,0.04016,172.253.118.0-255,2902,137865,76,268523
8511,0.040167,172.31.40.0-255,66,137931,76,268523
8512,0.04271,172.253.118.0-255,2902,140833,76,268523
8513,0.042717,172.31.40.0-255,66,140899,76,268523
8514,0.042772,172.253.118.0-255,2902,143801,76,268523
8515,0.043074,172.31.40.0-255,66,143867,76,268523
8516,0.045314,172.253.118.0-255,2902,146769,76,268523
8517,0.045321,172.31.40.0-255,66,146835,76,268523
8518,0.045668,172.253.118.0-255,2902,149737,76,268523
8519,0.045674,172.31.40.0-255,66,149803,76,268523
8520,0.047912,172.253.118.0-255,2902,152705,76,268523
8521,0.047918,172.31.40.0-255,66,152771,76,268523
8522,0.048269,172.253.118.0-255,2902,155673,76,268523
8523,0.048274,172.31.40.0-255,66,155739,76,268523
8524,0.050516,172.253.118.0-255,2902,158641,76,268523
8525,0.050523,172.31.40.0-255,66,158707,76,268523
8526,0.050864,172.253.118.0-255,2902,161609,76,268523
8527,0.05087,172.31.40.0-255,66,161675,76,268523
8528,0.053125,172.253.118.0-255,2902,164577,76,268523
8529,0.053132,172.31.40.0-255,66,164643,76,268523
8530,0.053471,172.253.118.0-255,2902,167545,76,268523
8531,0.053478,172.31.40.0-255,66,167611,76,268523
8532,0.055733,172.253.118.0-255,2902,170513,76,268523
8533,0.05574,172.31.40.0-255,66,170579,76,268523
8534,0.056071,172.253.118.0-255,2902,173481,76,268523
8535,0.056078,172.31.40.0-255,66,173547,76,268523
8536,0.058338,172.253.118.0-255,2902,176449,76,268523
8537,0.058346,172.31.40.0-255,66,176515,76,268523
8538,0.058665,172.253.118.0-255,2902,179417,76,268523
8539,0.058671,172.31.40.0-255,66,179483,76,268523
8540,0.060962,172.253.118.0-255,2902,182385,76,268523
8541,0.060968,172.31.40.0-255,66,182451,76,268523
8542,0.061269,172.253.118.0-255,2902,185353,76,268523
8543,0.061275,172.31.40.0-255,66,185419,76,268523
8544,0.063573,172.253.118.0-255,2902,188321,76,268523
8545,0.063578,172.31.40.0-255,66,188387,76,268523
8546,0.063869,172.253.118.0-255,2902,191289,76,268523
8547,0.063875,172.31.40.0-255,66,191355,76,268523
8548,0.066169,172.253.118.0-255,2902,194257,76,268523
8549,0.066175,172.31.40.0-255,66,194323,76,268523
8550,0.066457,172.253.118.0-255,2902,197225,76,268523
8551,0.066463,172.31.40.0-255,66,197291,76,268523
8552,0.068791,172.253.118.0-255,2902,200193,76,268523
8553,0.068796,172.31.40.0-255,66,200259,76,268523
8554,0.069052,172.253.118.0-255,2902,203161,76,268523
8555,0.069058,172.31.40.0-255,66,203227,76,268523
8556,0.071429,172.253.118.0-255,2902,206129,76,268523
8557,0.071436,172.31.40.0-255,66,206195,76,268523
8558,0.071645,172.253.118.0-255,2902,209097,76,268523
8559,0.071651,172.31.40.0-255,66,209163,76,268523
8560,0.074027,172.253.118.0-255,2902,212065,76,268523
8561,0.074034,172.31.40.0-255,66,212131,76,268523
8562,0.074258,172.253.118.0-255,2902,215033,76,268523
8563,0.074751,172.31.40.0-255,66,215099,76,268523
8564,0.076646,172.253.118.0-255,2902,218001,76,268523
8565,0.076652,172.31.40.0-255,66,218067,76,268523
8566,0.077341,172.253.118.0-255,2902,220969,76,268523
8567,0.077346,172.31.40.0-255,66,221035,76,268523
8568,0.07926,172.253.118.0-255,2902,223937,76,268523
8569,0.079266,172.31.40.0-255,66,224003,76,268523
8570,0.07995,172.253.118.0-255,2902,226905,76,268523
8571,0.079955,172.31.40.0-255,66,226971,76,268523
8572,0.081861,172.253.118.0-255,2902,229873,76,268523
8573,0.081866,172.31.40.0-255,66,229939,76,268523
8574,0.082557,172.253.118.0-255,2902,232841,76,268523
8575,0.082563,172.31.40.0-255,66,232907,76,268523
8576,0.084452,172.253.118.0-255,2902,235809,76,268523
8577,0.084458,172.31.40.0-255,66,235875,76,268523
8578,0.085153,172.253.118.0-255,2902,238777,76,268523
8579,0.085953,172.31.40.0-255,66,238843,76,268523
8580,0.087057,172.253.118.0-255,2902,241745,76,268523
8581,0.087063,172.31.40.0-255,66,241811,76,268523
8582,0.088563,172.253.118.0-255,2902,244713,76,268523
8583,0.088571,172.31.40.0-255,66,244779,76,268523
8584,0.089649,172.253.118.0-255,2902,247681,76,268523
8585,0.089656,172.31.40.0-255,66,247747,76,268523
8586,0.091167,172.253.118.0-255,2902,250649,76,268523
8587,0.091173,172.31.40.0-255,66,250715,76,268523
8588,0.092242,172.253.118.0-255,2902,253617,76,268523
8589,0.092248,172.31.40.0-255,66,253683,76,268523
8590,0.093787,172.253.118.0-255,2902,256585,76,268523
8591,0.093794,172.31.40.0-255,66,256651,76,268523
8592,0.09483,172.253.118.0-255,2902,259553,76,268523
8593,0.094835,172.31.40.0-255,66,259619,76,268523
8594,0.096391,172.253.118.0-255,2902,262521,76,268523
8595,0.096397,172.31.40.0-255,66,262587,76,268523
8596,0.097431,172.253.118.0-255,2902,265489,76,268523
8597,0.097437,172.31.40.0-255,66,265555,76,268523
8598,0.098996,172.253.118.0-255,2902,268457,76,268523
8599,0.099001,172.31.40.0-255,66,268523,76,268523
8600,0.0,74.125.200.0-255,156,156,76,347564
8601,2.5e-05,172.31.40.0-255,66,222,76,347564
8602,3.2e-05,74.125.200.0-255,1484,1706,76,347564
8603,3.7e-05,172.31.40.0-255,66,1772,76,347564
8604,4.3e-05,74.125.200.0-255,2902,4674,76,347564
8605,4.6e-05,172.31.40.0-255,66,4740,76,347564
8606,5.3e-05,74.125.200.0-255,5738,10478,76,347564
8607,5.6e-05,172.31.40.0-255,66,10544,76,347564
8608,6e-05,74.125.200.0-255,1484,12028,76,347564
8609,6.2e-05,172.31.40.0-255,66,12094,76,347564
8610,8.2e-05,74.125.200.0-255,2037,14131,76,347564
8611,8.5e-05,172.31.40.0-255,66,14197,76,347564
8612,0.000204,74.125.200.0-255,1484,15681,76,347564
8613,0.00021,172.31.40.0-255,66,15747,76,347564
8614,0.000214,74.125.200.0-255,1484,17231,76,347564
8615,0.000216,172.31.40.0-255,66,17297,76,347564
8616,0.000219,74.125.200.0-255,1484,18781,76,347564
8617,0.000221,172.31.40.0-255,66,18847,76,347564
8618,0.000245,74.125.200.0-255,1484,20331,76,347564
8619,0.000247,172.31.40.0-255,66,20397,76,347564
8620,0.00025,74.125.200.0-255,1484,21881,76,347564
8621,0.000253,172.31.40.0-255,66,21947,76,347564
8622,0.00027,74.125.200.0-255,4320,26267,76,347564
8623,0.000272,172.31.40.0-255,66,26333,76,347564
8624,0.000278,74.125.200.0-255,4320,30653,76,347564
8625,0.00028,172.31.40.0-255,66,30719,76,347564
8626,0.000303,74.125.200.0-255,1125,31844,76,347564
8627,0.000305,172.31.40.0-255,66,31910,76,347564
8628,0.00048,74.125.200.0-255,1484,33394,76,347564
8629,0.000485,172.31.40.0-255,66,33460,76,347564
8630,0.000489,74.125.200.0-255,1484,34944,76,347564
8631,0.000491,172.31.40.0-255,66,35010,76,347564
8632,0.000505,74.125.200.0-255,1484,36494,76,347564
8633,0.000509,74.125.200.0-255,1484,37978,76,347564
8634,0.000511,172.31.40.0-255,66,38044,76,347564
8635,0.000533,74.125.200.0-255,4320,42364,76,347564
8636,0.000536,172.31.40.0-255,66,42430,76,347564
8637,0.00054,74.125.200.0-255,2902,45332,76,347564
8638,0.000542,172.31.40.0-255,66,45398,76,347564
8639,0.000548,74.125.200.0-255,3961,49359,76,347564
8640,0.00055,172.31.40.0-255,66,49425,76,347564
8641,0.000568,74.125.200.0-255,1484,50909,76,347564
8642,0.000596,74.125.200.0-255,7156,58065,76,347564
8643,0.000599,172.31.40.0-255,66,58131,76,347564
8644,0.000635,74.125.200.0-255,5738,63869,76,347564
8645,0.000638,172.31.40.0-255,66,63935,76,347564
8646,0.000659,74.125.200.0-255,2543,66478,76,347564
8647,0.000662,172.31.40.0-255,66,66544,76,347564
8648,0.000665,74.125.200.0-255,411,66955,76,347564
8649,0.000697,74.125.200.0-255,331,67286,76,347564
8650,0.000938,74.125.200.0-255,1484,68770,76,347564
8651,0.000943,172.31.40.0-255,66,68836,76,347564
8652,0.000948,74.125.200.0-255,1484,70320,76,347564
8653,0.000961,74.125.200.0-255,1484,71804,76,347564
8654,0.000963,172.31.40.0-255,66,71870,76,347564
8655,0.000982,74.125.200.0-255,5738,77608,76,347564
8656,0.000985,172.31.40.0-255,66,77674,76,347564
8657,0.001007,74.125.200.0-255,2902,80576,76,347564
8658,0.001009,172.31.40.0-255,66,80642,76,347564
8659,0.001021,74.125.200.0-255,1484,82126,76,347564
8660,0.00104,74.125.200.0-255,2902,85028,76,347564
8661,0.001043,172.31.40.0-255,66,85094,76,347564
8662,0.001057,172.31.40.0-255,66,85160,76,347564
8663,0.001079,74.125.200.0-255,1484,86644,76,347564
8664,0.001138,74.125.200.0-255,2184,88828,76,347564
8665,0.001143,172.31.40.0-255,66,88894,76,347564
8666,0.001243,74.125.200.0-255,1484,90378,76,347564
8667,0.001259,74.125.200.0-255,2902,93280,76,347564
8668,0.001263,172.31.40.0-255,66,93346,76,347564
8669,0.001285,74.125.200.0-255,5738,99084,76,347564
8670,0.001288,172.31.40.0-255,66,99150,76,347564
8671,0.001299,74.125.200.0-255,1484,100634,76,347564
8672,0.001313,74.125.200.0-255,1484,102118,76,347564
8673,0.001315,172.31.40.0-255,66,102184,76,347564
8674,0.001334,74.125.200.0-255,1484,103668,76,347564
8675,0.001352,74.125.200.0-255,2902,106570,76,347564
8676,0.001356,172.31.40.0-255,66,106636,76,347564
8677,0.001405,172.31.40.0-255,66,106702,76,347564
8678,0.001434,74.125.200.0-255,1484,108186,76,347564
8679,0.001446,74.125.200.0-255,1484,109670,76,347564
8680,0.001449,172.31.40.0-255,66,109736,76,347564
8681,0.001465,74.125.200.0-255,5020,114756,76,347564
8682,0.001467,172.31.40.0-255,66,114822,76,347564
8683,0.002548,74.125.200.0-255,1484,116306,76,347564
8684,0.002559,74.125.200.0-255,2902,119208,76,347564
8685,0.002564,172.31.40.0-255,66,119274,76,347564
8686,0.002571,74.125.200.0-255,2902,122176,76,347564
8687,0.002573,172.31.40.0-255,66,122242,76,347564
8688,0.002588,74.125.200.0-255,2902,125144,76,347564
8689,0.002591,172.31.40.0-255,66,125210,76,347564
8690,0.002595,74.125.200.0-255,2902,128112,76,347564
8691,0.002597,172.31.40.0-255,66,128178,76,347564
8692,0.002611,74.125.200.0-255,5738,133916,76,347564
8693,0.002614,172.31.40.0-255,66,133982,76,347564
8694,0.002643,74.125.200.0-255,1484,135466,76,347564
8695,0.00267,172.31.40.0-255,66,135532,76,347564
8696,0.002705,74.125.200.0-255,4320,139852,76,347564
8697,0.002707,172.31.40.0-255,66,139918,76,347564
8698,0.00271,74.125.200.0-255,766,140684,76,347564
8699,0.002746,74.125.200.0-255,2902,143586,76,347564
8700,0.002748,172.31.40.0-255,66,143652,76,347564
8701,0.002751,74.125.200.0-255,1484,145136,76,347564
8702,0.005462,74.125.200.0-255,4320,149456,76,347564
8703,0.005465,172.31.40.0-255,66,149522,76,347564
8704,0.008191,74.125.200.0-255,5738,155260,76,347564
8705,0.008198,172.31.40.0-255,66,155326,76,347564
8706,0.010934,74.125.200.0-255,5738,161064,76,347564
8707,0.010943,172.31.40.0-255,66,161130,76,347564
8708,0.013709,74.125.200.0-255,5738,166868,76,347564
8709,0.013719,172.31.40.0-255,66,166934,76,347564
8710,0.016467,74.125.200.0-255,5738,172672,76,347564
8711,0.016479,172.31.40.0-255,66,172738,76,347564
8712,0.019219,74.125.200.0-255,5738,178476,76,347564
8713,0.019227,172.31.40.0-255,66,178542,76,347564
8714,0.021957,74.125.200.0-255,5738,184280,76,347564
8715,0.021966,172.31.40.0-255,66,184346,76,347564
8716,0.024691,74.125.200.0-255,5738,190084,76,347564
8717,0.0247,172.31.40.0-255,66,190150,76,347564
8718,0.026224,172.31.40.0-255,172,190322,76,347564
8719,0.026277,172.31.40.0-255,1109,191431,76,347564
8720,0.026332,172.31.40.0-255,1514,192945,76,347564
8721,0.026334,172.31.40.0-255,1307,194252,76,347564
8722,0.027432,74.125.200.0-255,5738,199990,76,347564
8723,0.027439,172.31.40.0-255,66,200056,76,347564
8724,0.027883,104.244.42.0-255,66,200122,76,347564
8725,0.02795,104.244.42.0-255,66,200188,76,347564
8726,0.028046,104.244.42.0-255,66,200254,76,347564
8727,0.030162,74.125.200.0-255,5738,205992,76,347564
8728,0.030169,172.31.40.0-255,66,206058,76,347564
8729,0.032892,74.125.200.0-255,5738,211796,76,347564
8730,0.032904,172.31.40.0-255,66,211862,76,347564
8731,0.035643,74.125.200.0-255,5738,217600,76,347564
8732,0.035649,172.31.40.0-255,66,217666,76,347564
8733,0.03841,74.125.200.0-255,5738,223404,76,347564
8734,0.038417,172.31.40.0-255,66,223470,76,347564
8735,0.041191,74.125.200.0-255,5738,229208,76,347564
8736,0.041201,172.31.40.0-255,66,229274,76,347564
8737,0.043926,74.125.200.0-255,2902,232176,76,347564
8738,0.043934,172.31.40.0-255,66,232242,76,347564
8739,0.043956,74.125.200.0-255,2902,235144,76,347564
8740,0.043959,172.31.40.0-255,66,235210,76,347564
8741,0.046655,74.125.200.0-255,2902,238112,76,347564
8742,0.046661,172.31.40.0-255,66,238178,76,347564
8743,0.046683,74.125.200.0-255,2902,241080,76,347564
8744,0.046686,172.31.40.0-255,66,241146,76,347564
8745,0.049385,74.125.200.0-255,2902,244048,76,347564
8746,0.049392,172.31.40.0-255,66,244114,76,347564
8747,0.049418,74.125.200.0-255,2902,247016,76,347564
8748,0.049421,172.31.40.0-255,66,247082,76,347564
8749,0.052141,74.125.200.0-255,5738,252820,76,347564
8750,0.052149,172.31.40.0-255,66,252886,76,347564
8751,0.054889,74.125.200.0-255,5738,258624,76,347564
8752,0.054897,172.31.40.0-255,66,258690,76,347564
8753,0.057635,74.125.200.0-255,5738,264428,76,347564
8754,0.057641,172.31.40.0-255,66,264494,76,347564
8755,0.060381,74.125.200.0-255,5738,270232,76,347564
8756,0.060388,172.31.40.0-255,66,270298,76,347564
8757,0.063139,74.125.200.0-255,5738,276036,76,347564
8758,0.063145,172.31.40.0-255,66,276102,76,347564
8759,0.065912,74.125.200.0-255,5738,281840,76,347564
8760,0.06592,172.31.40.0-255,66,281906,76,347564
8761,0.068689,74.125.200.0-255,5738,287644,76,347564
8762,0.068701,172.31.40.0-255,66,287710,76,347564
8763,0.071436,74.125.200.0-255,5738,293448,76,347564
8764,0.071443,172.31.40.0-255,66,293514,76,347564
8765,0.074155,74.125.200.0-255,4320,297834,76,347564
8766,0.074161,172.31.40.0-255,66,297900,76,347564
8767,0.074188,74.125.200.0-255,1484,299384,76,347564
8768,0.076866,74.125.200.0-255,2902,302286,76,347564
8769,0.076871,172.31.40.0-255,66,302352,76,347564
8770,0.076915,74.125.200.0-255,1484,303836,76,347564
8771,0.079598,74.125.200.0-255,4320,308156,76,347564
8772,0.079604,172.31.40.0-255,66,308222,76,347564
8773,0.082329,74.125.200.0-255,4320,312542,76,347564
8774,0.082336,172.31.40.0-255,66,312608,76,347564
8775,0.082353,74.125.200.0-255,1484,314092,76,347564
8776,0.085047,74.125.200.0-255,4320,318412,76,347564
8777,0.085054,172.31.40.0-255,66,318478,76,347564
8778,0.087775,74.125.200.0-255,5738,324216,76,347564
8779,0.087781,172.31.40.0-255,66,324282,76,347564
8780,0.09056,74.125.200.0-255,1484,325766,76,347564
8781,0.090587,74.125.200.0-255,4320,330086,76,347564
8782,0.090591,172.31.40.0-255,66,330152,76,347564
8783,0.093331,74.125.200.0-255,5738,335890,76,347564
8784,0.093336,172.31.40.0-255,66,335956,76,347564
8785,0.096053,74.125.200.0-255,5738,341694,76,347564
8786,0.096057,172.31.40.0-255,66,341760,76,347564
8787,0.09889,74.125.200.0-255,5738,347498,76,347564
8788,0.098901,172.31.40.0-255,66,347564,76,347564
8789,0.0,74.125.68.0-255,152,152,76,376931
8790,2e-05,172.31.40.0-255,66,218,76,376931
8791,2.7e-05,74.125.68.0-255,1484,1702,76,376931
8792,3.2e-05,172.31.40.0-255,66,1768,76,376931
8793,4.7e-05,74.125.68.0-255,2902,4670,76,376931
8794,5e-05,172.31.40.0-255,66,4736,76,376931
8795,5.8e-05,74.125.68.0-255,7156,11892,76,376931
8796,6e-05,172.31.40.0-255,66,11958,76,376931
8797,6.5e-05,74.125.68.0-255,2065,14023,76,376931
8798,6.7e-05,172.31.40.0-255,66,14089,76,376931
8799,0.00019,74.125.68.0-255,1484,15573,76,376931
8800,0.000194,172.31.40.0-255,66,15639,76,376931
8801,0.0002,74.125.68.0-255,2902,18541,76,376931
8802,0.000202,172.31.40.0-255,66,18607,76,376931
8803,0.000205,74.125.68.0-255,1484,20091,76,376931
8804,0.000213,172.31.40.0-255,66,20157,76,376931
8805,0.000246,74.125.68.0-255,5738,25895,76,376931
8806,0.000248,172.31.40.0-255,66,25961,76,376931
8807,0.000273,74.125.68.0-255,2902,28863,76,376931
8808,0.000276,172.31.40.0-255,66,28929,76,376931
8809,0.000318,74.125.68.0-255,2543,31472,76,376931
8810,0.000321,172.31.40.0-255,66,31538,76,376931
8811,0.000517,74.125.68.0-255,1484,33022,76,376931
8812,0.000524,172.31.40.0-255,66,33088,76,376931
8813,0.000529,74.125.68.0-255,1484,34572,76,376931
8814,0.000531,172.31.40.0-255,66,34638,76,376931
8815,0.000566,74.125.68.0-255,1484,36122,76,376931
8816,0.00057,172.31.40.0-255,66,36188,76,376931
8817,0.000576,74.125.68.0-255,5738,41926,76,376931
8818,0.000579,172.31.40.0-255,66,41992,76,376931
8819,0.000583,74.125.68.0-255,2902,44894,76,376931
8820,0.000586,172.31.40.0-255,66,44960,76,376931
8821,0.000591,74.125.68.0-255,3961,48921,76,376931
8822,0.000593,172.31.40.0-255,66,48987,76,376931
8823,0.000646,172.31.40.0-255,66,49053,76,376931
8824,0.000652,74.125.68.0-255,5738,54791,76,376931
8825,0.000655,172.31.40.0-255,66,54857,76,376931
8826,0.000687,74.125.68.0-255,2543,57400,76,376931
8827,0.00069,172.31.40.0-255,66,57466,76,376931
8828,0.000713,74.125.68.0-255,678,58144,76,376931
8829,0.000988,74.125.68.0-255,1484,59628,76,376931
8830,0.000993,172.31.40.0-255,66,59694,76,376931
8831,0.000997,74.125.68.0-255,1484,61178,76,376931
8832,0.001026,74.125.68.0-255,1484,62662,76,376931
8833,0.001029,172.31.40.0-255,66,62728,76,376931
8834,0.001035,74.125.68.0-255,4320,67048,76,376931
8835,0.001037,172.31.40.0-255,66,67114,76,376931
8836,0.001043,74.125.68.0-255,5738,72852,76,376931
8837,0.001045,172.31.40.0-255,66,72918,76,376931
8838,0.0011,74.125.68.0-255,5738,78656,76,376931
8839,0.001103,172.31.40.0-255,66,78722,76,376931
8840,0.001132,74.125.68.0-255,2902,81624,76,376931
8841,0.001135,172.31.40.0-255,66,81690,76,376931
8842,0.001147,172.31.40.0-255,66,81756,76,376931
8843,0.001149,74.125.68.0-255,766,82522,76,376931
8844,0.001366,74.125.68.0-255,1484,84006,76,376931
8845,0.00137,172.31.40.0-255,66,84072,76,376931
8846,0.001376,74.125.68.0-255,2902,86974,76,376931
8847,0.001378,172.31.40.0-255,66,87040,76,376931
8848,0.00142,74.125.68.0-255,5738,92778,76,376931
8849,0.001423,172.31.40.0-255,66,92844,76,376931
8850,0.001428,74.125.68.0-255,4320,97164,76,376931
8851,0.00143,172.31.40.0-255,66,97230,76,376931
8852,0.001465,74.125.68.0-255,5738,102968,76,376931
8853,0.001469,172.31.40.0-255,66,103034,76,376931
8854,0.001481,172.31.40.0-255,66,103100,76,376931
8855,0.001513,74.125.68.0-255,2184,105284,76,376931
8856,0.001516,172.31.40.0-255,66,105350,76,376931
8857,0.002138,74.125.68.0-255,1484,106834,76,376931
8858,0.003588,74.125.68.0-255,1484,108318,76,376931
8859,0.003595,172.31.40.0-255,66,108384,76,376931
8860,0.003627,74.125.68.0-255,2902,111286,76,376931
8861,0.00363,172.31.40.0-255,66,111352,76,376931
8862,0.005702,74.125.68.0-255,2902,114254,76,376931
8863,0.005708,172.31.40.0-255,66,114320,76,376931
8864,0.005752,74.125.68.0-255,2902,117222,76,376931
8865,0.005756,172.31.40.0-255,66,117288,76,376931
8866,0.00781,74.125.68.0-255,2902,120190,76,376931
8867,0.007817,172.31.40.0-255,66,120256,76,376931
8868,0.007856,74.125.68.0-255,2902,123158,76,376931
8869,0.007859,172.31.40.0-255,66,123224,76,376931
8870,0.009951,74.125.68.0-255,2902,126126,76,376931
8871,0.009959,172.31.40.0-255,66,126192,76,376931
8872,0.01,74.125.68.0-255,2902,129094,76,376931
8873,0.010005,172.31.40.0-255,66,129160,76,376931
8874,0.012088,74.125.68.0-255,2902,132062,76,376931
8875,0.012095,172.31.40.0-255,66,132128,76,376931
8876,0.012139,74.125.68.0-255,1484,133612,76,376931
8877,0.012152,74.125.68.0-255,1484,135096,76,376931
8878,0.012154,172.31.40.0-255,66,135162,76,376931
8879,0.014207,74.125.68.0-255,2902,138064,76,376931
8880,0.014214,172.31.40.0-255,66,138130,76,376931
8881,0.014275,74.125.68.0-255,2902,141032,76,376931
8882,0.014279,172.31.40.0-255,66,141098,76,376931
8883,0.01635,74.125.68.0-255,2902,144000,76,376931
8884,0.016362,172.31.40.0-255,66,144066,76,376931
8885,0.016397,74.125.68.0-255,2902,146968,76,376931
8886,0.0164,172.31.40.0-255,66,147034,76,376931
8887,0.018485,74.125.68.0-255,2902,149936,76,376931
8888,0.018495,172.31.40.0-255,66,150002,76,376931
8889,0.018528,74.125.68.0-255,2902,152904,76,376931
8890,0.01853,172.31.40.0-255,66,152970,76,376931
8891,0.020603,74.125.68.0-255,1484,154454,76,376931
8892,0.02063,74.125.68.0-255,4320,158774,76,376931
8893,0.020635,172.31.40.0-255,66,158840,76,376931
8894,0.022778,74.125.68.0-255,5738,164578,76,376931
8895,0.022786,172.31.40.0-255,66,164644,76,376931
8896,0.024907,74.125.68.0-255,5738,170382,76,376931
8897,0.024918,172.31.40.0-255,66,170448,76,376931
8898,0.027039,74.125.68.0-255,5738,176186,76,376931
8899,0.027052,172.31.40.0-255,66,176252,76,376931
8900,0.029185,74.125.68.0-255,5738,181990,76,376931
8901,0.029193,172.31.40.0-255,66,182056,76,376931
8902,0.029495,172.31.40.0-255,171,182227,76,376931
8903,0.029526,172.31.40.0-255,1131,183358,76,376931
8904,0.029583,172.31.40.0-255,1514,184872,76,376931
8905,0.029585,172.31.40.0-255,1285,186157,76,376931
8906,0.031211,104.244.42.0-255,66,186223,76,376931
8907,0.031242,104.244.42.0-255,66,186289,76,376931
8908,0.031264,104.244.42.0-255,66,186355,76,376931
8909,0.0313,74.125.68.0-255,2902,189257,76,376931
8910,0.031304,172.31.40.0-255,66,189323,76,376931
8911,0.031328,74.125.68.0-255,2902,192225,76,376931
8912,0.031331,172.31.40.0-255,66,192291,76,376931
8913,0.033411,74.125.68.0-255,2902,195193,76,376931
8914,0.033418,172.31.40.0-255,66,195259,76,376931
8915,0.033451,74.125.68.0-255,2902,198161,76,376931
8916,0.033454,172.31.40.0-255,66,198227,76,376931
8917,0.035538,74.125.68.0-255,2902,201129,76,376931
8918,0.035544,172.31.40.0-255,66,201195,76,376931
8919,0.03557,74.125.68.0-255,2902,204097,76,376931
8920,0.035573,172.31.40.0-255,66,204163,76,376931
8921,0.037697,74.125.68.0-255,5738,209901,76,376931
8922,0.037703,172.31.40.0-255,66,209967,76,376931
8923,0.039844,74.125.68.0-255,5738,215705,76,376931
8924,0.039851,172.31.40.0-255,66,215771,76,376931
8925,0.041975,74.125.68.0-255,4320,220091,76,376931
8926,0.041982,172.31.40.0-255,66,220157,76,376931
8927,0.042008,74.125.68.0-255,1484,221641,76,376931
8928,0.044115,74.125.68.0-255,4320,225961,76,376931
8929,0.044122,172.31.40.0-255,66,226027,76,376931
8930,0.046288,74.125.68.0-255,5738,231765,76,376931
8931,0.046295,172.31.40.0-255,66,231831,76,376931
8932,0.048459,74.125.68.0-255,5738,237569,76,376931
8933,0.048466,172.31.40.0-255,66,237635,76,376931
8934,0.050588,74.125.68.0-255,5738,243373,76,376931
8935,0.050595,172.31.40.0-255,66,243439,76,376931
8936,0.052716,74.125.68.0-255,5738,249177,76,376931
8937,0.052723,172.31.40.0-255,66,249243,76,376931
8938,0.054848,74.125.68.0-255,5738,254981,76,376931
8939,0.054854,172.31.40.0-255,66,255047,76,376931
8940,0.056991,74.125.68.0-255,5738,260785,76,376931
8941,0.056998,172.31.40.0-255,66,260851,76,376931
8942,0.059211,74.125.68.0-255,5738,266589,76,376931
8943,0.059218,172.31.40.0-255,66,266655,76,376931
8944,0.06134,74.125.68.0-255,5738,272393,76,376931
8945,0.061347,172.31.40.0-255,66,272459,76,376931
8946,0.063482,74.125.68.0-255,5738,278197,76,376931
8947,0.063488,172.31.40.0-255,66,278263,76,376931
8948,0.06561,74.125.68.0-255,5738,284001,76,376931
8949,0.065617,172.31.40.0-255,66,284067,76,376931
8950,0.067758,74.125.68.0-255,5738,289805,76,376931
8951,0.067764,172.31.40.0-255,66,289871,76,376931
8952,0.069883,74.125.68.0-255,5738,295609,76,376931
8953,0.06989,172.31.40.0-255,66,295675,76,376931
8954,0.072018,74.125.68.0-255,5738,301413,76,376931
8955,0.072025,172.31.40.0-255,66,301479,76,376931
8956,0.074148,74.125.68.0-255,5738,307217,76,376931
8957,0.074155,172.31.40.0-255,66,307283,76,376931
8958,0.076277,74.125.68.0-255,5738,313021,76,376931
8959,0.076285,172.31.40.0-255,66,313087,76,376931
8960,0.07841,74.125.68.0-255,5738,318825,76,376931
8961,0.078419,172.31.40.0-255,66,318891,76,376931
8962,0.080556,74.125.68.0-255,5738,324629,76,376931
8963,0.080563,172.31.40.0-255,66,324695,76,376931
8964,0.082674,74.125.68.0-255,5738,330433,76,376931
8965,0.08268,172.31.40.0-255,66,330499,76,376931
8966,0.084813,74.125.68.0-255,5738,336237,76,376931
8967,0.084819,172.31.40.0-255,66,336303,76,376931
8968,0.086961,74.125.68.0-255,5738,342041,76,376931
8969,0.086968,172.31.40.0-255,66,342107,76,376931
8970,0.08909,74.125.68.0-255,5738,347845,76,376931
8971,0.089098,172.31.40.0-255,66,347911,76,376931
8972,0.091231,74.125.68.0-255,5738,353649,76,376931
8973,0.091238,172.31.40.0-255,66,353715,76,376931
8974,0.093351,74.125.68.0-255,5738,359453,76,376931
8975,0.093358,172.31.40.0-255,66,359519,76,376931
8976,0.095485,74.125.68.0-255,5738,365257,76,376931
8977,0.095493,172.31.40.0-255,66,365323,76,376931
8978,0.097613,74.125.68.0-255,5738,371061,76,376931
8979,0.097619,172.31.40.0-255,66,371127,76,376931
8980,0.099754,74.125.68.0-255,5738,376865,76,376931
8981,0.099762,172.31.40.0-255,66,376931,76,376931
8982,0.0,74.125.200.0-255,151,151,76,302531
8983,2.4e-05,172.31.40.0-255,66,217,76,302531
8984,3.1e-05,74.125.200.0-255,1484,1701,76,302531
8985,3.6e-05,172.31.40.0-255,66,1767,76,302531
8986,7.2e-05,74.125.200.0-255,2902,4669,76,302531
8987,7.6e-05,172.31.40.0-255,66,4735,76,302531
8988,8.2e-05,74.125.200.0-255,2902,7637,76,302531
8989,8.4e-05,172.31.40.0-255,66,7703,76,302531
8990,9e-05,74.125.200.0-255,4320,12023,76,302531
8991,9.3e-05,172.31.40.0-255,66,12089,76,302531
8992,9.6e-05,74.125.200.0-255,1484,13573,76,302531
8993,9.8e-05,172.31.40.0-255,66,13639,76,302531
8994,0.00014,172.31.40.0-255,66,13705,76,302531
8995,0.000146,74.125.200.0-255,4320,18025,76,302531
8996,0.000148,172.31.40.0-255,66,18091,76,302531
8997,0.000152,74.125.200.0-255,1484,19575,76,302531
8998,0.000153,172.31.40.0-255,66,19641,76,302531
8999,0.000173,74.125.200.0-255,3961,23602,76,302531
9000,0.000176,172.31.40.0-255,66,23668,76,302531
9001,0.000237,74.125.200.0-255,1484,25152,76,302531
9002,0.000241,172.31.40.0-255,66,25218,76,302531
9003,0.000247,74.125.200.0-255,2902,28120,76,302531
9004,0.000249,172.31.40.0-255,66,28186,76,302531
9005,0.000252,74.125.200.0-255,1484,29670,76,302531
9006,0.000254,172.31.40.0-255,66,29736,76,302531
9007,0.000274,74.125.200.0-255,2902,32638,76,302531
9008,0.000277,172.31.40.0-255,66,32704,76,302531
9009,0.000289,74.125.200.0-255,1484,34188,76,302531
9010,0.000291,172.31.40.0-255,66,34254,76,302531
9011,0.000308,74.125.200.0-255,2902,37156,76,302531
9012,0.00031,172.31.40.0-255,66,37222,76,302531
9013,0.000332,74.125.200.0-255,1484,38706,76,302531
9014,0.000342,74.125.200.0-255,6797,45503,76,302531
9015,0.000344,172.31.40.0-255,66,45569,76,302531
9016,0.000352,74.125.200.0-255,7156,52725,76,302531
9017,0.000355,172.31.40.0-255,66,52791,76,302531
9018,0.000357,74.125.200.0-255,1484,54275,76,302531
9019,0.000383,74.125.200.0-255,4232,58507,76,302531
9020,0.000386,172.31.40.0-255,66,58573,76,302531
9021,0.000389,74.125.200.0-255,135,58708,76,302531
9022,0.00053,74.125.200.0-255,1484,60192,76,302531
9023,0.000536,172.31.40.0-255,66,60258,76,302531
9024,0.000542,74.125.200.0-255,2902,63160,76,302531
9025,0.000545,172.31.40.0-255,66,63226,76,302531
9026,0.000549,74.125.200.0-255,2902,66128,76,302531
9027,0.000552,172.31.40.0-255,66,66194,76,302531
9028,0.00057,74.125.200.0-255,2902,69096,76,302531
9029,0.000572,172.31.40.0-255,66,69162,76,302531
9030,0.000577,74.125.200.0-255,2902,72064,76,302531
9031,0.000579,172.31.40.0-255,66,72130,76,302531
9032,0.000584,74.125.200.0-255,4320,76450,76,302531
9033,0.000587,172.31.40.0-255,66,76516,76,302531
9034,0.000621,172.31.40.0-255,66,76582,76,302531
9035,0.000629,74.125.200.0-255,7156,83738,76,302531
9036,0.000631,172.31.40.0-255,66,83804,76,302531
9037,0.000676,74.125.200.0-255,766,84570,76,302531
9038,0.000787,74.125.200.0-255,1484,86054,76,302531
9039,0.000792,172.31.40.0-255,66,86120,76,302531
9040,0.000796,74.125.200.0-255,1484,87604,76,302531
9041,0.00081,74.125.200.0-255,1484,89088,76,302531
9042,0.000812,172.31.40.0-255,66,89154,76,302531
9043,0.000817,74.125.200.0-255,2902,92056,76,302531
9044,0.000819,172.31.40.0-255,66,92122,76,302531
9045,0.000834,74.125.200.0-255,2902,95024,76,302531
9046,0.000836,172.31.40.0-255,66,95090,76,302531
9047,0.000842,74.125.200.0-255,4320,99410,76,302531
9048,0.000844,172.31.40.0-255,66,99476,76,302531
9049,0.000861,74.125.200.0-255,2902,102378,76,302531
9050,0.000864,172.31.40.0-255,66,102444,76,302531
9051,0.000885,74.125.200.0-255,5738,108182,76,302531
9052,0.000887,172.31.40.0-255,66,108248,76,302531
9053,0.000919,172.31.40.0-255,66,108314,76,302531
9054,0.000924,74.125.200.0-255,2902,111216,76,302531
9055,0.000926,172.31.40.0-255,66,111282,76,302531
9056,0.000948,74.125.200.0-255,5020,116302,76,302531
9057,0.000951,172.31.40.0-255,66,116368,76,302531
9058,0.00096,74.125.200.0-255,7156,123524,76,302531
9059,0.000972,74.125.200.0-255,1484,125008,76,302531
9060,0.000978,74.125.200.0-255,5738,130746,76,302531
9061,0.00099,74.125.200.0-255,1484,132230,76,302531
9062,0.001016,74.125.200.0-255,5738,137968,76,302531
9063,0.00102,74.125.200.0-255,2902,140870,76,302531
9064,0.001043,74.125.200.0-255,3602,144472,76,302531
9065,0.001094,74.125.200.0-255,1484,145956,76,302531
9066,0.001099,74.125.200.0-255,2902,148858,76,302531
9067,0.001112,74.125.200.0-255,1484,150342,76,302531
9068,0.001122,74.125.200.0-255,1484,151826,76,302531
9069,0.001143,74.125.200.0-255,4320,156146,76,302531
9070,0.001162,74.125.200.0-255,7156,163302,76,302531
9071,0.001174,74.125.200.0-255,1484,164786,76,302531
9072,0.001181,74.125.200.0-255,7156,171942,76,302531
9073,0.001229,74.125.200.0-255,6438,178380,76,302531
9074,0.001243,74.125.200.0-255,4320,182700,76,302531
9075,0.001248,172.31.40.0-255,66,182766,76,302531
9076,0.001257,74.125.200.0-255,2902,185668,76,302531
9077,0.001263,172.31.40.0-255,66,185734,76,302531
9078,0.0013,74.125.200.0-255,1484,187218,76,302531
9079,0.001313,172.31.40.0-255,66,187284,76,302531
9080,0.001346,74.125.200.0-255,1484,188768,76,302531
9081,0.00135,74.125.200.0-255,2902,191670,76,302531
9082,0.001357,74.125.200.0-255,5738,197408,76,302531
9083,0.001363,172.31.40.0-255,66,197474,76,302531
9084,0.001415,172.31.40.0-255,66,197540,76,302531
9085,0.001433,74.125.200.0-255,3602,201142,76,302531
9086,0.001447,172.31.40.0-255,66,201208,76,302531
9087,0.00152,74.125.200.0-255,1484,202692,76,302531
9088,0.001537,74.125.200.0-255,2902,205594,76,302531
9089,0.001543,172.31.40.0-255,66,205660,76,302531
9090,0.001561,74.125.200.0-255,5738,211398,76,302531
9091,0.001602,74.125.200.0-255,1484,212882,76,302531
9092,0.001623,74.125.200.0-255,5738,218620,76,302531
9093,0.001644,172.31.40.0-255,66,218686,76,302531
9094,0.001694,74.125.200.0-255,1484,220170,76,302531
9095,0.001714,74.125.200.0-255,2902,223072,76,302531
9096,0.001717,74.125.200.0-255,1484,224556,76,302531
9097,0.001736,74.125.200.0-255,4320,228876,76,302531
9098,0.001739,74.125.200.0-255,1484,230360,76,302531
9099,0.001743,74.125.200.0-255,2902,233262,76,302531
9100,0.001748,172.31.40.0-255,66,233328,76,302531
9101,0.00177,74.125.200.0-255,5738,239066,76,302531
9102,0.001787,74.125.200.0-255,4320,243386,76,302531
9103,0.001792,172.31.40.0-255,66,243452,76,302531
9104,0.00181,74.125.200.0-255,5738,249190,76,302531
9105,0.001826,172.31.40.0-255,66,249256,76,302531
9106,0.001844,74.125.200.0-255,2902,252158,76,302531
9107,0.001852,172.31.40.0-255,66,252224,76,302531
9108,0.001865,74.125.200.0-255,6438,258662,76,302531
9109,0.001881,74.125.200.0-255,4320,262982,76,302531
9110,0.001902,74.125.200.0-255,5738,268720,76,302531
9111,0.001915,172.31.40.0-255,66,268786,76,302531
9112,0.001977,172.31.40.0-255,66,268852,76,302531
9113,0.001992,74.125.200.0-255,2902,271754,76,302531
9114,0.002012,172.31.40.0-255,66,271820,76,302531
9115,0.002019,74.125.200.0-255,4320,276140,76,302531
9116,0.00203,74.125.200.0-255,2902,279042,76,302531
9117,0.002036,172.31.40.0-255,66,279108,76,302531
9118,0.002052,74.125.200.0-255,7156,286264,76,302531
9119,0.002071,74.125.200.0-255,2902,289166,76,302531
9120,0.002076,172.31.40.0-255,66,289232,76,302531
9121,0.002109,74.125.200.0-255,4320,293552,76,302531
9122,0.002116,172.31.40.0-255,66,293618,76,302531
9123,0.00213,74.125.200.0-255,1484,295102,76,302531
9124,0.002144,74.125.200.0-255,2709,297811,76,302531
9125,0.002151,172.31.40.0-255,66,297877,76,302531
9126,0.002178,74.125.200.0-255,105,297982,76,302531
9127,0.01179,172.31.40.0-255,66,298048,76,302531
9128,0.011829,172.31.40.0-255,105,298153,76,302531
9129,0.014174,74.125.200.0-255,66,298219,76,302531
9130,0.032036,172.31.40.0-255,182,298401,76,302531
9131,0.032071,172.31.40.0-255,1109,299510,76,302531
9132,0.032132,172.31.40.0-255,1514,301024,76,302531
9133,0.032134,172.31.40.0-255,1309,302333,76,302531
9134,0.033622,104.244.42.0-255,66,302399,76,302531
9135,0.033659,104.244.42.0-255,66,302465,76,302531
9136,0.033739,104.244.42.0-255,66,302531,76,302531
9137,0.0,74.125.24.0-255,146,146,76,160062
9138,2.3e-05,172.31.40.0-255,66,212,76,160062
9139,3e-05,74.125.24.0-255,1484,1696,76,160062
9140,3.5e-05,172.31.40.0-255,66,1762,76,160062
9141,4e-05,74.125.24.0-255,2902,4664,76,160062
9142,4.3e-05,172.31.40.0-255,66,4730,76,160062
9143,5.1e-05,74.125.24.0-255,7156,11886,76,160062
9144,5.5e-05,172.31.40.0-255,66,11952,76,160062
9145,8.9e-05,74.125.24.0-255,2072,14024,76,160062
9146,9.2e-05,172.31.40.0-255,66,14090,76,160062
9147,0.000156,74.125.24.0-255,1484,15574,76,160062
9148,0.000159,172.31.40.0-255,66,15640,76,160062
9149,0.000164,74.125.24.0-255,2902,18542,76,160062
9150,0.000167,172.31.40.0-255,66,18608,76,160062
9151,0.000196,74.125.24.0-255,5738,24346,76,160062
9152,0.000199,172.31.40.0-255,66,24412,76,160062
9153,0.000205,74.125.24.0-255,4320,28732,76,160062
9154,0.000207,172.31.40.0-255,66,28798,76,160062
9155,0.000247,74.125.24.0-255,2543,31341,76,160062
9156,0.00025,172.31.40.0-255,66,31407,76,160062
9157,0.000357,74.125.24.0-255,1484,32891,76,160062
9158,0.000361,172.31.40.0-255,66,32957,76,160062
9159,0.000366,74.125.24.0-255,2902,35859,76,160062
9160,0.000368,172.31.40.0-255,66,35925,76,160062
9161,0.000373,74.125.24.0-255,2902,38827,76,160062
9162,0.000375,172.31.40.0-255,66,38893,76,160062
9163,0.000403,74.125.24.0-255,2902,41795,76,160062
9164,0.000405,172.31.40.0-255,66,41861,76,160062
9165,0.000412,74.125.24.0-255,6797,48658,76,160062
9166,0.000415,172.31.40.0-255,66,48724,76,160062
9167,0.000442,74.125.24.0-255,7156,55880,76,160062
9168,0.000447,172.31.40.0-255,66,55946,76,160062
9169,0.00046,74.125.24.0-255,7156,63102,76,160062
9170,0.000463,172.31.40.0-255,66,63168,76,160062
9171,0.000467,74.125.24.0-255,2543,65711,76,160062
9172,0.000469,172.31.40.0-255,66,65777,76,160062
9173,0.000604,74.125.24.0-255,646,66423,76,160062
9174,0.00079,74.125.24.0-255,1484,67907,76,160062
9175,0.000795,172.31.40.0-255,66,67973,76,160062
9176,0.000815,74.125.24.0-255,2902,70875,76,160062
9177,0.000818,172.31.40.0-255,66,70941,76,160062
9178,0.000825,74.125.24.0-255,5738,76679,76,160062
9179,0.000827,172.31.40.0-255,66,76745,76,160062
9180,0.000869,172.31.40.0-255,66,76811,76,160062
9181,0.000876,74.125.24.0-255,7156,83967,76,160062
9182,0.000879,172.31.40.0-255,66,84033,76,160062
9183,0.000907,74.125.24.0-255,3602,87635,76,160062
9184,0.00091,172.31.40.0-255,66,87701,76,160062
9185,0.00128,74.125.24.0-255,1484,89185,76,160062
9186,0.001286,74.125.24.0-255,2902,92087,76,160062
9187,0.001291,172.31.40.0-255,66,92153,76,160062
9188,0.001312,74.125.24.0-255,5738,97891,76,160062
9189,0.001315,172.31.40.0-255,66,97957,76,160062
9190,0.001322,74.125.24.0-255,5738,103695,76,160062
9191,0.001324,172.31.40.0-255,66,103761,76,160062
9192,0.001338,74.125.24.0-255,1484,105245,76,160062
9193,0.001357,74.125.24.0-255,5738,110983,76,160062
9194,0.00136,172.31.40.0-255,66,111049,76,160062
9195,0.001384,74.125.24.0-255,5738,116787,76,160062
9196,0.001387,172.31.40.0-255,66,116853,76,160062
9197,0.001419,172.31.40.0-255,66,116919,76,160062
9198,0.001422,74.125.24.0-255,1484,118403,76,160062
9199,0.00145,172.31.40.0-255,66,118469,76,160062
9200,0.001461,172.31.40.0-255,66,118535,76,160062
9201,0.001538,74.125.24.0-255,1484,120019,76,160062
9202,0.001543,74.125.24.0-255,2902,122921,76,160062
9203,0.001546,172.31.40.0-255,66,122987,76,160062
9204,0.001569,74.125.24.0-255,5738,128725,76,160062
9205,0.001571,172.31.40.0-255,66,128791,76,160062
9206,0.001582,172.31.40.0-255,66,128857,76,160062
9207,0.00163,74.125.24.0-255,5738,134595,76,160062
9208,0.001634,172.31.40.0-255,66,134661,76,160062
9209,0.001665,172.31.40.0-255,66,134727,76,160062
9210,0.00167,74.125.24.0-255,4320,139047,76,160062
9211,0.001672,172.31.40.0-255,66,139113,76,160062
9212,0.001699,74.125.24.0-255,5738,144851,76,160062
9213,0.001702,172.31.40.0-255,66,144917,76,160062
9214,0.001729,172.31.40.0-255,66,144983,76,160062
9215,0.001752,74.125.24.0-255,1484,146467,76,160062
9216,0.001766,172.31.40.0-255,66,146533,76,160062
9217,0.00178,74.125.24.0-255,1484,148017,76,160062
9218,0.001833,172.31.40.0-255,66,148083,76,160062
9219,0.001845,172.31.40.0-255,66,148149,76,160062
9220,0.001888,172.31.40.0-255,66,148215,76,160062
9221,0.001919,172.31.40.0-255,66,148281,76,160062
9222,0.001936,172.31.40.0-255,66,148347,76,160062
9223,0.001969,172.31.40.0-255,66,148413,76,160062
9224,0.001984,172.31.40.0-255,66,148479,76,160062
9225,0.002038,172.31.40.0-255,66,148545,76,160062
9226,0.002062,172.31.40.0-255,66,148611,76,160062
9227,0.002088,172.31.40.0-255,66,148677,76,160062
9228,0.002109,74.125.24.0-255,766,149443,76,160062
9229,0.002117,74.125.24.0-255,5911,155354,76,160062
9230,0.00212,172.31.40.0-255,66,155420,76,160062
9231,0.002123,74.125.24.0-255,105,155525,76,160062
9232,0.004236,172.31.40.0-255,66,155591,76,160062
9233,0.004273,172.31.40.0-255,105,155696,76,160062
9234,0.006549,74.125.24.0-255,66,155762,76,160062
9235,0.032573,172.31.40.0-255,172,155934,76,160062
9236,0.032608,172.31.40.0-255,1109,157043,76,160062
9237,0.032664,172.31.40.0-255,1514,158557,76,160062
9238,0.032666,172.31.40.0-255,1307,159864,76,160062
9239,0.034118,104.244.42.0-255,66,159930,76,160062
9240,0.034263,104.244.42.0-255,66,159996,76,160062
9241,0.03428,104.244.42.0-255,66,160062,76,160062
9242,0.0,74.125.24.0-255,151,151,76,256854
9243,2.1e-05,172.31.40.0-255,66,217,76,256854
9244,2.9e-05,74.125.24.0-255,1484,1701,76,256854
9245,3.3e-05,172.31.40.0-255,66,1767,76,256854
9246,3.9e-05,74.125.24.0-255,2902,4669,76,256854
9247,4.2e-05,172.31.40.0-255,66,4735,76,256854
9248,5e-05,74.125.24.0-255,7156,11891,76,256854
9249,5.3e-05,172.31.40.0-255,66,11957,76,256854
9250,9.3e-05,74.125.24.0-255,4320,16277,76,256854
9251,9.6e-05,172.31.40.0-255,66,16343,76,256854
9252,0.000127,172.31.40.0-255,66,16409,76,256854
9253,0.000135,74.125.24.0-255,6797,23206,76,256854
9254,0.000137,172.31.40.0-255,66,23272,76,256854
9255,0.000167,74.125.24.0-255,1484,24756,76,256854
9256,0.00017,172.31.40.0-255,66,24822,76,256854
9257,0.000175,74.125.24.0-255,2902,27724,76,256854
9258,0.000177,172.31.40.0-255,66,27790,76,256854
9259,0.000202,74.125.24.0-255,5738,33528,76,256854
9260,0.000204,172.31.40.0-255,66,33594,76,256854
9261,0.00021,74.125.24.0-255,4320,37914,76,256854
9262,0.000212,172.31.40.0-255,66,37980,76,256854
9263,0.000235,74.125.24.0-255,2902,40882,76,256854
9264,0.000238,172.31.40.0-255,66,40948,76,256854
9265,0.000254,172.31.40.0-255,66,41014,76,256854
9266,0.000258,74.125.24.0-255,2515,43529,76,256854
9267,0.000261,172.31.40.0-255,66,43595,76,256854
9268,0.000324,74.125.24.0-255,113,43708,76,256854
9269,0.000328,172.31.40.0-255,66,43774,76,256854
9270,0.000363,74.125.24.0-255,330,44104,76,256854
9271,0.000366,172.31.40.0-255,66,44170,76,256854
9272,0.000642,74.125.24.0-255,1484,45654,76,256854
9273,0.000661,74.125.24.0-255,2902,48556,76,256854
9274,0.000665,172.31.40.0-255,66,48622,76,256854
9275,0.000671,74.125.24.0-255,5738,54360,76,256854
9276,0.000673,172.31.40.0-255,66,54426,76,256854
9277,0.000719,172.31.40.0-255,66,54492,76,256854
9278,0.000727,74.125.24.0-255,7156,61648,76,256854
9279,0.000729,172.31.40.0-255,66,61714,76,256854
9280,0.000771,74.125.24.0-255,3602,65316,76,256854
9281,0.000773,172.31.40.0-255,66,65382,76,256854
9282,0.000838,74.125.24.0-255,1484,66866,76,256854
9283,0.000843,74.125.24.0-255,2902,69768,76,256854
9284,0.000846,172.31.40.0-255,66,69834,76,256854
9285,0.000861,74.125.24.0-255,5738,75572,76,256854
9286,0.000863,172.31.40.0-255,66,75638,76,256854
9287,0.00089,74.125.24.0-255,5738,81376,76,256854
9288,0.000894,172.31.40.0-255,66,81442,76,256854
9289,0.000924,74.125.24.0-255,4320,85762,76,256854
9290,0.000927,172.31.40.0-255,66,85828,76,256854
9291,0.000951,74.125.24.0-255,5738,91566,76,256854
9292,0.000954,172.31.40.0-255,66,91632,76,256854
9293,0.000981,172.31.40.0-255,66,91698,76,256854
9294,0.001015,74.125.24.0-255,1484,93182,76,256854
9295,0.001046,74.125.24.0-255,2902,96084,76,256854
9296,0.001049,172.31.40.0-255,66,96150,76,256854
9297,0.00108,74.125.24.0-255,5738,101888,76,256854
9298,0.001083,172.31.40.0-255,66,101954,76,256854
9299,0.001089,74.125.24.0-255,7156,109110,76,256854
9300,0.001091,172.31.40.0-255,66,109176,76,256854
9301,0.001111,74.125.24.0-255,2902,112078,76,256854
9302,0.001113,172.31.40.0-255,66,112144,76,256854
9303,0.001133,172.31.40.0-255,66,112210,76,256854
9304,0.001137,74.125.24.0-255,2184,114394,76,256854
9305,0.001139,172.31.40.0-255,66,114460,76,256854
9306,0.001194,74.125.24.0-255,1484,115944,76,256854
9307,0.001207,74.125.24.0-255,2902,118846,76,256854
9308,0.00121,172.31.40.0-255,66,118912,76,256854
9309,0.001214,74.125.24.0-255,2902,121814,76,256854
9310,0.001216,172.31.40.0-255,66,121880,76,256854
9311,0.001234,74.125.24.0-255,2902,124782,76,256854
9312,0.001236,172.31.40.0-255,66,124848,76,256854
9313,0.001241,74.125.24.0-255,4320,129168,76,256854
9314,0.001243,172.31.40.0-255,66,129234,76,256854
9315,0.001245,74.125.24.0-255,1484,130718,76,256854
9316,0.001271,172.31.40.0-255,66,130784,76,256854
9317,0.001275,74.125.24.0-255,2902,133686,76,256854
9318,0.001278,172.31.40.0-255,66,133752,76,256854
9319,0.001302,74.125.24.0-255,5020,138772,76,256854
9320,0.001305,172.31.40.0-255,66,138838,76,256854
9321,0.001312,74.125.24.0-255,7156,145994,76,256854
9322,0.001314,172.31.40.0-255,66,146060,76,256854
9323,0.001336,74.125.24.0-255,1484,147544,76,256854
9324,0.001349,172.31.40.0-255,66,147610,76,256854
9325,0.00136,172.31.40.0-255,66,147676,76,256854
9326,0.001374,74.125.24.0-255,4320,151996,76,256854
9327,0.001376,172.31.40.0-255,66,152062,76,256854
9328,0.001397,74.125.24.0-255,766,152828,76,256854
9329,0.001467,74.125.24.0-255,1484,154312,76,256854
9330,0.00147,172.31.40.0-255,66,154378,76,256854
9331,0.001492,74.125.24.0-255,2902,157280,76,256854
9332,0.001496,172.31.40.0-255,66,157346,76,256854
9333,0.001499,74.125.24.0-255,1484,158830,76,256854
9334,0.001519,74.125.24.0-255,4320,163150,76,256854
9335,0.001521,172.31.40.0-255,66,163216,76,256854
9336,0.001603,74.125.24.0-255,5738,168954,76,256854
9337,0.001611,172.31.40.0-255,66,169020,76,256854
9338,0.001632,74.125.24.0-255,4320,173340,76,256854
9339,0.001635,172.31.40.0-255,66,173406,76,256854
9340,0.001645,172.31.40.0-255,66,173472,76,256854
9341,0.001651,74.125.24.0-255,3602,177074,76,256854
9342,0.001653,172.31.40.0-255,66,177140,76,256854
9343,0.001676,74.125.24.0-255,4320,181460,76,256854
9344,0.001679,172.31.40.0-255,66,181526,76,256854
9345,0.001682,74.125.24.0-255,1484,183010,76,256854
9346,0.0017,74.125.24.0-255,2902,185912,76,256854
9347,0.001703,172.31.40.0-255,66,185978,76,256854
9348,0.001707,74.125.24.0-255,2902,188880,76,256854
9349,0.00171,172.31.40.0-255,66,188946,76,256854
9350,0.00173,74.125.24.0-255,7156,196102,76,256854
9351,0.001733,172.31.40.0-255,66,196168,76,256854
9352,0.001738,74.125.24.0-255,2902,199070,76,256854
9353,0.00174,172.31.40.0-255,66,199136,76,256854
9354,0.001755,74.125.24.0-255,7156,206292,76,256854
9355,0.001757,172.31.40.0-255,66,206358,76,256854
9356,0.001789,74.125.24.0-255,5020,211378,76,256854
9357,0.001794,172.31.40.0-255,66,211444,76,256854
9358,0.001844,74.125.24.0-255,1484,212928,76,256854
9359,0.001849,74.125.24.0-255,2902,215830,76,256854
9360,0.001851,172.31.40.0-255,66,215896,76,256854
9361,0.001876,74.125.24.0-255,5738,221634,76,256854
9362,0.00188,172.31.40.0-255,66,221700,76,256854
9363,0.001885,74.125.24.0-255,4320,226020,76,256854
9364,0.001888,172.31.40.0-255,66,226086,76,256854
9365,0.001911,172.31.40.0-255,66,226152,76,256854
9366,0.001914,74.125.24.0-255,1484,227636,76,256854
9367,0.00196,74.125.24.0-255,5738,233374,76,256854
9368,0.001965,172.31.40.0-255,66,233440,76,256854
9369,0.001983,74.125.24.0-255,3602,237042,76,256854
9370,0.001985,172.31.40.0-255,66,237108,76,256854
9371,0.001998,74.125.24.0-255,1484,238592,76,256854
9372,0.002019,74.125.24.0-255,2902,241494,76,256854
9373,0.002022,172.31.40.0-255,66,241560,76,256854
9374,0.002028,74.125.24.0-255,4320,245880,76,256854
9375,0.00203,172.31.40.0-255,66,245946,76,256854
9376,0.002042,74.125.24.0-255,1484,247430,76,256854
9377,0.002057,74.125.24.0-255,4320,251750,76,256854
9378,0.00206,172.31.40.0-255,66,251816,76,256854
9379,0.002099,172.31.40.0-255,66,251882,76,256854
9380,0.002109,172.31.40.0-255,66,251948,76,256854
9381,0.002142,172.31.40.0-255,66,252014,76,256854
9382,0.002177,172.31.40.0-255,66,252080,76,256854
9383,0.002189,172.31.40.0-255,66,252146,76,256854
9384,0.002225,172.31.40.0-255,66,252212,76,256854
9385,0.002228,74.125.24.0-255,105,252317,76,256854
9386,0.004631,172.31.40.0-255,66,252383,76,256854
9387,0.004665,172.31.40.0-255,105,252488,76,256854
9388,0.007289,74.125.24.0-255,66,252554,76,256854
9389,0.032691,172.31.40.0-255,172,252726,76,256854
9390,0.032721,172.31.40.0-255,1109,253835,76,256854
9391,0.032774,172.31.40.0-255,1514,255349,76,256854
9392,0.032775,172.31.40.0-255,1307,256656,76,256854
9393,0.034386,104.244.42.0-255,66,256722,76,256854
9394,0.034396,104.244.42.0-255,66,256788,76,256854
9395,0.034463,104.244.42.0-255,66,256854,76,256854
9396,0.0,74.125.200.0-255,296,296,76,371071
9397,1.4e-05,172.31.40.0-255,66,362,76,371071
9398,2e-05,74.125.200.0-255,1484,1846,76,371071
9399,2.3e-05,172.31.40.0-255,66,1912,76,371071
9400,3e-05,74.125.200.0-255,4320,6232,76,371071
9401,4e-05,172.31.40.0-255,66,6298,76,371071
9402,4.6e-05,74.125.200.0-255,5738,12036,76,371071
9403,4.9e-05,172.31.40.0-255,66,12102,76,371071
9404,8.1e-05,74.125.200.0-255,5738,17840,76,371071
9405,8.4e-05,172.31.40.0-255,66,17906,76,371071
9406,0.000103,74.125.200.0-255,1824,19730,76,371071
9407,0.000105,172.31.40.0-255,66,19796,76,371071
9408,0.000137,172.31.40.0-255,66,19862,76,371071
9409,0.000141,74.125.200.0-255,2543,22405,76,371071
9410,0.000143,172.31.40.0-255,66,22471,76,371071
9411,0.000678,74.125.200.0-255,1484,23955,76,371071
9412,0.000684,172.31.40.0-255,66,24021,76,371071
9413,0.000692,74.125.200.0-255,2902,26923,76,371071
9414,0.000694,172.31.40.0-255,66,26989,76,371071
9415,0.000714,74.125.200.0-255,5738,32727,76,371071
9416,0.000716,172.31.40.0-255,66,32793,76,371071
9417,0.000724,74.125.200.0-255,2902,35695,76,371071
9418,0.000726,172.31.40.0-255,66,35761,76,371071
9419,0.000731,74.125.200.0-255,3961,39722,76,371071
9420,0.000733,172.31.40.0-255,66,39788,76,371071
9421,0.000763,74.125.200.0-255,5738,45526,76,371071
9422,0.000766,172.31.40.0-255,66,45592,76,371071
9423,0.000786,74.125.200.0-255,2902,48494,76,371071
9424,0.000788,172.31.40.0-255,66,48560,76,371071
9425,0.000792,74.125.200.0-255,2902,51462,76,371071
9426,0.000794,172.31.40.0-255,66,51528,76,371071
9427,0.000835,74.125.200.0-255,5379,56907,76,371071
9428,0.000853,74.125.200.0-255,426,57333,76,371071
9429,0.000961,74.125.200.0-255,1484,58817,76,371071
9430,0.000975,74.125.200.0-255,2902,61719,76,371071
9431,0.000979,74.125.200.0-255,1484,63203,76,371071
9432,0.000988,74.125.200.0-255,1484,64687,76,371071
9433,0.001,74.125.200.0-255,1484,66171,76,371071
9434,0.001031,74.125.200.0-255,5738,71909,76,371071
9435,0.001044,74.125.200.0-255,2543,74452,76,371071
9436,0.001081,74.125.200.0-255,2902,77354,76,371071
9437,0.001107,74.125.200.0-255,1484,78838,76,371071
9438,0.001121,74.125.200.0-255,2902,81740,76,371071
9439,0.001124,74.125.200.0-255,1484,83224,76,371071
9440,0.001157,74.125.200.0-255,7156,90380,76,371071
9441,0.001169,74.125.200.0-255,1125,91505,76,371071
9442,0.001241,74.125.200.0-255,1484,92989,76,371071
9443,0.001256,74.125.200.0-255,2902,95891,76,371071
9444,0.001264,74.125.200.0-255,1484,97375,76,371071
9445,0.001279,74.125.200.0-255,4320,101695,76,371071
9446,0.001283,74.125.200.0-255,2902,104597,76,371071
9447,0.001288,74.125.200.0-255,4320,108917,76,371071
9448,0.001314,74.125.200.0-255,5738,114655,76,371071
9449,0.001332,74.125.200.0-255,2902,117557,76,371071
9450,0.001336,74.125.200.0-255,2902,120459,76,371071
9451,0.00136,74.125.200.0-255,5020,125479,76,371071
9452,0.001393,74.125.200.0-255,2902,128381,76,371071
9453,0.001398,74.125.200.0-255,4320,132701,76,371071
9454,0.001412,74.125.200.0-255,2902,135603,76,371071
9455,0.001435,74.125.200.0-255,5738,141341,76,371071
9456,0.001447,74.125.200.0-255,2902,144243,76,371071
9457,0.001473,74.125.200.0-255,4320,148563,76,371071
9458,0.001494,74.125.200.0-255,2184,150747,76,371071
9459,0.00171,74.125.200.0-255,1484,152231,76,371071
9460,0.001716,74.125.200.0-255,2902,155133,76,371071
9461,0.00174,74.125.200.0-255,5738,160871,76,371071
9462,0.001761,74.125.200.0-255,7156,168027,76,371071
9463,0.00179,74.125.200.0-255,4320,172347,76,371071
9464,0.001807,74.125.200.0-255,4320,176667,76,371071
9465,0.001848,74.125.200.0-255,2902,179569,76,371071
9466,0.001864,74.125.200.0-255,5020,184589,76,371071
9467,0.001898,74.125.200.0-255,1484,186073,76,371071
9468,0.001901,74.125.200.0-255,1484,187557,76,371071
9469,0.001913,74.125.200.0-255,1484,189041,76,371071
9470,0.001924,74.125.200.0-255,2902,191943,76,371071
9471,0.001936,74.125.200.0-255,2902,194845,76,371071
9472,0.001952,74.125.200.0-255,5738,200583,76,371071
9473,0.001955,74.125.200.0-255,1484,202067,76,371071
9474,0.001974,74.125.200.0-255,5738,207805,76,371071
9475,0.002004,74.125.200.0-255,2902,210707,76,371071
9476,0.002021,74.125.200.0-255,2902,213609,76,371071
9477,0.002026,74.125.200.0-255,2902,216511,76,371071
9478,0.002043,74.125.200.0-255,3602,220113,76,371071
9479,0.002048,74.125.200.0-255,4320,224433,76,371071
9480,0.002065,74.125.200.0-255,5738,230171,76,371071
9481,0.002118,74.125.200.0-255,1484,231655,76,371071
9482,0.002123,74.125.200.0-255,4320,235975,76,371071
9483,0.002185,74.125.200.0-255,7156,243131,76,371071
9484,0.002217,74.125.200.0-255,4320,247451,76,371071
9485,0.00225,74.125.200.0-255,2902,250353,76,371071
9486,0.002264,74.125.200.0-255,2184,252537,76,371071
9487,0.002296,74.125.200.0-255,1484,254021,76,371071
9488,0.002312,74.125.200.0-255,2902,256923,76,371071
9489,0.003924,172.31.40.0-255,66,256989,76,371071
9490,0.006281,74.125.200.0-255,4320,261309,76,371071
9491,0.006287,172.31.40.0-255,66,261375,76,371071
9492,0.006314,74.125.200.0-255,1484,262859,76,371071
9493,0.008585,74.125.200.0-255,4320,267179,76,371071
9494,0.00859,172.31.40.0-255,66,267245,76,371071
9495,0.010891,74.125.200.0-255,5738,272983,76,371071
9496,0.015245,172.31.40.0-255,66,273049,76,371071
9497,0.017575,74.125.200.0-255,5738,278787,76,371071
9498,0.017591,172.31.40.0-255,66,278853,76,371071
9499,0.019899,74.125.200.0-255,5738,284591,76,371071
9500,0.019907,172.31.40.0-255,66,284657,76,371071
9501,0.022216,74.125.200.0-255,5738,290395,76,371071
9502,0.022226,172.31.40.0-255,66,290461,76,371071
9503,0.024525,74.125.200.0-255,5738,296199,76,371071
9504,0.024533,172.31.40.0-255,66,296265,76,371071
9505,0.026852,74.125.200.0-255,5738,302003,76,371071
9506,0.026858,172.31.40.0-255,66,302069,76,371071
9507,0.027854,172.31.40.0-255,172,302241,76,371071
9508,0.027885,172.31.40.0-255,1109,303350,76,371071
9509,0.02794,172.31.40.0-255,1514,304864,76,371071
9510,0.027942,172.31.40.0-255,339,305203,76,371071
9511,0.029172,74.125.200.0-255,5738,310941,76,371071
9512,0.029179,172.31.40.0-255,66,311007,76,371071
9513,0.029393,104.244.42.0-255,66,311073,76,371071
9514,0.029411,104.244.42.0-255,66,311139,76,371071
9515,0.029465,104.244.42.0-255,66,311205,76,371071
9516,0.031486,74.125.200.0-255,5738,316943,76,371071
9517,0.031493,172.31.40.0-255,66,317009,76,371071
9518,0.033827,74.125.200.0-255,5738,322747,76,371071
9519,0.033832,172.31.40.0-255,66,322813,76,371071
9520,0.036144,74.125.200.0-255,5738,328551,76,371071
9521,0.03615,172.31.40.0-255,66,328617,76,371071
9522,0.038467,74.125.200.0-255,5738,334355,76,371071
9523,0.038474,172.31.40.0-255,66,334421,76,371071
9524,0.040787,74.125.200.0-255,5738,340159,76,371071
9525,0.040793,172.31.40.0-255,66,340225,76,371071
9526,0.043109,74.125.200.0-255,5738,345963,76,371071
9527,0.043114,172.31.40.0-255,66,346029,76,371071
9528,0.045431,74.125.200.0-255,5738,351767,76,371071
9529,0.045437,172.31.40.0-255,66,351833,76,371071
9530,0.047742,74.125.200.0-255,5738,357571,76,371071
9531,0.047748,172.31.40.0-255,66,357637,76,371071
9532,0.050058,74.125.200.0-255,5738,363375,76,371071
9533,0.050068,172.31.40.0-255,66,363441,76,371071
9534,0.052383,74.125.200.0-255,5738,369179,76,371071
9535,0.052393,172.31.40.0-255,66,369245,76,371071
9536,0.054699,74.125.200.0-255,1130,370375,76,371071
9537,0.054861,172.31.40.0-255,105,370480,76,371071
9538,0.054897,172.31.40.0-255,105,370585,76,371071
9539,0.055121,172.31.40.0-255,90,370675,76,371071
9540,0.05513,172.31.40.0-255,66,370741,76,371071
9541,0.057138,74.125.200.0-255,66,370807,76,371071
9542,0.057163,74.125.200.0-255,66,370873,76,371071
9543,0.057388,74.125.200.0-255,66,370939,76,371071
9544,0.057415,74.125.200.0-255,66,371005,76,371071
9545,0.057429,172.31.40.0-255,66,371071,76,371071
9546,0.0,74.125.130.0-255,153,153,76,375560
9547,1.6e-05,172.31.40.0-255,66,219,76,375560
9548,9.3e-05,74.125.130.0-255,1484,1703,76,375560
9549,9.6e-05,172.31.40.0-255,66,1769,76,375560
9550,0.000131,74.125.130.0-255,2902,4671,76,375560
9551,0.000136,172.31.40.0-255,66,4737,76,375560
9552,0.000139,74.125.130.0-255,1484,6221,76,375560
9553,0.000142,172.31.40.0-255,66,6287,76,375560
9554,0.00017,74.125.130.0-255,2902,9189,76,375560
9555,0.000173,172.31.40.0-255,66,9255,76,375560
9556,0.000202,74.125.130.0-255,4937,14192,76,375560
9557,0.000205,172.31.40.0-255,66,14258,76,375560
9558,0.000406,74.125.130.0-255,1484,15742,76,375560
9559,0.000411,172.31.40.0-255,66,15808,76,375560
9560,0.000444,74.125.130.0-255,2902,18710,76,375560
9561,0.000447,172.31.40.0-255,66,18776,76,375560
9562,0.000455,74.125.130.0-255,5738,24514,76,375560
9563,0.000458,172.31.40.0-255,66,24580,76,375560
9564,0.000463,74.125.130.0-255,4320,28900,76,375560
9565,0.000466,172.31.40.0-255,66,28966,76,375560
9566,0.000493,74.125.130.0-255,2543,31509,76,375560
9567,0.000496,172.31.40.0-255,66,31575,76,375560
9568,0.000507,172.31.40.0-255,66,31641,76,375560
9569,0.000544,172.31.40.0-255,66,31707,76,375560
9570,0.000547,74.125.130.0-255,1484,33191,76,375560
9571,0.000549,172.31.40.0-255,66,33257,76,375560
9572,0.000588,74.125.130.0-255,2902,36159,76,375560
9573,0.000592,172.31.40.0-255,66,36225,76,375560
9574,0.000598,74.125.130.0-255,5738,41963,76,375560
9575,0.0006,172.31.40.0-255,66,42029,76,375560
9576,0.000603,74.125.130.0-255,1484,43513,76,375560
9577,0.000608,74.125.130.0-255,2902,46415,76,375560
9578,0.00061,172.31.40.0-255,66,46481,76,375560
9579,0.000641,74.125.130.0-255,766,47247,76,375560
9580,0.000787,74.125.130.0-255,340,47587,76,375560
9581,0.000914,74.125.130.0-255,119,47706,76,375560
9582,0.001109,172.31.40.0-255,66,47772,76,375560
9583,0.001269,74.125.130.0-255,1484,49256,76,375560
9584,0.001276,74.125.130.0-255,1484,50740,76,375560
9585,0.00128,172.31.40.0-255,66,50806,76,375560
9586,0.00131,74.125.130.0-255,1484,52290,76,375560
9587,0.001315,74.125.130.0-255,2902,55192,76,375560
9588,0.001318,172.31.40.0-255,66,55258,76,375560
9589,0.001324,74.125.130.0-255,4320,59578,76,375560
9590,0.001326,172.31.40.0-255,66,59644,76,375560
9591,0.001376,74.125.130.0-255,7156,66800,76,375560
9592,0.001379,172.31.40.0-255,66,66866,76,375560
9593,0.00139,172.31.40.0-255,66,66932,76,375560
9594,0.001415,74.125.130.0-255,1484,68416,76,375560
9595,0.001443,74.125.130.0-255,5020,73436,76,375560
9596,0.001445,172.31.40.0-255,66,73502,76,375560
9597,0.001486,74.125.130.0-255,380,73882,76,375560
9598,0.001664,74.125.130.0-255,1484,75366,76,375560
9599,0.00167,172.31.40.0-255,66,75432,76,375560
9600,0.001705,74.125.130.0-255,1484,76916,76,375560
9601,0.001723,74.125.130.0-255,2902,79818,76,375560
9602,0.001725,172.31.40.0-255,66,79884,76,375560
9603,0.001754,74.125.130.0-255,5738,85622,76,375560
9604,0.001756,172.31.40.0-255,66,85688,76,375560
9605,0.001776,74.125.130.0-255,5738,91426,76,375560
9606,0.001783,172.31.40.0-255,66,91492,76,375560
9607,0.00181,74.125.130.0-255,1484,92976,76,375560
9608,0.001823,172.31.40.0-255,66,93042,76,375560
9609,0.001852,74.125.130.0-255,1484,94526,76,375560
9610,0.001867,74.125.130.0-255,2184,96710,76,375560
9611,0.00187,172.31.40.0-255,66,96776,76,375560
9612,0.002088,74.125.130.0-255,1484,98260,76,375560
9613,0.002107,74.125.130.0-255,1484,99744,76,375560
9614,0.002111,172.31.40.0-255,66,99810,76,375560
9615,0.002141,74.125.130.0-255,2902,102712,76,375560
9616,0.002145,172.31.40.0-255,66,102778,76,375560
9617,0.002177,74.125.130.0-255,1484,104262,76,375560
9618,0.002182,74.125.130.0-255,2902,107164,76,375560
9619,0.002185,172.31.40.0-255,66,107230,76,375560
9620,0.002201,74.125.130.0-255,4320,111550,76,375560
9621,0.002203,172.31.40.0-255,66,111616,76,375560
9622,0.002222,74.125.130.0-255,1484,113100,76,375560
9623,0.002232,74.125.130.0-255,2902,116002,76,375560
9624,0.002234,172.31.40.0-255,66,116068,76,375560
9625,0.002237,74.125.130.0-255,1484,117552,76,375560
9626,0.002268,172.31.40.0-255,66,117618,76,375560
9627,0.002271,74.125.130.0-255,1484,119102,76,375560
9628,0.002275,74.125.130.0-255,2902,122004,76,375560
9629,0.002277,172.31.40.0-255,66,122070,76,375560
9630,0.00228,74.125.130.0-255,766,122836,76,375560
9631,0.002446,74.125.130.0-255,1484,124320,76,375560
9632,0.002449,172.31.40.0-255,66,124386,76,375560
9633,0.002452,74.125.130.0-255,1484,125870,76,375560
9634,0.002473,74.125.130.0-255,1484,127354,76,375560
9635,0.002475,172.31.40.0-255,66,127420,76,375560
9636,0.002508,74.125.130.0-255,2902,130322,76,375560
9637,0.002511,172.31.40.0-255,66,130388,76,375560
9638,0.002535,74.125.130.0-255,1484,131872,76,375560
9639,0.002549,74.125.130.0-255,2902,134774,76,375560
9640,0.002552,172.31.40.0-255,66,134840,76,375560
9641,0.002581,74.125.130.0-255,4320,139160,76,375560
9642,0.002585,172.31.40.0-255,66,139226,76,375560
9643,0.002591,74.125.130.0-255,5738,144964,76,375560
9644,0.002593,172.31.40.0-255,66,145030,76,375560
9645,0.002626,74.125.130.0-255,7156,152186,76,375560
9646,0.002628,172.31.40.0-255,66,152252,76,375560
9647,0.002661,74.125.130.0-255,4320,156572,76,375560
9648,0.002664,172.31.40.0-255,66,156638,76,375560
9649,0.002667,74.125.130.0-255,766,157404,76,375560
9650,0.004837,172.31.40.0-255,66,157470,76,375560
9651,0.005184,74.125.130.0-255,4320,161790,76,375560
9652,0.005189,172.31.40.0-255,66,161856,76,375560
9653,0.007355,74.125.130.0-255,1484,163340,76,375560
9654,0.007706,74.125.130.0-255,4320,167660,76,375560
9655,0.007709,172.31.40.0-255,66,167726,76,375560
9656,0.010228,74.125.130.0-255,5738,173464,76,375560
9657,0.010235,172.31.40.0-255,66,173530,76,375560
9658,0.012766,74.125.130.0-255,5738,179268,76,375560
9659,0.012775,172.31.40.0-255,66,179334,76,375560
9660,0.015315,74.125.130.0-255,5738,185072,76,375560
9661,0.015326,172.31.40.0-255,66,185138,76,375560
9662,0.017859,74.125.130.0-255,5738,190876,76,375560
9663,0.017869,172.31.40.0-255,66,190942,76,375560
9664,0.0204,74.125.130.0-255,5738,196680,76,375560
9665,0.020408,172.31.40.0-255,66,196746,76,375560
9666,0.022951,74.125.130.0-255,5738,202484,76,375560
9667,0.022959,172.31.40.0-255,66,202550,76,375560
9668,0.025502,74.125.130.0-255,5738,208288,76,375560
9669,0.025509,172.31.40.0-255,66,208354,76,375560
9670,0.028087,74.125.130.0-255,5738,214092,76,375560
9671,0.028094,172.31.40.0-255,66,214158,76,375560
9672,0.02872,172.31.40.0-255,172,214330,76,375560
9673,0.028752,172.31.40.0-255,1107,215437,76,375560
9674,0.028834,172.31.40.0-255,1514,216951,76,375560
9675,0.028836,172.31.40.0-255,1309,218260,76,375560
9676,0.030285,104.244.42.0-255,66,218326,76,375560
9677,0.030315,104.244.42.0-255,66,218392,76,375560
9678,0.030403,104.244.42.0-255,66,218458,76,375560
9679,0.030617,74.125.130.0-255,5738,224196,76,375560
9680,0.030624,172.31.40.0-255,66,224262,76,375560
9681,0.03315,74.125.130.0-255,5738,230000,76,375560
9682,0.033161,172.31.40.0-255,66,230066,76,375560
9683,0.035706,74.125.130.0-255,5738,235804,76,375560
9684,0.035712,172.31.40.0-255,66,235870,76,375560
9685,0.038276,74.125.130.0-255,5738,241608,76,375560
9686,0.038283,172.31.40.0-255,66,241674,76,375560
9687,0.040828,74.125.130.0-255,5738,247412,76,375560
9688,0.040833,172.31.40.0-255,66,247478,76,375560
9689,0.04093,172.31.40.0-255,101,247579,76,375560
9690,0.043359,74.125.130.0-255,5738,253317,76,375560
9691,0.043365,172.31.40.0-255,66,253383,76,375560
9692,0.043394,74.125.130.0-255,66,253449,76,375560
9693,0.0459,74.125.130.0-255,5738,259187,76,375560
9694,0.045907,172.31.40.0-255,66,259253,76,375560
9695,0.048428,74.125.130.0-255,5738,264991,76,375560
9696,0.048434,172.31.40.0-255,66,265057,76,375560
9697,0.050955,74.125.130.0-255,5738,270795,76,375560
9698,0.050963,172.31.40.0-255,66,270861,76,375560
9699,0.053505,74.125.130.0-255,5738,276599,76,375560
9700,0.053512,172.31.40.0-255,66,276665,76,375560
9701,0.056048,74.125.130.0-255,5738,282403,76,375560
9702,0.056055,172.31.40.0-255,66,282469,76,375560
9703,0.058599,74.125.130.0-255,5738,288207,76,375560
9704,0.058605,172.31.40.0-255,66,288273,76,375560
9705,0.061132,74.125.130.0-255,5738,294011,76,375560
9706,0.06114,172.31.40.0-255,66,294077,76,375560
9707,0.063672,74.125.130.0-255,5738,299815,76,375560
9708,0.063679,172.31.40.0-255,66,299881,76,375560
9709,0.06621,74.125.130.0-255,5738,305619,76,375560
9710,0.066217,172.31.40.0-255,66,305685,76,375560
9711,0.068757,74.125.130.0-255,5738,311423,76,375560
9712,0.068764,172.31.40.0-255,66,311489,76,375560
9713,0.071294,74.125.130.0-255,5738,317227,76,375560
9714,0.071301,172.31.40.0-255,66,317293,76,375560
9715,0.073839,74.125.130.0-255,5738,323031,76,375560
9716,0.073847,172.31.40.0-255,66,323097,76,375560
9717,0.076377,74.125.130.0-255,5738,328835,76,375560
9718,0.076384,172.31.40.0-255,66,328901,76,375560
9719,0.078923,74.125.130.0-255,5738,334639,76,375560
9720,0.078931,172.31.40.0-255,66,334705,76,375560
9721,0.081486,74.125.130.0-255,5738,340443,76,375560
9722,0.081495,172.31.40.0-255,66,340509,76,375560
9723,0.08403,74.125.130.0-255,5738,346247,76,375560
9724,0.084038,172.31.40.0-255,66,346313,76,375560
9725,0.086605,74.125.130.0-255,5738,352051,76,375560
9726,0.086614,172.31.40.0-255,66,352117,76,375560
9727,0.08916,74.125.130.0-255,5738,357855,76,375560
9728,0.089167,172.31.40.0-255,66,357921,76,375560
9729,0.091698,74.125.130.0-255,5738,363659,76,375560
9730,0.091705,172.31.40.0-255,66,363725,76,375560
9731,0.094245,74.125.130.0-255,5738,369463,76,375560
9732,0.094252,172.31.40.0-255,66,369529,76,375560
9733,0.096788,74.125.130.0-255,5738,375267,76,375560
9734,0.096795,172.31.40.0-255,66,375333,76,375560
9735,0.09931,74.125.130.0-255,122,375455,76,375560
9736,0.099895,172.31.40.0-255,105,375560,76,375560
9737,0.0,172.217.194.0-255,146,146,76,186544
9738,2.5e-05,172.31.40.0-255,66,212,76,186544
9739,3.2e-05,172.217.194.0-255,1484,1696,76,186544
9740,3.7e-05,172.31.40.0-255,66,1762,76,186544
9741,5e-05,172.217.194.0-255,2902,4664,76,186544
9742,5.4e-05,172.31.40.0-255,66,4730,76,186544
9743,6.1e-05,172.217.194.0-255,5738,10468,76,186544
9744,6.4e-05,172.31.40.0-255,66,10534,76,186544
9745,0.000104,172.217.194.0-255,3473,14007,76,186544
9746,0.000107,172.31.40.0-255,66,14073,76,186544
9747,0.000131,172.217.194.0-255,4320,18393,76,186544
9748,0.000134,172.31.40.0-255,66,18459,76,186544
9749,0.000165,172.31.40.0-255,66,18525,76,186544
9750,0.000192,172.217.194.0-255,1484,20009,76,186544
9751,0.000194,172.31.40.0-255,66,20075,76,186544
9752,0.000199,172.217.194.0-255,2543,22618,76,186544
9753,0.000201,172.31.40.0-255,66,22684,76,186544
9754,0.000237,172.31.40.0-255,66,22750,76,186544
9755,0.000241,172.217.194.0-255,2543,25293,76,186544
9756,0.000243,172.31.40.0-255,66,25359,76,186544
9757,0.000285,172.31.40.0-255,66,25425,76,186544
9758,0.000343,172.217.194.0-255,100,25525,76,186544
9759,0.000346,172.31.40.0-255,66,25591,76,186544
9760,0.00037,172.217.194.0-255,363,25954,76,186544
9761,0.000372,172.31.40.0-255,66,26020,76,186544
9762,0.00069,172.217.194.0-255,1484,27504,76,186544
9763,0.000696,172.31.40.0-255,66,27570,76,186544
9764,0.000702,172.217.194.0-255,2902,30472,76,186544
9765,0.000704,172.31.40.0-255,66,30538,76,186544
9766,0.00071,172.217.194.0-255,5738,36276,76,186544
9767,0.000718,172.31.40.0-255,66,36342,76,186544
9768,0.000721,172.217.194.0-255,1484,37826,76,186544
9769,0.000753,172.31.40.0-255,66,37892,76,186544
9770,0.000803,172.31.40.0-255,66,37958,76,186544
9771,0.000879,172.217.194.0-255,1484,39442,76,186544
9772,0.000883,172.217.194.0-255,1484,40926,76,186544
9773,0.000886,172.31.40.0-255,66,40992,76,186544
9774,0.000899,172.217.194.0-255,1484,42476,76,186544
9775,0.00091,172.217.194.0-255,5738,48214,76,186544
9776,0.000915,172.31.40.0-255,66,48280,76,186544
9777,0.000926,172.217.194.0-255,4320,52600,76,186544
9778,0.000932,172.31.40.0-255,66,52666,76,186544
9779,0.000943,172.31.40.0-255,66,52732,76,186544
9780,0.000967,172.217.194.0-255,2902,55634,76,186544
9781,0.00097,172.31.40.0-255,66,55700,76,186544
9782,0.000981,172.31.40.0-255,66,55766,76,186544
9783,0.001083,172.217.194.0-255,1484,57250,76,186544
9784,0.0011,172.217.194.0-255,2902,60152,76,186544
9785,0.001104,172.31.40.0-255,66,60218,76,186544
9786,0.001111,172.217.194.0-255,5738,65956,76,186544
9787,0.001113,172.31.40.0-255,66,66022,76,186544
9788,0.001116,172.217.194.0-255,1484,67506,76,186544
9789,0.00114,172.217.194.0-255,4320,71826,76,186544
9790,0.001142,172.31.40.0-255,66,71892,76,186544
9791,0.001148,172.217.194.0-255,4320,76212,76,186544
9792,0.001151,172.31.40.0-255,66,76278,76,186544
9793,0.001186,172.31.40.0-255,66,76344,76,186544
9794,0.001192,172.217.194.0-255,5020,81364,76,186544
9795,0.001194,172.31.40.0-255,66,81430,76,186544
9796,0.001633,172.217.194.0-255,1484,82914,76,186544
9797,0.001639,172.217.194.0-255,2902,85816,76,186544
9798,0.001643,172.31.40.0-255,66,85882,76,186544
9799,0.00165,172.217.194.0-255,5738,91620,76,186544
9800,0.001652,172.31.40.0-255,66,91686,76,186544
9801,0.001672,172.217.194.0-255,2902,94588,76,186544
9802,0.001674,172.31.40.0-255,66,94654,76,186544
9803,0.001707,172.31.40.0-255,66,94720,76,186544
9804,0.001714,172.217.194.0-255,7156,101876,76,186544
9805,0.001716,172.31.40.0-255,66,101942,76,186544
9806,0.00178,172.217.194.0-255,6438,108380,76,186544
9807,0.001783,172.31.40.0-255,66,108446,76,186544
9808,0.00179,172.217.194.0-255,7156,115602,76,186544
9809,0.001792,172.31.40.0-255,66,115668,76,186544
9810,0.001808,172.31.40.0-255,66,115734,76,186544
9811,0.001818,172.31.40.0-255,66,115800,76,186544
9812,0.001838,172.217.194.0-255,1484,117284,76,186544
9813,0.001861,172.217.194.0-255,2902,120186,76,186544
9814,0.001864,172.31.40.0-255,66,120252,76,186544
9815,0.00187,172.217.194.0-255,4320,124572,76,186544
9816,0.001872,172.31.40.0-255,66,124638,76,186544
9817,0.001892,172.217.194.0-255,1484,126122,76,186544
9818,0.001915,172.31.40.0-255,66,126188,76,186544
9819,0.001926,172.31.40.0-255,66,126254,76,186544
9820,0.00196,172.217.194.0-255,2184,128438,76,186544
9821,0.001963,172.31.40.0-255,66,128504,76,186544
9822,0.001984,172.217.194.0-255,2902,131406,76,186544
9823,0.001987,172.31.40.0-255,66,131472,76,186544
9824,0.002019,172.217.194.0-255,7156,138628,76,186544
9825,0.002026,172.217.194.0-255,7156,145784,76,186544
9826,0.002035,172.31.40.0-255,66,145850,76,186544
9827,0.002038,172.31.40.0-255,66,145916,76,186544
9828,0.002059,172.217.194.0-255,7156,153072,76,186544
9829,0.002061,172.31.40.0-255,66,153138,76,186544
9830,0.002101,172.31.40.0-255,66,153204,76,186544
9831,0.002104,172.217.194.0-255,766,153970,76,186544
9832,0.002107,172.217.194.0-255,1484,155454,76,186544
9833,0.002108,172.31.40.0-255,66,155520,76,186544
9834,0.002114,172.217.194.0-255,4320,159840,76,186544
9835,0.002116,172.31.40.0-255,66,159906,76,186544
9836,0.002124,172.217.194.0-255,7156,167062,76,186544
9837,0.002126,172.31.40.0-255,66,167128,76,186544
9838,0.002178,172.31.40.0-255,66,167194,76,186544
9839,0.002185,172.217.194.0-255,5020,172214,76,186544
9840,0.002187,172.31.40.0-255,66,172280,76,186544
9841,0.002194,172.217.194.0-255,5738,178018,76,186544
9842,0.002196,172.31.40.0-255,66,178084,76,186544
9843,0.002247,172.31.40.0-255,66,178150,76,186544
9844,0.00226,172.31.40.0-255,66,178216,76,186544
9845,0.002339,172.31.40.0-255,66,178282,76,186544
9846,0.002381,172.31.40.0-255,66,178348,76,186544
9847,0.002393,172.31.40.0-255,66,178414,76,186544
9848,0.002396,172.217.194.0-255,105,178519,76,186544
9849,0.010376,172.31.40.0-255,66,178585,76,186544
9850,0.010411,172.31.40.0-255,105,178690,76,186544
9851,0.013131,172.217.194.0-255,66,178756,76,186544
9852,0.034332,172.31.40.0-255,172,178928,76,186544
9853,0.034363,172.31.40.0-255,1109,180037,76,186544
9854,0.034542,172.31.40.0-255,1514,181551,76,186544
9855,0.034545,172.31.40.0-255,1514,183065,76,186544
9856,0.034546,172.31.40.0-255,1514,184579,76,186544
9857,0.034578,172.31.40.0-255,1514,186093,76,186544
9858,0.034579,172.31.40.0-255,187,186280,76,186544
9859,0.035983,104.244.42.0-255,66,186346,76,186544
9860,0.03602,104.244.42.0-255,66,186412,76,186544
9861,0.036254,104.244.42.0-255,66,186478,76,186544
9862,0.036274,104.244.42.0-255,66,186544,76,186544
9863,0.0,172.217.194.0-255,153,153,76,322943
9864,1.6e-05,172.31.40.0-255,66,219,76,322943
9865,2.3e-05,172.217.194.0-255,1484,1703,76,322943
9866,2.7e-05,172.31.40.0-255,66,1769,76,322943
9867,4.1e-05,172.217.194.0-255,2902,4671,76,322943
9868,4.5e-05,172.31.40.0-255,66,4737,76,322943
9869,5.3e-05,172.217.194.0-255,7156,11893,76,322943
9870,5.7e-05,172.31.40.0-255,66,11959,76,322943
9871,6.1e-05,172.217.194.0-255,2062,14021,76,322943
9872,6.4e-05,172.31.40.0-255,66,14087,76,322943
9873,0.000109,172.31.40.0-255,66,14153,76,322943
9874,0.000116,172.217.194.0-255,5379,19532,76,322943
9875,0.000118,172.31.40.0-255,66,19598,76,322943
9876,0.000478,172.217.194.0-255,1484,21082,76,322943
9877,0.000485,172.31.40.0-255,66,21148,76,322943
9878,0.000494,172.217.194.0-255,2902,24050,76,322943
9879,0.000496,172.31.40.0-255,66,24116,76,322943
9880,0.000507,172.217.194.0-255,5738,29854,76,322943
9881,0.00051,172.31.40.0-255,66,29920,76,322943
9882,0.000522,172.217.194.0-255,1484,31404,76,322943
9883,0.000524,172.31.40.0-255,66,31470,76,322943
9884,0.000562,172.31.40.0-255,66,31536,76,322943
9885,0.000569,172.217.194.0-255,7156,38692,76,322943
9886,0.000572,172.31.40.0-255,66,38758,76,322943
9887,0.000601,172.217.194.0-255,6438,45196,76,322943
9888,0.000604,172.31.40.0-255,66,45262,76,322943
9889,0.000606,172.217.194.0-255,707,45969,76,322943
9890,0.000609,172.31.40.0-255,66,46035,76,322943
9891,0.000773,172.217.194.0-255,1484,47519,76,322943
9892,0.000778,172.31.40.0-255,66,47585,76,322943
9893,0.000784,172.217.194.0-255,2902,50487,76,322943
9894,0.000787,172.31.40.0-255,66,50553,76,322943
9895,0.000798,172.217.194.0-255,5738,56291,76,322943
9896,0.0008,172.31.40.0-255,66,56357,76,322943
9897,0.000843,172.217.194.0-255,1484,57841,76,322943
9898,0.000873,172.31.40.0-255,66,57907,76,322943
9899,0.000886,172.31.40.0-255,66,57973,76,322943
9900,0.001545,172.217.194.0-255,1484,59457,76,322943
9901,0.001553,172.217.194.0-255,2902,62359,76,322943
9902,0.001558,172.31.40.0-255,66,62425,76,322943
9903,0.001565,172.217.194.0-255,5738,68163,76,322943
9904,0.001568,172.31.40.0-255,66,68229,76,322943
9905,0.001591,172.217.194.0-255,4320,72549,76,322943
9906,0.001593,172.31.40.0-255,66,72615,76,322943
9907,0.001603,172.217.194.0-255,5738,78353,76,322943
9908,0.001605,172.31.40.0-255,66,78419,76,322943
9909,0.001654,172.31.40.0-255,66,78485,76,322943
9910,0.001659,172.217.194.0-255,2184,80669,76,322943
9911,0.001661,172.31.40.0-255,66,80735,76,322943
9912,0.001713,172.217.194.0-255,1484,82219,76,322943
9913,0.001718,172.217.194.0-255,2902,85121,76,322943
9914,0.001721,172.31.40.0-255,66,85187,76,322943
9915,0.001725,172.217.194.0-255,1484,86671,76,322943
9916,0.001754,172.217.194.0-255,4320,90991,76,322943
9917,0.001758,172.31.40.0-255,66,91057,76,322943
9918,0.00177,172.31.40.0-255,66,91123,76,322943
9919,0.001786,172.217.194.0-255,2902,94025,76,322943
9920,0.001788,172.31.40.0-255,66,94091,76,322943
9921,0.001805,172.31.40.0-255,66,94157,76,322943
9922,0.001854,172.31.40.0-255,66,94223,76,322943
9923,0.001867,172.31.40.0-255,66,94289,76,322943
9924,0.001902,172.31.40.0-255,66,94355,76,322943
9925,0.001919,172.217.194.0-255,5738,100093,76,322943
9926,0.001921,172.31.40.0-255,66,100159,76,322943
9927,0.001928,172.217.194.0-255,766,100925,76,322943
9928,0.001997,172.217.194.0-255,1484,102409,76,322943
9929,0.002001,172.31.40.0-255,66,102475,76,322943
9930,0.003901,172.217.194.0-255,2902,105377,76,322943
9931,0.003907,172.31.40.0-255,66,105443,76,322943
9932,0.003976,172.217.194.0-255,2902,108345,76,322943
9933,0.003979,172.31.40.0-255,66,108411,76,322943
9934,0.005912,172.217.194.0-255,2902,111313,76,322943
9935,0.005919,172.31.40.0-255,66,111379,76,322943
9936,0.005945,172.217.194.0-255,2902,114281,76,322943
9937,0.005948,172.31.40.0-255,66,114347,76,322943
9938,0.007884,172.217.194.0-255,2902,117249,76,322943
9939,0.007889,172.31.40.0-255,66,117315,76,322943
9940,0.007921,172.217.194.0-255,2902,120217,76,322943
9941,0.007924,172.31.40.0-255,66,120283,76,322943
9942,0.00987,172.217.194.0-255,2902,123185,76,322943
9943,0.009878,172.31.40.0-255,66,123251,76,322943
9944,0.009906,172.217.194.0-255,2902,126153,76,322943
9945,0.009909,172.31.40.0-255,66,126219,76,322943
9946,0.01186,172.217.194.0-255,2902,129121,76,322943
9947,0.011869,172.31.40.0-255,66,129187,76,322943
9948,0.011897,172.217.194.0-255,2902,132089,76,322943
9949,0.011899,172.31.40.0-255,66,132155,76,322943
9950,0.013862,172.217.194.0-255,5738,137893,76,322943
9951,0.013869,172.31.40.0-255,66,137959,76,322943
9952,0.015864,172.217.194.0-255,5738,143697,76,322943
9953,0.015874,172.31.40.0-255,66,143763,76,322943
9954,0.017859,172.217.194.0-255,5738,149501,76,322943
9955,0.017868,172.31.40.0-255,66,149567,76,322943
9956,0.019881,172.217.194.0-255,5738,155305,76,322943
9957,0.019887,172.31.40.0-255,66,155371,76,322943
9958,0.021894,172.217.194.0-255,5738,161109,76,322943
9959,0.0219,172.31.40.0-255,66,161175,76,322943
9960,0.023876,172.217.194.0-255,5738,166913,76,322943
9961,0.023883,172.31.40.0-255,66,166979,76,322943
9962,0.02585,172.217.194.0-255,5738,172717,76,322943
9963,0.025856,172.31.40.0-255,66,172783,76,322943
9964,0.027251,172.31.40.0-255,172,172955,76,322943
9965,0.027298,172.31.40.0-255,1107,174062,76,322943
9966,0.027359,172.31.40.0-255,1514,175576,76,322943
9967,0.027361,172.31.40.0-255,1514,177090,76,322943
9968,0.027362,172.31.40.0-255,1514,178604,76,322943
9969,0.027392,172.31.40.0-255,1514,180118,76,322943
9970,0.027393,172.31.40.0-255,185,180303,76,322943
9971,0.027823,172.217.194.0-255,5738,186041,76,322943
9972,0.027829,172.31.40.0-255,66,186107,76,322943
9973,0.028812,104.244.42.0-255,66,186173,76,322943
9974,0.028885,104.244.42.0-255,66,186239,76,322943
9975,0.028926,104.244.42.0-255,66,186305,76,322943
9976,0.028966,104.244.42.0-255,66,186371,76,322943
9977,0.029799,172.217.194.0-255,5738,192109,76,322943
9978,0.029804,172.31.40.0-255,66,192175,76,322943
9979,0.03177,172.217.194.0-255,5738,197913,76,322943
9980,0.031775,172.31.40.0-255,66,197979,76,322943
9981,0.033759,172.217.194.0-255,5738,203717,76,322943
9982,0.033765,172.31.40.0-255,66,203783,76,322943
9983,0.035745,172.217.194.0-255,5738,209521,76,322943
9984,0.035752,172.31.40.0-255,66,209587,76,322943
9985,0.037751,172.217.194.0-255,5738,215325,76,322943
9986,0.037756,172.31.40.0-255,66,215391,76,322943
9987,0.039763,172.217.194.0-255,5738,221129,76,322943
9988,0.03977,172.31.40.0-255,66,221195,76,322943
9989,0.041743,172.217.194.0-255,5738,226933,76,322943
9990,0.041751,172.31.40.0-255,66,226999,76,322943
9991,0.043715,172.217.194.0-255,5738,232737,76,322943
9992,0.043722,172.31.40.0-255,66,232803,76,322943
9993,0.045688,172.217.194.0-255,5738,238541,76,322943
9994,0.045694,172.31.40.0-255,66,238607,76,322943
9995,0.047698,172.217.194.0-255,5738,244345,76,322943
9996,0.047705,172.31.40.0-255,66,244411,76,322943
9997,0.049695,172.217.194.0-255,5738,250149,76,322943
9998,0.049702,172.31.40.0-255,66,250215,76,322943
9999,0.05167,172.217.194.0-255,5738,255953,76,322943
10000,0.051677,172.31.40.0-255,66,256019,76,322943
10001,0.05367,172.217.194.0-255,5738,261757,76,322943
10002,0.053675,172.31.40.0-255,66,261823,76,322943
10003,0.055656,172.217.194.0-255,5738,267561,76,322943
10004,0.055663,172.31.40.0-255,66,267627,76,322943
10005,0.057665,172.217.194.0-255,5738,273365,76,322943
10006,0.05767,172.31.40.0-255,66,273431,76,322943
10007,0.05965,172.217.194.0-255,5738,279169,76,322943
10008,0.059656,172.31.40.0-255,66,279235,76,322943
10009,0.061627,172.217.194.0-255,5738,284973,76,322943
10010,0.061633,172.31.40.0-255,66,285039,76,322943
10011,0.063632,172.217.194.0-255,5738,290777,76,322943
10012,0.063638,172.31.40.0-255,66,290843,76,322943
10013,0.065624,172.217.194.0-255,5738,296581,76,322943
10014,0.06563,172.31.40.0-255,66,296647,76,322943
10015,0.067622,172.217.194.0-255,5738,302385,76,322943
10016,0.067628,172.31.40.0-255,66,302451,76,322943
10017,0.069626,172.217.194.0-255,5738,308189,76,322943
10018,0.069632,172.31.40.0-255,66,308255,76,322943
10019,0.071632,172.217.194.0-255,5738,313993,76,322943
10020,0.071639,172.31.40.0-255,66,314059,76,322943
10021,0.073616,172.217.194.0-255,5738,319797,76,322943
10022,0.073621,172.31.40.0-255,66,319863,76,322943
10023,0.075605,172.217.194.0-255,2843,322706,76,322943
10024,0.075612,172.31.40.0-255,66,322772,76,322943
10025,0.075768,172.31.40.0-255,105,322877,76,322943
10026,0.077729,172.217.194.0-255,66,322943,76,322943
10027,0.0,216.58.221.0-255,153,153,76,355520
10028,1.9e-05,172.31.40.0-255,66,219,76,355520
10029,2.5e-05,216.58.221.0-255,1484,1703,76,355520
10030,2.9e-05,172.31.40.0-255,66,1769,76,355520
10031,3.5e-05,216.58.221.0-255,2902,4671,76,355520
10032,4.5e-05,172.31.40.0-255,66,4737,76,355520
10033,5e-05,216.58.221.0-255,4320,9057,76,355520
10034,5.3e-05,172.31.40.0-255,66,9123,76,355520
10035,9.1e-05,216.58.221.0-255,4320,13443,76,355520
10036,9.4e-05,172.31.40.0-255,66,13509,76,355520
10037,0.000118,216.58.221.0-255,646,14155,76,355520
10038,0.00012,172.31.40.0-255,66,14221,76,355520
10039,0.000513,216.58.221.0-255,1484,15705,76,355520
10040,0.000517,172.31.40.0-255,66,15771,76,355520
10041,0.000525,216.58.221.0-255,2902,18673,76,355520
10042,0.000527,172.31.40.0-255,66,18739,76,355520
10043,0.000544,216.58.221.0-255,2902,21641,76,355520
10044,0.00055,172.31.40.0-255,66,21707,76,355520
10045,0.000572,216.58.221.0-255,1484,23191,76,355520
10046,0.000574,172.31.40.0-255,66,23257,76,355520
10047,0.000603,216.58.221.0-255,2902,26159,76,355520
10048,0.000605,172.31.40.0-255,66,26225,76,355520
10049,0.000613,216.58.221.0-255,5379,31604,76,355520
10050,0.000616,172.31.40.0-255,66,31670,76,355520
10051,0.000697,216.58.221.0-255,1484,33154,76,355520
10052,0.000701,172.31.40.0-255,66,33220,76,355520
10053,0.000706,216.58.221.0-255,2902,36122,76,355520
10054,0.000708,172.31.40.0-255,66,36188,76,355520
10055,0.000728,216.58.221.0-255,5738,41926,76,355520
10056,0.000735,172.31.40.0-255,66,41992,76,355520
10057,0.000783,216.58.221.0-255,5738,47730,76,355520
10058,0.000787,172.31.40.0-255,66,47796,76,355520
10059,0.000801,216.58.221.0-255,1125,48921,76,355520
10060,0.001722,216.58.221.0-255,1484,50405,76,355520
10061,0.00173,172.31.40.0-255,66,50471,76,355520
10062,0.001736,216.58.221.0-255,2902,53373,76,355520
10063,0.001739,172.31.40.0-255,66,53439,76,355520
10064,0.001749,216.58.221.0-255,1484,54923,76,355520
10065,0.001771,216.58.221.0-255,1484,56407,76,355520
10066,0.001773,172.31.40.0-255,66,56473,76,355520
10067,0.00178,216.58.221.0-255,4320,60793,76,355520
10068,0.001782,172.31.40.0-255,66,60859,76,355520
10069,0.00182,216.58.221.0-255,5958,66817,76,355520
10070,0.001823,172.31.40.0-255,66,66883,76,355520
10071,0.001876,216.58.221.0-255,1484,68367,76,355520
10072,0.001889,216.58.221.0-255,2902,71269,76,355520
10073,0.001892,172.31.40.0-255,66,71335,76,355520
10074,0.001918,216.58.221.0-255,4320,75655,76,355520
10075,0.001921,172.31.40.0-255,66,75721,76,355520
10076,0.001956,216.58.221.0-255,4320,80041,76,355520
10077,0.001958,172.31.40.0-255,66,80107,76,355520
10078,0.001987,216.58.221.0-255,5379,85486,76,355520
10079,0.00199,172.31.40.0-255,66,85552,76,355520
10080,0.002047,216.58.221.0-255,2902,88454,76,355520
10081,0.00205,172.31.40.0-255,66,88520,76,355520
10082,0.00209,172.31.40.0-255,66,88586,76,355520
10083,0.002199,216.58.221.0-255,1125,89711,76,355520
10084,0.004184,216.58.221.0-255,4320,94031,76,355520
10085,0.00419,172.31.40.0-255,66,94097,76,355520
10086,0.006294,216.58.221.0-255,5738,99835,76,355520
10087,0.006302,172.31.40.0-255,66,99901,76,355520
10088,0.008404,216.58.221.0-255,5738,105639,76,355520
10089,0.008412,172.31.40.0-255,66,105705,76,355520
10090,0.010511,216.58.221.0-255,5738,111443,76,355520
10091,0.01052,172.31.40.0-255,66,111509,76,355520
10092,0.012615,216.58.221.0-255,5738,117247,76,355520
10093,0.012623,172.31.40.0-255,66,117313,76,355520
10094,0.014714,216.58.221.0-255,4320,121633,76,355520
10095,0.014723,172.31.40.0-255,66,121699,76,355520
10096,0.014754,216.58.221.0-255,1484,123183,76,355520
10097,0.016823,216.58.221.0-255,2902,126085,76,355520
10098,0.01683,172.31.40.0-255,66,126151,76,355520
10099,0.016857,216.58.221.0-255,1484,127635,76,355520
10100,0.018929,216.58.221.0-255,4320,131955,76,355520
10101,0.018936,172.31.40.0-255,66,132021,76,355520
10102,0.021059,216.58.221.0-255,5738,137759,76,355520
10103,0.021067,172.31.40.0-255,66,137825,76,355520
10104,0.023171,216.58.221.0-255,5738,143563,76,355520
10105,0.02318,172.31.40.0-255,66,143629,76,355520
10106,0.025274,216.58.221.0-255,5738,149367,76,355520
10107,0.025282,172.31.40.0-255,66,149433,76,355520
10108,0.026528,172.31.40.0-255,171,149604,76,355520
10109,0.026561,172.31.40.0-255,1131,150735,76,355520
10110,0.026616,172.31.40.0-255,1514,152249,76,355520
10111,0.026618,172.31.40.0-255,1285,153534,76,355520
10112,0.027384,216.58.221.0-255,4320,157854,76,355520
10113,0.027392,172.31.40.0-255,66,157920,76,355520
10114,0.02742,216.58.221.0-255,1484,159404,76,355520
10115,0.028218,104.244.42.0-255,66,159470,76,355520
10116,0.028226,104.244.42.0-255,66,159536,76,355520
10117,0.028313,104.244.42.0-255,66,159602,76,355520
10118,0.029501,216.58.221.0-255,4320,163922,76,355520
10119,0.029508,172.31.40.0-255,66,163988,76,355520
10120,0.031617,216.58.221.0-255,5738,169726,76,355520
10121,0.031623,172.31.40.0-255,66,169792,76,355520
10122,0.033731,216.58.221.0-255,5738,175530,76,355520
10123,0.033738,172.31.40.0-255,66,175596,76,355520
10124,0.035859,216.58.221.0-255,5738,181334,76,355520
10125,0.035866,172.31.40.0-255,66,181400,76,355520
10126,0.037969,216.58.221.0-255,5738,187138,76,355520
10127,0.037976,172.31.40.0-255,66,187204,76,355520
10128,0.040083,216.58.221.0-255,5738,192942,76,355520
10129,0.040091,172.31.40.0-255,66,193008,76,355520
10130,0.042195,216.58.221.0-255,5738,198746,76,355520
10131,0.042201,172.31.40.0-255,66,198812,76,355520
10132,0.0443,216.58.221.0-255,5738,204550,76,355520
10133,0.044306,172.31.40.0-255,66,204616,76,355520
10134,0.046417,216.58.221.0-255,5738,210354,76,355520
10135,0.046423,172.31.40.0-255,66,210420,76,355520
10136,0.048528,216.58.221.0-255,5738,216158,76,355520
10137,0.048535,172.31.40.0-255,66,216224,76,355520
10138,0.050641,216.58.221.0-255,5738,221962,76,355520
10139,0.050648,172.31.40.0-255,66,222028,76,355520
10140,0.052751,216.58.221.0-255,5738,227766,76,355520
10141,0.052758,172.31.40.0-255,66,227832,76,355520
10142,0.054876,216.58.221.0-255,5738,233570,76,355520
10143,0.054882,172.31.40.0-255,66,233636,76,355520
10144,0.056979,216.58.221.0-255,5738,239374,76,355520
10145,0.056987,172.31.40.0-255,66,239440,76,355520
10146,0.0591,216.58.221.0-255,5738,245178,76,355520
10147,0.059107,172.31.40.0-255,66,245244,76,355520
10148,0.0612,216.58.221.0-255,5738,250982,76,355520
10149,0.061207,172.31.40.0-255,66,251048,76,355520
10150,0.063317,216.58.221.0-255,5738,256786,76,355520
10151,0.063329,172.31.40.0-255,66,256852,76,355520
10152,0.065495,216.58.221.0-255,5738,262590,76,355520
10153,0.06551,172.31.40.0-255,66,262656,76,355520
10154,0.067614,216.58.221.0-255,5738,268394,76,355520
10155,0.067622,172.31.40.0-255,66,268460,76,355520
10156,0.069737,216.58.221.0-255,5738,274198,76,355520
10157,0.069745,172.31.40.0-255,66,274264,76,355520
10158,0.071874,216.58.221.0-255,5738,280002,76,355520
10159,0.071886,172.31.40.0-255,66,280068,76,355520
10160,0.074006,216.58.221.0-255,5738,285806,76,355520
10161,0.074017,172.31.40.0-255,66,285872,76,355520
10162,0.076158,216.58.221.0-255,5738,291610,76,355520
10163,0.076169,172.31.40.0-255,66,291676,76,355520
10164,0.078304,216.58.221.0-255,5738,297414,76,355520
10165,0.078312,172.31.40.0-255,66,297480,76,355520
10166,0.080412,216.58.221.0-255,5738,303218,76,355520
10167,0.080419,172.31.40.0-255,66,303284,76,355520
10168,0.082523,216.58.221.0-255,5738,309022,76,355520
10169,0.082532,172.31.40.0-255,66,309088,76,355520
10170,0.084632,216.58.221.0-255,5738,314826,76,355520
10171,0.084637,172.31.40.0-255,66,314892,76,355520
10172,0.086789,216.58.221.0-255,5738,320630,76,355520
10173,0.086794,172.31.40.0-255,66,320696,76,355520
10174,0.088901,216.58.221.0-255,5738,326434,76,355520
10175,0.088908,172.31.40.0-255,66,326500,76,355520
10176,0.091005,216.58.221.0-255,5738,332238,76,355520
10177,0.091011,172.31.40.0-255,66,332304,76,355520
10178,0.093117,216.58.221.0-255,5738,338042,76,355520
10179,0.093124,172.31.40.0-255,66,338108,76,355520
10180,0.095222,216.58.221.0-255,5738,343846,76,355520
10181,0.095229,172.31.40.0-255,66,343912,76,355520
10182,0.097324,216.58.221.0-255,5738,349650,76,355520
10183,0.097335,172.31.40.0-255,66,349716,76,355520
10184,0.099435,216.58.221.0-255,5738,355454,76,355520
10185,0.099441,172.31.40.0-255,66,355520,76,355520
10186,0.0,74.125.24.0-255,153,153,76,371252
10187,2.2e-05,172.31.40.0-255,66,219,76,371252
10188,2.9e-05,74.125.24.0-255,1484,1703,76,371252
10189,3.4e-05,172.31.40.0-255,66,1769,76,371252
10190,4e-05,74.125.24.0-255,2902,4671,76,371252
10191,4.4e-05,172.31.40.0-255,66,4737,76,371252
10192,5.2e-05,74.125.24.0-255,7156,11893,76,371252
10193,5.5e-05,172.31.40.0-255,66,11959,76,371252
10194,5.9e-05,74.125.24.0-255,1484,13443,76,371252
10195,6.1e-05,172.31.40.0-255,66,13509,76,371252
10196,6.5e-05,74.125.24.0-255,622,14131,76,371252
10197,6.9e-05,172.31.40.0-255,66,14197,76,371252
10198,0.000505,74.125.24.0-255,1484,15681,76,371252
10199,0.000513,172.31.40.0-255,66,15747,76,371252
10200,0.00052,74.125.24.0-255,2902,18649,76,371252
10201,0.000523,172.31.40.0-255,66,18715,76,371252
10202,0.00053,74.125.24.0-255,5738,24453,76,371252
10203,0.000532,172.31.40.0-255,66,24519,76,371252
10204,0.00054,74.125.24.0-255,6797,31316,76,371252
10205,0.000543,172.31.40.0-255,66,31382,76,371252
10206,0.00058,74.125.24.0-255,4320,35702,76,371252
10207,0.000582,172.31.40.0-255,66,35768,76,371252
10208,0.000585,74.125.24.0-255,1484,37252,76,371252
10209,0.000587,172.31.40.0-255,66,37318,76,371252
10210,0.000609,74.125.24.0-255,4320,41638,76,371252
10211,0.000612,172.31.40.0-255,66,41704,76,371252
10212,0.000654,74.125.24.0-255,4320,46024,76,371252
10213,0.000658,172.31.40.0-255,66,46090,76,371252
10214,0.000677,74.125.24.0-255,2543,48633,76,371252
10215,0.000679,172.31.40.0-255,66,48699,76,371252
10216,0.001021,74.125.24.0-255,1484,50183,76,371252
10217,0.001027,172.31.40.0-255,66,50249,76,371252
10218,0.001034,74.125.24.0-255,2902,53151,76,371252
10219,0.001037,172.31.40.0-255,66,53217,76,371252
10220,0.001067,74.125.24.0-255,5738,58955,76,371252
10221,0.00107,172.31.40.0-255,66,59021,76,371252
10222,0.001094,74.125.24.0-255,5738,64759,76,371252
10223,0.001096,172.31.40.0-255,66,64825,76,371252
10224,0.001109,74.125.24.0-255,1705,66530,76,371252
10225,0.001111,172.31.40.0-255,66,66596,76,371252
10226,0.001227,74.125.24.0-255,1484,68080,76,371252
10227,0.001235,74.125.24.0-255,2902,70982,76,371252
10228,0.001238,172.31.40.0-255,66,71048,76,371252
10229,0.001245,74.125.24.0-255,4320,75368,76,371252
10230,0.001247,172.31.40.0-255,66,75434,76,371252
10231,0.001262,74.125.24.0-255,1484,76918,76,371252
10232,0.001304,74.125.24.0-255,6797,83715,76,371252
10233,0.001307,172.31.40.0-255,66,83781,76,371252
10234,0.001335,74.125.24.0-255,7156,90937,76,371252
10235,0.001339,172.31.40.0-255,66,91003,76,371252
10236,0.001384,172.31.40.0-255,66,91069,76,371252
10237,0.001741,74.125.24.0-255,1484,92553,76,371252
10238,0.001763,74.125.24.0-255,2902,95455,76,371252
10239,0.001769,172.31.40.0-255,66,95521,76,371252
10240,0.001773,74.125.24.0-255,1484,97005,76,371252
10241,0.001795,74.125.24.0-255,4320,101325,76,371252
10242,0.001798,172.31.40.0-255,66,101391,76,371252
10243,0.00181,172.31.40.0-255,66,101457,76,371252
10244,0.001825,74.125.24.0-255,2902,104359,76,371252
10245,0.001827,172.31.40.0-255,66,104425,76,371252
10246,0.001835,74.125.24.0-255,7156,111581,76,371252
10247,0.001838,172.31.40.0-255,66,111647,76,371252
10248,0.001869,74.125.24.0-255,3602,115249,76,371252
10249,0.001873,172.31.40.0-255,66,115315,76,371252
10250,0.001952,74.125.24.0-255,1484,116799,76,371252
10251,0.001958,74.125.24.0-255,2902,119701,76,371252
10252,0.001962,172.31.40.0-255,66,119767,76,371252
10253,0.001985,74.125.24.0-255,5738,125505,76,371252
10254,0.001988,172.31.40.0-255,66,125571,76,371252
10255,0.002028,74.125.24.0-255,1484,127055,76,371252
10256,0.002056,172.31.40.0-255,66,127121,76,371252
10257,0.002091,172.31.40.0-255,66,127187,76,371252
10258,0.004146,74.125.24.0-255,4320,131507,76,371252
10259,0.00415,172.31.40.0-255,66,131573,76,371252
10260,0.004168,74.125.24.0-255,1484,133057,76,371252
10261,0.006202,74.125.24.0-255,4320,137377,76,371252
10262,0.00621,172.31.40.0-255,66,137443,76,371252
10263,0.008314,74.125.24.0-255,5738,143181,76,371252
10264,0.00832,172.31.40.0-255,66,143247,76,371252
10265,0.010406,74.125.24.0-255,5738,148985,76,371252
10266,0.010414,172.31.40.0-255,66,149051,76,371252
10267,0.012509,74.125.24.0-255,5738,154789,76,371252
10268,0.012518,172.31.40.0-255,66,154855,76,371252
10269,0.014588,74.125.24.0-255,5738,160593,76,371252
10270,0.014597,172.31.40.0-255,66,160659,76,371252
10271,0.016651,74.125.24.0-255,5738,166397,76,371252
10272,0.016659,172.31.40.0-255,66,166463,76,371252
10273,0.018705,74.125.24.0-255,5738,172201,76,371252
10274,0.018714,172.31.40.0-255,66,172267,76,371252
10275,0.020802,74.125.24.0-255,5738,178005,76,371252
10276,0.020808,172.31.40.0-255,66,178071,76,371252
10277,0.022846,74.125.24.0-255,5738,183809,76,371252
10278,0.022853,172.31.40.0-255,66,183875,76,371252
10279,0.024908,74.125.24.0-255,5738,189613,76,371252
10280,0.024916,172.31.40.0-255,66,189679,76,371252
10281,0.026982,74.125.24.0-255,5738,195417,76,371252
10282,0.026989,172.31.40.0-255,66,195483,76,371252
10283,0.02821,172.31.40.0-255,172,195655,76,371252
10284,0.028242,172.31.40.0-255,1109,196764,76,371252
10285,0.028295,172.31.40.0-255,1514,198278,76,371252
10286,0.028297,172.31.40.0-255,1307,199585,76,371252
10287,0.029061,74.125.24.0-255,5738,205323,76,371252
10288,0.029068,172.31.40.0-255,66,205389,76,371252
10289,0.029778,104.244.42.0-255,66,205455,76,371252
10290,0.029814,104.244.42.0-255,66,205521,76,371252
10291,0.02984,104.244.42.0-255,66,205587,76,371252
10292,0.03116,74.125.24.0-255,5738,211325,76,371252
10293,0.031165,172.31.40.0-255,66,211391,76,371252
10294,0.033264,74.125.24.0-255,5738,217129,76,371252
10295,0.033271,172.31.40.0-255,66,217195,76,371252
10296,0.035348,74.125.24.0-255,5738,222933,76,371252
10297,0.035355,172.31.40.0-255,66,222999,76,371252
10298,0.037417,74.125.24.0-255,5738,228737,76,371252
10299,0.037424,172.31.40.0-255,66,228803,76,371252
10300,0.039486,74.125.24.0-255,5738,234541,76,371252
10301,0.039493,172.31.40.0-255,66,234607,76,371252
10302,0.041562,74.125.24.0-255,5738,240345,76,371252
10303,0.041571,172.31.40.0-255,66,240411,76,371252
10304,0.043628,74.125.24.0-255,5738,246149,76,371252
10305,0.043634,172.31.40.0-255,66,246215,76,371252
10306,0.04568,74.125.24.0-255,5738,251953,76,371252
10307,0.045687,172.31.40.0-255,66,252019,76,371252
10308,0.047756,74.125.24.0-255,5738,257757,76,371252
10309,0.047762,172.31.40.0-255,66,257823,76,371252
10310,0.049825,74.125.24.0-255,5738,263561,76,371252
10311,0.04983,172.31.40.0-255,66,263627,76,371252
10312,0.051909,74.125.24.0-255,5738,269365,76,371252
10313,0.051916,172.31.40.0-255,66,269431,76,371252
10314,0.054001,74.125.24.0-255,5738,275169,76,371252
10315,0.054007,172.31.40.0-255,66,275235,76,371252
10316,0.056065,74.125.24.0-255,5738,280973,76,371252
10317,0.056071,172.31.40.0-255,66,281039,76,371252
10318,0.058128,74.125.24.0-255,5738,286777,76,371252
10319,0.058135,172.31.40.0-255,66,286843,76,371252
10320,0.060208,74.125.24.0-255,5738,292581,76,371252
10321,0.060215,172.31.40.0-255,66,292647,76,371252
10322,0.062278,74.125.24.0-255,5738,298385,76,371252
10323,0.062284,172.31.40.0-255,66,298451,76,371252
10324,0.064342,74.125.24.0-255,5738,304189,76,371252
10325,0.064349,172.31.40.0-255,66,304255,76,371252
10326,0.06642,74.125.24.0-255,5738,309993,76,371252
10327,0.066426,172.31.40.0-255,66,310059,76,371252
10328,0.068494,74.125.24.0-255,5738,315797,76,371252
10329,0.068501,172.31.40.0-255,66,315863,76,371252
10330,0.070556,74.125.24.0-255,5738,321601,76,371252
10331,0.070565,172.31.40.0-255,66,321667,76,371252
10332,0.072625,74.125.24.0-255,5738,327405,76,371252
10333,0.072638,172.31.40.0-255,66,327471,76,371252
10334,0.074698,74.125.24.0-255,5738,333209,76,371252
10335,0.074705,172.31.40.0-255,66,333275,76,371252
10336,0.076797,74.125.24.0-255,5738,339013,76,371252
10337,0.076802,172.31.40.0-255,66,339079,76,371252
10338,0.078886,74.125.24.0-255,5738,344817,76,371252
10339,0.078893,172.31.40.0-255,66,344883,76,371252
10340,0.080952,74.125.24.0-255,5738,350621,76,371252
10341,0.080958,172.31.40.0-255,66,350687,76,371252
10342,0.083056,74.125.24.0-255,5738,356425,76,371252
10343,0.083061,172.31.40.0-255,66,356491,76,371252
10344,0.085129,74.125.24.0-255,5738,362229,76,371252
10345,0.085134,172.31.40.0-255,66,362295,76,371252
10346,0.087235,74.125.24.0-255,5738,368033,76,371252
10347,0.087241,172.31.40.0-255,66,368099,76,371252
10348,0.089314,74.125.24.0-255,2916,371015,76,371252
10349,0.089321,172.31.40.0-255,66,371081,76,371252
10350,0.089483,172.31.40.0-255,105,371186,76,371252
10351,0.091506,74.125.24.0-255,66,371252,76,371252
10352,0.0,74.125.200.0-255,146,146,76,309828
10353,1.5e-05,172.31.40.0-255,66,212,76,309828
10354,2.2e-05,74.125.200.0-255,1484,1696,76,309828
10355,2.6e-05,172.31.40.0-255,66,1762,76,309828
10356,3.1e-05,74.125.200.0-255,2902,4664,76,309828
10357,4e-05,172.31.40.0-255,66,4730,76,309828
10358,7.9e-05,74.125.200.0-255,5738,10468,76,309828
10359,8.2e-05,172.31.40.0-255,66,10534,76,309828
10360,0.000132,74.125.200.0-255,3481,14015,76,309828
10361,0.000135,172.31.40.0-255,66,14081,76,309828
10362,0.000583,74.125.200.0-255,1484,15565,76,309828
10363,0.000588,172.31.40.0-255,66,15631,76,309828
10364,0.000595,74.125.200.0-255,1484,17115,76,309828
10365,0.000598,172.31.40.0-255,66,17181,76,309828
10366,0.000615,74.125.200.0-255,1484,18665,76,309828
10367,0.000617,172.31.40.0-255,66,18731,76,309828
10368,0.000656,74.125.200.0-255,5738,24469,76,309828
10369,0.00066,172.31.40.0-255,66,24535,76,309828
10370,0.000668,74.125.200.0-255,6797,31332,76,309828
10371,0.000671,172.31.40.0-255,66,31398,76,309828
10372,0.000897,74.125.200.0-255,1484,32882,76,309828
10373,0.000902,172.31.40.0-255,66,32948,76,309828
10374,0.000956,74.125.200.0-255,2902,35850,76,309828
10375,0.00096,172.31.40.0-255,66,35916,76,309828
10376,0.000963,74.125.200.0-255,1484,37400,76,309828
10377,0.000965,172.31.40.0-255,66,37466,76,309828
10378,0.000969,74.125.200.0-255,2902,40368,76,309828
10379,0.000973,172.31.40.0-255,66,40434,76,309828
10380,0.000984,74.125.200.0-255,5738,46172,76,309828
10381,0.000987,172.31.40.0-255,66,46238,76,309828
10382,0.00099,74.125.200.0-255,1484,47722,76,309828
10383,0.000993,172.31.40.0-255,66,47788,76,309828
10384,0.001009,74.125.200.0-255,2543,50331,76,309828
10385,0.001016,172.31.40.0-255,66,50397,76,309828
10386,0.00106,74.125.200.0-255,2902,53299,76,309828
10387,0.001062,172.31.40.0-255,66,53365,76,309828
10388,0.00109,74.125.200.0-255,1484,54849,76,309828
10389,0.001133,74.125.200.0-255,2902,57751,76,309828
10390,0.001137,172.31.40.0-255,66,57817,76,309828
10391,0.001149,172.31.40.0-255,66,57883,76,309828
10392,0.001312,74.125.200.0-255,645,58528,76,309828
10393,0.001547,172.31.40.0-255,66,58594,76,309828
10394,0.002296,74.125.200.0-255,1484,60078,76,309828
10395,0.002304,74.125.200.0-255,2902,62980,76,309828
10396,0.002308,172.31.40.0-255,66,63046,76,309828
10397,0.003857,74.125.200.0-255,1484,64530,76,309828
10398,0.004612,74.125.200.0-255,4320,68850,76,309828
10399,0.004615,172.31.40.0-255,66,68916,76,309828
10400,0.006927,74.125.200.0-255,5738,74654,76,309828
10401,0.006932,172.31.40.0-255,66,74720,76,309828
10402,0.009237,74.125.200.0-255,5738,80458,76,309828
10403,0.009244,172.31.40.0-255,66,80524,76,309828
10404,0.011554,74.125.200.0-255,5738,86262,76,309828
10405,0.01156,172.31.40.0-255,66,86328,76,309828
10406,0.013887,74.125.200.0-255,5738,92066,76,309828
10407,0.013901,172.31.40.0-255,66,92132,76,309828
10408,0.01621,74.125.200.0-255,5738,97870,76,309828
10409,0.016217,172.31.40.0-255,66,97936,76,309828
10410,0.018516,74.125.200.0-255,5738,103674,76,309828
10411,0.018523,172.31.40.0-255,66,103740,76,309828
10412,0.020831,74.125.200.0-255,5738,109478,76,309828
10413,0.020839,172.31.40.0-255,66,109544,76,309828
10414,0.02314,74.125.200.0-255,5738,115282,76,309828
10415,0.023149,172.31.40.0-255,66,115348,76,309828
10416,0.025462,74.125.200.0-255,5738,121086,76,309828
10417,0.025469,172.31.40.0-255,66,121152,76,309828
10418,0.026435,172.31.40.0-255,172,121324,76,309828
10419,0.026467,172.31.40.0-255,1107,122431,76,309828
10420,0.026529,172.31.40.0-255,1514,123945,76,309828
10421,0.026531,172.31.40.0-255,1309,125254,76,309828
10422,0.027769,74.125.200.0-255,5738,130992,76,309828
10423,0.027776,172.31.40.0-255,66,131058,76,309828
10424,0.027983,104.244.42.0-255,66,131124,76,309828
10425,0.028031,104.244.42.0-255,66,131190,76,309828
10426,0.028076,104.244.42.0-255,66,131256,76,309828
10427,0.030088,74.125.200.0-255,5738,136994,76,309828
10428,0.030098,172.31.40.0-255,66,137060,76,309828
10429,0.0324,74.125.200.0-255,5738,142798,76,309828
10430,0.032408,172.31.40.0-255,66,142864,76,309828
10431,0.034718,74.125.200.0-255,5738,148602,76,309828
10432,0.034725,172.31.40.0-255,66,148668,76,309828
10433,0.037051,74.125.200.0-255,4320,152988,76,309828
10434,0.037059,172.31.40.0-255,66,153054,76,309828
10435,0.03709,74.125.200.0-255,1484,154538,76,309828
10436,0.039377,74.125.200.0-255,4320,158858,76,309828
10437,0.039386,172.31.40.0-255,66,158924,76,309828
10438,0.041692,74.125.200.0-255,5738,164662,76,309828
10439,0.041699,172.31.40.0-255,66,164728,76,309828
10440,0.044024,74.125.200.0-255,5738,170466,76,309828
10441,0.04403,172.31.40.0-255,66,170532,76,309828
10442,0.04633,74.125.200.0-255,5738,176270,76,309828
10443,0.046334,172.31.40.0-255,66,176336,76,309828
10444,0.048642,74.125.200.0-255,5738,182074,76,309828
10445,0.048649,172.31.40.0-255,66,182140,76,309828
10446,0.050963,74.125.200.0-255,5738,187878,76,309828
10447,0.05097,172.31.40.0-255,66,187944,76,309828
10448,0.053271,74.125.200.0-255,5738,193682,76,309828
10449,0.053279,172.31.40.0-255,66,193748,76,309828
10450,0.055577,74.125.200.0-255,5738,199486,76,309828
10451,0.055584,172.31.40.0-255,66,199552,76,309828
10452,0.057897,74.125.200.0-255,5738,205290,76,309828
10453,0.057904,172.31.40.0-255,66,205356,76,309828
10454,0.060214,74.125.200.0-255,5738,211094,76,309828
10455,0.060222,172.31.40.0-255,66,211160,76,309828
10456,0.062541,74.125.200.0-255,5738,216898,76,309828
10457,0.062547,172.31.40.0-255,66,216964,76,309828
10458,0.064857,74.125.200.0-255,5738,222702,76,309828
10459,0.064863,172.31.40.0-255,66,222768,76,309828
10460,0.067169,74.125.200.0-255,5738,228506,76,309828
10461,0.067176,172.31.40.0-255,66,228572,76,309828
10462,0.069491,74.125.200.0-255,5738,234310,76,309828
10463,0.069498,172.31.40.0-255,66,234376,76,309828
10464,0.071809,74.125.200.0-255,5738,240114,76,309828
10465,0.071817,172.31.40.0-255,66,240180,76,309828
10466,0.074135,74.125.200.0-255,5738,245918,76,309828
10467,0.074141,172.31.40.0-255,66,245984,76,309828
10468,0.076451,74.125.200.0-255,5738,251722,76,309828
10469,0.076457,172.31.40.0-255,66,251788,76,309828
10470,0.078777,74.125.200.0-255,5738,257526,76,309828
10471,0.078787,172.31.40.0-255,66,257592,76,309828
10472,0.081097,74.125.200.0-255,5738,263330,76,309828
10473,0.081103,172.31.40.0-255,66,263396,76,309828
10474,0.083415,74.125.200.0-255,5738,269134,76,309828
10475,0.083421,172.31.40.0-255,66,269200,76,309828
10476,0.08573,74.125.200.0-255,5738,274938,76,309828
10477,0.085735,172.31.40.0-255,66,275004,76,309828
10478,0.088044,74.125.200.0-255,5738,280742,76,309828
10479,0.088051,172.31.40.0-255,66,280808,76,309828
10480,0.090364,74.125.200.0-255,5738,286546,76,309828
10481,0.090371,172.31.40.0-255,66,286612,76,309828
10482,0.092687,74.125.200.0-255,5738,292350,76,309828
10483,0.092693,172.31.40.0-255,66,292416,76,309828
10484,0.095008,74.125.200.0-255,5738,298154,76,309828
10485,0.095015,172.31.40.0-255,66,298220,76,309828
10486,0.097339,74.125.200.0-255,5738,303958,76,309828
10487,0.097346,172.31.40.0-255,66,304024,76,309828
10488,0.099696,74.125.200.0-255,5738,309762,76,309828
10489,0.099702,172.31.40.0-255,66,309828,76,309828
10490,0.0,74.125.24.0-255,154,154,76,339376
10491,3.3e-05,172.31.40.0-255,66,220,76,339376
10492,4e-05,74.125.24.0-255,1484,1704,76,339376
10493,4.5e-05,172.31.40.0-255,66,1770,76,339376
10494,5e-05,74.125.24.0-255,2902,4672,76,339376
10495,6e-05,172.31.40.0-255,66,4738,76,339376
10496,6.5e-05,74.125.24.0-255,4320,9058,76,339376
10497,6.8e-05,172.31.40.0-255,66,9124,76,339376
10498,0.000114,172.31.40.0-255,66,9190,76,339376
10499,0.000119,74.125.24.0-255,2902,12092,76,339376
10500,0.000121,172.31.40.0-255,66,12158,76,339376
10501,0.000157,74.125.24.0-255,7156,19314,76,339376
10502,0.00016,172.31.40.0-255,66,19380,76,339376
10503,0.000165,74.125.24.0-255,2543,21923,76,339376
10504,0.000167,172.31.40.0-255,66,21989,76,339376
10505,0.000813,74.125.24.0-255,1484,23473,76,339376
10506,0.000818,172.31.40.0-255,66,23539,76,339376
10507,0.000828,74.125.24.0-255,2902,26441,76,339376
10508,0.00083,172.31.40.0-255,66,26507,76,339376
10509,0.000845,74.125.24.0-255,5738,32245,76,339376
10510,0.000847,172.31.40.0-255,66,32311,76,339376
10511,0.000881,74.125.24.0-255,6797,39108,76,339376
10512,0.000884,172.31.40.0-255,66,39174,76,339376
10513,0.000903,172.31.40.0-255,66,39240,76,339376
10514,0.000934,74.125.24.0-255,1484,40724,76,339376
10515,0.000937,172.31.40.0-255,66,40790,76,339376
10516,0.000942,74.125.24.0-255,2819,43609,76,339376
10517,0.000945,172.31.40.0-255,66,43675,76,339376
10518,0.000994,74.125.24.0-255,132,43807,76,339376
10519,0.000998,172.31.40.0-255,66,43873,76,339376
10520,0.001115,74.125.24.0-255,1484,45357,76,339376
10521,0.001123,74.125.24.0-255,2902,48259,76,339376
10522,0.001128,172.31.40.0-255,66,48325,76,339376
10523,0.001133,74.125.24.0-255,2902,51227,76,339376
10524,0.001135,172.31.40.0-255,66,51293,76,339376
10525,0.001164,74.125.24.0-255,2902,54195,76,339376
10526,0.00117,172.31.40.0-255,66,54261,76,339376
10527,0.001177,74.125.24.0-255,6797,61058,76,339376
10528,0.00118,172.31.40.0-255,66,61124,76,339376
10529,0.001185,74.125.24.0-255,4320,65444,76,339376
10530,0.001188,172.31.40.0-255,66,65510,76,339376
10531,0.001215,74.125.24.0-255,2902,68412,76,339376
10532,0.001219,172.31.40.0-255,66,68478,76,339376
10533,0.001233,172.31.40.0-255,66,68544,76,339376
10534,0.00194,74.125.24.0-255,1484,70028,76,339376
10535,0.001963,74.125.24.0-255,2902,72930,76,339376
10536,0.001967,172.31.40.0-255,66,72996,76,339376
10537,0.001974,74.125.24.0-255,5738,78734,76,339376
10538,0.001976,172.31.40.0-255,66,78800,76,339376
10539,0.001987,74.125.24.0-255,5738,84538,76,339376
10540,0.001989,172.31.40.0-255,66,84604,76,339376
10541,0.002033,172.31.40.0-255,66,84670,76,339376
10542,0.002039,74.125.24.0-255,5020,89690,76,339376
10543,0.002041,172.31.40.0-255,66,89756,76,339376
10544,0.004325,74.125.24.0-255,5738,95494,76,339376
10545,0.004332,172.31.40.0-255,66,95560,76,339376
10546,0.006643,74.125.24.0-255,5738,101298,76,339376
10547,0.006652,172.31.40.0-255,66,101364,76,339376
10548,0.008956,74.125.24.0-255,5738,107102,76,339376
10549,0.008965,172.31.40.0-255,66,107168,76,339376
10550,0.011253,74.125.24.0-255,5738,112906,76,339376
10551,0.011261,172.31.40.0-255,66,112972,76,339376
10552,0.013546,74.125.24.0-255,5738,118710,76,339376
10553,0.013559,172.31.40.0-255,66,118776,76,339376
10554,0.015852,74.125.24.0-255,5738,124514,76,339376
10555,0.015865,172.31.40.0-255,66,124580,76,339376
10556,0.018148,74.125.24.0-255,5738,130318,76,339376
10557,0.018157,172.31.40.0-255,66,130384,76,339376
10558,0.020452,74.125.24.0-255,5738,136122,76,339376
10559,0.020464,172.31.40.0-255,66,136188,76,339376
10560,0.022757,74.125.24.0-255,5738,141926,76,339376
10561,0.022768,172.31.40.0-255,66,141992,76,339376
10562,0.02508,74.125.24.0-255,5738,147730,76,339376
10563,0.025088,172.31.40.0-255,66,147796,76,339376
10564,0.025253,172.31.40.0-255,172,147968,76,339376
10565,0.025288,172.31.40.0-255,1107,149075,76,339376
10566,0.025391,172.31.40.0-255,1514,150589,76,339376
10567,0.025418,172.31.40.0-255,1309,151898,76,339376
10568,0.02677,104.244.42.0-255,66,151964,76,339376
10569,0.026823,104.244.42.0-255,66,152030,76,339376
10570,0.026951,104.244.42.0-255,66,152096,76,339376
10571,0.027372,74.125.24.0-255,1484,153580,76,339376
10572,0.027406,74.125.24.0-255,4320,157900,76,339376
10573,0.027411,172.31.40.0-255,66,157966,76,339376
10574,0.029672,74.125.24.0-255,5738,163704,76,339376
10575,0.029678,172.31.40.0-255,66,163770,76,339376
10576,0.03198,74.125.24.0-255,2902,166672,76,339376
10577,0.031986,172.31.40.0-255,66,166738,76,339376
10578,0.032018,74.125.24.0-255,2902,169640,76,339376
10579,0.032021,172.31.40.0-255,66,169706,76,339376
10580,0.034239,74.125.24.0-255,2902,172608,76,339376
10581,0.034244,172.31.40.0-255,66,172674,76,339376
10582,0.034317,74.125.24.0-255,2902,175576,76,339376
10583,0.034322,172.31.40.0-255,66,175642,76,339376
10584,0.036579,74.125.24.0-255,5738,181380,76,339376
10585,0.036585,172.31.40.0-255,66,181446,76,339376
10586,0.038851,74.125.24.0-255,4320,185766,76,339376
10587,0.038856,172.31.40.0-255,66,185832,76,339376
10588,0.038887,74.125.24.0-255,1484,187316,76,339376
10589,0.04113,74.125.24.0-255,4320,191636,76,339376
10590,0.041133,172.31.40.0-255,66,191702,76,339376
10591,0.043428,74.125.24.0-255,5738,197440,76,339376
10592,0.043433,172.31.40.0-255,66,197506,76,339376
10593,0.045728,74.125.24.0-255,5738,203244,76,339376
10594,0.045733,172.31.40.0-255,66,203310,76,339376
10595,0.048031,74.125.24.0-255,5738,209048,76,339376
10596,0.048038,172.31.40.0-255,66,209114,76,339376
10597,0.050318,74.125.24.0-255,5738,214852,76,339376
10598,0.050324,172.31.40.0-255,66,214918,76,339376
10599,0.05265,74.125.24.0-255,5738,220656,76,339376
10600,0.052655,172.31.40.0-255,66,220722,76,339376
10601,0.054923,74.125.24.0-255,5738,226460,76,339376
10602,0.054927,172.31.40.0-255,66,226526,76,339376
10603,0.057203,74.125.24.0-255,2902,229428,76,339376
10604,0.057208,172.31.40.0-255,66,229494,76,339376
10605,0.057242,74.125.24.0-255,2902,232396,76,339376
10606,0.057245,172.31.40.0-255,66,232462,76,339376
10607,0.059502,74.125.24.0-255,2902,235364,76,339376
10608,0.059508,172.31.40.0-255,66,235430,76,339376
10609,0.059548,74.125.24.0-255,2902,238332,76,339376
10610,0.059551,172.31.40.0-255,66,238398,76,339376
10611,0.061797,74.125.24.0-255,2902,241300,76,339376
10612,0.061802,172.31.40.0-255,66,241366,76,339376
10613,0.061831,74.125.24.0-255,1484,242850,76,339376
10614,0.061842,74.125.24.0-255,1484,244334,76,339376
10615,0.061845,172.31.40.0-255,66,244400,76,339376
10616,0.064087,74.125.24.0-255,2902,247302,76,339376
10617,0.064092,172.31.40.0-255,66,247368,76,339376
10618,0.064123,74.125.24.0-255,2902,250270,76,339376
10619,0.064126,172.31.40.0-255,66,250336,76,339376
10620,0.066408,74.125.24.0-255,5738,256074,76,339376
10621,0.066413,172.31.40.0-255,66,256140,76,339376
10622,0.068721,74.125.24.0-255,5738,261878,76,339376
10623,0.068728,172.31.40.0-255,66,261944,76,339376
10624,0.071045,74.125.24.0-255,2902,264846,76,339376
10625,0.071052,172.31.40.0-255,66,264912,76,339376
10626,0.071083,74.125.24.0-255,2902,267814,76,339376
10627,0.071086,172.31.40.0-255,66,267880,76,339376
10628,0.073352,74.125.24.0-255,2902,270782,76,339376
10629,0.073357,172.31.40.0-255,66,270848,76,339376
10630,0.073411,74.125.24.0-255,2902,273750,76,339376
10631,0.073415,172.31.40.0-255,66,273816,76,339376
10632,0.075633,74.125.24.0-255,2902,276718,76,339376
10633,0.075638,172.31.40.0-255,66,276784,76,339376
10634,0.075671,74.125.24.0-255,1484,278268,76,339376
10635,0.075689,74.125.24.0-255,1484,279752,76,339376
10636,0.075692,172.31.40.0-255,66,279818,76,339376
10637,0.077919,74.125.24.0-255,2902,282720,76,339376
10638,0.077925,172.31.40.0-255,66,282786,76,339376
10639,0.078015,74.125.24.0-255,2902,285688,76,339376
10640,0.07802,172.31.40.0-255,66,285754,76,339376
10641,0.080218,74.125.24.0-255,2902,288656,76,339376
10642,0.080223,172.31.40.0-255,66,288722,76,339376
10643,0.080277,74.125.24.0-255,1484,290206,76,339376
10644,0.080294,74.125.24.0-255,1484,291690,76,339376
10645,0.080298,172.31.40.0-255,66,291756,76,339376
10646,0.082519,74.125.24.0-255,2902,294658,76,339376
10647,0.082524,172.31.40.0-255,66,294724,76,339376
10648,0.082588,74.125.24.0-255,2902,297626,76,339376
10649,0.082594,172.31.40.0-255,66,297692,76,339376
10650,0.084834,74.125.24.0-255,2902,300594,76,339376
10651,0.08484,172.31.40.0-255,66,300660,76,339376
10652,0.084888,74.125.24.0-255,2902,303562,76,339376
10653,0.084891,172.31.40.0-255,66,303628,76,339376
10654,0.087153,74.125.24.0-255,2902,306530,76,339376
10655,0.087162,172.31.40.0-255,66,306596,76,339376
10656,0.087194,74.125.24.0-255,2902,309498,76,339376
10657,0.087198,172.31.40.0-255,66,309564,76,339376
10658,0.089462,74.125.24.0-255,2902,312466,76,339376
10659,0.089469,172.31.40.0-255,66,312532,76,339376
10660,0.089504,74.125.24.0-255,2902,315434,76,339376
10661,0.089507,172.31.40.0-255,66,315500,76,339376
10662,0.091732,74.125.24.0-255,2902,318402,76,339376
10663,0.091738,172.31.40.0-255,66,318468,76,339376
10664,0.091799,74.125.24.0-255,2902,321370,76,339376
10665,0.091803,172.31.40.0-255,66,321436,76,339376
10666,0.094019,74.125.24.0-255,2902,324338,76,339376
10667,0.094023,172.31.40.0-255,66,324404,76,339376
10668,0.094068,74.125.24.0-255,1484,325888,76,339376
10669,0.094078,74.125.24.0-255,1484,327372,76,339376
10670,0.094081,172.31.40.0-255,66,327438,76,339376
10671,0.096334,74.125.24.0-255,2902,330340,76,339376
10672,0.096339,172.31.40.0-255,66,330406,76,339376
10673,0.096382,74.125.24.0-255,1484,331890,76,339376
10674,0.0964,74.125.24.0-255,1484,333374,76,339376
10675,0.096403,172.31.40.0-255,66,333440,76,339376
10676,0.09861,74.125.24.0-255,2902,336342,76,339376
10677,0.098615,172.31.40.0-255,66,336408,76,339376
10678,0.098667,74.125.24.0-255,2902,339310,76,339376
10679,0.098672,172.31.40.0-255,66,339376,76,339376
10680,0.0,172.31.40.0-255,66,66,76,66
10681,0.0,142.250.4.0-255,153,153,76,391161
10682,2.3e-05,172.31.40.0-255,66,219,76,391161
10683,2.9e-05,142.250.4.0-255,1484,1703,76,391161
10684,3.4e-05,172.31.40.0-255,66,1769,76,391161
10685,4.8e-05,142.250.4.0-255,2902,4671,76,391161
10686,5.2e-05,172.31.40.0-255,66,4737,76,391161
10687,6e-05,142.250.4.0-255,7156,11893,76,391161
10688,6.3e-05,172.31.40.0-255,66,11959,76,391161
10689,6.7e-05,142.250.4.0-255,2054,14013,76,391161
10690,6.9e-05,172.31.40.0-255,66,14079,76,391161
10691,0.000129,142.250.4.0-255,1484,15563,76,391161
10692,0.000132,172.31.40.0-255,66,15629,76,391161
10693,0.000137,142.250.4.0-255,2902,18531,76,391161
10694,0.000139,172.31.40.0-255,66,18597,76,391161
10695,0.000165,142.250.4.0-255,5738,24335,76,391161
10696,0.000168,172.31.40.0-255,66,24401,76,391161
10697,0.000178,142.250.4.0-255,6797,31198,76,391161
10698,0.000181,172.31.40.0-255,66,31264,76,391161
10699,0.000213,142.250.4.0-255,4320,35584,76,391161
10700,0.000216,172.31.40.0-255,66,35650,76,391161
10701,0.000259,172.31.40.0-255,66,35716,76,391161
10702,0.000263,142.250.4.0-255,2543,38259,76,391161
10703,0.000265,172.31.40.0-255,66,38325,76,391161
10704,0.000732,142.250.4.0-255,1484,39809,76,391161
10705,0.000738,172.31.40.0-255,66,39875,76,391161
10706,0.000744,142.250.4.0-255,2902,42777,76,391161
10707,0.000747,172.31.40.0-255,66,42843,76,391161
10708,0.000777,142.250.4.0-255,4320,47163,76,391161
10709,0.000779,172.31.40.0-255,66,47229,76,391161
10710,0.000811,142.250.4.0-255,1484,48713,76,391161
10711,0.000813,172.31.40.0-255,66,48779,76,391161
10712,0.000821,142.250.4.0-255,6797,55576,76,391161
10713,0.000823,172.31.40.0-255,66,55642,76,391161
10714,0.000826,142.250.4.0-255,646,56288,76,391161
10715,0.000886,142.250.4.0-255,1484,57772,76,391161
10716,0.00089,172.31.40.0-255,66,57838,76,391161
10717,0.000895,142.250.4.0-255,2902,60740,76,391161
10718,0.000897,172.31.40.0-255,66,60806,76,391161
10719,0.0009,142.250.4.0-255,1484,62290,76,391161
10720,0.000947,142.250.4.0-255,4320,66610,76,391161
10721,0.000979,172.31.40.0-255,66,66676,76,391161
10722,0.000987,142.250.4.0-255,1484,68160,76,391161
10723,0.001044,172.31.40.0-255,66,68226,76,391161
10724,0.001107,142.250.4.0-255,1484,69710,76,391161
10725,0.001112,142.250.4.0-255,2902,72612,76,391161
10726,0.001115,172.31.40.0-255,66,72678,76,391161
10727,0.00112,142.250.4.0-255,2902,75580,76,391161
10728,0.001145,172.31.40.0-255,66,75646,76,391161
10729,0.00115,142.250.4.0-255,2902,78548,76,391161
10730,0.001155,142.250.4.0-255,4320,82868,76,391161
10731,0.001173,172.31.40.0-255,66,82934,76,391161
10732,0.001186,142.250.4.0-255,2011,84945,76,391161
10733,0.001215,172.31.40.0-255,66,85011,76,391161
10734,0.00141,142.250.4.0-255,1484,86495,76,391161
10735,0.001417,142.250.4.0-255,2902,89397,76,391161
10736,0.00142,172.31.40.0-255,66,89463,76,391161
10737,0.001446,142.250.4.0-255,5738,95201,76,391161
10738,0.001451,172.31.40.0-255,66,95267,76,391161
10739,0.001471,142.250.4.0-255,7156,102423,76,391161
10740,0.00149,142.250.4.0-255,2902,105325,76,391161
10741,0.001498,142.250.4.0-255,7156,112481,76,391161
10742,0.001505,172.31.40.0-255,66,112547,76,391161
10743,0.001522,142.250.4.0-255,1484,114031,76,391161
10744,0.001542,142.250.4.0-255,2902,116933,76,391161
10745,0.001549,172.31.40.0-255,66,116999,76,391161
10746,0.001557,142.250.4.0-255,2184,119183,76,391161
10747,0.001566,172.31.40.0-255,66,119249,76,391161
10748,0.001771,142.250.4.0-255,1484,120733,76,391161
10749,0.001787,142.250.4.0-255,2902,123635,76,391161
10750,0.00179,172.31.40.0-255,66,123701,76,391161
10751,0.001813,142.250.4.0-255,5738,129439,76,391161
10752,0.001838,142.250.4.0-255,5738,135177,76,391161
10753,0.001849,172.31.40.0-255,66,135243,76,391161
10754,0.00187,142.250.4.0-255,7156,142399,76,391161
10755,0.001876,142.250.4.0-255,5738,148137,76,391161
10756,0.001897,172.31.40.0-255,66,148203,76,391161
10757,0.001931,142.250.4.0-255,2902,151105,76,391161
10758,0.001947,142.250.4.0-255,2184,153289,76,391161
10759,0.00195,172.31.40.0-255,66,153355,76,391161
10760,0.001955,172.31.40.0-255,66,153421,76,391161
10761,0.004129,142.250.4.0-255,5738,159159,76,391161
10762,0.004136,172.31.40.0-255,66,159225,76,391161
10763,0.006321,142.250.4.0-255,5738,164963,76,391161
10764,0.006329,172.31.40.0-255,66,165029,76,391161
10765,0.008516,142.250.4.0-255,4320,169349,76,391161
10766,0.008521,172.31.40.0-255,66,169415,76,391161
10767,0.008547,142.250.4.0-255,1484,170899,76,391161
10768,0.010705,142.250.4.0-255,4320,175219,76,391161
10769,0.010712,172.31.40.0-255,66,175285,76,391161
10770,0.012893,142.250.4.0-255,5738,181023,76,391161
10771,0.012901,172.31.40.0-255,66,181089,76,391161
10772,0.015101,142.250.4.0-255,5738,186827,76,391161
10773,0.015111,172.31.40.0-255,66,186893,76,391161
10774,0.017322,142.250.4.0-255,5738,192631,76,391161
10775,0.01733,172.31.40.0-255,66,192697,76,391161
10776,0.019518,142.250.4.0-255,5738,198435,76,391161
10777,0.019525,172.31.40.0-255,66,198501,76,391161
10778,0.021719,142.250.4.0-255,5738,204239,76,391161
10779,0.021725,172.31.40.0-255,66,204305,76,391161
10780,0.023954,142.250.4.0-255,5738,210043,76,391161
10781,0.023962,172.31.40.0-255,66,210109,76,391161
10782,0.026149,142.250.4.0-255,5738,215847,76,391161
10783,0.026157,172.31.40.0-255,66,215913,76,391161
10784,0.028047,172.31.40.0-255,172,216085,76,391161
10785,0.028077,172.31.40.0-255,1105,217190,76,391161
10786,0.028135,172.31.40.0-255,1514,218704,76,391161
10787,0.028137,172.31.40.0-255,1313,220017,76,391161
10788,0.028339,142.250.4.0-255,5738,225755,76,391161
10789,0.028346,172.31.40.0-255,66,225821,76,391161
10790,0.029696,104.244.42.0-255,66,225887,76,391161
10791,0.029744,104.244.42.0-255,66,225953,76,391161
10792,0.029844,104.244.42.0-255,66,226019,76,391161
10793,0.030531,142.250.4.0-255,5738,231757,76,391161
10794,0.030536,172.31.40.0-255,66,231823,76,391161
10795,0.032743,142.250.4.0-255,5738,237561,76,391161
10796,0.032749,172.31.40.0-255,66,237627,76,391161
10797,0.034945,142.250.4.0-255,5738,243365,76,391161
10798,0.034951,172.31.40.0-255,66,243431,76,391161
10799,0.037141,142.250.4.0-255,5738,249169,76,391161
10800,0.037148,172.31.40.0-255,66,249235,76,391161
10801,0.039339,142.250.4.0-255,5738,254973,76,391161
10802,0.039345,172.31.40.0-255,66,255039,76,391161
10803,0.041526,142.250.4.0-255,5738,260777,76,391161
10804,0.041532,172.31.40.0-255,66,260843,76,391161
10805,0.043713,142.250.4.0-255,5738,266581,76,391161
10806,0.043718,172.31.40.0-255,66,266647,76,391161
10807,0.045929,142.250.4.0-255,5738,272385,76,391161
10808,0.045938,172.31.40.0-255,66,272451,76,391161
10809,0.048128,142.250.4.0-255,5738,278189,76,391161
10810,0.048134,172.31.40.0-255,66,278255,76,391161
10811,0.050317,142.250.4.0-255,5738,283993,76,391161
10812,0.050324,172.31.40.0-255,66,284059,76,391161
10813,0.052521,142.250.4.0-255,5738,289797,76,391161
10814,0.052528,172.31.40.0-255,66,289863,76,391161
10815,0.054723,142.250.4.0-255,2902,292765,76,391161
10816,0.05473,172.31.40.0-255,66,292831,76,391161
10817,0.05476,142.250.4.0-255,2902,295733,76,391161
10818,0.054763,172.31.40.0-255,66,295799,76,391161
10819,0.056913,142.250.4.0-255,2902,298701,76,391161
10820,0.056932,172.31.40.0-255,66,298767,76,391161
10821,0.056961,142.250.4.0-255,2902,301669,76,391161
10822,0.056964,172.31.40.0-255,66,301735,76,391161
10823,0.059123,142.250.4.0-255,2902,304637,76,391161
10824,0.059129,172.31.40.0-255,66,304703,76,391161
10825,0.059159,142.250.4.0-255,2902,307605,76,391161
10826,0.059162,172.31.40.0-255,66,307671,76,391161
10827,0.061345,142.250.4.0-255,2902,310573,76,391161
10828,0.061351,172.31.40.0-255,66,310639,76,391161
10829,0.061384,142.250.4.0-255,2902,313541,76,391161
10830,0.061388,172.31.40.0-255,66,313607,76,391161
10831,0.063537,142.250.4.0-255,2902,316509,76,391161
10832,0.063544,172.31.40.0-255,66,316575,76,391161
10833,0.063575,142.250.4.0-255,2902,319477,76,391161
10834,0.063577,172.31.40.0-255,66,319543,76,391161
10835,0.065744,142.250.4.0-255,2902,322445,76,391161
10836,0.06575,172.31.40.0-255,66,322511,76,391161
10837,0.065782,142.250.4.0-255,2902,325413,76,391161
10838,0.065785,172.31.40.0-255,66,325479,76,391161
10839,0.067939,142.250.4.0-255,2902,328381,76,391161
10840,0.067946,172.31.40.0-255,66,328447,76,391161
10841,0.067969,142.250.4.0-255,2902,331349,76,391161
10842,0.067972,172.31.40.0-255,66,331415,76,391161
10843,0.070136,142.250.4.0-255,2902,334317,76,391161
10844,0.070143,172.31.40.0-255,66,334383,76,391161
10845,0.070171,142.250.4.0-255,2902,337285,76,391161
10846,0.070173,172.31.40.0-255,66,337351,76,391161
10847,0.072331,142.250.4.0-255,2902,340253,76,391161
10848,0.072338,172.31.40.0-255,66,340319,76,391161
10849,0.072371,142.250.4.0-255,2902,343221,76,391161
10850,0.072374,172.31.40.0-255,66,343287,76,391161
10851,0.074527,142.250.4.0-255,2902,346189,76,391161
10852,0.074534,172.31.40.0-255,66,346255,76,391161
10853,0.074565,142.250.4.0-255,2902,349157,76,391161
10854,0.074568,172.31.40.0-255,66,349223,76,391161
10855,0.076716,142.250.4.0-255,2902,352125,76,391161
10856,0.076723,172.31.40.0-255,66,352191,76,391161
10857,0.076755,142.250.4.0-255,2902,355093,76,391161
10858,0.076758,172.31.40.0-255,66,355159,76,391161
10859,0.078911,142.250.4.0-255,2902,358061,76,391161
10860,0.078918,172.31.40.0-255,66,358127,76,391161
10861,0.078951,142.250.4.0-255,2902,361029,76,391161
10862,0.078954,172.31.40.0-255,66,361095,76,391161
10863,0.081112,142.250.4.0-255,2902,363997,76,391161
10864,0.081119,172.31.40.0-255,66,364063,76,391161
10865,0.081145,142.250.4.0-255,2902,366965,76,391161
10866,0.081148,172.31.40.0-255,66,367031,76,391161
10867,0.083307,142.250.4.0-255,2902,369933,76,391161
10868,0.083313,172.31.40.0-255,66,369999,76,391161
10869,0.083335,142.250.4.0-255,2902,372901,76,391161
10870,0.083338,172.31.40.0-255,66,372967,76,391161
10871,0.085497,142.250.4.0-255,2902,375869,76,391161
10872,0.085504,172.31.40.0-255,66,375935,76,391161
10873,0.085532,142.250.4.0-255,2902,378837,76,391161
10874,0.085535,172.31.40.0-255,66,378903,76,391161
10875,0.087699,142.250.4.0-255,2902,381805,76,391161
10876,0.087706,172.31.40.0-255,66,381871,76,391161
10877,0.087734,142.250.4.0-255,2902,384773,76,391161
10878,0.087737,172.31.40.0-255,66,384839,76,391161
10879,0.089892,142.250.4.0-255,2902,387741,76,391161
10880,0.089899,172.31.40.0-255,66,387807,76,391161
10881,0.089931,142.250.4.0-255,2902,390709,76,391161
10882,0.089934,172.31.40.0-255,66,390775,76,391161
10883,0.092062,142.250.4.0-255,149,390924,76,391161
10884,0.092183,172.31.40.0-255,66,390990,76,391161
10885,0.092214,172.31.40.0-255,105,391095,76,391161
10886,0.094342,142.250.4.0-255,66,391161,76,391161
10887,0.0,172.217.194.0-255,153,153,76,183911
10888,2.2e-05,172.31.40.0-255,66,219,76,183911
10889,3e-05,172.217.194.0-255,1484,1703,76,183911
10890,3.4e-05,172.31.40.0-255,66,1769,76,183911
10891,4e-05,172.217.194.0-255,2902,4671,76,183911
10892,4.4e-05,172.31.40.0-255,66,4737,76,183911
10893,5.9e-05,172.217.194.0-255,7156,11893,76,183911
10894,6.2e-05,172.31.40.0-255,66,11959,76,183911
10895,9e-05,172.217.194.0-255,2032,13991,76,183911
10896,9.3e-05,172.31.40.0-255,66,14057,76,183911
10897,0.000134,172.217.194.0-255,1484,15541,76,183911
10898,0.000137,172.31.40.0-255,66,15607,76,183911
10899,0.00014,172.217.194.0-255,1484,17091,76,183911
10900,0.000143,172.31.40.0-255,66,17157,76,183911
10901,0.000175,172.217.194.0-255,1484,18641,76,183911
10902,0.000177,172.31.40.0-255,66,18707,76,183911
10903,0.000183,172.217.194.0-255,5738,24445,76,183911
10904,0.000186,172.31.40.0-255,66,24511,76,183911
10905,0.000197,172.217.194.0-255,6797,31308,76,183911
10906,0.0002,172.31.40.0-255,66,31374,76,183911
10907,0.000205,172.217.194.0-255,4320,35694,76,183911
10908,0.000209,172.31.40.0-255,66,35760,76,183911
10909,0.000272,172.217.194.0-255,2510,38270,76,183911
10910,0.000281,172.31.40.0-255,66,38336,76,183911
10911,0.000284,172.31.40.0-255,66,38402,76,183911
10912,0.000287,172.31.40.0-255,66,38468,76,183911
10913,0.00053,172.217.194.0-255,381,38849,76,183911
10914,0.000536,172.31.40.0-255,66,38915,76,183911
10915,0.000664,172.217.194.0-255,1484,40399,76,183911
10916,0.000667,172.31.40.0-255,66,40465,76,183911
10917,0.000673,172.217.194.0-255,2902,43367,76,183911
10918,0.000676,172.31.40.0-255,66,43433,76,183911
10919,0.000724,172.217.194.0-255,5738,49171,76,183911
10920,0.000728,172.31.40.0-255,66,49237,76,183911
10921,0.000741,172.31.40.0-255,66,49303,76,183911
10922,0.000762,172.217.194.0-255,1484,50787,76,183911
10923,0.000781,172.31.40.0-255,66,50853,76,183911
10924,0.000784,172.217.194.0-255,766,51619,76,183911
10925,0.001102,172.217.194.0-255,1484,53103,76,183911
10926,0.001106,172.31.40.0-255,66,53169,76,183911
10927,0.001113,172.217.194.0-255,2902,56071,76,183911
10928,0.001115,172.31.40.0-255,66,56137,76,183911
10929,0.001121,172.217.194.0-255,5738,61875,76,183911
10930,0.001123,172.31.40.0-255,66,61941,76,183911
10931,0.001132,172.217.194.0-255,2902,64843,76,183911
10932,0.001135,172.31.40.0-255,66,64909,76,183911
10933,0.001181,172.31.40.0-255,66,64975,76,183911
10934,0.001198,172.31.40.0-255,66,65041,76,183911
10935,0.001504,172.217.194.0-255,1484,66525,76,183911
10936,0.001539,172.217.194.0-255,2902,69427,76,183911
10937,0.001542,172.31.40.0-255,66,69493,76,183911
10938,0.001548,172.217.194.0-255,4320,73813,76,183911
10939,0.001551,172.31.40.0-255,66,73879,76,183911
10940,0.001576,172.217.194.0-255,1484,75363,76,183911
10941,0.001587,172.31.40.0-255,66,75429,76,183911
10942,0.001599,172.31.40.0-255,66,75495,76,183911
10943,0.001635,172.217.194.0-255,5020,80515,76,183911
10944,0.001638,172.31.40.0-255,66,80581,76,183911
10945,0.001642,172.217.194.0-255,1484,82065,76,183911
10946,0.001672,172.217.194.0-255,4320,86385,76,183911
10947,0.001674,172.31.40.0-255,66,86451,76,183911
10948,0.001685,172.31.40.0-255,66,86517,76,183911
10949,0.001701,172.217.194.0-255,2902,89419,76,183911
10950,0.001703,172.31.40.0-255,66,89485,76,183911
10951,0.001752,172.31.40.0-255,66,89551,76,183911
10952,0.001755,172.217.194.0-255,766,90317,76,183911
10953,0.001807,172.217.194.0-255,1484,91801,76,183911
10954,0.00181,172.31.40.0-255,66,91867,76,183911
10955,0.001832,172.217.194.0-255,2902,94769,76,183911
10956,0.001836,172.31.40.0-255,66,94835,76,183911
10957,0.001841,172.217.194.0-255,4320,99155,76,183911
10958,0.001844,172.31.40.0-255,66,99221,76,183911
10959,0.001858,172.217.194.0-255,1484,100705,76,183911
10960,0.00187,172.217.194.0-255,5738,106443,76,183911
10961,0.001873,172.31.40.0-255,66,106509,76,183911
10962,0.001917,172.217.194.0-255,7156,113665,76,183911
10963,0.001921,172.31.40.0-255,66,113731,76,183911
10964,0.001931,172.31.40.0-255,66,113797,76,183911
10965,0.001952,172.217.194.0-255,2184,115981,76,183911
10966,0.001956,172.217.194.0-255,2902,118883,76,183911
10967,0.001963,172.217.194.0-255,7156,126039,76,183911
10968,0.001971,172.31.40.0-255,66,126105,76,183911
10969,0.001978,172.31.40.0-255,66,126171,76,183911
10970,0.001981,172.31.40.0-255,66,126237,76,183911
10971,0.001986,172.217.194.0-255,2902,129139,76,183911
10972,0.001989,172.31.40.0-255,66,129205,76,183911
10973,0.002027,172.31.40.0-255,66,129271,76,183911
10974,0.002079,172.217.194.0-255,1484,130755,76,183911
10975,0.002094,172.31.40.0-255,66,130821,76,183911
10976,0.002101,172.31.40.0-255,66,130887,76,183911
10977,0.00214,172.217.194.0-255,4320,135207,76,183911
10978,0.002154,172.217.194.0-255,5738,140945,76,183911
10979,0.002157,172.217.194.0-255,1484,142429,76,183911
10980,0.002164,172.31.40.0-255,66,142495,76,183911
10981,0.00222,172.31.40.0-255,66,142561,76,183911
10982,0.002236,172.217.194.0-255,1484,144045,76,183911
10983,0.002259,172.217.194.0-255,7156,151201,76,183911
10984,0.002277,172.31.40.0-255,66,151267,76,183911
10985,0.002297,172.217.194.0-255,7156,158423,76,183911
10986,0.002324,172.217.194.0-255,766,159189,76,183911
10987,0.002332,172.217.194.0-255,7156,166345,76,183911
10988,0.002347,172.31.40.0-255,66,166411,76,183911
10989,0.002365,172.217.194.0-255,7156,173567,76,183911
10990,0.002386,172.217.194.0-255,6438,180005,76,183911
10991,0.002398,172.31.40.0-255,66,180071,76,183911
10992,0.002424,172.31.40.0-255,66,180137,76,183911
10993,0.002442,172.217.194.0-255,105,180242,76,183911
10994,0.0031,172.31.40.0-255,101,180343,76,183911
10995,0.00475,172.31.40.0-255,105,180448,76,183911
10996,0.005611,172.217.194.0-255,66,180514,76,183911
10997,0.007249,172.217.194.0-255,66,180580,76,183911
10998,0.027511,172.31.40.0-255,172,180752,76,183911
10999,0.02754,172.31.40.0-255,1109,181861,76,183911
11000,0.027593,172.31.40.0-255,1514,183375,76,183911
11001,0.027617,172.31.40.0-255,338,183713,76,183911
11002,0.02906,104.244.42.0-255,66,183779,76,183911
11003,0.029091,104.244.42.0-255,66,183845,76,183911
11004,0.029145,104.244.42.0-255,66,183911,76,183911
11005,0.0,172.253.118.0-255,146,146,76,363423
11006,1.7e-05,172.31.40.0-255,66,212,76,363423
11007,2.3e-05,172.253.118.0-255,1484,1696,76,363423
11008,2.7e-05,172.31.40.0-255,66,1762,76,363423
11009,4.3e-05,172.253.118.0-255,2902,4664,76,363423
11010,4.6e-05,172.31.40.0-255,66,4730,76,363423
11011,7.8e-05,172.253.118.0-255,4320,9050,76,363423
11012,8e-05,172.31.40.0-255,66,9116,76,363423
11013,0.00011,172.253.118.0-255,1484,10600,76,363423
11014,0.000113,172.31.40.0-255,66,10666,76,363423
11015,0.000119,172.253.118.0-255,3511,14177,76,363423
11016,0.000121,172.31.40.0-255,66,14243,76,363423
11017,0.000165,172.253.118.0-255,1484,15727,76,363423
11018,0.000167,172.31.40.0-255,66,15793,76,363423
11019,0.000172,172.253.118.0-255,2902,18695,76,363423
11020,0.000175,172.31.40.0-255,66,18761,76,363423
11021,0.000202,172.253.118.0-255,5738,24499,76,363423
11022,0.000205,172.31.40.0-255,66,24565,76,363423
11023,0.000211,172.253.118.0-255,4320,28885,76,363423
11024,0.000213,172.31.40.0-255,66,28951,76,363423
11025,0.000268,172.253.118.0-255,2543,31494,76,363423
11026,0.000271,172.31.40.0-255,66,31560,76,363423
11027,0.000481,172.253.118.0-255,1484,33044,76,363423
11028,0.000487,172.31.40.0-255,66,33110,76,363423
11029,0.000492,172.253.118.0-255,2902,36012,76,363423
11030,0.000495,172.31.40.0-255,66,36078,76,363423
11031,0.000518,172.253.118.0-255,1484,37562,76,363423
11032,0.00052,172.31.40.0-255,66,37628,76,363423
11033,0.000524,172.253.118.0-255,1484,39112,76,363423
11034,0.000526,172.31.40.0-255,66,39178,76,363423
11035,0.000542,172.253.118.0-255,4320,43498,76,363423
11036,0.000544,172.31.40.0-255,66,43564,76,363423
11037,0.000571,172.253.118.0-255,5379,48943,76,363423
11038,0.000574,172.31.40.0-255,66,49009,76,363423
11039,0.000595,172.253.118.0-255,5738,54747,76,363423
11040,0.000601,172.253.118.0-255,2902,57649,76,363423
11041,0.000607,172.31.40.0-255,66,57715,76,363423
11042,0.000616,172.253.118.0-255,2902,60617,76,363423
11043,0.000641,172.31.40.0-255,66,60683,76,363423
11044,0.00065,172.253.118.0-255,2902,63585,76,363423
11045,0.000656,172.31.40.0-255,66,63651,76,363423
11046,0.000666,172.253.118.0-255,2812,66463,76,363423
11047,0.000677,172.253.118.0-255,416,66879,76,363423
11048,0.000698,172.31.40.0-255,66,66945,76,363423
11049,0.000856,172.253.118.0-255,1484,68429,76,363423
11050,0.000862,172.253.118.0-255,2902,71331,76,363423
11051,0.000884,172.31.40.0-255,66,71397,76,363423
11052,0.000902,172.253.118.0-255,2902,74299,76,363423
11053,0.000915,172.253.118.0-255,2902,77201,76,363423
11054,0.000919,172.253.118.0-255,2902,80103,76,363423
11055,0.000926,172.31.40.0-255,66,80169,76,363423
11056,0.00094,172.253.118.0-255,4320,84489,76,363423
11057,0.000953,172.253.118.0-255,1484,85973,76,363423
11058,0.000961,172.31.40.0-255,66,86039,76,363423
11059,0.000974,172.253.118.0-255,5738,91777,76,363423
11060,0.000987,172.253.118.0-255,4320,96097,76,363423
11061,0.001009,172.253.118.0-255,4320,100417,76,363423
11062,0.001012,172.253.118.0-255,218,100635,76,363423
11063,0.00102,172.31.40.0-255,66,100701,76,363423
11064,0.001295,172.253.118.0-255,1484,102185,76,363423
11065,0.001313,172.253.118.0-255,2902,105087,76,363423
11066,0.001316,172.31.40.0-255,66,105153,76,363423
11067,0.00132,172.253.118.0-255,1484,106637,76,363423
11068,0.001337,172.253.118.0-255,4320,110957,76,363423
11069,0.001342,172.31.40.0-255,66,111023,76,363423
11070,0.001349,172.253.118.0-255,1484,112507,76,363423
11071,0.001362,172.253.118.0-255,2902,115409,76,363423
11072,0.001418,172.253.118.0-255,5738,121147,76,363423
11073,0.001425,172.31.40.0-255,66,121213,76,363423
11074,0.001433,172.253.118.0-255,1484,122697,76,363423
11075,0.001438,172.253.118.0-255,3602,126299,76,363423
11076,0.001443,172.31.40.0-255,66,126365,76,363423
11077,0.001779,172.253.118.0-255,1484,127849,76,363423
11078,0.001794,172.253.118.0-255,2902,130751,76,363423
11079,0.001798,172.31.40.0-255,66,130817,76,363423
11080,0.001803,172.253.118.0-255,2902,133719,76,363423
11081,0.001809,172.31.40.0-255,66,133785,76,363423
11082,0.001818,172.253.118.0-255,2902,136687,76,363423
11083,0.001823,172.31.40.0-255,66,136753,76,363423
11084,0.001836,172.253.118.0-255,7156,143909,76,363423
11085,0.001866,172.253.118.0-255,4320,148229,76,363423
11086,0.00187,172.253.118.0-255,1484,149713,76,363423
11087,0.007911,172.31.40.0-255,66,149779,76,363423
11088,0.010373,172.253.118.0-255,5738,155517,76,363423
11089,0.010379,172.31.40.0-255,66,155583,76,363423
11090,0.012832,172.253.118.0-255,5738,161321,76,363423
11091,0.01284,172.31.40.0-255,66,161387,76,363423
11092,0.015279,172.253.118.0-255,5738,167125,76,363423
11093,0.01529,172.31.40.0-255,66,167191,76,363423
11094,0.017733,172.253.118.0-255,5738,172929,76,363423
11095,0.017741,172.31.40.0-255,66,172995,76,363423
11096,0.020175,172.253.118.0-255,5738,178733,76,363423
11097,0.020182,172.31.40.0-255,66,178799,76,363423
11098,0.0226,172.253.118.0-255,5738,184537,76,363423
11099,0.022608,172.31.40.0-255,66,184603,76,363423
11100,0.025068,172.253.118.0-255,5738,190341,76,363423
11101,0.025079,172.31.40.0-255,66,190407,76,363423
11102,0.027519,172.253.118.0-255,5738,196145,76,363423
11103,0.027527,172.31.40.0-255,66,196211,76,363423
11104,0.02997,172.253.118.0-255,4320,200531,76,363423
11105,0.029977,172.31.40.0-255,66,200597,76,363423
11106,0.029996,172.253.118.0-255,1484,202081,76,363423
11107,0.031151,172.31.40.0-255,176,202257,76,363423
11108,0.031179,172.31.40.0-255,1105,203362,76,363423
11109,0.031236,172.31.40.0-255,1514,204876,76,363423
11110,0.031238,172.31.40.0-255,1311,206187,76,363423
11111,0.032409,172.253.118.0-255,4320,210507,76,363423
11112,0.032415,172.31.40.0-255,66,210573,76,363423
11113,0.032818,104.244.42.0-255,66,210639,76,363423
11114,0.032842,104.244.42.0-255,66,210705,76,363423
11115,0.032925,104.244.42.0-255,66,210771,76,363423
11116,0.034849,172.253.118.0-255,4320,215091,76,363423
11117,0.034855,172.31.40.0-255,66,215157,76,363423
11118,0.034876,172.253.118.0-255,1484,216641,76,363423
11119,0.037293,172.253.118.0-255,4320,220961,76,363423
11120,0.037299,172.31.40.0-255,66,221027,76,363423
11121,0.039754,172.253.118.0-255,5738,226765,76,363423
11122,0.039822,172.31.40.0-255,66,226831,76,363423
11123,0.042263,172.253.118.0-255,5738,232569,76,363423
11124,0.042271,172.31.40.0-255,66,232635,76,363423
11125,0.044705,172.253.118.0-255,5738,238373,76,363423
11126,0.044711,172.31.40.0-255,66,238439,76,363423
11127,0.047151,172.253.118.0-255,5738,244177,76,363423
11128,0.047158,172.31.40.0-255,66,244243,76,363423
11129,0.049597,172.253.118.0-255,5738,249981,76,363423
11130,0.049604,172.31.40.0-255,66,250047,76,363423
11131,0.052051,172.253.118.0-255,5738,255785,76,363423
11132,0.052058,172.31.40.0-255,66,255851,76,363423
11133,0.054559,172.253.118.0-255,5738,261589,76,363423
11134,0.054567,172.31.40.0-255,66,261655,76,363423
11135,0.057197,172.253.118.0-255,5738,267393,76,363423
11136,0.057206,172.31.40.0-255,66,267459,76,363423
11137,0.059654,172.253.118.0-255,5738,273197,76,363423
11138,0.05966,172.31.40.0-255,66,273263,76,363423
11139,0.062116,172.253.118.0-255,5738,279001,76,363423
11140,0.062122,172.31.40.0-255,66,279067,76,363423
11141,0.064566,172.253.118.0-255,5738,284805,76,363423
11142,0.064572,172.31.40.0-255,66,284871,76,363423
11143,0.067012,172.253.118.0-255,4320,289191,76,363423
11144,0.067018,172.31.40.0-255,66,289257,76,363423
11145,0.067036,172.253.118.0-255,1484,290741,76,363423
11146,0.069478,172.253.118.0-255,4320,295061,76,363423
11147,0.069485,172.31.40.0-255,66,295127,76,363423
11148,0.07196,172.253.118.0-255,5738,300865,76,363423
11149,0.07234,172.31.40.0-255,66,300931,76,363423
11150,0.074786,172.253.118.0-255,5738,306669,76,363423
11151,0.074792,172.31.40.0-255,66,306735,76,363423
11152,0.077239,172.253.118.0-255,5738,312473,76,363423
11153,0.077246,172.31.40.0-255,66,312539,76,363423
11154,0.079694,172.253.118.0-255,5738,318277,76,363423
11155,0.0797,172.31.40.0-255,66,318343,76,363423
11156,0.08216,172.253.118.0-255,5738,324081,76,363423
11157,0.082166,172.31.40.0-255,66,324147,76,363423
11158,0.084578,172.253.118.0-255,5738,329885,76,363423
11159,0.084584,172.31.40.0-255,66,329951,76,363423
11160,0.087024,172.253.118.0-255,4320,334271,76,363423
11161,0.08703,172.31.40.0-255,66,334337,76,363423
11162,0.087047,172.253.118.0-255,1484,335821,76,363423
11163,0.089505,172.253.118.0-255,4320,340141,76,363423
11164,0.089512,172.31.40.0-255,66,340207,76,363423
11165,0.091987,172.253.118.0-255,5738,345945,76,363423
11166,0.092039,172.31.40.0-255,66,346011,76,363423
11167,0.094487,172.253.118.0-255,5738,351749,76,363423
11168,0.094494,172.31.40.0-255,66,351815,76,363423
11169,0.096984,172.253.118.0-255,5738,357553,76,363423
11170,0.09699,172.31.40.0-255,66,357619,76,363423
11171,0.09944,172.253.118.0-255,5738,363357,76,363423
11172,0.099448,172.31.40.0-255,66,363423,76,363423
11173,0.0,74.125.24.0-255,155,155,76,384533
11174,2e-05,172.31.40.0-255,66,221,76,384533
11175,2.6e-05,74.125.24.0-255,1484,1705,76,384533
11176,3e-05,172.31.40.0-255,66,1771,76,384533
11177,3.5e-05,74.125.24.0-255,2902,4673,76,384533
11178,3.8e-05,172.31.40.0-255,66,4739,76,384533
11179,4.3e-05,74.125.24.0-255,4320,9059,76,384533
11180,4.6e-05,172.31.40.0-255,66,9125,76,384533
11181,6.9e-05,74.125.24.0-255,2902,12027,76,384533
11182,7.2e-05,172.31.40.0-255,66,12093,76,384533
11183,7.6e-05,74.125.24.0-255,2093,14186,76,384533
11184,7.8e-05,172.31.40.0-255,66,14252,76,384533
11185,0.000114,74.125.24.0-255,1484,15736,76,384533
11186,0.000116,172.31.40.0-255,66,15802,76,384533
11187,0.000127,74.125.24.0-255,2902,18704,76,384533
11188,0.000129,172.31.40.0-255,66,18770,76,384533
11189,0.000142,74.125.24.0-255,1484,20254,76,384533
11190,0.000144,172.31.40.0-255,66,20320,76,384533
11191,0.000159,74.125.24.0-255,4320,24640,76,384533
11192,0.000161,172.31.40.0-255,66,24706,76,384533
11193,0.000163,74.125.24.0-255,1484,26190,76,384533
11194,0.000165,172.31.40.0-255,66,26256,76,384533
11195,0.000184,74.125.24.0-255,2902,29158,76,384533
11196,0.000187,172.31.40.0-255,66,29224,76,384533
11197,0.000222,74.125.24.0-255,2543,31767,76,384533
11198,0.000224,172.31.40.0-255,66,31833,76,384533
11199,0.000318,74.125.24.0-255,1484,33317,76,384533
11200,0.000322,172.31.40.0-255,66,33383,76,384533
11201,0.000327,74.125.24.0-255,2902,36285,76,384533
11202,0.000329,172.31.40.0-255,66,36351,76,384533
11203,0.000333,74.125.24.0-255,2902,39253,76,384533
11204,0.000334,172.31.40.0-255,66,39319,76,384533
11205,0.000355,74.125.24.0-255,2902,42221,76,384533
11206,0.000357,172.31.40.0-255,66,42287,76,384533
11207,0.000387,172.31.40.0-255,66,42353,76,384533
11208,0.000396,172.31.40.0-255,66,42419,76,384533
11209,0.000424,74.125.24.0-255,7072,49491,76,384533
11210,0.000427,172.31.40.0-255,66,49557,76,384533
11211,0.000506,74.125.24.0-255,127,49684,76,384533
11212,0.000878,74.125.24.0-255,350,50034,76,384533
11213,0.001002,172.31.40.0-255,66,50100,76,384533
11214,0.001093,74.125.24.0-255,1484,51584,76,384533
11215,0.001099,74.125.24.0-255,1484,53068,76,384533
11216,0.001103,172.31.40.0-255,66,53134,76,384533
11217,0.001121,74.125.24.0-255,1484,54618,76,384533
11218,0.001128,74.125.24.0-255,5738,60356,76,384533
11219,0.00113,172.31.40.0-255,66,60422,76,384533
11220,0.001136,74.125.24.0-255,4320,64742,76,384533
11221,0.001138,172.31.40.0-255,66,64808,76,384533
11222,0.001164,74.125.24.0-255,2902,67710,76,384533
11223,0.001167,172.31.40.0-255,66,67776,76,384533
11224,0.001187,172.31.40.0-255,66,67842,76,384533
11225,0.001194,74.125.24.0-255,5738,73580,76,384533
11226,0.001196,172.31.40.0-255,66,73646,76,384533
11227,0.00122,74.125.24.0-255,2184,75830,76,384533
11228,0.001222,172.31.40.0-255,66,75896,76,384533
11229,0.001501,74.125.24.0-255,1484,77380,76,384533
11230,0.001525,74.125.24.0-255,2902,80282,76,384533
11231,0.001529,172.31.40.0-255,66,80348,76,384533
11232,0.001535,74.125.24.0-255,1484,81832,76,384533
11233,0.001559,74.125.24.0-255,2902,84734,76,384533
11234,0.001561,172.31.40.0-255,66,84800,76,384533
11235,0.001584,74.125.24.0-255,5738,90538,76,384533
11236,0.001586,172.31.40.0-255,66,90604,76,384533
11237,0.00159,74.125.24.0-255,1484,92088,76,384533
11238,0.001605,74.125.24.0-255,1484,93572,76,384533
11239,0.001607,172.31.40.0-255,66,93638,76,384533
11240,0.00161,74.125.24.0-255,1484,95122,76,384533
11241,0.00163,74.125.24.0-255,7156,102278,76,384533
11242,0.001632,172.31.40.0-255,66,102344,76,384533
11243,0.001647,74.125.24.0-255,1484,103828,76,384533
11244,0.001655,74.125.24.0-255,6438,110266,76,384533
11245,0.001657,172.31.40.0-255,66,110332,76,384533
11246,0.002056,74.125.24.0-255,1484,111816,76,384533
11247,0.002065,74.125.24.0-255,2902,114718,76,384533
11248,0.00207,172.31.40.0-255,66,114784,76,384533
11249,0.002074,74.125.24.0-255,1484,116268,76,384533
11250,0.002115,74.125.24.0-255,1484,117752,76,384533
11251,0.002118,172.31.40.0-255,66,117818,76,384533
11252,0.00214,74.125.24.0-255,2902,120720,76,384533
11253,0.002143,172.31.40.0-255,66,120786,76,384533
11254,0.00215,74.125.24.0-255,5738,126524,76,384533
11255,0.002152,172.31.40.0-255,66,126590,76,384533
11256,0.002166,172.31.40.0-255,66,126656,76,384533
11257,0.002173,74.125.24.0-255,5020,131676,76,384533
11258,0.002176,172.31.40.0-255,66,131742,76,384533
11259,0.002276,74.125.24.0-255,1484,133226,76,384533
11260,0.002283,74.125.24.0-255,2902,136128,76,384533
11261,0.002287,172.31.40.0-255,66,136194,76,384533
11262,0.002292,74.125.24.0-255,2902,139096,76,384533
11263,0.002294,172.31.40.0-255,66,139162,76,384533
11264,0.002309,74.125.24.0-255,2902,142064,76,384533
11265,0.002312,172.31.40.0-255,66,142130,76,384533
11266,0.002329,74.125.24.0-255,5738,147868,76,384533
11267,0.002333,172.31.40.0-255,66,147934,76,384533
11268,0.002339,74.125.24.0-255,5738,153672,76,384533
11269,0.002341,172.31.40.0-255,66,153738,76,384533
11270,0.002362,74.125.24.0-255,1484,155222,76,384533
11271,0.002376,74.125.24.0-255,4320,159542,76,384533
11272,0.002379,172.31.40.0-255,66,159608,76,384533
11273,0.002395,74.125.24.0-255,4320,163928,76,384533
11274,0.002397,172.31.40.0-255,66,163994,76,384533
11275,0.002459,74.125.24.0-255,2184,166178,76,384533
11276,0.002464,172.31.40.0-255,66,166244,76,384533
11277,0.00483,74.125.24.0-255,2902,169146,76,384533
11278,0.004839,172.31.40.0-255,66,169212,76,384533
11279,0.004904,74.125.24.0-255,2902,172114,76,384533
11280,0.004906,172.31.40.0-255,66,172180,76,384533
11281,0.007289,74.125.24.0-255,2902,175082,76,384533
11282,0.007293,172.31.40.0-255,66,175148,76,384533
11283,0.007356,74.125.24.0-255,2902,178050,76,384533
11284,0.007359,172.31.40.0-255,66,178116,76,384533
11285,0.009746,74.125.24.0-255,2902,181018,76,384533
11286,0.009754,172.31.40.0-255,66,181084,76,384533
11287,0.009794,74.125.24.0-255,2902,183986,76,384533
11288,0.009797,172.31.40.0-255,66,184052,76,384533
11289,0.012211,74.125.24.0-255,2902,186954,76,384533
11290,0.01222,172.31.40.0-255,66,187020,76,384533
11291,0.012244,74.125.24.0-255,2902,189922,76,384533
11292,0.012247,172.31.40.0-255,66,189988,76,384533
11293,0.014654,74.125.24.0-255,2902,192890,76,384533
11294,0.014662,172.31.40.0-255,66,192956,76,384533
11295,0.014682,74.125.24.0-255,2902,195858,76,384533
11296,0.014685,172.31.40.0-255,66,195924,76,384533
11297,0.01712,74.125.24.0-255,5738,201662,76,384533
11298,0.017128,172.31.40.0-255,66,201728,76,384533
11299,0.019593,74.125.24.0-255,5738,207466,76,384533
11300,0.019602,172.31.40.0-255,66,207532,76,384533
11301,0.022047,74.125.24.0-255,5738,213270,76,384533
11302,0.022056,172.31.40.0-255,66,213336,76,384533
11303,0.024524,74.125.24.0-255,5738,219074,76,384533
11304,0.024531,172.31.40.0-255,66,219140,76,384533
11305,0.026985,74.125.24.0-255,5738,224878,76,384533
11306,0.02699,172.31.40.0-255,66,224944,76,384533
11307,0.029436,74.125.24.0-255,5738,230682,76,384533
11308,0.029446,172.31.40.0-255,66,230748,76,384533
11309,0.031913,74.125.24.0-255,5738,236486,76,384533
11310,0.031922,172.31.40.0-255,66,236552,76,384533
11311,0.034367,74.125.24.0-255,5738,242290,76,384533
11312,0.034376,172.31.40.0-255,66,242356,76,384533
11313,0.036198,172.31.40.0-255,172,242528,76,384533
11314,0.036232,172.31.40.0-255,1109,243637,76,384533
11315,0.036294,172.31.40.0-255,1514,245151,76,384533
11316,0.036296,172.31.40.0-255,1307,246458,76,384533
11317,0.03682,74.125.24.0-255,5738,252196,76,384533
11318,0.036828,172.31.40.0-255,66,252262,76,384533
11319,0.037895,104.244.42.0-255,66,252328,76,384533
11320,0.037931,104.244.42.0-255,66,252394,76,384533
11321,0.037978,104.244.42.0-255,66,252460,76,384533
11322,0.039276,74.125.24.0-255,5738,258198,76,384533
11323,0.039281,172.31.40.0-255,66,258264,76,384533
11324,0.041743,74.125.24.0-255,5738,264002,76,384533
11325,0.041752,172.31.40.0-255,66,264068,76,384533
11326,0.044216,74.125.24.0-255,5738,269806,76,384533
11327,0.044221,172.31.40.0-255,66,269872,76,384533
11328,0.046744,74.125.24.0-255,5738,275610,76,384533
11329,0.04675,172.31.40.0-255,66,275676,76,384533
11330,0.049223,74.125.24.0-255,5738,281414,76,384533
11331,0.04923,172.31.40.0-255,66,281480,76,384533
11332,0.051695,74.125.24.0-255,5738,287218,76,384533
11333,0.051702,172.31.40.0-255,66,287284,76,384533
11334,0.054159,74.125.24.0-255,5738,293022,76,384533
11335,0.054164,172.31.40.0-255,66,293088,76,384533
11336,0.056656,74.125.24.0-255,5738,298826,76,384533
11337,0.056661,172.31.40.0-255,66,298892,76,384533
11338,0.059125,74.125.24.0-255,5738,304630,76,384533
11339,0.059132,172.31.40.0-255,66,304696,76,384533
11340,0.061579,74.125.24.0-255,5738,310434,76,384533
11341,0.061585,172.31.40.0-255,66,310500,76,384533
11342,0.064064,74.125.24.0-255,5738,316238,76,384533
11343,0.064072,172.31.40.0-255,66,316304,76,384533
11344,0.066513,74.125.24.0-255,5738,322042,76,384533
11345,0.06652,172.31.40.0-255,66,322108,76,384533
11346,0.068979,74.125.24.0-255,5738,327846,76,384533
11347,0.068986,172.31.40.0-255,66,327912,76,384533
11348,0.071444,74.125.24.0-255,5738,333650,76,384533
11349,0.071449,172.31.40.0-255,66,333716,76,384533
11350,0.073918,74.125.24.0-255,5738,339454,76,384533
11351,0.073924,172.31.40.0-255,66,339520,76,384533
11352,0.076407,74.125.24.0-255,5738,345258,76,384533
11353,0.076414,172.31.40.0-255,66,345324,76,384533
11354,0.078883,74.125.24.0-255,5738,351062,76,384533
11355,0.07889,172.31.40.0-255,66,351128,76,384533
11356,0.081353,74.125.24.0-255,5738,356866,76,384533
11357,0.08136,172.31.40.0-255,66,356932,76,384533
11358,0.083826,74.125.24.0-255,5738,362670,76,384533
11359,0.083832,172.31.40.0-255,66,362736,76,384533
11360,0.08633,74.125.24.0-255,5738,368474,76,384533
11361,0.086338,172.31.40.0-255,66,368540,76,384533
11362,0.088794,74.125.24.0-255,5738,374278,76,384533
11363,0.088801,172.31.40.0-255,66,374344,76,384533
11364,0.091276,74.125.24.0-255,5738,380082,76,384533
11365,0.091282,172.31.40.0-255,66,380148,76,384533
11366,0.093755,74.125.24.0-255,4148,384296,76,384533
11367,0.09376,172.31.40.0-255,66,384362,76,384533
11368,0.093918,172.31.40.0-255,105,384467,76,384533
11369,0.096336,74.125.24.0-255,66,384533,76,384533
11370,0.0,74.125.200.0-255,153,153,76,395497
11371,2.4e-05,172.31.40.0-255,66,219,76,395497
11372,4.5e-05,74.125.200.0-255,1484,1703,76,395497
11373,4.9e-05,172.31.40.0-255,66,1769,76,395497
11374,5.3e-05,74.125.200.0-255,1484,3253,76,395497
11375,5.6e-05,172.31.40.0-255,66,3319,76,395497
11376,6.2e-05,74.125.200.0-255,2902,6221,76,395497
11377,6.5e-05,172.31.40.0-255,66,6287,76,395497
11378,9.4e-05,74.125.200.0-255,5738,12025,76,395497
11379,9.7e-05,172.31.40.0-255,66,12091,76,395497
11380,0.00012,74.125.200.0-255,2064,14155,76,395497
11381,0.000122,172.31.40.0-255,66,14221,76,395497
11382,0.000217,74.125.200.0-255,1484,15705,76,395497
11383,0.000221,172.31.40.0-255,66,15771,76,395497
11384,0.000226,74.125.200.0-255,2902,18673,76,395497
11385,0.000228,172.31.40.0-255,66,18739,76,395497
11386,0.000261,74.125.200.0-255,5738,24477,76,395497
11387,0.000264,172.31.40.0-255,66,24543,76,395497
11388,0.000268,74.125.200.0-255,2902,27445,76,395497
11389,0.00027,172.31.40.0-255,66,27511,76,395497
11390,0.000275,74.125.200.0-255,3961,31472,76,395497
11391,0.000277,172.31.40.0-255,66,31538,76,395497
11392,0.000305,74.125.200.0-255,5738,37276,76,395497
11393,0.000307,172.31.40.0-255,66,37342,76,395497
11394,0.000328,74.125.200.0-255,2902,40244,76,395497
11395,0.00033,172.31.40.0-255,66,40310,76,395497
11396,0.000335,74.125.200.0-255,4320,44630,76,395497
11397,0.000337,172.31.40.0-255,66,44696,76,395497
11398,0.000358,74.125.200.0-255,2902,47598,76,395497
11399,0.00036,172.31.40.0-255,66,47664,76,395497
11400,0.000391,172.31.40.0-255,66,47730,76,395497
11401,0.000397,74.125.200.0-255,5738,53468,76,395497
11402,0.0004,172.31.40.0-255,66,53534,76,395497
11403,0.000422,74.125.200.0-255,766,54300,76,395497
11404,0.000524,74.125.200.0-255,646,54946,76,395497
11405,0.00093,74.125.200.0-255,1484,56430,76,395497
11406,0.000936,172.31.40.0-255,66,56496,76,395497
11407,0.000942,74.125.200.0-255,2902,59398,76,395497
11408,0.000944,172.31.40.0-255,66,59464,76,395497
11409,0.000956,74.125.200.0-255,1484,60948,76,395497
11410,0.000976,74.125.200.0-255,4320,65268,76,395497
11411,0.000978,172.31.40.0-255,66,65334,76,395497
11412,0.000982,74.125.200.0-255,1484,66818,76,395497
11413,0.000999,74.125.200.0-255,4830,71648,76,395497
11414,0.001001,172.31.40.0-255,66,71714,76,395497
11415,0.001323,74.125.200.0-255,1484,73198,76,395497
11416,0.00133,74.125.200.0-255,1484,74682,76,395497
11417,0.001334,172.31.40.0-255,66,74748,76,395497
11418,0.001352,74.125.200.0-255,1484,76232,76,395497
11419,0.001359,74.125.200.0-255,5738,81970,76,395497
11420,0.001361,172.31.40.0-255,66,82036,76,395497
11421,0.001385,74.125.200.0-255,4320,86356,76,395497
11422,0.001387,172.31.40.0-255,66,86422,76,395497
11423,0.001415,172.31.40.0-255,66,86488,76,395497
11424,0.001421,74.125.200.0-255,5738,92226,76,395497
11425,0.001423,172.31.40.0-255,66,92292,76,395497
11426,0.001451,74.125.200.0-255,5020,97312,76,395497
11427,0.001453,172.31.40.0-255,66,97378,76,395497
11428,0.001711,74.125.200.0-255,1484,98862,76,395497
11429,0.001725,74.125.200.0-255,2902,101764,76,395497
11430,0.001727,172.31.40.0-255,66,101830,76,395497
11431,0.001748,74.125.200.0-255,4320,106150,76,395497
11432,0.00175,172.31.40.0-255,66,106216,76,395497
11433,0.001762,74.125.200.0-255,1484,107700,76,395497
11434,0.001767,74.125.200.0-255,2902,110602,76,395497
11435,0.001768,172.31.40.0-255,66,110668,76,395497
11436,0.001793,74.125.200.0-255,4320,114988,76,395497
11437,0.001795,172.31.40.0-255,66,115054,76,395497
11438,0.001801,74.125.200.0-255,5738,120792,76,395497
11439,0.001803,172.31.40.0-255,66,120858,76,395497
11440,0.001824,172.31.40.0-255,66,120924,76,395497
11441,0.001852,74.125.200.0-255,2184,123108,76,395497
11442,0.001855,172.31.40.0-255,66,123174,76,395497
11443,0.001901,74.125.200.0-255,1484,124658,76,395497
11444,0.001914,74.125.200.0-255,2902,127560,76,395497
11445,0.001916,172.31.40.0-255,66,127626,76,395497
11446,0.001939,74.125.200.0-255,5738,133364,76,395497
11447,0.001941,172.31.40.0-255,66,133430,76,395497
11448,0.001976,74.125.200.0-255,4320,137750,76,395497
11449,0.001979,172.31.40.0-255,66,137816,76,395497
11450,0.001998,74.125.200.0-255,1484,139300,76,395497
11451,0.002006,74.125.200.0-255,7156,146456,76,395497
11452,0.002009,172.31.40.0-255,66,146522,76,395497
11453,0.002016,74.125.200.0-255,5738,152260,76,395497
11454,0.002018,172.31.40.0-255,66,152326,76,395497
11455,0.002033,74.125.200.0-255,5020,157346,76,395497
11456,0.002036,172.31.40.0-255,66,157412,76,395497
11457,0.004394,74.125.200.0-255,5738,163150,76,395497
11458,0.004404,172.31.40.0-255,66,163216,76,395497
11459,0.006774,74.125.200.0-255,5738,168954,76,395497
11460,0.006778,172.31.40.0-255,66,169020,76,395497
11461,0.009148,74.125.200.0-255,5738,174758,76,395497
11462,0.009155,172.31.40.0-255,66,174824,76,395497
11463,0.011518,74.125.200.0-255,5738,180562,76,395497
11464,0.011528,172.31.40.0-255,66,180628,76,395497
11465,0.013888,74.125.200.0-255,5738,186366,76,395497
11466,0.013898,172.31.40.0-255,66,186432,76,395497
11467,0.016261,74.125.200.0-255,5738,192170,76,395497
11468,0.016276,172.31.40.0-255,66,192236,76,395497
11469,0.018638,74.125.200.0-255,5738,197974,76,395497
11470,0.018648,172.31.40.0-255,66,198040,76,395497
11471,0.021009,74.125.200.0-255,5738,203778,76,395497
11472,0.021016,172.31.40.0-255,66,203844,76,395497
11473,0.023382,74.125.200.0-255,5738,209582,76,395497
11474,0.02339,172.31.40.0-255,66,209648,76,395497
11475,0.025753,74.125.200.0-255,5738,215386,76,395497
11476,0.025762,172.31.40.0-255,66,215452,76,395497
11477,0.028121,74.125.200.0-255,5738,221190,76,395497
11478,0.028127,172.31.40.0-255,66,221256,76,395497
11479,0.029113,172.31.40.0-255,172,221428,76,395497
11480,0.02914,172.31.40.0-255,1107,222535,76,395497
11481,0.029192,172.31.40.0-255,1514,224049,76,395497
11482,0.029193,172.31.40.0-255,1311,225360,76,395497
11483,0.030483,74.125.200.0-255,5738,231098,76,395497
11484,0.030488,172.31.40.0-255,66,231164,76,395497
11485,0.030709,104.244.42.0-255,66,231230,76,395497
11486,0.030814,104.244.42.0-255,66,231296,76,395497
11487,0.030828,104.244.42.0-255,66,231362,76,395497
11488,0.032845,74.125.200.0-255,5738,237100,76,395497
11489,0.03285,172.31.40.0-255,66,237166,76,395497
11490,0.035207,74.125.200.0-255,5738,242904,76,395497
11491,0.035213,172.31.40.0-255,66,242970,76,395497
11492,0.037567,74.125.200.0-255,5738,248708,76,395497
11493,0.037572,172.31.40.0-255,66,248774,76,395497
11494,0.039935,74.125.200.0-255,5738,254512,76,395497
11495,0.039946,172.31.40.0-255,66,254578,76,395497
11496,0.042322,74.125.200.0-255,5738,260316,76,395497
11497,0.042328,172.31.40.0-255,66,260382,76,395497
11498,0.044686,74.125.200.0-255,5738,266120,76,395497
11499,0.044693,172.31.40.0-255,66,266186,76,395497
11500,0.047048,74.125.200.0-255,5738,271924,76,395497
11501,0.047054,172.31.40.0-255,66,271990,76,395497
11502,0.049404,74.125.200.0-255,5738,277728,76,395497
11503,0.049409,172.31.40.0-255,66,277794,76,395497
11504,0.051761,74.125.200.0-255,5738,283532,76,395497
11505,0.051767,172.31.40.0-255,66,283598,76,395497
11506,0.054144,74.125.200.0-255,5738,289336,76,395497
11507,0.054157,172.31.40.0-255,66,289402,76,395497
11508,0.056529,74.125.200.0-255,5738,295140,76,395497
11509,0.056535,172.31.40.0-255,66,295206,76,395497
11510,0.05891,74.125.200.0-255,5738,300944,76,395497
11511,0.058915,172.31.40.0-255,66,301010,76,395497
11512,0.061275,74.125.200.0-255,5738,306748,76,395497
11513,0.061282,172.31.40.0-255,66,306814,76,395497
11514,0.063674,74.125.200.0-255,5738,312552,76,395497
11515,0.06368,172.31.40.0-255,66,312618,76,395497
11516,0.066036,74.125.200.0-255,5738,318356,76,395497
11517,0.066042,172.31.40.0-255,66,318422,76,395497
11518,0.068409,74.125.200.0-255,5738,324160,76,395497
11519,0.068416,172.31.40.0-255,66,324226,76,395497
11520,0.070832,74.125.200.0-255,5738,329964,76,395497
11521,0.070838,172.31.40.0-255,66,330030,76,395497
11522,0.073197,74.125.200.0-255,5738,335768,76,395497
11523,0.073204,172.31.40.0-255,66,335834,76,395497
11524,0.075555,74.125.200.0-255,5738,341572,76,395497
11525,0.075562,172.31.40.0-255,66,341638,76,395497
11526,0.077918,74.125.200.0-255,5738,347376,76,395497
11527,0.077924,172.31.40.0-255,66,347442,76,395497
11528,0.080291,74.125.200.0-255,5738,353180,76,395497
11529,0.080296,172.31.40.0-255,66,353246,76,395497
11530,0.082658,74.125.200.0-255,5738,358984,76,395497
11531,0.082664,172.31.40.0-255,66,359050,76,395497
11532,0.085046,74.125.200.0-255,5738,364788,76,395497
11533,0.085059,172.31.40.0-255,66,364854,76,395497
11534,0.087423,74.125.200.0-255,5738,370592,76,395497
11535,0.087433,172.31.40.0-255,66,370658,76,395497
11536,0.089788,74.125.200.0-255,5738,376396,76,395497
11537,0.089796,172.31.40.0-255,66,376462,76,395497
11538,0.092168,74.125.200.0-255,5738,382200,76,395497
11539,0.092177,172.31.40.0-255,66,382266,76,395497
11540,0.094534,74.125.200.0-255,5738,388004,76,395497
11541,0.094541,172.31.40.0-255,66,388070,76,395497
11542,0.096893,74.125.200.0-255,5738,393808,76,395497
11543,0.096899,172.31.40.0-255,66,393874,76,395497
11544,0.099238,74.125.200.0-255,1452,395326,76,395497
11545,0.099349,172.31.40.0-255,66,395392,76,395497
11546,0.099384,172.31.40.0-255,105,395497,76,395497
11547,0.0,74.125.24.0-255,146,146,76,196996
11548,2.5e-05,172.31.40.0-255,66,212,76,196996
11549,3.2e-05,74.125.24.0-255,1484,1696,76,196996
11550,3.6e-05,172.31.40.0-255,66,1762,76,196996
11551,5e-05,74.125.24.0-255,2902,4664,76,196996
11552,5.5e-05,172.31.40.0-255,66,4730,76,196996
11553,6.3e-05,74.125.24.0-255,7156,11886,76,196996
11554,6.6e-05,172.31.40.0-255,66,11952,76,196996
11555,0.000107,74.125.24.0-255,6318,18270,76,196996
11556,0.000111,172.31.40.0-255,66,18336,76,196996
11557,0.000141,74.125.24.0-255,7156,25492,76,196996
11558,0.000144,172.31.40.0-255,66,25558,76,196996
11559,0.000147,74.125.24.0-255,1484,27042,76,196996
11560,0.000149,172.31.40.0-255,66,27108,76,196996
11561,0.000173,74.125.24.0-255,3961,31069,76,196996
11562,0.000179,172.31.40.0-255,66,31135,76,196996
11563,0.000209,74.125.24.0-255,1484,32619,76,196996
11564,0.000212,172.31.40.0-255,66,32685,76,196996
11565,0.000216,74.125.24.0-255,2902,35587,76,196996
11566,0.000219,172.31.40.0-255,66,35653,76,196996
11567,0.000223,74.125.24.0-255,2902,38555,76,196996
11568,0.000225,172.31.40.0-255,66,38621,76,196996
11569,0.000255,74.125.24.0-255,2902,41523,76,196996
11570,0.000258,172.31.40.0-255,66,41589,76,196996
11571,0.000264,74.125.24.0-255,4320,45909,76,196996
11572,0.000266,172.31.40.0-255,66,45975,76,196996
11573,0.000301,74.125.24.0-255,5379,51354,76,196996
11574,0.000303,172.31.40.0-255,66,51420,76,196996
11575,0.000316,172.31.40.0-255,66,51486,76,196996
11576,0.000325,74.125.24.0-255,4271,55757,76,196996
11577,0.000327,172.31.40.0-255,66,55823,76,196996
11578,0.000554,74.125.24.0-255,345,56168,76,196996
11579,0.000561,172.31.40.0-255,66,56234,76,196996
11580,0.000698,74.125.24.0-255,1484,57718,76,196996
11581,0.000703,172.31.40.0-255,66,57784,76,196996
11582,0.000708,74.125.24.0-255,2902,60686,76,196996
11583,0.00071,172.31.40.0-255,66,60752,76,196996
11584,0.000716,74.125.24.0-255,5738,66490,76,196996
11585,0.000719,172.31.40.0-255,66,66556,76,196996
11586,0.000765,172.31.40.0-255,66,66622,76,196996
11587,0.000792,74.125.24.0-255,5379,72001,76,196996
11588,0.000795,172.31.40.0-255,66,72067,76,196996
11589,0.000801,74.125.24.0-255,5738,77805,76,196996
11590,0.000804,172.31.40.0-255,66,77871,76,196996
11591,0.000825,74.125.24.0-255,3961,81832,76,196996
11592,0.000827,172.31.40.0-255,66,81898,76,196996
11593,0.001033,74.125.24.0-255,1484,83382,76,196996
11594,0.001038,172.31.40.0-255,66,83448,76,196996
11595,0.001043,74.125.24.0-255,2902,86350,76,196996
11596,0.001046,172.31.40.0-255,66,86416,76,196996
11597,0.001058,74.125.24.0-255,5738,92154,76,196996
11598,0.00106,172.31.40.0-255,66,92220,76,196996
11599,0.001097,172.31.40.0-255,66,92286,76,196996
11600,0.00117,172.31.40.0-255,66,92352,76,196996
11601,0.001597,74.125.24.0-255,1484,93836,76,196996
11602,0.001602,172.31.40.0-255,66,93902,76,196996
11603,0.001608,74.125.24.0-255,2902,96804,76,196996
11604,0.00161,172.31.40.0-255,66,96870,76,196996
11605,0.001613,74.125.24.0-255,1484,98354,76,196996
11606,0.001641,74.125.24.0-255,4320,102674,76,196996
11607,0.001644,74.125.24.0-255,1484,104158,76,196996
11608,0.001647,74.125.24.0-255,1484,105642,76,196996
11609,0.001673,74.125.24.0-255,7156,112798,76,196996
11610,0.001676,74.125.24.0-255,1484,114282,76,196996
11611,0.001678,172.31.40.0-255,66,114348,76,196996
11612,0.001685,172.31.40.0-255,66,114414,76,196996
11613,0.001738,172.31.40.0-255,66,114480,76,196996
11614,0.001906,74.125.24.0-255,1484,115964,76,196996
11615,0.00191,172.31.40.0-255,66,116030,76,196996
11616,0.001915,74.125.24.0-255,2902,118932,76,196996
11617,0.001918,172.31.40.0-255,66,118998,76,196996
11618,0.001929,74.125.24.0-255,5738,124736,76,196996
11619,0.001959,172.31.40.0-255,66,124802,76,196996
11620,0.001966,74.125.24.0-255,5738,130540,76,196996
11621,0.001987,172.31.40.0-255,66,130606,76,196996
11622,0.001994,74.125.24.0-255,1484,132090,76,196996
11623,0.002,74.125.24.0-255,5738,137828,76,196996
11624,0.002066,74.125.24.0-255,1484,139312,76,196996
11625,0.002069,172.31.40.0-255,66,139378,76,196996
11626,0.002101,74.125.24.0-255,5020,144398,76,196996
11627,0.002117,172.31.40.0-255,66,144464,76,196996
11628,0.002144,74.125.24.0-255,4320,148784,76,196996
11629,0.002149,74.125.24.0-255,2902,151686,76,196996
11630,0.002188,172.31.40.0-255,66,151752,76,196996
11631,0.002196,74.125.24.0-255,2184,153936,76,196996
11632,0.00222,172.31.40.0-255,66,154002,76,196996
11633,0.002263,172.31.40.0-255,66,154068,76,196996
11634,0.002283,74.125.24.0-255,7156,161224,76,196996
11635,0.0023,74.125.24.0-255,4320,165544,76,196996
11636,0.002346,172.31.40.0-255,66,165610,76,196996
11637,0.002397,74.125.24.0-255,4320,169930,76,196996
11638,0.002416,74.125.24.0-255,7156,177086,76,196996
11639,0.002423,172.31.40.0-255,66,177152,76,196996
11640,0.002474,172.31.40.0-255,66,177218,76,196996
11641,0.002507,172.31.40.0-255,66,177284,76,196996
11642,0.002561,172.31.40.0-255,66,177350,76,196996
11643,0.004904,74.125.24.0-255,5738,183088,76,196996
11644,0.012583,172.31.40.0-255,66,183154,76,196996
11645,0.013205,74.125.24.0-255,1484,184638,76,196996
11646,0.01494,74.125.24.0-255,4320,188958,76,196996
11647,0.014947,172.31.40.0-255,66,189024,76,196996
11648,0.01727,74.125.24.0-255,3433,192457,76,196996
11649,0.017277,172.31.40.0-255,66,192523,76,196996
11650,0.025591,172.31.40.0-255,105,192628,76,196996
11651,0.027919,74.125.24.0-255,66,192694,76,196996
11652,0.037925,172.31.40.0-255,172,192866,76,196996
11653,0.037957,172.31.40.0-255,1107,193973,76,196996
11654,0.038009,172.31.40.0-255,1514,195487,76,196996
11655,0.03801,172.31.40.0-255,1311,196798,76,196996
11656,0.039553,104.244.42.0-255,66,196864,76,196996
11657,0.039618,104.244.42.0-255,66,196930,76,196996
11658,0.039708,104.244.42.0-255,66,196996,76,196996
11659,0.0,74.125.68.0-255,143,143,76,357111
11660,2.3e-05,172.31.40.0-255,66,209,76,357111
11661,3e-05,74.125.68.0-255,1484,1693,76,357111
11662,3.5e-05,172.31.40.0-255,66,1759,76,357111
11663,4e-05,74.125.68.0-255,2902,4661,76,357111
11664,4.4e-05,172.31.40.0-255,66,4727,76,357111
11665,5e-05,74.125.68.0-255,5738,10465,76,357111
11666,5.3e-05,172.31.40.0-255,66,10531,76,357111
11667,7.1e-05,74.125.68.0-255,6292,16823,76,357111
11668,7.5e-05,172.31.40.0-255,66,16889,76,357111
11669,9.5e-05,74.125.68.0-255,7156,24045,76,357111
11670,9.8e-05,172.31.40.0-255,66,24111,76,357111
11671,0.000141,74.125.68.0-255,6797,30908,76,357111
11672,0.000144,172.31.40.0-255,66,30974,76,357111
11673,0.000207,74.125.68.0-255,1484,32458,76,357111
11674,0.00021,172.31.40.0-255,66,32524,76,357111
11675,0.000213,74.125.68.0-255,1484,34008,76,357111
11676,0.000215,172.31.40.0-255,66,34074,76,357111
11677,0.000228,74.125.68.0-255,1484,35558,76,357111
11678,0.00023,172.31.40.0-255,66,35624,76,357111
11679,0.000244,74.125.68.0-255,2902,38526,76,357111
11680,0.000247,172.31.40.0-255,66,38592,76,357111
11681,0.000252,74.125.68.0-255,4320,42912,76,357111
11682,0.000254,172.31.40.0-255,66,42978,76,357111
11683,0.000287,74.125.68.0-255,2902,45880,76,357111
11684,0.00029,172.31.40.0-255,66,45946,76,357111
11685,0.000316,74.125.68.0-255,6797,52743,76,357111
11686,0.000319,172.31.40.0-255,66,52809,76,357111
11687,0.000331,172.31.40.0-255,66,52875,76,357111
11688,0.000334,74.125.68.0-255,1484,54359,76,357111
11689,0.000336,172.31.40.0-255,66,54425,76,357111
11690,0.00036,74.125.68.0-255,1436,55861,76,357111
11691,0.000384,74.125.68.0-255,112,55973,76,357111
11692,0.000446,74.125.68.0-255,330,56303,76,357111
11693,0.000449,172.31.40.0-255,66,56369,76,357111
11694,0.000607,74.125.68.0-255,1484,57853,76,357111
11695,0.000614,74.125.68.0-255,2902,60755,76,357111
11696,0.000618,172.31.40.0-255,66,60821,76,357111
11697,0.000648,74.125.68.0-255,5738,66559,76,357111
11698,0.000651,172.31.40.0-255,66,66625,76,357111
11699,0.000736,74.125.68.0-255,5738,72363,76,357111
11700,0.000741,172.31.40.0-255,66,72429,76,357111
11701,0.000761,74.125.68.0-255,7156,79585,76,357111
11702,0.000764,172.31.40.0-255,66,79651,76,357111
11703,0.000777,172.31.40.0-255,66,79717,76,357111
11704,0.001013,74.125.68.0-255,1484,81201,76,357111
11705,0.001034,74.125.68.0-255,2902,84103,76,357111
11706,0.001038,172.31.40.0-255,66,84169,76,357111
11707,0.001062,74.125.68.0-255,5738,89907,76,357111
11708,0.001065,172.31.40.0-255,66,89973,76,357111
11709,0.001104,74.125.68.0-255,4320,94293,76,357111
11710,0.001107,172.31.40.0-255,66,94359,76,357111
11711,0.001127,74.125.68.0-255,2902,97261,76,357111
11712,0.001129,172.31.40.0-255,66,97327,76,357111
11713,0.001133,74.125.68.0-255,2902,100229,76,357111
11714,0.001135,172.31.40.0-255,66,100295,76,357111
11715,0.00114,74.125.68.0-255,2902,103197,76,357111
11716,0.001142,172.31.40.0-255,66,103263,76,357111
11717,0.001156,74.125.68.0-255,1484,104747,76,357111
11718,0.001172,74.125.68.0-255,2902,107649,76,357111
11719,0.001175,172.31.40.0-255,66,107715,76,357111
11720,0.001196,74.125.68.0-255,2902,110617,76,357111
11721,0.001199,172.31.40.0-255,66,110683,76,357111
11722,0.001218,74.125.68.0-255,3602,114285,76,357111
11723,0.001221,172.31.40.0-255,66,114351,76,357111
11724,0.001298,74.125.68.0-255,1484,115835,76,357111
11725,0.001317,74.125.68.0-255,2902,118737,76,357111
11726,0.00132,172.31.40.0-255,66,118803,76,357111
11727,0.001324,74.125.68.0-255,1484,120287,76,357111
11728,0.001344,74.125.68.0-255,4320,124607,76,357111
11729,0.001347,172.31.40.0-255,66,124673,76,357111
11730,0.001381,74.125.68.0-255,4320,128993,76,357111
11731,0.001384,172.31.40.0-255,66,129059,76,357111
11732,0.001411,172.31.40.0-255,66,129125,76,357111
11733,0.001443,172.31.40.0-255,66,129191,76,357111
11734,0.001491,74.125.68.0-255,1484,130675,76,357111
11735,0.001496,74.125.68.0-255,2902,133577,76,357111
11736,0.001498,172.31.40.0-255,66,133643,76,357111
11737,0.001527,74.125.68.0-255,4320,137963,76,357111
11738,0.00153,172.31.40.0-255,66,138029,76,357111
11739,0.001557,74.125.68.0-255,1484,139513,76,357111
11740,0.001561,74.125.68.0-255,1484,140997,76,357111
11741,0.001563,172.31.40.0-255,66,141063,76,357111
11742,0.001573,172.31.40.0-255,66,141129,76,357111
11743,0.001599,172.31.40.0-255,66,141195,76,357111
11744,0.00165,74.125.68.0-255,5020,146215,76,357111
11745,0.001654,172.31.40.0-255,66,146281,76,357111
11746,0.001729,74.125.68.0-255,1484,147765,76,357111
11747,0.001741,74.125.68.0-255,1484,149249,76,357111
11748,0.001744,172.31.40.0-255,66,149315,76,357111
11749,0.001762,74.125.68.0-255,1484,150799,76,357111
11750,0.001785,74.125.68.0-255,5738,156537,76,357111
11751,0.001788,172.31.40.0-255,66,156603,76,357111
11752,0.001816,74.125.68.0-255,4320,160923,76,357111
11753,0.001819,172.31.40.0-255,66,160989,76,357111
11754,0.001839,74.125.68.0-255,2902,163891,76,357111
11755,0.001841,172.31.40.0-255,66,163957,76,357111
11756,0.001845,74.125.68.0-255,2902,166859,76,357111
11757,0.001848,172.31.40.0-255,66,166925,76,357111
11758,0.001853,74.125.68.0-255,4320,171245,76,357111
11759,0.001856,172.31.40.0-255,66,171311,76,357111
11760,0.001891,74.125.68.0-255,5738,177049,76,357111
11761,0.001894,172.31.40.0-255,66,177115,76,357111
11762,0.001949,74.125.68.0-255,3602,180717,76,357111
11763,0.001953,172.31.40.0-255,66,180783,76,357111
11764,0.002164,74.125.68.0-255,1484,182267,76,357111
11765,0.002172,74.125.68.0-255,2902,185169,76,357111
11766,0.002177,172.31.40.0-255,66,185235,76,357111
11767,0.002184,74.125.68.0-255,5738,190973,76,357111
11768,0.002186,172.31.40.0-255,66,191039,76,357111
11769,0.002189,74.125.68.0-255,1484,192523,76,357111
11770,0.002212,74.125.68.0-255,2902,195425,76,357111
11771,0.002214,172.31.40.0-255,66,195491,76,357111
11772,0.002239,74.125.68.0-255,5738,201229,76,357111
11773,0.002242,172.31.40.0-255,66,201295,76,357111
11774,0.002292,74.125.68.0-255,7156,208451,76,357111
11775,0.002296,172.31.40.0-255,66,208517,76,357111
11776,0.002299,74.125.68.0-255,1484,210001,76,357111
11777,0.002322,74.125.68.0-255,4320,214321,76,357111
11778,0.002324,172.31.40.0-255,66,214387,76,357111
11779,0.002327,74.125.68.0-255,766,215153,76,357111
11780,0.004648,74.125.68.0-255,4320,219473,76,357111
11781,0.004656,172.31.40.0-255,66,219539,76,357111
11782,0.006945,74.125.68.0-255,5738,225277,76,357111
11783,0.006952,172.31.40.0-255,66,225343,76,357111
11784,0.009252,74.125.68.0-255,5738,231081,76,357111
11785,0.009259,172.31.40.0-255,66,231147,76,357111
11786,0.011548,74.125.68.0-255,5738,236885,76,357111
11787,0.011558,172.31.40.0-255,66,236951,76,357111
11788,0.01385,74.125.68.0-255,5738,242689,76,357111
11789,0.013862,172.31.40.0-255,66,242755,76,357111
11790,0.016158,74.125.68.0-255,5738,248493,76,357111
11791,0.016169,172.31.40.0-255,66,248559,76,357111
11792,0.018483,74.125.68.0-255,5738,254297,76,357111
11793,0.018491,172.31.40.0-255,66,254363,76,357111
11794,0.020792,74.125.68.0-255,5738,260101,76,357111
11795,0.020801,172.31.40.0-255,66,260167,76,357111
11796,0.023092,74.125.68.0-255,5738,265905,76,357111
11797,0.0231,172.31.40.0-255,66,265971,76,357111
11798,0.025389,74.125.68.0-255,5738,271709,76,357111
11799,0.025397,172.31.40.0-255,66,271775,76,357111
11800,0.027692,74.125.68.0-255,5738,277513,76,357111
11801,0.027701,172.31.40.0-255,66,277579,76,357111
11802,0.02999,74.125.68.0-255,5738,283317,76,357111
11803,0.029997,172.31.40.0-255,66,283383,76,357111
11804,0.031337,172.31.40.0-255,172,283555,76,357111
11805,0.031371,172.31.40.0-255,1109,284664,76,357111
11806,0.031427,172.31.40.0-255,1514,286178,76,357111
11807,0.031429,172.31.40.0-255,1307,287485,76,357111
11808,0.032297,74.125.68.0-255,5738,293223,76,357111
11809,0.032304,172.31.40.0-255,66,293289,76,357111
11810,0.032882,104.244.42.0-255,66,293355,76,357111
11811,0.03289,104.244.42.0-255,66,293421,76,357111
11812,0.032992,104.244.42.0-255,66,293487,76,357111
11813,0.034653,74.125.68.0-255,5738,299225,76,357111
11814,0.034659,172.31.40.0-255,66,299291,76,357111
11815,0.036955,74.125.68.0-255,5738,305029,76,357111
11816,0.036962,172.31.40.0-255,66,305095,76,357111
11817,0.039245,74.125.68.0-255,5738,310833,76,357111
11818,0.039251,172.31.40.0-255,66,310899,76,357111
11819,0.041563,74.125.68.0-255,5738,316637,76,357111
11820,0.041573,172.31.40.0-255,66,316703,76,357111
11821,0.043888,74.125.68.0-255,5738,322441,76,357111
11822,0.043896,172.31.40.0-255,66,322507,76,357111
11823,0.046192,74.125.68.0-255,5738,328245,76,357111
11824,0.046198,172.31.40.0-255,66,328311,76,357111
11825,0.048489,74.125.68.0-255,5738,334049,76,357111
11826,0.048495,172.31.40.0-255,66,334115,76,357111
11827,0.05078,74.125.68.0-255,5738,339853,76,357111
11828,0.050785,172.31.40.0-255,66,339919,76,357111
11829,0.05307,74.125.68.0-255,5738,345657,76,357111
11830,0.053076,172.31.40.0-255,66,345723,76,357111
11831,0.055387,74.125.68.0-255,5738,351461,76,357111
11832,0.055397,172.31.40.0-255,66,351527,76,357111
11833,0.057692,74.125.68.0-255,5347,356874,76,357111
11834,0.057697,172.31.40.0-255,66,356940,76,357111
11835,0.057866,172.31.40.0-255,105,357045,76,357111
11836,0.060106,74.125.68.0-255,66,357111,76,357111
11837,0.0,172.217.194.0-255,150,150,76,317703
11838,2.3e-05,172.31.40.0-255,66,216,76,317703
11839,3.1e-05,172.217.194.0-255,1484,1700,76,317703
11840,3.5e-05,172.31.40.0-255,66,1766,76,317703
11841,4.2e-05,172.217.194.0-255,2902,4668,76,317703
11842,4.6e-05,172.31.40.0-255,66,4734,76,317703
11843,5.4e-05,172.217.194.0-255,7156,11890,76,317703
11844,5.7e-05,172.31.40.0-255,66,11956,76,317703
11845,6.1e-05,172.217.194.0-255,1484,13440,76,317703
11846,6.3e-05,172.31.40.0-255,66,13506,76,317703
11847,0.000112,172.31.40.0-255,66,13572,76,317703
11848,0.000116,172.217.194.0-255,2543,16115,76,317703
11849,0.000118,172.31.40.0-255,66,16181,76,317703
11850,0.000139,172.217.194.0-255,1484,17665,76,317703
11851,0.000141,172.31.40.0-255,66,17731,76,317703
11852,0.000145,172.217.194.0-255,1484,19215,76,317703
11853,0.000147,172.31.40.0-255,66,19281,76,317703
11854,0.000162,172.217.194.0-255,1484,20765,76,317703
11855,0.000165,172.31.40.0-255,66,20831,76,317703
11856,0.000187,172.217.194.0-255,5738,26569,76,317703
11857,0.000191,172.31.40.0-255,66,26635,76,317703
11858,0.000201,172.217.194.0-255,5738,32373,76,317703
11859,0.000205,172.31.40.0-255,66,32439,76,317703
11860,0.000221,172.217.194.0-255,1125,33564,76,317703
11861,0.000224,172.31.40.0-255,66,33630,76,317703
11862,0.000364,172.217.194.0-255,1484,35114,76,317703
11863,0.000368,172.31.40.0-255,66,35180,76,317703
11864,0.000374,172.217.194.0-255,2902,38082,76,317703
11865,0.000378,172.31.40.0-255,66,38148,76,317703
11866,0.000382,172.217.194.0-255,2902,41050,76,317703
11867,0.000385,172.31.40.0-255,66,41116,76,317703
11868,0.000411,172.217.194.0-255,2902,44018,76,317703
11869,0.000433,172.217.194.0-255,2902,46920,76,317703
11870,0.000446,172.217.194.0-255,4260,51180,76,317703
11871,0.000601,172.31.40.0-255,66,51246,76,317703
11872,0.000761,172.217.194.0-255,378,51624,76,317703
11873,0.000891,172.217.194.0-255,1484,53108,76,317703
11874,0.000897,172.217.194.0-255,2902,56010,76,317703
11875,0.000914,172.217.194.0-255,1484,57494,76,317703
11876,0.000918,172.31.40.0-255,66,57560,76,317703
11877,0.000939,172.217.194.0-255,4320,61880,76,317703
11878,0.000947,172.217.194.0-255,6797,68677,76,317703
11879,0.000961,172.31.40.0-255,66,68743,76,317703
11880,0.000973,172.217.194.0-255,7156,75899,76,317703
11881,0.000984,172.31.40.0-255,66,75965,76,317703
11882,0.00107,172.217.194.0-255,1125,77090,76,317703
11883,0.001073,172.31.40.0-255,66,77156,76,317703
11884,0.001503,172.217.194.0-255,1484,78640,76,317703
11885,0.001508,172.31.40.0-255,66,78706,76,317703
11886,0.001513,172.217.194.0-255,2902,81608,76,317703
11887,0.001517,172.31.40.0-255,66,81674,76,317703
11888,0.001532,172.217.194.0-255,5738,87412,76,317703
11889,0.00155,172.217.194.0-255,1484,88896,76,317703
11890,0.001554,172.31.40.0-255,66,88962,76,317703
11891,0.001587,172.217.194.0-255,766,89728,76,317703
11892,0.001635,172.31.40.0-255,66,89794,76,317703
11893,0.004014,172.217.194.0-255,5738,95532,76,317703
11894,0.00402,172.31.40.0-255,66,95598,76,317703
11895,0.006408,172.217.194.0-255,5738,101336,76,317703
11896,0.008134,172.31.40.0-255,66,101402,76,317703
11897,0.01054,172.217.194.0-255,5738,107140,76,317703
11898,0.010549,172.31.40.0-255,66,107206,76,317703
11899,0.012911,172.217.194.0-255,5738,112944,76,317703
11900,0.012919,172.31.40.0-255,66,113010,76,317703
11901,0.015267,172.217.194.0-255,5738,118748,76,317703
11902,0.015525,172.31.40.0-255,66,118814,76,317703
11903,0.017895,172.217.194.0-255,5738,124552,76,317703
11904,0.017902,172.31.40.0-255,66,124618,76,317703
11905,0.020281,172.217.194.0-255,5738,130356,76,317703
11906,0.020288,172.31.40.0-255,66,130422,76,317703
11907,0.022631,172.217.194.0-255,5738,136160,76,317703
11908,0.022639,172.31.40.0-255,66,136226,76,317703
11909,0.025044,172.217.194.0-255,5738,141964,76,317703
11910,0.025057,172.31.40.0-255,66,142030,76,317703
11911,0.027013,172.31.40.0-255,172,142202,76,317703
11912,0.027048,172.31.40.0-255,1104,143306,76,317703
11913,0.027109,172.31.40.0-255,1514,144820,76,317703
11914,0.027111,172.31.40.0-255,345,145165,76,317703
11915,0.027424,172.217.194.0-255,5738,150903,76,317703
11916,0.027431,172.31.40.0-255,66,150969,76,317703
11917,0.0293,104.244.42.0-255,66,151035,76,317703
11918,0.029831,172.217.194.0-255,5738,156773,76,317703
11919,0.029836,172.31.40.0-255,66,156839,76,317703
11920,0.032215,172.217.194.0-255,2902,159741,76,317703
11921,0.032221,172.31.40.0-255,66,159807,76,317703
11922,0.032243,172.217.194.0-255,2902,162709,76,317703
11923,0.032263,172.31.40.0-255,66,162775,76,317703
11924,0.034574,172.217.194.0-255,2902,165677,76,317703
11925,0.034581,172.31.40.0-255,66,165743,76,317703
11926,0.034615,172.217.194.0-255,1484,167227,76,317703
11927,0.034629,172.217.194.0-255,1484,168711,76,317703
11928,0.034635,172.31.40.0-255,66,168777,76,317703
11929,0.036948,172.217.194.0-255,2902,171679,76,317703
11930,0.036956,172.31.40.0-255,66,171745,76,317703
11931,0.037004,172.217.194.0-255,2902,174647,76,317703
11932,0.037221,172.31.40.0-255,66,174713,76,317703
11933,0.039319,172.217.194.0-255,2902,177615,76,317703
11934,0.039326,172.31.40.0-255,66,177681,76,317703
11935,0.039569,172.217.194.0-255,2902,180583,76,317703
11936,0.03979,172.31.40.0-255,66,180649,76,317703
11937,0.041668,172.217.194.0-255,2902,183551,76,317703
11938,0.041677,172.31.40.0-255,66,183617,76,317703
11939,0.042148,172.217.194.0-255,2902,186519,76,317703
11940,0.042155,172.31.40.0-255,66,186585,76,317703
11941,0.044039,172.217.194.0-255,2902,189487,76,317703
11942,0.044046,172.31.40.0-255,66,189553,76,317703
11943,0.044516,172.217.194.0-255,2902,192455,76,317703
11944,0.044522,172.31.40.0-255,66,192521,76,317703
11945,0.046428,172.217.194.0-255,2902,195423,76,317703
11946,0.046435,172.31.40.0-255,66,195489,76,317703
11947,0.046869,172.217.194.0-255,2902,198391,76,317703
11948,0.046875,172.31.40.0-255,66,198457,76,317703
11949,0.048838,172.217.194.0-255,2902,201359,76,317703
11950,0.048845,172.31.40.0-255,66,201425,76,317703
11951,0.049281,172.217.194.0-255,2902,204327,76,317703
11952,0.049287,172.31.40.0-255,66,204393,76,317703
11953,0.051231,172.217.194.0-255,2902,207295,76,317703
11954,0.05125,172.31.40.0-255,66,207361,76,317703
11955,0.051698,172.217.194.0-255,2902,210263,76,317703
11956,0.053636,172.217.194.0-255,2902,213165,76,317703
11957,0.057016,172.31.40.0-255,66,213231,76,317703
11958,0.059423,172.217.194.0-255,5738,218969,76,317703
11959,0.059442,172.31.40.0-255,66,219035,76,317703
11960,0.061842,172.217.194.0-255,5738,224773,76,317703
11961,0.06186,172.31.40.0-255,66,224839,76,317703
11962,0.064218,172.217.194.0-255,5738,230577,76,317703
11963,0.06423,172.31.40.0-255,66,230643,76,317703
11964,0.066608,172.217.194.0-255,5738,236381,76,317703
11965,0.066616,172.31.40.0-255,66,236447,76,317703
11966,0.069044,172.217.194.0-255,5738,242185,76,317703
11967,0.069053,172.31.40.0-255,66,242251,76,317703
11968,0.071448,172.217.194.0-255,5738,247989,76,317703
11969,0.071455,172.31.40.0-255,66,248055,76,317703
11970,0.07379,172.217.194.0-255,5738,253793,76,317703
11971,0.073797,172.31.40.0-255,66,253859,76,317703
11972,0.076175,172.217.194.0-255,5738,259597,76,317703
11973,0.076182,172.31.40.0-255,66,259663,76,317703
11974,0.078579,172.217.194.0-255,5738,265401,76,317703
11975,0.078585,172.31.40.0-255,66,265467,76,317703
11976,0.080972,172.217.194.0-255,5738,271205,76,317703
11977,0.080979,172.31.40.0-255,66,271271,76,317703
11978,0.083327,172.217.194.0-255,5738,277009,76,317703
11979,0.083334,172.31.40.0-255,66,277075,76,317703
11980,0.08573,172.217.194.0-255,5738,282813,76,317703
11981,0.085738,172.31.40.0-255,66,282879,76,317703
11982,0.088097,172.217.194.0-255,5738,288617,76,317703
11983,0.088104,172.31.40.0-255,66,288683,76,317703
11984,0.090485,172.217.194.0-255,5738,294421,76,317703
11985,0.090492,172.31.40.0-255,66,294487,76,317703
11986,0.092858,172.217.194.0-255,5738,300225,76,317703
11987,0.092865,172.31.40.0-255,66,300291,76,317703
11988,0.095209,172.217.194.0-255,5738,306029,76,317703
11989,0.095217,172.31.40.0-255,66,306095,76,317703
11990,0.097576,172.217.194.0-255,5738,311833,76,317703
11991,0.097582,172.31.40.0-255,66,311899,76,317703
11992,0.099924,172.217.194.0-255,5738,317637,76,317703
11993,0.099933,172.31.40.0-255,66,317703,76,317703
11994,0.0,172.217.24.0-255,156,156,76,374601
11995,2.1e-05,172.31.40.0-255,66,222,76,374601
11996,2.7e-05,172.217.24.0-255,1484,1706,76,374601
11997,3.1e-05,172.31.40.0-255,66,1772,76,374601
11998,3.6e-05,172.217.24.0-255,2902,4674,76,374601
11999,4.6e-05,172.31.40.0-255,66,4740,76,374601
12000,5.3e-05,172.217.24.0-255,5738,10478,76,374601
12001,5.6e-05,172.31.40.0-255,66,10544,76,374601
12002,7.7e-05,172.217.24.0-255,2902,13446,76,374601
12003,8.3e-05,172.31.40.0-255,66,13512,76,374601
12004,0.000117,172.31.40.0-255,66,13578,76,374601
12005,0.000123,172.217.24.0-255,6797,20375,76,374601
12006,0.000125,172.31.40.0-255,66,20441,76,374601
12007,0.000203,172.217.24.0-255,1484,21925,76,374601
12008,0.000206,172.31.40.0-255,66,21991,76,374601
12009,0.000235,172.217.24.0-255,2902,24893,76,374601
12010,0.000237,172.31.40.0-255,66,24959,76,374601
12011,0.000243,172.217.24.0-255,5738,30697,76,374601
12012,0.000245,172.31.40.0-255,66,30763,76,374601
12013,0.000249,172.217.24.0-255,4320,35083,76,374601
12014,0.000255,172.31.40.0-255,66,35149,76,374601
12015,0.000261,172.217.24.0-255,5379,40528,76,374601
12016,0.000263,172.31.40.0-255,66,40594,76,374601
12017,0.000267,172.217.24.0-255,2902,43496,76,374601
12018,0.000269,172.31.40.0-255,66,43562,76,374601
12019,0.000311,172.31.40.0-255,66,43628,76,374601
12020,0.000315,172.217.24.0-255,2844,46472,76,374601
12021,0.000316,172.31.40.0-255,66,46538,76,374601
12022,0.000851,172.217.24.0-255,120,46658,76,374601
12023,0.000859,172.31.40.0-255,66,46724,76,374601
12024,0.001254,172.217.24.0-255,1484,48208,76,374601
12025,0.001305,172.217.24.0-255,2902,51110,76,374601
12026,0.001311,172.31.40.0-255,66,51176,76,374601
12027,0.001318,172.217.24.0-255,4320,55496,76,374601
12028,0.00132,172.31.40.0-255,66,55562,76,374601
12029,0.001376,172.31.40.0-255,66,55628,76,374601
12030,0.001403,172.217.24.0-255,4320,59948,76,374601
12031,0.001405,172.31.40.0-255,66,60014,76,374601
12032,0.001408,172.217.24.0-255,1484,61498,76,374601
12033,0.001427,172.217.24.0-255,4320,65818,76,374601
12034,0.00143,172.31.40.0-255,66,65884,76,374601
12035,0.001477,172.217.24.0-255,2902,68786,76,374601
12036,0.00148,172.31.40.0-255,66,68852,76,374601
12037,0.001507,172.217.24.0-255,1484,70336,76,374601
12038,0.001514,172.217.24.0-255,5738,76074,76,374601
12039,0.001516,172.31.40.0-255,66,76140,76,374601
12040,0.001521,172.217.24.0-255,2902,79042,76,374601
12041,0.001523,172.31.40.0-255,66,79108,76,374601
12042,0.001533,172.217.24.0-255,4320,83428,76,374601
12043,0.001535,172.31.40.0-255,66,83494,76,374601
12044,0.001586,172.217.24.0-255,1484,84978,76,374601
12045,0.001591,172.217.24.0-255,2902,87880,76,374601
12046,0.001594,172.31.40.0-255,66,87946,76,374601
12047,0.001623,172.217.24.0-255,2184,90130,76,374601
12048,0.001626,172.31.40.0-255,66,90196,76,374601
12049,0.001752,172.217.24.0-255,1484,91680,76,374601
12050,0.001761,172.217.24.0-255,2902,94582,76,374601
12051,0.001764,172.31.40.0-255,66,94648,76,374601
12052,0.001768,172.217.24.0-255,1484,96132,76,374601
12053,0.001797,172.217.24.0-255,4320,100452,76,374601
12054,0.001799,172.31.40.0-255,66,100518,76,374601
12055,0.001803,172.217.24.0-255,1484,102002,76,374601
12056,0.001831,172.217.24.0-255,5379,107381,76,374601
12057,0.001834,172.31.40.0-255,66,107447,76,374601
12058,0.001841,172.217.24.0-255,7156,114603,76,374601
12059,0.001844,172.31.40.0-255,66,114669,76,374601
12060,0.001847,172.217.24.0-255,2902,117571,76,374601
12061,0.001854,172.31.40.0-255,66,117637,76,374601
12062,0.001902,172.31.40.0-255,66,117703,76,374601
12063,0.001914,172.31.40.0-255,66,117769,76,374601
12064,0.001921,172.217.24.0-255,766,118535,76,374601
12065,0.002093,172.217.24.0-255,1484,120019,76,374601
12066,0.002096,172.31.40.0-255,66,120085,76,374601
12067,0.00399,172.217.24.0-255,2902,122987,76,374601
12068,0.003994,172.31.40.0-255,66,123053,76,374601
12069,0.004162,172.217.24.0-255,2902,125955,76,374601
12070,0.004165,172.31.40.0-255,66,126021,76,374601
12071,0.006085,172.217.24.0-255,2902,128923,76,374601
12072,0.00609,172.31.40.0-255,66,128989,76,374601
12073,0.006237,172.217.24.0-255,2902,131891,76,374601
12074,0.006239,172.31.40.0-255,66,131957,76,374601
12075,0.008172,172.217.24.0-255,2902,134859,76,374601
12076,0.008177,172.31.40.0-255,66,134925,76,374601
12077,0.008323,172.217.24.0-255,1484,136409,76,374601
12078,0.008336,172.217.24.0-255,1484,137893,76,374601
12079,0.008339,172.31.40.0-255,66,137959,76,374601
12080,0.010259,172.217.24.0-255,2902,140861,76,374601
12081,0.010264,172.31.40.0-255,66,140927,76,374601
12082,0.010415,172.217.24.0-255,2902,143829,76,374601
12083,0.01042,172.31.40.0-255,66,143895,76,374601
12084,0.012355,172.217.24.0-255,2902,146797,76,374601
12085,0.012362,172.31.40.0-255,66,146863,76,374601
12086,0.012505,172.217.24.0-255,2902,149765,76,374601
12087,0.01251,172.31.40.0-255,66,149831,76,374601
12088,0.01444,172.217.24.0-255,2902,152733,76,374601
12089,0.014447,172.31.40.0-255,66,152799,76,374601
12090,0.014583,172.217.24.0-255,2902,155701,76,374601
12091,0.014588,172.31.40.0-255,66,155767,76,374601
12092,0.016536,172.217.24.0-255,2902,158669,76,374601
12093,0.016543,172.31.40.0-255,66,158735,76,374601
12094,0.016665,172.217.24.0-255,2902,161637,76,374601
12095,0.01667,172.31.40.0-255,66,161703,76,374601
12096,0.018629,172.217.24.0-255,2902,164605,76,374601
12097,0.018636,172.31.40.0-255,66,164671,76,374601
12098,0.018748,172.217.24.0-255,2902,167573,76,374601
12099,0.018752,172.31.40.0-255,66,167639,76,374601
12100,0.020721,172.217.24.0-255,2902,170541,76,374601
12101,0.020729,172.31.40.0-255,66,170607,76,374601
12102,0.020832,172.217.24.0-255,2902,173509,76,374601
12103,0.020837,172.31.40.0-255,66,173575,76,374601
12104,0.02281,172.217.24.0-255,2902,176477,76,374601
12105,0.022818,172.31.40.0-255,66,176543,76,374601
12106,0.022913,172.217.24.0-255,2902,179445,76,374601
12107,0.022918,172.31.40.0-255,66,179511,76,374601
12108,0.024904,172.217.24.0-255,2902,182413,76,374601
12109,0.024909,172.31.40.0-255,66,182479,76,374601
12110,0.024995,172.217.24.0-255,2902,185381,76,374601
12111,0.024998,172.31.40.0-255,66,185447,76,374601
12112,0.026999,172.217.24.0-255,2902,188349,76,374601
12113,0.027005,172.31.40.0-255,66,188415,76,374601
12114,0.027077,172.217.24.0-255,2902,191317,76,374601
12115,0.027081,172.31.40.0-255,66,191383,76,374601
12116,0.029089,172.217.24.0-255,2902,194285,76,374601
12117,0.029096,172.31.40.0-255,66,194351,76,374601
12118,0.029148,172.217.24.0-255,2902,197253,76,374601
12119,0.029151,172.31.40.0-255,66,197319,76,374601
12120,0.030341,172.31.40.0-255,176,197495,76,374601
12121,0.030373,172.31.40.0-255,1109,198604,76,374601
12122,0.03044,172.31.40.0-255,1514,200118,76,374601
12123,0.030442,172.31.40.0-255,1307,201425,76,374601
12124,0.031179,172.217.24.0-255,2902,204327,76,374601
12125,0.03119,172.31.40.0-255,66,204393,76,374601
12126,0.031241,172.217.24.0-255,2902,207295,76,374601
12127,0.031244,172.31.40.0-255,66,207361,76,374601
12128,0.03199,104.244.42.0-255,66,207427,76,374601
12129,0.032019,104.244.42.0-255,66,207493,76,374601
12130,0.032141,104.244.42.0-255,66,207559,76,374601
12131,0.033279,172.217.24.0-255,2902,210461,76,374601
12132,0.033285,172.31.40.0-255,66,210527,76,374601
12133,0.033317,172.217.24.0-255,2902,213429,76,374601
12134,0.03332,172.31.40.0-255,66,213495,76,374601
12135,0.035385,172.217.24.0-255,4320,217815,76,374601
12136,0.035392,172.31.40.0-255,66,217881,76,374601
12137,0.035423,172.217.24.0-255,1484,219365,76,374601
12138,0.037492,172.217.24.0-255,4320,223685,76,374601
12139,0.037499,172.31.40.0-255,66,223751,76,374601
12140,0.039604,172.217.24.0-255,5738,229489,76,374601
12141,0.039611,172.31.40.0-255,66,229555,76,374601
12142,0.041754,172.217.24.0-255,5738,235293,76,374601
12143,0.04176,172.31.40.0-255,66,235359,76,374601
12144,0.043869,172.217.24.0-255,5738,241097,76,374601
12145,0.043876,172.31.40.0-255,66,241163,76,374601
12146,0.046011,172.217.24.0-255,5738,246901,76,374601
12147,0.046018,172.31.40.0-255,66,246967,76,374601
12148,0.048118,172.217.24.0-255,5738,252705,76,374601
12149,0.048125,172.31.40.0-255,66,252771,76,374601
12150,0.050218,172.217.24.0-255,5738,258509,76,374601
12151,0.050225,172.31.40.0-255,66,258575,76,374601
12152,0.052334,172.217.24.0-255,5738,264313,76,374601
12153,0.052341,172.31.40.0-255,66,264379,76,374601
12154,0.054428,172.217.24.0-255,5738,270117,76,374601
12155,0.054434,172.31.40.0-255,66,270183,76,374601
12156,0.056527,172.217.24.0-255,5738,275921,76,374601
12157,0.056533,172.31.40.0-255,66,275987,76,374601
12158,0.058633,172.217.24.0-255,5738,281725,76,374601
12159,0.058639,172.31.40.0-255,66,281791,76,374601
12160,0.060734,172.217.24.0-255,5738,287529,76,374601
12161,0.06074,172.31.40.0-255,66,287595,76,374601
12162,0.062838,172.217.24.0-255,5738,293333,76,374601
12163,0.062844,172.31.40.0-255,66,293399,76,374601
12164,0.064946,172.217.24.0-255,5738,299137,76,374601
12165,0.064952,172.31.40.0-255,66,299203,76,374601
12166,0.067048,172.217.24.0-255,5738,304941,76,374601
12167,0.067055,172.31.40.0-255,66,305007,76,374601
12168,0.069147,172.217.24.0-255,5738,310745,76,374601
12169,0.069153,172.31.40.0-255,66,310811,76,374601
12170,0.071258,172.217.24.0-255,5738,316549,76,374601
12171,0.071264,172.31.40.0-255,66,316615,76,374601
12172,0.073348,172.217.24.0-255,5738,322353,76,374601
12173,0.073353,172.31.40.0-255,66,322419,76,374601
12174,0.075446,172.217.24.0-255,5738,328157,76,374601
12175,0.075455,172.31.40.0-255,66,328223,76,374601
12176,0.077558,172.217.24.0-255,5738,333961,76,374601
12177,0.077564,172.31.40.0-255,66,334027,76,374601
12178,0.079689,172.217.24.0-255,5738,339765,76,374601
12179,0.079694,172.31.40.0-255,66,339831,76,374601
12180,0.081784,172.217.24.0-255,5738,345569,76,374601
12181,0.081791,172.31.40.0-255,66,345635,76,374601
12182,0.083888,172.217.24.0-255,5738,351373,76,374601
12183,0.083894,172.31.40.0-255,66,351439,76,374601
12184,0.085989,172.217.24.0-255,5738,357177,76,374601
12185,0.085995,172.31.40.0-255,66,357243,76,374601
12186,0.088088,172.217.24.0-255,5738,362981,76,374601
12187,0.088094,172.31.40.0-255,66,363047,76,374601
12188,0.090208,172.217.24.0-255,5738,368785,76,374601
12189,0.090215,172.31.40.0-255,66,368851,76,374601
12190,0.092311,172.217.24.0-255,5513,374364,76,374601
12191,0.092318,172.31.40.0-255,66,374430,76,374601
12192,0.092511,172.31.40.0-255,105,374535,76,374601
12193,0.094563,172.217.24.0-255,66,374601,76,374601
12194,0.0,74.125.24.0-255,299,299,76,328504
12195,1.6e-05,172.31.40.0-255,66,365,76,328504
12196,2.2e-05,74.125.24.0-255,1484,1849,76,328504
12197,2.7e-05,172.31.40.0-255,66,1915,76,328504
12198,3.4e-05,74.125.24.0-255,4320,6235,76,328504
12199,3.7e-05,172.31.40.0-255,66,6301,76,328504
12200,4.3e-05,74.125.24.0-255,2902,9203,76,328504
12201,4.6e-05,172.31.40.0-255,66,9269,76,328504
12202,6.6e-05,74.125.24.0-255,4798,14067,76,328504
12203,6.9e-05,172.31.40.0-255,66,14133,76,328504
12204,7.4e-05,74.125.24.0-255,2902,17035,76,328504
12205,7.6e-05,172.31.40.0-255,66,17101,76,328504
12206,0.000101,74.125.24.0-255,5738,22839,76,328504
12207,0.000104,172.31.40.0-255,66,22905,76,328504
12208,0.000114,172.31.40.0-255,66,22971,76,328504
12209,0.000226,74.125.24.0-255,1484,24455,76,328504
12210,0.00023,172.31.40.0-255,66,24521,76,328504
12211,0.000236,74.125.24.0-255,2902,27423,76,328504
12212,0.000238,172.31.40.0-255,66,27489,76,328504
12213,0.000256,74.125.24.0-255,2902,30391,76,328504
12214,0.000258,172.31.40.0-255,66,30457,76,328504
12215,0.000263,74.125.24.0-255,4320,34777,76,328504
12216,0.000266,172.31.40.0-255,66,34843,76,328504
12217,0.000288,74.125.24.0-255,4320,39163,76,328504
12218,0.000291,172.31.40.0-255,66,39229,76,328504
12219,0.000316,74.125.24.0-255,5379,44608,76,328504
12220,0.000319,172.31.40.0-255,66,44674,76,328504
12221,0.000325,74.125.24.0-255,5738,50412,76,328504
12222,0.000328,172.31.40.0-255,66,50478,76,328504
12223,0.000354,74.125.24.0-255,7076,57554,76,328504
12224,0.000357,172.31.40.0-255,66,57620,76,328504
12225,0.000382,74.125.24.0-255,377,57997,76,328504
12226,0.00047,74.125.24.0-255,1484,59481,76,328504
12227,0.000473,172.31.40.0-255,66,59547,76,328504
12228,0.000479,74.125.24.0-255,2902,62449,76,328504
12229,0.000481,172.31.40.0-255,66,62515,76,328504
12230,0.000486,74.125.24.0-255,2902,65417,76,328504
12231,0.000488,172.31.40.0-255,66,65483,76,328504
12232,0.000518,74.125.24.0-255,2902,68385,76,328504
12233,0.000522,172.31.40.0-255,66,68451,76,328504
12234,0.000529,74.125.24.0-255,6797,75248,76,328504
12235,0.000531,172.31.40.0-255,66,75314,76,328504
12236,0.00082,74.125.24.0-255,1484,76798,76,328504
12237,0.000826,74.125.24.0-255,2902,79700,76,328504
12238,0.00083,172.31.40.0-255,66,79766,76,328504
12239,0.000861,74.125.24.0-255,4320,84086,76,328504
12240,0.000864,172.31.40.0-255,66,84152,76,328504
12241,0.000871,74.125.24.0-255,5738,89890,76,328504
12242,0.000873,172.31.40.0-255,66,89956,76,328504
12243,0.0009,74.125.24.0-255,2543,92499,76,328504
12244,0.000903,172.31.40.0-255,66,92565,76,328504
12245,0.001064,74.125.24.0-255,1484,94049,76,328504
12246,0.001069,74.125.24.0-255,2902,96951,76,328504
12247,0.001072,172.31.40.0-255,66,97017,76,328504
12248,0.001079,74.125.24.0-255,4320,101337,76,328504
12249,0.001081,172.31.40.0-255,66,101403,76,328504
12250,0.001125,74.125.24.0-255,1484,102887,76,328504
12251,0.001141,172.31.40.0-255,66,102953,76,328504
12252,0.001149,74.125.24.0-255,7156,110109,76,328504
12253,0.001151,172.31.40.0-255,66,110175,76,328504
12254,0.001154,74.125.24.0-255,1484,111659,76,328504
12255,0.001178,74.125.24.0-255,2184,113843,76,328504
12256,0.001181,172.31.40.0-255,66,113909,76,328504
12257,0.001289,74.125.24.0-255,1484,115393,76,328504
12258,0.001309,74.125.24.0-255,2902,118295,76,328504
12259,0.001313,172.31.40.0-255,66,118361,76,328504
12260,0.00132,74.125.24.0-255,5738,124099,76,328504
12261,0.001322,172.31.40.0-255,66,124165,76,328504
12262,0.001328,74.125.24.0-255,4320,128485,76,328504
12263,0.00133,172.31.40.0-255,66,128551,76,328504
12264,0.001334,74.125.24.0-255,1484,130035,76,328504
12265,0.001366,172.31.40.0-255,66,130101,76,328504
12266,0.001369,74.125.24.0-255,1484,131585,76,328504
12267,0.001393,74.125.24.0-255,6438,138023,76,328504
12268,0.001398,172.31.40.0-255,66,138089,76,328504
12269,0.001583,74.125.24.0-255,1484,139573,76,328504
12270,0.001589,74.125.24.0-255,2902,142475,76,328504
12271,0.001592,172.31.40.0-255,66,142541,76,328504
12272,0.001598,74.125.24.0-255,4320,146861,76,328504
12273,0.0016,172.31.40.0-255,66,146927,76,328504
12274,0.001612,74.125.24.0-255,1484,148411,76,328504
12275,0.001616,74.125.24.0-255,1484,149895,76,328504
12276,0.001618,172.31.40.0-255,66,149961,76,328504
12277,0.001644,172.31.40.0-255,66,150027,76,328504
12278,0.001657,172.31.40.0-255,66,150093,76,328504
12279,0.001712,74.125.24.0-255,2184,152277,76,328504
12280,0.001714,172.31.40.0-255,66,152343,76,328504
12281,0.00183,74.125.24.0-255,1484,153827,76,328504
12282,0.001861,74.125.24.0-255,2902,156729,76,328504
12283,0.001864,172.31.40.0-255,66,156795,76,328504
12284,0.001869,74.125.24.0-255,4320,161115,76,328504
12285,0.001872,172.31.40.0-255,66,161181,76,328504
12286,0.001883,74.125.24.0-255,1484,162665,76,328504
12287,0.001886,74.125.24.0-255,1484,164149,76,328504
12288,0.001888,172.31.40.0-255,66,164215,76,328504
12289,0.001899,172.31.40.0-255,66,164281,76,328504
12290,0.001934,74.125.24.0-255,4320,168601,76,328504
12291,0.001937,172.31.40.0-255,66,168667,76,328504
12292,0.001968,172.31.40.0-255,66,168733,76,328504
12293,0.002007,74.125.24.0-255,1484,170217,76,328504
12294,0.002012,74.125.24.0-255,2902,173119,76,328504
12295,0.002017,172.31.40.0-255,66,173185,76,328504
12296,0.002036,74.125.24.0-255,2902,176087,76,328504
12297,0.002039,172.31.40.0-255,66,176153,76,328504
12298,0.002045,74.125.24.0-255,4320,180473,76,328504
12299,0.002047,172.31.40.0-255,66,180539,76,328504
12300,0.002057,74.125.24.0-255,4320,184859,76,328504
12301,0.002059,172.31.40.0-255,66,184925,76,328504
12302,0.002075,74.125.24.0-255,4320,189245,76,328504
12303,0.002077,172.31.40.0-255,66,189311,76,328504
12304,0.002081,74.125.24.0-255,2902,192213,76,328504
12305,0.002083,172.31.40.0-255,66,192279,76,328504
12306,0.002114,172.31.40.0-255,66,192345,76,328504
12307,0.002241,74.125.24.0-255,1484,193829,76,328504
12308,0.002254,74.125.24.0-255,2902,196731,76,328504
12309,0.002257,172.31.40.0-255,66,196797,76,328504
12310,0.00228,74.125.24.0-255,5738,202535,76,328504
12311,0.002283,172.31.40.0-255,66,202601,76,328504
12312,0.002287,74.125.24.0-255,2902,205503,76,328504
12313,0.002289,172.31.40.0-255,66,205569,76,328504
12314,0.002303,74.125.24.0-255,2902,208471,76,328504
12315,0.002305,172.31.40.0-255,66,208537,76,328504
12316,0.002325,74.125.24.0-255,7156,215693,76,328504
12317,0.002329,172.31.40.0-255,66,215759,76,328504
12318,0.002335,74.125.24.0-255,5738,221497,76,328504
12319,0.002336,172.31.40.0-255,66,221563,76,328504
12320,0.002355,74.125.24.0-255,4320,225883,76,328504
12321,0.002358,172.31.40.0-255,66,225949,76,328504
12322,0.002379,74.125.24.0-255,766,226715,76,328504
12323,0.002502,74.125.24.0-255,1484,228199,76,328504
12324,0.002506,172.31.40.0-255,66,228265,76,328504
12325,0.00251,74.125.24.0-255,2902,231167,76,328504
12326,0.002512,172.31.40.0-255,66,231233,76,328504
12327,0.002516,74.125.24.0-255,2902,234135,76,328504
12328,0.002518,172.31.40.0-255,66,234201,76,328504
12329,0.002542,74.125.24.0-255,2902,237103,76,328504
12330,0.002545,172.31.40.0-255,66,237169,76,328504
12331,0.002556,172.31.40.0-255,66,237235,76,328504
12332,0.002599,74.125.24.0-255,7156,244391,76,328504
12333,0.002603,172.31.40.0-255,66,244457,76,328504
12334,0.002622,74.125.24.0-255,6438,250895,76,328504
12335,0.002625,172.31.40.0-255,66,250961,76,328504
12336,0.003799,172.31.40.0-255,101,251062,76,328504
12337,0.005201,74.125.24.0-255,5738,256800,76,328504
12338,0.005209,172.31.40.0-255,66,256866,76,328504
12339,0.006332,74.125.24.0-255,66,256932,76,328504
12340,0.007862,74.125.24.0-255,5738,262670,76,328504
12341,0.007867,172.31.40.0-255,66,262736,76,328504
12342,0.010483,74.125.24.0-255,5738,268474,76,328504
12343,0.010492,172.31.40.0-255,66,268540,76,328504
12344,0.013146,74.125.24.0-255,5738,274278,76,328504
12345,0.013163,172.31.40.0-255,66,274344,76,328504
12346,0.015771,74.125.24.0-255,5738,280082,76,328504
12347,0.015789,172.31.40.0-255,66,280148,76,328504
12348,0.01836,74.125.24.0-255,5738,285886,76,328504
12349,0.018369,172.31.40.0-255,66,285952,76,328504
12350,0.020969,74.125.24.0-255,5738,291690,76,328504
12351,0.020978,172.31.40.0-255,66,291756,76,328504
12352,0.023628,74.125.24.0-255,5738,297494,76,328504
12353,0.023636,172.31.40.0-255,66,297560,76,328504
12354,0.026216,74.125.24.0-255,5738,303298,76,328504
12355,0.026224,172.31.40.0-255,66,303364,76,328504
12356,0.028773,74.125.24.0-255,5738,309102,76,328504
12357,0.028782,172.31.40.0-255,66,309168,76,328504
12358,0.0314,74.125.24.0-255,5738,314906,76,328504
12359,0.031407,172.31.40.0-255,66,314972,76,328504
12360,0.034024,74.125.24.0-255,5738,320710,76,328504
12361,0.034031,172.31.40.0-255,66,320776,76,328504
12362,0.03663,74.125.24.0-255,4158,324934,76,328504
12363,0.036638,172.31.40.0-255,66,325000,76,328504
12364,0.036849,172.31.40.0-255,172,325172,76,328504
12365,0.036877,172.31.40.0-255,1104,326276,76,328504
12366,0.036931,172.31.40.0-255,1514,327790,76,328504
12367,0.036933,172.31.40.0-255,345,328135,76,328504
12368,0.037061,172.31.40.0-255,105,328240,76,328504
12369,0.038398,104.244.42.0-255,66,328306,76,328504
12370,0.038438,104.244.42.0-255,66,328372,76,328504
12371,0.038485,104.244.42.0-255,66,328438,76,328504
12372,0.043896,74.125.24.0-255,66,328504,76,328504
12373,0.0,172.217.194.0-255,146,146,76,182590
12374,2.3e-05,172.31.40.0-255,66,212,76,182590
12375,3e-05,172.217.194.0-255,1484,1696,76,182590
12376,3.5e-05,172.31.40.0-255,66,1762,76,182590
12377,4e-05,172.217.194.0-255,2902,4664,76,182590
12378,4.4e-05,172.31.40.0-255,66,4730,76,182590
12379,5.3e-05,172.217.194.0-255,7156,11886,76,182590
12380,5.6e-05,172.31.40.0-255,66,11952,76,182590
12381,6.9e-05,172.31.40.0-255,66,12018,76,182590
12382,8.3e-05,172.31.40.0-255,66,12084,76,182590
12383,9e-05,172.217.194.0-255,7156,19240,76,182590
12384,9.2e-05,172.31.40.0-255,66,19306,76,182590
12385,0.000103,172.31.40.0-255,66,19372,76,182590
12386,0.000106,172.217.194.0-255,1125,20497,76,182590
12387,0.000109,172.31.40.0-255,66,20563,76,182590
12388,0.000176,172.217.194.0-255,1484,22047,76,182590
12389,0.00018,172.31.40.0-255,66,22113,76,182590
12390,0.000193,172.217.194.0-255,2902,25015,76,182590
12391,0.000196,172.31.40.0-255,66,25081,76,182590
12392,0.0002,172.217.194.0-255,1484,26565,76,182590
12393,0.000202,172.31.40.0-255,66,26631,76,182590
12394,0.000224,172.217.194.0-255,4320,30951,76,182590
12395,0.000227,172.31.40.0-255,66,31017,76,182590
12396,0.000248,172.217.194.0-255,2902,33919,76,182590
12397,0.000251,172.31.40.0-255,66,33985,76,182590
12398,0.00027,172.217.194.0-255,3961,37946,76,182590
12399,0.000273,172.31.40.0-255,66,38012,76,182590
12400,0.000538,172.217.194.0-255,379,38391,76,182590
12401,0.000552,172.31.40.0-255,66,38457,76,182590
12402,0.000845,172.217.194.0-255,1484,39941,76,182590
12403,0.00085,172.217.194.0-255,1484,41425,76,182590
12404,0.000854,172.31.40.0-255,66,41491,76,182590
12405,0.000873,172.217.194.0-255,1484,42975,76,182590
12406,0.000878,172.217.194.0-255,4320,47295,76,182590
12407,0.000887,172.31.40.0-255,66,47361,76,182590
12408,0.000891,172.217.194.0-255,1484,48845,76,182590
12409,0.000925,172.31.40.0-255,66,48911,76,182590
12410,0.000932,172.217.194.0-255,7156,56067,76,182590
12411,0.000934,172.31.40.0-255,66,56133,76,182590
12412,0.000968,172.217.194.0-255,3602,59735,76,182590
12413,0.000971,172.31.40.0-255,66,59801,76,182590
12414,0.002395,172.217.194.0-255,1484,61285,76,182590
12415,0.00241,172.217.194.0-255,2902,64187,76,182590
12416,0.002415,172.31.40.0-255,66,64253,76,182590
12417,0.002424,172.217.194.0-255,5738,69991,76,182590
12418,0.002426,172.31.40.0-255,66,70057,76,182590
12419,0.002439,172.31.40.0-255,66,70123,76,182590
12420,0.002464,172.217.194.0-255,1484,71607,76,182590
12421,0.002466,172.217.194.0-255,1484,73091,76,182590
12422,0.002469,172.31.40.0-255,66,73157,76,182590
12423,0.002498,172.217.194.0-255,2902,76059,76,182590
12424,0.0025,172.31.40.0-255,66,76125,76,182590
12425,0.002525,172.217.194.0-255,6438,82563,76,182590
12426,0.002527,172.31.40.0-255,66,82629,76,182590
12427,0.002599,172.217.194.0-255,1484,84113,76,182590
12428,0.002612,172.217.194.0-255,2902,87015,76,182590
12429,0.002615,172.31.40.0-255,66,87081,76,182590
12430,0.002621,172.217.194.0-255,4320,91401,76,182590
12431,0.002623,172.31.40.0-255,66,91467,76,182590
12432,0.002639,172.217.194.0-255,1484,92951,76,182590
12433,0.002651,172.217.194.0-255,2902,95853,76,182590
12434,0.002654,172.31.40.0-255,66,95919,76,182590
12435,0.002686,172.31.40.0-255,66,95985,76,182590
12436,0.002689,172.217.194.0-255,1484,97469,76,182590
12437,0.002757,172.31.40.0-255,66,97535,76,182590
12438,0.002785,172.31.40.0-255,66,97601,76,182590
12439,0.002803,172.31.40.0-255,66,97667,76,182590
12440,0.00281,172.217.194.0-255,7156,104823,76,182590
12441,0.002815,172.217.194.0-255,4320,109143,76,182590
12442,0.002839,172.217.194.0-255,4320,113463,76,182590
12443,0.002844,172.217.194.0-255,2902,116365,76,182590
12444,0.002874,172.217.194.0-255,766,117131,76,182590
12445,0.003118,172.217.194.0-255,1484,118615,76,182590
12446,0.003136,172.217.194.0-255,2902,121517,76,182590
12447,0.003142,172.217.194.0-255,4320,125837,76,182590
12448,0.003155,172.217.194.0-255,1484,127321,76,182590
12449,0.003162,172.217.194.0-255,5738,133059,76,182590
12450,0.003185,172.217.194.0-255,4320,137379,76,182590
12451,0.003225,172.217.194.0-255,4320,141699,76,182590
12452,0.003255,172.217.194.0-255,7156,148855,76,182590
12453,0.003273,172.217.194.0-255,1484,150339,76,182590
12454,0.003281,172.217.194.0-255,7156,157495,76,182590
12455,0.003284,172.217.194.0-255,1484,158979,76,182590
12456,0.003318,172.217.194.0-255,4320,163299,76,182590
12457,0.003377,172.217.194.0-255,7156,170455,76,182590
12458,0.003426,172.217.194.0-255,2902,173357,76,182590
12459,0.00353,172.217.194.0-255,4320,177677,76,182590
12460,0.003621,172.217.194.0-255,97,177774,76,182590
12461,0.003635,172.217.194.0-255,105,177879,76,182590
12462,0.006034,172.31.40.0-255,66,177945,76,182590
12463,0.008479,172.31.40.0-255,105,178050,76,182590
12464,0.010838,172.217.194.0-255,66,178116,76,182590
12465,0.032223,172.31.40.0-255,172,178288,76,182590
12466,0.032256,172.31.40.0-255,1107,179395,76,182590
12467,0.032316,172.31.40.0-255,1514,180909,76,182590
12468,0.032318,172.31.40.0-255,1309,182218,76,182590
12469,0.033755,104.244.42.0-255,66,182284,76,182590
12470,0.033806,104.244.42.0-255,66,182350,76,182590
12471,0.033901,104.244.42.0-255,66,182416,76,182590
12472,0.034402,104.244.42.0-255,108,182524,76,182590
12473,0.034412,172.31.40.0-255,66,182590,76,182590
12474,0.0,74.125.68.0-255,155,155,76,252218
12475,2.1e-05,172.31.40.0-255,66,221,76,252218
12476,2.7e-05,74.125.68.0-255,1484,1705,76,252218
12477,3.1e-05,172.31.40.0-255,66,1771,76,252218
12478,3.7e-05,74.125.68.0-255,2902,4673,76,252218
12479,4.7e-05,172.31.40.0-255,66,4739,76,252218
12480,6.4e-05,74.125.68.0-255,1484,6223,76,252218
12481,6.6e-05,172.31.40.0-255,66,6289,76,252218
12482,9.1e-05,74.125.68.0-255,1484,7773,76,252218
12483,9.3e-05,172.31.40.0-255,66,7839,76,252218
12484,9.9e-05,74.125.68.0-255,4320,12159,76,252218
12485,0.000101,172.31.40.0-255,66,12225,76,252218
12486,0.00013,74.125.68.0-255,2064,14289,76,252218
12487,0.000132,172.31.40.0-255,66,14355,76,252218
12488,0.000136,74.125.68.0-255,2902,17257,76,252218
12489,0.000138,172.31.40.0-255,66,17323,76,252218
12490,0.000174,74.125.68.0-255,2902,20225,76,252218
12491,0.000176,172.31.40.0-255,66,20291,76,252218
12492,0.000203,74.125.68.0-255,4320,24611,76,252218
12493,0.000205,172.31.40.0-255,66,24677,76,252218
12494,0.000223,74.125.68.0-255,4320,28997,76,252218
12495,0.000226,172.31.40.0-255,66,29063,76,252218
12496,0.000248,74.125.68.0-255,2543,31606,76,252218
12497,0.000251,172.31.40.0-255,66,31672,76,252218
12498,0.000358,74.125.68.0-255,1484,33156,76,252218
12499,0.000363,172.31.40.0-255,66,33222,76,252218
12500,0.000367,74.125.68.0-255,1484,34706,76,252218
12501,0.000369,172.31.40.0-255,66,34772,76,252218
12502,0.000374,74.125.68.0-255,2902,37674,76,252218
12503,0.000396,172.31.40.0-255,66,37740,76,252218
12504,0.000404,74.125.68.0-255,5738,43478,76,252218
12505,0.000408,172.31.40.0-255,66,43544,76,252218
12506,0.000441,74.125.68.0-255,5379,48923,76,252218
12507,0.000445,172.31.40.0-255,66,48989,76,252218
12508,0.00045,74.125.68.0-255,5738,54727,76,252218
12509,0.000452,172.31.40.0-255,66,54793,76,252218
12510,0.000487,172.31.40.0-255,66,54859,76,252218
12511,0.000515,74.125.68.0-255,1439,56298,76,252218
12512,0.000539,74.125.68.0-255,109,56407,76,252218
12513,0.000596,74.125.68.0-255,1484,57891,76,252218
12514,0.0006,172.31.40.0-255,66,57957,76,252218
12515,0.000603,74.125.68.0-255,1484,59441,76,252218
12516,0.000626,74.125.68.0-255,1484,60925,76,252218
12517,0.000628,172.31.40.0-255,66,60991,76,252218
12518,0.000633,74.125.68.0-255,2902,63893,76,252218
12519,0.000636,172.31.40.0-255,66,63959,76,252218
12520,0.000646,74.125.68.0-255,4320,68279,76,252218
12521,0.000649,172.31.40.0-255,66,68345,76,252218
12522,0.000651,74.125.68.0-255,1484,69829,76,252218
12523,0.000687,74.125.68.0-255,7156,76985,76,252218
12524,0.00069,172.31.40.0-255,66,77051,76,252218
12525,0.000696,74.125.68.0-255,4320,81371,76,252218
12526,0.000698,172.31.40.0-255,66,81437,76,252218
12527,0.000704,74.125.68.0-255,5738,87175,76,252218
12528,0.000706,172.31.40.0-255,66,87241,76,252218
12529,0.000731,74.125.68.0-255,3602,90843,76,252218
12530,0.000734,172.31.40.0-255,66,90909,76,252218
12531,0.000856,74.125.68.0-255,1484,92393,76,252218
12532,0.000874,74.125.68.0-255,2902,95295,76,252218
12533,0.000878,172.31.40.0-255,66,95361,76,252218
12534,0.000884,74.125.68.0-255,4320,99681,76,252218
12535,0.000886,172.31.40.0-255,66,99747,76,252218
12536,0.000926,172.31.40.0-255,66,99813,76,252218
12537,0.000934,74.125.68.0-255,7156,106969,76,252218
12538,0.000936,172.31.40.0-255,66,107035,76,252218
12539,0.000976,172.31.40.0-255,66,107101,76,252218
12540,0.000979,74.125.68.0-255,766,107867,76,252218
12541,0.001014,74.125.68.0-255,1484,109351,76,252218
12542,0.001018,172.31.40.0-255,66,109417,76,252218
12543,0.001026,74.125.68.0-255,1484,110901,76,252218
12544,0.001029,74.125.68.0-255,1484,112385,76,252218
12545,0.001031,172.31.40.0-255,66,112451,76,252218
12546,0.00105,74.125.68.0-255,1484,113935,76,252218
12547,0.001062,74.125.68.0-255,5738,119673,76,252218
12548,0.001067,172.31.40.0-255,66,119739,76,252218
12549,0.001094,74.125.68.0-255,7156,126895,76,252218
12550,0.001097,172.31.40.0-255,66,126961,76,252218
12551,0.001109,172.31.40.0-255,66,127027,76,252218
12552,0.00114,74.125.68.0-255,6438,133465,76,252218
12553,0.001144,172.31.40.0-255,66,133531,76,252218
12554,0.001182,74.125.68.0-255,1484,135015,76,252218
12555,0.001187,74.125.68.0-255,2902,137917,76,252218
12556,0.001189,172.31.40.0-255,66,137983,76,252218
12557,0.00121,74.125.68.0-255,5738,143721,76,252218
12558,0.001212,172.31.40.0-255,66,143787,76,252218
12559,0.001243,172.31.40.0-255,66,143853,76,252218
12560,0.001281,172.31.40.0-255,66,143919,76,252218
12561,0.001286,74.125.68.0-255,5020,148939,76,252218
12562,0.001288,172.31.40.0-255,66,149005,76,252218
12563,0.001349,74.125.68.0-255,1484,150489,76,252218
12564,0.001353,74.125.68.0-255,2902,153391,76,252218
12565,0.001355,172.31.40.0-255,66,153457,76,252218
12566,0.001361,74.125.68.0-255,5738,159195,76,252218
12567,0.001363,172.31.40.0-255,66,159261,76,252218
12568,0.001408,172.31.40.0-255,66,159327,76,252218
12569,0.00142,172.31.40.0-255,66,159393,76,252218
12570,0.001444,74.125.68.0-255,1484,160877,76,252218
12571,0.001448,74.125.68.0-255,2902,163779,76,252218
12572,0.001451,172.31.40.0-255,66,163845,76,252218
12573,0.001474,74.125.68.0-255,766,164611,76,252218
12574,0.001611,74.125.68.0-255,1484,166095,76,252218
12575,0.001616,172.31.40.0-255,66,166161,76,252218
12576,0.001621,74.125.68.0-255,2902,169063,76,252218
12577,0.001623,172.31.40.0-255,66,169129,76,252218
12578,0.001628,74.125.68.0-255,2902,172031,76,252218
12579,0.001629,172.31.40.0-255,66,172097,76,252218
12580,0.001665,74.125.68.0-255,4320,176417,76,252218
12581,0.001682,74.125.68.0-255,1484,177901,76,252218
12582,0.001687,172.31.40.0-255,66,177967,76,252218
12583,0.001689,172.31.40.0-255,66,178033,76,252218
12584,0.001716,74.125.68.0-255,5738,183771,76,252218
12585,0.001719,172.31.40.0-255,66,183837,76,252218
12586,0.001734,74.125.68.0-255,4320,188157,76,252218
12587,0.001736,172.31.40.0-255,66,188223,76,252218
12588,0.001763,74.125.68.0-255,2184,190407,76,252218
12589,0.001768,172.31.40.0-255,66,190473,76,252218
12590,0.001871,74.125.68.0-255,1484,191957,76,252218
12591,0.001888,74.125.68.0-255,2902,194859,76,252218
12592,0.001891,172.31.40.0-255,66,194925,76,252218
12593,0.001925,74.125.68.0-255,5738,200663,76,252218
12594,0.001928,172.31.40.0-255,66,200729,76,252218
12595,0.001962,172.31.40.0-255,66,200795,76,252218
12596,0.001994,74.125.68.0-255,4320,205115,76,252218
12597,0.001996,172.31.40.0-255,66,205181,76,252218
12598,0.002017,74.125.68.0-255,6438,211619,76,252218
12599,0.00202,172.31.40.0-255,66,211685,76,252218
12600,0.002025,74.125.68.0-255,4320,216005,76,252218
12601,0.002028,172.31.40.0-255,66,216071,76,252218
12602,0.002063,74.125.68.0-255,7156,223227,76,252218
12603,0.002066,172.31.40.0-255,66,223293,76,252218
12604,0.002071,74.125.68.0-255,4320,227613,76,252218
12605,0.002073,172.31.40.0-255,66,227679,76,252218
12606,0.00208,74.125.68.0-255,5738,233417,76,252218
12607,0.002095,74.125.68.0-255,766,234183,76,252218
12608,0.002099,172.31.40.0-255,66,234249,76,252218
12609,0.0021,172.31.40.0-255,66,234315,76,252218
12610,0.002148,74.125.68.0-255,2902,237217,76,252218
12611,0.002152,172.31.40.0-255,66,237283,76,252218
12612,0.002213,74.125.68.0-255,3602,240885,76,252218
12613,0.002219,172.31.40.0-255,66,240951,76,252218
12614,0.002227,172.31.40.0-255,66,241017,76,252218
12615,0.00223,172.31.40.0-255,66,241083,76,252218
12616,0.002271,172.31.40.0-255,66,241149,76,252218
12617,0.002356,172.31.40.0-255,66,241215,76,252218
12618,0.002362,74.125.68.0-255,5738,246953,76,252218
12619,0.002364,172.31.40.0-255,66,247019,76,252218
12620,0.002376,172.31.40.0-255,66,247085,76,252218
12621,0.00467,74.125.68.0-255,594,247679,76,252218
12622,0.008153,172.31.40.0-255,66,247745,76,252218
12623,0.008192,172.31.40.0-255,105,247850,76,252218
12624,0.010465,74.125.68.0-255,66,247916,76,252218
12625,0.032792,172.31.40.0-255,172,248088,76,252218
12626,0.032826,172.31.40.0-255,1107,249195,76,252218
12627,0.032889,172.31.40.0-255,1514,250709,76,252218
12628,0.032911,172.31.40.0-255,1311,252020,76,252218
12629,0.034323,104.244.42.0-255,66,252086,76,252218
12630,0.034361,104.244.42.0-255,66,252152,76,252218
12631,0.034447,104.244.42.0-255,66,252218,76,252218
12632,0.0,74.125.24.0-255,153,153,76,181786
12633,1.4e-05,172.31.40.0-255,66,219,76,181786
12634,2.1e-05,74.125.24.0-255,1484,1703,76,181786
12635,2.6e-05,172.31.40.0-255,66,1769,76,181786
12636,3.9e-05,74.125.24.0-255,2902,4671,76,181786
12637,4.3e-05,172.31.40.0-255,66,4737,76,181786
12638,5e-05,74.125.24.0-255,7156,11893,76,181786
12639,5.3e-05,172.31.40.0-255,66,11959,76,181786
12640,5.7e-05,74.125.24.0-255,2102,14061,76,181786
12641,6e-05,172.31.40.0-255,66,14127,76,181786
12642,9.7e-05,172.31.40.0-255,66,14193,76,181786
12643,0.0001,74.125.24.0-255,1484,15677,76,181786
12644,0.000102,172.31.40.0-255,66,15743,76,181786
12645,0.000126,74.125.24.0-255,3961,19704,76,181786
12646,0.000132,172.31.40.0-255,66,19770,76,181786
12647,0.000181,74.125.24.0-255,1484,21254,76,181786
12648,0.000184,172.31.40.0-255,66,21320,76,181786
12649,0.000189,74.125.24.0-255,2902,24222,76,181786
12650,0.000191,172.31.40.0-255,66,24288,76,181786
12651,0.000214,74.125.24.0-255,2902,27190,76,181786
12652,0.000216,172.31.40.0-255,66,27256,76,181786
12653,0.000224,74.125.24.0-255,7156,34412,76,181786
12654,0.000231,172.31.40.0-255,66,34478,76,181786
12655,0.000274,172.31.40.0-255,66,34544,76,181786
12656,0.000279,74.125.24.0-255,2818,37362,76,181786
12657,0.000281,172.31.40.0-255,66,37428,76,181786
12658,0.000284,74.125.24.0-255,129,37557,76,181786
12659,0.000291,172.31.40.0-255,66,37623,76,181786
12660,0.000383,74.125.24.0-255,349,37972,76,181786
12661,0.000388,172.31.40.0-255,66,38038,76,181786
12662,0.000541,74.125.24.0-255,1484,39522,76,181786
12663,0.000549,74.125.24.0-255,2902,42424,76,181786
12664,0.000552,172.31.40.0-255,66,42490,76,181786
12665,0.000559,74.125.24.0-255,5738,48228,76,181786
12666,0.000562,172.31.40.0-255,66,48294,76,181786
12667,0.000575,74.125.24.0-255,7156,55450,76,181786
12668,0.000577,172.31.40.0-255,66,55516,76,181786
12669,0.000625,172.31.40.0-255,66,55582,76,181786
12670,0.000629,74.125.24.0-255,2184,57766,76,181786
12671,0.000632,172.31.40.0-255,66,57832,76,181786
12672,0.000728,74.125.24.0-255,1484,59316,76,181786
12673,0.000746,74.125.24.0-255,2902,62218,76,181786
12674,0.00075,172.31.40.0-255,66,62284,76,181786
12675,0.000756,74.125.24.0-255,5738,68022,76,181786
12676,0.000759,172.31.40.0-255,66,68088,76,181786
12677,0.000805,74.125.24.0-255,5738,73826,76,181786
12678,0.000809,172.31.40.0-255,66,73892,76,181786
12679,0.000817,74.125.24.0-255,7156,81048,76,181786
12680,0.000819,172.31.40.0-255,66,81114,76,181786
12681,0.00083,74.125.24.0-255,5738,86852,76,181786
12682,0.000832,172.31.40.0-255,66,86918,76,181786
12683,0.000864,74.125.24.0-255,5020,91938,76,181786
12684,0.000868,172.31.40.0-255,66,92004,76,181786
12685,0.000904,172.31.40.0-255,66,92070,76,181786
12686,0.000922,172.31.40.0-255,66,92136,76,181786
12687,0.00096,74.125.24.0-255,4320,96456,76,181786
12688,0.000963,172.31.40.0-255,66,96522,76,181786
12689,0.000992,74.125.24.0-255,5020,101542,76,181786
12690,0.000995,172.31.40.0-255,66,101608,76,181786
12691,0.001007,172.31.40.0-255,66,101674,76,181786
12692,0.001024,172.31.40.0-255,66,101740,76,181786
12693,0.001073,172.31.40.0-255,66,101806,76,181786
12694,0.00119,74.125.24.0-255,1484,103290,76,181786
12695,0.001196,74.125.24.0-255,2902,106192,76,181786
12696,0.001199,172.31.40.0-255,66,106258,76,181786
12697,0.001233,74.125.24.0-255,5738,111996,76,181786
12698,0.001236,172.31.40.0-255,66,112062,76,181786
12699,0.001255,172.31.40.0-255,66,112128,76,181786
12700,0.00129,172.31.40.0-255,66,112194,76,181786
12701,0.00132,74.125.24.0-255,2184,114378,76,181786
12702,0.001324,172.31.40.0-255,66,114444,76,181786
12703,0.001346,74.125.24.0-255,5738,120182,76,181786
12704,0.001349,172.31.40.0-255,66,120248,76,181786
12705,0.001356,74.125.24.0-255,7156,127404,76,181786
12706,0.001359,172.31.40.0-255,66,127470,76,181786
12707,0.001401,172.31.40.0-255,66,127536,76,181786
12708,0.001426,74.125.24.0-255,2902,130438,76,181786
12709,0.001429,172.31.40.0-255,66,130504,76,181786
12710,0.001436,74.125.24.0-255,6438,136942,76,181786
12711,0.001438,172.31.40.0-255,66,137008,76,181786
12712,0.001866,74.125.24.0-255,1484,138492,76,181786
12713,0.001872,74.125.24.0-255,2902,141394,76,181786
12714,0.001876,172.31.40.0-255,66,141460,76,181786
12715,0.00191,74.125.24.0-255,5738,147198,76,181786
12716,0.001913,172.31.40.0-255,66,147264,76,181786
12717,0.001926,172.31.40.0-255,66,147330,76,181786
12718,0.001955,74.125.24.0-255,1484,148814,76,181786
12719,0.001968,172.31.40.0-255,66,148880,76,181786
12720,0.00206,74.125.24.0-255,1484,150364,76,181786
12721,0.002066,74.125.24.0-255,2902,153266,76,181786
12722,0.00207,172.31.40.0-255,66,153332,76,181786
12723,0.002077,74.125.24.0-255,5738,159070,76,181786
12724,0.002079,172.31.40.0-255,66,159136,76,181786
12725,0.002104,74.125.24.0-255,4320,163456,76,181786
12726,0.002106,172.31.40.0-255,66,163522,76,181786
12727,0.002137,172.31.40.0-255,66,163588,76,181786
12728,0.002142,74.125.24.0-255,2902,166490,76,181786
12729,0.002143,172.31.40.0-255,66,166556,76,181786
12730,0.002179,172.31.40.0-255,66,166622,76,181786
12731,0.002183,74.125.24.0-255,2902,169524,76,181786
12732,0.002185,172.31.40.0-255,66,169590,76,181786
12733,0.002223,172.31.40.0-255,66,169656,76,181786
12734,0.00223,74.125.24.0-255,7156,176812,76,181786
12735,0.002233,172.31.40.0-255,66,176878,76,181786
12736,0.002307,172.31.40.0-255,66,176944,76,181786
12737,0.002325,172.31.40.0-255,66,177010,76,181786
12738,0.00234,172.31.40.0-255,66,177076,76,181786
12739,0.002374,172.31.40.0-255,66,177142,76,181786
12740,0.002377,74.125.24.0-255,105,177247,76,181786
12741,0.005095,172.31.40.0-255,66,177313,76,181786
12742,0.005133,172.31.40.0-255,105,177418,76,181786
12743,0.007615,74.125.24.0-255,66,177484,76,181786
12744,0.030799,172.31.40.0-255,172,177656,76,181786
12745,0.030833,172.31.40.0-255,1107,178763,76,181786
12746,0.030893,172.31.40.0-255,1514,180277,76,181786
12747,0.030895,172.31.40.0-255,1311,181588,76,181786
12748,0.032338,104.244.42.0-255,66,181654,76,181786
12749,0.032388,104.244.42.0-255,66,181720,76,181786
12750,0.032436,104.244.42.0-255,66,181786,76,181786
12751,0.0,74.125.24.0-255,147,147,76,296989
12752,2.5e-05,172.31.40.0-255,66,213,76,296989
12753,3.3e-05,74.125.24.0-255,1484,1697,76,296989
12754,3.8e-05,172.31.40.0-255,66,1763,76,296989
12755,4.4e-05,74.125.24.0-255,2902,4665,76,296989
12756,4.8e-05,172.31.40.0-255,66,4731,76,296989
12757,5.6e-05,74.125.24.0-255,7156,11887,76,296989
12758,5.9e-05,172.31.40.0-255,66,11953,76,296989
12759,8.6e-05,74.125.24.0-255,2039,13992,76,296989
12760,8.9e-05,172.31.40.0-255,66,14058,76,296989
12761,0.000145,74.125.24.0-255,1484,15542,76,296989
12762,0.000147,172.31.40.0-255,66,15608,76,296989
12763,0.000151,74.125.24.0-255,1484,17092,76,296989
12764,0.000153,172.31.40.0-255,66,17158,76,296989
12765,0.000165,74.125.24.0-255,1484,18642,76,296989
12766,0.000168,172.31.40.0-255,66,18708,76,296989
12767,0.000173,74.125.24.0-255,2902,21610,76,296989
12768,0.000175,172.31.40.0-255,66,21676,76,296989
12769,0.000201,74.125.24.0-255,2902,24578,76,296989
12770,0.000204,172.31.40.0-255,66,24644,76,296989
12771,0.000212,74.125.24.0-255,6797,31441,76,296989
12772,0.000214,172.31.40.0-255,66,31507,76,296989
12773,0.000353,74.125.24.0-255,1484,32991,76,296989
12774,0.000358,172.31.40.0-255,66,33057,76,296989
12775,0.000363,74.125.24.0-255,2902,35959,76,296989
12776,0.000365,172.31.40.0-255,66,36025,76,296989
12777,0.000372,74.125.24.0-255,4320,40345,76,296989
12778,0.000375,172.31.40.0-255,66,40411,76,296989
12779,0.000397,74.125.24.0-255,1484,41895,76,296989
12780,0.0004,172.31.40.0-255,66,41961,76,296989
12781,0.000436,172.31.40.0-255,66,42027,76,296989
12782,0.000455,74.125.24.0-255,3961,45988,76,296989
12783,0.000458,172.31.40.0-255,66,46054,76,296989
12784,0.000461,74.125.24.0-255,1484,47538,76,296989
12785,0.000494,172.31.40.0-255,66,47604,76,296989
12786,0.000538,74.125.24.0-255,410,48014,76,296989
12787,0.000605,74.125.24.0-255,332,48346,76,296989
12788,0.000794,74.125.24.0-255,1484,49830,76,296989
12789,0.000799,172.31.40.0-255,66,49896,76,296989
12790,0.000804,74.125.24.0-255,2902,52798,76,296989
12791,0.000807,172.31.40.0-255,66,52864,76,296989
12792,0.00081,74.125.24.0-255,1484,54348,76,296989
12793,0.000843,74.125.24.0-255,4320,58668,76,296989
12794,0.000846,172.31.40.0-255,66,58734,76,296989
12795,0.000852,74.125.24.0-255,5738,64472,76,296989
12796,0.000855,172.31.40.0-255,66,64538,76,296989
12797,0.000876,74.125.24.0-255,7156,71694,76,296989
12798,0.000879,172.31.40.0-255,66,71760,76,296989
12799,0.000886,74.125.24.0-255,7156,78916,76,296989
12800,0.000889,172.31.40.0-255,66,78982,76,296989
12801,0.000912,74.125.24.0-255,3602,82584,76,296989
12802,0.000915,172.31.40.0-255,66,82650,76,296989
12803,0.000997,74.125.24.0-255,1484,84134,76,296989
12804,0.001004,74.125.24.0-255,2902,87036,76,296989
12805,0.001007,172.31.40.0-255,66,87102,76,296989
12806,0.001014,74.125.24.0-255,5738,92840,76,296989
12807,0.001016,172.31.40.0-255,66,92906,76,296989
12808,0.00102,74.125.24.0-255,1484,94390,76,296989
12809,0.001055,172.31.40.0-255,66,94456,76,296989
12810,0.001085,74.125.24.0-255,5738,100194,76,296989
12811,0.001088,172.31.40.0-255,66,100260,76,296989
12812,0.001096,74.125.24.0-255,7156,107416,76,296989
12813,0.001098,172.31.40.0-255,66,107482,76,296989
12814,0.0011,74.125.24.0-255,766,108248,76,296989
12815,0.00116,74.125.24.0-255,1484,109732,76,296989
12816,0.001164,172.31.40.0-255,66,109798,76,296989
12817,0.001168,74.125.24.0-255,1484,111282,76,296989
12818,0.001188,74.125.24.0-255,2902,114184,76,296989
12819,0.001193,74.125.24.0-255,4320,118504,76,296989
12820,0.001197,172.31.40.0-255,66,118570,76,296989
12821,0.001205,172.31.40.0-255,66,118636,76,296989
12822,0.001208,74.125.24.0-255,1484,120120,76,296989
12823,0.001257,74.125.24.0-255,4320,124440,76,296989
12824,0.00126,172.31.40.0-255,66,124506,76,296989
12825,0.001289,74.125.24.0-255,7156,131662,76,296989
12826,0.001293,172.31.40.0-255,66,131728,76,296989
12827,0.001305,172.31.40.0-255,66,131794,76,296989
12828,0.001344,74.125.24.0-255,1484,133278,76,296989
12829,0.001358,74.125.24.0-255,2902,136180,76,296989
12830,0.001362,172.31.40.0-255,66,136246,76,296989
12831,0.001384,74.125.24.0-255,1484,137730,76,296989
12832,0.0014,74.125.24.0-255,2902,140632,76,296989
12833,0.001418,74.125.24.0-255,1484,142116,76,296989
12834,0.001425,74.125.24.0-255,5738,147854,76,296989
12835,0.001434,172.31.40.0-255,66,147920,76,296989
12836,0.001464,74.125.24.0-255,1484,149404,76,296989
12837,0.00147,172.31.40.0-255,66,149470,76,296989
12838,0.001482,74.125.24.0-255,3602,153072,76,296989
12839,0.001505,172.31.40.0-255,66,153138,76,296989
12840,0.001569,74.125.24.0-255,1484,154622,76,296989
12841,0.001573,74.125.24.0-255,1484,156106,76,296989
12842,0.001577,172.31.40.0-255,66,156172,76,296989
12843,0.001584,74.125.24.0-255,1484,157656,76,296989
12844,0.001587,74.125.24.0-255,1484,159140,76,296989
12845,0.001598,172.31.40.0-255,66,159206,76,296989
12846,0.001604,74.125.24.0-255,4320,163526,76,296989
12847,0.001616,74.125.24.0-255,1484,165010,76,296989
12848,0.001649,172.31.40.0-255,66,165076,76,296989
12849,0.001663,74.125.24.0-255,2902,167978,76,296989
12850,0.001691,74.125.24.0-255,1484,169462,76,296989
12851,0.001694,74.125.24.0-255,1484,170946,76,296989
12852,0.001708,172.31.40.0-255,66,171012,76,296989
12853,0.001711,74.125.24.0-255,1484,172496,76,296989
12854,0.001732,74.125.24.0-255,5738,178234,76,296989
12855,0.001737,74.125.24.0-255,2902,181136,76,296989
12856,0.001748,172.31.40.0-255,66,181202,76,296989
12857,0.001778,74.125.24.0-255,5738,186940,76,296989
12858,0.001796,74.125.24.0-255,1484,188424,76,296989
12859,0.001802,74.125.24.0-255,3602,192026,76,296989
12860,0.00181,172.31.40.0-255,66,192092,76,296989
12861,0.001923,74.125.24.0-255,1484,193576,76,296989
12862,0.001928,74.125.24.0-255,1484,195060,76,296989
12863,0.001942,74.125.24.0-255,1484,196544,76,296989
12864,0.001946,172.31.40.0-255,66,196610,76,296989
12865,0.001953,74.125.24.0-255,1484,198094,76,296989
12866,0.00197,74.125.24.0-255,4320,202414,76,296989
12867,0.001973,74.125.24.0-255,1484,203898,76,296989
12868,0.001985,172.31.40.0-255,66,203964,76,296989
12869,0.002012,74.125.24.0-255,7156,211120,76,296989
12870,0.002028,74.125.24.0-255,1484,212604,76,296989
12871,0.002031,172.31.40.0-255,66,212670,76,296989
12872,0.002082,172.31.40.0-255,66,212736,76,296989
12873,0.002088,74.125.24.0-255,4320,217056,76,296989
12874,0.002094,172.31.40.0-255,66,217122,76,296989
12875,0.002128,74.125.24.0-255,1484,218606,76,296989
12876,0.002141,172.31.40.0-255,66,218672,76,296989
12877,0.002146,172.31.40.0-255,66,218738,76,296989
12878,0.002179,74.125.24.0-255,6438,225176,76,296989
12879,0.002228,172.31.40.0-255,66,225242,76,296989
12880,0.002599,74.125.24.0-255,1484,226726,76,296989
12881,0.002603,74.125.24.0-255,1484,228210,76,296989
12882,0.002606,172.31.40.0-255,66,228276,76,296989
12883,0.002624,74.125.24.0-255,1484,229760,76,296989
12884,0.002627,74.125.24.0-255,1484,231244,76,296989
12885,0.002638,74.125.24.0-255,1484,232728,76,296989
12886,0.002653,172.31.40.0-255,66,232794,76,296989
12887,0.002659,74.125.24.0-255,4320,237114,76,296989
12888,0.002664,172.31.40.0-255,66,237180,76,296989
12889,0.002672,74.125.24.0-255,1484,238664,76,296989
12890,0.002686,74.125.24.0-255,5738,244402,76,296989
12891,0.002703,74.125.24.0-255,5738,250140,76,296989
12892,0.002707,74.125.24.0-255,2902,253042,76,296989
12893,0.002711,172.31.40.0-255,66,253108,76,296989
12894,0.002732,74.125.24.0-255,5738,258846,76,296989
12895,0.002735,74.125.24.0-255,766,259612,76,296989
12896,0.002747,74.125.24.0-255,1484,261096,76,296989
12897,0.002753,74.125.24.0-255,2902,263998,76,296989
12898,0.002758,172.31.40.0-255,66,264064,76,296989
12899,0.00277,74.125.24.0-255,1484,265548,76,296989
12900,0.002777,74.125.24.0-255,5738,271286,76,296989
12901,0.002789,74.125.24.0-255,4320,275606,76,296989
12902,0.002794,74.125.24.0-255,2902,278508,76,296989
12903,0.002802,172.31.40.0-255,66,278574,76,296989
12904,0.002813,74.125.24.0-255,7156,285730,76,296989
12905,0.002815,74.125.24.0-255,1484,287214,76,296989
12906,0.002821,172.31.40.0-255,66,287280,76,296989
12907,0.002834,74.125.24.0-255,1484,288764,76,296989
12908,0.00286,172.31.40.0-255,66,288830,76,296989
12909,0.002878,74.125.24.0-255,3517,292347,76,296989
12910,0.002882,74.125.24.0-255,105,292452,76,296989
12911,0.002896,172.31.40.0-255,66,292518,76,296989
12912,0.010146,172.31.40.0-255,105,292623,76,296989
12913,0.012511,74.125.24.0-255,66,292689,76,296989
12914,0.033305,172.31.40.0-255,172,292861,76,296989
12915,0.033343,172.31.40.0-255,1109,293970,76,296989
12916,0.0334,172.31.40.0-255,1514,295484,76,296989
12917,0.033402,172.31.40.0-255,1307,296791,76,296989
12918,0.035029,104.244.42.0-255,66,296857,76,296989
12919,0.035042,104.244.42.0-255,66,296923,76,296989
12920,0.035114,104.244.42.0-255,66,296989,76,296989
12921,0.0,74.125.24.0-255,298,298,76,162468
12922,1.2e-05,172.31.40.0-255,66,364,76,162468
12923,1.7e-05,74.125.24.0-255,1484,1848,76,162468
12924,2.1e-05,172.31.40.0-255,66,1914,76,162468
12925,4.8e-05,74.125.24.0-255,4320,6234,76,162468
12926,5.1e-05,172.31.40.0-255,66,6300,76,162468
12927,5.4e-05,74.125.24.0-255,1484,7784,76,162468
12928,5.6e-05,172.31.40.0-255,66,7850,76,162468
12929,8.8e-05,172.31.40.0-255,66,7916,76,162468
12930,9.4e-05,74.125.24.0-255,4320,12236,76,162468
12931,9.6e-05,172.31.40.0-255,66,12302,76,162468
12932,0.000133,172.31.40.0-255,66,12368,76,162468
12933,0.000167,74.125.24.0-255,1484,13852,76,162468
12934,0.000169,172.31.40.0-255,66,13918,76,162468
12935,0.000195,74.125.24.0-255,2902,16820,76,162468
12936,0.000198,172.31.40.0-255,66,16886,76,162468
12937,0.000206,74.125.24.0-255,5738,22624,76,162468
12938,0.000208,172.31.40.0-255,66,22690,76,162468
12939,0.000216,74.125.24.0-255,6797,29487,76,162468
12940,0.000219,172.31.40.0-255,66,29553,76,162468
12941,0.000249,172.31.40.0-255,66,29619,76,162468
12942,0.000253,74.125.24.0-255,2815,32434,76,162468
12943,0.000254,172.31.40.0-255,66,32500,76,162468
12944,0.00032,74.125.24.0-255,385,32885,76,162468
12945,0.000323,172.31.40.0-255,66,32951,76,162468
12946,0.00043,74.125.24.0-255,1484,34435,76,162468
12947,0.000434,172.31.40.0-255,66,34501,76,162468
12948,0.000438,74.125.24.0-255,2902,37403,76,162468
12949,0.00044,172.31.40.0-255,66,37469,76,162468
12950,0.000446,74.125.24.0-255,5738,43207,76,162468
12951,0.000448,172.31.40.0-255,66,43273,76,162468
12952,0.000478,172.31.40.0-255,66,43339,76,162468
12953,0.000492,74.125.24.0-255,5379,48718,76,162468
12954,0.000494,172.31.40.0-255,66,48784,76,162468
12955,0.00051,74.125.24.0-255,1484,50268,76,162468
12956,0.000537,172.31.40.0-255,66,50334,76,162468
12957,0.00077,74.125.24.0-255,1484,51818,76,162468
12958,0.000786,74.125.24.0-255,1484,53302,76,162468
12959,0.00079,172.31.40.0-255,66,53368,76,162468
12960,0.000804,74.125.24.0-255,1484,54852,76,162468
12961,0.000809,74.125.24.0-255,5738,60590,76,162468
12962,0.000811,172.31.40.0-255,66,60656,76,162468
12963,0.000844,74.125.24.0-255,7156,67812,76,162468
12964,0.000847,172.31.40.0-255,66,67878,76,162468
12965,0.000868,74.125.24.0-255,5738,73616,76,162468
12966,0.000871,172.31.40.0-255,66,73682,76,162468
12967,0.000882,172.31.40.0-255,66,73748,76,162468
12968,0.000904,74.125.24.0-255,1484,75232,76,162468
12969,0.000916,74.125.24.0-255,2902,78134,76,162468
12970,0.000918,172.31.40.0-255,66,78200,76,162468
12971,0.000947,74.125.24.0-255,5738,83938,76,162468
12972,0.000949,172.31.40.0-255,66,84004,76,162468
12973,0.000953,74.125.24.0-255,2902,86906,76,162468
12974,0.000955,172.31.40.0-255,66,86972,76,162468
12975,0.000987,172.31.40.0-255,66,87038,76,162468
12976,0.000998,172.31.40.0-255,66,87104,76,162468
12977,0.001035,172.31.40.0-255,66,87170,76,162468
12978,0.001038,172.31.40.0-255,66,87236,76,162468
12979,0.001051,74.125.24.0-255,5738,92974,76,162468
12980,0.001053,172.31.40.0-255,66,93040,76,162468
12981,0.001062,172.31.40.0-255,66,93106,76,162468
12982,0.001095,74.125.24.0-255,7156,100262,76,162468
12983,0.001098,172.31.40.0-255,66,100328,76,162468
12984,0.001127,74.125.24.0-255,4320,104648,76,162468
12985,0.00113,172.31.40.0-255,66,104714,76,162468
12986,0.001142,172.31.40.0-255,66,104780,76,162468
12987,0.001152,172.31.40.0-255,66,104846,76,162468
12988,0.001174,74.125.24.0-255,5738,110584,76,162468
12989,0.001177,172.31.40.0-255,66,110650,76,162468
12990,0.001209,74.125.24.0-255,4320,114970,76,162468
12991,0.001212,172.31.40.0-255,66,115036,76,162468
12992,0.00122,74.125.24.0-255,7156,122192,76,162468
12993,0.001222,172.31.40.0-255,66,122258,76,162468
12994,0.001267,172.31.40.0-255,66,122324,76,162468
12995,0.001281,172.31.40.0-255,66,122390,76,162468
12996,0.001313,74.125.24.0-255,4320,126710,76,162468
12997,0.001315,172.31.40.0-255,66,126776,76,162468
12998,0.001352,172.31.40.0-255,66,126842,76,162468
12999,0.001372,172.31.40.0-255,66,126908,76,162468
13000,0.001384,172.31.40.0-255,66,126974,76,162468
13001,0.001448,172.31.40.0-255,66,127040,76,162468
13002,0.001458,172.31.40.0-255,66,127106,76,162468
13003,0.001476,74.125.24.0-255,2184,129290,76,162468
13004,0.001498,172.31.40.0-255,66,129356,76,162468
13005,0.001517,74.125.24.0-255,1484,130840,76,162468
13006,0.001522,74.125.24.0-255,2902,133742,76,162468
13007,0.001536,172.31.40.0-255,66,133808,76,162468
13008,0.001548,74.125.24.0-255,5738,139546,76,162468
13009,0.001569,74.125.24.0-255,7156,146702,76,162468
13010,0.001586,74.125.24.0-255,5738,152440,76,162468
13011,0.001596,172.31.40.0-255,66,152506,76,162468
13012,0.001633,172.31.40.0-255,66,152572,76,162468
13013,0.00166,74.125.24.0-255,1634,154206,76,162468
13014,0.001676,172.31.40.0-255,66,154272,76,162468
13015,0.001704,74.125.24.0-255,105,154377,76,162468
13016,0.009176,172.31.40.0-255,66,154443,76,162468
13017,0.009217,172.31.40.0-255,105,154548,76,162468
13018,0.011768,74.125.24.0-255,66,154614,76,162468
13019,0.032337,172.31.40.0-255,172,154786,76,162468
13020,0.032371,172.31.40.0-255,1107,155893,76,162468
13021,0.032436,172.31.40.0-255,1514,157407,76,162468
13022,0.032438,172.31.40.0-255,1514,158921,76,162468
13023,0.032443,172.31.40.0-255,1514,160435,76,162468
13024,0.032445,172.31.40.0-255,1514,161949,76,162468
13025,0.032463,172.31.40.0-255,189,162138,76,162468
13026,0.033899,104.244.42.0-255,66,162204,76,162468
13027,0.034006,104.244.42.0-255,66,162270,76,162468
13028,0.034027,104.244.42.0-255,66,162336,76,162468
13029,0.034046,104.244.42.0-255,66,162402,76,162468
13030,0.034056,104.244.42.0-255,66,162468,76,162468
13031,0.0,172.217.194.0-255,153,153,76,342452
13032,2.2e-05,172.31.40.0-255,66,219,76,342452
13033,2.9e-05,172.217.194.0-255,1484,1703,76,342452
13034,3.4e-05,172.31.40.0-255,66,1769,76,342452
13035,4e-05,172.217.194.0-255,2902,4671,76,342452
13036,4.2e-05,172.31.40.0-255,66,4737,76,342452
13037,4.8e-05,172.217.194.0-255,4320,9057,76,342452
13038,5e-05,172.31.40.0-255,66,9123,76,342452
13039,9.7e-05,172.31.40.0-255,66,9189,76,342452
13040,0.000108,172.31.40.0-255,66,9255,76,342452
13041,0.00024,172.217.194.0-255,4320,13575,76,342452
13042,0.000244,172.31.40.0-255,66,13641,76,342452
13043,0.000273,172.31.40.0-255,66,13707,76,342452
13044,0.000289,172.217.194.0-255,2543,16250,76,342452
13045,0.000292,172.31.40.0-255,66,16316,76,342452
13046,0.000727,172.217.194.0-255,1484,17800,76,342452
13047,0.000733,172.31.40.0-255,66,17866,76,342452
13048,0.000738,172.217.194.0-255,2902,20768,76,342452
13049,0.00074,172.31.40.0-255,66,20834,76,342452
13050,0.000746,172.217.194.0-255,5738,26572,76,342452
13051,0.000748,172.31.40.0-255,66,26638,76,342452
13052,0.000764,172.217.194.0-255,1484,28122,76,342452
13053,0.000767,172.31.40.0-255,66,28188,76,342452
13054,0.000795,172.217.194.0-255,5959,34147,76,342452
13055,0.000798,172.31.40.0-255,66,34213,76,342452
13056,0.000844,172.217.194.0-255,1484,35697,76,342452
13057,0.000847,172.31.40.0-255,66,35763,76,342452
13058,0.000871,172.217.194.0-255,7156,42919,76,342452
13059,0.000874,172.31.40.0-255,66,42985,76,342452
13060,0.000888,172.217.194.0-255,4320,47305,76,342452
13061,0.000902,172.31.40.0-255,66,47371,76,342452
13062,0.000907,172.217.194.0-255,2902,50273,76,342452
13063,0.000912,172.31.40.0-255,66,50339,76,342452
13064,0.00092,172.217.194.0-255,2902,53241,76,342452
13065,0.000936,172.217.194.0-255,5379,58620,76,342452
13066,0.000948,172.31.40.0-255,66,58686,76,342452
13067,0.001194,172.217.194.0-255,1484,60170,76,342452
13068,0.001219,172.217.194.0-255,2902,63072,76,342452
13069,0.001222,172.31.40.0-255,66,63138,76,342452
13070,0.001229,172.217.194.0-255,5738,68876,76,342452
13071,0.001235,172.217.194.0-255,4320,73196,76,342452
13072,0.001247,172.217.194.0-255,2902,76098,76,342452
13073,0.001252,172.31.40.0-255,66,76164,76,342452
13074,0.001286,172.31.40.0-255,66,76230,76,342452
13075,0.001294,172.217.194.0-255,1484,77714,76,342452
13076,0.001297,172.217.194.0-255,1635,79349,76,342452
13077,0.001303,172.31.40.0-255,66,79415,76,342452
13078,0.00133,172.217.194.0-255,5738,85153,76,342452
13079,0.001342,172.31.40.0-255,66,85219,76,342452
13080,0.001348,172.217.194.0-255,5738,90957,76,342452
13081,0.001355,172.217.194.0-255,5738,96695,76,342452
13082,0.00136,172.31.40.0-255,66,96761,76,342452
13083,0.001382,172.217.194.0-255,7156,103917,76,342452
13084,0.0014,172.31.40.0-255,66,103983,76,342452
13085,0.001408,172.217.194.0-255,766,104749,76,342452
13086,0.00182,172.217.194.0-255,1484,106233,76,342452
13087,0.001825,172.31.40.0-255,66,106299,76,342452
13088,0.001831,172.217.194.0-255,2902,109201,76,342452
13089,0.001845,172.217.194.0-255,2902,112103,76,342452
13090,0.001859,172.217.194.0-255,2902,115005,76,342452
13091,0.001866,172.217.194.0-255,5738,120743,76,342452
13092,0.001874,172.31.40.0-255,66,120809,76,342452
13093,0.00189,172.217.194.0-255,7156,127965,76,342452
13094,0.001949,172.31.40.0-255,66,128031,76,342452
13095,0.002002,172.217.194.0-255,1484,129515,76,342452
13096,0.002021,172.217.194.0-255,2902,132417,76,342452
13097,0.00204,172.217.194.0-255,5738,138155,76,342452
13098,0.002047,172.217.194.0-255,5738,143893,76,342452
13099,0.002051,172.31.40.0-255,66,143959,76,342452
13100,0.004069,172.217.194.0-255,5738,149697,76,342452
13101,0.004076,172.31.40.0-255,66,149763,76,342452
13102,0.006107,172.217.194.0-255,1484,151247,76,342452
13103,0.006125,172.217.194.0-255,4320,155567,76,342452
13104,0.008772,172.31.40.0-255,66,155633,76,342452
13105,0.010775,172.217.194.0-255,5738,161371,76,342452
13106,0.010783,172.31.40.0-255,66,161437,76,342452
13107,0.01279,172.217.194.0-255,5738,167175,76,342452
13108,0.013642,172.31.40.0-255,66,167241,76,342452
13109,0.015663,172.217.194.0-255,5738,172979,76,342452
13110,0.01567,172.31.40.0-255,66,173045,76,342452
13111,0.017635,172.217.194.0-255,5738,178783,76,342452
13112,0.017641,172.31.40.0-255,66,178849,76,342452
13113,0.019688,172.217.194.0-255,5738,184587,76,342452
13114,0.019695,172.31.40.0-255,66,184653,76,342452
13115,0.021696,172.217.194.0-255,5738,190391,76,342452
13116,0.025657,172.31.40.0-255,66,190457,76,342452
13117,0.027685,172.217.194.0-255,5738,196195,76,342452
13118,0.027701,172.31.40.0-255,66,196261,76,342452
13119,0.029705,172.217.194.0-255,5738,201999,76,342452
13120,0.029713,172.31.40.0-255,66,202065,76,342452
13121,0.031697,172.217.194.0-255,5738,207803,76,342452
13122,0.031708,172.31.40.0-255,66,207869,76,342452
13123,0.033708,172.217.194.0-255,5738,213607,76,342452
13124,0.033716,172.31.40.0-255,66,213673,76,342452
13125,0.035716,172.217.194.0-255,5738,219411,76,342452
13126,0.035723,172.31.40.0-255,66,219477,76,342452
13127,0.037723,172.217.194.0-255,5738,225215,76,342452
13128,0.037731,172.31.40.0-255,66,225281,76,342452
13129,0.037749,172.31.40.0-255,190,225471,76,342452
13130,0.037782,172.31.40.0-255,1104,226575,76,342452
13131,0.037846,172.31.40.0-255,1514,228089,76,342452
13132,0.037848,172.31.40.0-255,345,228434,76,342452
13133,0.039294,104.244.42.0-255,66,228500,76,342452
13134,0.039353,104.244.42.0-255,66,228566,76,342452
13135,0.03943,104.244.42.0-255,66,228632,76,342452
13136,0.039759,172.217.194.0-255,5738,234370,76,342452
13137,0.039764,172.31.40.0-255,66,234436,76,342452
13138,0.041745,172.217.194.0-255,5738,240174,76,342452
13139,0.041752,172.31.40.0-255,66,240240,76,342452
13140,0.043785,172.217.194.0-255,5738,245978,76,342452
13141,0.043792,172.31.40.0-255,66,246044,76,342452
13142,0.045795,172.217.194.0-255,5738,251782,76,342452
13143,0.045801,172.31.40.0-255,66,251848,76,342452
13144,0.047826,172.217.194.0-255,5738,257586,76,342452
13145,0.047832,172.31.40.0-255,66,257652,76,342452
13146,0.049846,172.217.194.0-255,5738,263390,76,342452
13147,0.049853,172.31.40.0-255,66,263456,76,342452
13148,0.051854,172.217.194.0-255,5738,269194,76,342452
13149,0.051861,172.31.40.0-255,66,269260,76,342452
13150,0.053858,172.217.194.0-255,5738,274998,76,342452
13151,0.053865,172.31.40.0-255,66,275064,76,342452
13152,0.055946,172.217.194.0-255,5738,280802,76,342452
13153,0.055953,172.31.40.0-255,66,280868,76,342452
13154,0.057988,172.217.194.0-255,5738,286606,76,342452
13155,0.057994,172.31.40.0-255,66,286672,76,342452
13156,0.060039,172.217.194.0-255,5738,292410,76,342452
13157,0.060045,172.31.40.0-255,66,292476,76,342452
13158,0.062032,172.217.194.0-255,5738,298214,76,342452
13159,0.062041,172.31.40.0-255,66,298280,76,342452
13160,0.06406,172.217.194.0-255,5738,304018,76,342452
13161,0.064067,172.31.40.0-255,66,304084,76,342452
13162,0.066109,172.217.194.0-255,5738,309822,76,342452
13163,0.066115,172.31.40.0-255,66,309888,76,342452
13164,0.068159,172.217.194.0-255,5738,315626,76,342452
13165,0.068166,172.31.40.0-255,66,315692,76,342452
13166,0.070197,172.217.194.0-255,5738,321430,76,342452
13167,0.070204,172.31.40.0-255,66,321496,76,342452
13168,0.072178,172.217.194.0-255,5738,327234,76,342452
13169,0.072184,172.31.40.0-255,66,327300,76,342452
13170,0.074237,172.217.194.0-255,5738,333038,76,342452
13171,0.074244,172.31.40.0-255,66,333104,76,342452
13172,0.076254,172.217.194.0-255,5738,338842,76,342452
13173,0.07626,172.31.40.0-255,66,338908,76,342452
13174,0.078247,172.217.194.0-255,3307,342215,76,342452
13175,0.078254,172.31.40.0-255,66,342281,76,342452
13176,0.078423,172.31.40.0-255,105,342386,76,342452
13177,0.080377,172.217.194.0-255,66,342452,76,342452
13178,0.0,74.125.68.0-255,146,146,76,279616
13179,1.5e-05,172.31.40.0-255,66,212,76,279616
13180,4.3e-05,74.125.68.0-255,1484,1696,76,279616
13181,4.7e-05,172.31.40.0-255,66,1762,76,279616
13182,5.1e-05,74.125.68.0-255,1484,3246,76,279616
13183,5.3e-05,172.31.40.0-255,66,3312,76,279616
13184,7.6e-05,74.125.68.0-255,1484,4796,76,279616
13185,7.9e-05,172.31.40.0-255,66,4862,76,279616
13186,8.8e-05,74.125.68.0-255,2902,7764,76,279616
13187,9.1e-05,172.31.40.0-255,66,7830,76,279616
13188,9.4e-05,74.125.68.0-255,1484,9314,76,279616
13189,9.6e-05,172.31.40.0-255,66,9380,76,279616
13190,0.000125,74.125.68.0-255,2902,12282,76,279616
13191,0.000127,172.31.40.0-255,66,12348,76,279616
13192,0.000134,74.125.68.0-255,1484,13832,76,279616
13193,0.000137,172.31.40.0-255,66,13898,76,279616
13194,0.000168,74.125.68.0-255,620,14518,76,279616
13195,0.000171,172.31.40.0-255,66,14584,76,279616
13196,0.000189,74.125.68.0-255,1484,16068,76,279616
13197,0.000192,172.31.40.0-255,66,16134,76,279616
13198,0.000195,74.125.68.0-255,1484,17618,76,279616
13199,0.000197,172.31.40.0-255,66,17684,76,279616
13200,0.000231,74.125.68.0-255,2902,20586,76,279616
13201,0.000235,74.125.68.0-255,2902,23488,76,279616
13202,0.000241,74.125.68.0-255,4320,27808,76,279616
13203,0.000245,172.31.40.0-255,66,27874,76,279616
13204,0.000248,172.31.40.0-255,66,27940,76,279616
13205,0.000255,172.31.40.0-255,66,28006,76,279616
13206,0.000281,74.125.68.0-255,3961,31967,76,279616
13207,0.000284,172.31.40.0-255,66,32033,76,279616
13208,0.000484,74.125.68.0-255,1484,33517,76,279616
13209,0.00049,172.31.40.0-255,66,33583,76,279616
13210,0.000496,74.125.68.0-255,2902,36485,76,279616
13211,0.000499,172.31.40.0-255,66,36551,76,279616
13212,0.000528,74.125.68.0-255,5738,42289,76,279616
13213,0.000531,172.31.40.0-255,66,42355,76,279616
13214,0.000537,74.125.68.0-255,4320,46675,76,279616
13215,0.000539,172.31.40.0-255,66,46741,76,279616
13216,0.000543,74.125.68.0-255,1484,48225,76,279616
13217,0.00058,74.125.68.0-255,3961,52186,76,279616
13218,0.000584,172.31.40.0-255,66,52252,76,279616
13219,0.000591,74.125.68.0-255,5738,57990,76,279616
13220,0.000593,172.31.40.0-255,66,58056,76,279616
13221,0.000605,74.125.68.0-255,7156,65212,76,279616
13222,0.000608,172.31.40.0-255,66,65278,76,279616
13223,0.000611,74.125.68.0-255,1125,66403,76,279616
13224,0.001124,172.31.40.0-255,66,66469,76,279616
13225,0.001654,74.125.68.0-255,647,67116,76,279616
13226,0.001815,74.125.68.0-255,1484,68600,76,279616
13227,0.001822,172.31.40.0-255,66,68666,76,279616
13228,0.001829,74.125.68.0-255,2902,71568,76,279616
13229,0.001831,172.31.40.0-255,66,71634,76,279616
13230,0.001836,74.125.68.0-255,2902,74536,76,279616
13231,0.001842,172.31.40.0-255,66,74602,76,279616
13232,0.001872,74.125.68.0-255,4320,78922,76,279616
13233,0.001874,172.31.40.0-255,66,78988,76,279616
13234,0.001885,74.125.68.0-255,5738,84726,76,279616
13235,0.001888,172.31.40.0-255,66,84792,76,279616
13236,0.001926,74.125.68.0-255,2902,87694,76,279616
13237,0.001929,172.31.40.0-255,66,87760,76,279616
13238,0.001934,74.125.68.0-255,4320,92080,76,279616
13239,0.001936,172.31.40.0-255,66,92146,76,279616
13240,0.00194,74.125.68.0-255,2902,95048,76,279616
13241,0.001942,172.31.40.0-255,66,95114,76,279616
13242,0.001981,74.125.68.0-255,6438,101552,76,279616
13243,0.001983,172.31.40.0-255,66,101618,76,279616
13244,0.002867,74.125.68.0-255,1484,103102,76,279616
13245,0.002875,74.125.68.0-255,2902,106004,76,279616
13246,0.002879,172.31.40.0-255,66,106070,76,279616
13247,0.002887,74.125.68.0-255,5738,111808,76,279616
13248,0.002889,172.31.40.0-255,66,111874,76,279616
13249,0.002895,74.125.68.0-255,4320,116194,76,279616
13250,0.002902,172.31.40.0-255,66,116260,76,279616
13251,0.002907,74.125.68.0-255,2902,119162,76,279616
13252,0.002909,172.31.40.0-255,66,119228,76,279616
13253,0.002942,74.125.68.0-255,2902,122130,76,279616
13254,0.002944,172.31.40.0-255,66,122196,76,279616
13255,0.002954,172.31.40.0-255,66,122262,76,279616
13256,0.002975,74.125.68.0-255,2902,125164,76,279616
13257,0.002977,172.31.40.0-255,66,125230,76,279616
13258,0.002986,74.125.68.0-255,2184,127414,76,279616
13259,0.002989,172.31.40.0-255,66,127480,76,279616
13260,0.003162,74.125.68.0-255,1484,128964,76,279616
13261,0.003167,74.125.68.0-255,1484,130448,76,279616
13262,0.00317,172.31.40.0-255,66,130514,76,279616
13263,0.003197,74.125.68.0-255,1484,131998,76,279616
13264,0.003205,74.125.68.0-255,5738,137736,76,279616
13265,0.003207,172.31.40.0-255,66,137802,76,279616
13266,0.003211,74.125.68.0-255,2902,140704,76,279616
13267,0.003213,172.31.40.0-255,66,140770,76,279616
13268,0.003275,172.31.40.0-255,66,140836,76,279616
13269,0.003278,172.31.40.0-255,66,140902,76,279616
13270,0.003311,172.31.40.0-255,66,140968,76,279616
13271,0.003334,74.125.68.0-255,2902,143870,76,279616
13272,0.003337,172.31.40.0-255,66,143936,76,279616
13273,0.003347,74.125.68.0-255,4320,148256,76,279616
13274,0.003349,172.31.40.0-255,66,148322,76,279616
13275,0.003354,74.125.68.0-255,4320,152642,76,279616
13276,0.003356,172.31.40.0-255,66,152708,76,279616
13277,0.003403,172.31.40.0-255,66,152774,76,279616
13278,0.003405,74.125.68.0-255,766,153540,76,279616
13279,0.003576,74.125.68.0-255,1484,155024,76,279616
13280,0.003582,74.125.68.0-255,2902,157926,76,279616
13281,0.003592,172.31.40.0-255,66,157992,76,279616
13282,0.003595,172.31.40.0-255,66,158058,76,279616
13283,0.003601,74.125.68.0-255,2902,160960,76,279616
13284,0.003603,172.31.40.0-255,66,161026,76,279616
13285,0.003636,74.125.68.0-255,2902,163928,76,279616
13286,0.003639,172.31.40.0-255,66,163994,76,279616
13287,0.003644,74.125.68.0-255,4320,168314,76,279616
13288,0.00365,172.31.40.0-255,66,168380,76,279616
13289,0.003657,74.125.68.0-255,5738,174118,76,279616
13290,0.003659,172.31.40.0-255,66,174184,76,279616
13291,0.003665,74.125.68.0-255,5738,179922,76,279616
13292,0.003668,172.31.40.0-255,66,179988,76,279616
13293,0.003711,74.125.68.0-255,5738,185726,76,279616
13294,0.003714,172.31.40.0-255,66,185792,76,279616
13295,0.003718,74.125.68.0-255,2184,187976,76,279616
13296,0.00372,172.31.40.0-255,66,188042,76,279616
13297,0.003788,74.125.68.0-255,1484,189526,76,279616
13298,0.003803,74.125.68.0-255,2902,192428,76,279616
13299,0.003806,172.31.40.0-255,66,192494,76,279616
13300,0.003841,74.125.68.0-255,5738,198232,76,279616
13301,0.003845,172.31.40.0-255,66,198298,76,279616
13302,0.003854,74.125.68.0-255,2902,201200,76,279616
13303,0.003856,172.31.40.0-255,66,201266,76,279616
13304,0.003864,74.125.68.0-255,1484,202750,76,279616
13305,0.003867,74.125.68.0-255,1484,204234,76,279616
13306,0.003869,172.31.40.0-255,66,204300,76,279616
13307,0.003912,172.31.40.0-255,66,204366,76,279616
13308,0.003915,74.125.68.0-255,1484,205850,76,279616
13309,0.003918,74.125.68.0-255,1484,207334,76,279616
13310,0.00392,172.31.40.0-255,66,207400,76,279616
13311,0.003923,74.125.68.0-255,766,208166,76,279616
13312,0.003926,74.125.68.0-255,1484,209650,76,279616
13313,0.003928,172.31.40.0-255,66,209716,76,279616
13314,0.003954,74.125.68.0-255,2902,212618,76,279616
13315,0.003957,172.31.40.0-255,66,212684,76,279616
13316,0.003964,74.125.68.0-255,1484,214168,76,279616
13317,0.003967,74.125.68.0-255,1484,215652,76,279616
13318,0.003969,172.31.40.0-255,66,215718,76,279616
13319,0.003971,74.125.68.0-255,1484,217202,76,279616
13320,0.004018,172.31.40.0-255,66,217268,76,279616
13321,0.004021,74.125.68.0-255,1484,218752,76,279616
13322,0.004032,172.31.40.0-255,66,218818,76,279616
13323,0.004054,74.125.68.0-255,2902,221720,76,279616
13324,0.004056,172.31.40.0-255,66,221786,76,279616
13325,0.004061,74.125.68.0-255,3602,225388,76,279616
13326,0.004064,172.31.40.0-255,66,225454,76,279616
13327,0.004098,172.31.40.0-255,66,225520,76,279616
13328,0.0041,74.125.68.0-255,1484,227004,76,279616
13329,0.004129,172.31.40.0-255,66,227070,76,279616
13330,0.004189,172.31.40.0-255,66,227136,76,279616
13331,0.004195,74.125.68.0-255,5020,232156,76,279616
13332,0.004197,172.31.40.0-255,66,232222,76,279616
13333,0.004242,74.125.68.0-255,1484,233706,76,279616
13334,0.004246,74.125.68.0-255,1484,235190,76,279616
13335,0.004248,172.31.40.0-255,66,235256,76,279616
13336,0.004271,74.125.68.0-255,1484,236740,76,279616
13337,0.004278,74.125.68.0-255,5738,242478,76,279616
13338,0.00428,172.31.40.0-255,66,242544,76,279616
13339,0.004287,74.125.68.0-255,4320,246864,76,279616
13340,0.004289,172.31.40.0-255,66,246930,76,279616
13341,0.004292,74.125.68.0-255,1484,248414,76,279616
13342,0.004323,74.125.68.0-255,4320,252734,76,279616
13343,0.004327,172.31.40.0-255,66,252800,76,279616
13344,0.004332,74.125.68.0-255,2902,255702,76,279616
13345,0.004333,172.31.40.0-255,66,255768,76,279616
13346,0.004376,172.31.40.0-255,66,255834,76,279616
13347,0.00438,74.125.68.0-255,2184,258018,76,279616
13348,0.004383,172.31.40.0-255,66,258084,76,279616
13349,0.004385,74.125.68.0-255,1484,259568,76,279616
13350,0.00441,172.31.40.0-255,66,259634,76,279616
13351,0.004431,74.125.68.0-255,5738,265372,76,279616
13352,0.004434,172.31.40.0-255,66,265438,76,279616
13353,0.004446,172.31.40.0-255,66,265504,76,279616
13354,0.00447,74.125.68.0-255,7156,272660,76,279616
13355,0.004477,172.31.40.0-255,66,272726,76,279616
13356,0.00448,74.125.68.0-255,766,273492,76,279616
13357,0.004498,74.125.68.0-255,1416,274908,76,279616
13358,0.004501,172.31.40.0-255,66,274974,76,279616
13359,0.004524,74.125.68.0-255,105,275079,76,279616
13360,0.008339,172.31.40.0-255,66,275145,76,279616
13361,0.008376,172.31.40.0-255,105,275250,76,279616
13362,0.010346,74.125.68.0-255,66,275316,76,279616
13363,0.03413,172.31.40.0-255,172,275488,76,279616
13364,0.034164,172.31.40.0-255,1109,276597,76,279616
13365,0.03422,172.31.40.0-255,1514,278111,76,279616
13366,0.034222,172.31.40.0-255,1307,279418,76,279616
13367,0.035709,104.244.42.0-255,66,279484,76,279616
13368,0.035747,104.244.42.0-255,66,279550,76,279616
13369,0.035772,104.244.42.0-255,66,279616,76,279616
13370,0.0,172.217.194.0-255,150,150,76,323360
13371,2.4e-05,172.31.40.0-255,66,216,76,323360
13372,3.1e-05,172.217.194.0-255,1484,1700,76,323360
13373,3.6e-05,172.31.40.0-255,66,1766,76,323360
13374,4.1e-05,172.217.194.0-255,2902,4668,76,323360
13375,4.4e-05,172.31.40.0-255,66,4734,76,323360
13376,5.2e-05,172.217.194.0-255,7156,11890,76,323360
13377,5.4e-05,172.31.40.0-255,66,11956,76,323360
13378,5.9e-05,172.217.194.0-255,2030,13986,76,323360
13379,6.3e-05,172.31.40.0-255,66,14052,76,323360
13380,9.7e-05,172.217.194.0-255,2902,16954,76,323360
13381,0.0001,172.31.40.0-255,66,17020,76,323360
13382,0.000104,172.217.194.0-255,2902,19922,76,323360
13383,0.000106,172.31.40.0-255,66,19988,76,323360
13384,0.000124,172.217.194.0-255,7156,27144,76,323360
13385,0.000126,172.31.40.0-255,66,27210,76,323360
13386,0.000152,172.217.194.0-255,3961,31171,76,323360
13387,0.000154,172.31.40.0-255,66,31237,76,323360
13388,0.00021,172.217.194.0-255,1484,32721,76,323360
13389,0.000212,172.31.40.0-255,66,32787,76,323360
13390,0.000216,172.217.194.0-255,1484,34271,76,323360
13391,0.000218,172.31.40.0-255,66,34337,76,323360
13392,0.000232,172.217.194.0-255,1484,35821,76,323360
13393,0.000235,172.31.40.0-255,66,35887,76,323360
13394,0.000241,172.217.194.0-255,5738,41625,76,323360
13395,0.000244,172.31.40.0-255,66,41691,76,323360
13396,0.00027,172.31.40.0-255,66,41757,76,323360
13397,0.000273,172.217.194.0-255,1484,43241,76,323360
13398,0.000275,172.31.40.0-255,66,43307,76,323360
13399,0.000319,172.31.40.0-255,66,43373,76,323360
13400,0.000335,172.217.194.0-255,118,43491,76,323360
13401,0.000378,172.217.194.0-255,381,43872,76,323360
13402,0.000633,172.217.194.0-255,1484,45356,76,323360
13403,0.000638,172.31.40.0-255,66,45422,76,323360
13404,0.000645,172.217.194.0-255,2902,48324,76,323360
13405,0.000648,172.31.40.0-255,66,48390,76,323360
13406,0.000684,172.217.194.0-255,5738,54128,76,323360
13407,0.000687,172.31.40.0-255,66,54194,76,323360
13408,0.000694,172.217.194.0-255,7156,61350,76,323360
13409,0.000697,172.31.40.0-255,66,61416,76,323360
13410,0.000727,172.217.194.0-255,5738,67154,76,323360
13411,0.00073,172.31.40.0-255,66,67220,76,323360
13412,0.000736,172.217.194.0-255,4320,71540,76,323360
13413,0.000738,172.31.40.0-255,66,71606,76,323360
13414,0.000759,172.217.194.0-255,6438,78044,76,323360
13415,0.000762,172.31.40.0-255,66,78110,76,323360
13416,0.00097,172.217.194.0-255,1484,79594,76,323360
13417,0.000988,172.217.194.0-255,2902,82496,76,323360
13418,0.000991,172.31.40.0-255,66,82562,76,323360
13419,0.000997,172.217.194.0-255,5738,88300,76,323360
13420,0.000999,172.31.40.0-255,66,88366,76,323360
13421,0.00101,172.217.194.0-255,1484,89850,76,323360
13422,0.001036,172.31.40.0-255,66,89916,76,323360
13423,0.001084,172.31.40.0-255,66,89982,76,323360
13424,0.00112,172.217.194.0-255,2902,92884,76,323360
13425,0.001123,172.31.40.0-255,66,92950,76,323360
13426,0.001129,172.217.194.0-255,4320,97270,76,323360
13427,0.001131,172.31.40.0-255,66,97336,76,323360
13428,0.001208,172.217.194.0-255,4320,101656,76,323360
13429,0.001217,172.31.40.0-255,66,101722,76,323360
13430,0.001231,172.217.194.0-255,1484,103206,76,323360
13431,0.001238,172.217.194.0-255,7156,110362,76,323360
13432,0.001251,172.31.40.0-255,66,110428,76,323360
13433,0.00127,172.217.194.0-255,5020,115448,76,323360
13434,0.001284,172.217.194.0-255,1484,116932,76,323360
13435,0.001292,172.31.40.0-255,66,116998,76,323360
13436,0.001349,172.31.40.0-255,66,117064,76,323360
13437,0.001584,172.217.194.0-255,1484,118548,76,323360
13438,0.001605,172.217.194.0-255,2902,121450,76,323360
13439,0.00161,172.217.194.0-255,2902,124352,76,323360
13440,0.001626,172.217.194.0-255,2902,127254,76,323360
13441,0.001629,172.217.194.0-255,2902,130156,76,323360
13442,0.001643,172.31.40.0-255,66,130222,76,323360
13443,0.00165,172.217.194.0-255,7156,137378,76,323360
13444,0.001655,172.31.40.0-255,66,137444,76,323360
13445,0.001679,172.217.194.0-255,2902,140346,76,323360
13446,0.001686,172.31.40.0-255,66,140412,76,323360
13447,0.001706,172.31.40.0-255,66,140478,76,323360
13448,0.003715,172.217.194.0-255,5738,146216,76,323360
13449,0.003724,172.31.40.0-255,66,146282,76,323360
13450,0.005711,172.217.194.0-255,5738,152020,76,323360
13451,0.005715,172.31.40.0-255,66,152086,76,323360
13452,0.007676,172.217.194.0-255,4320,156406,76,323360
13453,0.007679,172.31.40.0-255,66,156472,76,323360
13454,0.007696,172.217.194.0-255,1484,157956,76,323360
13455,0.009673,172.217.194.0-255,4320,162276,76,323360
13456,0.00968,172.31.40.0-255,66,162342,76,323360
13457,0.011658,172.217.194.0-255,5738,168080,76,323360
13458,0.011666,172.31.40.0-255,66,168146,76,323360
13459,0.013659,172.217.194.0-255,5738,173884,76,323360
13460,0.013667,172.31.40.0-255,66,173950,76,323360
13461,0.015677,172.217.194.0-255,5738,179688,76,323360
13462,0.015685,172.31.40.0-255,66,179754,76,323360
13463,0.017703,172.217.194.0-255,5738,185492,76,323360
13464,0.017711,172.31.40.0-255,66,185558,76,323360
13465,0.019676,172.217.194.0-255,5738,191296,76,323360
13466,0.019683,172.31.40.0-255,66,191362,76,323360
13467,0.02168,172.217.194.0-255,5738,197100,76,323360
13468,0.021687,172.31.40.0-255,66,197166,76,323360
13469,0.023701,172.217.194.0-255,5738,202904,76,323360
13470,0.023709,172.31.40.0-255,66,202970,76,323360
13471,0.02568,172.217.194.0-255,5738,208708,76,323360
13472,0.025687,172.31.40.0-255,66,208774,76,323360
13473,0.02747,172.31.40.0-255,172,208946,76,323360
13474,0.027522,172.31.40.0-255,1109,210055,76,323360
13475,0.027578,172.31.40.0-255,1514,211569,76,323360
13476,0.02758,172.31.40.0-255,340,211909,76,323360
13477,0.027671,172.217.194.0-255,1484,213393,76,323360
13478,0.027698,172.217.194.0-255,4320,217713,76,323360
13479,0.027702,172.31.40.0-255,66,217779,76,323360
13480,0.029684,172.217.194.0-255,5738,223517,76,323360
13481,0.02969,172.31.40.0-255,66,223583,76,323360
13482,0.029892,104.244.42.0-255,66,223649,76,323360
13483,0.031689,172.217.194.0-255,5738,229387,76,323360
13484,0.031696,172.31.40.0-255,66,229453,76,323360
13485,0.033687,172.217.194.0-255,5738,235191,76,323360
13486,0.033693,172.31.40.0-255,66,235257,76,323360
13487,0.035684,172.217.194.0-255,5738,240995,76,323360
13488,0.035691,172.31.40.0-255,66,241061,76,323360
13489,0.037719,172.217.194.0-255,5738,246799,76,323360
13490,0.037726,172.31.40.0-255,66,246865,76,323360
13491,0.039699,172.217.194.0-255,4320,251185,76,323360
13492,0.039704,172.31.40.0-255,66,251251,76,323360
13493,0.039721,172.217.194.0-255,1484,252735,76,323360
13494,0.04171,172.217.194.0-255,4320,257055,76,323360
13495,0.041717,172.31.40.0-255,66,257121,76,323360
13496,0.043734,172.217.194.0-255,5738,262859,76,323360
13497,0.043741,172.31.40.0-255,66,262925,76,323360
13498,0.045732,172.217.194.0-255,5738,268663,76,323360
13499,0.045738,172.31.40.0-255,66,268729,76,323360
13500,0.047804,172.217.194.0-255,5738,274467,76,323360
13501,0.047811,172.31.40.0-255,66,274533,76,323360
13502,0.049798,172.217.194.0-255,5738,280271,76,323360
13503,0.049805,172.31.40.0-255,66,280337,76,323360
13504,0.051802,172.217.194.0-255,1484,281821,76,323360
13505,0.051823,172.217.194.0-255,4320,286141,76,323360
13506,0.051829,172.31.40.0-255,66,286207,76,323360
13507,0.053796,172.217.194.0-255,5738,291945,76,323360
13508,0.053802,172.31.40.0-255,66,292011,76,323360
13509,0.055798,172.217.194.0-255,5738,297749,76,323360
13510,0.055806,172.31.40.0-255,66,297815,76,323360
13511,0.057827,172.217.194.0-255,5738,303553,76,323360
13512,0.057833,172.31.40.0-255,66,303619,76,323360
13513,0.059855,172.217.194.0-255,5738,309357,76,323360
13514,0.059862,172.31.40.0-255,66,309423,76,323360
13515,0.061857,172.217.194.0-255,5738,315161,76,323360
13516,0.061863,172.31.40.0-255,66,315227,76,323360
13517,0.063873,172.217.194.0-255,5738,320965,76,323360
13518,0.063881,172.31.40.0-255,66,321031,76,323360
13519,0.065877,172.217.194.0-255,2092,323123,76,323360
13520,0.065883,172.31.40.0-255,66,323189,76,323360
13521,0.066048,172.31.40.0-255,105,323294,76,323360
13522,0.068067,172.217.194.0-255,66,323360,76,323360
13523,0.0,74.125.130.0-255,153,153,76,400606
13524,1.6e-05,172.31.40.0-255,66,219,76,400606
13525,2.2e-05,74.125.130.0-255,1484,1703,76,400606
13526,2.7e-05,172.31.40.0-255,66,1769,76,400606
13527,3e-05,74.125.130.0-255,1484,3253,76,400606
13528,3.4e-05,172.31.40.0-255,66,3319,76,400606
13529,5.8e-05,74.125.130.0-255,1484,4803,76,400606
13530,6.1e-05,172.31.40.0-255,66,4869,76,400606
13531,6.8e-05,74.125.130.0-255,4320,9189,76,400606
13532,7e-05,172.31.40.0-255,66,9255,76,400606
13533,7.7e-05,74.125.130.0-255,4935,14190,76,400606
13534,7.9e-05,172.31.40.0-255,66,14256,76,400606
13535,0.000158,74.125.130.0-255,1484,15740,76,400606
13536,0.000161,172.31.40.0-255,66,15806,76,400606
13537,0.000166,74.125.130.0-255,2902,18708,76,400606
13538,0.000168,172.31.40.0-255,66,18774,76,400606
13539,0.000195,74.125.130.0-255,5738,24512,76,400606
13540,0.000198,172.31.40.0-255,66,24578,76,400606
13541,0.000204,74.125.130.0-255,4320,28898,76,400606
13542,0.000206,172.31.40.0-255,66,28964,76,400606
13543,0.000223,74.125.130.0-255,2543,31507,76,400606
13544,0.000225,172.31.40.0-255,66,31573,76,400606
13545,0.000365,74.125.130.0-255,1484,33057,76,400606
13546,0.000369,172.31.40.0-255,66,33123,76,400606
13547,0.000375,74.125.130.0-255,2902,36025,76,400606
13548,0.000377,172.31.40.0-255,66,36091,76,400606
13549,0.000384,74.125.130.0-255,5738,41829,76,400606
13550,0.000387,172.31.40.0-255,66,41895,76,400606
13551,0.000421,74.125.130.0-255,6797,48692,76,400606
13552,0.000424,172.31.40.0-255,66,48758,76,400606
13553,0.000448,74.125.130.0-255,1484,50242,76,400606
13554,0.00045,172.31.40.0-255,66,50308,76,400606
13555,0.000455,74.125.130.0-255,2902,53210,76,400606
13556,0.000457,172.31.40.0-255,66,53276,76,400606
13557,0.00047,74.125.130.0-255,1484,54760,76,400606
13558,0.000494,74.125.130.0-255,4320,59080,76,400606
13559,0.000498,172.31.40.0-255,66,59146,76,400606
13560,0.000503,74.125.130.0-255,4320,63466,76,400606
13561,0.000505,172.31.40.0-255,66,63532,76,400606
13562,0.000519,74.125.130.0-255,2543,66075,76,400606
13563,0.000521,172.31.40.0-255,66,66141,76,400606
13564,0.001066,74.125.130.0-255,645,66786,76,400606
13565,0.001472,74.125.130.0-255,1484,68270,76,400606
13566,0.001479,172.31.40.0-255,66,68336,76,400606
13567,0.001486,74.125.130.0-255,2902,71238,76,400606
13568,0.001488,172.31.40.0-255,66,71304,76,400606
13569,0.001496,74.125.130.0-255,5738,77042,76,400606
13570,0.001498,172.31.40.0-255,66,77108,76,400606
13571,0.001536,74.125.130.0-255,4320,81428,76,400606
13572,0.001539,172.31.40.0-255,66,81494,76,400606
13573,0.001557,74.125.130.0-255,2543,84037,76,400606
13574,0.001559,172.31.40.0-255,66,84103,76,400606
13575,0.001574,74.125.130.0-255,1484,85587,76,400606
13576,0.001593,74.125.130.0-255,2902,88489,76,400606
13577,0.001595,172.31.40.0-255,66,88555,76,400606
13578,0.00162,74.125.130.0-255,5738,94293,76,400606
13579,0.001623,172.31.40.0-255,66,94359,76,400606
13580,0.001629,74.125.130.0-255,6797,101156,76,400606
13581,0.001631,172.31.40.0-255,66,101222,76,400606
13582,0.001802,74.125.130.0-255,1484,102706,76,400606
13583,0.001806,74.125.130.0-255,2902,105608,76,400606
13584,0.001809,172.31.40.0-255,66,105674,76,400606
13585,0.001812,74.125.130.0-255,1484,107158,76,400606
13586,0.001829,74.125.130.0-255,1484,108642,76,400606
13587,0.001831,172.31.40.0-255,66,108708,76,400606
13588,0.001836,74.125.130.0-255,4320,113028,76,400606
13589,0.001838,172.31.40.0-255,66,113094,76,400606
13590,0.001841,74.125.130.0-255,1484,114578,76,400606
13591,0.001867,74.125.130.0-255,7156,121734,76,400606
13592,0.00187,172.31.40.0-255,66,121800,76,400606
13593,0.001875,74.125.130.0-255,2902,124702,76,400606
13594,0.001877,172.31.40.0-255,66,124768,76,400606
13595,0.001902,172.31.40.0-255,66,124834,76,400606
13596,0.002006,74.125.130.0-255,1484,126318,76,400606
13597,0.002018,74.125.130.0-255,2902,129220,76,400606
13598,0.002021,172.31.40.0-255,66,129286,76,400606
13599,0.002034,74.125.130.0-255,1484,130770,76,400606
13600,0.002052,74.125.130.0-255,4320,135090,76,400606
13601,0.002055,172.31.40.0-255,66,135156,76,400606
13602,0.002058,74.125.130.0-255,1484,136640,76,400606
13603,0.002084,172.31.40.0-255,66,136706,76,400606
13604,0.00209,74.125.130.0-255,5738,142444,76,400606
13605,0.002093,172.31.40.0-255,66,142510,76,400606
13606,0.002119,74.125.130.0-255,5020,147530,76,400606
13607,0.002122,172.31.40.0-255,66,147596,76,400606
13608,0.004218,74.125.130.0-255,5738,153334,76,400606
13609,0.004222,172.31.40.0-255,66,153400,76,400606
13610,0.006317,74.125.130.0-255,5738,159138,76,400606
13611,0.006321,172.31.40.0-255,66,159204,76,400606
13612,0.008421,74.125.130.0-255,5738,164942,76,400606
13613,0.008428,172.31.40.0-255,66,165008,76,400606
13614,0.010525,74.125.130.0-255,5738,170746,76,400606
13615,0.010532,172.31.40.0-255,66,170812,76,400606
13616,0.01269,74.125.130.0-255,5738,176550,76,400606
13617,0.012699,172.31.40.0-255,66,176616,76,400606
13618,0.014797,74.125.130.0-255,5738,182354,76,400606
13619,0.014805,172.31.40.0-255,66,182420,76,400606
13620,0.016912,74.125.130.0-255,5738,188158,76,400606
13621,0.016921,172.31.40.0-255,66,188224,76,400606
13622,0.019017,74.125.130.0-255,5738,193962,76,400606
13623,0.019025,172.31.40.0-255,66,194028,76,400606
13624,0.021141,74.125.130.0-255,5738,199766,76,400606
13625,0.021149,172.31.40.0-255,66,199832,76,400606
13626,0.023247,74.125.130.0-255,5738,205570,76,400606
13627,0.023254,172.31.40.0-255,66,205636,76,400606
13628,0.025349,74.125.130.0-255,5738,211374,76,400606
13629,0.025357,172.31.40.0-255,66,211440,76,400606
13630,0.027457,74.125.130.0-255,2902,214342,76,400606
13631,0.027464,172.31.40.0-255,66,214408,76,400606
13632,0.027486,74.125.130.0-255,2902,217310,76,400606
13633,0.02749,172.31.40.0-255,66,217376,76,400606
13634,0.028832,172.31.40.0-255,176,217552,76,400606
13635,0.028864,172.31.40.0-255,1107,218659,76,400606
13636,0.028923,172.31.40.0-255,1514,220173,76,400606
13637,0.028925,172.31.40.0-255,1309,221482,76,400606
13638,0.029545,74.125.130.0-255,2902,224384,76,400606
13639,0.029551,172.31.40.0-255,66,224450,76,400606
13640,0.029576,74.125.130.0-255,2902,227352,76,400606
13641,0.029579,172.31.40.0-255,66,227418,76,400606
13642,0.030372,104.244.42.0-255,66,227484,76,400606
13643,0.0304,104.244.42.0-255,66,227550,76,400606
13644,0.030476,104.244.42.0-255,66,227616,76,400606
13645,0.031649,74.125.130.0-255,2902,230518,76,400606
13646,0.031655,172.31.40.0-255,66,230584,76,400606
13647,0.031678,74.125.130.0-255,2902,233486,76,400606
13648,0.031681,172.31.40.0-255,66,233552,76,400606
13649,0.033755,74.125.130.0-255,5738,239290,76,400606
13650,0.033761,172.31.40.0-255,66,239356,76,400606
13651,0.035864,74.125.130.0-255,5738,245094,76,400606
13652,0.03587,172.31.40.0-255,66,245160,76,400606
13653,0.037962,74.125.130.0-255,5738,250898,76,400606
13654,0.037968,172.31.40.0-255,66,250964,76,400606
13655,0.040073,74.125.130.0-255,5738,256702,76,400606
13656,0.040081,172.31.40.0-255,66,256768,76,400606
13657,0.042186,74.125.130.0-255,5738,262506,76,400606
13658,0.042193,172.31.40.0-255,66,262572,76,400606
13659,0.044294,74.125.130.0-255,5738,268310,76,400606
13660,0.0443,172.31.40.0-255,66,268376,76,400606
13661,0.046405,74.125.130.0-255,5738,274114,76,400606
13662,0.046412,172.31.40.0-255,66,274180,76,400606
13663,0.048531,74.125.130.0-255,5738,279918,76,400606
13664,0.048538,172.31.40.0-255,66,279984,76,400606
13665,0.05062,74.125.130.0-255,5738,285722,76,400606
13666,0.050626,172.31.40.0-255,66,285788,76,400606
13667,0.052731,74.125.130.0-255,5738,291526,76,400606
13668,0.052738,172.31.40.0-255,66,291592,76,400606
13669,0.054838,74.125.130.0-255,5738,297330,76,400606
13670,0.054844,172.31.40.0-255,66,297396,76,400606
13671,0.056938,74.125.130.0-255,5738,303134,76,400606
13672,0.056944,172.31.40.0-255,66,303200,76,400606
13673,0.059049,74.125.130.0-255,5738,308938,76,400606
13674,0.059056,172.31.40.0-255,66,309004,76,400606
13675,0.061168,74.125.130.0-255,5738,314742,76,400606
13676,0.061174,172.31.40.0-255,66,314808,76,400606
13677,0.063275,74.125.130.0-255,5738,320546,76,400606
13678,0.063282,172.31.40.0-255,66,320612,76,400606
13679,0.065388,74.125.130.0-255,5738,326350,76,400606
13680,0.065395,172.31.40.0-255,66,326416,76,400606
13681,0.067492,74.125.130.0-255,5738,332154,76,400606
13682,0.067499,172.31.40.0-255,66,332220,76,400606
13683,0.069603,74.125.130.0-255,5738,337958,76,400606
13684,0.06961,172.31.40.0-255,66,338024,76,400606
13685,0.071705,74.125.130.0-255,5738,343762,76,400606
13686,0.071711,172.31.40.0-255,66,343828,76,400606
13687,0.073815,74.125.130.0-255,5738,349566,76,400606
13688,0.073821,172.31.40.0-255,66,349632,76,400606
13689,0.075928,74.125.130.0-255,5738,355370,76,400606
13690,0.075935,172.31.40.0-255,66,355436,76,400606
13691,0.07807,74.125.130.0-255,5738,361174,76,400606
13692,0.078077,172.31.40.0-255,66,361240,76,400606
13693,0.080174,74.125.130.0-255,5738,366978,76,400606
13694,0.080181,172.31.40.0-255,66,367044,76,400606
13695,0.082303,74.125.130.0-255,5738,372782,76,400606
13696,0.082309,172.31.40.0-255,66,372848,76,400606
13697,0.084415,74.125.130.0-255,5738,378586,76,400606
13698,0.084421,172.31.40.0-255,66,378652,76,400606
13699,0.086516,74.125.130.0-255,5738,384390,76,400606
13700,0.086523,172.31.40.0-255,66,384456,76,400606
13701,0.088623,74.125.130.0-255,5738,390194,76,400606
13702,0.08863,172.31.40.0-255,66,390260,76,400606
13703,0.090725,74.125.130.0-255,5738,395998,76,400606
13704,0.090732,172.31.40.0-255,66,396064,76,400606
13705,0.092835,74.125.130.0-255,4305,400369,76,400606
13706,0.092842,172.31.40.0-255,66,400435,76,400606
13707,0.093019,172.31.40.0-255,105,400540,76,400606
13708,0.095081,74.125.130.0-255,66,400606,76,400606
13709,0.0,74.125.24.0-255,219,219,76,257360
13710,2.3e-05,172.31.40.0-255,66,285,76,257360
13711,3e-05,74.125.24.0-255,1484,1769,76,257360
13712,3.5e-05,172.31.40.0-255,66,1835,76,257360
13713,4.1e-05,74.125.24.0-255,2902,4737,76,257360
13714,5.2e-05,172.31.40.0-255,66,4803,76,257360
13715,5.9e-05,74.125.24.0-255,4320,9123,76,257360
13716,6.2e-05,172.31.40.0-255,66,9189,76,257360
13717,9.5e-05,74.125.24.0-255,4730,13919,76,257360
13718,0.000101,172.31.40.0-255,66,13985,76,257360
13719,0.00024,74.125.24.0-255,1484,15469,76,257360
13720,0.000244,172.31.40.0-255,66,15535,76,257360
13721,0.00025,74.125.24.0-255,2902,18437,76,257360
13722,0.000252,172.31.40.0-255,66,18503,76,257360
13723,0.00026,74.125.24.0-255,5738,24241,76,257360
13724,0.000267,172.31.40.0-255,66,24307,76,257360
13725,0.000274,74.125.24.0-255,5738,30045,76,257360
13726,0.000276,172.31.40.0-255,66,30111,76,257360
13727,0.000299,74.125.24.0-255,1125,31236,76,257360
13728,0.000301,172.31.40.0-255,66,31302,76,257360
13729,0.00037,74.125.24.0-255,1484,32786,76,257360
13730,0.000373,172.31.40.0-255,66,32852,76,257360
13731,0.000378,74.125.24.0-255,2902,35754,76,257360
13732,0.00038,172.31.40.0-255,66,35820,76,257360
13733,0.000406,74.125.24.0-255,5738,41558,76,257360
13734,0.00041,172.31.40.0-255,66,41624,76,257360
13735,0.000415,74.125.24.0-255,2902,44526,76,257360
13736,0.000418,172.31.40.0-255,66,44592,76,257360
13737,0.000444,74.125.24.0-255,3961,48553,76,257360
13738,0.000447,172.31.40.0-255,66,48619,76,257360
13739,0.000471,74.125.24.0-255,7156,55775,76,257360
13740,0.000473,172.31.40.0-255,66,55841,76,257360
13741,0.000506,74.125.24.0-255,7156,62997,76,257360
13742,0.00051,172.31.40.0-255,66,63063,76,257360
13743,0.000514,74.125.24.0-255,2816,65879,76,257360
13744,0.000516,172.31.40.0-255,66,65945,76,257360
13745,0.000562,74.125.24.0-255,382,66327,76,257360
13746,0.000704,74.125.24.0-255,1484,67811,76,257360
13747,0.000709,172.31.40.0-255,66,67877,76,257360
13748,0.000715,74.125.24.0-255,2902,70779,76,257360
13749,0.000718,172.31.40.0-255,66,70845,76,257360
13750,0.000741,74.125.24.0-255,5738,76583,76,257360
13751,0.000744,172.31.40.0-255,66,76649,76,257360
13752,0.000767,74.125.24.0-255,1484,78133,76,257360
13753,0.000799,172.31.40.0-255,66,78199,76,257360
13754,0.000804,74.125.24.0-255,2902,81101,76,257360
13755,0.000806,172.31.40.0-255,66,81167,76,257360
13756,0.000843,74.125.24.0-255,7156,88323,76,257360
13757,0.000846,172.31.40.0-255,66,88389,76,257360
13758,0.00085,74.125.24.0-255,2543,90932,76,257360
13759,0.000852,172.31.40.0-255,66,90998,76,257360
13760,0.000883,74.125.24.0-255,2902,93900,76,257360
13761,0.000887,172.31.40.0-255,66,93966,76,257360
13762,0.000891,74.125.24.0-255,2902,96868,76,257360
13763,0.000893,172.31.40.0-255,66,96934,76,257360
13764,0.000915,74.125.24.0-255,2902,99836,76,257360
13765,0.000918,172.31.40.0-255,66,99902,76,257360
13766,0.000924,74.125.24.0-255,4320,104222,76,257360
13767,0.000928,172.31.40.0-255,66,104288,76,257360
13768,0.000953,74.125.24.0-255,5738,110026,76,257360
13769,0.000955,172.31.40.0-255,66,110092,76,257360
13770,0.000969,172.31.40.0-255,66,110158,76,257360
13771,0.001001,74.125.24.0-255,2184,112342,76,257360
13772,0.001003,172.31.40.0-255,66,112408,76,257360
13773,0.001019,74.125.24.0-255,1484,113892,76,257360
13774,0.001041,74.125.24.0-255,1484,115376,76,257360
13775,0.001043,172.31.40.0-255,66,115442,76,257360
13776,0.00105,74.125.24.0-255,5738,121180,76,257360
13777,0.001052,172.31.40.0-255,66,121246,76,257360
13778,0.001086,172.31.40.0-255,66,121312,76,257360
13779,0.001117,74.125.24.0-255,4320,125632,76,257360
13780,0.00112,172.31.40.0-255,66,125698,76,257360
13781,0.001192,172.31.40.0-255,66,125764,76,257360
13782,0.00139,74.125.24.0-255,1484,127248,76,257360
13783,0.001395,74.125.24.0-255,1484,128732,76,257360
13784,0.001398,172.31.40.0-255,66,128798,76,257360
13785,0.001429,74.125.24.0-255,1484,130282,76,257360
13786,0.001437,74.125.24.0-255,5738,136020,76,257360
13787,0.00144,172.31.40.0-255,66,136086,76,257360
13788,0.001448,74.125.24.0-255,7156,143242,76,257360
13789,0.001451,172.31.40.0-255,66,143308,76,257360
13790,0.001485,74.125.24.0-255,5738,149046,76,257360
13791,0.001493,172.31.40.0-255,66,149112,76,257360
13792,0.001505,172.31.40.0-255,66,149178,76,257360
13793,0.001507,74.125.24.0-255,766,149944,76,257360
13794,0.001575,74.125.24.0-255,1484,151428,76,257360
13795,0.001579,172.31.40.0-255,66,151494,76,257360
13796,0.001584,74.125.24.0-255,2902,154396,76,257360
13797,0.001586,172.31.40.0-255,66,154462,76,257360
13798,0.00161,74.125.24.0-255,5738,160200,76,257360
13799,0.001613,172.31.40.0-255,66,160266,76,257360
13800,0.001618,74.125.24.0-255,4320,164586,76,257360
13801,0.001621,172.31.40.0-255,66,164652,76,257360
13802,0.001654,172.31.40.0-255,66,164718,76,257360
13803,0.00168,172.31.40.0-255,66,164784,76,257360
13804,0.001722,172.31.40.0-255,66,164850,76,257360
13805,0.001739,172.31.40.0-255,66,164916,76,257360
13806,0.001819,172.31.40.0-255,66,164982,76,257360
13807,0.001858,74.125.24.0-255,1484,166466,76,257360
13808,0.001873,74.125.24.0-255,2902,169368,76,257360
13809,0.001876,172.31.40.0-255,66,169434,76,257360
13810,0.001879,74.125.24.0-255,1484,170918,76,257360
13811,0.001907,74.125.24.0-255,4320,175238,76,257360
13812,0.001909,172.31.40.0-255,66,175304,76,257360
13813,0.001934,74.125.24.0-255,2902,178206,76,257360
13814,0.001938,172.31.40.0-255,66,178272,76,257360
13815,0.001972,172.31.40.0-255,66,178338,76,257360
13816,0.001983,172.31.40.0-255,66,178404,76,257360
13817,0.001995,172.31.40.0-255,66,178470,76,257360
13818,0.00202,74.125.24.0-255,7156,185626,76,257360
13819,0.002023,172.31.40.0-255,66,185692,76,257360
13820,0.002055,74.125.24.0-255,1484,187176,76,257360
13821,0.002074,172.31.40.0-255,66,187242,76,257360
13822,0.002605,74.125.24.0-255,1484,188726,76,257360
13823,0.002611,74.125.24.0-255,2902,191628,76,257360
13824,0.002615,172.31.40.0-255,66,191694,76,257360
13825,0.002622,74.125.24.0-255,4320,196014,76,257360
13826,0.002624,172.31.40.0-255,66,196080,76,257360
13827,0.002645,74.125.24.0-255,1484,197564,76,257360
13828,0.002651,74.125.24.0-255,5738,203302,76,257360
13829,0.002653,172.31.40.0-255,66,203368,76,257360
13830,0.002661,74.125.24.0-255,1484,204852,76,257360
13831,0.002701,172.31.40.0-255,66,204918,76,257360
13832,0.002707,74.125.24.0-255,5020,209938,76,257360
13833,0.00271,172.31.40.0-255,66,210004,76,257360
13834,0.005402,74.125.24.0-255,5738,215742,76,257360
13835,0.00541,172.31.40.0-255,66,215808,76,257360
13836,0.008104,74.125.24.0-255,5738,221546,76,257360
13837,0.008113,172.31.40.0-255,66,221612,76,257360
13838,0.010827,74.125.24.0-255,5738,227350,76,257360
13839,0.010836,172.31.40.0-255,66,227416,76,257360
13840,0.013537,74.125.24.0-255,5738,233154,76,257360
13841,0.013543,172.31.40.0-255,66,233220,76,257360
13842,0.01627,74.125.24.0-255,5738,238958,76,257360
13843,0.016281,172.31.40.0-255,66,239024,76,257360
13844,0.019056,74.125.24.0-255,5738,244762,76,257360
13845,0.019068,172.31.40.0-255,66,244828,76,257360
13846,0.021793,74.125.24.0-255,5738,250566,76,257360
13847,0.021808,172.31.40.0-255,66,250632,76,257360
13848,0.024502,74.125.24.0-255,2187,252819,76,257360
13849,0.024513,172.31.40.0-255,66,252885,76,257360
13850,0.024738,172.31.40.0-255,105,252990,76,257360
13851,0.027441,74.125.24.0-255,66,253056,76,257360
13852,0.039484,172.31.40.0-255,176,253232,76,257360
13853,0.039517,172.31.40.0-255,1109,254341,76,257360
13854,0.039583,172.31.40.0-255,1514,255855,76,257360
13855,0.039604,172.31.40.0-255,1307,257162,76,257360
13856,0.041188,104.244.42.0-255,66,257228,76,257360
13857,0.041197,104.244.42.0-255,66,257294,76,257360
13858,0.041268,104.244.42.0-255,66,257360,76,257360
13859,0.0,74.125.24.0-255,153,153,76,238235
13860,1.3e-05,172.31.40.0-255,66,219,76,238235
13861,1.8e-05,74.125.24.0-255,1484,1703,76,238235
13862,2.2e-05,172.31.40.0-255,66,1769,76,238235
13863,2.7e-05,74.125.24.0-255,2902,4671,76,238235
13864,3e-05,172.31.40.0-255,66,4737,76,238235
13865,6.2e-05,74.125.24.0-255,7156,11893,76,238235
13866,6.4e-05,172.31.40.0-255,66,11959,76,238235
13867,8.2e-05,74.125.24.0-255,4320,16279,76,238235
13868,8.4e-05,172.31.40.0-255,66,16345,76,238235
13869,0.000112,74.125.24.0-255,6348,22693,76,238235
13870,0.000115,172.31.40.0-255,66,22759,76,238235
13871,0.000117,74.125.24.0-255,1484,24243,76,238235
13872,0.000119,172.31.40.0-255,66,24309,76,238235
13873,0.000135,74.125.24.0-255,6797,31106,76,238235
13874,0.000137,172.31.40.0-255,66,31172,76,238235
13875,0.000185,74.125.24.0-255,1484,32656,76,238235
13876,0.000188,172.31.40.0-255,66,32722,76,238235
13877,0.000192,74.125.24.0-255,2902,35624,76,238235
13878,0.000194,172.31.40.0-255,66,35690,76,238235
13879,0.000207,74.125.24.0-255,2902,38592,76,238235
13880,0.000209,172.31.40.0-255,66,38658,76,238235
13881,0.000227,74.125.24.0-255,2902,41560,76,238235
13882,0.00023,172.31.40.0-255,66,41626,76,238235
13883,0.00024,172.31.40.0-255,66,41692,76,238235
13884,0.000292,172.31.40.0-255,66,41758,76,238235
13885,0.000316,74.125.24.0-255,6732,48490,76,238235
13886,0.000319,172.31.40.0-255,66,48556,76,238235
13887,0.00038,74.125.24.0-255,132,48688,76,238235
13888,0.000383,172.31.40.0-255,66,48754,76,238235
13889,0.000503,74.125.24.0-255,1484,50238,76,238235
13890,0.00051,74.125.24.0-255,2902,53140,76,238235
13891,0.000514,172.31.40.0-255,66,53206,76,238235
13892,0.000518,74.125.24.0-255,2902,56108,76,238235
13893,0.000521,172.31.40.0-255,66,56174,76,238235
13894,0.000533,74.125.24.0-255,2902,59076,76,238235
13895,0.000536,172.31.40.0-255,66,59142,76,238235
13896,0.000569,74.125.24.0-255,1484,60626,76,238235
13897,0.000587,74.125.24.0-255,5081,65707,76,238235
13898,0.000589,172.31.40.0-255,66,65773,76,238235
13899,0.000661,74.125.24.0-255,1484,67257,76,238235
13900,0.000666,74.125.24.0-255,2902,70159,76,238235
13901,0.000668,172.31.40.0-255,66,70225,76,238235
13902,0.000691,74.125.24.0-255,5738,75963,76,238235
13903,0.000694,172.31.40.0-255,66,76029,76,238235
13904,0.000697,74.125.24.0-255,1484,77513,76,238235
13905,0.000717,74.125.24.0-255,7156,84669,76,238235
13906,0.00072,172.31.40.0-255,66,84735,76,238235
13907,0.000741,74.125.24.0-255,4320,89055,76,238235
13908,0.000743,172.31.40.0-255,66,89121,76,238235
13909,0.000754,172.31.40.0-255,66,89187,76,238235
13910,0.001016,74.125.24.0-255,1484,90671,76,238235
13911,0.001021,74.125.24.0-255,2902,93573,76,238235
13912,0.001024,172.31.40.0-255,66,93639,76,238235
13913,0.001027,74.125.24.0-255,1484,95123,76,238235
13914,0.001046,74.125.24.0-255,2902,98025,76,238235
13915,0.001049,74.125.24.0-255,1484,99509,76,238235
13916,0.001052,172.31.40.0-255,66,99575,76,238235
13917,0.001073,74.125.24.0-255,7156,106731,76,238235
13918,0.001076,172.31.40.0-255,66,106797,76,238235
13919,0.001106,74.125.24.0-255,7156,113953,76,238235
13920,0.001109,172.31.40.0-255,66,114019,76,238235
13921,0.001139,172.31.40.0-255,66,114085,76,238235
13922,0.001392,74.125.24.0-255,1484,115569,76,238235
13923,0.001395,74.125.24.0-255,1484,117053,76,238235
13924,0.001398,172.31.40.0-255,66,117119,76,238235
13925,0.001417,74.125.24.0-255,1484,118603,76,238235
13926,0.001423,74.125.24.0-255,5738,124341,76,238235
13927,0.001426,172.31.40.0-255,66,124407,76,238235
13928,0.00145,74.125.24.0-255,2902,127309,76,238235
13929,0.001454,172.31.40.0-255,66,127375,76,238235
13930,0.001462,74.125.24.0-255,4320,131695,76,238235
13931,0.001464,172.31.40.0-255,66,131761,76,238235
13932,0.001481,74.125.24.0-255,5738,137499,76,238235
13933,0.001483,172.31.40.0-255,66,137565,76,238235
13934,0.001506,74.125.24.0-255,5738,143303,76,238235
13935,0.001508,172.31.40.0-255,66,143369,76,238235
13936,0.001521,74.125.24.0-255,5020,148389,76,238235
13937,0.001525,172.31.40.0-255,66,148455,76,238235
13938,0.001597,74.125.24.0-255,1484,149939,76,238235
13939,0.001616,74.125.24.0-255,2902,152841,76,238235
13940,0.001619,172.31.40.0-255,66,152907,76,238235
13941,0.001622,74.125.24.0-255,1484,154391,76,238235
13942,0.001641,74.125.24.0-255,4320,158711,76,238235
13943,0.001644,172.31.40.0-255,66,158777,76,238235
13944,0.001652,74.125.24.0-255,2902,161679,76,238235
13945,0.001653,172.31.40.0-255,66,161745,76,238235
13946,0.001677,74.125.24.0-255,2902,164647,76,238235
13947,0.001679,172.31.40.0-255,66,164713,76,238235
13948,0.001684,74.125.24.0-255,4320,169033,76,238235
13949,0.001686,172.31.40.0-255,66,169099,76,238235
13950,0.001708,172.31.40.0-255,66,169165,76,238235
13951,0.001713,74.125.24.0-255,5020,174185,76,238235
13952,0.001715,172.31.40.0-255,66,174251,76,238235
13953,0.001861,74.125.24.0-255,1484,175735,76,238235
13954,0.00188,74.125.24.0-255,2902,178637,76,238235
13955,0.001883,172.31.40.0-255,66,178703,76,238235
13956,0.001886,74.125.24.0-255,1484,180187,76,238235
13957,0.001912,74.125.24.0-255,4320,184507,76,238235
13958,0.001915,74.125.24.0-255,2902,187409,76,238235
13959,0.001949,172.31.40.0-255,66,187475,76,238235
13960,0.001957,172.31.40.0-255,66,187541,76,238235
13961,0.001969,172.31.40.0-255,66,187607,76,238235
13962,0.001987,172.31.40.0-255,66,187673,76,238235
13963,0.002036,74.125.24.0-255,1484,189157,76,238235
13964,0.00204,74.125.24.0-255,1484,190641,76,238235
13965,0.002043,172.31.40.0-255,66,190707,76,238235
13966,0.00206,74.125.24.0-255,1484,192191,76,238235
13967,0.002084,74.125.24.0-255,5738,197929,76,238235
13968,0.002087,172.31.40.0-255,66,197995,76,238235
13969,0.002092,74.125.24.0-255,2902,200897,76,238235
13970,0.002094,172.31.40.0-255,66,200963,76,238235
13971,0.002135,172.31.40.0-255,66,201029,76,238235
13972,0.002146,172.31.40.0-255,66,201095,76,238235
13973,0.002178,74.125.24.0-255,7156,208251,76,238235
13974,0.002181,172.31.40.0-255,66,208317,76,238235
13975,0.002202,74.125.24.0-255,7156,215473,76,238235
13976,0.002204,172.31.40.0-255,66,215539,76,238235
13977,0.002227,74.125.24.0-255,2184,217723,76,238235
13978,0.00223,172.31.40.0-255,66,217789,76,238235
13979,0.002236,74.125.24.0-255,5738,223527,76,238235
13980,0.002238,172.31.40.0-255,66,223593,76,238235
13981,0.002266,172.31.40.0-255,66,223659,76,238235
13982,0.00227,74.125.24.0-255,2184,225843,76,238235
13983,0.002272,172.31.40.0-255,66,225909,76,238235
13984,0.00228,74.125.24.0-255,7156,233065,76,238235
13985,0.002282,172.31.40.0-255,66,233131,76,238235
13986,0.00233,172.31.40.0-255,66,233197,76,238235
13987,0.002343,172.31.40.0-255,66,233263,76,238235
13988,0.002359,172.31.40.0-255,66,233329,76,238235
13989,0.002393,172.31.40.0-255,66,233395,76,238235
13990,0.002408,172.31.40.0-255,66,233461,76,238235
13991,0.002449,172.31.40.0-255,66,233527,76,238235
13992,0.002461,172.31.40.0-255,66,233593,76,238235
13993,0.004871,74.125.24.0-255,105,233698,76,238235
13994,0.010758,172.31.40.0-255,66,233764,76,238235
13995,0.010802,172.31.40.0-255,105,233869,76,238235
13996,0.013153,74.125.24.0-255,66,233935,76,238235
13997,0.030464,172.31.40.0-255,172,234107,76,238235
13998,0.030499,172.31.40.0-255,1109,235216,76,238235
13999,0.030563,172.31.40.0-255,1514,236730,76,238235
14000,0.030565,172.31.40.0-255,1307,238037,76,238235
14001,0.032155,104.244.42.0-255,66,238103,76,238235
14002,0.032191,104.244.42.0-255,66,238169,76,238235
14003,0.03225,104.244.42.0-255,66,238235,76,238235
14004,0.0,74.125.24.0-255,153,153,76,351888
14005,1.9e-05,172.31.40.0-255,66,219,76,351888
14006,2.6e-05,74.125.24.0-255,1484,1703,76,351888
14007,3e-05,172.31.40.0-255,66,1769,76,351888
14008,3.6e-05,74.125.24.0-255,2902,4671,76,351888
14009,3.9e-05,172.31.40.0-255,66,4737,76,351888
14010,5.4e-05,74.125.24.0-255,7156,11893,76,351888
14011,5.8e-05,172.31.40.0-255,66,11959,76,351888
14012,9.1e-05,74.125.24.0-255,2119,14078,76,351888
14013,9.4e-05,172.31.40.0-255,66,14144,76,351888
14014,0.000178,74.125.24.0-255,1484,15628,76,351888
14015,0.000182,172.31.40.0-255,66,15694,76,351888
14016,0.000187,74.125.24.0-255,2902,18596,76,351888
14017,0.00019,172.31.40.0-255,66,18662,76,351888
14018,0.000226,74.125.24.0-255,5738,24400,76,351888
14019,0.000229,172.31.40.0-255,66,24466,76,351888
14020,0.000252,74.125.24.0-255,4320,28786,76,351888
14021,0.000254,172.31.40.0-255,66,28852,76,351888
14022,0.000279,74.125.24.0-255,2543,31395,76,351888
14023,0.000282,172.31.40.0-255,66,31461,76,351888
14024,0.000587,74.125.24.0-255,1484,32945,76,351888
14025,0.000592,172.31.40.0-255,66,33011,76,351888
14026,0.000598,74.125.24.0-255,2902,35913,76,351888
14027,0.0006,172.31.40.0-255,66,35979,76,351888
14028,0.000603,74.125.24.0-255,1484,37463,76,351888
14029,0.000605,172.31.40.0-255,66,37529,76,351888
14030,0.000634,74.125.24.0-255,4320,41849,76,351888
14031,0.000637,172.31.40.0-255,66,41915,76,351888
14032,0.000653,172.31.40.0-255,66,41981,76,351888
14033,0.000656,74.125.24.0-255,1484,43465,76,351888
14034,0.000658,172.31.40.0-255,66,43531,76,351888
14035,0.000708,172.31.40.0-255,66,43597,76,351888
14036,0.000733,74.125.24.0-255,351,43948,76,351888
14037,0.001045,74.125.24.0-255,1484,45432,76,351888
14038,0.001052,172.31.40.0-255,66,45498,76,351888
14039,0.001058,74.125.24.0-255,2902,48400,76,351888
14040,0.00106,172.31.40.0-255,66,48466,76,351888
14041,0.001096,74.125.24.0-255,5738,54204,76,351888
14042,0.001099,172.31.40.0-255,66,54270,76,351888
14043,0.001112,172.31.40.0-255,66,54336,76,351888
14044,0.00115,74.125.24.0-255,4320,58656,76,351888
14045,0.001153,172.31.40.0-255,66,58722,76,351888
14046,0.00119,172.31.40.0-255,66,58788,76,351888
14047,0.001216,74.125.24.0-255,1484,60272,76,351888
14048,0.00122,74.125.24.0-255,1484,61756,76,351888
14049,0.001222,172.31.40.0-255,66,61822,76,351888
14050,0.001236,74.125.24.0-255,1484,63306,76,351888
14051,0.001244,74.125.24.0-255,1484,64790,76,351888
14052,0.001246,172.31.40.0-255,66,64856,76,351888
14053,0.001271,74.125.24.0-255,2902,67758,76,351888
14054,0.001274,172.31.40.0-255,66,67824,76,351888
14055,0.001284,172.31.40.0-255,66,67890,76,351888
14056,0.00129,74.125.24.0-255,4320,72210,76,351888
14057,0.001292,172.31.40.0-255,66,72276,76,351888
14058,0.001333,172.31.40.0-255,66,72342,76,351888
14059,0.001337,74.125.24.0-255,2184,74526,76,351888
14060,0.00134,172.31.40.0-255,66,74592,76,351888
14061,0.001724,74.125.24.0-255,1484,76076,76,351888
14062,0.001733,74.125.24.0-255,2902,78978,76,351888
14063,0.001738,172.31.40.0-255,66,79044,76,351888
14064,0.001745,74.125.24.0-255,5738,84782,76,351888
14065,0.001747,172.31.40.0-255,66,84848,76,351888
14066,0.001771,74.125.24.0-255,5738,90586,76,351888
14067,0.001774,172.31.40.0-255,66,90652,76,351888
14068,0.001807,74.125.24.0-255,7156,97808,76,351888
14069,0.00181,172.31.40.0-255,66,97874,76,351888
14070,0.001822,172.31.40.0-255,66,97940,76,351888
14071,0.001918,74.125.24.0-255,1484,99424,76,351888
14072,0.001934,74.125.24.0-255,2902,102326,76,351888
14073,0.001936,172.31.40.0-255,66,102392,76,351888
14074,0.001965,74.125.24.0-255,5738,108130,76,351888
14075,0.001968,172.31.40.0-255,66,108196,76,351888
14076,0.001972,74.125.24.0-255,2902,111098,76,351888
14077,0.001975,172.31.40.0-255,66,111164,76,351888
14078,0.001999,74.125.24.0-255,2902,114066,76,351888
14079,0.002002,172.31.40.0-255,66,114132,76,351888
14080,0.002009,74.125.24.0-255,7156,121288,76,351888
14081,0.002012,172.31.40.0-255,66,121354,76,351888
14082,0.002051,74.125.24.0-255,5738,127092,76,351888
14083,0.002054,172.31.40.0-255,66,127158,76,351888
14084,0.002059,74.125.24.0-255,5020,132178,76,351888
14085,0.002061,172.31.40.0-255,66,132244,76,351888
14086,0.002161,74.125.24.0-255,1484,133728,76,351888
14087,0.002165,74.125.24.0-255,1484,135212,76,351888
14088,0.002167,172.31.40.0-255,66,135278,76,351888
14089,0.002195,74.125.24.0-255,1484,136762,76,351888
14090,0.002203,74.125.24.0-255,5738,142500,76,351888
14091,0.002205,172.31.40.0-255,66,142566,76,351888
14092,0.002249,74.125.24.0-255,4320,146886,76,351888
14093,0.002251,172.31.40.0-255,66,146952,76,351888
14094,0.002279,74.125.24.0-255,7156,154108,76,351888
14095,0.002282,172.31.40.0-255,66,154174,76,351888
14096,0.002285,74.125.24.0-255,2902,157076,76,351888
14097,0.002287,172.31.40.0-255,66,157142,76,351888
14098,0.004473,74.125.24.0-255,5738,162880,76,351888
14099,0.00448,172.31.40.0-255,66,162946,76,351888
14100,0.006695,74.125.24.0-255,5738,168684,76,351888
14101,0.006702,172.31.40.0-255,66,168750,76,351888
14102,0.008888,74.125.24.0-255,5738,174488,76,351888
14103,0.008896,172.31.40.0-255,66,174554,76,351888
14104,0.011086,74.125.24.0-255,5738,180292,76,351888
14105,0.011094,172.31.40.0-255,66,180358,76,351888
14106,0.013307,74.125.24.0-255,5738,186096,76,351888
14107,0.013318,172.31.40.0-255,66,186162,76,351888
14108,0.015519,74.125.24.0-255,5738,191900,76,351888
14109,0.015528,172.31.40.0-255,66,191966,76,351888
14110,0.017737,74.125.24.0-255,5738,197704,76,351888
14111,0.017745,172.31.40.0-255,66,197770,76,351888
14112,0.019933,74.125.24.0-255,5738,203508,76,351888
14113,0.019942,172.31.40.0-255,66,203574,76,351888
14114,0.022138,74.125.24.0-255,5738,209312,76,351888
14115,0.022147,172.31.40.0-255,66,209378,76,351888
14116,0.024359,74.125.24.0-255,5738,215116,76,351888
14117,0.024367,172.31.40.0-255,66,215182,76,351888
14118,0.026583,74.125.24.0-255,5738,220920,76,351888
14119,0.026592,172.31.40.0-255,66,220986,76,351888
14120,0.02747,172.31.40.0-255,172,221158,76,351888
14121,0.0275,172.31.40.0-255,1105,222263,76,351888
14122,0.02756,172.31.40.0-255,1514,223777,76,351888
14123,0.027562,172.31.40.0-255,1312,225089,76,351888
14124,0.028769,74.125.24.0-255,5738,230827,76,351888
14125,0.028777,172.31.40.0-255,66,230893,76,351888
14126,0.030981,74.125.24.0-255,5738,236631,76,351888
14127,0.030989,172.31.40.0-255,66,236697,76,351888
14128,0.033204,74.125.24.0-255,5738,242435,76,351888
14129,0.033211,172.31.40.0-255,66,242501,76,351888
14130,0.035383,74.125.24.0-255,5738,248239,76,351888
14131,0.03539,172.31.40.0-255,66,248305,76,351888
14132,0.03755,74.125.24.0-255,5738,254043,76,351888
14133,0.037557,172.31.40.0-255,66,254109,76,351888
14134,0.039758,74.125.24.0-255,5738,259847,76,351888
14135,0.039765,172.31.40.0-255,66,259913,76,351888
14136,0.041971,74.125.24.0-255,5738,265651,76,351888
14137,0.041981,172.31.40.0-255,66,265717,76,351888
14138,0.044179,74.125.24.0-255,5738,271455,76,351888
14139,0.044186,172.31.40.0-255,66,271521,76,351888
14140,0.046389,74.125.24.0-255,5738,277259,76,351888
14141,0.046396,172.31.40.0-255,66,277325,76,351888
14142,0.04861,74.125.24.0-255,5738,283063,76,351888
14143,0.048617,172.31.40.0-255,66,283129,76,351888
14144,0.050847,74.125.24.0-255,5738,288867,76,351888
14145,0.050854,172.31.40.0-255,66,288933,76,351888
14146,0.053059,74.125.24.0-255,5738,294671,76,351888
14147,0.053067,172.31.40.0-255,66,294737,76,351888
14148,0.055293,74.125.24.0-255,5738,300475,76,351888
14149,0.0553,172.31.40.0-255,66,300541,76,351888
14150,0.057519,74.125.24.0-255,5738,306279,76,351888
14151,0.057526,172.31.40.0-255,66,306345,76,351888
14152,0.05971,74.125.24.0-255,5738,312083,76,351888
14153,0.059717,172.31.40.0-255,66,312149,76,351888
14154,0.061933,74.125.24.0-255,5738,317887,76,351888
14155,0.061939,172.31.40.0-255,66,317953,76,351888
14156,0.064141,74.125.24.0-255,5738,323691,76,351888
14157,0.064146,172.31.40.0-255,66,323757,76,351888
14158,0.066343,74.125.24.0-255,5738,329495,76,351888
14159,0.066349,172.31.40.0-255,66,329561,76,351888
14160,0.068578,74.125.24.0-255,5738,335299,76,351888
14161,0.068585,172.31.40.0-255,66,335365,76,351888
14162,0.070763,74.125.24.0-255,1484,336849,76,351888
14163,0.070787,74.125.24.0-255,4320,341169,76,351888
14164,0.070793,172.31.40.0-255,66,341235,76,351888
14165,0.072994,74.125.24.0-255,5738,346973,76,351888
14166,0.073001,172.31.40.0-255,66,347039,76,351888
14167,0.075195,74.125.24.0-255,4612,351651,76,351888
14168,0.075201,172.31.40.0-255,66,351717,76,351888
14169,0.075347,172.31.40.0-255,105,351822,76,351888
14170,0.077513,74.125.24.0-255,66,351888,76,351888
14171,0.0,172.217.194.0-255,150,150,76,187288
14172,1.5e-05,172.31.40.0-255,66,216,76,187288
14173,2.2e-05,172.217.194.0-255,1484,1700,76,187288
14174,2.6e-05,172.31.40.0-255,66,1766,76,187288
14175,3.2e-05,172.217.194.0-255,2902,4668,76,187288
14176,3.6e-05,172.31.40.0-255,66,4734,76,187288
14177,6.4e-05,172.217.194.0-255,7156,11890,76,187288
14178,6.7e-05,172.31.40.0-255,66,11956,76,187288
14179,7.1e-05,172.217.194.0-255,2055,14011,76,187288
14180,7.3e-05,172.31.40.0-255,66,14077,76,187288
14181,0.000117,172.217.194.0-255,4320,18397,76,187288
14182,0.000121,172.31.40.0-255,66,18463,76,187288
14183,0.000144,172.217.194.0-255,7156,25619,76,187288
14184,0.000147,172.31.40.0-255,66,25685,76,187288
14185,0.000162,172.217.194.0-255,2902,28587,76,187288
14186,0.000165,172.31.40.0-255,66,28653,76,187288
14187,0.000194,172.217.194.0-255,3961,32614,76,187288
14188,0.000197,172.31.40.0-255,66,32680,76,187288
14189,0.000205,172.217.194.0-255,7156,39836,76,187288
14190,0.000208,172.31.40.0-255,66,39902,76,187288
14191,0.00021,172.217.194.0-255,1484,41386,76,187288
14192,0.000212,172.31.40.0-255,66,41452,76,187288
14193,0.000245,172.217.194.0-255,6797,48249,76,187288
14194,0.000248,172.31.40.0-255,66,48315,76,187288
14195,0.000256,172.217.194.0-255,7156,55471,76,187288
14196,0.000259,172.31.40.0-255,66,55537,76,187288
14197,0.000284,172.217.194.0-255,1484,57021,76,187288
14198,0.000287,172.31.40.0-255,66,57087,76,187288
14199,0.000299,172.31.40.0-255,66,57153,76,187288
14200,0.000301,172.217.194.0-255,396,57549,76,187288
14201,0.000304,172.31.40.0-255,66,57615,76,187288
14202,0.000432,172.217.194.0-255,1484,59099,76,187288
14203,0.000439,172.217.194.0-255,2902,62001,76,187288
14204,0.000443,172.31.40.0-255,66,62067,76,187288
14205,0.000463,172.217.194.0-255,5738,67805,76,187288
14206,0.000466,172.31.40.0-255,66,67871,76,187288
14207,0.000471,172.217.194.0-255,4320,72191,76,187288
14208,0.000473,172.31.40.0-255,66,72257,76,187288
14209,0.000526,172.31.40.0-255,66,72323,76,187288
14210,0.000542,172.217.194.0-255,1125,73448,76,187288
14211,0.00055,172.217.194.0-255,6797,80245,76,187288
14212,0.000553,172.31.40.0-255,66,80311,76,187288
14213,0.000881,172.217.194.0-255,1484,81795,76,187288
14214,0.000889,172.217.194.0-255,2902,84697,76,187288
14215,0.000894,172.31.40.0-255,66,84763,76,187288
14216,0.000902,172.217.194.0-255,5738,90501,76,187288
14217,0.000905,172.31.40.0-255,66,90567,76,187288
14218,0.000934,172.217.194.0-255,4320,94887,76,187288
14219,0.000937,172.31.40.0-255,66,94953,76,187288
14220,0.000967,172.31.40.0-255,66,95019,76,187288
14221,0.000979,172.31.40.0-255,66,95085,76,187288
14222,0.001047,172.217.194.0-255,1484,96569,76,187288
14223,0.001051,172.217.194.0-255,1484,98053,76,187288
14224,0.001053,172.31.40.0-255,66,98119,76,187288
14225,0.00107,172.217.194.0-255,1484,99603,76,187288
14226,0.001077,172.217.194.0-255,5738,105341,76,187288
14227,0.001079,172.31.40.0-255,66,105407,76,187288
14228,0.00112,172.31.40.0-255,66,105473,76,187288
14229,0.001132,172.31.40.0-255,66,105539,76,187288
14230,0.001154,172.217.194.0-255,766,106305,76,187288
14231,0.001229,172.217.194.0-255,1484,107789,76,187288
14232,0.001232,172.31.40.0-255,66,107855,76,187288
14233,0.001238,172.217.194.0-255,2902,110757,76,187288
14234,0.001241,172.31.40.0-255,66,110823,76,187288
14235,0.001247,172.217.194.0-255,5738,116561,76,187288
14236,0.00125,172.31.40.0-255,66,116627,76,187288
14237,0.001257,172.217.194.0-255,5738,122365,76,187288
14238,0.001259,172.31.40.0-255,66,122431,76,187288
14239,0.001292,172.31.40.0-255,66,122497,76,187288
14240,0.001295,172.217.194.0-255,1484,123981,76,187288
14241,0.001322,172.217.194.0-255,3602,127583,76,187288
14242,0.001324,172.31.40.0-255,66,127649,76,187288
14243,0.00133,172.217.194.0-255,5738,133387,76,187288
14244,0.001332,172.31.40.0-255,66,133453,76,187288
14245,0.001338,172.217.194.0-255,4320,137773,76,187288
14246,0.00134,172.31.40.0-255,66,137839,76,187288
14247,0.0014,172.31.40.0-255,66,137905,76,187288
14248,0.001411,172.31.40.0-255,66,137971,76,187288
14249,0.001418,172.217.194.0-255,7156,145127,76,187288
14250,0.001419,172.31.40.0-255,66,145193,76,187288
14251,0.001488,172.31.40.0-255,66,145259,76,187288
14252,0.001508,172.217.194.0-255,3602,148861,76,187288
14253,0.00151,172.31.40.0-255,66,148927,76,187288
14254,0.001521,172.31.40.0-255,66,148993,76,187288
14255,0.001534,172.31.40.0-255,66,149059,76,187288
14256,0.001549,172.31.40.0-255,66,149125,76,187288
14257,0.001551,172.217.194.0-255,766,149891,76,187288
14258,0.001805,172.217.194.0-255,1484,151375,76,187288
14259,0.00181,172.31.40.0-255,66,151441,76,187288
14260,0.001815,172.217.194.0-255,2902,154343,76,187288
14261,0.001817,172.31.40.0-255,66,154409,76,187288
14262,0.001821,172.217.194.0-255,2902,157311,76,187288
14263,0.001823,172.31.40.0-255,66,157377,76,187288
14264,0.00184,172.217.194.0-255,2902,160279,76,187288
14265,0.001843,172.31.40.0-255,66,160345,76,187288
14266,0.00187,172.31.40.0-255,66,160411,76,187288
14267,0.001888,172.217.194.0-255,2902,163313,76,187288
14268,0.001891,172.31.40.0-255,66,163379,76,187288
14269,0.001902,172.31.40.0-255,66,163445,76,187288
14270,0.001938,172.31.40.0-255,66,163511,76,187288
14271,0.001956,172.31.40.0-255,66,163577,76,187288
14272,0.00196,172.217.194.0-255,2184,165761,76,187288
14273,0.001961,172.31.40.0-255,66,165827,76,187288
14274,0.001995,172.217.194.0-255,5738,171565,76,187288
14275,0.001997,172.31.40.0-255,66,171631,76,187288
14276,0.002029,172.31.40.0-255,66,171697,76,187288
14277,0.002064,172.31.40.0-255,66,171763,76,187288
14278,0.002085,172.217.194.0-255,5738,177501,76,187288
14279,0.002088,172.31.40.0-255,66,177567,76,187288
14280,0.002106,172.217.194.0-255,5013,182580,76,187288
14281,0.002108,172.31.40.0-255,66,182646,76,187288
14282,0.002111,172.217.194.0-255,105,182751,76,187288
14283,0.005003,172.31.40.0-255,66,182817,76,187288
14284,0.005038,172.31.40.0-255,105,182922,76,187288
14285,0.007203,172.217.194.0-255,66,182988,76,187288
14286,0.035239,172.31.40.0-255,172,183160,76,187288
14287,0.035268,172.31.40.0-255,1109,184269,76,187288
14288,0.035338,172.31.40.0-255,1514,185783,76,187288
14289,0.03534,172.31.40.0-255,1307,187090,76,187288
14290,0.036903,104.244.42.0-255,66,187156,76,187288
14291,0.036941,104.244.42.0-255,66,187222,76,187288
14292,0.037077,104.244.42.0-255,66,187288,76,187288
14293,0.0,74.125.68.0-255,155,155,76,367662
14294,2.3e-05,172.31.40.0-255,66,221,76,367662
14295,3e-05,74.125.68.0-255,1484,1705,76,367662
14296,3.4e-05,172.31.40.0-255,66,1771,76,367662
14297,4e-05,74.125.68.0-255,2902,4673,76,367662
14298,4.4e-05,172.31.40.0-255,66,4739,76,367662
14299,5.1e-05,74.125.68.0-255,5738,10477,76,367662
14300,5.3e-05,172.31.40.0-255,66,10543,76,367662
14301,7e-05,74.125.68.0-255,1484,12027,76,367662
14302,7.3e-05,172.31.40.0-255,66,12093,76,367662
14303,7.7e-05,74.125.68.0-255,2071,14164,76,367662
14304,7.9e-05,172.31.40.0-255,66,14230,76,367662
14305,8.4e-05,74.125.68.0-255,2902,17132,76,367662
14306,8.7e-05,172.31.40.0-255,66,17198,76,367662
14307,0.000124,74.125.68.0-255,7156,24354,76,367662
14308,0.000127,172.31.40.0-255,66,24420,76,367662
14309,0.000159,74.125.68.0-255,2902,27322,76,367662
14310,0.000161,172.31.40.0-255,66,27388,76,367662
14311,0.000179,74.125.68.0-255,3961,31349,76,367662
14312,0.000182,172.31.40.0-255,66,31415,76,367662
14313,0.000232,74.125.68.0-255,1484,32899,76,367662
14314,0.000234,172.31.40.0-255,66,32965,76,367662
14315,0.000267,74.125.68.0-255,2902,35867,76,367662
14316,0.00027,172.31.40.0-255,66,35933,76,367662
14317,0.000285,74.125.68.0-255,4320,40253,76,367662
14318,0.000288,172.31.40.0-255,66,40319,76,367662
14319,0.000326,172.31.40.0-255,66,40385,76,367662
14320,0.000343,74.125.68.0-255,1484,41869,76,367662
14321,0.000345,172.31.40.0-255,66,41935,76,367662
14322,0.000364,74.125.68.0-255,7156,49091,76,367662
14323,0.000367,172.31.40.0-255,66,49157,76,367662
14324,0.000373,74.125.68.0-255,4320,53477,76,367662
14325,0.000375,172.31.40.0-255,66,53543,76,367662
14326,0.000395,74.125.68.0-255,4239,57782,76,367662
14327,0.000398,172.31.40.0-255,66,57848,76,367662
14328,0.000401,74.125.68.0-255,132,57980,76,367662
14329,0.000485,74.125.68.0-255,1484,59464,76,367662
14330,0.00049,172.31.40.0-255,66,59530,76,367662
14331,0.000495,74.125.68.0-255,2902,62432,76,367662
14332,0.000497,172.31.40.0-255,66,62498,76,367662
14333,0.000513,74.125.68.0-255,5738,68236,76,367662
14334,0.000515,172.31.40.0-255,66,68302,76,367662
14335,0.00053,74.125.68.0-255,1484,69786,76,367662
14336,0.000548,74.125.68.0-255,5738,75524,76,367662
14337,0.000551,172.31.40.0-255,66,75590,76,367662
14338,0.00057,74.125.68.0-255,1484,77074,76,367662
14339,0.000594,172.31.40.0-255,66,77140,76,367662
14340,0.000642,74.125.68.0-255,3879,81019,76,367662
14341,0.000645,172.31.40.0-255,66,81085,76,367662
14342,0.000912,74.125.68.0-255,1484,82569,76,367662
14343,0.000928,74.125.68.0-255,1484,84053,76,367662
14344,0.000931,172.31.40.0-255,66,84119,76,367662
14345,0.000939,74.125.68.0-255,2902,87021,76,367662
14346,0.000941,172.31.40.0-255,66,87087,76,367662
14347,0.000947,74.125.68.0-255,4320,91407,76,367662
14348,0.000949,172.31.40.0-255,66,91473,76,367662
14349,0.00097,74.125.68.0-255,1484,92957,76,367662
14350,0.000991,172.31.40.0-255,66,93023,76,367662
14351,0.00101,74.125.68.0-255,7156,100179,76,367662
14352,0.001014,172.31.40.0-255,66,100245,76,367662
14353,0.001043,74.125.68.0-255,4320,104565,76,367662
14354,0.001046,172.31.40.0-255,66,104631,76,367662
14355,0.001049,74.125.68.0-255,766,105397,76,367662
14356,0.001108,74.125.68.0-255,1484,106881,76,367662
14357,0.001113,172.31.40.0-255,66,106947,76,367662
14358,0.001124,74.125.68.0-255,2902,109849,76,367662
14359,0.001127,172.31.40.0-255,66,109915,76,367662
14360,0.001158,74.125.68.0-255,5738,115653,76,367662
14361,0.001162,172.31.40.0-255,66,115719,76,367662
14362,0.001183,74.125.68.0-255,5738,121457,76,367662
14363,0.001186,172.31.40.0-255,66,121523,76,367662
14364,0.001212,74.125.68.0-255,7156,128679,76,367662
14365,0.001215,172.31.40.0-255,66,128745,76,367662
14366,0.001218,74.125.68.0-255,1484,130229,76,367662
14367,0.001251,172.31.40.0-255,66,130295,76,367662
14368,0.001475,74.125.68.0-255,1484,131779,76,367662
14369,0.001494,74.125.68.0-255,2902,134681,76,367662
14370,0.001499,172.31.40.0-255,66,134747,76,367662
14371,0.001506,74.125.68.0-255,5738,140485,76,367662
14372,0.001508,172.31.40.0-255,66,140551,76,367662
14373,0.001529,74.125.68.0-255,2902,143453,76,367662
14374,0.001532,172.31.40.0-255,66,143519,76,367662
14375,0.001559,172.31.40.0-255,66,143585,76,367662
14376,0.001566,74.125.68.0-255,7156,150741,76,367662
14377,0.001569,172.31.40.0-255,66,150807,76,367662
14378,0.001596,74.125.68.0-255,5020,155827,76,367662
14379,0.001599,172.31.40.0-255,66,155893,76,367662
14380,0.002092,74.125.68.0-255,1484,157377,76,367662
14381,0.002105,74.125.68.0-255,2902,160279,76,367662
14382,0.002109,172.31.40.0-255,66,160345,76,367662
14383,0.002112,74.125.68.0-255,1484,161829,76,367662
14384,0.002136,74.125.68.0-255,4320,166149,76,367662
14385,0.002139,172.31.40.0-255,66,166215,76,367662
14386,0.002146,74.125.68.0-255,5738,171953,76,367662
14387,0.002148,172.31.40.0-255,66,172019,76,367662
14388,0.002181,74.125.68.0-255,7156,179175,76,367662
14389,0.002185,172.31.40.0-255,66,179241,76,367662
14390,0.002208,74.125.68.0-255,5738,184979,76,367662
14391,0.002211,172.31.40.0-255,66,185045,76,367662
14392,0.002244,74.125.68.0-255,6438,191483,76,367662
14393,0.002247,172.31.40.0-255,66,191549,76,367662
14394,0.002253,74.125.68.0-255,4320,195869,76,367662
14395,0.002255,172.31.40.0-255,66,195935,76,367662
14396,0.002261,74.125.68.0-255,5738,201673,76,367662
14397,0.002263,172.31.40.0-255,66,201739,76,367662
14398,0.002286,74.125.68.0-255,1484,203223,76,367662
14399,0.002334,74.125.68.0-255,5738,208961,76,367662
14400,0.002338,172.31.40.0-255,66,209027,76,367662
14401,0.008141,172.31.40.0-255,66,209093,76,367662
14402,0.010435,74.125.68.0-255,5738,214831,76,367662
14403,0.010443,172.31.40.0-255,66,214897,76,367662
14404,0.012748,74.125.68.0-255,5738,220635,76,367662
14405,0.012757,172.31.40.0-255,66,220701,76,367662
14406,0.015105,74.125.68.0-255,5738,226439,76,367662
14407,0.015113,172.31.40.0-255,66,226505,76,367662
14408,0.017417,74.125.68.0-255,5738,232243,76,367662
14409,0.017427,172.31.40.0-255,66,232309,76,367662
14410,0.019725,74.125.68.0-255,5738,238047,76,367662
14411,0.019734,172.31.40.0-255,66,238113,76,367662
14412,0.022046,74.125.68.0-255,5738,243851,76,367662
14413,0.022053,172.31.40.0-255,66,243917,76,367662
14414,0.024353,74.125.68.0-255,5738,249655,76,367662
14415,0.02436,172.31.40.0-255,66,249721,76,367662
14416,0.026659,74.125.68.0-255,5738,255459,76,367662
14417,0.026666,172.31.40.0-255,66,255525,76,367662
14418,0.02896,74.125.68.0-255,5738,261263,76,367662
14419,0.028966,172.31.40.0-255,66,261329,76,367662
14420,0.029398,172.31.40.0-255,172,261501,76,367662
14421,0.02943,172.31.40.0-255,1109,262610,76,367662
14422,0.029487,172.31.40.0-255,1514,264124,76,367662
14423,0.029488,172.31.40.0-255,1309,265433,76,367662
14424,0.030891,104.244.42.0-255,66,265499,76,367662
14425,0.031086,104.244.42.0-255,66,265565,76,367662
14426,0.031098,104.244.42.0-255,66,265631,76,367662
14427,0.031282,74.125.68.0-255,5738,271369,76,367662
14428,0.031288,172.31.40.0-255,66,271435,76,367662
14429,0.033599,74.125.68.0-255,5738,277173,76,367662
14430,0.033608,172.31.40.0-255,66,277239,76,367662
14431,0.035908,74.125.68.0-255,5738,282977,76,367662
14432,0.03592,172.31.40.0-255,66,283043,76,367662
14433,0.038232,74.125.68.0-255,5738,288781,76,367662
14434,0.038238,172.31.40.0-255,66,288847,76,367662
14435,0.04054,74.125.68.0-255,5738,294585,76,367662
14436,0.040549,172.31.40.0-255,66,294651,76,367662
14437,0.042848,74.125.68.0-255,5738,300389,76,367662
14438,0.042855,172.31.40.0-255,66,300455,76,367662
14439,0.045157,74.125.68.0-255,5738,306193,76,367662
14440,0.045162,172.31.40.0-255,66,306259,76,367662
14441,0.047459,74.125.68.0-255,5738,311997,76,367662
14442,0.047466,172.31.40.0-255,66,312063,76,367662
14443,0.049765,74.125.68.0-255,5738,317801,76,367662
14444,0.049772,172.31.40.0-255,66,317867,76,367662
14445,0.052095,74.125.68.0-255,5738,323605,76,367662
14446,0.052107,172.31.40.0-255,66,323671,76,367662
14447,0.054447,74.125.68.0-255,5738,329409,76,367662
14448,0.054453,172.31.40.0-255,66,329475,76,367662
14449,0.056758,74.125.68.0-255,5738,335213,76,367662
14450,0.056765,172.31.40.0-255,66,335279,76,367662
14451,0.059068,74.125.68.0-255,5738,341017,76,367662
14452,0.059075,172.31.40.0-255,66,341083,76,367662
14453,0.061374,74.125.68.0-255,5738,346821,76,367662
14454,0.061381,172.31.40.0-255,66,346887,76,367662
14455,0.063677,74.125.68.0-255,5738,352625,76,367662
14456,0.063684,172.31.40.0-255,66,352691,76,367662
14457,0.065993,74.125.68.0-255,5738,358429,76,367662
14458,0.066,172.31.40.0-255,66,358495,76,367662
14459,0.068315,74.125.68.0-255,5738,364233,76,367662
14460,0.068324,172.31.40.0-255,66,364299,76,367662
14461,0.070637,74.125.68.0-255,2601,366900,76,367662
14462,0.070644,172.31.40.0-255,66,366966,76,367662
14463,0.070826,172.31.40.0-255,105,367071,76,367662
14464,0.070863,172.31.40.0-255,105,367176,76,367662
14465,0.071111,172.31.40.0-255,90,367266,76,367662
14466,0.071123,172.31.40.0-255,66,367332,76,367662
14467,0.073085,74.125.68.0-255,66,367398,76,367662
14468,0.073121,74.125.68.0-255,66,367464,76,367662
14469,0.073374,74.125.68.0-255,66,367530,76,367662
14470,0.073395,74.125.68.0-255,66,367596,76,367662
14471,0.073417,172.31.40.0-255,66,367662,76,367662
14472,0.0,74.125.200.0-255,152,152,76,364623
14473,2.3e-05,172.31.40.0-255,66,218,76,364623
14474,3.1e-05,74.125.200.0-255,1484,1702,76,364623
14475,3.5e-05,172.31.40.0-255,66,1768,76,364623
14476,4e-05,74.125.200.0-255,2902,4670,76,364623
14477,5.1e-05,172.31.40.0-255,66,4736,76,364623
14478,5.6e-05,74.125.200.0-255,2902,7638,76,364623
14479,5.8e-05,172.31.40.0-255,66,7704,76,364623
14480,6.4e-05,74.125.200.0-255,4320,12024,76,364623
14481,6.6e-05,172.31.40.0-255,66,12090,76,364623
14482,0.000113,74.125.200.0-255,2160,14250,76,364623
14483,0.000116,172.31.40.0-255,66,14316,76,364623
14484,0.000185,74.125.200.0-255,1484,15800,76,364623
14485,0.000188,172.31.40.0-255,66,15866,76,364623
14486,0.000191,74.125.200.0-255,1484,17350,76,364623
14487,0.000193,172.31.40.0-255,66,17416,76,364623
14488,0.000216,74.125.200.0-255,1484,18900,76,364623
14489,0.000224,172.31.40.0-255,66,18966,76,364623
14490,0.000231,74.125.200.0-255,5738,24704,76,364623
14491,0.000233,172.31.40.0-255,66,24770,76,364623
14492,0.000236,74.125.200.0-255,1484,26254,76,364623
14493,0.000237,172.31.40.0-255,66,26320,76,364623
14494,0.000276,172.31.40.0-255,66,26386,76,364623
14495,0.000286,74.125.200.0-255,1125,27511,76,364623
14496,0.000289,172.31.40.0-255,66,27577,76,364623
14497,0.000299,74.125.200.0-255,4320,31897,76,364623
14498,0.000301,172.31.40.0-255,66,31963,76,364623
14499,0.00033,74.125.200.0-255,2902,34865,76,364623
14500,0.000332,172.31.40.0-255,66,34931,76,364623
14501,0.000365,74.125.200.0-255,5379,40310,76,364623
14502,0.000368,172.31.40.0-255,66,40376,76,364623
14503,0.000394,74.125.200.0-255,1484,41860,76,364623
14504,0.000398,74.125.200.0-255,1484,43344,76,364623
14505,0.00041,74.125.200.0-255,1484,44828,76,364623
14506,0.000432,74.125.200.0-255,5738,50566,76,364623
14507,0.000435,74.125.200.0-255,1484,52050,76,364623
14508,0.000485,74.125.200.0-255,4320,56370,76,364623
14509,0.0005,74.125.200.0-255,1470,57840,76,364623
14510,0.000503,74.125.200.0-255,343,58183,76,364623
14511,0.000627,172.31.40.0-255,66,58249,76,364623
14512,0.000853,74.125.200.0-255,1484,59733,76,364623
14513,0.000858,74.125.200.0-255,1484,61217,76,364623
14514,0.000872,74.125.200.0-255,1484,62701,76,364623
14515,0.000875,172.31.40.0-255,66,62767,76,364623
14516,0.000882,74.125.200.0-255,1484,64251,76,364623
14517,0.000894,172.31.40.0-255,66,64317,76,364623
14518,0.000906,74.125.200.0-255,4320,68637,76,364623
14519,0.000916,74.125.200.0-255,7156,75793,76,364623
14520,0.000937,74.125.200.0-255,2902,78695,76,364623
14521,0.000946,172.31.40.0-255,66,78761,76,364623
14522,0.000989,74.125.200.0-255,2902,81663,76,364623
14523,0.000994,172.31.40.0-255,66,81729,76,364623
14524,0.001003,74.125.200.0-255,2184,83913,76,364623
14525,0.001012,172.31.40.0-255,66,83979,76,364623
14526,0.001221,74.125.200.0-255,1484,85463,76,364623
14527,0.001233,74.125.200.0-255,1484,86947,76,364623
14528,0.001235,172.31.40.0-255,66,87013,76,364623
14529,0.001241,74.125.200.0-255,2902,89915,76,364623
14530,0.001262,172.31.40.0-255,66,89981,76,364623
14531,0.001288,74.125.200.0-255,4320,94301,76,364623
14532,0.001293,172.31.40.0-255,66,94367,76,364623
14533,0.001328,74.125.200.0-255,5738,100105,76,364623
14534,0.00134,172.31.40.0-255,66,100171,76,364623
14535,0.001346,74.125.200.0-255,4320,104491,76,364623
14536,0.00135,172.31.40.0-255,66,104557,76,364623
14537,0.001364,74.125.200.0-255,5738,110295,76,364623
14538,0.001385,74.125.200.0-255,1484,111779,76,364623
14539,0.001405,74.125.200.0-255,6438,118217,76,364623
14540,0.001408,172.31.40.0-255,66,118283,76,364623
14541,0.001418,172.31.40.0-255,66,118349,76,364623
14542,0.001453,172.31.40.0-255,66,118415,76,364623
14543,0.001457,74.125.200.0-255,2902,121317,76,364623
14544,0.001461,172.31.40.0-255,66,121383,76,364623
14545,0.001486,74.125.200.0-255,7156,128539,76,364623
14546,0.001491,74.125.200.0-255,2902,131441,76,364623
14547,0.001533,74.125.200.0-255,766,132207,76,364623
14548,0.001645,74.125.200.0-255,1484,133691,76,364623
14549,0.001672,74.125.200.0-255,2902,136593,76,364623
14550,0.001695,74.125.200.0-255,1484,138077,76,364623
14551,0.001698,74.125.200.0-255,1484,139561,76,364623
14552,0.001712,74.125.200.0-255,1484,141045,76,364623
14553,0.001718,74.125.200.0-255,5738,146783,76,364623
14554,0.001738,74.125.200.0-255,4320,151103,76,364623
14555,0.001751,74.125.200.0-255,4320,155423,76,364623
14556,0.001759,74.125.200.0-255,1484,156907,76,364623
14557,0.001787,74.125.200.0-255,766,157673,76,364623
14558,0.001843,74.125.200.0-255,1484,159157,76,364623
14559,0.001849,74.125.200.0-255,4320,163477,76,364623
14560,0.001851,74.125.200.0-255,1484,164961,76,364623
14561,0.001855,74.125.200.0-255,2902,167863,76,364623
14562,0.001873,74.125.200.0-255,4320,172183,76,364623
14563,0.001887,74.125.200.0-255,1484,173667,76,364623
14564,0.00189,74.125.200.0-255,1484,175151,76,364623
14565,0.001948,74.125.200.0-255,5738,180889,76,364623
14566,0.001999,74.125.200.0-255,2184,183073,76,364623
14567,0.002161,74.125.200.0-255,1484,184557,76,364623
14568,0.002229,74.125.200.0-255,1484,186041,76,364623
14569,0.002241,74.125.200.0-255,1484,187525,76,364623
14570,0.002258,74.125.200.0-255,1484,189009,76,364623
14571,0.002264,74.125.200.0-255,2902,191911,76,364623
14572,0.002276,74.125.200.0-255,1484,193395,76,364623
14573,0.00228,74.125.200.0-255,2902,196297,76,364623
14574,0.002309,74.125.200.0-255,5738,202035,76,364623
14575,0.002317,74.125.200.0-255,7156,209191,76,364623
14576,0.002328,74.125.200.0-255,2902,212093,76,364623
14577,0.002351,74.125.200.0-255,5020,217113,76,364623
14578,0.010495,172.31.40.0-255,66,217179,76,364623
14579,0.010655,74.125.200.0-255,1484,218663,76,364623
14580,0.012829,74.125.200.0-255,4320,222983,76,364623
14581,0.012837,172.31.40.0-255,66,223049,76,364623
14582,0.015179,74.125.200.0-255,5738,228787,76,364623
14583,0.0157,172.31.40.0-255,66,228853,76,364623
14584,0.01801,74.125.200.0-255,5738,234591,76,364623
14585,0.018017,172.31.40.0-255,66,234657,76,364623
14586,0.020398,74.125.200.0-255,4320,238977,76,364623
14587,0.020405,172.31.40.0-255,66,239043,76,364623
14588,0.020437,74.125.200.0-255,1484,240527,76,364623
14589,0.022711,74.125.200.0-255,4320,244847,76,364623
14590,0.022717,172.31.40.0-255,66,244913,76,364623
14591,0.025038,74.125.200.0-255,5738,250651,76,364623
14592,0.025975,172.31.40.0-255,66,250717,76,364623
14593,0.028295,74.125.200.0-255,5738,256455,76,364623
14594,0.028303,172.31.40.0-255,66,256521,76,364623
14595,0.030622,74.125.200.0-255,5738,262259,76,364623
14596,0.030628,172.31.40.0-255,66,262325,76,364623
14597,0.032945,74.125.200.0-255,5738,268063,76,364623
14598,0.032951,172.31.40.0-255,66,268129,76,364623
14599,0.035264,74.125.200.0-255,5738,273867,76,364623
14600,0.03527,172.31.40.0-255,66,273933,76,364623
14601,0.037578,74.125.200.0-255,5738,279671,76,364623
14602,0.037584,172.31.40.0-255,66,279737,76,364623
14603,0.037742,172.31.40.0-255,172,279909,76,364623
14604,0.037771,172.31.40.0-255,1104,281013,76,364623
14605,0.037829,172.31.40.0-255,1514,282527,76,364623
14606,0.037831,172.31.40.0-255,345,282872,76,364623
14607,0.03988,104.244.42.0-255,66,282938,76,364623
14608,0.039892,74.125.200.0-255,5738,288676,76,364623
14609,0.039896,172.31.40.0-255,66,288742,76,364623
14610,0.04221,74.125.200.0-255,5738,294480,76,364623
14611,0.042216,172.31.40.0-255,66,294546,76,364623
14612,0.044538,74.125.200.0-255,5738,300284,76,364623
14613,0.044545,172.31.40.0-255,66,300350,76,364623
14614,0.046881,74.125.200.0-255,5738,306088,76,364623
14615,0.046901,172.31.40.0-255,66,306154,76,364623
14616,0.04925,74.125.200.0-255,5738,311892,76,364623
14617,0.049261,172.31.40.0-255,66,311958,76,364623
14618,0.051583,74.125.200.0-255,5738,317696,76,364623
14619,0.051589,172.31.40.0-255,66,317762,76,364623
14620,0.053919,74.125.200.0-255,5738,323500,76,364623
14621,0.053926,172.31.40.0-255,66,323566,76,364623
14622,0.056232,74.125.200.0-255,5738,329304,76,364623
14623,0.056239,172.31.40.0-255,66,329370,76,364623
14624,0.058601,74.125.200.0-255,5738,335108,76,364623
14625,0.058609,172.31.40.0-255,66,335174,76,364623
14626,0.060915,74.125.200.0-255,4320,339494,76,364623
14627,0.060922,172.31.40.0-255,66,339560,76,364623
14628,0.060949,74.125.200.0-255,1484,341044,76,364623
14629,0.063229,74.125.200.0-255,4320,345364,76,364623
14630,0.063235,172.31.40.0-255,66,345430,76,364623
14631,0.065536,74.125.200.0-255,2902,348332,76,364623
14632,0.065544,172.31.40.0-255,66,348398,76,364623
14633,0.065563,74.125.200.0-255,2902,351300,76,364623
14634,0.066083,172.31.40.0-255,66,351366,76,364623
14635,0.067868,74.125.200.0-255,2902,354268,76,364623
14636,0.067875,172.31.40.0-255,66,354334,76,364623
14637,0.068402,74.125.200.0-255,2902,357236,76,364623
14638,0.068409,172.31.40.0-255,66,357302,76,364623
14639,0.070189,74.125.200.0-255,2902,360204,76,364623
14640,0.070195,172.31.40.0-255,66,360270,76,364623
14641,0.070719,74.125.200.0-255,2902,363172,76,364623
14642,0.070726,172.31.40.0-255,66,363238,76,364623
14643,0.072495,74.125.200.0-255,1148,364386,76,364623
14644,0.072711,172.31.40.0-255,66,364452,76,364623
14645,0.07275,172.31.40.0-255,105,364557,76,364623
14646,0.075028,74.125.200.0-255,66,364623,76,364623
14647,0.0,74.125.24.0-255,150,150,76,342122
14648,2.4e-05,172.31.40.0-255,66,216,76,342122
14649,3.1e-05,74.125.24.0-255,1484,1700,76,342122
14650,3.6e-05,172.31.40.0-255,66,1766,76,342122
14651,4.2e-05,74.125.24.0-255,2902,4668,76,342122
14652,4.6e-05,172.31.40.0-255,66,4734,76,342122
14653,6.6e-05,74.125.24.0-255,2902,7636,76,342122
14654,6.9e-05,172.31.40.0-255,66,7702,76,342122
14655,9.1e-05,74.125.24.0-255,2902,10604,76,342122
14656,9.4e-05,172.31.40.0-255,66,10670,76,342122
14657,0.0001,74.125.24.0-255,5738,16408,76,342122
14658,0.000103,172.31.40.0-255,66,16474,76,342122
14659,0.000123,74.125.24.0-255,4936,21410,76,342122
14660,0.000126,172.31.40.0-255,66,21476,76,342122
14661,0.000144,74.125.24.0-255,4320,25796,76,342122
14662,0.000146,172.31.40.0-255,66,25862,76,342122
14663,0.000164,74.125.24.0-255,5379,31241,76,342122
14664,0.000167,172.31.40.0-255,66,31307,76,342122
14665,0.00052,74.125.24.0-255,1484,32791,76,342122
14666,0.000526,172.31.40.0-255,66,32857,76,342122
14667,0.000532,74.125.24.0-255,2902,35759,76,342122
14668,0.000535,172.31.40.0-255,66,35825,76,342122
14669,0.000541,74.125.24.0-255,5738,41563,76,342122
14670,0.000544,172.31.40.0-255,66,41629,76,342122
14671,0.000547,74.125.24.0-255,1484,43113,76,342122
14672,0.000549,172.31.40.0-255,66,43179,76,342122
14673,0.000583,172.31.40.0-255,66,43245,76,342122
14674,0.00061,172.31.40.0-255,66,43311,76,342122
14675,0.000631,74.125.24.0-255,2184,45495,76,342122
14676,0.000633,172.31.40.0-255,66,45561,76,342122
14677,0.000636,74.125.24.0-255,444,46005,76,342122
14678,0.000731,74.125.24.0-255,1484,47489,76,342122
14679,0.000736,172.31.40.0-255,66,47555,76,342122
14680,0.000749,74.125.24.0-255,2902,50457,76,342122
14681,0.000752,172.31.40.0-255,66,50523,76,342122
14682,0.000756,74.125.24.0-255,2902,53425,76,342122
14683,0.000758,172.31.40.0-255,66,53491,76,342122
14684,0.000783,74.125.24.0-255,2902,56393,76,342122
14685,0.000785,172.31.40.0-255,66,56459,76,342122
14686,0.000794,74.125.24.0-255,7156,63615,76,342122
14687,0.000796,172.31.40.0-255,66,63681,76,342122
14688,0.000823,74.125.24.0-255,5738,69419,76,342122
14689,0.000827,172.31.40.0-255,66,69485,76,342122
14690,0.000834,74.125.24.0-255,5738,75223,76,342122
14691,0.000836,172.31.40.0-255,66,75289,76,342122
14692,0.00086,74.125.24.0-255,5020,80309,76,342122
14693,0.000864,172.31.40.0-255,66,80375,76,342122
14694,0.001571,74.125.24.0-255,1484,81859,76,342122
14695,0.001581,74.125.24.0-255,2902,84761,76,342122
14696,0.001586,172.31.40.0-255,66,84827,76,342122
14697,0.001593,74.125.24.0-255,5738,90565,76,342122
14698,0.001595,172.31.40.0-255,66,90631,76,342122
14699,0.00162,74.125.24.0-255,1484,92115,76,342122
14700,0.001657,172.31.40.0-255,66,92181,76,342122
14701,0.001671,172.31.40.0-255,66,92247,76,342122
14702,0.002348,74.125.24.0-255,1484,93731,76,342122
14703,0.002354,74.125.24.0-255,1484,95215,76,342122
14704,0.002359,172.31.40.0-255,66,95281,76,342122
14705,0.003993,74.125.24.0-255,2902,98183,76,342122
14706,0.003997,172.31.40.0-255,66,98249,76,342122
14707,0.004691,74.125.24.0-255,2902,101151,76,342122
14708,0.004695,172.31.40.0-255,66,101217,76,342122
14709,0.00638,74.125.24.0-255,1484,102701,76,342122
14710,0.006396,74.125.24.0-255,1484,104185,76,342122
14711,0.006398,172.31.40.0-255,66,104251,76,342122
14712,0.007017,74.125.24.0-255,2902,107153,76,342122
14713,0.007024,172.31.40.0-255,66,107219,76,342122
14714,0.008727,74.125.24.0-255,2902,110121,76,342122
14715,0.008735,172.31.40.0-255,66,110187,76,342122
14716,0.009362,74.125.24.0-255,2902,113089,76,342122
14717,0.00937,172.31.40.0-255,66,113155,76,342122
14718,0.011081,74.125.24.0-255,2902,116057,76,342122
14719,0.011089,172.31.40.0-255,66,116123,76,342122
14720,0.011686,74.125.24.0-255,2902,119025,76,342122
14721,0.011692,172.31.40.0-255,66,119091,76,342122
14722,0.013411,74.125.24.0-255,2902,121993,76,342122
14723,0.013418,172.31.40.0-255,66,122059,76,342122
14724,0.01401,74.125.24.0-255,2902,124961,76,342122
14725,0.014017,172.31.40.0-255,66,125027,76,342122
14726,0.015762,74.125.24.0-255,2902,127929,76,342122
14727,0.015769,172.31.40.0-255,66,127995,76,342122
14728,0.016364,74.125.24.0-255,2902,130897,76,342122
14729,0.016369,172.31.40.0-255,66,130963,76,342122
14730,0.018097,74.125.24.0-255,2902,133865,76,342122
14731,0.018105,172.31.40.0-255,66,133931,76,342122
14732,0.018693,74.125.24.0-255,2902,136833,76,342122
14733,0.0187,172.31.40.0-255,66,136899,76,342122
14734,0.020455,74.125.24.0-255,2902,139801,76,342122
14735,0.020462,172.31.40.0-255,66,139867,76,342122
14736,0.021023,74.125.24.0-255,2902,142769,76,342122
14737,0.02103,172.31.40.0-255,66,142835,76,342122
14738,0.022815,74.125.24.0-255,2902,145737,76,342122
14739,0.022821,172.31.40.0-255,66,145803,76,342122
14740,0.023388,74.125.24.0-255,2902,148705,76,342122
14741,0.023394,172.31.40.0-255,66,148771,76,342122
14742,0.023878,172.31.40.0-255,172,148943,76,342122
14743,0.02391,172.31.40.0-255,1104,150047,76,342122
14744,0.023971,172.31.40.0-255,1514,151561,76,342122
14745,0.023973,172.31.40.0-255,345,151906,76,342122
14746,0.025143,74.125.24.0-255,2902,154808,76,342122
14747,0.025149,172.31.40.0-255,66,154874,76,342122
14748,0.025457,104.244.42.0-255,66,154940,76,342122
14749,0.025485,104.244.42.0-255,66,155006,76,342122
14750,0.025534,104.244.42.0-255,66,155072,76,342122
14751,0.025739,74.125.24.0-255,2902,157974,76,342122
14752,0.025745,172.31.40.0-255,66,158040,76,342122
14753,0.027561,74.125.24.0-255,2902,160942,76,342122
14754,0.027568,172.31.40.0-255,66,161008,76,342122
14755,0.028093,74.125.24.0-255,2902,163910,76,342122
14756,0.0281,172.31.40.0-255,66,163976,76,342122
14757,0.029895,74.125.24.0-255,2902,166878,76,342122
14758,0.029901,172.31.40.0-255,66,166944,76,342122
14759,0.030434,74.125.24.0-255,2902,169846,76,342122
14760,0.030441,172.31.40.0-255,66,169912,76,342122
14761,0.032245,74.125.24.0-255,2902,172814,76,342122
14762,0.03225,172.31.40.0-255,66,172880,76,342122
14763,0.032764,74.125.24.0-255,2902,175782,76,342122
14764,0.03277,172.31.40.0-255,66,175848,76,342122
14765,0.034597,74.125.24.0-255,2902,178750,76,342122
14766,0.034602,172.31.40.0-255,66,178816,76,342122
14767,0.03508,74.125.24.0-255,2902,181718,76,342122
14768,0.035085,172.31.40.0-255,66,181784,76,342122
14769,0.036976,74.125.24.0-255,2902,184686,76,342122
14770,0.036983,172.31.40.0-255,66,184752,76,342122
14771,0.037442,74.125.24.0-255,2902,187654,76,342122
14772,0.037448,172.31.40.0-255,66,187720,76,342122
14773,0.039333,74.125.24.0-255,2902,190622,76,342122
14774,0.039339,172.31.40.0-255,66,190688,76,342122
14775,0.039775,74.125.24.0-255,2902,193590,76,342122
14776,0.039782,172.31.40.0-255,66,193656,76,342122
14777,0.041643,74.125.24.0-255,2902,196558,76,342122
14778,0.041649,172.31.40.0-255,66,196624,76,342122
14779,0.042124,74.125.24.0-255,2902,199526,76,342122
14780,0.042131,172.31.40.0-255,66,199592,76,342122
14781,0.043973,74.125.24.0-255,2902,202494,76,342122
14782,0.04398,172.31.40.0-255,66,202560,76,342122
14783,0.044474,74.125.24.0-255,2902,205462,76,342122
14784,0.044479,172.31.40.0-255,66,205528,76,342122
14785,0.046311,74.125.24.0-255,1484,207012,76,342122
14786,0.046336,74.125.24.0-255,1484,208496,76,342122
14787,0.046342,172.31.40.0-255,66,208562,76,342122
14788,0.046783,74.125.24.0-255,2902,211464,76,342122
14789,0.04679,172.31.40.0-255,66,211530,76,342122
14790,0.048726,74.125.24.0-255,2902,214432,76,342122
14791,0.048747,172.31.40.0-255,66,214498,76,342122
14792,0.049122,74.125.24.0-255,2902,217400,76,342122
14793,0.049128,172.31.40.0-255,66,217466,76,342122
14794,0.051079,74.125.24.0-255,2902,220368,76,342122
14795,0.051093,172.31.40.0-255,66,220434,76,342122
14796,0.051463,74.125.24.0-255,2902,223336,76,342122
14797,0.051469,172.31.40.0-255,66,223402,76,342122
14798,0.053426,74.125.24.0-255,2902,226304,76,342122
14799,0.053443,172.31.40.0-255,66,226370,76,342122
14800,0.05381,74.125.24.0-255,2902,229272,76,342122
14801,0.053817,172.31.40.0-255,66,229338,76,342122
14802,0.055811,74.125.24.0-255,2902,232240,76,342122
14803,0.055828,172.31.40.0-255,66,232306,76,342122
14804,0.056177,74.125.24.0-255,2902,235208,76,342122
14805,0.056185,172.31.40.0-255,66,235274,76,342122
14806,0.058161,74.125.24.0-255,2902,238176,76,342122
14807,0.058169,172.31.40.0-255,66,238242,76,342122
14808,0.058513,74.125.24.0-255,2902,241144,76,342122
14809,0.05852,172.31.40.0-255,66,241210,76,342122
14810,0.060506,74.125.24.0-255,2902,244112,76,342122
14811,0.060523,172.31.40.0-255,66,244178,76,342122
14812,0.060872,74.125.24.0-255,2902,247080,76,342122
14813,0.060878,172.31.40.0-255,66,247146,76,342122
14814,0.062865,74.125.24.0-255,2902,250048,76,342122
14815,0.062878,172.31.40.0-255,66,250114,76,342122
14816,0.063199,74.125.24.0-255,2902,253016,76,342122
14817,0.063205,172.31.40.0-255,66,253082,76,342122
14818,0.065235,74.125.24.0-255,2902,255984,76,342122
14819,0.065243,172.31.40.0-255,66,256050,76,342122
14820,0.065566,74.125.24.0-255,2902,258952,76,342122
14821,0.065573,172.31.40.0-255,66,259018,76,342122
14822,0.067575,74.125.24.0-255,2902,261920,76,342122
14823,0.067581,172.31.40.0-255,66,261986,76,342122
14824,0.067956,74.125.24.0-255,2902,264888,76,342122
14825,0.067962,172.31.40.0-255,66,264954,76,342122
14826,0.069922,74.125.24.0-255,2902,267856,76,342122
14827,0.069931,172.31.40.0-255,66,267922,76,342122
14828,0.070302,74.125.24.0-255,2902,270824,76,342122
14829,0.070308,172.31.40.0-255,66,270890,76,342122
14830,0.072296,74.125.24.0-255,2902,273792,76,342122
14831,0.072304,172.31.40.0-255,66,273858,76,342122
14832,0.072689,74.125.24.0-255,2902,276760,76,342122
14833,0.072695,172.31.40.0-255,66,276826,76,342122
14834,0.074633,74.125.24.0-255,2902,279728,76,342122
14835,0.07464,172.31.40.0-255,66,279794,76,342122
14836,0.075076,74.125.24.0-255,2902,282696,76,342122
14837,0.075082,172.31.40.0-255,66,282762,76,342122
14838,0.077027,74.125.24.0-255,2902,285664,76,342122
14839,0.077034,172.31.40.0-255,66,285730,76,342122
14840,0.077472,74.125.24.0-255,2902,288632,76,342122
14841,0.077478,172.31.40.0-255,66,288698,76,342122
14842,0.079394,74.125.24.0-255,2902,291600,76,342122
14843,0.0794,172.31.40.0-255,66,291666,76,342122
14844,0.079827,74.125.24.0-255,2902,294568,76,342122
14845,0.079834,172.31.40.0-255,66,294634,76,342122
14846,0.081721,74.125.24.0-255,2902,297536,76,342122
14847,0.081728,172.31.40.0-255,66,297602,76,342122
14848,0.082161,74.125.24.0-255,2902,300504,76,342122
14849,0.082168,172.31.40.0-255,66,300570,76,342122
14850,0.084056,74.125.24.0-255,2902,303472,76,342122
14851,0.084062,172.31.40.0-255,66,303538,76,342122
14852,0.084538,74.125.24.0-255,2902,306440,76,342122
14853,0.084545,172.31.40.0-255,66,306506,76,342122
14854,0.086379,74.125.24.0-255,2902,309408,76,342122
14855,0.086389,172.31.40.0-255,66,309474,76,342122
14856,0.086903,74.125.24.0-255,2902,312376,76,342122
14857,0.086909,172.31.40.0-255,66,312442,76,342122
14858,0.088736,74.125.24.0-255,2902,315344,76,342122
14859,0.088742,172.31.40.0-255,66,315410,76,342122
14860,0.089254,74.125.24.0-255,2902,318312,76,342122
14861,0.08926,172.31.40.0-255,66,318378,76,342122
14862,0.091115,74.125.24.0-255,2902,321280,76,342122
14863,0.091126,172.31.40.0-255,66,321346,76,342122
14864,0.091603,74.125.24.0-255,2902,324248,76,342122
14865,0.09161,172.31.40.0-255,66,324314,76,342122
14866,0.093468,74.125.24.0-255,2902,327216,76,342122
14867,0.093477,172.31.40.0-255,66,327282,76,342122
14868,0.093935,74.125.24.0-255,2902,330184,76,342122
14869,0.093942,172.31.40.0-255,66,330250,76,342122
14870,0.095797,74.125.24.0-255,2902,333152,76,342122
14871,0.095803,172.31.40.0-255,66,333218,76,342122
14872,0.09629,74.125.24.0-255,2902,336120,76,342122
14873,0.096297,172.31.40.0-255,66,336186,76,342122
14874,0.098159,74.125.24.0-255,2902,339088,76,342122
14875,0.098166,172.31.40.0-255,66,339154,76,342122
14876,0.098635,74.125.24.0-255,2902,342056,76,342122
14877,0.098641,172.31.40.0-255,66,342122,76,342122
14878,0.0,74.125.130.0-255,150,150,76,407637
14879,2.5e-05,172.31.40.0-255,66,216,76,407637
14880,6.7e-05,74.125.130.0-255,1484,1700,76,407637
14881,7.1e-05,172.31.40.0-255,66,1766,76,407637
14882,7.5e-05,74.125.130.0-255,1484,3250,76,407637
14883,7.8e-05,172.31.40.0-255,66,3316,76,407637
14884,9.2e-05,74.125.130.0-255,1484,4800,76,407637
14885,9.4e-05,172.31.40.0-255,66,4866,76,407637
14886,9.8e-05,74.125.130.0-255,1484,6350,76,407637
14887,0.0001,172.31.40.0-255,66,6416,76,407637
14888,0.000126,74.125.130.0-255,2902,9318,76,407637
14889,0.000128,172.31.40.0-255,66,9384,76,407637
14890,0.000167,74.125.130.0-255,4828,14212,76,407637
14891,0.00017,172.31.40.0-255,66,14278,76,407637
14892,0.000229,74.125.130.0-255,5738,20016,76,407637
14893,0.000232,172.31.40.0-255,66,20082,76,407637
14894,0.000235,74.125.130.0-255,1484,21566,76,407637
14895,0.000237,172.31.40.0-255,66,21632,76,407637
14896,0.000242,74.125.130.0-255,2902,24534,76,407637
14897,0.000245,172.31.40.0-255,66,24600,76,407637
14898,0.00026,74.125.130.0-255,5738,30338,76,407637
14899,0.000263,172.31.40.0-255,66,30404,76,407637
14900,0.000265,74.125.130.0-255,1125,31529,76,407637
14901,0.000268,172.31.40.0-255,66,31595,76,407637
14902,0.000617,74.125.130.0-255,1484,33079,76,407637
14903,0.000626,172.31.40.0-255,66,33145,76,407637
14904,0.000648,74.125.130.0-255,2902,36047,76,407637
14905,0.000651,172.31.40.0-255,66,36113,76,407637
14906,0.000694,74.125.130.0-255,1484,37597,76,407637
14907,0.000696,172.31.40.0-255,66,37663,76,407637
14908,0.000721,74.125.130.0-255,2902,40565,76,407637
14909,0.000724,172.31.40.0-255,66,40631,76,407637
14910,0.000727,74.125.130.0-255,1484,42115,76,407637
14911,0.000731,74.125.130.0-255,1484,43599,76,407637
14912,0.000733,172.31.40.0-255,66,43665,76,407637
14913,0.000752,74.125.130.0-255,1484,45149,76,407637
14914,0.000757,74.125.130.0-255,3961,49110,76,407637
14915,0.00076,172.31.40.0-255,66,49176,76,407637
14916,0.000796,74.125.130.0-255,4320,53496,76,407637
14917,0.000799,172.31.40.0-255,66,53562,76,407637
14918,0.000802,74.125.130.0-255,1484,55046,76,407637
14919,0.000835,74.125.130.0-255,2902,57948,76,407637
14920,0.000837,172.31.40.0-255,66,58014,76,407637
14921,0.00086,74.125.130.0-255,5738,63752,76,407637
14922,0.000863,172.31.40.0-255,66,63818,76,407637
14923,0.000915,74.125.130.0-255,2834,66652,76,407637
14924,0.000925,172.31.40.0-255,66,66718,76,407637
14925,0.000943,74.125.130.0-255,98,66816,76,407637
14926,0.001195,74.125.130.0-255,1484,68300,76,407637
14927,0.001199,172.31.40.0-255,66,68366,76,407637
14928,0.001214,74.125.130.0-255,1484,69850,76,407637
14929,0.00123,74.125.130.0-255,1484,71334,76,407637
14930,0.001232,172.31.40.0-255,66,71400,76,407637
14931,0.001251,74.125.130.0-255,1484,72884,76,407637
14932,0.001269,74.125.130.0-255,4320,77204,76,407637
14933,0.001272,172.31.40.0-255,66,77270,76,407637
14934,0.001292,74.125.130.0-255,4320,81590,76,407637
14935,0.001296,172.31.40.0-255,66,81656,76,407637
14936,0.001304,74.125.130.0-255,1484,83140,76,407637
14937,0.001316,74.125.130.0-255,1484,84624,76,407637
14938,0.001318,172.31.40.0-255,66,84690,76,407637
14939,0.00133,74.125.130.0-255,1484,86174,76,407637
14940,0.001354,74.125.130.0-255,4320,90494,76,407637
14941,0.001356,172.31.40.0-255,66,90560,76,407637
14942,0.001375,74.125.130.0-255,1484,92044,76,407637
14943,0.001392,74.125.130.0-255,2902,94946,76,407637
14944,0.001395,172.31.40.0-255,66,95012,76,407637
14945,0.001413,74.125.130.0-255,1484,96496,76,407637
14946,0.001441,74.125.130.0-255,2902,99398,76,407637
14947,0.001444,172.31.40.0-255,66,99464,76,407637
14948,0.001481,74.125.130.0-255,2184,101648,76,407637
14949,0.001484,172.31.40.0-255,66,101714,76,407637
14950,0.001488,74.125.130.0-255,363,102077,76,407637
14951,0.001762,172.31.40.0-255,66,102143,76,407637
14952,0.001832,74.125.130.0-255,1484,103627,76,407637
14953,0.00185,74.125.130.0-255,2902,106529,76,407637
14954,0.001853,172.31.40.0-255,66,106595,76,407637
14955,0.001879,74.125.130.0-255,5738,112333,76,407637
14956,0.001881,172.31.40.0-255,66,112399,76,407637
14957,0.001886,74.125.130.0-255,2902,115301,76,407637
14958,0.001888,172.31.40.0-255,66,115367,76,407637
14959,0.001905,74.125.130.0-255,4320,119687,76,407637
14960,0.001907,172.31.40.0-255,66,119753,76,407637
14961,0.001924,74.125.130.0-255,4320,124073,76,407637
14962,0.001926,172.31.40.0-255,66,124139,76,407637
14963,0.001955,172.31.40.0-255,66,124205,76,407637
14964,0.001971,74.125.130.0-255,3602,127807,76,407637
14965,0.001974,172.31.40.0-255,66,127873,76,407637
14966,0.002022,74.125.130.0-255,1484,129357,76,407637
14967,0.002035,74.125.130.0-255,2902,132259,76,407637
14968,0.002038,172.31.40.0-255,66,132325,76,407637
14969,0.002044,74.125.130.0-255,4320,136645,76,407637
14970,0.002046,172.31.40.0-255,66,136711,76,407637
14971,0.002057,74.125.130.0-255,1484,138195,76,407637
14972,0.00208,172.31.40.0-255,66,138261,76,407637
14973,0.002101,74.125.130.0-255,1484,139745,76,407637
14974,0.002109,74.125.130.0-255,7156,146901,76,407637
14975,0.002111,172.31.40.0-255,66,146967,76,407637
14976,0.002137,74.125.130.0-255,4320,151287,76,407637
14977,0.002142,74.125.130.0-255,2184,153471,76,407637
14978,0.002145,172.31.40.0-255,66,153537,76,407637
14979,0.002148,172.31.40.0-255,66,153603,76,407637
14980,0.00218,74.125.130.0-255,1484,155087,76,407637
14981,0.002196,74.125.130.0-255,1484,156571,76,407637
14982,0.002199,172.31.40.0-255,66,156637,76,407637
14983,0.00222,74.125.130.0-255,1484,158121,76,407637
14984,0.002227,74.125.130.0-255,5738,163859,76,407637
14985,0.00223,172.31.40.0-255,66,163925,76,407637
14986,0.002235,74.125.130.0-255,2902,166827,76,407637
14987,0.002237,172.31.40.0-255,66,166893,76,407637
14988,0.002242,74.125.130.0-255,4320,171213,76,407637
14989,0.002245,172.31.40.0-255,66,171279,76,407637
14990,0.002248,74.125.130.0-255,1484,172763,76,407637
14991,0.002272,74.125.130.0-255,7156,179919,76,407637
14992,0.002275,172.31.40.0-255,66,179985,76,407637
14993,0.002278,74.125.130.0-255,1484,181469,76,407637
14994,0.00233,74.125.130.0-255,2902,184371,76,407637
14995,0.002333,172.31.40.0-255,66,184437,76,407637
14996,0.002338,74.125.130.0-255,3602,188039,76,407637
14997,0.002341,172.31.40.0-255,66,188105,76,407637
14998,0.004625,74.125.130.0-255,5738,193843,76,407637
14999,0.004642,172.31.40.0-255,66,193909,76,407637
15000,0.006918,74.125.130.0-255,5738,199647,76,407637
15001,0.006925,172.31.40.0-255,66,199713,76,407637
15002,0.009204,74.125.130.0-255,5738,205451,76,407637
15003,0.009215,172.31.40.0-255,66,205517,76,407637
15004,0.0115,74.125.130.0-255,5738,211255,76,407637
15005,0.011514,172.31.40.0-255,66,211321,76,407637
15006,0.013809,74.125.130.0-255,5738,217059,76,407637
15007,0.013827,172.31.40.0-255,66,217125,76,407637
15008,0.016115,74.125.130.0-255,5738,222863,76,407637
15009,0.016126,172.31.40.0-255,66,222929,76,407637
15010,0.018426,74.125.130.0-255,5738,228667,76,407637
15011,0.018441,172.31.40.0-255,66,228733,76,407637
15012,0.020728,74.125.130.0-255,5738,234471,76,407637
15013,0.020741,172.31.40.0-255,66,234537,76,407637
15014,0.023028,74.125.130.0-255,5738,240275,76,407637
15015,0.023041,172.31.40.0-255,66,240341,76,407637
15016,0.025337,74.125.130.0-255,5738,246079,76,407637
15017,0.025349,172.31.40.0-255,66,246145,76,407637
15018,0.027642,74.125.130.0-255,5738,251883,76,407637
15019,0.027655,172.31.40.0-255,66,251949,76,407637
15020,0.029698,172.31.40.0-255,172,252121,76,407637
15021,0.029735,172.31.40.0-255,1109,253230,76,407637
15022,0.029795,172.31.40.0-255,1514,254744,76,407637
15023,0.029796,172.31.40.0-255,338,255082,76,407637
15024,0.029945,74.125.130.0-255,5738,260820,76,407637
15025,0.029953,172.31.40.0-255,66,260886,76,407637
15026,0.031262,104.244.42.0-255,66,260952,76,407637
15027,0.031307,104.244.42.0-255,66,261018,76,407637
15028,0.031347,104.244.42.0-255,66,261084,76,407637
15029,0.032235,74.125.130.0-255,5738,266822,76,407637
15030,0.032244,172.31.40.0-255,66,266888,76,407637
15031,0.034538,74.125.130.0-255,5738,272626,76,407637
15032,0.034547,172.31.40.0-255,66,272692,76,407637
15033,0.036832,74.125.130.0-255,5738,278430,76,407637
15034,0.036842,172.31.40.0-255,66,278496,76,407637
15035,0.039139,74.125.130.0-255,5738,284234,76,407637
15036,0.039155,172.31.40.0-255,66,284300,76,407637
15037,0.041454,74.125.130.0-255,5738,290038,76,407637
15038,0.041465,172.31.40.0-255,66,290104,76,407637
15039,0.043772,74.125.130.0-255,5738,295842,76,407637
15040,0.04378,172.31.40.0-255,66,295908,76,407637
15041,0.046066,74.125.130.0-255,5738,301646,76,407637
15042,0.046075,172.31.40.0-255,66,301712,76,407637
15043,0.048356,74.125.130.0-255,5738,307450,76,407637
15044,0.048364,172.31.40.0-255,66,307516,76,407637
15045,0.05066,74.125.130.0-255,5738,313254,76,407637
15046,0.050671,172.31.40.0-255,66,313320,76,407637
15047,0.052965,74.125.130.0-255,5738,319058,76,407637
15048,0.052976,172.31.40.0-255,66,319124,76,407637
15049,0.05528,74.125.130.0-255,5738,324862,76,407637
15050,0.055297,172.31.40.0-255,66,324928,76,407637
15051,0.057588,74.125.130.0-255,5738,330666,76,407637
15052,0.057598,172.31.40.0-255,66,330732,76,407637
15053,0.059884,74.125.130.0-255,5738,336470,76,407637
15054,0.059893,172.31.40.0-255,66,336536,76,407637
15055,0.062178,74.125.130.0-255,5738,342274,76,407637
15056,0.062185,172.31.40.0-255,66,342340,76,407637
15057,0.064466,74.125.130.0-255,5738,348078,76,407637
15058,0.064472,172.31.40.0-255,66,348144,76,407637
15059,0.066757,74.125.130.0-255,5738,353882,76,407637
15060,0.066764,172.31.40.0-255,66,353948,76,407637
15061,0.069043,74.125.130.0-255,5738,359686,76,407637
15062,0.06905,172.31.40.0-255,66,359752,76,407637
15063,0.071337,74.125.130.0-255,5738,365490,76,407637
15064,0.071348,172.31.40.0-255,66,365556,76,407637
15065,0.073683,74.125.130.0-255,5738,371294,76,407637
15066,0.073696,172.31.40.0-255,66,371360,76,407637
15067,0.075976,74.125.130.0-255,5738,377098,76,407637
15068,0.075993,172.31.40.0-255,66,377164,76,407637
15069,0.078279,74.125.130.0-255,5738,382902,76,407637
15070,0.078286,172.31.40.0-255,66,382968,76,407637
15071,0.080585,74.125.130.0-255,5738,388706,76,407637
15072,0.080591,172.31.40.0-255,66,388772,76,407637
15073,0.082872,74.125.130.0-255,5738,394510,76,407637
15074,0.082884,172.31.40.0-255,66,394576,76,407637
15075,0.085185,74.125.130.0-255,5738,400314,76,407637
15076,0.085202,172.31.40.0-255,66,400380,76,407637
15077,0.087487,74.125.130.0-255,5738,406118,76,407637
15078,0.087496,172.31.40.0-255,66,406184,76,407637
15079,0.089787,74.125.130.0-255,1216,407400,76,407637
15080,0.09005,172.31.40.0-255,66,407466,76,407637
15081,0.090095,172.31.40.0-255,105,407571,76,407637
15082,0.092345,74.125.130.0-255,66,407637,76,407637
15083,0.0,172.217.194.0-255,152,152,76,362409
15084,1.6e-05,172.31.40.0-255,66,218,76,362409
15085,2.3e-05,172.217.194.0-255,1484,1702,76,362409
15086,2.8e-05,172.31.40.0-255,66,1768,76,362409
15087,3.4e-05,172.217.194.0-255,2902,4670,76,362409
15088,3.8e-05,172.31.40.0-255,66,4736,76,362409
15089,5.5e-05,172.217.194.0-255,7156,11892,76,362409
15090,5.8e-05,172.31.40.0-255,66,11958,76,362409
15091,6.2e-05,172.217.194.0-255,2137,14095,76,362409
15092,6.5e-05,172.31.40.0-255,66,14161,76,362409
15093,0.000284,172.217.194.0-255,1484,15645,76,362409
15094,0.00029,172.31.40.0-255,66,15711,76,362409
15095,0.000295,172.217.194.0-255,2902,18613,76,362409
15096,0.000299,172.31.40.0-255,66,18679,76,362409
15097,0.000304,172.217.194.0-255,2902,21581,76,362409
15098,0.00031,172.31.40.0-255,66,21647,76,362409
15099,0.000345,172.217.194.0-255,2902,24549,76,362409
15100,0.000348,172.31.40.0-255,66,24615,76,362409
15101,0.000356,172.217.194.0-255,6797,31412,76,362409
15102,0.000358,172.31.40.0-255,66,31478,76,362409
15103,0.00053,172.217.194.0-255,1484,32962,76,362409
15104,0.000534,172.31.40.0-255,66,33028,76,362409
15105,0.00054,172.217.194.0-255,2902,35930,76,362409
15106,0.000543,172.31.40.0-255,66,35996,76,362409
15107,0.000576,172.217.194.0-255,5738,41734,76,362409
15108,0.000584,172.217.194.0-255,6797,48531,76,362409
15109,0.000588,172.31.40.0-255,66,48597,76,362409
15110,0.000594,172.31.40.0-255,66,48663,76,362409
15111,0.0006,172.217.194.0-255,4320,52983,76,362409
15112,0.000602,172.31.40.0-255,66,53049,76,362409
15113,0.000638,172.217.194.0-255,3123,56172,76,362409
15114,0.000643,172.31.40.0-255,66,56238,76,362409
15115,0.000645,172.31.40.0-255,66,56304,76,362409
15116,0.000989,172.217.194.0-255,1484,57788,76,362409
15117,0.000996,172.217.194.0-255,2902,60690,76,362409
15118,0.001,172.31.40.0-255,66,60756,76,362409
15119,0.001035,172.217.194.0-255,5738,66494,76,362409
15120,0.001038,172.31.40.0-255,66,66560,76,362409
15121,0.001054,172.31.40.0-255,66,66626,76,362409
15122,0.001101,172.217.194.0-255,7156,73782,76,362409
15123,0.001104,172.31.40.0-255,66,73848,76,362409
15124,0.001132,172.217.194.0-255,6438,80286,76,362409
15125,0.001134,172.31.40.0-255,66,80352,76,362409
15126,0.002009,172.217.194.0-255,1484,81836,76,362409
15127,0.003117,172.217.194.0-255,4320,86156,76,362409
15128,0.003122,172.31.40.0-255,66,86222,76,362409
15129,0.005098,172.217.194.0-255,1484,87706,76,362409
15130,0.005115,172.217.194.0-255,4320,92026,76,362409
15131,0.005118,172.31.40.0-255,66,92092,76,362409
15132,0.007109,172.217.194.0-255,5738,97830,76,362409
15133,0.007115,172.31.40.0-255,66,97896,76,362409
15134,0.009124,172.217.194.0-255,5738,103634,76,362409
15135,0.00913,172.31.40.0-255,66,103700,76,362409
15136,0.011142,172.217.194.0-255,5738,109438,76,362409
15137,0.011149,172.31.40.0-255,66,109504,76,362409
15138,0.013162,172.217.194.0-255,5738,115242,76,362409
15139,0.01317,172.31.40.0-255,66,115308,76,362409
15140,0.015218,172.217.194.0-255,5738,121046,76,362409
15141,0.015227,172.31.40.0-255,66,121112,76,362409
15142,0.017263,172.217.194.0-255,5738,126850,76,362409
15143,0.017271,172.31.40.0-255,66,126916,76,362409
15144,0.019296,172.217.194.0-255,5738,132654,76,362409
15145,0.019304,172.31.40.0-255,66,132720,76,362409
15146,0.021304,172.217.194.0-255,5738,138458,76,362409
15147,0.021311,172.31.40.0-255,66,138524,76,362409
15148,0.023306,172.217.194.0-255,5738,144262,76,362409
15149,0.023312,172.31.40.0-255,66,144328,76,362409
15150,0.024045,172.31.40.0-255,172,144500,76,362409
15151,0.024074,172.31.40.0-255,1104,145604,76,362409
15152,0.024126,172.31.40.0-255,1514,147118,76,362409
15153,0.024128,172.31.40.0-255,345,147463,76,362409
15154,0.025314,172.217.194.0-255,5738,153201,76,362409
15155,0.025321,172.31.40.0-255,66,153267,76,362409
15156,0.025624,104.244.42.0-255,66,153333,76,362409
15157,0.025672,104.244.42.0-255,66,153399,76,362409
15158,0.025676,104.244.42.0-255,66,153465,76,362409
15159,0.027365,172.217.194.0-255,5738,159203,76,362409
15160,0.027371,172.31.40.0-255,66,159269,76,362409
15161,0.029481,172.217.194.0-255,5738,165007,76,362409
15162,0.029487,172.31.40.0-255,66,165073,76,362409
15163,0.031537,172.217.194.0-255,5738,170811,76,362409
15164,0.031543,172.31.40.0-255,66,170877,76,362409
15165,0.033531,172.217.194.0-255,5738,176615,76,362409
15166,0.033538,172.31.40.0-255,66,176681,76,362409
15167,0.035559,172.217.194.0-255,5738,182419,76,362409
15168,0.035565,172.31.40.0-255,66,182485,76,362409
15169,0.037584,172.217.194.0-255,5738,188223,76,362409
15170,0.037591,172.31.40.0-255,66,188289,76,362409
15171,0.039619,172.217.194.0-255,5738,194027,76,362409
15172,0.039625,172.31.40.0-255,66,194093,76,362409
15173,0.041626,172.217.194.0-255,5738,199831,76,362409
15174,0.041635,172.31.40.0-255,66,199897,76,362409
15175,0.04368,172.217.194.0-255,5738,205635,76,362409
15176,0.043693,172.31.40.0-255,66,205701,76,362409
15177,0.045748,172.217.194.0-255,5738,211439,76,362409
15178,0.045756,172.31.40.0-255,66,211505,76,362409
15179,0.047787,172.217.194.0-255,5738,217243,76,362409
15180,0.047795,172.31.40.0-255,66,217309,76,362409
15181,0.049813,172.217.194.0-255,5738,223047,76,362409
15182,0.049819,172.31.40.0-255,66,223113,76,362409
15183,0.051815,172.217.194.0-255,5738,228851,76,362409
15184,0.051821,172.31.40.0-255,66,228917,76,362409
15185,0.053851,172.217.194.0-255,5738,234655,76,362409
15186,0.053858,172.31.40.0-255,66,234721,76,362409
15187,0.055875,172.217.194.0-255,5738,240459,76,362409
15188,0.05589,172.31.40.0-255,66,240525,76,362409
15189,0.057931,172.217.194.0-255,5738,246263,76,362409
15190,0.057952,172.31.40.0-255,66,246329,76,362409
15191,0.059979,172.217.194.0-255,5738,252067,76,362409
15192,0.059996,172.31.40.0-255,66,252133,76,362409
15193,0.062017,172.217.194.0-255,5738,257871,76,362409
15194,0.062031,172.31.40.0-255,66,257937,76,362409
15195,0.064079,172.217.194.0-255,5738,263675,76,362409
15196,0.064094,172.31.40.0-255,66,263741,76,362409
15197,0.06613,172.217.194.0-255,5738,269479,76,362409
15198,0.066138,172.31.40.0-255,66,269545,76,362409
15199,0.068165,172.217.194.0-255,5738,275283,76,362409
15200,0.068173,172.31.40.0-255,66,275349,76,362409
15201,0.070216,172.217.194.0-255,5738,281087,76,362409
15202,0.070225,172.31.40.0-255,66,281153,76,362409
15203,0.072243,172.217.194.0-255,5738,286891,76,362409
15204,0.072251,172.31.40.0-255,66,286957,76,362409
15205,0.074301,172.217.194.0-255,5738,292695,76,362409
15206,0.074307,172.31.40.0-255,66,292761,76,362409
15207,0.076338,172.217.194.0-255,5738,298499,76,362409
15208,0.076345,172.31.40.0-255,66,298565,76,362409
15209,0.078432,172.217.194.0-255,5738,304303,76,362409
15210,0.078438,172.31.40.0-255,66,304369,76,362409
15211,0.080494,172.217.194.0-255,5738,310107,76,362409
15212,0.080499,172.31.40.0-255,66,310173,76,362409
15213,0.082505,172.217.194.0-255,5738,315911,76,362409
15214,0.082511,172.31.40.0-255,66,315977,76,362409
15215,0.084537,172.217.194.0-255,5738,321715,76,362409
15216,0.084543,172.31.40.0-255,66,321781,76,362409
15217,0.086572,172.217.194.0-255,5738,327519,76,362409
15218,0.086579,172.31.40.0-255,66,327585,76,362409
15219,0.088583,172.217.194.0-255,5738,333323,76,362409
15220,0.08859,172.31.40.0-255,66,333389,76,362409
15221,0.090592,172.217.194.0-255,5738,339127,76,362409
15222,0.090598,172.31.40.0-255,66,339193,76,362409
15223,0.092605,172.217.194.0-255,5738,344931,76,362409
15224,0.092612,172.31.40.0-255,66,344997,76,362409
15225,0.094653,172.217.194.0-255,5738,350735,76,362409
15226,0.094658,172.31.40.0-255,66,350801,76,362409
15227,0.096658,172.217.194.0-255,5738,356539,76,362409
15228,0.096666,172.31.40.0-255,66,356605,76,362409
15229,0.098677,172.217.194.0-255,5738,362343,76,362409
15230,0.098684,172.31.40.0-255,66,362409,76,362409
15231,0.0,172.217.194.0-255,150,150,76,292183
15232,2.2e-05,172.31.40.0-255,66,216,76,292183
15233,2.8e-05,172.217.194.0-255,1484,1700,76,292183
15234,3.2e-05,172.31.40.0-255,66,1766,76,292183
15235,3.7e-05,172.217.194.0-255,2902,4668,76,292183
15236,4.1e-05,172.31.40.0-255,66,4734,76,292183
15237,4.6e-05,172.217.194.0-255,2902,7636,76,292183
15238,4.9e-05,172.31.40.0-255,66,7702,76,292183
15239,7.2e-05,172.217.194.0-255,4320,12022,76,292183
15240,7.7e-05,172.31.40.0-255,66,12088,76,292183
15241,7.9e-05,172.217.194.0-255,1484,13572,76,292183
15242,8.1e-05,172.31.40.0-255,66,13638,76,292183
15243,0.000111,172.217.194.0-255,7156,20794,76,292183
15244,0.000114,172.31.40.0-255,66,20860,76,292183
15245,0.000136,172.217.194.0-255,6292,27152,76,292183
15246,0.000139,172.31.40.0-255,66,27218,76,292183
15247,0.000144,172.217.194.0-255,3961,31179,76,292183
15248,0.000146,172.31.40.0-255,66,31245,76,292183
15249,0.000162,172.217.194.0-255,1484,32729,76,292183
15250,0.000164,172.31.40.0-255,66,32795,76,292183
15251,0.00019,172.217.194.0-255,2902,35697,76,292183
15252,0.000192,172.31.40.0-255,66,35763,76,292183
15253,0.000197,172.217.194.0-255,4320,40083,76,292183
15254,0.0002,172.31.40.0-255,66,40149,76,292183
15255,0.000202,172.217.194.0-255,1484,41633,76,292183
15256,0.000204,172.31.40.0-255,66,41699,76,292183
15257,0.00024,172.31.40.0-255,66,41765,76,292183
15258,0.000253,172.31.40.0-255,66,41831,76,292183
15259,0.00027,172.217.194.0-255,2184,44015,76,292183
15260,0.000272,172.31.40.0-255,66,44081,76,292183
15261,0.000275,172.217.194.0-255,676,44757,76,292183
15262,0.000555,172.217.194.0-255,1484,46241,76,292183
15263,0.000562,172.31.40.0-255,66,46307,76,292183
15264,0.000567,172.217.194.0-255,2902,49209,76,292183
15265,0.00057,172.31.40.0-255,66,49275,76,292183
15266,0.000575,172.217.194.0-255,5738,55013,76,292183
15267,0.000578,172.31.40.0-255,66,55079,76,292183
15268,0.0006,172.217.194.0-255,1484,56563,76,292183
15269,0.000624,172.31.40.0-255,66,56629,76,292183
15270,0.000641,172.217.194.0-255,1484,58113,76,292183
15271,0.000646,172.217.194.0-255,4320,62433,76,292183
15272,0.000648,172.31.40.0-255,66,62499,76,292183
15273,0.000672,172.217.194.0-255,6438,68937,76,292183
15274,0.000674,172.31.40.0-255,66,69003,76,292183
15275,0.001538,172.217.194.0-255,1484,70487,76,292183
15276,0.001568,172.217.194.0-255,2902,73389,76,292183
15277,0.001573,172.31.40.0-255,66,73455,76,292183
15278,0.00158,172.217.194.0-255,5738,79193,76,292183
15279,0.001581,172.31.40.0-255,66,79259,76,292183
15280,0.001585,172.217.194.0-255,2902,82161,76,292183
15281,0.001587,172.31.40.0-255,66,82227,76,292183
15282,0.001623,172.31.40.0-255,66,82293,76,292183
15283,0.00163,172.217.194.0-255,7156,89449,76,292183
15284,0.001632,172.31.40.0-255,66,89515,76,292183
15285,0.001646,172.217.194.0-255,3602,93117,76,292183
15286,0.001648,172.31.40.0-255,66,93183,76,292183
15287,0.00167,172.217.194.0-255,1484,94667,76,292183
15288,0.001674,172.217.194.0-255,1484,96151,76,292183
15289,0.001675,172.31.40.0-255,66,96217,76,292183
15290,0.001695,172.217.194.0-255,1484,97701,76,292183
15291,0.001701,172.217.194.0-255,5738,103439,76,292183
15292,0.001703,172.31.40.0-255,66,103505,76,292183
15293,0.001769,172.217.194.0-255,7156,110661,76,292183
15294,0.001772,172.31.40.0-255,66,110727,76,292183
15295,0.001786,172.217.194.0-255,5738,116465,76,292183
15296,0.001788,172.31.40.0-255,66,116531,76,292183
15297,0.001794,172.217.194.0-255,5738,122269,76,292183
15298,0.001795,172.31.40.0-255,66,122335,76,292183
15299,0.001828,172.217.194.0-255,2902,125237,76,292183
15300,0.00183,172.31.40.0-255,66,125303,76,292183
15301,0.001848,172.217.194.0-255,2184,127487,76,292183
15302,0.00185,172.31.40.0-255,66,127553,76,292183
15303,0.001856,172.217.194.0-255,5738,133291,76,292183
15304,0.001857,172.31.40.0-255,66,133357,76,292183
15305,0.00186,172.217.194.0-255,1484,134841,76,292183
15306,0.001878,172.217.194.0-255,4320,139161,76,292183
15307,0.00188,172.31.40.0-255,66,139227,76,292183
15308,0.001903,172.217.194.0-255,2902,142129,76,292183
15309,0.001905,172.31.40.0-255,66,142195,76,292183
15310,0.001923,172.31.40.0-255,66,142261,76,292183
15311,0.001934,172.217.194.0-255,1484,143745,76,292183
15312,0.001941,172.217.194.0-255,7156,150901,76,292183
15313,0.001943,172.31.40.0-255,66,150967,76,292183
15314,0.001964,172.217.194.0-255,2184,153151,76,292183
15315,0.001966,172.31.40.0-255,66,153217,76,292183
15316,0.002797,172.217.194.0-255,1484,154701,76,292183
15317,0.002803,172.217.194.0-255,1484,156185,76,292183
15318,0.002806,172.31.40.0-255,66,156251,76,292183
15319,0.002821,172.217.194.0-255,1484,157735,76,292183
15320,0.002825,172.217.194.0-255,2902,160637,76,292183
15321,0.002827,172.31.40.0-255,66,160703,76,292183
15322,0.002832,172.217.194.0-255,4320,165023,76,292183
15323,0.002834,172.31.40.0-255,66,165089,76,292183
15324,0.002849,172.217.194.0-255,1484,166573,76,292183
15325,0.002868,172.217.194.0-255,7156,173729,76,292183
15326,0.00287,172.31.40.0-255,66,173795,76,292183
15327,0.002872,172.217.194.0-255,1484,175279,76,292183
15328,0.002921,172.217.194.0-255,4320,179599,76,292183
15329,0.002923,172.31.40.0-255,66,179665,76,292183
15330,0.002946,172.217.194.0-255,5738,185403,76,292183
15331,0.002948,172.31.40.0-255,66,185469,76,292183
15332,0.00295,172.217.194.0-255,1484,186953,76,292183
15333,0.002953,172.217.194.0-255,766,187719,76,292183
15334,0.002955,172.31.40.0-255,66,187785,76,292183
15335,0.003204,172.217.194.0-255,1484,189269,76,292183
15336,0.003219,172.217.194.0-255,2902,192171,76,292183
15337,0.003221,172.31.40.0-255,66,192237,76,292183
15338,0.003235,172.217.194.0-255,1484,193721,76,292183
15339,0.003246,172.217.194.0-255,1484,195205,76,292183
15340,0.003248,172.31.40.0-255,66,195271,76,292183
15341,0.00325,172.217.194.0-255,1484,196755,76,292183
15342,0.003283,172.217.194.0-255,2902,199657,76,292183
15343,0.003285,172.31.40.0-255,66,199723,76,292183
15344,0.003301,172.217.194.0-255,4320,204043,76,292183
15345,0.003304,172.31.40.0-255,66,204109,76,292183
15346,0.003325,172.217.194.0-255,2902,207011,76,292183
15347,0.003327,172.31.40.0-255,66,207077,76,292183
15348,0.003333,172.217.194.0-255,5738,212815,76,292183
15349,0.003335,172.31.40.0-255,66,212881,76,292183
15350,0.003358,172.217.194.0-255,5738,218619,76,292183
15351,0.00336,172.31.40.0-255,66,218685,76,292183
15352,0.00337,172.31.40.0-255,66,218751,76,292183
15353,0.003377,172.217.194.0-255,7156,225907,76,292183
15354,0.003379,172.31.40.0-255,66,225973,76,292183
15355,0.003399,172.217.194.0-255,2902,228875,76,292183
15356,0.003401,172.31.40.0-255,66,228941,76,292183
15357,0.003405,172.217.194.0-255,2902,231843,76,292183
15358,0.003407,172.31.40.0-255,66,231909,76,292183
15359,0.003425,172.217.194.0-255,5738,237647,76,292183
15360,0.003427,172.31.40.0-255,66,237713,76,292183
15361,0.003456,172.31.40.0-255,66,237779,76,292183
15362,0.00366,172.217.194.0-255,1484,239263,76,292183
15363,0.003666,172.217.194.0-255,2902,242165,76,292183
15364,0.003668,172.31.40.0-255,66,242231,76,292183
15365,0.003692,172.217.194.0-255,5738,247969,76,292183
15366,0.003695,172.31.40.0-255,66,248035,76,292183
15367,0.003701,172.217.194.0-255,7156,255191,76,292183
15368,0.003703,172.31.40.0-255,66,255257,76,292183
15369,0.003716,172.217.194.0-255,1484,256741,76,292183
15370,0.003769,172.217.194.0-255,4320,261061,76,292183
15371,0.003772,172.31.40.0-255,66,261127,76,292183
15372,0.003794,172.217.194.0-255,5738,266865,76,292183
15373,0.003797,172.31.40.0-255,66,266931,76,292183
15374,0.003821,172.217.194.0-255,5020,271951,76,292183
15375,0.003823,172.31.40.0-255,66,272017,76,292183
15376,0.003866,172.31.40.0-255,66,272083,76,292183
15377,0.003894,172.217.194.0-255,1484,273567,76,292183
15378,0.003908,172.31.40.0-255,66,273633,76,292183
15379,0.003923,172.31.40.0-255,66,273699,76,292183
15380,0.003935,172.31.40.0-255,66,273765,76,292183
15381,0.003956,172.217.194.0-255,5020,278785,76,292183
15382,0.003958,172.31.40.0-255,66,278851,76,292183
15383,0.003962,172.217.194.0-255,2902,281753,76,292183
15384,0.003964,172.31.40.0-255,66,281819,76,292183
15385,0.003978,172.217.194.0-255,1484,283303,76,292183
15386,0.004033,172.217.194.0-255,1484,284787,76,292183
15387,0.004037,172.31.40.0-255,66,284853,76,292183
15388,0.004056,172.217.194.0-255,2622,287475,76,292183
15389,0.004058,172.31.40.0-255,66,287541,76,292183
15390,0.004061,172.217.194.0-255,105,287646,76,292183
15391,0.005946,172.31.40.0-255,66,287712,76,292183
15392,0.005978,172.31.40.0-255,105,287817,76,292183
15393,0.008631,172.217.194.0-255,66,287883,76,292183
15394,0.030658,172.31.40.0-255,172,288055,76,292183
15395,0.030686,172.31.40.0-255,1109,289164,76,292183
15396,0.030736,172.31.40.0-255,1514,290678,76,292183
15397,0.030738,172.31.40.0-255,1307,291985,76,292183
15398,0.032449,104.244.42.0-255,66,292051,76,292183
15399,0.03246,104.244.42.0-255,66,292117,76,292183
15400,0.032463,104.244.42.0-255,66,292183,76,292183
15401,0.0,172.217.194.0-255,156,156,76,238226
15402,1.4e-05,172.31.40.0-255,66,222,76,238226
15403,2e-05,172.217.194.0-255,1484,1706,76,238226
15404,2.4e-05,172.31.40.0-255,66,1772,76,238226
15405,2.9e-05,172.217.194.0-255,2902,4674,76,238226
15406,3.2e-05,172.31.40.0-255,66,4740,76,238226
15407,3.5e-05,172.217.194.0-255,1484,6224,76,238226
15408,3.7e-05,172.31.40.0-255,66,6290,76,238226
15409,6.8e-05,172.217.194.0-255,5738,12028,76,238226
15410,7.1e-05,172.31.40.0-255,66,12094,76,238226
15411,7.4e-05,172.217.194.0-255,2088,14182,76,238226
15412,7.6e-05,172.31.40.0-255,66,14248,76,238226
15413,0.000107,172.217.194.0-255,1484,15732,76,238226
15414,0.000109,172.31.40.0-255,66,15798,76,238226
15415,0.000138,172.31.40.0-255,66,15864,76,238226
15416,0.000161,172.217.194.0-255,5379,21243,76,238226
15417,0.000163,172.31.40.0-255,66,21309,76,238226
15418,0.000203,172.217.194.0-255,2902,24211,76,238226
15419,0.000206,172.31.40.0-255,66,24277,76,238226
15420,0.000227,172.217.194.0-255,1484,25761,76,238226
15421,0.000229,172.31.40.0-255,66,25827,76,238226
15422,0.000235,172.217.194.0-255,5738,31565,76,238226
15423,0.000237,172.31.40.0-255,66,31631,76,238226
15424,0.000262,172.217.194.0-255,4320,35951,76,238226
15425,0.000265,172.31.40.0-255,66,36017,76,238226
15426,0.000283,172.217.194.0-255,2543,38560,76,238226
15427,0.000285,172.31.40.0-255,66,38626,76,238226
15428,0.000291,172.217.194.0-255,7156,45782,76,238226
15429,0.000293,172.31.40.0-255,66,45848,76,238226
15430,0.000323,172.31.40.0-255,66,45914,76,238226
15431,0.000404,172.217.194.0-255,366,46280,76,238226
15432,0.000408,172.217.194.0-255,377,46657,76,238226
15433,0.000678,172.217.194.0-255,1484,48141,76,238226
15434,0.000683,172.217.194.0-255,2902,51043,76,238226
15435,0.000688,172.31.40.0-255,66,51109,76,238226
15436,0.000691,172.31.40.0-255,66,51175,76,238226
15437,0.000711,172.217.194.0-255,5738,56913,76,238226
15438,0.000713,172.31.40.0-255,66,56979,76,238226
15439,0.00072,172.217.194.0-255,7156,64135,76,238226
15440,0.000722,172.31.40.0-255,66,64201,76,238226
15441,0.000736,172.217.194.0-255,2902,67103,76,238226
15442,0.000738,172.31.40.0-255,66,67169,76,238226
15443,0.000765,172.31.40.0-255,66,67235,76,238226
15444,0.000769,172.217.194.0-255,2184,69419,76,238226
15445,0.00077,172.31.40.0-255,66,69485,76,238226
15446,0.000789,172.217.194.0-255,2902,72387,76,238226
15447,0.000791,172.31.40.0-255,66,72453,76,238226
15448,0.000815,172.217.194.0-255,7156,79609,76,238226
15449,0.000819,172.31.40.0-255,66,79675,76,238226
15450,0.000824,172.217.194.0-255,4320,83995,76,238226
15451,0.000826,172.31.40.0-255,66,84061,76,238226
15452,0.000839,172.217.194.0-255,2902,86963,76,238226
15453,0.000841,172.31.40.0-255,66,87029,76,238226
15454,0.000854,172.31.40.0-255,66,87095,76,238226
15455,0.000869,172.217.194.0-255,2902,89997,76,238226
15456,0.000872,172.217.194.0-255,766,90763,76,238226
15457,0.000884,172.31.40.0-255,66,90829,76,238226
15458,0.001008,172.217.194.0-255,1484,92313,76,238226
15459,0.001012,172.217.194.0-255,1484,93797,76,238226
15460,0.001015,172.31.40.0-255,66,93863,76,238226
15461,0.001032,172.217.194.0-255,1484,95347,76,238226
15462,0.001039,172.217.194.0-255,5738,101085,76,238226
15463,0.00104,172.31.40.0-255,66,101151,76,238226
15464,0.001113,172.31.40.0-255,66,101217,76,238226
15465,0.001388,172.217.194.0-255,1484,102701,76,238226
15466,0.001417,172.217.194.0-255,2902,105603,76,238226
15467,0.00142,172.31.40.0-255,66,105669,76,238226
15468,0.001425,172.217.194.0-255,4320,109989,76,238226
15469,0.001427,172.31.40.0-255,66,110055,76,238226
15470,0.001438,172.217.194.0-255,1484,111539,76,238226
15471,0.001441,172.217.194.0-255,1484,113023,76,238226
15472,0.001443,172.31.40.0-255,66,113089,76,238226
15473,0.001453,172.31.40.0-255,66,113155,76,238226
15474,0.001467,172.217.194.0-255,2902,116057,76,238226
15475,0.001469,172.31.40.0-255,66,116123,76,238226
15476,0.001473,172.217.194.0-255,4320,120443,76,238226
15477,0.001475,172.31.40.0-255,66,120509,76,238226
15478,0.001502,172.217.194.0-255,5020,125529,76,238226
15479,0.001518,172.31.40.0-255,66,125595,76,238226
15480,0.001523,172.217.194.0-255,4320,129915,76,238226
15481,0.001527,172.31.40.0-255,66,129981,76,238226
15482,0.001539,172.217.194.0-255,2902,132883,76,238226
15483,0.001546,172.217.194.0-255,7156,140039,76,238226
15484,0.001559,172.31.40.0-255,66,140105,76,238226
15485,0.001561,172.217.194.0-255,1484,141589,76,238226
15486,0.001566,172.217.194.0-255,4320,145909,76,238226
15487,0.00157,172.31.40.0-255,66,145975,76,238226
15488,0.00159,172.217.194.0-255,766,146741,76,238226
15489,0.001603,172.31.40.0-255,66,146807,76,238226
15490,0.001762,172.217.194.0-255,1484,148291,76,238226
15491,0.001766,172.217.194.0-255,2902,151193,76,238226
15492,0.001771,172.31.40.0-255,66,151259,76,238226
15493,0.001779,172.217.194.0-255,2902,154161,76,238226
15494,0.001797,172.31.40.0-255,66,154227,76,238226
15495,0.001809,172.217.194.0-255,7156,161383,76,238226
15496,0.00182,172.31.40.0-255,66,161449,76,238226
15497,0.001834,172.217.194.0-255,4320,165769,76,238226
15498,0.001838,172.31.40.0-255,66,165835,76,238226
15499,0.001856,172.217.194.0-255,3602,169437,76,238226
15500,0.001878,172.31.40.0-255,66,169503,76,238226
15501,0.001923,172.217.194.0-255,1484,170987,76,238226
15502,0.001928,172.217.194.0-255,2902,173889,76,238226
15503,0.00194,172.217.194.0-255,4320,178209,76,238226
15504,0.00195,172.217.194.0-255,1484,179693,76,238226
15505,0.001956,172.31.40.0-255,66,179759,76,238226
15506,0.001967,172.217.194.0-255,4320,184079,76,238226
15507,0.00198,172.31.40.0-255,66,184145,76,238226
15508,0.002008,172.217.194.0-255,5738,189883,76,238226
15509,0.002016,172.31.40.0-255,66,189949,76,238226
15510,0.002027,172.217.194.0-255,5020,194969,76,238226
15511,0.002042,172.217.194.0-255,4320,199289,76,238226
15512,0.002048,172.31.40.0-255,66,199355,76,238226
15513,0.002069,172.217.194.0-255,7156,206511,76,238226
15514,0.002081,172.31.40.0-255,66,206577,76,238226
15515,0.00216,172.217.194.0-255,6438,213015,76,238226
15516,0.00218,172.31.40.0-255,66,213081,76,238226
15517,0.002186,172.31.40.0-255,66,213147,76,238226
15518,0.002209,172.217.194.0-255,1484,214631,76,238226
15519,0.002226,172.31.40.0-255,66,214697,76,238226
15520,0.002243,172.31.40.0-255,66,214763,76,238226
15521,0.002262,172.217.194.0-255,7156,221919,76,238226
15522,0.002266,172.217.194.0-255,2184,224103,76,238226
15523,0.002269,172.31.40.0-255,66,224169,76,238226
15524,0.002285,172.217.194.0-255,2902,227071,76,238226
15525,0.002291,172.31.40.0-255,66,227137,76,238226
15526,0.002305,172.217.194.0-255,6445,233582,76,238226
15527,0.002322,172.217.194.0-255,105,233687,76,238226
15528,0.002326,172.31.40.0-255,66,233753,76,238226
15529,0.003887,172.31.40.0-255,105,233858,76,238226
15530,0.006518,172.217.194.0-255,66,233924,76,238226
15531,0.029609,172.31.40.0-255,172,234096,76,238226
15532,0.029641,172.31.40.0-255,1109,235205,76,238226
15533,0.029704,172.31.40.0-255,1514,236719,76,238226
15534,0.029706,172.31.40.0-255,1309,238028,76,238226
15535,0.031247,104.244.42.0-255,66,238094,76,238226
15536,0.031309,104.244.42.0-255,66,238160,76,238226
15537,0.031358,104.244.42.0-255,66,238226,76,238226
15538,0.0,172.217.194.0-255,146,146,76,211899
15539,1.7e-05,172.31.40.0-255,66,212,76,211899
15540,2.4e-05,172.217.194.0-255,1484,1696,76,211899
15541,2.9e-05,172.31.40.0-255,66,1762,76,211899
15542,3.5e-05,172.217.194.0-255,2902,4664,76,211899
15543,3.8e-05,172.31.40.0-255,66,4730,76,211899
15544,4.6e-05,172.217.194.0-255,7156,11886,76,211899
15545,4.9e-05,172.31.40.0-255,66,11952,76,211899
15546,5.3e-05,172.217.194.0-255,2138,14090,76,211899
15547,5.6e-05,172.31.40.0-255,66,14156,76,211899
15548,0.000103,172.217.194.0-255,4320,18476,76,211899
15549,0.000107,172.31.40.0-255,66,18542,76,211899
15550,0.00013,172.217.194.0-255,2902,21444,76,211899
15551,0.000132,172.31.40.0-255,66,21510,76,211899
15552,0.000143,172.31.40.0-255,66,21576,76,211899
15553,0.000146,172.217.194.0-255,1125,22701,76,211899
15554,0.000148,172.31.40.0-255,66,22767,76,211899
15555,0.000228,172.217.194.0-255,1484,24251,76,211899
15556,0.000232,172.31.40.0-255,66,24317,76,211899
15557,0.000255,172.217.194.0-255,2902,27219,76,211899
15558,0.000258,172.31.40.0-255,66,27285,76,211899
15559,0.000264,172.217.194.0-255,5738,33023,76,211899
15560,0.000267,172.31.40.0-255,66,33089,76,211899
15561,0.000301,172.217.194.0-255,2902,35991,76,211899
15562,0.000304,172.31.40.0-255,66,36057,76,211899
15563,0.000328,172.217.194.0-255,3961,40018,76,211899
15564,0.000331,172.31.40.0-255,66,40084,76,211899
15565,0.000338,172.217.194.0-255,7156,47240,76,211899
15566,0.000341,172.31.40.0-255,66,47306,76,211899
15567,0.000359,172.217.194.0-255,5738,53044,76,211899
15568,0.000361,172.31.40.0-255,66,53110,76,211899
15569,0.000393,172.217.194.0-255,4573,57683,76,211899
15570,0.000397,172.31.40.0-255,66,57749,76,211899
15571,0.000639,172.217.194.0-255,1484,59233,76,211899
15572,0.000646,172.31.40.0-255,66,59299,76,211899
15573,0.000653,172.217.194.0-255,2902,62201,76,211899
15574,0.00066,172.217.194.0-255,5738,67939,76,211899
15575,0.000678,172.217.194.0-255,4320,72259,76,211899
15576,0.000682,172.31.40.0-255,66,72325,76,211899
15577,0.000687,172.31.40.0-255,66,72391,76,211899
15578,0.00072,172.217.194.0-255,4320,76711,76,211899
15579,0.000736,172.217.194.0-255,6438,83149,76,211899
15580,0.00075,172.31.40.0-255,66,83215,76,211899
15581,0.000955,172.217.194.0-255,1484,84699,76,211899
15582,0.00096,172.217.194.0-255,2902,87601,76,211899
15583,0.000975,172.217.194.0-255,5738,93339,76,211899
15584,0.000995,172.217.194.0-255,4320,97659,76,211899
15585,0.001,172.31.40.0-255,66,97725,76,211899
15586,0.001019,172.31.40.0-255,66,97791,76,211899
15587,0.001053,172.31.40.0-255,66,97857,76,211899
15588,0.001069,172.217.194.0-255,1484,99341,76,211899
15589,0.001119,172.31.40.0-255,66,99407,76,211899
15590,0.001129,172.217.194.0-255,4320,103727,76,211899
15591,0.001138,172.31.40.0-255,66,103793,76,211899
15592,0.001163,172.31.40.0-255,66,103859,76,211899
15593,0.001176,172.217.194.0-255,6438,110297,76,211899
15594,0.001207,172.31.40.0-255,66,110363,76,211899
15595,0.001634,172.217.194.0-255,1484,111847,76,211899
15596,0.00164,172.217.194.0-255,2902,114749,76,211899
15597,0.001643,172.31.40.0-255,66,114815,76,211899
15598,0.001647,172.217.194.0-255,1484,116299,76,211899
15599,0.001675,172.217.194.0-255,4320,120619,76,211899
15600,0.001689,172.217.194.0-255,1484,122103,76,211899
15601,0.001694,172.31.40.0-255,66,122169,76,211899
15602,0.001735,172.217.194.0-255,4320,126489,76,211899
15603,0.00175,172.217.194.0-255,4320,130809,76,211899
15604,0.001753,172.217.194.0-255,766,131575,76,211899
15605,0.001756,172.217.194.0-255,1484,133059,76,211899
15606,0.00176,172.217.194.0-255,4320,137379,76,211899
15607,0.001765,172.217.194.0-255,2902,140281,76,211899
15608,0.001789,172.217.194.0-255,7156,147437,76,211899
15609,0.001799,172.31.40.0-255,66,147503,76,211899
15610,0.001805,172.31.40.0-255,66,147569,76,211899
15611,0.001832,172.217.194.0-255,7156,154725,76,211899
15612,0.001839,172.31.40.0-255,66,154791,76,211899
15613,0.001861,172.217.194.0-255,5020,159811,76,211899
15614,0.001887,172.217.194.0-255,4320,164131,76,211899
15615,0.001898,172.31.40.0-255,66,164197,76,211899
15616,0.001914,172.217.194.0-255,4320,168517,76,211899
15617,0.001953,172.31.40.0-255,66,168583,76,211899
15618,0.001971,172.217.194.0-255,2902,171485,76,211899
15619,0.001981,172.31.40.0-255,66,171551,76,211899
15620,0.002025,172.31.40.0-255,66,171617,76,211899
15621,0.002035,172.217.194.0-255,4320,175937,76,211899
15622,0.00204,172.31.40.0-255,66,176003,76,211899
15623,0.002072,172.217.194.0-255,766,176769,76,211899
15624,0.002084,172.217.194.0-255,1484,178253,76,211899
15625,0.002089,172.31.40.0-255,66,178319,76,211899
15626,0.002098,172.217.194.0-255,4320,182639,76,211899
15627,0.002103,172.31.40.0-255,66,182705,76,211899
15628,0.002132,172.217.194.0-255,1484,184189,76,211899
15629,0.00214,172.31.40.0-255,66,184255,76,211899
15630,0.002194,172.31.40.0-255,66,184321,76,211899
15631,0.002213,172.217.194.0-255,6438,190759,76,211899
15632,0.00222,172.31.40.0-255,66,190825,76,211899
15633,0.002265,172.217.194.0-255,5738,196563,76,211899
15634,0.002272,172.31.40.0-255,66,196629,76,211899
15635,0.002354,172.217.194.0-255,2184,198813,76,211899
15636,0.00236,172.31.40.0-255,66,198879,76,211899
15637,0.002382,172.217.194.0-255,2902,201781,76,211899
15638,0.002391,172.31.40.0-255,66,201847,76,211899
15639,0.002424,172.31.40.0-255,66,201913,76,211899
15640,0.0049,172.217.194.0-255,4320,206233,76,211899
15641,0.004906,172.31.40.0-255,66,206299,76,211899
15642,0.004923,172.217.194.0-255,1484,207783,76,211899
15643,0.007243,172.217.194.0-255,333,208116,76,211899
15644,0.01405,172.217.194.0-255,333,208449,76,211899
15645,0.014077,172.31.40.0-255,78,208527,76,211899
15646,0.017862,172.31.40.0-255,105,208632,76,211899
15647,0.020193,172.217.194.0-255,66,208698,76,211899
15648,0.0355,172.31.40.0-255,172,208870,76,211899
15649,0.035535,172.31.40.0-255,1104,209974,76,211899
15650,0.035596,172.31.40.0-255,1514,211488,76,211899
15651,0.035598,172.31.40.0-255,345,211833,76,211899
15652,0.037652,104.244.42.0-255,66,211899,76,211899
15653,0.0,74.125.24.0-255,149,149,76,252987
15654,2.3e-05,172.31.40.0-255,66,215,76,252987
15655,3e-05,74.125.24.0-255,1484,1699,76,252987
15656,3.5e-05,172.31.40.0-255,66,1765,76,252987
15657,4e-05,74.125.24.0-255,2902,4667,76,252987
15658,5.1e-05,172.31.40.0-255,66,4733,76,252987
15659,5.8e-05,74.125.24.0-255,5738,10471,76,252987
15660,6e-05,172.31.40.0-255,66,10537,76,252987
15661,6.3e-05,74.125.24.0-255,1484,12021,76,252987
15662,6.6e-05,172.31.40.0-255,66,12087,76,252987
15663,0.000106,172.31.40.0-255,66,12153,76,252987
15664,0.000113,74.125.24.0-255,6797,18950,76,252987
15665,0.000116,172.31.40.0-255,66,19016,76,252987
15666,0.000165,74.125.24.0-255,1484,20500,76,252987
15667,0.000168,172.31.40.0-255,66,20566,76,252987
15668,0.000173,74.125.24.0-255,2902,23468,76,252987
15669,0.000175,172.31.40.0-255,66,23534,76,252987
15670,0.000181,74.125.24.0-255,5738,29272,76,252987
15671,0.000184,172.31.40.0-255,66,29338,76,252987
15672,0.000189,74.125.24.0-255,4320,33658,76,252987
15673,0.000192,172.31.40.0-255,66,33724,76,252987
15674,0.000242,74.125.24.0-255,2543,36267,76,252987
15675,0.000244,172.31.40.0-255,66,36333,76,252987
15676,0.000322,74.125.24.0-255,1484,37817,76,252987
15677,0.000324,172.31.40.0-255,66,37883,76,252987
15678,0.000343,74.125.24.0-255,2902,40785,76,252987
15679,0.000346,172.31.40.0-255,66,40851,76,252987
15680,0.000349,74.125.24.0-255,1484,42335,76,252987
15681,0.000351,172.31.40.0-255,66,42401,76,252987
15682,0.000389,74.125.24.0-255,4320,46721,76,252987
15683,0.000392,172.31.40.0-255,66,46787,76,252987
15684,0.0004,74.125.24.0-255,6797,53584,76,252987
15685,0.000402,172.31.40.0-255,66,53650,76,252987
15686,0.000487,74.125.24.0-255,1484,55134,76,252987
15687,0.000493,74.125.24.0-255,2902,58036,76,252987
15688,0.000497,172.31.40.0-255,66,58102,76,252987
15689,0.000504,74.125.24.0-255,5738,63840,76,252987
15690,0.000506,172.31.40.0-255,66,63906,76,252987
15691,0.000555,74.125.24.0-255,6797,70703,76,252987
15692,0.000559,172.31.40.0-255,66,70769,76,252987
15693,0.000965,74.125.24.0-255,1484,72253,76,252987
15694,0.000972,74.125.24.0-255,2902,75155,76,252987
15695,0.000975,172.31.40.0-255,66,75221,76,252987
15696,0.000979,74.125.24.0-255,1484,76705,76,252987
15697,0.001007,74.125.24.0-255,4320,81025,76,252987
15698,0.001015,74.125.24.0-255,6797,87822,76,252987
15699,0.001023,172.31.40.0-255,66,87888,76,252987
15700,0.001027,172.31.40.0-255,66,87954,76,252987
15701,0.001085,74.125.24.0-255,1484,89438,76,252987
15702,0.001106,74.125.24.0-255,2902,92340,76,252987
15703,0.001109,172.31.40.0-255,66,92406,76,252987
15704,0.001112,74.125.24.0-255,1484,93890,76,252987
15705,0.00114,74.125.24.0-255,4320,98210,76,252987
15706,0.001158,74.125.24.0-255,7156,105366,76,252987
15707,0.001164,172.31.40.0-255,66,105432,76,252987
15708,0.001172,172.31.40.0-255,66,105498,76,252987
15709,0.001175,172.31.40.0-255,66,105564,76,252987
15710,0.001185,74.125.24.0-255,3602,109166,76,252987
15711,0.001187,172.31.40.0-255,66,109232,76,252987
15712,0.001259,74.125.24.0-255,1484,110716,76,252987
15713,0.001264,74.125.24.0-255,2902,113618,76,252987
15714,0.001267,172.31.40.0-255,66,113684,76,252987
15715,0.001274,74.125.24.0-255,4320,118004,76,252987
15716,0.001276,172.31.40.0-255,66,118070,76,252987
15717,0.001304,74.125.24.0-255,1484,119554,76,252987
15718,0.001319,172.31.40.0-255,66,119620,76,252987
15719,0.001327,74.125.24.0-255,7156,126776,76,252987
15720,0.00133,172.31.40.0-255,66,126842,76,252987
15721,0.001362,74.125.24.0-255,3602,130444,76,252987
15722,0.001365,172.31.40.0-255,66,130510,76,252987
15723,0.00139,74.125.24.0-255,4320,134830,76,252987
15724,0.001392,172.31.40.0-255,66,134896,76,252987
15725,0.001432,172.31.40.0-255,66,134962,76,252987
15726,0.001439,74.125.24.0-255,5738,140700,76,252987
15727,0.001441,172.31.40.0-255,66,140766,76,252987
15728,0.001485,74.125.24.0-255,7156,147922,76,252987
15729,0.001488,172.31.40.0-255,66,147988,76,252987
15730,0.001521,74.125.24.0-255,6438,154426,76,252987
15731,0.001524,172.31.40.0-255,66,154492,76,252987
15732,0.00174,74.125.24.0-255,1484,155976,76,252987
15733,0.001746,74.125.24.0-255,2902,158878,76,252987
15734,0.00175,172.31.40.0-255,66,158944,76,252987
15735,0.001754,74.125.24.0-255,1484,160428,76,252987
15736,0.001785,74.125.24.0-255,4320,164748,76,252987
15737,0.001788,172.31.40.0-255,66,164814,76,252987
15738,0.001794,74.125.24.0-255,5738,170552,76,252987
15739,0.001797,172.31.40.0-255,66,170618,76,252987
15740,0.001842,74.125.24.0-255,7156,177774,76,252987
15741,0.001845,172.31.40.0-255,66,177840,76,252987
15742,0.001872,74.125.24.0-255,5738,183578,76,252987
15743,0.001875,172.31.40.0-255,66,183644,76,252987
15744,0.001881,74.125.24.0-255,5020,188664,76,252987
15745,0.001883,172.31.40.0-255,66,188730,76,252987
15746,0.001889,74.125.24.0-255,5738,194468,76,252987
15747,0.001891,172.31.40.0-255,66,194534,76,252987
15748,0.001898,74.125.24.0-255,7156,201690,76,252987
15749,0.001901,172.31.40.0-255,66,201756,76,252987
15750,0.001962,172.31.40.0-255,66,201822,76,252987
15751,0.001989,74.125.24.0-255,1484,203306,76,252987
15752,0.002017,172.31.40.0-255,66,203372,76,252987
15753,0.002077,74.125.24.0-255,1484,204856,76,252987
15754,0.002094,74.125.24.0-255,2902,207758,76,252987
15755,0.002097,172.31.40.0-255,66,207824,76,252987
15756,0.002104,74.125.24.0-255,5738,213562,76,252987
15757,0.002106,172.31.40.0-255,66,213628,76,252987
15758,0.002152,172.31.40.0-255,66,213694,76,252987
15759,0.002163,172.31.40.0-255,66,213760,76,252987
15760,0.002195,74.125.24.0-255,2184,215944,76,252987
15761,0.002197,172.31.40.0-255,66,216010,76,252987
15762,0.002231,74.125.24.0-255,1484,217494,76,252987
15763,0.002248,74.125.24.0-255,2902,220396,76,252987
15764,0.002255,74.125.24.0-255,4320,224716,76,252987
15765,0.002265,172.31.40.0-255,66,224782,76,252987
15766,0.002269,74.125.24.0-255,1484,226266,76,252987
15767,0.002338,172.31.40.0-255,66,226332,76,252987
15768,0.002347,74.125.24.0-255,2902,229234,76,252987
15769,0.002352,172.31.40.0-255,66,229300,76,252987
15770,0.002368,74.125.24.0-255,7156,236456,76,252987
15771,0.002399,172.31.40.0-255,66,236522,76,252987
15772,0.002451,74.125.24.0-255,6438,242960,76,252987
15773,0.002462,172.31.40.0-255,66,243026,76,252987
15774,0.002479,172.31.40.0-255,66,243092,76,252987
15775,0.002509,74.125.24.0-255,5185,248277,76,252987
15776,0.00255,172.31.40.0-255,66,248343,76,252987
15777,0.004944,74.125.24.0-255,105,248448,76,252987
15778,0.010994,172.31.40.0-255,66,248514,76,252987
15779,0.011045,172.31.40.0-255,105,248619,76,252987
15780,0.013444,74.125.24.0-255,66,248685,76,252987
15781,0.031516,172.31.40.0-255,172,248857,76,252987
15782,0.031548,172.31.40.0-255,1109,249966,76,252987
15783,0.031613,172.31.40.0-255,1514,251480,76,252987
15784,0.031614,172.31.40.0-255,1309,252789,76,252987
15785,0.033152,104.244.42.0-255,66,252855,76,252987
15786,0.033192,104.244.42.0-255,66,252921,76,252987
15787,0.033305,104.244.42.0-255,66,252987,76,252987
15788,0.0,74.125.130.0-255,150,150,76,291597
15789,1.3e-05,172.31.40.0-255,66,216,76,291597
15790,1.8e-05,74.125.130.0-255,1484,1700,76,291597
15791,2.3e-05,172.31.40.0-255,66,1766,76,291597
15792,2.8e-05,74.125.130.0-255,2902,4668,76,291597
15793,3.1e-05,172.31.40.0-255,66,4734,76,291597
15794,3.4e-05,74.125.130.0-255,1484,6218,76,291597
15795,3.6e-05,172.31.40.0-255,66,6284,76,291597
15796,6.2e-05,74.125.130.0-255,5738,12022,76,291597
15797,6.5e-05,172.31.40.0-255,66,12088,76,291597
15798,6.9e-05,74.125.130.0-255,2098,14186,76,291597
15799,7.1e-05,172.31.40.0-255,66,14252,76,291597
15800,7.5e-05,74.125.130.0-255,2902,17154,76,291597
15801,7.7e-05,172.31.40.0-255,66,17220,76,291597
15802,0.000106,74.125.130.0-255,7156,24376,76,291597
15803,0.000108,172.31.40.0-255,66,24442,76,291597
15804,0.000111,74.125.130.0-255,1484,25926,76,291597
15805,0.000112,172.31.40.0-255,66,25992,76,291597
15806,0.000166,74.125.130.0-255,5379,31371,76,291597
15807,0.000168,172.31.40.0-255,66,31437,76,291597
15808,0.000247,74.125.130.0-255,1484,32921,76,291597
15809,0.000249,172.31.40.0-255,66,32987,76,291597
15810,0.000254,74.125.130.0-255,2902,35889,76,291597
15811,0.000256,172.31.40.0-255,66,35955,76,291597
15812,0.000259,74.125.130.0-255,1484,37439,76,291597
15813,0.00026,172.31.40.0-255,66,37505,76,291597
15814,0.000284,74.125.130.0-255,4320,41825,76,291597
15815,0.000287,172.31.40.0-255,66,41891,76,291597
15816,0.000309,74.125.130.0-255,4320,46211,76,291597
15817,0.000312,172.31.40.0-255,66,46277,76,291597
15818,0.00034,172.31.40.0-255,66,46343,76,291597
15819,0.000391,74.125.130.0-255,5738,52081,76,291597
15820,0.000393,172.31.40.0-255,66,52147,76,291597
15821,0.000413,74.125.130.0-255,4218,56365,76,291597
15822,0.000415,172.31.40.0-255,66,56431,76,291597
15823,0.000418,74.125.130.0-255,117,56548,76,291597
15824,0.000516,74.125.130.0-255,1484,58032,76,291597
15825,0.00052,172.31.40.0-255,66,58098,76,291597
15826,0.000524,74.125.130.0-255,2902,61000,76,291597
15827,0.000526,172.31.40.0-255,66,61066,76,291597
15828,0.000529,74.125.130.0-255,1484,62550,76,291597
15829,0.000546,74.125.130.0-255,4320,66870,76,291597
15830,0.000549,172.31.40.0-255,66,66936,76,291597
15831,0.000552,74.125.130.0-255,2902,69838,76,291597
15832,0.000554,172.31.40.0-255,66,69904,76,291597
15833,0.00059,74.125.130.0-255,3961,73865,76,291597
15834,0.000593,172.31.40.0-255,66,73931,76,291597
15835,0.000599,74.125.130.0-255,7156,81087,76,291597
15836,0.000601,172.31.40.0-255,66,81153,76,291597
15837,0.000612,74.125.130.0-255,1484,82637,76,291597
15838,0.000633,172.31.40.0-255,66,82703,76,291597
15839,0.000868,74.125.130.0-255,1484,84187,76,291597
15840,0.000874,74.125.130.0-255,2902,87089,76,291597
15841,0.000876,172.31.40.0-255,66,87155,76,291597
15842,0.000899,74.125.130.0-255,5738,92893,76,291597
15843,0.000902,172.31.40.0-255,66,92959,76,291597
15844,0.000937,172.31.40.0-255,66,93025,76,291597
15845,0.000982,172.31.40.0-255,66,93091,76,291597
15846,0.001295,74.125.130.0-255,1484,94575,76,291597
15847,0.0013,74.125.130.0-255,2902,97477,76,291597
15848,0.001304,172.31.40.0-255,66,97543,76,291597
15849,0.001309,74.125.130.0-255,2902,100445,76,291597
15850,0.001311,172.31.40.0-255,66,100511,76,291597
15851,0.001323,74.125.130.0-255,1484,101995,76,291597
15852,0.001343,74.125.130.0-255,2902,104897,76,291597
15853,0.001346,172.31.40.0-255,66,104963,76,291597
15854,0.001349,74.125.130.0-255,1484,106447,76,291597
15855,0.001382,74.125.130.0-255,7156,113603,76,291597
15856,0.001385,172.31.40.0-255,66,113669,76,291597
15857,0.001398,172.31.40.0-255,66,113735,76,291597
15858,0.001424,74.125.130.0-255,3602,117337,76,291597
15859,0.001427,172.31.40.0-255,66,117403,76,291597
15860,0.001441,74.125.130.0-255,4320,121723,76,291597
15861,0.001443,172.31.40.0-255,66,121789,76,291597
15862,0.001482,172.31.40.0-255,66,121855,76,291597
15863,0.001485,74.125.130.0-255,1484,123339,76,291597
15864,0.001489,74.125.130.0-255,2902,126241,76,291597
15865,0.001492,172.31.40.0-255,66,126307,76,291597
15866,0.001515,172.31.40.0-255,66,126373,76,291597
15867,0.001518,74.125.130.0-255,1484,127857,76,291597
15868,0.001559,172.31.40.0-255,66,127923,76,291597
15869,0.001577,74.125.130.0-255,4320,132243,76,291597
15870,0.00158,172.31.40.0-255,66,132309,76,291597
15871,0.001599,74.125.130.0-255,1484,133793,76,291597
15872,0.001607,74.125.130.0-255,7156,140949,76,291597
15873,0.001609,172.31.40.0-255,66,141015,76,291597
15874,0.001637,172.31.40.0-255,66,141081,76,291597
15875,0.001672,74.125.130.0-255,4320,145401,76,291597
15876,0.001675,172.31.40.0-255,66,145467,76,291597
15877,0.001708,74.125.130.0-255,4320,149787,76,291597
15878,0.001711,172.31.40.0-255,66,149853,76,291597
15879,0.001735,74.125.130.0-255,1484,151337,76,291597
15880,0.001822,74.125.130.0-255,1484,152821,76,291597
15881,0.001842,74.125.130.0-255,2902,155723,76,291597
15882,0.001859,74.125.130.0-255,2902,158625,76,291597
15883,0.001876,74.125.130.0-255,2902,161527,76,291597
15884,0.001889,74.125.130.0-255,1484,163011,76,291597
15885,0.001938,74.125.130.0-255,5738,168749,76,291597
15886,0.001955,74.125.130.0-255,3602,172351,76,291597
15887,0.005238,172.31.40.0-255,66,172417,76,291597
15888,0.005242,172.31.40.0-255,66,172483,76,291597
15889,0.005246,172.31.40.0-255,66,172549,76,291597
15890,0.005248,172.31.40.0-255,66,172615,76,291597
15891,0.005251,172.31.40.0-255,66,172681,76,291597
15892,0.005259,172.31.40.0-255,66,172747,76,291597
15893,0.005263,172.31.40.0-255,66,172813,76,291597
15894,0.005266,172.31.40.0-255,66,172879,76,291597
15895,0.007591,74.125.130.0-255,5738,178617,76,291597
15896,0.007598,172.31.40.0-255,66,178683,76,291597
15897,0.009938,74.125.130.0-255,5738,184421,76,291597
15898,0.009944,172.31.40.0-255,66,184487,76,291597
15899,0.012278,74.125.130.0-255,5738,190225,76,291597
15900,0.012284,172.31.40.0-255,66,190291,76,291597
15901,0.014616,74.125.130.0-255,5738,196029,76,291597
15902,0.014624,172.31.40.0-255,66,196095,76,291597
15903,0.016958,74.125.130.0-255,5738,201833,76,291597
15904,0.016968,172.31.40.0-255,66,201899,76,291597
15905,0.019303,74.125.130.0-255,5738,207637,76,291597
15906,0.019312,172.31.40.0-255,66,207703,76,291597
15907,0.02164,74.125.130.0-255,5738,213441,76,291597
15908,0.021647,172.31.40.0-255,66,213507,76,291597
15909,0.023993,74.125.130.0-255,5738,219245,76,291597
15910,0.024001,172.31.40.0-255,66,219311,76,291597
15911,0.026351,74.125.130.0-255,5738,225049,76,291597
15912,0.026358,172.31.40.0-255,66,225115,76,291597
15913,0.028684,74.125.130.0-255,5738,230853,76,291597
15914,0.028689,172.31.40.0-255,66,230919,76,291597
15915,0.029596,172.31.40.0-255,171,231090,76,291597
15916,0.029628,172.31.40.0-255,1131,232221,76,291597
15917,0.029691,172.31.40.0-255,1514,233735,76,291597
15918,0.029693,172.31.40.0-255,1514,235249,76,291597
15919,0.029698,172.31.40.0-255,1514,236763,76,291597
15920,0.029699,172.31.40.0-255,1514,238277,76,291597
15921,0.029741,172.31.40.0-255,161,238438,76,291597
15922,0.031026,74.125.130.0-255,5738,244176,76,291597
15923,0.031033,172.31.40.0-255,66,244242,76,291597
15924,0.031114,104.244.42.0-255,66,244308,76,291597
15925,0.031142,104.244.42.0-255,66,244374,76,291597
15926,0.031265,104.244.42.0-255,66,244440,76,291597
15927,0.031273,104.244.42.0-255,66,244506,76,291597
15928,0.033368,74.125.130.0-255,5738,250244,76,291597
15929,0.033374,172.31.40.0-255,66,250310,76,291597
15930,0.035706,74.125.130.0-255,5738,256048,76,291597
15931,0.035713,172.31.40.0-255,66,256114,76,291597
15932,0.038052,74.125.130.0-255,5738,261852,76,291597
15933,0.038059,172.31.40.0-255,66,261918,76,291597
15934,0.040396,74.125.130.0-255,5738,267656,76,291597
15935,0.040402,172.31.40.0-255,66,267722,76,291597
15936,0.042746,74.125.130.0-255,5738,273460,76,291597
15937,0.042753,172.31.40.0-255,66,273526,76,291597
15938,0.045082,74.125.130.0-255,5738,279264,76,291597
15939,0.045089,172.31.40.0-255,66,279330,76,291597
15940,0.04742,74.125.130.0-255,5738,285068,76,291597
15941,0.047426,172.31.40.0-255,66,285134,76,291597
15942,0.049765,74.125.130.0-255,5738,290872,76,291597
15943,0.049771,172.31.40.0-255,66,290938,76,291597
15944,0.052071,74.125.130.0-255,422,291360,76,291597
15945,0.052208,172.31.40.0-255,66,291426,76,291597
15946,0.052246,172.31.40.0-255,105,291531,76,291597
15947,0.054528,74.125.130.0-255,66,291597,76,291597
15948,0.0,74.125.24.0-255,153,153,76,363532
15949,1.7e-05,172.31.40.0-255,66,219,76,363532
15950,2.3e-05,74.125.24.0-255,1484,1703,76,363532
15951,2.8e-05,172.31.40.0-255,66,1769,76,363532
15952,4.3e-05,74.125.24.0-255,2902,4671,76,363532
15953,4.6e-05,172.31.40.0-255,66,4737,76,363532
15954,5e-05,74.125.24.0-255,2902,7639,76,363532
15955,5.3e-05,172.31.40.0-255,66,7705,76,363532
15956,6.4e-05,172.31.40.0-255,66,7771,76,363532
15957,0.000112,172.31.40.0-255,66,7837,76,363532
15958,0.000115,74.125.24.0-255,1484,9321,76,363532
15959,0.000117,172.31.40.0-255,66,9387,76,363532
15960,0.000148,74.125.24.0-255,2902,12289,76,363532
15961,0.000151,172.31.40.0-255,66,12355,76,363532
15962,0.000158,74.125.24.0-255,5738,18093,76,363532
15963,0.00016,172.31.40.0-255,66,18159,76,363532
15964,0.000199,74.125.24.0-255,6797,24956,76,363532
15965,0.000202,172.31.40.0-255,66,25022,76,363532
15966,0.000228,74.125.24.0-255,7156,32178,76,363532
15967,0.000231,172.31.40.0-255,66,32244,76,363532
15968,0.000236,74.125.24.0-255,2902,35146,76,363532
15969,0.000238,172.31.40.0-255,66,35212,76,363532
15970,0.000271,74.125.24.0-255,5738,40950,76,363532
15971,0.000274,172.31.40.0-255,66,41016,76,363532
15972,0.000277,74.125.24.0-255,1458,42474,76,363532
15973,0.000279,172.31.40.0-255,66,42540,76,363532
15974,0.000303,74.125.24.0-255,114,42654,76,363532
15975,0.000305,172.31.40.0-255,66,42720,76,363532
15976,0.00053,74.125.24.0-255,329,43049,76,363532
15977,0.000535,172.31.40.0-255,66,43115,76,363532
15978,0.000689,74.125.24.0-255,1484,44599,76,363532
15979,0.000696,74.125.24.0-255,2902,47501,76,363532
15980,0.0007,172.31.40.0-255,66,47567,76,363532
15981,0.000706,74.125.24.0-255,4320,51887,76,363532
15982,0.000708,172.31.40.0-255,66,51953,76,363532
15983,0.00074,74.125.24.0-255,1484,53437,76,363532
15984,0.000748,74.125.24.0-255,6797,60234,76,363532
15985,0.00075,172.31.40.0-255,66,60300,76,363532
15986,0.00078,74.125.24.0-255,7156,67456,76,363532
15987,0.000783,172.31.40.0-255,66,67522,76,363532
15988,0.000788,74.125.24.0-255,4320,71842,76,363532
15989,0.000791,172.31.40.0-255,66,71908,76,363532
15990,0.000836,74.125.24.0-255,2902,74810,76,363532
15991,0.000839,172.31.40.0-255,66,74876,76,363532
15992,0.000865,74.125.24.0-255,2543,77419,76,363532
15993,0.000868,172.31.40.0-255,66,77485,76,363532
15994,0.001296,74.125.24.0-255,1484,78969,76,363532
15995,0.001303,74.125.24.0-255,2902,81871,76,363532
15996,0.001306,172.31.40.0-255,66,81937,76,363532
15997,0.001313,74.125.24.0-255,5738,87675,76,363532
15998,0.001315,172.31.40.0-255,66,87741,76,363532
15999,0.001346,172.31.40.0-255,66,87807,76,363532
16000,0.001376,74.125.24.0-255,4320,92127,76,363532
16001,0.001379,172.31.40.0-255,66,92193,76,363532
16002,0.001389,172.31.40.0-255,66,92259,76,363532
16003,0.001397,74.125.24.0-255,2184,94443,76,363532
16004,0.001399,172.31.40.0-255,66,94509,76,363532
16005,0.002031,74.125.24.0-255,1484,95993,76,363532
16006,0.002042,74.125.24.0-255,2902,98895,76,363532
16007,0.002046,172.31.40.0-255,66,98961,76,363532
16008,0.002054,74.125.24.0-255,5738,104699,76,363532
16009,0.002055,172.31.40.0-255,66,104765,76,363532
16010,0.002067,74.125.24.0-255,4320,109085,76,363532
16011,0.002069,172.31.40.0-255,66,109151,76,363532
16012,0.002072,74.125.24.0-255,1484,110635,76,363532
16013,0.002117,172.31.40.0-255,66,110701,76,363532
16014,0.002123,74.125.24.0-255,3602,114303,76,363532
16015,0.002125,172.31.40.0-255,66,114369,76,363532
16016,0.002272,74.125.24.0-255,1484,115853,76,363532
16017,0.002278,74.125.24.0-255,2902,118755,76,363532
16018,0.002281,172.31.40.0-255,66,118821,76,363532
16019,0.002289,74.125.24.0-255,5738,124559,76,363532
16020,0.002291,172.31.40.0-255,66,124625,76,363532
16021,0.0023,74.125.24.0-255,2902,127527,76,363532
16022,0.002302,172.31.40.0-255,66,127593,76,363532
16023,0.002327,74.125.24.0-255,1484,129077,76,363532
16024,0.004547,74.125.24.0-255,1484,130561,76,363532
16025,0.004554,172.31.40.0-255,66,130627,76,363532
16026,0.004583,74.125.24.0-255,2902,133529,76,363532
16027,0.004585,172.31.40.0-255,66,133595,76,363532
16028,0.006818,74.125.24.0-255,2902,136497,76,363532
16029,0.006821,172.31.40.0-255,66,136563,76,363532
16030,0.00685,74.125.24.0-255,2902,139465,76,363532
16031,0.006853,172.31.40.0-255,66,139531,76,363532
16032,0.00917,74.125.24.0-255,5738,145269,76,363532
16033,0.009178,172.31.40.0-255,66,145335,76,363532
16034,0.011469,74.125.24.0-255,5738,151073,76,363532
16035,0.011478,172.31.40.0-255,66,151139,76,363532
16036,0.013755,74.125.24.0-255,5738,156877,76,363532
16037,0.013763,172.31.40.0-255,66,156943,76,363532
16038,0.016018,74.125.24.0-255,5738,162681,76,363532
16039,0.016026,172.31.40.0-255,66,162747,76,363532
16040,0.018312,74.125.24.0-255,5738,168485,76,363532
16041,0.018317,172.31.40.0-255,66,168551,76,363532
16042,0.020608,74.125.24.0-255,5738,174289,76,363532
16043,0.020615,172.31.40.0-255,66,174355,76,363532
16044,0.022903,74.125.24.0-255,5738,180093,76,363532
16045,0.02291,172.31.40.0-255,66,180159,76,363532
16046,0.025168,74.125.24.0-255,5738,185897,76,363532
16047,0.025174,172.31.40.0-255,66,185963,76,363532
16048,0.025343,172.31.40.0-255,172,186135,76,363532
16049,0.025372,172.31.40.0-255,1104,187239,76,363532
16050,0.025426,172.31.40.0-255,1514,188753,76,363532
16051,0.025428,172.31.40.0-255,346,189099,76,363532
16052,0.02747,74.125.24.0-255,5738,194837,76,363532
16053,0.027476,172.31.40.0-255,66,194903,76,363532
16054,0.027557,104.244.42.0-255,66,194969,76,363532
16055,0.029763,74.125.24.0-255,5738,200707,76,363532
16056,0.02977,172.31.40.0-255,66,200773,76,363532
16057,0.032076,74.125.24.0-255,5738,206511,76,363532
16058,0.032091,172.31.40.0-255,66,206577,76,363532
16059,0.034412,74.125.24.0-255,5738,212315,76,363532
16060,0.034428,172.31.40.0-255,66,212381,76,363532
16061,0.036728,74.125.24.0-255,5738,218119,76,363532
16062,0.036745,172.31.40.0-255,66,218185,76,363532
16063,0.03904,74.125.24.0-255,5738,223923,76,363532
16064,0.039062,172.31.40.0-255,66,223989,76,363532
16065,0.041342,74.125.24.0-255,5738,229727,76,363532
16066,0.041349,172.31.40.0-255,66,229793,76,363532
16067,0.043625,74.125.24.0-255,5738,235531,76,363532
16068,0.043631,172.31.40.0-255,66,235597,76,363532
16069,0.045933,74.125.24.0-255,5738,241335,76,363532
16070,0.045939,172.31.40.0-255,66,241401,76,363532
16071,0.048242,74.125.24.0-255,5738,247139,76,363532
16072,0.048249,172.31.40.0-255,66,247205,76,363532
16073,0.05053,74.125.24.0-255,5738,252943,76,363532
16074,0.050535,172.31.40.0-255,66,253009,76,363532
16075,0.052812,74.125.24.0-255,5738,258747,76,363532
16076,0.052819,172.31.40.0-255,66,258813,76,363532
16077,0.055106,74.125.24.0-255,5738,264551,76,363532
16078,0.055113,172.31.40.0-255,66,264617,76,363532
16079,0.057431,74.125.24.0-255,5738,270355,76,363532
16080,0.057438,172.31.40.0-255,66,270421,76,363532
16081,0.059736,74.125.24.0-255,5738,276159,76,363532
16082,0.059743,172.31.40.0-255,66,276225,76,363532
16083,0.062016,74.125.24.0-255,5738,281963,76,363532
16084,0.062023,172.31.40.0-255,66,282029,76,363532
16085,0.0643,74.125.24.0-255,5738,287767,76,363532
16086,0.064307,172.31.40.0-255,66,287833,76,363532
16087,0.06659,74.125.24.0-255,5738,293571,76,363532
16088,0.066597,172.31.40.0-255,66,293637,76,363532
16089,0.068871,74.125.24.0-255,5738,299375,76,363532
16090,0.068878,172.31.40.0-255,66,299441,76,363532
16091,0.071159,74.125.24.0-255,1484,300925,76,363532
16092,0.071178,74.125.24.0-255,4320,305245,76,363532
16093,0.071182,172.31.40.0-255,66,305311,76,363532
16094,0.07345,74.125.24.0-255,5738,311049,76,363532
16095,0.073455,172.31.40.0-255,66,311115,76,363532
16096,0.075744,74.125.24.0-255,5738,316853,76,363532
16097,0.075751,172.31.40.0-255,66,316919,76,363532
16098,0.078055,74.125.24.0-255,5738,322657,76,363532
16099,0.078061,172.31.40.0-255,66,322723,76,363532
16100,0.080328,74.125.24.0-255,5738,328461,76,363532
16101,0.080335,172.31.40.0-255,66,328527,76,363532
16102,0.082612,74.125.24.0-255,5738,334265,76,363532
16103,0.082618,172.31.40.0-255,66,334331,76,363532
16104,0.084916,74.125.24.0-255,5738,340069,76,363532
16105,0.084922,172.31.40.0-255,66,340135,76,363532
16106,0.087217,74.125.24.0-255,5738,345873,76,363532
16107,0.087224,172.31.40.0-255,66,345939,76,363532
16108,0.089517,74.125.24.0-255,5738,351677,76,363532
16109,0.089523,172.31.40.0-255,66,351743,76,363532
16110,0.091802,74.125.24.0-255,4320,356063,76,363532
16111,0.091808,172.31.40.0-255,66,356129,76,363532
16112,0.091835,74.125.24.0-255,1484,357613,76,363532
16113,0.094092,74.125.24.0-255,4320,361933,76,363532
16114,0.094099,172.31.40.0-255,66,361999,76,363532
16115,0.096389,74.125.24.0-255,1296,363295,76,363532
16116,0.096517,172.31.40.0-255,66,363361,76,363532
16117,0.096553,172.31.40.0-255,105,363466,76,363532
16118,0.098816,74.125.24.0-255,66,363532,76,363532
16119,0.0,172.217.194.0-255,148,148,76,320789
16120,1.5e-05,172.31.40.0-255,66,214,76,320789
16121,2.1e-05,172.217.194.0-255,1484,1698,76,320789
16122,2.7e-05,172.31.40.0-255,66,1764,76,320789
16123,4e-05,172.217.194.0-255,2902,4666,76,320789
16124,4.3e-05,172.31.40.0-255,66,4732,76,320789
16125,4.9e-05,172.217.194.0-255,4320,9052,76,320789
16126,5.3e-05,172.31.40.0-255,66,9118,76,320789
16127,9e-05,172.217.194.0-255,4873,13991,76,320789
16128,9.3e-05,172.31.40.0-255,66,14057,76,320789
16129,0.000139,172.217.194.0-255,1484,15541,76,320789
16130,0.000141,172.31.40.0-255,66,15607,76,320789
16131,0.000147,172.217.194.0-255,2902,18509,76,320789
16132,0.000149,172.31.40.0-255,66,18575,76,320789
16133,0.00018,172.217.194.0-255,5738,24313,76,320789
16134,0.000182,172.31.40.0-255,66,24379,76,320789
16135,0.000188,172.217.194.0-255,4320,28699,76,320789
16136,0.00019,172.31.40.0-255,66,28765,76,320789
16137,0.000217,172.217.194.0-255,6797,35562,76,320789
16138,0.000225,172.31.40.0-255,66,35628,76,320789
16139,0.000238,172.31.40.0-255,66,35694,76,320789
16140,0.000249,172.31.40.0-255,66,35760,76,320789
16141,0.000293,172.217.194.0-255,4320,40080,76,320789
16142,0.000295,172.31.40.0-255,66,40146,76,320789
16143,0.000323,172.217.194.0-255,3951,44097,76,320789
16144,0.000325,172.31.40.0-255,66,44163,76,320789
16145,0.000328,172.217.194.0-255,360,44523,76,320789
16146,0.000331,172.31.40.0-255,66,44589,76,320789
16147,0.000566,172.217.194.0-255,1484,46073,76,320789
16148,0.000572,172.31.40.0-255,66,46139,76,320789
16149,0.000578,172.217.194.0-255,2902,49041,76,320789
16150,0.000581,172.31.40.0-255,66,49107,76,320789
16151,0.000608,172.217.194.0-255,4320,53427,76,320789
16152,0.000611,172.31.40.0-255,66,53493,76,320789
16153,0.000643,172.217.194.0-255,1484,54977,76,320789
16154,0.000663,172.31.40.0-255,66,55043,76,320789
16155,0.000676,172.31.40.0-255,66,55109,76,320789
16156,0.002149,172.217.194.0-255,1484,56593,76,320789
16157,0.002157,172.217.194.0-255,2902,59495,76,320789
16158,0.002162,172.31.40.0-255,66,59561,76,320789
16159,0.002169,172.217.194.0-255,4320,63881,76,320789
16160,0.002171,172.31.40.0-255,66,63947,76,320789
16161,0.002174,172.217.194.0-255,1484,65431,76,320789
16162,0.00221,172.217.194.0-255,7156,72587,76,320789
16163,0.002212,172.31.40.0-255,66,72653,76,320789
16164,0.002252,172.31.40.0-255,66,72719,76,320789
16165,0.004534,172.217.194.0-255,5738,78457,76,320789
16166,0.004539,172.31.40.0-255,66,78523,76,320789
16167,0.006834,172.217.194.0-255,5738,84261,76,320789
16168,0.00684,172.31.40.0-255,66,84327,76,320789
16169,0.009157,172.217.194.0-255,5738,90065,76,320789
16170,0.009163,172.31.40.0-255,66,90131,76,320789
16171,0.011505,172.217.194.0-255,5738,95869,76,320789
16172,0.011514,172.31.40.0-255,66,95935,76,320789
16173,0.013832,172.217.194.0-255,5738,101673,76,320789
16174,0.013842,172.31.40.0-255,66,101739,76,320789
16175,0.016211,172.217.194.0-255,5738,107477,76,320789
16176,0.01622,172.31.40.0-255,66,107543,76,320789
16177,0.018535,172.217.194.0-255,5738,113281,76,320789
16178,0.018547,172.31.40.0-255,66,113347,76,320789
16179,0.020853,172.217.194.0-255,5738,119085,76,320789
16180,0.020861,172.31.40.0-255,66,119151,76,320789
16181,0.02318,172.217.194.0-255,5738,124889,76,320789
16182,0.023188,172.31.40.0-255,66,124955,76,320789
16183,0.024745,172.31.40.0-255,172,125127,76,320789
16184,0.024776,172.31.40.0-255,1109,126236,76,320789
16185,0.024848,172.31.40.0-255,1514,127750,76,320789
16186,0.02485,172.31.40.0-255,1309,129059,76,320789
16187,0.025498,172.217.194.0-255,5738,134797,76,320789
16188,0.025505,172.31.40.0-255,66,134863,76,320789
16189,0.026226,104.244.42.0-255,66,134929,76,320789
16190,0.026266,104.244.42.0-255,66,134995,76,320789
16191,0.02637,104.244.42.0-255,66,135061,76,320789
16192,0.027855,172.217.194.0-255,5738,140799,76,320789
16193,0.027862,172.31.40.0-255,66,140865,76,320789
16194,0.03018,172.217.194.0-255,5738,146603,76,320789
16195,0.030185,172.31.40.0-255,66,146669,76,320789
16196,0.032479,172.217.194.0-255,5738,152407,76,320789
16197,0.032485,172.31.40.0-255,66,152473,76,320789
16198,0.034791,172.217.194.0-255,5738,158211,76,320789
16199,0.034798,172.31.40.0-255,66,158277,76,320789
16200,0.037115,172.217.194.0-255,5738,164015,76,320789
16201,0.037121,172.31.40.0-255,66,164081,76,320789
16202,0.039434,172.217.194.0-255,5738,169819,76,320789
16203,0.039439,172.31.40.0-255,66,169885,76,320789
16204,0.041783,172.217.194.0-255,5738,175623,76,320789
16205,0.041793,172.31.40.0-255,66,175689,76,320789
16206,0.044107,172.217.194.0-255,5738,181427,76,320789
16207,0.044114,172.31.40.0-255,66,181493,76,320789
16208,0.046406,172.217.194.0-255,5738,187231,76,320789
16209,0.046412,172.31.40.0-255,66,187297,76,320789
16210,0.048723,172.217.194.0-255,5738,193035,76,320789
16211,0.048732,172.31.40.0-255,66,193101,76,320789
16212,0.051031,172.217.194.0-255,5738,198839,76,320789
16213,0.05104,172.31.40.0-255,66,198905,76,320789
16214,0.053359,172.217.194.0-255,5738,204643,76,320789
16215,0.053366,172.31.40.0-255,66,204709,76,320789
16216,0.055676,172.217.194.0-255,5738,210447,76,320789
16217,0.055683,172.31.40.0-255,66,210513,76,320789
16218,0.058022,172.217.194.0-255,5738,216251,76,320789
16219,0.058028,172.31.40.0-255,66,216317,76,320789
16220,0.060322,172.217.194.0-255,5738,222055,76,320789
16221,0.060327,172.31.40.0-255,66,222121,76,320789
16222,0.06262,172.217.194.0-255,5738,227859,76,320789
16223,0.062627,172.31.40.0-255,66,227925,76,320789
16224,0.064955,172.217.194.0-255,5738,233663,76,320789
16225,0.064962,172.31.40.0-255,66,233729,76,320789
16226,0.06731,172.217.194.0-255,5738,239467,76,320789
16227,0.067316,172.31.40.0-255,66,239533,76,320789
16228,0.069646,172.217.194.0-255,5738,245271,76,320789
16229,0.069653,172.31.40.0-255,66,245337,76,320789
16230,0.071959,172.217.194.0-255,5738,251075,76,320789
16231,0.071966,172.31.40.0-255,66,251141,76,320789
16232,0.074275,172.217.194.0-255,5738,256879,76,320789
16233,0.074281,172.31.40.0-255,66,256945,76,320789
16234,0.076602,172.217.194.0-255,5738,262683,76,320789
16235,0.076609,172.31.40.0-255,66,262749,76,320789
16236,0.078925,172.217.194.0-255,5738,268487,76,320789
16237,0.078931,172.31.40.0-255,66,268553,76,320789
16238,0.081262,172.217.194.0-255,5738,274291,76,320789
16239,0.081273,172.31.40.0-255,66,274357,76,320789
16240,0.083566,172.217.194.0-255,5738,280095,76,320789
16241,0.083573,172.31.40.0-255,66,280161,76,320789
16242,0.085938,172.217.194.0-255,5738,285899,76,320789
16243,0.085956,172.31.40.0-255,66,285965,76,320789
16244,0.088263,172.217.194.0-255,5738,291703,76,320789
16245,0.08827,172.31.40.0-255,66,291769,76,320789
16246,0.090604,172.217.194.0-255,5738,297507,76,320789
16247,0.09061,172.31.40.0-255,66,297573,76,320789
16248,0.092923,172.217.194.0-255,5738,303311,76,320789
16249,0.092931,172.31.40.0-255,66,303377,76,320789
16250,0.095248,172.217.194.0-255,5738,309115,76,320789
16251,0.095255,172.31.40.0-255,66,309181,76,320789
16252,0.097546,172.217.194.0-255,5738,314919,76,320789
16253,0.097553,172.31.40.0-255,66,314985,76,320789
16254,0.099873,172.217.194.0-255,5738,320723,76,320789
16255,0.09988,172.31.40.0-255,66,320789,76,320789
16256,0.0,74.125.68.0-255,153,153,76,407499
16257,1e-05,172.31.40.0-255,66,219,76,407499
16258,1.5e-05,74.125.68.0-255,1484,1703,76,407499
16259,2e-05,172.31.40.0-255,66,1769,76,407499
16260,4.3e-05,74.125.68.0-255,2902,4671,76,407499
16261,4.7e-05,172.31.40.0-255,66,4737,76,407499
16262,7.6e-05,74.125.68.0-255,4320,9057,76,407499
16263,7.9e-05,172.31.40.0-255,66,9123,76,407499
16264,8.8e-05,74.125.68.0-255,4939,14062,76,407499
16265,9e-05,172.31.40.0-255,66,14128,76,407499
16266,0.000112,74.125.68.0-255,1484,15612,76,407499
16267,0.000114,172.31.40.0-255,66,15678,76,407499
16268,0.000145,74.125.68.0-255,4320,19998,76,407499
16269,0.000147,172.31.40.0-255,66,20064,76,407499
16270,0.000154,74.125.68.0-255,7156,27220,76,407499
16271,0.000156,172.31.40.0-255,66,27286,76,407499
16272,0.000161,74.125.68.0-255,3961,31247,76,407499
16273,0.000164,172.31.40.0-255,66,31313,76,407499
16274,0.000265,74.125.68.0-255,1484,32797,76,407499
16275,0.000269,172.31.40.0-255,66,32863,76,407499
16276,0.000299,74.125.68.0-255,2902,35765,76,407499
16277,0.000302,172.31.40.0-255,66,35831,76,407499
16278,0.000308,74.125.68.0-255,5738,41569,76,407499
16279,0.00031,172.31.40.0-255,66,41635,76,407499
16280,0.000315,74.125.68.0-255,5738,47373,76,407499
16281,0.000321,172.31.40.0-255,66,47439,76,407499
16282,0.000342,74.125.68.0-255,1484,48923,76,407499
16283,0.000344,172.31.40.0-255,66,48989,76,407499
16284,0.000374,74.125.68.0-255,5379,54368,76,407499
16285,0.00038,172.31.40.0-255,66,54434,76,407499
16286,0.000385,74.125.68.0-255,4320,58754,76,407499
16287,0.000387,172.31.40.0-255,66,58820,76,407499
16288,0.000393,74.125.68.0-255,5738,64558,76,407499
16289,0.000395,172.31.40.0-255,66,64624,76,407499
16290,0.000417,74.125.68.0-255,1395,66019,76,407499
16291,0.000465,74.125.68.0-255,135,66154,76,407499
16292,0.000561,74.125.68.0-255,1484,67638,76,407499
16293,0.000566,172.31.40.0-255,66,67704,76,407499
16294,0.000584,74.125.68.0-255,2902,70606,76,407499
16295,0.000587,172.31.40.0-255,66,70672,76,407499
16296,0.000617,74.125.68.0-255,5738,76410,76,407499
16297,0.00062,172.31.40.0-255,66,76476,76,407499
16298,0.000624,74.125.68.0-255,2902,79378,76,407499
16299,0.000625,172.31.40.0-255,66,79444,76,407499
16300,0.000655,74.125.68.0-255,4320,83764,76,407499
16301,0.000658,172.31.40.0-255,66,83830,76,407499
16302,0.000663,74.125.68.0-255,4320,88150,76,407499
16303,0.000664,172.31.40.0-255,66,88216,76,407499
16304,0.000689,74.125.68.0-255,4320,92536,76,407499
16305,0.000694,172.31.40.0-255,66,92602,76,407499
16306,0.000698,74.125.68.0-255,2902,95504,76,407499
16307,0.000701,172.31.40.0-255,66,95570,76,407499
16308,0.000737,74.125.68.0-255,5301,100871,76,407499
16309,0.00074,172.31.40.0-255,66,100937,76,407499
16310,0.001091,74.125.68.0-255,1484,102421,76,407499
16311,0.001112,74.125.68.0-255,2902,105323,76,407499
16312,0.001115,172.31.40.0-255,66,105389,76,407499
16313,0.001119,74.125.68.0-255,1484,106873,76,407499
16314,0.001149,74.125.68.0-255,4320,111193,76,407499
16315,0.001152,172.31.40.0-255,66,111259,76,407499
16316,0.001158,74.125.68.0-255,5738,116997,76,407499
16317,0.00116,172.31.40.0-255,66,117063,76,407499
16318,0.001168,74.125.68.0-255,7156,124219,76,407499
16319,0.001176,172.31.40.0-255,66,124285,76,407499
16320,0.00123,74.125.68.0-255,2902,127187,76,407499
16321,0.001233,172.31.40.0-255,66,127253,76,407499
16322,0.001265,172.31.40.0-255,66,127319,76,407499
16323,0.001311,74.125.68.0-255,1484,128803,76,407499
16324,0.001326,74.125.68.0-255,2902,131705,76,407499
16325,0.001329,172.31.40.0-255,66,131771,76,407499
16326,0.001359,74.125.68.0-255,5738,137509,76,407499
16327,0.001361,172.31.40.0-255,66,137575,76,407499
16328,0.001365,74.125.68.0-255,1484,139059,76,407499
16329,0.001397,74.125.68.0-255,5738,144797,76,407499
16330,0.001399,172.31.40.0-255,66,144863,76,407499
16331,0.001406,74.125.68.0-255,5738,150601,76,407499
16332,0.001408,172.31.40.0-255,66,150667,76,407499
16333,0.001429,74.125.68.0-255,7156,157823,76,407499
16334,0.001431,172.31.40.0-255,66,157889,76,407499
16335,0.001458,74.125.68.0-255,1484,159373,76,407499
16336,0.001477,74.125.68.0-255,2184,161557,76,407499
16337,0.001479,172.31.40.0-255,66,161623,76,407499
16338,0.001675,74.125.68.0-255,1484,163107,76,407499
16339,0.001681,74.125.68.0-255,2902,166009,76,407499
16340,0.001685,172.31.40.0-255,66,166075,76,407499
16341,0.001716,74.125.68.0-255,5738,171813,76,407499
16342,0.001719,172.31.40.0-255,66,171879,76,407499
16343,0.001726,74.125.68.0-255,7156,179035,76,407499
16344,0.001728,172.31.40.0-255,66,179101,76,407499
16345,0.001762,74.125.68.0-255,7156,186257,76,407499
16346,0.001766,172.31.40.0-255,66,186323,76,407499
16347,0.001799,74.125.68.0-255,7156,193479,76,407499
16348,0.001803,74.125.68.0-255,2184,195663,76,407499
16349,0.001807,172.31.40.0-255,66,195729,76,407499
16350,0.001816,172.31.40.0-255,66,195795,76,407499
16351,0.001938,74.125.68.0-255,1484,197279,76,407499
16352,0.001951,74.125.68.0-255,2902,200181,76,407499
16353,0.001955,172.31.40.0-255,66,200247,76,407499
16354,0.001959,74.125.68.0-255,1484,201731,76,407499
16355,0.001984,74.125.68.0-255,2902,204633,76,407499
16356,0.001987,172.31.40.0-255,66,204699,76,407499
16357,0.001994,74.125.68.0-255,7156,211855,76,407499
16358,0.001997,172.31.40.0-255,66,211921,76,407499
16359,0.002024,74.125.68.0-255,1484,213405,76,407499
16360,0.002031,74.125.68.0-255,5738,219143,76,407499
16361,0.002034,172.31.40.0-255,66,219209,76,407499
16362,0.002045,74.125.68.0-255,7156,226365,76,407499
16363,0.002048,172.31.40.0-255,66,226431,76,407499
16364,0.002051,74.125.68.0-255,1484,227915,76,407499
16365,0.002076,74.125.68.0-255,2184,230099,76,407499
16366,0.002079,172.31.40.0-255,66,230165,76,407499
16367,0.002232,74.125.68.0-255,1484,231649,76,407499
16368,0.002236,74.125.68.0-255,1484,233133,76,407499
16369,0.002239,172.31.40.0-255,66,233199,76,407499
16370,0.002269,74.125.68.0-255,1484,234683,76,407499
16371,0.002276,74.125.68.0-255,5738,240421,76,407499
16372,0.002278,172.31.40.0-255,66,240487,76,407499
16373,0.002283,74.125.68.0-255,2902,243389,76,407499
16374,0.002284,172.31.40.0-255,66,243455,76,407499
16375,0.002329,172.31.40.0-255,66,243521,76,407499
16376,0.004614,74.125.68.0-255,5738,249259,76,407499
16377,0.004621,172.31.40.0-255,66,249325,76,407499
16378,0.006903,74.125.68.0-255,4320,253645,76,407499
16379,0.006907,172.31.40.0-255,66,253711,76,407499
16380,0.006917,74.125.68.0-255,1484,255195,76,407499
16381,0.009192,74.125.68.0-255,4320,259515,76,407499
16382,0.009199,172.31.40.0-255,66,259581,76,407499
16383,0.011498,74.125.68.0-255,5738,265319,76,407499
16384,0.011505,172.31.40.0-255,66,265385,76,407499
16385,0.01379,74.125.68.0-255,5738,271123,76,407499
16386,0.013797,172.31.40.0-255,66,271189,76,407499
16387,0.016086,74.125.68.0-255,5738,276927,76,407499
16388,0.016094,172.31.40.0-255,66,276993,76,407499
16389,0.018386,74.125.68.0-255,5738,282731,76,407499
16390,0.018395,172.31.40.0-255,66,282797,76,407499
16391,0.02069,74.125.68.0-255,5738,288535,76,407499
16392,0.020698,172.31.40.0-255,66,288601,76,407499
16393,0.022988,74.125.68.0-255,5738,294339,76,407499
16394,0.022995,172.31.40.0-255,66,294405,76,407499
16395,0.02533,74.125.68.0-255,5738,300143,76,407499
16396,0.025337,172.31.40.0-255,66,300209,76,407499
16397,0.027636,74.125.68.0-255,5738,305947,76,407499
16398,0.027641,172.31.40.0-255,66,306013,76,407499
16399,0.028492,172.31.40.0-255,172,306185,76,407499
16400,0.028522,172.31.40.0-255,1107,307292,76,407499
16401,0.028584,172.31.40.0-255,1514,308806,76,407499
16402,0.028586,172.31.40.0-255,1309,310115,76,407499
16403,0.029934,74.125.68.0-255,5738,315853,76,407499
16404,0.029943,172.31.40.0-255,66,315919,76,407499
16405,0.030018,104.244.42.0-255,66,315985,76,407499
16406,0.030177,104.244.42.0-255,66,316051,76,407499
16407,0.030183,104.244.42.0-255,66,316117,76,407499
16408,0.032236,74.125.68.0-255,5738,321855,76,407499
16409,0.032244,172.31.40.0-255,66,321921,76,407499
16410,0.034537,74.125.68.0-255,5738,327659,76,407499
16411,0.034543,172.31.40.0-255,66,327725,76,407499
16412,0.036835,74.125.68.0-255,5738,333463,76,407499
16413,0.036841,172.31.40.0-255,66,333529,76,407499
16414,0.039137,74.125.68.0-255,5738,339267,76,407499
16415,0.039143,172.31.40.0-255,66,339333,76,407499
16416,0.041463,74.125.68.0-255,5738,345071,76,407499
16417,0.041469,172.31.40.0-255,66,345137,76,407499
16418,0.043752,74.125.68.0-255,5738,350875,76,407499
16419,0.04376,172.31.40.0-255,66,350941,76,407499
16420,0.046063,74.125.68.0-255,5738,356679,76,407499
16421,0.046069,172.31.40.0-255,66,356745,76,407499
16422,0.048365,74.125.68.0-255,5738,362483,76,407499
16423,0.048372,172.31.40.0-255,66,362549,76,407499
16424,0.050669,74.125.68.0-255,5738,368287,76,407499
16425,0.050675,172.31.40.0-255,66,368353,76,407499
16426,0.052972,74.125.68.0-255,5738,374091,76,407499
16427,0.052979,172.31.40.0-255,66,374157,76,407499
16428,0.055272,74.125.68.0-255,5738,379895,76,407499
16429,0.055279,172.31.40.0-255,66,379961,76,407499
16430,0.057595,74.125.68.0-255,5738,385699,76,407499
16431,0.057601,172.31.40.0-255,66,385765,76,407499
16432,0.059898,74.125.68.0-255,5738,391503,76,407499
16433,0.059904,172.31.40.0-255,66,391569,76,407499
16434,0.062203,74.125.68.0-255,5738,397307,76,407499
16435,0.062208,172.31.40.0-255,66,397373,76,407499
16436,0.064508,74.125.68.0-255,5738,403111,76,407499
16437,0.064515,172.31.40.0-255,66,403177,76,407499
16438,0.066795,74.125.68.0-255,4085,407262,76,407499
16439,0.0668,172.31.40.0-255,66,407328,76,407499
16440,0.066948,172.31.40.0-255,105,407433,76,407499
16441,0.069196,74.125.68.0-255,66,407499,76,407499
16442,0.0,74.125.68.0-255,152,152,76,360733
16443,1.7e-05,172.31.40.0-255,66,218,76,360733
16444,2.4e-05,74.125.68.0-255,1484,1702,76,360733
16445,3e-05,172.31.40.0-255,66,1768,76,360733
16446,3.6e-05,74.125.68.0-255,2902,4670,76,360733
16447,3.9e-05,172.31.40.0-255,66,4736,76,360733
16448,6.6e-05,74.125.68.0-255,7156,11892,76,360733
16449,6.8e-05,172.31.40.0-255,66,11958,76,360733
16450,7.3e-05,74.125.68.0-255,2063,14021,76,360733
16451,7.5e-05,172.31.40.0-255,66,14087,76,360733
16452,8e-05,74.125.68.0-255,2902,16989,76,360733
16453,8.3e-05,172.31.40.0-255,66,17055,76,360733
16454,0.000119,74.125.68.0-255,7156,24211,76,360733
16455,0.000122,172.31.40.0-255,66,24277,76,360733
16456,0.000127,74.125.68.0-255,4320,28597,76,360733
16457,0.000129,172.31.40.0-255,66,28663,76,360733
16458,0.000172,74.125.68.0-255,2543,31206,76,360733
16459,0.000175,172.31.40.0-255,66,31272,76,360733
16460,0.000707,74.125.68.0-255,1484,32756,76,360733
16461,0.000713,172.31.40.0-255,66,32822,76,360733
16462,0.00072,74.125.68.0-255,1484,34306,76,360733
16463,0.000722,172.31.40.0-255,66,34372,76,360733
16464,0.000743,74.125.68.0-255,2902,37274,76,360733
16465,0.000746,172.31.40.0-255,66,37340,76,360733
16466,0.000753,74.125.68.0-255,5738,43078,76,360733
16467,0.000755,172.31.40.0-255,66,43144,76,360733
16468,0.000785,74.125.68.0-255,5379,48523,76,360733
16469,0.000788,172.31.40.0-255,66,48589,76,360733
16470,0.000793,74.125.68.0-255,4320,52909,76,360733
16471,0.000795,172.31.40.0-255,66,52975,76,360733
16472,0.000816,74.125.68.0-255,1484,54459,76,360733
16473,0.000818,172.31.40.0-255,66,54525,76,360733
16474,0.000835,74.125.68.0-255,5738,60263,76,360733
16475,0.000837,172.31.40.0-255,66,60329,76,360733
16476,0.000856,74.125.68.0-255,5693,66022,76,360733
16477,0.000859,172.31.40.0-255,66,66088,76,360733
16478,0.001155,74.125.68.0-255,111,66199,76,360733
16479,0.001328,74.125.68.0-255,1484,67683,76,360733
16480,0.001335,172.31.40.0-255,66,67749,76,360733
16481,0.001341,74.125.68.0-255,1484,69233,76,360733
16482,0.001346,74.125.68.0-255,2902,72135,76,360733
16483,0.001348,172.31.40.0-255,66,72201,76,360733
16484,0.001351,74.125.68.0-255,1484,73685,76,360733
16485,0.001376,74.125.68.0-255,4320,78005,76,360733
16486,0.001379,172.31.40.0-255,66,78071,76,360733
16487,0.001385,74.125.68.0-255,4320,82391,76,360733
16488,0.001387,172.31.40.0-255,66,82457,76,360733
16489,0.001401,74.125.68.0-255,2543,85000,76,360733
16490,0.001403,172.31.40.0-255,66,85066,76,360733
16491,0.001411,74.125.68.0-255,7156,92222,76,360733
16492,0.001414,172.31.40.0-255,66,92288,76,360733
16493,0.001432,74.125.68.0-255,2902,95190,76,360733
16494,0.001435,172.31.40.0-255,66,95256,76,360733
16495,0.00146,74.125.68.0-255,5379,100635,76,360733
16496,0.001462,172.31.40.0-255,66,100701,76,360733
16497,0.002184,74.125.68.0-255,1484,102185,76,360733
16498,0.002203,74.125.68.0-255,2902,105087,76,360733
16499,0.002207,172.31.40.0-255,66,105153,76,360733
16500,0.002228,74.125.68.0-255,5738,110891,76,360733
16501,0.002231,172.31.40.0-255,66,110957,76,360733
16502,0.002262,74.125.68.0-255,4320,115277,76,360733
16503,0.002265,172.31.40.0-255,66,115343,76,360733
16504,0.002284,74.125.68.0-255,2902,118245,76,360733
16505,0.002287,172.31.40.0-255,66,118311,76,360733
16506,0.00229,74.125.68.0-255,1484,119795,76,360733
16507,0.002308,74.125.68.0-255,5738,125533,76,360733
16508,0.00231,172.31.40.0-255,66,125599,76,360733
16509,0.002327,74.125.68.0-255,1484,127083,76,360733
16510,0.00233,74.125.68.0-255,1484,128567,76,360733
16511,0.002332,172.31.40.0-255,66,128633,76,360733
16512,0.002349,74.125.68.0-255,2902,131535,76,360733
16513,0.002352,172.31.40.0-255,66,131601,76,360733
16514,0.002375,74.125.68.0-255,3602,135203,76,360733
16515,0.002377,172.31.40.0-255,66,135269,76,360733
16516,0.004766,74.125.68.0-255,1484,136753,76,360733
16517,0.004795,74.125.68.0-255,2902,139655,76,360733
16518,0.004799,172.31.40.0-255,66,139721,76,360733
16519,0.00481,74.125.68.0-255,1484,141205,76,360733
16520,0.007225,74.125.68.0-255,4320,145525,76,360733
16521,0.007231,172.31.40.0-255,66,145591,76,360733
16522,0.00966,74.125.68.0-255,2902,148493,76,360733
16523,0.009668,172.31.40.0-255,66,148559,76,360733
16524,0.009688,74.125.68.0-255,2902,151461,76,360733
16525,0.009691,172.31.40.0-255,66,151527,76,360733
16526,0.012126,74.125.68.0-255,5738,157265,76,360733
16527,0.012133,172.31.40.0-255,66,157331,76,360733
16528,0.014573,74.125.68.0-255,5738,163069,76,360733
16529,0.014583,172.31.40.0-255,66,163135,76,360733
16530,0.017018,74.125.68.0-255,5738,168873,76,360733
16531,0.017025,172.31.40.0-255,66,168939,76,360733
16532,0.019457,74.125.68.0-255,4320,173259,76,360733
16533,0.019465,172.31.40.0-255,66,173325,76,360733
16534,0.019487,74.125.68.0-255,1484,174809,76,360733
16535,0.021875,74.125.68.0-255,2902,177711,76,360733
16536,0.021881,172.31.40.0-255,66,177777,76,360733
16537,0.021904,74.125.68.0-255,1484,179261,76,360733
16538,0.024312,74.125.68.0-255,4320,183581,76,360733
16539,0.024319,172.31.40.0-255,66,183647,76,360733
16540,0.026745,74.125.68.0-255,5738,189385,76,360733
16541,0.026752,172.31.40.0-255,66,189451,76,360733
16542,0.028608,172.31.40.0-255,190,189641,76,360733
16543,0.028638,172.31.40.0-255,1107,190748,76,360733
16544,0.028695,172.31.40.0-255,1514,192262,76,360733
16545,0.028697,172.31.40.0-255,1309,193571,76,360733
16546,0.029179,74.125.68.0-255,5738,199309,76,360733
16547,0.029186,172.31.40.0-255,66,199375,76,360733
16548,0.030287,104.244.42.0-255,66,199441,76,360733
16549,0.030324,104.244.42.0-255,66,199507,76,360733
16550,0.03037,104.244.42.0-255,66,199573,76,360733
16551,0.031609,74.125.68.0-255,5738,205311,76,360733
16552,0.031614,172.31.40.0-255,66,205377,76,360733
16553,0.034095,74.125.68.0-255,5738,211115,76,360733
16554,0.0341,172.31.40.0-255,66,211181,76,360733
16555,0.036535,74.125.68.0-255,5738,216919,76,360733
16556,0.036542,172.31.40.0-255,66,216985,76,360733
16557,0.038995,74.125.68.0-255,5738,222723,76,360733
16558,0.039001,172.31.40.0-255,66,222789,76,360733
16559,0.041432,74.125.68.0-255,5738,228527,76,360733
16560,0.041438,172.31.40.0-255,66,228593,76,360733
16561,0.04388,74.125.68.0-255,5738,234331,76,360733
16562,0.043886,172.31.40.0-255,66,234397,76,360733
16563,0.046309,74.125.68.0-255,5738,240135,76,360733
16564,0.046314,172.31.40.0-255,66,240201,76,360733
16565,0.048744,74.125.68.0-255,5738,245939,76,360733
16566,0.04875,172.31.40.0-255,66,246005,76,360733
16567,0.051215,74.125.68.0-255,5738,251743,76,360733
16568,0.051227,172.31.40.0-255,66,251809,76,360733
16569,0.053661,74.125.68.0-255,4320,256129,76,360733
16570,0.053675,172.31.40.0-255,66,256195,76,360733
16571,0.053699,74.125.68.0-255,1484,257679,76,360733
16572,0.056115,74.125.68.0-255,4320,261999,76,360733
16573,0.056128,172.31.40.0-255,66,262065,76,360733
16574,0.058572,74.125.68.0-255,5738,267803,76,360733
16575,0.058587,172.31.40.0-255,66,267869,76,360733
16576,0.061005,74.125.68.0-255,5738,273607,76,360733
16577,0.061011,172.31.40.0-255,66,273673,76,360733
16578,0.063447,74.125.68.0-255,5738,279411,76,360733
16579,0.063457,172.31.40.0-255,66,279477,76,360733
16580,0.065904,74.125.68.0-255,5738,285215,76,360733
16581,0.065921,172.31.40.0-255,66,285281,76,360733
16582,0.068377,74.125.68.0-255,5738,291019,76,360733
16583,0.068395,172.31.40.0-255,66,291085,76,360733
16584,0.070839,74.125.68.0-255,5738,296823,76,360733
16585,0.070856,172.31.40.0-255,66,296889,76,360733
16586,0.073307,74.125.68.0-255,5738,302627,76,360733
16587,0.073325,172.31.40.0-255,66,302693,76,360733
16588,0.075757,74.125.68.0-255,5738,308431,76,360733
16589,0.075771,172.31.40.0-255,66,308497,76,360733
16590,0.078212,74.125.68.0-255,5738,314235,76,360733
16591,0.07823,172.31.40.0-255,66,314301,76,360733
16592,0.080683,74.125.68.0-255,5738,320039,76,360733
16593,0.0807,172.31.40.0-255,66,320105,76,360733
16594,0.083161,74.125.68.0-255,5738,325843,76,360733
16595,0.083179,172.31.40.0-255,66,325909,76,360733
16596,0.085641,74.125.68.0-255,5738,331647,76,360733
16597,0.085658,172.31.40.0-255,66,331713,76,360733
16598,0.088124,74.125.68.0-255,5738,337451,76,360733
16599,0.088142,172.31.40.0-255,66,337517,76,360733
16600,0.090579,74.125.68.0-255,5738,343255,76,360733
16601,0.090594,172.31.40.0-255,66,343321,76,360733
16602,0.093023,74.125.68.0-255,5738,349059,76,360733
16603,0.093031,172.31.40.0-255,66,349125,76,360733
16604,0.095488,74.125.68.0-255,5738,354863,76,360733
16605,0.095498,172.31.40.0-255,66,354929,76,360733
16606,0.097934,74.125.68.0-255,5738,360667,76,360733
16607,0.097952,172.31.40.0-255,66,360733,76,360733
16608,0.0,172.253.118.0-255,153,153,76,213780
16609,1.7e-05,172.31.40.0-255,66,219,76,213780
16610,2.4e-05,172.253.118.0-255,1484,1703,76,213780
16611,2.8e-05,172.31.40.0-255,66,1769,76,213780
16612,3.4e-05,172.253.118.0-255,2902,4671,76,213780
16613,3.9e-05,172.31.40.0-255,66,4737,76,213780
16614,4.5e-05,172.253.118.0-255,5738,10475,76,213780
16615,4.8e-05,172.31.40.0-255,66,10541,76,213780
16616,5.6e-05,172.253.118.0-255,6348,16889,76,213780
16617,5.9e-05,172.31.40.0-255,66,16955,76,213780
16618,6.6e-05,172.253.118.0-255,7156,24111,76,213780
16619,6.8e-05,172.31.40.0-255,66,24177,76,213780
16620,0.000122,172.253.118.0-255,6797,30974,76,213780
16621,0.000125,172.31.40.0-255,66,31040,76,213780
16622,0.000183,172.253.118.0-255,1484,32524,76,213780
16623,0.000187,172.31.40.0-255,66,32590,76,213780
16624,0.000203,172.253.118.0-255,1484,34074,76,213780
16625,0.000205,172.31.40.0-255,66,34140,76,213780
16626,0.000217,172.253.118.0-255,1484,35624,76,213780
16627,0.00022,172.31.40.0-255,66,35690,76,213780
16628,0.000227,172.253.118.0-255,5738,41428,76,213780
16629,0.000229,172.31.40.0-255,66,41494,76,213780
16630,0.000232,172.253.118.0-255,1484,42978,76,213780
16631,0.000233,172.31.40.0-255,66,43044,76,213780
16632,0.000257,172.253.118.0-255,2902,45946,76,213780
16633,0.00026,172.31.40.0-255,66,46012,76,213780
16634,0.000279,172.253.118.0-255,2902,48914,76,213780
16635,0.000282,172.31.40.0-255,66,48980,76,213780
16636,0.000295,172.253.118.0-255,1484,50464,76,213780
16637,0.000298,172.31.40.0-255,66,50530,76,213780
16638,0.000303,172.253.118.0-255,5738,56268,76,213780
16639,0.000306,172.31.40.0-255,66,56334,76,213780
16640,0.000362,172.253.118.0-255,5738,62072,76,213780
16641,0.000365,172.31.40.0-255,66,62138,76,213780
16642,0.000388,172.253.118.0-255,2902,65040,76,213780
16643,0.000391,172.31.40.0-255,66,65106,76,213780
16644,0.000394,172.253.118.0-255,766,65872,76,213780
16645,0.00041,172.253.118.0-255,677,66549,76,213780
16646,0.000605,172.253.118.0-255,1484,68033,76,213780
16647,0.00061,172.31.40.0-255,66,68099,76,213780
16648,0.000617,172.253.118.0-255,2902,71001,76,213780
16649,0.000619,172.31.40.0-255,66,71067,76,213780
16650,0.000653,172.253.118.0-255,5738,76805,76,213780
16651,0.000656,172.31.40.0-255,66,76871,76,213780
16652,0.000661,172.253.118.0-255,4320,81191,76,213780
16653,0.000663,172.31.40.0-255,66,81257,76,213780
16654,0.000685,172.253.118.0-255,4320,85577,76,213780
16655,0.000688,172.31.40.0-255,66,85643,76,213780
16656,0.000712,172.253.118.0-255,7156,92799,76,213780
16657,0.000715,172.31.40.0-255,66,92865,76,213780
16658,0.000726,172.31.40.0-255,66,92931,76,213780
16659,0.000898,172.253.118.0-255,1484,94415,76,213780
16660,0.000902,172.253.118.0-255,1484,95899,76,213780
16661,0.000905,172.31.40.0-255,66,95965,76,213780
16662,0.000918,172.253.118.0-255,1484,97449,76,213780
16663,0.000924,172.253.118.0-255,5738,103187,76,213780
16664,0.000938,172.31.40.0-255,66,103253,76,213780
16665,0.000961,172.31.40.0-255,66,103319,76,213780
16666,0.000982,172.253.118.0-255,2902,106221,76,213780
16667,0.000984,172.31.40.0-255,66,106287,76,213780
16668,0.000997,172.253.118.0-255,4320,110607,76,213780
16669,0.000999,172.31.40.0-255,66,110673,76,213780
16670,0.001028,172.31.40.0-255,66,110739,76,213780
16671,0.001034,172.253.118.0-255,5738,116477,76,213780
16672,0.001036,172.31.40.0-255,66,116543,76,213780
16673,0.001073,172.31.40.0-255,66,116609,76,213780
16674,0.001082,172.31.40.0-255,66,116675,76,213780
16675,0.001113,172.31.40.0-255,66,116741,76,213780
16676,0.001238,172.253.118.0-255,1484,118225,76,213780
16677,0.001242,172.253.118.0-255,1484,119709,76,213780
16678,0.001245,172.31.40.0-255,66,119775,76,213780
16679,0.001266,172.253.118.0-255,1484,121259,76,213780
16680,0.001273,172.253.118.0-255,5738,126997,76,213780
16681,0.001275,172.31.40.0-255,66,127063,76,213780
16682,0.001287,172.253.118.0-255,2902,129965,76,213780
16683,0.001289,172.31.40.0-255,66,130031,76,213780
16684,0.001312,172.31.40.0-255,66,130097,76,213780
16685,0.001317,172.253.118.0-255,5738,135835,76,213780
16686,0.001319,172.31.40.0-255,66,135901,76,213780
16687,0.001331,172.253.118.0-255,5020,140921,76,213780
16688,0.001333,172.31.40.0-255,66,140987,76,213780
16689,0.001431,172.253.118.0-255,1484,142471,76,213780
16690,0.001438,172.253.118.0-255,2902,145373,76,213780
16691,0.00144,172.31.40.0-255,66,145439,76,213780
16692,0.001497,172.253.118.0-255,5738,151177,76,213780
16693,0.0015,172.31.40.0-255,66,151243,76,213780
16694,0.001512,172.31.40.0-255,66,151309,76,213780
16695,0.001524,172.31.40.0-255,66,151375,76,213780
16696,0.001546,172.253.118.0-255,1484,152859,76,213780
16697,0.001558,172.253.118.0-255,4320,157179,76,213780
16698,0.001561,172.31.40.0-255,66,157245,76,213780
16699,0.001585,172.253.118.0-255,5738,162983,76,213780
16700,0.001587,172.31.40.0-255,66,163049,76,213780
16701,0.001591,172.253.118.0-255,2902,165951,76,213780
16702,0.001593,172.31.40.0-255,66,166017,76,213780
16703,0.00161,172.253.118.0-255,1484,167501,76,213780
16704,0.00165,172.31.40.0-255,66,167567,76,213780
16705,0.001655,172.253.118.0-255,3602,171169,76,213780
16706,0.001657,172.31.40.0-255,66,171235,76,213780
16707,0.001659,172.253.118.0-255,1484,172719,76,213780
16708,0.001676,172.253.118.0-255,4320,177039,76,213780
16709,0.001678,172.31.40.0-255,66,177105,76,213780
16710,0.001695,172.253.118.0-255,7156,184261,76,213780
16711,0.001698,172.31.40.0-255,66,184327,76,213780
16712,0.001727,172.31.40.0-255,66,184393,76,213780
16713,0.001736,172.31.40.0-255,66,184459,76,213780
16714,0.001761,172.253.118.0-255,1484,185943,76,213780
16715,0.001776,172.31.40.0-255,66,186009,76,213780
16716,0.001782,172.253.118.0-255,5738,191747,76,213780
16717,0.001784,172.31.40.0-255,66,191813,76,213780
16718,0.001807,172.31.40.0-255,66,191879,76,213780
16719,0.001829,172.253.118.0-255,1484,193363,76,213780
16720,0.001836,172.253.118.0-255,6438,199801,76,213780
16721,0.001838,172.31.40.0-255,66,199867,76,213780
16722,0.001853,172.253.118.0-255,4320,204187,76,213780
16723,0.001856,172.31.40.0-255,66,204253,76,213780
16724,0.001897,172.31.40.0-255,66,204319,76,213780
16725,0.001918,172.253.118.0-255,1484,205803,76,213780
16726,0.001928,172.31.40.0-255,66,205869,76,213780
16727,0.00195,172.253.118.0-255,2902,208771,76,213780
16728,0.001952,172.31.40.0-255,66,208837,76,213780
16729,0.002013,172.31.40.0-255,66,208903,76,213780
16730,0.00204,172.31.40.0-255,66,208969,76,213780
16731,0.002053,172.31.40.0-255,66,209035,76,213780
16732,0.002056,172.253.118.0-255,105,209140,76,213780
16733,0.002088,172.31.40.0-255,101,209241,76,213780
16734,0.004758,172.253.118.0-255,66,209307,76,213780
16735,0.009292,172.31.40.0-255,105,209412,76,213780
16736,0.011965,172.253.118.0-255,66,209478,76,213780
16737,0.029541,172.31.40.0-255,172,209650,76,213780
16738,0.029576,172.31.40.0-255,1105,210755,76,213780
16739,0.029643,172.31.40.0-255,1514,212269,76,213780
16740,0.029644,172.31.40.0-255,1313,213582,76,213780
16741,0.031152,104.244.42.0-255,66,213648,76,213780
16742,0.031178,104.244.42.0-255,66,213714,76,213780
16743,0.03127,104.244.42.0-255,66,213780,76,213780
16744,0.0,74.125.24.0-255,146,146,76,343250
16745,1.7e-05,172.31.40.0-255,66,212,76,343250
16746,2.3e-05,74.125.24.0-255,1484,1696,76,343250
16747,2.8e-05,172.31.40.0-255,66,1762,76,343250
16748,3.3e-05,74.125.24.0-255,2902,4664,76,343250
16749,3.7e-05,172.31.40.0-255,66,4730,76,343250
16750,4.4e-05,74.125.24.0-255,7156,11886,76,343250
16751,4.7e-05,172.31.40.0-255,66,11952,76,343250
16752,5.1e-05,74.125.24.0-255,2103,14055,76,343250
16753,5.4e-05,172.31.40.0-255,66,14121,76,343250
16754,0.000882,74.125.24.0-255,1484,15605,76,343250
16755,0.00089,172.31.40.0-255,66,15671,76,343250
16756,0.000899,74.125.24.0-255,2902,18573,76,343250
16757,0.000902,172.31.40.0-255,66,18639,76,343250
16758,0.000909,74.125.24.0-255,5738,24377,76,343250
16759,0.000911,172.31.40.0-255,66,24443,76,343250
16760,0.000925,74.125.24.0-255,1484,25927,76,343250
16761,0.000927,172.31.40.0-255,66,25993,76,343250
16762,0.000941,74.125.24.0-255,5379,31372,76,343250
16763,0.000944,172.31.40.0-255,66,31438,76,343250
16764,0.000948,74.125.24.0-255,2902,34340,76,343250
16765,0.00095,172.31.40.0-255,66,34406,76,343250
16766,0.000974,74.125.24.0-255,4320,38726,76,343250
16767,0.000977,172.31.40.0-255,66,38792,76,343250
16768,0.000988,172.31.40.0-255,66,38858,76,343250
16769,0.001017,74.125.24.0-255,1484,40342,76,343250
16770,0.00102,172.31.40.0-255,66,40408,76,343250
16771,0.001033,172.31.40.0-255,66,40474,76,343250
16772,0.001039,74.125.24.0-255,5314,45788,76,343250
16773,0.001042,172.31.40.0-255,66,45854,76,343250
16774,0.001097,74.125.24.0-255,382,46236,76,343250
16775,0.001102,172.31.40.0-255,66,46302,76,343250
16776,0.00129,74.125.24.0-255,1484,47786,76,343250
16777,0.001296,172.31.40.0-255,66,47852,76,343250
16778,0.001303,74.125.24.0-255,2902,50754,76,343250
16779,0.001306,172.31.40.0-255,66,50820,76,343250
16780,0.001312,74.125.24.0-255,5738,56558,76,343250
16781,0.001315,172.31.40.0-255,66,56624,76,343250
16782,0.001322,74.125.24.0-255,7156,63780,76,343250
16783,0.001324,172.31.40.0-255,66,63846,76,343250
16784,0.001362,172.31.40.0-255,66,63912,76,343250
16785,0.001366,74.125.24.0-255,2184,66096,76,343250
16786,0.001368,172.31.40.0-255,66,66162,76,343250
16787,0.001611,74.125.24.0-255,1484,67646,76,343250
16788,0.001613,172.31.40.0-255,66,67712,76,343250
16789,0.001618,74.125.24.0-255,2902,70614,76,343250
16790,0.001621,172.31.40.0-255,66,70680,76,343250
16791,0.001652,74.125.24.0-255,1484,72164,76,343250
16792,0.001654,172.31.40.0-255,66,72230,76,343250
16793,0.001675,74.125.24.0-255,4320,76550,76,343250
16794,0.001678,172.31.40.0-255,66,76616,76,343250
16795,0.001689,172.31.40.0-255,66,76682,76,343250
16796,0.001755,74.125.24.0-255,5020,81702,76,343250
16797,0.001821,74.125.24.0-255,1484,83186,76,343250
16798,0.001838,74.125.24.0-255,2902,86088,76,343250
16799,0.001841,74.125.24.0-255,1484,87572,76,343250
16800,0.00186,74.125.24.0-255,4320,91892,76,343250
16801,0.001896,74.125.24.0-255,1484,93376,76,343250
16802,0.001921,74.125.24.0-255,5738,99114,76,343250
16803,0.001937,74.125.24.0-255,5020,104134,76,343250
16804,0.002053,74.125.24.0-255,1484,105618,76,343250
16805,0.002073,74.125.24.0-255,2902,108520,76,343250
16806,0.00208,74.125.24.0-255,5738,114258,76,343250
16807,0.002099,74.125.24.0-255,7156,121414,76,343250
16808,0.002132,74.125.24.0-255,4320,125734,76,343250
16809,0.002147,74.125.24.0-255,5738,131472,76,343250
16810,0.002172,74.125.24.0-255,4320,135792,76,343250
16811,0.002176,74.125.24.0-255,2184,137976,76,343250
16812,0.002512,74.125.24.0-255,1484,139460,76,343250
16813,0.002517,74.125.24.0-255,2902,142362,76,343250
16814,0.002534,74.125.24.0-255,5738,148100,76,343250
16815,0.002551,74.125.24.0-255,4320,152420,76,343250
16816,0.002567,74.125.24.0-255,7156,159576,76,343250
16817,0.0026,74.125.24.0-255,7156,166732,76,343250
16818,0.002639,74.125.24.0-255,2902,169634,76,343250
16819,0.003712,172.31.40.0-255,66,169700,76,343250
16820,0.00632,74.125.24.0-255,5738,175438,76,343250
16821,0.006326,172.31.40.0-255,66,175504,76,343250
16822,0.008923,74.125.24.0-255,5738,181242,76,343250
16823,0.008933,172.31.40.0-255,66,181308,76,343250
16824,0.011518,74.125.24.0-255,5738,187046,76,343250
16825,0.011525,172.31.40.0-255,66,187112,76,343250
16826,0.014115,74.125.24.0-255,5738,192850,76,343250
16827,0.014127,172.31.40.0-255,66,192916,76,343250
16828,0.016709,74.125.24.0-255,5738,198654,76,343250
16829,0.016718,172.31.40.0-255,66,198720,76,343250
16830,0.019311,74.125.24.0-255,5738,204458,76,343250
16831,0.01932,172.31.40.0-255,66,204524,76,343250
16832,0.021932,74.125.24.0-255,5738,210262,76,343250
16833,0.02194,172.31.40.0-255,66,210328,76,343250
16834,0.024552,74.125.24.0-255,5738,216066,76,343250
16835,0.02456,172.31.40.0-255,66,216132,76,343250
16836,0.027175,74.125.24.0-255,5738,221870,76,343250
16837,0.027182,172.31.40.0-255,66,221936,76,343250
16838,0.029173,172.31.40.0-255,171,222107,76,343250
16839,0.029206,172.31.40.0-255,1131,223238,76,343250
16840,0.029265,172.31.40.0-255,1514,224752,76,343250
16841,0.029272,172.31.40.0-255,1285,226037,76,343250
16842,0.029783,74.125.24.0-255,5738,231775,76,343250
16843,0.02979,172.31.40.0-255,66,231841,76,343250
16844,0.030719,104.244.42.0-255,66,231907,76,343250
16845,0.030767,104.244.42.0-255,66,231973,76,343250
16846,0.030859,104.244.42.0-255,66,232039,76,343250
16847,0.032404,74.125.24.0-255,5738,237777,76,343250
16848,0.03241,172.31.40.0-255,66,237843,76,343250
16849,0.035011,74.125.24.0-255,5738,243581,76,343250
16850,0.035017,172.31.40.0-255,66,243647,76,343250
16851,0.037602,74.125.24.0-255,5738,249385,76,343250
16852,0.037609,172.31.40.0-255,66,249451,76,343250
16853,0.040265,74.125.24.0-255,5738,255189,76,343250
16854,0.040275,172.31.40.0-255,66,255255,76,343250
16855,0.042858,74.125.24.0-255,5738,260993,76,343250
16856,0.042865,172.31.40.0-255,66,261059,76,343250
16857,0.04546,74.125.24.0-255,5738,266797,76,343250
16858,0.045466,172.31.40.0-255,66,266863,76,343250
16859,0.048056,74.125.24.0-255,5738,272601,76,343250
16860,0.048065,172.31.40.0-255,66,272667,76,343250
16861,0.050653,74.125.24.0-255,5738,278405,76,343250
16862,0.050659,172.31.40.0-255,66,278471,76,343250
16863,0.053255,74.125.24.0-255,5738,284209,76,343250
16864,0.053267,172.31.40.0-255,66,284275,76,343250
16865,0.055875,74.125.24.0-255,5738,290013,76,343250
16866,0.055882,172.31.40.0-255,66,290079,76,343250
16867,0.058493,74.125.24.0-255,5738,295817,76,343250
16868,0.0585,172.31.40.0-255,66,295883,76,343250
16869,0.061091,74.125.24.0-255,5738,301621,76,343250
16870,0.061098,172.31.40.0-255,66,301687,76,343250
16871,0.063686,74.125.24.0-255,5738,307425,76,343250
16872,0.063693,172.31.40.0-255,66,307491,76,343250
16873,0.066295,74.125.24.0-255,5738,313229,76,343250
16874,0.066301,172.31.40.0-255,66,313295,76,343250
16875,0.068921,74.125.24.0-255,5738,319033,76,343250
16876,0.068928,172.31.40.0-255,66,319099,76,343250
16877,0.071529,74.125.24.0-255,5738,324837,76,343250
16878,0.071536,172.31.40.0-255,66,324903,76,343250
16879,0.074146,74.125.24.0-255,5738,330641,76,343250
16880,0.074154,172.31.40.0-255,66,330707,76,343250
16881,0.076769,74.125.24.0-255,5738,336445,76,343250
16882,0.076775,172.31.40.0-255,66,336511,76,343250
16883,0.079365,74.125.24.0-255,5738,342249,76,343250
16884,0.079372,172.31.40.0-255,66,342315,76,343250
16885,0.081934,74.125.24.0-255,698,343013,76,343250
16886,0.082068,172.31.40.0-255,66,343079,76,343250
16887,0.082105,172.31.40.0-255,105,343184,76,343250
16888,0.084658,74.125.24.0-255,66,343250,76,343250
16889,0.0,74.125.24.0-255,150,150,76,301703
16890,1.1e-05,172.31.40.0-255,66,216,76,301703
16891,3.4e-05,74.125.24.0-255,1484,1700,76,301703
16892,3.8e-05,172.31.40.0-255,66,1766,76,301703
16893,4.3e-05,74.125.24.0-255,2902,4668,76,301703
16894,4.5e-05,172.31.40.0-255,66,4734,76,301703
16895,7.7e-05,74.125.24.0-255,7156,11890,76,301703
16896,8e-05,172.31.40.0-255,66,11956,76,301703
16897,8.3e-05,74.125.24.0-255,2101,14057,76,301703
16898,8.5e-05,172.31.40.0-255,66,14123,76,301703
16899,0.000223,74.125.24.0-255,1484,15607,76,301703
16900,0.000227,172.31.40.0-255,66,15673,76,301703
16901,0.000233,74.125.24.0-255,2902,18575,76,301703
16902,0.000235,172.31.40.0-255,66,18641,76,301703
16903,0.000239,74.125.24.0-255,2902,21543,76,301703
16904,0.000242,172.31.40.0-255,66,21609,76,301703
16905,0.000258,74.125.24.0-255,2902,24511,76,301703
16906,0.00026,172.31.40.0-255,66,24577,76,301703
16907,0.000267,74.125.24.0-255,6797,31374,76,301703
16908,0.000269,172.31.40.0-255,66,31440,76,301703
16909,0.000375,74.125.24.0-255,1484,32924,76,301703
16910,0.000379,172.31.40.0-255,66,32990,76,301703
16911,0.000384,74.125.24.0-255,2902,35892,76,301703
16912,0.000387,172.31.40.0-255,66,35958,76,301703
16913,0.000406,74.125.24.0-255,5738,41696,76,301703
16914,0.000409,172.31.40.0-255,66,41762,76,301703
16915,0.00043,74.125.24.0-255,4320,46082,76,301703
16916,0.000433,172.31.40.0-255,66,46148,76,301703
16917,0.000454,74.125.24.0-255,2543,48691,76,301703
16918,0.000456,172.31.40.0-255,66,48757,76,301703
16919,0.000461,74.125.24.0-255,2902,51659,76,301703
16920,0.000463,172.31.40.0-255,66,51725,76,301703
16921,0.000477,74.125.24.0-255,2902,54627,76,301703
16922,0.000479,172.31.40.0-255,66,54693,76,301703
16923,0.000501,74.125.24.0-255,5738,60431,76,301703
16924,0.000503,172.31.40.0-255,66,60497,76,301703
16925,0.000517,74.125.24.0-255,1484,61981,76,301703
16926,0.000523,74.125.24.0-255,4231,66212,76,301703
16927,0.000525,172.31.40.0-255,66,66278,76,301703
16928,0.000573,74.125.24.0-255,132,66410,76,301703
16929,0.000612,74.125.24.0-255,349,66759,76,301703
16930,0.000776,74.125.24.0-255,1484,68243,76,301703
16931,0.00078,172.31.40.0-255,66,68309,76,301703
16932,0.000794,74.125.24.0-255,2902,71211,76,301703
16933,0.000798,74.125.24.0-255,4320,75531,76,301703
16934,0.000801,172.31.40.0-255,66,75597,76,301703
16935,0.000803,172.31.40.0-255,66,75663,76,301703
16936,0.000822,74.125.24.0-255,1484,77147,76,301703
16937,0.000827,74.125.24.0-255,4320,81467,76,301703
16938,0.00083,172.31.40.0-255,66,81533,76,301703
16939,0.000844,74.125.24.0-255,2902,84435,76,301703
16940,0.000846,172.31.40.0-255,66,84501,76,301703
16941,0.000861,74.125.24.0-255,7156,91657,76,301703
16942,0.000863,172.31.40.0-255,66,91723,76,301703
16943,0.000886,74.125.24.0-255,1484,93207,76,301703
16944,0.000896,172.31.40.0-255,66,93273,76,301703
16945,0.001496,74.125.24.0-255,1484,94757,76,301703
16946,0.001505,74.125.24.0-255,2902,97659,76,301703
16947,0.001509,172.31.40.0-255,66,97725,76,301703
16948,0.001516,74.125.24.0-255,5738,103463,76,301703
16949,0.001518,172.31.40.0-255,66,103529,76,301703
16950,0.001538,74.125.24.0-255,2902,106431,76,301703
16951,0.00154,172.31.40.0-255,66,106497,76,301703
16952,0.001556,74.125.24.0-255,2902,109399,76,301703
16953,0.001558,172.31.40.0-255,66,109465,76,301703
16954,0.001591,172.31.40.0-255,66,109531,76,301703
16955,0.001595,74.125.24.0-255,2902,112433,76,301703
16956,0.001597,172.31.40.0-255,66,112499,76,301703
16957,0.001614,74.125.24.0-255,2184,114683,76,301703
16958,0.001616,172.31.40.0-255,66,114749,76,301703
16959,0.002424,74.125.24.0-255,1484,116233,76,301703
16960,0.002432,74.125.24.0-255,2902,119135,76,301703
16961,0.002436,172.31.40.0-255,66,119201,76,301703
16962,0.002442,74.125.24.0-255,2902,122103,76,301703
16963,0.002444,172.31.40.0-255,66,122169,76,301703
16964,0.002486,74.125.24.0-255,2902,125071,76,301703
16965,0.002488,172.31.40.0-255,66,125137,76,301703
16966,0.002501,172.31.40.0-255,66,125203,76,301703
16967,0.002507,74.125.24.0-255,5738,130941,76,301703
16968,0.00251,172.31.40.0-255,66,131007,76,301703
16969,0.002532,74.125.24.0-255,5738,136745,76,301703
16970,0.002534,172.31.40.0-255,66,136811,76,301703
16971,0.002538,74.125.24.0-255,2184,138995,76,301703
16972,0.002541,172.31.40.0-255,66,139061,76,301703
16973,0.002673,74.125.24.0-255,1484,140545,76,301703
16974,0.002678,74.125.24.0-255,2902,143447,76,301703
16975,0.002681,172.31.40.0-255,66,143513,76,301703
16976,0.002702,74.125.24.0-255,5738,149251,76,301703
16977,0.002705,172.31.40.0-255,66,149317,76,301703
16978,0.002726,74.125.24.0-255,5738,155055,76,301703
16979,0.002729,172.31.40.0-255,66,155121,76,301703
16980,0.002755,74.125.24.0-255,5738,160859,76,301703
16981,0.002757,172.31.40.0-255,66,160925,76,301703
16982,0.002769,172.31.40.0-255,66,160991,76,301703
16983,0.002784,74.125.24.0-255,3602,164593,76,301703
16984,0.002787,172.31.40.0-255,66,164659,76,301703
16985,0.002794,74.125.24.0-255,7156,171815,76,301703
16986,0.002797,172.31.40.0-255,66,171881,76,301703
16987,0.002821,74.125.24.0-255,2902,174783,76,301703
16988,0.002824,172.31.40.0-255,66,174849,76,301703
16989,0.002844,74.125.24.0-255,4320,179169,76,301703
16990,0.002847,172.31.40.0-255,66,179235,76,301703
16991,0.002869,172.31.40.0-255,66,179301,76,301703
16992,0.002892,74.125.24.0-255,4320,183621,76,301703
16993,0.002894,172.31.40.0-255,66,183687,76,301703
16994,0.0029,74.125.24.0-255,5020,188707,76,301703
16995,0.002903,172.31.40.0-255,66,188773,76,301703
16996,0.002941,74.125.24.0-255,1484,190257,76,301703
16997,0.002974,74.125.24.0-255,2902,193159,76,301703
16998,0.002977,172.31.40.0-255,66,193225,76,301703
16999,0.003018,74.125.24.0-255,2902,196127,76,301703
17000,0.003021,172.31.40.0-255,66,196193,76,301703
17001,0.003044,74.125.24.0-255,2902,199095,76,301703
17002,0.003046,172.31.40.0-255,66,199161,76,301703
17003,0.003064,172.31.40.0-255,66,199227,76,301703
17004,0.003069,74.125.24.0-255,4320,203547,76,301703
17005,0.003071,172.31.40.0-255,66,203613,76,301703
17006,0.003074,74.125.24.0-255,1484,205097,76,301703
17007,0.003079,74.125.24.0-255,2902,207999,76,301703
17008,0.003082,172.31.40.0-255,66,208065,76,301703
17009,0.003098,74.125.24.0-255,2184,210249,76,301703
17010,0.0031,172.31.40.0-255,66,210315,76,301703
17011,0.003146,74.125.24.0-255,1484,211799,76,301703
17012,0.003161,74.125.24.0-255,2902,214701,76,301703
17013,0.003165,172.31.40.0-255,66,214767,76,301703
17014,0.003168,74.125.24.0-255,1484,216251,76,301703
17015,0.003189,74.125.24.0-255,4320,220571,76,301703
17016,0.003192,172.31.40.0-255,66,220637,76,301703
17017,0.003209,74.125.24.0-255,5738,226375,76,301703
17018,0.003212,172.31.40.0-255,66,226441,76,301703
17019,0.003226,74.125.24.0-255,4320,230761,76,301703
17020,0.003228,172.31.40.0-255,66,230827,76,301703
17021,0.003234,74.125.24.0-255,4320,235147,76,301703
17022,0.003236,172.31.40.0-255,66,235213,76,301703
17023,0.003265,172.31.40.0-255,66,235279,76,301703
17024,0.003298,74.125.24.0-255,1484,236763,76,301703
17025,0.003323,172.31.40.0-255,66,236829,76,301703
17026,0.00333,74.125.24.0-255,5738,242567,76,301703
17027,0.003332,172.31.40.0-255,66,242633,76,301703
17028,0.003355,172.31.40.0-255,66,242699,76,301703
17029,0.003362,74.125.24.0-255,6438,249137,76,301703
17030,0.003364,172.31.40.0-255,66,249203,76,301703
17031,0.003404,74.125.24.0-255,1484,250687,76,301703
17032,0.003424,74.125.24.0-255,4320,255007,76,301703
17033,0.003427,172.31.40.0-255,66,255073,76,301703
17034,0.003444,74.125.24.0-255,4320,259393,76,301703
17035,0.003447,172.31.40.0-255,66,259459,76,301703
17036,0.003486,172.31.40.0-255,66,259525,76,301703
17037,0.00349,74.125.24.0-255,2902,262427,76,301703
17038,0.003491,172.31.40.0-255,66,262493,76,301703
17039,0.00352,172.31.40.0-255,66,262559,76,301703
17040,0.003539,74.125.24.0-255,4320,266879,76,301703
17041,0.003541,172.31.40.0-255,66,266945,76,301703
17042,0.003551,74.125.24.0-255,1484,268429,76,301703
17043,0.003556,74.125.24.0-255,2902,271331,76,301703
17044,0.003558,172.31.40.0-255,66,271397,76,301703
17045,0.00358,74.125.24.0-255,4320,275717,76,301703
17046,0.003582,172.31.40.0-255,66,275783,76,301703
17047,0.003587,74.125.24.0-255,4320,280103,76,301703
17048,0.003589,172.31.40.0-255,66,280169,76,301703
17049,0.003607,74.125.24.0-255,2902,283071,76,301703
17050,0.00361,172.31.40.0-255,66,283137,76,301703
17051,0.003637,74.125.24.0-255,7156,290293,76,301703
17052,0.00364,172.31.40.0-255,66,290359,76,301703
17053,0.003644,74.125.24.0-255,4320,294679,76,301703
17054,0.003646,172.31.40.0-255,66,294745,76,301703
17055,0.003665,74.125.24.0-255,2184,296929,76,301703
17056,0.003667,172.31.40.0-255,66,296995,76,301703
17057,0.003678,172.31.40.0-255,66,297061,76,301703
17058,0.003681,74.125.24.0-255,105,297166,76,301703
17059,0.005416,172.31.40.0-255,66,297232,76,301703
17060,0.005447,172.31.40.0-255,105,297337,76,301703
17061,0.007568,74.125.24.0-255,66,297403,76,301703
17062,0.033207,172.31.40.0-255,172,297575,76,301703
17063,0.033241,172.31.40.0-255,1107,298682,76,301703
17064,0.033298,172.31.40.0-255,1514,300196,76,301703
17065,0.033301,172.31.40.0-255,1309,301505,76,301703
17066,0.034891,104.244.42.0-255,66,301571,76,301703
17067,0.034929,104.244.42.0-255,66,301637,76,301703
17068,0.034993,104.244.42.0-255,66,301703,76,301703
17069,0.0,74.125.24.0-255,153,153,76,335202
17070,1.4e-05,172.31.40.0-255,66,219,76,335202
17071,2.1e-05,74.125.24.0-255,1484,1703,76,335202
17072,2.5e-05,172.31.40.0-255,66,1769,76,335202
17073,3e-05,74.125.24.0-255,2902,4671,76,335202
17074,3.3e-05,172.31.40.0-255,66,4737,76,335202
17075,4e-05,74.125.24.0-255,4320,9057,76,335202
17076,4.3e-05,172.31.40.0-255,66,9123,76,335202
17077,6.6e-05,74.125.24.0-255,2902,12025,76,335202
17078,6.9e-05,172.31.40.0-255,66,12091,76,335202
17079,7.3e-05,74.125.24.0-255,1484,13575,76,335202
17080,7.5e-05,172.31.40.0-255,66,13641,76,335202
17081,8.9e-05,172.31.40.0-255,66,13707,76,335202
17082,0.000105,74.125.24.0-255,2104,15811,76,335202
17083,0.000108,172.31.40.0-255,66,15877,76,335202
17084,0.000112,74.125.24.0-255,2543,18420,76,335202
17085,0.000114,172.31.40.0-255,66,18486,76,335202
17086,0.000427,74.125.24.0-255,1484,19970,76,335202
17087,0.000432,172.31.40.0-255,66,20036,76,335202
17088,0.00044,74.125.24.0-255,2902,22938,76,335202
17089,0.000442,172.31.40.0-255,66,23004,76,335202
17090,0.000449,74.125.24.0-255,5738,28742,76,335202
17091,0.000451,172.31.40.0-255,66,28808,76,335202
17092,0.00049,172.31.40.0-255,66,28874,76,335202
17093,0.000495,74.125.24.0-255,4320,33194,76,335202
17094,0.000497,172.31.40.0-255,66,33260,76,335202
17095,0.000519,74.125.24.0-255,6438,39698,76,335202
17096,0.000521,172.31.40.0-255,66,39764,76,335202
17097,0.000558,74.125.24.0-255,648,40412,76,335202
17098,0.000561,172.31.40.0-255,66,40478,76,335202
17099,0.000594,74.125.24.0-255,1484,41962,76,335202
17100,0.00062,74.125.24.0-255,4320,46282,76,335202
17101,0.000624,172.31.40.0-255,66,46348,76,335202
17102,0.000655,172.31.40.0-255,66,46414,76,335202
17103,0.000681,74.125.24.0-255,1484,47898,76,335202
17104,0.000695,74.125.24.0-255,1484,49382,76,335202
17105,0.000697,172.31.40.0-255,66,49448,76,335202
17106,0.000719,74.125.24.0-255,5738,55186,76,335202
17107,0.000722,172.31.40.0-255,66,55252,76,335202
17108,0.000734,74.125.24.0-255,1484,56736,76,335202
17109,0.000737,74.125.24.0-255,1484,58220,76,335202
17110,0.00074,172.31.40.0-255,66,58286,76,335202
17111,0.00076,74.125.24.0-255,6438,64724,76,335202
17112,0.000763,172.31.40.0-255,66,64790,76,335202
17113,0.00095,74.125.24.0-255,1484,66274,76,335202
17114,0.000969,74.125.24.0-255,2902,69176,76,335202
17115,0.000973,172.31.40.0-255,66,69242,76,335202
17116,0.00098,74.125.24.0-255,5738,74980,76,335202
17117,0.000982,172.31.40.0-255,66,75046,76,335202
17118,0.000985,74.125.24.0-255,1484,76530,76,335202
17119,0.001008,74.125.24.0-255,7156,83686,76,335202
17120,0.001011,172.31.40.0-255,66,83752,76,335202
17121,0.001076,172.31.40.0-255,66,83818,76,335202
17122,0.001107,74.125.24.0-255,1484,85302,76,335202
17123,0.001126,74.125.24.0-255,1484,86786,76,335202
17124,0.001129,172.31.40.0-255,66,86852,76,335202
17125,0.001152,74.125.24.0-255,1484,88336,76,335202
17126,0.001159,74.125.24.0-255,5738,94074,76,335202
17127,0.001162,172.31.40.0-255,66,94140,76,335202
17128,0.001168,74.125.24.0-255,4320,98460,76,335202
17129,0.00117,172.31.40.0-255,66,98526,76,335202
17130,0.001182,172.31.40.0-255,66,98592,76,335202
17131,0.001208,74.125.24.0-255,1484,100076,76,335202
17132,0.00122,172.31.40.0-255,66,100142,76,335202
17133,0.001617,74.125.24.0-255,1484,101626,76,335202
17134,0.001633,74.125.24.0-255,2902,104528,76,335202
17135,0.001637,172.31.40.0-255,66,104594,76,335202
17136,0.001649,74.125.24.0-255,1484,106078,76,335202
17137,0.001668,74.125.24.0-255,2902,108980,76,335202
17138,0.001671,172.31.40.0-255,66,109046,76,335202
17139,0.001681,172.31.40.0-255,66,109112,76,335202
17140,0.001726,74.125.24.0-255,4320,113432,76,335202
17141,0.001729,172.31.40.0-255,66,113498,76,335202
17142,0.001754,172.31.40.0-255,66,113564,76,335202
17143,0.001759,74.125.24.0-255,2902,116466,76,335202
17144,0.00176,172.31.40.0-255,66,116532,76,335202
17145,0.001789,74.125.24.0-255,766,117298,76,335202
17146,0.002418,172.31.40.0-255,66,117364,76,335202
17147,0.003987,74.125.24.0-255,4320,121684,76,335202
17148,0.003994,172.31.40.0-255,66,121750,76,335202
17149,0.004621,74.125.24.0-255,1484,123234,76,335202
17150,0.006218,74.125.24.0-255,4320,127554,76,335202
17151,0.006224,172.31.40.0-255,66,127620,76,335202
17152,0.008461,74.125.24.0-255,5738,133358,76,335202
17153,0.008467,172.31.40.0-255,66,133424,76,335202
17154,0.010703,74.125.24.0-255,5738,139162,76,335202
17155,0.01071,172.31.40.0-255,66,139228,76,335202
17156,0.012945,74.125.24.0-255,5738,144966,76,335202
17157,0.012953,172.31.40.0-255,66,145032,76,335202
17158,0.015181,74.125.24.0-255,5738,150770,76,335202
17159,0.015189,172.31.40.0-255,66,150836,76,335202
17160,0.017417,74.125.24.0-255,5738,156574,76,335202
17161,0.017425,172.31.40.0-255,66,156640,76,335202
17162,0.019651,74.125.24.0-255,5738,162378,76,335202
17163,0.019664,172.31.40.0-255,66,162444,76,335202
17164,0.02192,74.125.24.0-255,5738,168182,76,335202
17165,0.02193,172.31.40.0-255,66,168248,76,335202
17166,0.024173,74.125.24.0-255,5738,173986,76,335202
17167,0.024181,172.31.40.0-255,66,174052,76,335202
17168,0.026442,74.125.24.0-255,5738,179790,76,335202
17169,0.02645,172.31.40.0-255,66,179856,76,335202
17170,0.028717,74.125.24.0-255,5738,185594,76,335202
17171,0.028726,172.31.40.0-255,66,185660,76,335202
17172,0.030936,74.125.24.0-255,5738,191398,76,335202
17173,0.030943,172.31.40.0-255,66,191464,76,335202
17174,0.031595,172.31.40.0-255,176,191640,76,335202
17175,0.031623,172.31.40.0-255,1107,192747,76,335202
17176,0.031701,172.31.40.0-255,1514,194261,76,335202
17177,0.031703,172.31.40.0-255,1311,195572,76,335202
17178,0.033128,104.244.42.0-255,66,195638,76,335202
17179,0.033171,104.244.42.0-255,66,195704,76,335202
17180,0.033177,74.125.24.0-255,5738,201442,76,335202
17181,0.033182,172.31.40.0-255,66,201508,76,335202
17182,0.033265,104.244.42.0-255,66,201574,76,335202
17183,0.035408,74.125.24.0-255,5738,207312,76,335202
17184,0.035415,172.31.40.0-255,66,207378,76,335202
17185,0.037649,74.125.24.0-255,5738,213116,76,335202
17186,0.037656,172.31.40.0-255,66,213182,76,335202
17187,0.039957,74.125.24.0-255,5738,218920,76,335202
17188,0.039964,172.31.40.0-255,66,218986,76,335202
17189,0.042202,74.125.24.0-255,5738,224724,76,335202
17190,0.042211,172.31.40.0-255,66,224790,76,335202
17191,0.044458,74.125.24.0-255,5738,230528,76,335202
17192,0.044464,172.31.40.0-255,66,230594,76,335202
17193,0.04671,74.125.24.0-255,5738,236332,76,335202
17194,0.046717,172.31.40.0-255,66,236398,76,335202
17195,0.048948,74.125.24.0-255,5738,242136,76,335202
17196,0.048955,172.31.40.0-255,66,242202,76,335202
17197,0.051204,74.125.24.0-255,5738,247940,76,335202
17198,0.051208,172.31.40.0-255,66,248006,76,335202
17199,0.053434,74.125.24.0-255,5738,253744,76,335202
17200,0.05344,172.31.40.0-255,66,253810,76,335202
17201,0.055657,74.125.24.0-255,5738,259548,76,335202
17202,0.055664,172.31.40.0-255,66,259614,76,335202
17203,0.057889,74.125.24.0-255,5738,265352,76,335202
17204,0.057896,172.31.40.0-255,66,265418,76,335202
17205,0.060154,74.125.24.0-255,5738,271156,76,335202
17206,0.060162,172.31.40.0-255,66,271222,76,335202
17207,0.062401,74.125.24.0-255,5738,276960,76,335202
17208,0.062408,172.31.40.0-255,66,277026,76,335202
17209,0.064645,74.125.24.0-255,5738,282764,76,335202
17210,0.064652,172.31.40.0-255,66,282830,76,335202
17211,0.066894,74.125.24.0-255,5738,288568,76,335202
17212,0.0669,172.31.40.0-255,66,288634,76,335202
17213,0.069135,74.125.24.0-255,5738,294372,76,335202
17214,0.069141,172.31.40.0-255,66,294438,76,335202
17215,0.071391,74.125.24.0-255,5738,300176,76,335202
17216,0.071397,172.31.40.0-255,66,300242,76,335202
17217,0.073633,74.125.24.0-255,5738,305980,76,335202
17218,0.073639,172.31.40.0-255,66,306046,76,335202
17219,0.075867,74.125.24.0-255,5738,311784,76,335202
17220,0.075874,172.31.40.0-255,66,311850,76,335202
17221,0.078107,74.125.24.0-255,5738,317588,76,335202
17222,0.07811,172.31.40.0-255,66,317654,76,335202
17223,0.080328,74.125.24.0-255,5738,323392,76,335202
17224,0.080334,172.31.40.0-255,66,323458,76,335202
17225,0.08256,74.125.24.0-255,5738,329196,76,335202
17226,0.082567,172.31.40.0-255,66,329262,76,335202
17227,0.084808,74.125.24.0-255,5703,334965,76,335202
17228,0.084815,172.31.40.0-255,66,335031,76,335202
17229,0.084989,172.31.40.0-255,105,335136,76,335202
17230,0.087201,74.125.24.0-255,66,335202,76,335202
17231,0.0,172.217.194.0-255,291,291,76,271178
17232,2.2e-05,172.31.40.0-255,66,357,76,271178
17233,2.8e-05,172.217.194.0-255,1484,1841,76,271178
17234,3.2e-05,172.31.40.0-255,66,1907,76,271178
17235,3.8e-05,172.217.194.0-255,4320,6227,76,271178
17236,4.7e-05,172.31.40.0-255,66,6293,76,271178
17237,8.7e-05,172.31.40.0-255,66,6359,76,271178
17238,9.3e-05,172.217.194.0-255,4320,10679,76,271178
17239,9.5e-05,172.31.40.0-255,66,10745,76,271178
17240,0.00012,172.217.194.0-255,2902,13647,76,271178
17241,0.000122,172.31.40.0-255,66,13713,76,271178
17242,0.000155,172.31.40.0-255,66,13779,76,271178
17243,0.002129,172.217.194.0-255,1484,15263,76,271178
17244,0.002135,172.31.40.0-255,66,15329,76,271178
17245,0.002144,172.217.194.0-255,2902,18231,76,271178
17246,0.002147,172.31.40.0-255,66,18297,76,271178
17247,0.002158,172.217.194.0-255,5738,24035,76,271178
17248,0.00216,172.31.40.0-255,66,24101,76,271178
17249,0.002182,172.217.194.0-255,2902,27003,76,271178
17250,0.002184,172.31.40.0-255,66,27069,76,271178
17251,0.002208,172.217.194.0-255,3961,31030,76,271178
17252,0.00221,172.31.40.0-255,66,31096,76,271178
17253,0.002213,172.217.194.0-255,1484,32580,76,271178
17254,0.002214,172.31.40.0-255,66,32646,76,271178
17255,0.002255,172.31.40.0-255,66,32712,76,271178
17256,0.002259,172.217.194.0-255,2796,35508,76,271178
17257,0.002261,172.31.40.0-255,66,35574,76,271178
17258,0.004678,172.217.194.0-255,2902,38476,76,271178
17259,0.004685,172.31.40.0-255,66,38542,76,271178
17260,0.004714,172.217.194.0-255,2902,41444,76,271178
17261,0.004716,172.31.40.0-255,66,41510,76,271178
17262,0.0071,172.217.194.0-255,2902,44412,76,271178
17263,0.007106,172.31.40.0-255,66,44478,76,271178
17264,0.007125,172.217.194.0-255,2902,47380,76,271178
17265,0.007128,172.31.40.0-255,66,47446,76,271178
17266,0.009505,172.217.194.0-255,2902,50348,76,271178
17267,0.009518,172.31.40.0-255,66,50414,76,271178
17268,0.009598,172.217.194.0-255,2902,53316,76,271178
17269,0.009603,172.31.40.0-255,66,53382,76,271178
17270,0.011951,172.217.194.0-255,2902,56284,76,271178
17271,0.011962,172.31.40.0-255,66,56350,76,271178
17272,0.011997,172.217.194.0-255,2902,59252,76,271178
17273,0.012002,172.31.40.0-255,66,59318,76,271178
17274,0.014392,172.217.194.0-255,2902,62220,76,271178
17275,0.014404,172.31.40.0-255,66,62286,76,271178
17276,0.014434,172.217.194.0-255,2902,65188,76,271178
17277,0.014438,172.31.40.0-255,66,65254,76,271178
17278,0.016806,172.217.194.0-255,2902,68156,76,271178
17279,0.016813,172.31.40.0-255,66,68222,76,271178
17280,0.016872,172.217.194.0-255,2902,71124,76,271178
17281,0.016878,172.31.40.0-255,66,71190,76,271178
17282,0.019241,172.217.194.0-255,2902,74092,76,271178
17283,0.019248,172.31.40.0-255,66,74158,76,271178
17284,0.019293,172.217.194.0-255,1484,75642,76,271178
17285,0.019308,172.217.194.0-255,1484,77126,76,271178
17286,0.01931,172.31.40.0-255,66,77192,76,271178
17287,0.020224,172.31.40.0-255,172,77364,76,271178
17288,0.020251,172.31.40.0-255,1109,78473,76,271178
17289,0.020314,172.31.40.0-255,1514,79987,76,271178
17290,0.020316,172.31.40.0-255,1307,81294,76,271178
17291,0.02165,172.217.194.0-255,2902,84196,76,271178
17292,0.021657,172.31.40.0-255,66,84262,76,271178
17293,0.02171,172.217.194.0-255,2902,87164,76,271178
17294,0.021713,172.31.40.0-255,66,87230,76,271178
17295,0.021946,104.244.42.0-255,66,87296,76,271178
17296,0.021962,104.244.42.0-255,66,87362,76,271178
17297,0.022085,104.244.42.0-255,66,87428,76,271178
17298,0.024061,172.217.194.0-255,2902,90330,76,271178
17299,0.024066,172.31.40.0-255,66,90396,76,271178
17300,0.024106,172.217.194.0-255,2902,93298,76,271178
17301,0.024108,172.31.40.0-255,66,93364,76,271178
17302,0.026508,172.217.194.0-255,2902,96266,76,271178
17303,0.026513,172.31.40.0-255,66,96332,76,271178
17304,0.026531,172.217.194.0-255,2902,99234,76,271178
17305,0.026534,172.31.40.0-255,66,99300,76,271178
17306,0.028953,172.217.194.0-255,5738,105038,76,271178
17307,0.028959,172.31.40.0-255,66,105104,76,271178
17308,0.031405,172.217.194.0-255,2902,108006,76,271178
17309,0.031411,172.31.40.0-255,66,108072,76,271178
17310,0.031445,172.217.194.0-255,2902,110974,76,271178
17311,0.031448,172.31.40.0-255,66,111040,76,271178
17312,0.033818,172.217.194.0-255,2902,113942,76,271178
17313,0.033824,172.31.40.0-255,66,114008,76,271178
17314,0.033847,172.217.194.0-255,2902,116910,76,271178
17315,0.03385,172.31.40.0-255,66,116976,76,271178
17316,0.036245,172.217.194.0-255,2902,119878,76,271178
17317,0.036252,172.31.40.0-255,66,119944,76,271178
17318,0.036289,172.217.194.0-255,2902,122846,76,271178
17319,0.036291,172.31.40.0-255,66,122912,76,271178
17320,0.038693,172.217.194.0-255,5738,128650,76,271178
17321,0.0387,172.31.40.0-255,66,128716,76,271178
17322,0.041136,172.217.194.0-255,5738,134454,76,271178
17323,0.041142,172.31.40.0-255,66,134520,76,271178
17324,0.043571,172.217.194.0-255,5738,140258,76,271178
17325,0.043578,172.31.40.0-255,66,140324,76,271178
17326,0.046037,172.217.194.0-255,5738,146062,76,271178
17327,0.046044,172.31.40.0-255,66,146128,76,271178
17328,0.048459,172.217.194.0-255,5738,151866,76,271178
17329,0.048466,172.31.40.0-255,66,151932,76,271178
17330,0.050889,172.217.194.0-255,5738,157670,76,271178
17331,0.050894,172.31.40.0-255,66,157736,76,271178
17332,0.053301,172.217.194.0-255,5738,163474,76,271178
17333,0.053307,172.31.40.0-255,66,163540,76,271178
17334,0.055715,172.217.194.0-255,5738,169278,76,271178
17335,0.055722,172.31.40.0-255,66,169344,76,271178
17336,0.058184,172.217.194.0-255,5738,175082,76,271178
17337,0.058192,172.31.40.0-255,66,175148,76,271178
17338,0.060621,172.217.194.0-255,5738,180886,76,271178
17339,0.060627,172.31.40.0-255,66,180952,76,271178
17340,0.063033,172.217.194.0-255,1484,182436,76,271178
17341,0.063055,172.217.194.0-255,4320,186756,76,271178
17342,0.06306,172.31.40.0-255,66,186822,76,271178
17343,0.065484,172.217.194.0-255,5738,192560,76,271178
17344,0.06549,172.31.40.0-255,66,192626,76,271178
17345,0.067941,172.217.194.0-255,5738,198364,76,271178
17346,0.067947,172.31.40.0-255,66,198430,76,271178
17347,0.070384,172.217.194.0-255,5738,204168,76,271178
17348,0.07039,172.31.40.0-255,66,204234,76,271178
17349,0.072831,172.217.194.0-255,5738,209972,76,271178
17350,0.072838,172.31.40.0-255,66,210038,76,271178
17351,0.07528,172.217.194.0-255,5738,215776,76,271178
17352,0.075286,172.31.40.0-255,66,215842,76,271178
17353,0.077714,172.217.194.0-255,5738,221580,76,271178
17354,0.07772,172.31.40.0-255,66,221646,76,271178
17355,0.080158,172.217.194.0-255,5738,227384,76,271178
17356,0.080165,172.31.40.0-255,66,227450,76,271178
17357,0.082647,172.217.194.0-255,4320,231770,76,271178
17358,0.082654,172.31.40.0-255,66,231836,76,271178
17359,0.082682,172.217.194.0-255,1484,233320,76,271178
17360,0.085124,172.217.194.0-255,4320,237640,76,271178
17361,0.085132,172.31.40.0-255,66,237706,76,271178
17362,0.087593,172.217.194.0-255,5738,243444,76,271178
17363,0.087601,172.31.40.0-255,66,243510,76,271178
17364,0.090088,172.217.194.0-255,5738,249248,76,271178
17365,0.090096,172.31.40.0-255,66,249314,76,271178
17366,0.092517,172.217.194.0-255,4320,253634,76,271178
17367,0.092524,172.31.40.0-255,66,253700,76,271178
17368,0.092544,172.217.194.0-255,1484,255184,76,271178
17369,0.094991,172.217.194.0-255,4320,259504,76,271178
17370,0.094997,172.31.40.0-255,66,259570,76,271178
17371,0.097402,172.217.194.0-255,5738,265308,76,271178
17372,0.097408,172.31.40.0-255,66,265374,76,271178
17373,0.099831,172.217.194.0-255,5738,271112,76,271178
17374,0.099837,172.31.40.0-255,66,271178,76,271178
17375,0.0,74.125.24.0-255,152,152,76,276943
17376,2.3e-05,172.31.40.0-255,66,218,76,276943
17377,3e-05,74.125.24.0-255,1484,1702,76,276943
17378,3.5e-05,172.31.40.0-255,66,1768,76,276943
17379,4.1e-05,74.125.24.0-255,2902,4670,76,276943
17380,4.4e-05,172.31.40.0-255,66,4736,76,276943
17381,6.1e-05,74.125.24.0-255,7156,11892,76,276943
17382,6.4e-05,172.31.40.0-255,66,11958,76,276943
17383,0.000116,172.31.40.0-255,66,12024,76,276943
17384,0.00012,74.125.24.0-255,1484,13508,76,276943
17385,0.000122,172.31.40.0-255,66,13574,76,276943
17386,0.000157,74.125.24.0-255,5379,18953,76,276943
17387,0.00016,172.31.40.0-255,66,19019,76,276943
17388,0.000184,74.125.24.0-255,1484,20503,76,276943
17389,0.000186,172.31.40.0-255,66,20569,76,276943
17390,0.000191,74.125.24.0-255,2902,23471,76,276943
17391,0.000193,172.31.40.0-255,66,23537,76,276943
17392,0.000228,74.125.24.0-255,5738,29275,76,276943
17393,0.000231,172.31.40.0-255,66,29341,76,276943
17394,0.000238,74.125.24.0-255,6797,36138,76,276943
17395,0.00024,172.31.40.0-255,66,36204,76,276943
17396,0.000317,74.125.24.0-255,1484,37688,76,276943
17397,0.000319,172.31.40.0-255,66,37754,76,276943
17398,0.000348,74.125.24.0-255,2902,40656,76,276943
17399,0.00035,172.31.40.0-255,66,40722,76,276943
17400,0.000357,74.125.24.0-255,5738,46460,76,276943
17401,0.000359,172.31.40.0-255,66,46526,76,276943
17402,0.00041,172.31.40.0-255,66,46592,76,276943
17403,0.000413,74.125.24.0-255,329,46921,76,276943
17404,0.000415,172.31.40.0-255,66,46987,76,276943
17405,0.000719,74.125.24.0-255,1484,48471,76,276943
17406,0.000727,74.125.24.0-255,2902,51373,76,276943
17407,0.000731,172.31.40.0-255,66,51439,76,276943
17408,0.000736,74.125.24.0-255,2902,54341,76,276943
17409,0.000738,172.31.40.0-255,66,54407,76,276943
17410,0.000769,74.125.24.0-255,2902,57309,76,276943
17411,0.000772,172.31.40.0-255,66,57375,76,276943
17412,0.000792,74.125.24.0-255,1484,58859,76,276943
17413,0.000819,172.31.40.0-255,66,58925,76,276943
17414,0.000829,74.125.24.0-255,4320,63245,76,276943
17415,0.000834,172.31.40.0-255,66,63311,76,276943
17416,0.000858,74.125.24.0-255,5020,68331,76,276943
17417,0.000878,74.125.24.0-255,4320,72651,76,276943
17418,0.000884,74.125.24.0-255,5738,78389,76,276943
17419,0.000912,172.31.40.0-255,66,78455,76,276943
17420,0.000919,74.125.24.0-255,1484,79939,76,276943
17421,0.000924,172.31.40.0-255,66,80005,76,276943
17422,0.000972,172.31.40.0-255,66,80071,76,276943
17423,0.001087,74.125.24.0-255,1484,81555,76,276943
17424,0.001093,74.125.24.0-255,2902,84457,76,276943
17425,0.001095,172.31.40.0-255,66,84523,76,276943
17426,0.001115,74.125.24.0-255,5738,90261,76,276943
17427,0.001159,74.125.24.0-255,5738,95999,76,276943
17428,0.001173,74.125.24.0-255,4320,100319,76,276943
17429,0.00118,74.125.24.0-255,7156,107475,76,276943
17430,0.001183,172.31.40.0-255,66,107541,76,276943
17431,0.001188,172.31.40.0-255,66,107607,76,276943
17432,0.001216,74.125.24.0-255,6438,114045,76,276943
17433,0.001233,172.31.40.0-255,66,114111,76,276943
17434,0.001549,74.125.24.0-255,1484,115595,76,276943
17435,0.001556,74.125.24.0-255,2902,118497,76,276943
17436,0.001559,172.31.40.0-255,66,118563,76,276943
17437,0.001592,74.125.24.0-255,5738,124301,76,276943
17438,0.001601,74.125.24.0-255,7156,131457,76,276943
17439,0.001613,74.125.24.0-255,2902,134359,76,276943
17440,0.001628,172.31.40.0-255,66,134425,76,276943
17441,0.001633,74.125.24.0-255,2902,137327,76,276943
17442,0.001637,172.31.40.0-255,66,137393,76,276943
17443,0.001696,172.31.40.0-255,66,137459,76,276943
17444,0.001754,74.125.24.0-255,1484,138943,76,276943
17445,0.001757,74.125.24.0-255,1484,140427,76,276943
17446,0.001761,172.31.40.0-255,66,140493,76,276943
17447,0.00177,74.125.24.0-255,1484,141977,76,276943
17448,0.001781,74.125.24.0-255,5738,147715,76,276943
17449,0.001784,74.125.24.0-255,1484,149199,76,276943
17450,0.001788,74.125.24.0-255,2902,152101,76,276943
17451,0.001808,74.125.24.0-255,5738,157839,76,276943
17452,0.001816,172.31.40.0-255,66,157905,76,276943
17453,0.001871,172.31.40.0-255,66,157971,76,276943
17454,0.001878,74.125.24.0-255,1484,159455,76,276943
17455,0.001896,74.125.24.0-255,2902,162357,76,276943
17456,0.001911,74.125.24.0-255,5738,168095,76,276943
17457,0.001974,172.31.40.0-255,66,168161,76,276943
17458,0.001993,74.125.24.0-255,5020,173181,76,276943
17459,0.002011,172.31.40.0-255,66,173247,76,276943
17460,0.002022,74.125.24.0-255,5738,178985,76,276943
17461,0.002034,74.125.24.0-255,4320,183305,76,276943
17462,0.00204,172.31.40.0-255,66,183371,76,276943
17463,0.002081,172.31.40.0-255,66,183437,76,276943
17464,0.002129,172.31.40.0-255,66,183503,76,276943
17465,0.002139,74.125.24.0-255,1484,184987,76,276943
17466,0.002162,74.125.24.0-255,2902,187889,76,276943
17467,0.002167,172.31.40.0-255,66,187955,76,276943
17468,0.002201,74.125.24.0-255,5738,193693,76,276943
17469,0.002206,74.125.24.0-255,2902,196595,76,276943
17470,0.002238,74.125.24.0-255,2902,199497,76,276943
17471,0.002248,172.31.40.0-255,66,199563,76,276943
17472,0.002319,172.31.40.0-255,66,199629,76,276943
17473,0.002348,74.125.24.0-255,1484,201113,76,276943
17474,0.004622,74.125.24.0-255,4320,205433,76,276943
17475,0.004631,172.31.40.0-255,66,205499,76,276943
17476,0.006948,74.125.24.0-255,5738,211237,76,276943
17477,0.006951,172.31.40.0-255,66,211303,76,276943
17478,0.00928,74.125.24.0-255,5738,217041,76,276943
17479,0.009297,172.31.40.0-255,66,217107,76,276943
17480,0.011618,74.125.24.0-255,5738,222845,76,276943
17481,0.014496,172.31.40.0-255,66,222911,76,276943
17482,0.016822,74.125.24.0-255,5738,228649,76,276943
17483,0.016834,172.31.40.0-255,66,228715,76,276943
17484,0.019153,74.125.24.0-255,5738,234453,76,276943
17485,0.019173,172.31.40.0-255,66,234519,76,276943
17486,0.02152,74.125.24.0-255,5738,240257,76,276943
17487,0.021532,172.31.40.0-255,66,240323,76,276943
17488,0.023826,74.125.24.0-255,5738,246061,76,276943
17489,0.023838,172.31.40.0-255,66,246127,76,276943
17490,0.026153,74.125.24.0-255,5738,251865,76,276943
17491,0.026163,172.31.40.0-255,66,251931,76,276943
17492,0.028475,74.125.24.0-255,5738,257669,76,276943
17493,0.028484,172.31.40.0-255,66,257735,76,276943
17494,0.030785,74.125.24.0-255,5738,263473,76,276943
17495,0.030792,172.31.40.0-255,66,263539,76,276943
17496,0.03311,74.125.24.0-255,5738,269277,76,276943
17497,0.033116,172.31.40.0-255,66,269343,76,276943
17498,0.03543,74.125.24.0-255,4161,273504,76,276943
17499,0.035437,172.31.40.0-255,66,273570,76,276943
17500,0.03562,172.31.40.0-255,105,273675,76,276943
17501,0.037886,74.125.24.0-255,66,273741,76,276943
17502,0.038552,172.31.40.0-255,172,273913,76,276943
17503,0.038584,172.31.40.0-255,1104,275017,76,276943
17504,0.038644,172.31.40.0-255,1514,276531,76,276943
17505,0.038646,172.31.40.0-255,346,276877,76,276943
17506,0.040722,104.244.42.0-255,66,276943,76,276943
17507,0.0,74.125.24.0-255,152,152,76,255851
17508,1.4e-05,172.31.40.0-255,66,218,76,255851
17509,2e-05,74.125.24.0-255,1484,1702,76,255851
17510,2.5e-05,172.31.40.0-255,66,1768,76,255851
17511,3e-05,74.125.24.0-255,2902,4670,76,255851
17512,3.3e-05,172.31.40.0-255,66,4736,76,255851
17513,6.8e-05,74.125.24.0-255,7156,11892,76,255851
17514,7.1e-05,172.31.40.0-255,66,11958,76,255851
17515,0.0001,74.125.24.0-255,2902,14860,76,255851
17516,0.000103,172.31.40.0-255,66,14926,76,255851
17517,0.000124,172.31.40.0-255,66,14992,76,255851
17518,0.00013,74.125.24.0-255,5379,20371,76,255851
17519,0.000132,172.31.40.0-255,66,20437,76,255851
17520,0.000679,74.125.24.0-255,1484,21921,76,255851
17521,0.000684,172.31.40.0-255,66,21987,76,255851
17522,0.000692,74.125.24.0-255,2902,24889,76,255851
17523,0.000694,172.31.40.0-255,66,24955,76,255851
17524,0.0007,74.125.24.0-255,5738,30693,76,255851
17525,0.000702,172.31.40.0-255,66,30759,76,255851
17526,0.000725,74.125.24.0-255,2902,33661,76,255851
17527,0.000728,172.31.40.0-255,66,33727,76,255851
17528,0.000759,172.31.40.0-255,66,33793,76,255851
17529,0.000764,74.125.24.0-255,4320,38113,76,255851
17530,0.000766,172.31.40.0-255,66,38179,76,255851
17531,0.000802,74.125.24.0-255,5652,43831,76,255851
17532,0.000804,172.31.40.0-255,66,43897,76,255851
17533,0.000807,74.125.24.0-255,134,44031,76,255851
17534,0.000809,172.31.40.0-255,66,44097,76,255851
17535,0.000894,74.125.24.0-255,1484,45581,76,255851
17536,0.000897,172.31.40.0-255,66,45647,76,255851
17537,0.000901,74.125.24.0-255,1484,47131,76,255851
17538,0.000916,74.125.24.0-255,1484,48615,76,255851
17539,0.000919,172.31.40.0-255,66,48681,76,255851
17540,0.000925,74.125.24.0-255,5738,54419,76,255851
17541,0.000927,172.31.40.0-255,66,54485,76,255851
17542,0.000958,172.31.40.0-255,66,54551,76,255851
17543,0.000968,172.31.40.0-255,66,54617,76,255851
17544,0.00098,74.125.24.0-255,1484,56101,76,255851
17545,0.001011,74.125.24.0-255,7156,63257,76,255851
17546,0.001014,172.31.40.0-255,66,63323,76,255851
17547,0.001042,172.31.40.0-255,66,63389,76,255851
17548,0.001255,74.125.24.0-255,1484,64873,76,255851
17549,0.001262,74.125.24.0-255,2902,67775,76,255851
17550,0.001266,172.31.40.0-255,66,67841,76,255851
17551,0.001269,74.125.24.0-255,1484,69325,76,255851
17552,0.001286,74.125.24.0-255,4320,73645,76,255851
17553,0.001288,172.31.40.0-255,66,73711,76,255851
17554,0.001293,74.125.24.0-255,4320,78031,76,255851
17555,0.001295,172.31.40.0-255,66,78097,76,255851
17556,0.001323,172.31.40.0-255,66,78163,76,255851
17557,0.001334,172.31.40.0-255,66,78229,76,255851
17558,0.001478,74.125.24.0-255,1484,79713,76,255851
17559,0.001484,74.125.24.0-255,2902,82615,76,255851
17560,0.001487,172.31.40.0-255,66,82681,76,255851
17561,0.001491,74.125.24.0-255,1484,84165,76,255851
17562,0.001503,74.125.24.0-255,4320,88485,76,255851
17563,0.001506,172.31.40.0-255,66,88551,76,255851
17564,0.001523,74.125.24.0-255,1484,90035,76,255851
17565,0.001535,74.125.24.0-255,2902,92937,76,255851
17566,0.001538,172.31.40.0-255,66,93003,76,255851
17567,0.001555,74.125.24.0-255,2902,95905,76,255851
17568,0.001557,172.31.40.0-255,66,95971,76,255851
17569,0.001568,74.125.24.0-255,2902,98873,76,255851
17570,0.00157,172.31.40.0-255,66,98939,76,255851
17571,0.001585,74.125.24.0-255,4320,103259,76,255851
17572,0.001587,172.31.40.0-255,66,103325,76,255851
17573,0.001612,74.125.24.0-255,1484,104809,76,255851
17574,0.001622,172.31.40.0-255,66,104875,76,255851
17575,0.001635,74.125.24.0-255,2902,107777,76,255851
17576,0.001637,172.31.40.0-255,66,107843,76,255851
17577,0.001657,74.125.24.0-255,5738,113581,76,255851
17578,0.001659,172.31.40.0-255,66,113647,76,255851
17579,0.00167,172.31.40.0-255,66,113713,76,255851
17580,0.001714,172.31.40.0-255,66,113779,76,255851
17581,0.001733,172.31.40.0-255,66,113845,76,255851
17582,0.001745,172.31.40.0-255,66,113911,76,255851
17583,0.001761,172.31.40.0-255,66,113977,76,255851
17584,0.001792,74.125.24.0-255,1484,115461,76,255851
17585,0.001796,74.125.24.0-255,2902,118363,76,255851
17586,0.001798,172.31.40.0-255,66,118429,76,255851
17587,0.001801,74.125.24.0-255,1484,119913,76,255851
17588,0.001817,74.125.24.0-255,4320,124233,76,255851
17589,0.001819,172.31.40.0-255,66,124299,76,255851
17590,0.001826,74.125.24.0-255,7156,131455,76,255851
17591,0.001829,172.31.40.0-255,66,131521,76,255851
17592,0.001843,74.125.24.0-255,1484,133005,76,255851
17593,0.001877,172.31.40.0-255,66,133071,76,255851
17594,0.001912,74.125.24.0-255,2184,135255,76,255851
17595,0.001914,172.31.40.0-255,66,135321,76,255851
17596,0.002036,74.125.24.0-255,1484,136805,76,255851
17597,0.002046,74.125.24.0-255,2902,139707,76,255851
17598,0.002049,172.31.40.0-255,66,139773,76,255851
17599,0.002072,74.125.24.0-255,5738,145511,76,255851
17600,0.002074,172.31.40.0-255,66,145577,76,255851
17601,0.0021,172.31.40.0-255,66,145643,76,255851
17602,0.00213,74.125.24.0-255,5738,151381,76,255851
17603,0.002132,172.31.40.0-255,66,151447,76,255851
17604,0.002153,74.125.24.0-255,5020,156467,76,255851
17605,0.002155,172.31.40.0-255,66,156533,76,255851
17606,0.002161,74.125.24.0-255,5738,162271,76,255851
17607,0.002163,172.31.40.0-255,66,162337,76,255851
17608,0.002187,74.125.24.0-255,5738,168075,76,255851
17609,0.002189,172.31.40.0-255,66,168141,76,255851
17610,0.002195,74.125.24.0-255,5738,173879,76,255851
17611,0.002197,172.31.40.0-255,66,173945,76,255851
17612,0.004338,74.125.24.0-255,5738,179683,76,255851
17613,0.004344,172.31.40.0-255,66,179749,76,255851
17614,0.006504,74.125.24.0-255,5738,185487,76,255851
17615,0.00651,172.31.40.0-255,66,185553,76,255851
17616,0.008685,74.125.24.0-255,5738,191291,76,255851
17617,0.008692,172.31.40.0-255,66,191357,76,255851
17618,0.01084,74.125.24.0-255,5738,197095,76,255851
17619,0.010847,172.31.40.0-255,66,197161,76,255851
17620,0.013022,74.125.24.0-255,5738,202899,76,255851
17621,0.01303,172.31.40.0-255,66,202965,76,255851
17622,0.015187,74.125.24.0-255,5738,208703,76,255851
17623,0.015194,172.31.40.0-255,66,208769,76,255851
17624,0.017303,74.125.24.0-255,5738,214507,76,255851
17625,0.01731,172.31.40.0-255,66,214573,76,255851
17626,0.019446,74.125.24.0-255,5738,220311,76,255851
17627,0.019455,172.31.40.0-255,66,220377,76,255851
17628,0.021633,74.125.24.0-255,5738,226115,76,255851
17629,0.02164,172.31.40.0-255,66,226181,76,255851
17630,0.023775,74.125.24.0-255,5738,231919,76,255851
17631,0.023782,172.31.40.0-255,66,231985,76,255851
17632,0.025953,74.125.24.0-255,5738,237723,76,255851
17633,0.02596,172.31.40.0-255,66,237789,76,255851
17634,0.028116,74.125.24.0-255,5738,243527,76,255851
17635,0.028122,172.31.40.0-255,66,243593,76,255851
17636,0.030264,74.125.24.0-255,5738,249331,76,255851
17637,0.030271,172.31.40.0-255,66,249397,76,255851
17638,0.032453,74.125.24.0-255,1916,251313,76,255851
17639,0.03246,172.31.40.0-255,66,251379,76,255851
17640,0.032622,172.31.40.0-255,105,251484,76,255851
17641,0.033155,172.31.40.0-255,171,251655,76,255851
17642,0.033188,172.31.40.0-255,1131,252786,76,255851
17643,0.033244,172.31.40.0-255,1514,254300,76,255851
17644,0.033246,172.31.40.0-255,1287,255587,76,255851
17645,0.034711,74.125.24.0-255,66,255653,76,255851
17646,0.034806,104.244.42.0-255,66,255719,76,255851
17647,0.034852,104.244.42.0-255,66,255785,76,255851
17648,0.034906,104.244.42.0-255,66,255851,76,255851
17649,0.0,74.125.130.0-255,153,153,76,338195
17650,3.4e-05,172.31.40.0-255,66,219,76,338195
17651,4.1e-05,74.125.130.0-255,1484,1703,76,338195
17652,4.5e-05,172.31.40.0-255,66,1769,76,338195
17653,5e-05,74.125.130.0-255,2902,4671,76,338195
17654,6e-05,172.31.40.0-255,66,4737,76,338195
17655,9e-05,74.125.130.0-255,4320,9057,76,338195
17656,9.3e-05,172.31.40.0-255,66,9123,76,338195
17657,0.000152,74.125.130.0-255,1484,10607,76,338195
17658,0.000155,172.31.40.0-255,66,10673,76,338195
17659,0.000191,172.31.40.0-255,66,10739,76,338195
17660,0.000236,172.31.40.0-255,66,10805,76,338195
17661,0.000303,74.125.130.0-255,2543,13348,76,338195
17662,0.000307,172.31.40.0-255,66,13414,76,338195
17663,0.000338,74.125.130.0-255,7156,20570,76,338195
17664,0.000342,172.31.40.0-255,66,20636,76,338195
17665,0.000394,74.125.130.0-255,1484,22120,76,338195
17666,0.000397,172.31.40.0-255,66,22186,76,338195
17667,0.000435,172.31.40.0-255,66,22252,76,338195
17668,0.000636,74.125.130.0-255,1484,23736,76,338195
17669,0.00064,172.31.40.0-255,66,23802,76,338195
17670,0.000671,74.125.130.0-255,2902,26704,76,338195
17671,0.000674,172.31.40.0-255,66,26770,76,338195
17672,0.00068,74.125.130.0-255,4320,31090,76,338195
17673,0.000682,172.31.40.0-255,66,31156,76,338195
17674,0.000703,74.125.130.0-255,1484,32640,76,338195
17675,0.000706,172.31.40.0-255,66,32706,76,338195
17676,0.000744,172.31.40.0-255,66,32772,76,338195
17677,0.000818,74.125.130.0-255,2902,35674,76,338195
17678,0.000822,172.31.40.0-255,66,35740,76,338195
17679,0.000838,74.125.130.0-255,4320,40060,76,338195
17680,0.000855,172.31.40.0-255,66,40126,76,338195
17681,0.000858,74.125.130.0-255,2902,43028,76,338195
17682,0.000874,172.31.40.0-255,66,43094,76,338195
17683,0.0009,74.125.130.0-255,1484,44578,76,338195
17684,0.000915,74.125.130.0-255,3961,48539,76,338195
17685,0.000928,172.31.40.0-255,66,48605,76,338195
17686,0.000961,74.125.130.0-255,1484,50089,76,338195
17687,0.000983,74.125.130.0-255,4320,54409,76,338195
17688,0.000988,172.31.40.0-255,66,54475,76,338195
17689,0.001028,74.125.130.0-255,4320,58795,76,338195
17690,0.001032,172.31.40.0-255,66,58861,76,338195
17691,0.001112,172.31.40.0-255,66,58927,76,338195
17692,0.001167,74.125.130.0-255,2902,61829,76,338195
17693,0.001173,172.31.40.0-255,66,61895,76,338195
17694,0.001186,74.125.130.0-255,5738,67633,76,338195
17695,0.001197,172.31.40.0-255,66,67699,76,338195
17696,0.001209,74.125.130.0-255,2902,70601,76,338195
17697,0.00122,172.31.40.0-255,66,70667,76,338195
17698,0.001276,74.125.130.0-255,3487,74154,76,338195
17699,0.00128,172.31.40.0-255,66,74220,76,338195
17700,0.001314,74.125.130.0-255,2902,77122,76,338195
17701,0.001317,172.31.40.0-255,66,77188,76,338195
17702,0.001372,172.31.40.0-255,66,77254,76,338195
17703,0.001478,74.125.130.0-255,4320,81574,76,338195
17704,0.001482,172.31.40.0-255,66,81640,76,338195
17705,0.001536,172.31.40.0-255,66,81706,76,338195
17706,0.001661,74.125.130.0-255,2902,84608,76,338195
17707,0.001665,172.31.40.0-255,66,84674,76,338195
17708,0.00172,172.31.40.0-255,66,84740,76,338195
17709,0.001836,74.125.130.0-255,2902,87642,76,338195
17710,0.001845,172.31.40.0-255,66,87708,76,338195
17711,0.001926,74.125.130.0-255,2902,90610,76,338195
17712,0.001934,172.31.40.0-255,66,90676,76,338195
17713,0.001952,74.125.130.0-255,6438,97114,76,338195
17714,0.001977,172.31.40.0-255,66,97180,76,338195
17715,0.002082,74.125.130.0-255,1484,98664,76,338195
17716,0.0021,74.125.130.0-255,2902,101566,76,338195
17717,0.002132,172.31.40.0-255,66,101632,76,338195
17718,0.002164,74.125.130.0-255,1484,103116,76,338195
17719,0.002183,74.125.130.0-255,1484,104600,76,338195
17720,0.002187,172.31.40.0-255,66,104666,76,338195
17721,0.002192,74.125.130.0-255,2902,107568,76,338195
17722,0.002225,74.125.130.0-255,2902,110470,76,338195
17723,0.002242,172.31.40.0-255,66,110536,76,338195
17724,0.002251,74.125.130.0-255,1484,112020,76,338195
17725,0.002271,74.125.130.0-255,2902,114922,76,338195
17726,0.002274,74.125.130.0-255,1484,116406,76,338195
17727,0.002292,74.125.130.0-255,2902,119308,76,338195
17728,0.002317,74.125.130.0-255,1484,120792,76,338195
17729,0.002332,74.125.130.0-255,4320,125112,76,338195
17730,0.002336,172.31.40.0-255,66,125178,76,338195
17731,0.002342,172.31.40.0-255,66,125244,76,338195
17732,0.002376,74.125.130.0-255,4320,129564,76,338195
17733,0.002389,74.125.130.0-255,2184,131748,76,338195
17734,0.002395,172.31.40.0-255,66,131814,76,338195
17735,0.002565,74.125.130.0-255,1484,133298,76,338195
17736,0.002571,74.125.130.0-255,2902,136200,76,338195
17737,0.002573,172.31.40.0-255,66,136266,76,338195
17738,0.002604,74.125.130.0-255,5738,142004,76,338195
17739,0.00261,172.31.40.0-255,66,142070,76,338195
17740,0.002659,74.125.130.0-255,5738,147808,76,338195
17741,0.002683,74.125.130.0-255,5738,153546,76,338195
17742,0.002688,172.31.40.0-255,66,153612,76,338195
17743,0.002773,74.125.130.0-255,2902,156514,76,338195
17744,0.002778,172.31.40.0-255,66,156580,76,338195
17745,0.002787,74.125.130.0-255,4320,160900,76,338195
17746,0.002791,172.31.40.0-255,66,160966,76,338195
17747,0.002805,74.125.130.0-255,1484,162450,76,338195
17748,0.005419,74.125.130.0-255,4320,166770,76,338195
17749,0.005424,172.31.40.0-255,66,166836,76,338195
17750,0.008057,74.125.130.0-255,5738,172574,76,338195
17751,0.008087,172.31.40.0-255,66,172640,76,338195
17752,0.010787,74.125.130.0-255,5738,178378,76,338195
17753,0.010795,172.31.40.0-255,66,178444,76,338195
17754,0.013429,74.125.130.0-255,5738,184182,76,338195
17755,0.013437,172.31.40.0-255,66,184248,76,338195
17756,0.016058,74.125.130.0-255,5738,189986,76,338195
17757,0.016064,172.31.40.0-255,66,190052,76,338195
17758,0.018691,74.125.130.0-255,5738,195790,76,338195
17759,0.018697,172.31.40.0-255,66,195856,76,338195
17760,0.021329,74.125.130.0-255,5738,201594,76,338195
17761,0.021338,172.31.40.0-255,66,201660,76,338195
17762,0.023965,74.125.130.0-255,5738,207398,76,338195
17763,0.023974,172.31.40.0-255,66,207464,76,338195
17764,0.027039,74.125.130.0-255,5738,213202,76,338195
17765,0.027048,172.31.40.0-255,66,213268,76,338195
17766,0.029682,74.125.130.0-255,4320,217588,76,338195
17767,0.02969,172.31.40.0-255,66,217654,76,338195
17768,0.02972,74.125.130.0-255,1484,219138,76,338195
17769,0.032312,74.125.130.0-255,4320,223458,76,338195
17770,0.032319,172.31.40.0-255,66,223524,76,338195
17771,0.034951,74.125.130.0-255,5738,229262,76,338195
17772,0.035013,172.31.40.0-255,66,229328,76,338195
17773,0.036635,172.31.40.0-255,176,229504,76,338195
17774,0.036664,172.31.40.0-255,1109,230613,76,338195
17775,0.036707,172.31.40.0-255,1514,232127,76,338195
17776,0.036709,172.31.40.0-255,1307,233434,76,338195
17777,0.037667,74.125.130.0-255,2902,236336,76,338195
17778,0.037672,172.31.40.0-255,66,236402,76,338195
17779,0.037703,74.125.130.0-255,2902,239304,76,338195
17780,0.037725,172.31.40.0-255,66,239370,76,338195
17781,0.038297,104.244.42.0-255,66,239436,76,338195
17782,0.038342,104.244.42.0-255,66,239502,76,338195
17783,0.038381,104.244.42.0-255,66,239568,76,338195
17784,0.040302,74.125.130.0-255,2902,242470,76,338195
17785,0.040307,172.31.40.0-255,66,242536,76,338195
17786,0.040351,74.125.130.0-255,2902,245438,76,338195
17787,0.040384,172.31.40.0-255,66,245504,76,338195
17788,0.042926,74.125.130.0-255,2902,248406,76,338195
17789,0.042931,172.31.40.0-255,66,248472,76,338195
17790,0.042984,74.125.130.0-255,2902,251374,76,338195
17791,0.04301,172.31.40.0-255,66,251440,76,338195
17792,0.045549,74.125.130.0-255,1484,252924,76,338195
17793,0.045581,74.125.130.0-255,1484,254408,76,338195
17794,0.045585,172.31.40.0-255,66,254474,76,338195
17795,0.045624,74.125.130.0-255,1484,255958,76,338195
17796,0.045637,74.125.130.0-255,1484,257442,76,338195
17797,0.04565,172.31.40.0-255,66,257508,76,338195
17798,0.048205,74.125.130.0-255,2902,260410,76,338195
17799,0.048211,172.31.40.0-255,66,260476,76,338195
17800,0.048257,74.125.130.0-255,2902,263378,76,338195
17801,0.048285,172.31.40.0-255,66,263444,76,338195
17802,0.05085,74.125.130.0-255,2902,266346,76,338195
17803,0.050857,172.31.40.0-255,66,266412,76,338195
17804,0.050892,74.125.130.0-255,2902,269314,76,338195
17805,0.051454,172.31.40.0-255,66,269380,76,338195
17806,0.053476,74.125.130.0-255,2902,272282,76,338195
17807,0.053482,172.31.40.0-255,66,272348,76,338195
17808,0.054073,74.125.130.0-255,2902,275250,76,338195
17809,0.054078,172.31.40.0-255,66,275316,76,338195
17810,0.056113,74.125.130.0-255,2902,278218,76,338195
17811,0.056118,172.31.40.0-255,66,278284,76,338195
17812,0.056698,74.125.130.0-255,2902,281186,76,338195
17813,0.056704,172.31.40.0-255,66,281252,76,338195
17814,0.058757,74.125.130.0-255,2902,284154,76,338195
17815,0.058762,172.31.40.0-255,66,284220,76,338195
17816,0.059333,74.125.130.0-255,2902,287122,76,338195
17817,0.059339,172.31.40.0-255,66,287188,76,338195
17818,0.061381,74.125.130.0-255,2902,290090,76,338195
17819,0.061388,172.31.40.0-255,66,290156,76,338195
17820,0.061961,74.125.130.0-255,2902,293058,76,338195
17821,0.061967,172.31.40.0-255,66,293124,76,338195
17822,0.06401,74.125.130.0-255,2902,296026,76,338195
17823,0.064015,172.31.40.0-255,66,296092,76,338195
17824,0.064581,74.125.130.0-255,2902,298994,76,338195
17825,0.064587,172.31.40.0-255,66,299060,76,338195
17826,0.066646,74.125.130.0-255,2902,301962,76,338195
17827,0.066651,172.31.40.0-255,66,302028,76,338195
17828,0.067211,74.125.130.0-255,2902,304930,76,338195
17829,0.067217,172.31.40.0-255,66,304996,76,338195
17830,0.069278,74.125.130.0-255,1484,306480,76,338195
17831,0.069305,74.125.130.0-255,1484,307964,76,338195
17832,0.069311,172.31.40.0-255,66,308030,76,338195
17833,0.06984,74.125.130.0-255,2902,310932,76,338195
17834,0.069845,172.31.40.0-255,66,310998,76,338195
17835,0.071964,74.125.130.0-255,2902,313900,76,338195
17836,0.071969,172.31.40.0-255,66,313966,76,338195
17837,0.072464,74.125.130.0-255,2902,316868,76,338195
17838,0.072469,172.31.40.0-255,66,316934,76,338195
17839,0.074598,74.125.130.0-255,2902,319836,76,338195
17840,0.074604,172.31.40.0-255,66,319902,76,338195
17841,0.075085,74.125.130.0-255,2902,322804,76,338195
17842,0.075091,172.31.40.0-255,66,322870,76,338195
17843,0.07723,74.125.130.0-255,2902,325772,76,338195
17844,0.077236,172.31.40.0-255,66,325838,76,338195
17845,0.077708,74.125.130.0-255,2902,328740,76,338195
17846,0.077714,172.31.40.0-255,66,328806,76,338195
17847,0.079863,74.125.130.0-255,2902,331708,76,338195
17848,0.079869,172.31.40.0-255,66,331774,76,338195
17849,0.080333,74.125.130.0-255,2902,334676,76,338195
17850,0.080338,172.31.40.0-255,66,334742,76,338195
17851,0.082494,74.125.130.0-255,2902,337644,76,338195
17852,0.082499,172.31.40.0-255,66,337710,76,338195
17853,0.082939,74.125.130.0-255,248,337958,76,338195
17854,0.08309,172.31.40.0-255,66,338024,76,338195
17855,0.083118,172.31.40.0-255,105,338129,76,338195
17856,0.085724,74.125.130.0-255,66,338195,76,338195
17857,0.0,74.125.24.0-255,150,150,76,349646
17858,2e-05,172.31.40.0-255,66,216,76,349646
17859,2.7e-05,74.125.24.0-255,1484,1700,76,349646
17860,3.2e-05,172.31.40.0-255,66,1766,76,349646
17861,3.7e-05,74.125.24.0-255,2902,4668,76,349646
17862,4.8e-05,172.31.40.0-255,66,4734,76,349646
17863,5.6e-05,74.125.24.0-255,7156,11890,76,349646
17864,5.8e-05,172.31.40.0-255,66,11956,76,349646
17865,0.000107,74.125.24.0-255,2055,14011,76,349646
17866,0.00011,172.31.40.0-255,66,14077,76,349646
17867,0.000228,74.125.24.0-255,1484,15561,76,349646
17868,0.000232,172.31.40.0-255,66,15627,76,349646
17869,0.000237,74.125.24.0-255,2902,18529,76,349646
17870,0.000239,172.31.40.0-255,66,18595,76,349646
17871,0.000271,74.125.24.0-255,4320,22915,76,349646
17872,0.000273,172.31.40.0-255,66,22981,76,349646
17873,0.000299,74.125.24.0-255,1484,24465,76,349646
17874,0.000301,172.31.40.0-255,66,24531,76,349646
17875,0.000309,74.125.24.0-255,6797,31328,76,349646
17876,0.000311,172.31.40.0-255,66,31394,76,349646
17877,0.000545,74.125.24.0-255,1484,32878,76,349646
17878,0.000551,172.31.40.0-255,66,32944,76,349646
17879,0.000557,74.125.24.0-255,2902,35846,76,349646
17880,0.000559,172.31.40.0-255,66,35912,76,349646
17881,0.000571,74.125.24.0-255,5738,41650,76,349646
17882,0.000573,172.31.40.0-255,66,41716,76,349646
17883,0.000584,74.125.24.0-255,1484,43200,76,349646
17884,0.000586,172.31.40.0-255,66,43266,76,349646
17885,0.000632,172.31.40.0-255,66,43332,76,349646
17886,0.000644,172.31.40.0-255,66,43398,76,349646
17887,0.000646,74.125.24.0-255,1125,44523,76,349646
17888,0.001033,74.125.24.0-255,645,45168,76,349646
17889,0.001038,172.31.40.0-255,66,45234,76,349646
17890,0.001217,74.125.24.0-255,1484,46718,76,349646
17891,0.001227,74.125.24.0-255,2902,49620,76,349646
17892,0.001231,172.31.40.0-255,66,49686,76,349646
17893,0.001238,74.125.24.0-255,5738,55424,76,349646
17894,0.00124,172.31.40.0-255,66,55490,76,349646
17895,0.001279,172.31.40.0-255,66,55556,76,349646
17896,0.001303,74.125.24.0-255,4320,59876,76,349646
17897,0.001305,172.31.40.0-255,66,59942,76,349646
17898,0.001316,172.31.40.0-255,66,60008,76,349646
17899,0.001319,74.125.24.0-255,766,60774,76,349646
17900,0.001725,74.125.24.0-255,1484,62258,76,349646
17901,0.001731,172.31.40.0-255,66,62324,76,349646
17902,0.001737,74.125.24.0-255,2902,65226,76,349646
17903,0.001738,172.31.40.0-255,66,65292,76,349646
17904,0.001744,74.125.24.0-255,5738,71030,76,349646
17905,0.001749,172.31.40.0-255,66,71096,76,349646
17906,0.001754,74.125.24.0-255,2902,73998,76,349646
17907,0.001756,172.31.40.0-255,66,74064,76,349646
17908,0.001794,172.31.40.0-255,66,74130,76,349646
17909,0.001804,172.31.40.0-255,66,74196,76,349646
17910,0.001807,74.125.24.0-255,766,74962,76,349646
17911,0.001961,74.125.24.0-255,1484,76446,76,349646
17912,0.001964,172.31.40.0-255,66,76512,76,349646
17913,0.001967,74.125.24.0-255,1484,77996,76,349646
17914,0.001988,74.125.24.0-255,1484,79480,76,349646
17915,0.00199,172.31.40.0-255,66,79546,76,349646
17916,0.001995,74.125.24.0-255,5738,85284,76,349646
17917,0.001998,172.31.40.0-255,66,85350,76,349646
17918,0.00204,172.31.40.0-255,66,85416,76,349646
17919,0.002046,74.125.24.0-255,5738,91154,76,349646
17920,0.002048,172.31.40.0-255,66,91220,76,349646
17921,0.002093,74.125.24.0-255,1484,92704,76,349646
17922,0.002108,74.125.24.0-255,3602,96306,76,349646
17923,0.002111,172.31.40.0-255,66,96372,76,349646
17924,0.004273,74.125.24.0-255,2902,99274,76,349646
17925,0.004276,172.31.40.0-255,66,99340,76,349646
17926,0.004299,74.125.24.0-255,2902,102242,76,349646
17927,0.004302,172.31.40.0-255,66,102308,76,349646
17928,0.006435,74.125.24.0-255,2902,105210,76,349646
17929,0.006442,172.31.40.0-255,66,105276,76,349646
17930,0.00647,74.125.24.0-255,2902,108178,76,349646
17931,0.006472,172.31.40.0-255,66,108244,76,349646
17932,0.008568,74.125.24.0-255,2902,111146,76,349646
17933,0.008573,172.31.40.0-255,66,111212,76,349646
17934,0.008603,74.125.24.0-255,2902,114114,76,349646
17935,0.008606,172.31.40.0-255,66,114180,76,349646
17936,0.010691,74.125.24.0-255,2902,117082,76,349646
17937,0.010699,172.31.40.0-255,66,117148,76,349646
17938,0.010743,74.125.24.0-255,2902,120050,76,349646
17939,0.010746,172.31.40.0-255,66,120116,76,349646
17940,0.012866,74.125.24.0-255,2902,123018,76,349646
17941,0.012874,172.31.40.0-255,66,123084,76,349646
17942,0.012906,74.125.24.0-255,2902,125986,76,349646
17943,0.012909,172.31.40.0-255,66,126052,76,349646
17944,0.015,74.125.24.0-255,2902,128954,76,349646
17945,0.015009,172.31.40.0-255,66,129020,76,349646
17946,0.015043,74.125.24.0-255,2902,131922,76,349646
17947,0.015045,172.31.40.0-255,66,131988,76,349646
17948,0.017141,74.125.24.0-255,2902,134890,76,349646
17949,0.017147,172.31.40.0-255,66,134956,76,349646
17950,0.017176,74.125.24.0-255,2902,137858,76,349646
17951,0.017179,172.31.40.0-255,66,137924,76,349646
17952,0.01931,74.125.24.0-255,5738,143662,76,349646
17953,0.019316,172.31.40.0-255,66,143728,76,349646
17954,0.021476,74.125.24.0-255,5738,149466,76,349646
17955,0.021482,172.31.40.0-255,66,149532,76,349646
17956,0.023629,74.125.24.0-255,5738,155270,76,349646
17957,0.023636,172.31.40.0-255,66,155336,76,349646
17958,0.025779,74.125.24.0-255,5738,161074,76,349646
17959,0.025785,172.31.40.0-255,66,161140,76,349646
17960,0.027924,74.125.24.0-255,2902,164042,76,349646
17961,0.027931,172.31.40.0-255,66,164108,76,349646
17962,0.027975,74.125.24.0-255,2902,167010,76,349646
17963,0.027979,172.31.40.0-255,66,167076,76,349646
17964,0.029492,172.31.40.0-255,175,167251,76,349646
17965,0.029522,172.31.40.0-255,1133,168384,76,349646
17966,0.029582,172.31.40.0-255,1514,169898,76,349646
17967,0.029584,172.31.40.0-255,1283,171181,76,349646
17968,0.030061,74.125.24.0-255,2902,174083,76,349646
17969,0.030068,172.31.40.0-255,66,174149,76,349646
17970,0.030121,74.125.24.0-255,2902,177051,76,349646
17971,0.030125,172.31.40.0-255,66,177117,76,349646
17972,0.031108,104.244.42.0-255,66,177183,76,349646
17973,0.031204,104.244.42.0-255,66,177249,76,349646
17974,0.031263,104.244.42.0-255,66,177315,76,349646
17975,0.032199,74.125.24.0-255,2902,180217,76,349646
17976,0.032204,172.31.40.0-255,66,180283,76,349646
17977,0.032255,74.125.24.0-255,2902,183185,76,349646
17978,0.032258,172.31.40.0-255,66,183251,76,349646
17979,0.034323,74.125.24.0-255,2902,186153,76,349646
17980,0.034329,172.31.40.0-255,66,186219,76,349646
17981,0.034388,74.125.24.0-255,2902,189121,76,349646
17982,0.034391,172.31.40.0-255,66,189187,76,349646
17983,0.036461,74.125.24.0-255,2902,192089,76,349646
17984,0.036468,172.31.40.0-255,66,192155,76,349646
17985,0.036526,74.125.24.0-255,2902,195057,76,349646
17986,0.036529,172.31.40.0-255,66,195123,76,349646
17987,0.03864,74.125.24.0-255,5738,200861,76,349646
17988,0.038647,172.31.40.0-255,66,200927,76,349646
17989,0.040811,74.125.24.0-255,5738,206665,76,349646
17990,0.04082,172.31.40.0-255,66,206731,76,349646
17991,0.042977,74.125.24.0-255,5738,212469,76,349646
17992,0.042983,172.31.40.0-255,66,212535,76,349646
17993,0.045153,74.125.24.0-255,5738,218273,76,349646
17994,0.04516,172.31.40.0-255,66,218339,76,349646
17995,0.047306,74.125.24.0-255,5738,224077,76,349646
17996,0.047312,172.31.40.0-255,66,224143,76,349646
17997,0.049458,74.125.24.0-255,5738,229881,76,349646
17998,0.049464,172.31.40.0-255,66,229947,76,349646
17999,0.051596,74.125.24.0-255,5738,235685,76,349646
18000,0.051603,172.31.40.0-255,66,235751,76,349646
18001,0.053755,74.125.24.0-255,5738,241489,76,349646
18002,0.053762,172.31.40.0-255,66,241555,76,349646
18003,0.0559,74.125.24.0-255,5738,247293,76,349646
18004,0.055907,172.31.40.0-255,66,247359,76,349646
18005,0.058054,74.125.24.0-255,5738,253097,76,349646
18006,0.058061,172.31.40.0-255,66,253163,76,349646
18007,0.060214,74.125.24.0-255,5738,258901,76,349646
18008,0.060221,172.31.40.0-255,66,258967,76,349646
18009,0.062367,74.125.24.0-255,5738,264705,76,349646
18010,0.062374,172.31.40.0-255,66,264771,76,349646
18011,0.064519,74.125.24.0-255,5738,270509,76,349646
18012,0.064525,172.31.40.0-255,66,270575,76,349646
18013,0.066655,74.125.24.0-255,5738,276313,76,349646
18014,0.066661,172.31.40.0-255,66,276379,76,349646
18015,0.068812,74.125.24.0-255,5738,282117,76,349646
18016,0.068819,172.31.40.0-255,66,282183,76,349646
18017,0.070939,74.125.24.0-255,5738,287921,76,349646
18018,0.070945,172.31.40.0-255,66,287987,76,349646
18019,0.073126,74.125.24.0-255,5738,293725,76,349646
18020,0.073133,172.31.40.0-255,66,293791,76,349646
18021,0.075287,74.125.24.0-255,5738,299529,76,349646
18022,0.075293,172.31.40.0-255,66,299595,76,349646
18023,0.077442,74.125.24.0-255,5738,305333,76,349646
18024,0.077447,172.31.40.0-255,66,305399,76,349646
18025,0.079567,74.125.24.0-255,5738,311137,76,349646
18026,0.079574,172.31.40.0-255,66,311203,76,349646
18027,0.081756,74.125.24.0-255,5738,316941,76,349646
18028,0.081768,172.31.40.0-255,66,317007,76,349646
18029,0.083908,74.125.24.0-255,5738,322745,76,349646
18030,0.083914,172.31.40.0-255,66,322811,76,349646
18031,0.086047,74.125.24.0-255,5738,328549,76,349646
18032,0.086053,172.31.40.0-255,66,328615,76,349646
18033,0.088204,74.125.24.0-255,5738,334353,76,349646
18034,0.088211,172.31.40.0-255,66,334419,76,349646
18035,0.090359,74.125.24.0-255,5738,340157,76,349646
18036,0.090366,172.31.40.0-255,66,340223,76,349646
18037,0.092528,74.125.24.0-255,5738,345961,76,349646
18038,0.092534,172.31.40.0-255,66,346027,76,349646
18039,0.094663,74.125.24.0-255,3382,349409,76,349646
18040,0.09467,172.31.40.0-255,66,349475,76,349646
18041,0.094841,172.31.40.0-255,105,349580,76,349646
18042,0.096922,74.125.24.0-255,66,349646,76,349646
18043,0.0,74.125.24.0-255,291,291,76,233910
18044,1.6e-05,172.31.40.0-255,66,357,76,233910
18045,2.2e-05,74.125.24.0-255,1484,1841,76,233910
18046,2.7e-05,172.31.40.0-255,66,1907,76,233910
18047,3.5e-05,74.125.24.0-255,4320,6227,76,233910
18048,3.8e-05,172.31.40.0-255,66,6293,76,233910
18049,7.6e-05,172.31.40.0-255,66,6359,76,233910
18050,0.000118,172.31.40.0-255,66,6425,76,233910
18051,0.000129,172.31.40.0-255,66,6491,76,233910
18052,0.000259,74.125.24.0-255,1484,7975,76,233910
18053,0.000263,172.31.40.0-255,66,8041,76,233910
18054,0.000269,74.125.24.0-255,2902,10943,76,233910
18055,0.000271,172.31.40.0-255,66,11009,76,233910
18056,0.000276,74.125.24.0-255,2902,13911,76,233910
18057,0.000278,172.31.40.0-255,66,13977,76,233910
18058,0.000298,74.125.24.0-255,2902,16879,76,233910
18059,0.000301,172.31.40.0-255,66,16945,76,233910
18060,0.000315,74.125.24.0-255,2902,19847,76,233910
18061,0.000317,172.31.40.0-255,66,19913,76,233910
18062,0.000334,74.125.24.0-255,1484,21397,76,233910
18063,0.000337,172.31.40.0-255,66,21463,76,233910
18064,0.000344,74.125.24.0-255,5379,26842,76,233910
18065,0.000346,172.31.40.0-255,66,26908,76,233910
18066,0.000365,74.125.24.0-255,4320,31228,76,233910
18067,0.000368,172.31.40.0-255,66,31294,76,233910
18068,0.000393,74.125.24.0-255,4320,35614,76,233910
18069,0.000395,172.31.40.0-255,66,35680,76,233910
18070,0.000414,74.125.24.0-255,1484,37164,76,233910
18071,0.000416,172.31.40.0-255,66,37230,76,233910
18072,0.000442,74.125.24.0-255,4336,41566,76,233910
18073,0.000444,172.31.40.0-255,66,41632,76,233910
18074,0.000447,74.125.24.0-255,332,41964,76,233910
18075,0.000913,74.125.24.0-255,1484,43448,76,233910
18076,0.000918,172.31.40.0-255,66,43514,76,233910
18077,0.000923,74.125.24.0-255,2902,46416,76,233910
18078,0.000926,172.31.40.0-255,66,46482,76,233910
18079,0.000934,74.125.24.0-255,5738,52220,76,233910
18080,0.000936,172.31.40.0-255,66,52286,76,233910
18081,0.000971,172.31.40.0-255,66,52352,76,233910
18082,0.000994,172.31.40.0-255,66,52418,76,233910
18083,0.001019,74.125.24.0-255,3602,56020,76,233910
18084,0.001022,172.31.40.0-255,66,56086,76,233910
18085,0.001291,74.125.24.0-255,1484,57570,76,233910
18086,0.001298,74.125.24.0-255,2902,60472,76,233910
18087,0.001302,172.31.40.0-255,66,60538,76,233910
18088,0.001309,74.125.24.0-255,5738,66276,76,233910
18089,0.001311,172.31.40.0-255,66,66342,76,233910
18090,0.001314,74.125.24.0-255,2902,69244,76,233910
18091,0.001316,172.31.40.0-255,66,69310,76,233910
18092,0.00135,172.31.40.0-255,66,69376,76,233910
18093,0.001381,172.31.40.0-255,66,69442,76,233910
18094,0.001973,74.125.24.0-255,1484,70926,76,233910
18095,0.001983,74.125.24.0-255,2902,73828,76,233910
18096,0.001988,172.31.40.0-255,66,73894,76,233910
18097,0.001995,74.125.24.0-255,5738,79632,76,233910
18098,0.001998,172.31.40.0-255,66,79698,76,233910
18099,0.002002,74.125.24.0-255,2902,82600,76,233910
18100,0.002004,172.31.40.0-255,66,82666,76,233910
18101,0.002051,172.31.40.0-255,66,82732,76,233910
18102,0.002063,172.31.40.0-255,66,82798,76,233910
18103,0.002066,74.125.24.0-255,766,83564,76,233910
18104,0.002175,74.125.24.0-255,1484,85048,76,233910
18105,0.00218,172.31.40.0-255,66,85114,76,233910
18106,0.002185,74.125.24.0-255,2902,88016,76,233910
18107,0.002188,172.31.40.0-255,66,88082,76,233910
18108,0.002195,74.125.24.0-255,5738,93820,76,233910
18109,0.002197,172.31.40.0-255,66,93886,76,233910
18110,0.002225,74.125.24.0-255,1484,95370,76,233910
18111,0.002228,172.31.40.0-255,78,95448,76,233910
18112,0.002236,74.125.24.0-255,7156,102604,76,233910
18113,0.00224,172.31.40.0-255,66,102670,76,233910
18114,0.00225,172.31.40.0-255,66,102736,76,233910
18115,0.002257,74.125.24.0-255,5020,107756,76,233910
18116,0.002259,172.31.40.0-255,66,107822,76,233910
18117,0.00246,74.125.24.0-255,1484,109306,76,233910
18118,0.002467,74.125.24.0-255,2902,112208,76,233910
18119,0.002472,172.31.40.0-255,66,112274,76,233910
18120,0.002476,74.125.24.0-255,2902,115176,76,233910
18121,0.002479,172.31.40.0-255,66,115242,76,233910
18122,0.002494,74.125.24.0-255,1484,116726,76,233910
18123,0.002498,74.125.24.0-255,2902,119628,76,233910
18124,0.002501,172.31.40.0-255,66,119694,76,233910
18125,0.002514,74.125.24.0-255,2902,122596,76,233910
18126,0.002517,172.31.40.0-255,66,122662,76,233910
18127,0.002522,74.125.24.0-255,4320,126982,76,233910
18128,0.002524,172.31.40.0-255,66,127048,76,233910
18129,0.002527,74.125.24.0-255,1484,128532,76,233910
18130,0.002562,172.31.40.0-255,66,128598,76,233910
18131,0.002576,74.125.24.0-255,2184,130782,76,233910
18132,0.002578,172.31.40.0-255,66,130848,76,233910
18133,0.002583,74.125.24.0-255,2902,133750,76,233910
18134,0.002585,172.31.40.0-255,66,133816,76,233910
18135,0.002591,74.125.24.0-255,4320,138136,76,233910
18136,0.002594,172.31.40.0-255,66,138202,76,233910
18137,0.002641,172.31.40.0-255,66,138268,76,233910
18138,0.002693,172.31.40.0-255,66,138334,76,233910
18139,0.0027,74.125.24.0-255,7156,145490,76,233910
18140,0.002702,172.31.40.0-255,66,145556,76,233910
18141,0.00271,74.125.24.0-255,7156,152712,76,233910
18142,0.002713,172.31.40.0-255,66,152778,76,233910
18143,0.002736,74.125.24.0-255,1484,154262,76,233910
18144,0.002756,172.31.40.0-255,66,154328,76,233910
18145,0.002758,74.125.24.0-255,766,155094,76,233910
18146,0.003135,74.125.24.0-255,1484,156578,76,233910
18147,0.00314,172.31.40.0-255,66,156644,76,233910
18148,0.003147,74.125.24.0-255,2902,159546,76,233910
18149,0.003149,172.31.40.0-255,66,159612,76,233910
18150,0.003154,74.125.24.0-255,4320,163932,76,233910
18151,0.003157,172.31.40.0-255,66,163998,76,233910
18152,0.003176,74.125.24.0-255,1484,165482,76,233910
18153,0.003183,74.125.24.0-255,5738,171220,76,233910
18154,0.003185,172.31.40.0-255,66,171286,76,233910
18155,0.003218,74.125.24.0-255,7156,178442,76,233910
18156,0.003221,172.31.40.0-255,66,178508,76,233910
18157,0.003233,172.31.40.0-255,66,178574,76,233910
18158,0.003352,74.125.24.0-255,1484,180058,76,233910
18159,0.003358,74.125.24.0-255,2902,182960,76,233910
18160,0.003362,172.31.40.0-255,66,183026,76,233910
18161,0.003383,74.125.24.0-255,5738,188764,76,233910
18162,0.003387,172.31.40.0-255,66,188830,76,233910
18163,0.003391,74.125.24.0-255,2902,191732,76,233910
18164,0.003392,172.31.40.0-255,66,191798,76,233910
18165,0.003413,74.125.24.0-255,2902,194700,76,233910
18166,0.003415,172.31.40.0-255,66,194766,76,233910
18167,0.003418,74.125.24.0-255,1484,196250,76,233910
18168,0.003421,74.125.24.0-255,1484,197734,76,233910
18169,0.003423,172.31.40.0-255,66,197800,76,233910
18170,0.003426,74.125.24.0-255,1484,199284,76,233910
18171,0.003455,74.125.24.0-255,5738,205022,76,233910
18172,0.003458,172.31.40.0-255,66,205088,76,233910
18173,0.003462,74.125.24.0-255,2902,207990,76,233910
18174,0.003464,172.31.40.0-255,66,208056,76,233910
18175,0.003483,74.125.24.0-255,5020,213076,76,233910
18176,0.003486,172.31.40.0-255,66,213142,76,233910
18177,0.003517,74.125.24.0-255,7156,220298,76,233910
18178,0.00352,172.31.40.0-255,66,220364,76,233910
18179,0.003525,74.125.24.0-255,4320,224684,76,233910
18180,0.003528,172.31.40.0-255,66,224750,76,233910
18181,0.003547,74.125.24.0-255,4320,229070,76,233910
18182,0.003549,172.31.40.0-255,66,229136,76,233910
18183,0.003623,172.31.40.0-255,66,229202,76,233910
18184,0.003638,172.31.40.0-255,66,229268,76,233910
18185,0.00364,74.125.24.0-255,105,229373,76,233910
18186,0.009634,172.31.40.0-255,66,229439,76,233910
18187,0.009675,172.31.40.0-255,105,229544,76,233910
18188,0.011728,74.125.24.0-255,66,229610,76,233910
18189,0.030819,172.31.40.0-255,172,229782,76,233910
18190,0.030851,172.31.40.0-255,1107,230889,76,233910
18191,0.030916,172.31.40.0-255,1514,232403,76,233910
18192,0.030918,172.31.40.0-255,1309,233712,76,233910
18193,0.032485,104.244.42.0-255,66,233778,76,233910
18194,0.032515,104.244.42.0-255,66,233844,76,233910
18195,0.032569,104.244.42.0-255,66,233910,76,233910
18196,0.0,74.125.200.0-255,156,156,76,381545
18197,2.2e-05,172.31.40.0-255,66,222,76,381545
18198,2.9e-05,74.125.200.0-255,1484,1706,76,381545
18199,3.2e-05,172.31.40.0-255,66,1772,76,381545
18200,3.8e-05,74.125.200.0-255,2902,4674,76,381545
18201,4.1e-05,172.31.40.0-255,66,4740,76,381545
18202,4.6e-05,74.125.200.0-255,4320,9060,76,381545
18203,4.9e-05,172.31.40.0-255,66,9126,76,381545
18204,6.4e-05,74.125.200.0-255,1484,10610,76,381545
18205,6.6e-05,172.31.40.0-255,66,10676,76,381545
18206,8.8e-05,172.31.40.0-255,66,10742,76,381545
18207,9.3e-05,74.125.200.0-255,4320,15062,76,381545
18208,9.5e-05,172.31.40.0-255,66,15128,76,381545
18209,0.000147,74.125.200.0-255,2902,18030,76,381545
18210,0.00015,172.31.40.0-255,66,18096,76,381545
18211,0.000168,74.125.200.0-255,5379,23475,76,381545
18212,0.00017,172.31.40.0-255,66,23541,76,381545
18213,0.000292,74.125.200.0-255,1484,25025,76,381545
18214,0.000296,172.31.40.0-255,66,25091,76,381545
18215,0.000336,74.125.200.0-255,1484,26575,76,381545
18216,0.000338,172.31.40.0-255,66,26641,76,381545
18217,0.000341,74.125.200.0-255,1484,28125,76,381545
18218,0.000344,172.31.40.0-255,66,28191,76,381545
18219,0.000356,74.125.200.0-255,1484,29675,76,381545
18220,0.000358,172.31.40.0-255,66,29741,76,381545
18221,0.000373,74.125.200.0-255,5738,35479,76,381545
18222,0.000375,172.31.40.0-255,66,35545,76,381545
18223,0.00038,74.125.200.0-255,2902,38447,76,381545
18224,0.000381,172.31.40.0-255,66,38513,76,381545
18225,0.000406,74.125.200.0-255,4320,42833,76,381545
18226,0.000409,172.31.40.0-255,66,42899,76,381545
18227,0.000416,74.125.200.0-255,7156,50055,76,381545
18228,0.000418,172.31.40.0-255,66,50121,76,381545
18229,0.000432,74.125.200.0-255,1484,51605,76,381545
18230,0.000438,74.125.200.0-255,4320,55925,76,381545
18231,0.00044,172.31.40.0-255,66,55991,76,381545
18232,0.000461,74.125.200.0-255,2184,58175,76,381545
18233,0.000464,172.31.40.0-255,66,58241,76,381545
18234,0.000466,74.125.200.0-255,356,58597,76,381545
18235,0.0005,74.125.200.0-255,132,58729,76,381545
18236,0.000555,74.125.200.0-255,1484,60213,76,381545
18237,0.000558,172.31.40.0-255,66,60279,76,381545
18238,0.000572,74.125.200.0-255,2902,63181,76,381545
18239,0.000574,172.31.40.0-255,66,63247,76,381545
18240,0.000577,74.125.200.0-255,1484,64731,76,381545
18241,0.000595,74.125.200.0-255,1484,66215,76,381545
18242,0.000597,172.31.40.0-255,66,66281,76,381545
18243,0.000616,74.125.200.0-255,1484,67765,76,381545
18244,0.000622,74.125.200.0-255,5738,73503,76,381545
18245,0.000625,172.31.40.0-255,66,73569,76,381545
18246,0.000628,74.125.200.0-255,1484,75053,76,381545
18247,0.000645,74.125.200.0-255,4320,79373,76,381545
18248,0.000648,172.31.40.0-255,66,79439,76,381545
18249,0.00065,74.125.200.0-255,1484,80923,76,381545
18250,0.000673,74.125.200.0-255,5738,86661,76,381545
18251,0.000675,172.31.40.0-255,66,86727,76,381545
18252,0.000697,74.125.200.0-255,6723,93450,76,381545
18253,0.0007,172.31.40.0-255,66,93516,76,381545
18254,0.000872,74.125.200.0-255,1484,95000,76,381545
18255,0.000905,74.125.200.0-255,1484,96484,76,381545
18256,0.000907,172.31.40.0-255,66,96550,76,381545
18257,0.000926,74.125.200.0-255,1484,98034,76,381545
18258,0.000932,74.125.200.0-255,4320,102354,76,381545
18259,0.000933,172.31.40.0-255,66,102420,76,381545
18260,0.000943,172.31.40.0-255,66,102486,76,381545
18261,0.000948,74.125.200.0-255,5738,108224,76,381545
18262,0.00095,172.31.40.0-255,66,108290,76,381545
18263,0.000967,74.125.200.0-255,2902,111192,76,381545
18264,0.000969,172.31.40.0-255,66,111258,76,381545
18265,0.000993,74.125.200.0-255,5738,116996,76,381545
18266,0.000996,172.31.40.0-255,66,117062,76,381545
18267,0.001013,74.125.200.0-255,2184,119246,76,381545
18268,0.001015,172.31.40.0-255,66,119312,76,381545
18269,0.001489,74.125.200.0-255,1484,120796,76,381545
18270,0.001511,74.125.200.0-255,2902,123698,76,381545
18271,0.001514,172.31.40.0-255,66,123764,76,381545
18272,0.001534,74.125.200.0-255,5738,129502,76,381545
18273,0.001536,172.31.40.0-255,66,129568,76,381545
18274,0.001556,74.125.200.0-255,1484,131052,76,381545
18275,0.001588,74.125.200.0-255,2902,133954,76,381545
18276,0.001591,172.31.40.0-255,66,134020,76,381545
18277,0.001604,74.125.200.0-255,1484,135504,76,381545
18278,0.001625,74.125.200.0-255,2902,138406,76,381545
18279,0.001628,172.31.40.0-255,66,138472,76,381545
18280,0.001631,74.125.200.0-255,1484,139956,76,381545
18281,0.001649,74.125.200.0-255,4320,144276,76,381545
18282,0.001651,172.31.40.0-255,66,144342,76,381545
18283,0.001654,74.125.200.0-255,1484,145826,76,381545
18284,0.001671,74.125.200.0-255,2902,148728,76,381545
18285,0.001673,172.31.40.0-255,66,148794,76,381545
18286,0.001676,74.125.200.0-255,1484,150278,76,381545
18287,0.001696,74.125.200.0-255,3602,153880,76,381545
18288,0.001698,172.31.40.0-255,66,153946,76,381545
18289,0.001945,74.125.200.0-255,1484,155430,76,381545
18290,0.001952,74.125.200.0-255,1484,156914,76,381545
18291,0.001955,172.31.40.0-255,66,156980,76,381545
18292,0.001972,74.125.200.0-255,1484,158464,76,381545
18293,0.001975,74.125.200.0-255,1484,159948,76,381545
18294,0.001977,172.31.40.0-255,66,160014,76,381545
18295,0.001992,74.125.200.0-255,2902,162916,76,381545
18296,0.001995,172.31.40.0-255,66,162982,76,381545
18297,0.001998,74.125.200.0-255,1484,164466,76,381545
18298,0.002022,74.125.200.0-255,4320,168786,76,381545
18299,0.002024,172.31.40.0-255,66,168852,76,381545
18300,0.00203,74.125.200.0-255,4320,173172,76,381545
18301,0.002032,172.31.40.0-255,66,173238,76,381545
18302,0.002045,74.125.200.0-255,1484,174722,76,381545
18303,0.00206,74.125.200.0-255,2902,177624,76,381545
18304,0.002062,172.31.40.0-255,66,177690,76,381545
18305,0.00208,74.125.200.0-255,1484,179174,76,381545
18306,0.002087,74.125.200.0-255,4320,183494,76,381545
18307,0.002089,172.31.40.0-255,66,183560,76,381545
18308,0.002105,74.125.200.0-255,1484,185044,76,381545
18309,0.002111,74.125.200.0-255,3602,188646,76,381545
18310,0.002113,172.31.40.0-255,66,188712,76,381545
18311,0.002125,74.125.200.0-255,1484,190196,76,381545
18312,0.002143,74.125.200.0-255,2902,193098,76,381545
18313,0.002145,172.31.40.0-255,66,193164,76,381545
18314,0.002166,74.125.200.0-255,4320,197484,76,381545
18315,0.002168,172.31.40.0-255,66,197550,76,381545
18316,0.002189,74.125.200.0-255,4320,201870,76,381545
18317,0.002191,172.31.40.0-255,66,201936,76,381545
18318,0.002194,74.125.200.0-255,1484,203420,76,381545
18319,0.002217,172.31.40.0-255,66,203486,76,381545
18320,0.002228,172.31.40.0-255,66,203552,76,381545
18321,0.002269,74.125.200.0-255,1484,205036,76,381545
18322,0.002284,74.125.200.0-255,2184,207220,76,381545
18323,0.002287,172.31.40.0-255,66,207286,76,381545
18324,0.002305,74.125.200.0-255,1484,208770,76,381545
18325,0.00232,74.125.200.0-255,2902,211672,76,381545
18326,0.002322,172.31.40.0-255,66,211738,76,381545
18327,0.002328,74.125.200.0-255,4320,216058,76,381545
18328,0.00233,172.31.40.0-255,66,216124,76,381545
18329,0.002339,74.125.200.0-255,2902,219026,76,381545
18330,0.002341,172.31.40.0-255,66,219092,76,381545
18331,0.002372,74.125.200.0-255,2902,221994,76,381545
18332,0.002375,172.31.40.0-255,66,222060,76,381545
18333,0.002387,172.31.40.0-255,66,222126,76,381545
18334,0.002392,74.125.200.0-255,4320,226446,76,381545
18335,0.002394,172.31.40.0-255,66,226512,76,381545
18336,0.00242,74.125.200.0-255,2184,228696,76,381545
18337,0.002423,172.31.40.0-255,66,228762,76,381545
18338,0.002441,74.125.200.0-255,1484,230246,76,381545
18339,0.002458,74.125.200.0-255,1484,231730,76,381545
18340,0.002461,172.31.40.0-255,66,231796,76,381545
18341,0.004842,74.125.200.0-255,2902,234698,76,381545
18342,0.004849,172.31.40.0-255,66,234764,76,381545
18343,0.004875,74.125.200.0-255,2902,237666,76,381545
18344,0.004877,172.31.40.0-255,66,237732,76,381545
18345,0.007275,74.125.200.0-255,2902,240634,76,381545
18346,0.00728,172.31.40.0-255,66,240700,76,381545
18347,0.007299,74.125.200.0-255,2902,243602,76,381545
18348,0.007302,172.31.40.0-255,66,243668,76,381545
18349,0.009743,74.125.200.0-255,5738,249406,76,381545
18350,0.009749,172.31.40.0-255,66,249472,76,381545
18351,0.012182,74.125.200.0-255,5738,255210,76,381545
18352,0.012191,172.31.40.0-255,66,255276,76,381545
18353,0.014646,74.125.200.0-255,5738,261014,76,381545
18354,0.014655,172.31.40.0-255,66,261080,76,381545
18355,0.017087,74.125.200.0-255,5738,266818,76,381545
18356,0.017095,172.31.40.0-255,66,266884,76,381545
18357,0.019522,74.125.200.0-255,5738,272622,76,381545
18358,0.019529,172.31.40.0-255,66,272688,76,381545
18359,0.021961,74.125.200.0-255,5738,278426,76,381545
18360,0.021969,172.31.40.0-255,66,278492,76,381545
18361,0.024397,74.125.200.0-255,5738,284230,76,381545
18362,0.024403,172.31.40.0-255,66,284296,76,381545
18363,0.026843,74.125.200.0-255,5738,290034,76,381545
18364,0.026851,172.31.40.0-255,66,290100,76,381545
18365,0.028833,172.31.40.0-255,172,290272,76,381545
18366,0.028862,172.31.40.0-255,1105,291377,76,381545
18367,0.028922,172.31.40.0-255,1514,292891,76,381545
18368,0.028924,172.31.40.0-255,1514,294405,76,381545
18369,0.028925,172.31.40.0-255,1514,295919,76,381545
18370,0.028926,172.31.40.0-255,1093,297012,76,381545
18371,0.029281,74.125.200.0-255,5738,302750,76,381545
18372,0.029287,172.31.40.0-255,66,302816,76,381545
18373,0.030514,104.244.42.0-255,66,302882,76,381545
18374,0.030542,104.244.42.0-255,66,302948,76,381545
18375,0.030686,104.244.42.0-255,66,303014,76,381545
18376,0.0307,104.244.42.0-255,66,303080,76,381545
18377,0.031719,74.125.200.0-255,5738,308818,76,381545
18378,0.031725,172.31.40.0-255,66,308884,76,381545
18379,0.034173,74.125.200.0-255,5738,314622,76,381545
18380,0.03418,172.31.40.0-255,66,314688,76,381545
18381,0.036649,74.125.200.0-255,5738,320426,76,381545
18382,0.036655,172.31.40.0-255,66,320492,76,381545
18383,0.039096,74.125.200.0-255,5738,326230,76,381545
18384,0.039101,172.31.40.0-255,66,326296,76,381545
18385,0.041541,74.125.200.0-255,5738,332034,76,381545
18386,0.041552,172.31.40.0-255,66,332100,76,381545
18387,0.04399,74.125.200.0-255,5738,337838,76,381545
18388,0.043998,172.31.40.0-255,66,337904,76,381545
18389,0.046436,74.125.200.0-255,5738,343642,76,381545
18390,0.046443,172.31.40.0-255,66,343708,76,381545
18391,0.048887,74.125.200.0-255,5738,349446,76,381545
18392,0.048894,172.31.40.0-255,66,349512,76,381545
18393,0.05134,74.125.200.0-255,5738,355250,76,381545
18394,0.051347,172.31.40.0-255,66,355316,76,381545
18395,0.05379,74.125.200.0-255,5738,361054,76,381545
18396,0.053796,172.31.40.0-255,66,361120,76,381545
18397,0.056238,74.125.200.0-255,5738,366858,76,381545
18398,0.056244,172.31.40.0-255,66,366924,76,381545
18399,0.058687,74.125.200.0-255,5738,372662,76,381545
18400,0.058693,172.31.40.0-255,66,372728,76,381545
18401,0.061131,74.125.200.0-255,5738,378466,76,381545
18402,0.061137,172.31.40.0-255,66,378532,76,381545
18403,0.063593,74.125.200.0-255,2776,381308,76,381545
18404,0.063599,172.31.40.0-255,66,381374,76,381545
18405,0.063734,172.31.40.0-255,105,381479,76,381545
18406,0.066129,74.125.200.0-255,66,381545,76,381545
18407,0.0,74.125.68.0-255,146,146,76,410195
18408,2.4e-05,172.31.40.0-255,66,212,76,410195
18409,3.1e-05,74.125.68.0-255,1484,1696,76,410195
18410,3.5e-05,172.31.40.0-255,66,1762,76,410195
18411,3.8e-05,74.125.68.0-255,1484,3246,76,410195
18412,4.1e-05,172.31.40.0-255,66,3312,76,410195
18413,4.8e-05,74.125.68.0-255,2902,6214,76,410195
18414,5.1e-05,172.31.40.0-255,66,6280,76,410195
18415,5.7e-05,74.125.68.0-255,5738,12018,76,410195
18416,6.1e-05,172.31.40.0-255,66,12084,76,410195
18417,8.7e-05,74.125.68.0-255,2127,14211,76,410195
18418,9e-05,172.31.40.0-255,66,14277,76,410195
18419,0.000154,74.125.68.0-255,1484,15761,76,410195
18420,0.000157,172.31.40.0-255,66,15827,76,410195
18421,0.000177,74.125.68.0-255,1484,17311,76,410195
18422,0.00018,172.31.40.0-255,66,17377,76,410195
18423,0.000207,74.125.68.0-255,1484,18861,76,410195
18424,0.00021,172.31.40.0-255,66,18927,76,410195
18425,0.000222,74.125.68.0-255,1484,20411,76,410195
18426,0.000225,172.31.40.0-255,66,20477,76,410195
18427,0.000232,74.125.68.0-255,5738,26215,76,410195
18428,0.000234,172.31.40.0-255,66,26281,76,410195
18429,0.000237,74.125.68.0-255,1484,27765,76,410195
18430,0.000239,172.31.40.0-255,66,27831,76,410195
18431,0.000276,74.125.68.0-255,3961,31792,76,410195
18432,0.00028,172.31.40.0-255,66,31858,76,410195
18433,0.000402,74.125.68.0-255,1484,33342,76,410195
18434,0.000407,172.31.40.0-255,66,33408,76,410195
18435,0.000411,74.125.68.0-255,1484,34892,76,410195
18436,0.000413,172.31.40.0-255,66,34958,76,410195
18437,0.00043,74.125.68.0-255,1484,36442,76,410195
18438,0.000433,172.31.40.0-255,66,36508,76,410195
18439,0.00044,74.125.68.0-255,5738,42246,76,410195
18440,0.000442,172.31.40.0-255,66,42312,76,410195
18441,0.000449,74.125.68.0-255,6797,49109,76,410195
18442,0.000451,172.31.40.0-255,66,49175,76,410195
18443,0.000479,74.125.68.0-255,5738,54913,76,410195
18444,0.000482,172.31.40.0-255,66,54979,76,410195
18445,0.000498,74.125.68.0-255,1484,56463,76,410195
18446,0.0005,172.31.40.0-255,66,56529,76,410195
18447,0.000506,74.125.68.0-255,4320,60849,76,410195
18448,0.000508,172.31.40.0-255,66,60915,76,410195
18449,0.000534,74.125.68.0-255,4320,65235,76,410195
18450,0.000537,172.31.40.0-255,66,65301,76,410195
18451,0.00054,74.125.68.0-255,1438,66739,76,410195
18452,0.000542,172.31.40.0-255,66,66805,76,410195
18453,0.000628,74.125.68.0-255,109,66914,76,410195
18454,0.000633,172.31.40.0-255,66,66980,76,410195
18455,0.000778,74.125.68.0-255,330,67310,76,410195
18456,0.000782,172.31.40.0-255,66,67376,76,410195
18457,0.000922,74.125.68.0-255,1484,68860,76,410195
18458,0.000926,172.31.40.0-255,66,68926,76,410195
18459,0.000931,74.125.68.0-255,2902,71828,76,410195
18460,0.000933,172.31.40.0-255,66,71894,76,410195
18461,0.000951,74.125.68.0-255,4320,76214,76,410195
18462,0.000954,172.31.40.0-255,66,76280,76,410195
18463,0.000978,74.125.68.0-255,1484,77764,76,410195
18464,0.000981,172.31.40.0-255,66,77830,76,410195
18465,0.000996,74.125.68.0-255,5738,83568,76,410195
18466,0.000999,172.31.40.0-255,66,83634,76,410195
18467,0.001014,74.125.68.0-255,2902,86536,76,410195
18468,0.001016,172.31.40.0-255,66,86602,76,410195
18469,0.001041,74.125.68.0-255,5738,92340,76,410195
18470,0.001044,172.31.40.0-255,66,92406,76,410195
18471,0.001047,74.125.68.0-255,1484,93890,76,410195
18472,0.001049,172.31.40.0-255,66,93956,76,410195
18473,0.00109,172.31.40.0-255,66,94022,76,410195
18474,0.001156,74.125.68.0-255,1484,95506,76,410195
18475,0.001159,172.31.40.0-255,66,95572,76,410195
18476,0.001164,74.125.68.0-255,2902,98474,76,410195
18477,0.001166,172.31.40.0-255,66,98540,76,410195
18478,0.001179,74.125.68.0-255,2902,101442,76,410195
18479,0.001181,172.31.40.0-255,66,101508,76,410195
18480,0.001186,74.125.68.0-255,4320,105828,76,410195
18481,0.001189,172.31.40.0-255,66,105894,76,410195
18482,0.001226,74.125.68.0-255,7156,113050,76,410195
18483,0.00123,172.31.40.0-255,66,113116,76,410195
18484,0.001249,74.125.68.0-255,1484,114600,76,410195
18485,0.001251,172.31.40.0-255,66,114666,76,410195
18486,0.001256,74.125.68.0-255,2902,117568,76,410195
18487,0.001258,172.31.40.0-255,66,117634,76,410195
18488,0.00129,74.125.68.0-255,4320,121954,76,410195
18489,0.001294,172.31.40.0-255,66,122020,76,410195
18490,0.001318,74.125.68.0-255,6438,128458,76,410195
18491,0.001322,172.31.40.0-255,66,128524,76,410195
18492,0.003326,74.125.68.0-255,5738,134262,76,410195
18493,0.003332,172.31.40.0-255,66,134328,76,410195
18494,0.005335,74.125.68.0-255,4320,138648,76,410195
18495,0.005339,172.31.40.0-255,66,138714,76,410195
18496,0.005359,74.125.68.0-255,1484,140198,76,410195
18497,0.005361,172.31.40.0-255,66,140264,76,410195
18498,0.007353,74.125.68.0-255,5738,146002,76,410195
18499,0.00736,172.31.40.0-255,66,146068,76,410195
18500,0.009355,74.125.68.0-255,5738,151806,76,410195
18501,0.009362,172.31.40.0-255,66,151872,76,410195
18502,0.01136,74.125.68.0-255,5738,157610,76,410195
18503,0.011367,172.31.40.0-255,66,157676,76,410195
18504,0.013383,74.125.68.0-255,5738,163414,76,410195
18505,0.01339,172.31.40.0-255,66,163480,76,410195
18506,0.015382,74.125.68.0-255,5738,169218,76,410195
18507,0.015388,172.31.40.0-255,66,169284,76,410195
18508,0.01739,74.125.68.0-255,5738,175022,76,410195
18509,0.017398,172.31.40.0-255,66,175088,76,410195
18510,0.019393,74.125.68.0-255,5738,180826,76,410195
18511,0.019401,172.31.40.0-255,66,180892,76,410195
18512,0.021404,74.125.68.0-255,5738,186630,76,410195
18513,0.021411,172.31.40.0-255,66,186696,76,410195
18514,0.023415,74.125.68.0-255,5738,192434,76,410195
18515,0.023424,172.31.40.0-255,66,192500,76,410195
18516,0.02547,74.125.68.0-255,5738,198238,76,410195
18517,0.025478,172.31.40.0-255,66,198304,76,410195
18518,0.027483,74.125.68.0-255,5738,204042,76,410195
18519,0.02749,172.31.40.0-255,66,204108,76,410195
18520,0.029484,74.125.68.0-255,5738,209846,76,410195
18521,0.029491,172.31.40.0-255,66,209912,76,410195
18522,0.03073,172.31.40.0-255,171,210083,76,410195
18523,0.030761,172.31.40.0-255,1128,211211,76,410195
18524,0.030818,172.31.40.0-255,1514,212725,76,410195
18525,0.03082,172.31.40.0-255,321,213046,76,410195
18526,0.031496,74.125.68.0-255,5738,218784,76,410195
18527,0.031502,172.31.40.0-255,66,218850,76,410195
18528,0.032404,104.244.42.0-255,66,218916,76,410195
18529,0.033504,74.125.68.0-255,5738,224654,76,410195
18530,0.03351,172.31.40.0-255,66,224720,76,410195
18531,0.035513,74.125.68.0-255,5738,230458,76,410195
18532,0.035522,172.31.40.0-255,66,230524,76,410195
18533,0.037521,74.125.68.0-255,5738,236262,76,410195
18534,0.037527,172.31.40.0-255,66,236328,76,410195
18535,0.039525,74.125.68.0-255,5738,242066,76,410195
18536,0.039532,172.31.40.0-255,66,242132,76,410195
18537,0.041554,74.125.68.0-255,5738,247870,76,410195
18538,0.041561,172.31.40.0-255,66,247936,76,410195
18539,0.043566,74.125.68.0-255,5738,253674,76,410195
18540,0.04358,172.31.40.0-255,66,253740,76,410195
18541,0.045594,74.125.68.0-255,5738,259478,76,410195
18542,0.045608,172.31.40.0-255,66,259544,76,410195
18543,0.047629,74.125.68.0-255,5738,265282,76,410195
18544,0.047643,172.31.40.0-255,66,265348,76,410195
18545,0.049653,74.125.68.0-255,5738,271086,76,410195
18546,0.049669,172.31.40.0-255,66,271152,76,410195
18547,0.05168,74.125.68.0-255,5738,276890,76,410195
18548,0.051688,172.31.40.0-255,66,276956,76,410195
18549,0.05369,74.125.68.0-255,5738,282694,76,410195
18550,0.053697,172.31.40.0-255,66,282760,76,410195
18551,0.055693,74.125.68.0-255,5738,288498,76,410195
18552,0.0557,172.31.40.0-255,66,288564,76,410195
18553,0.057726,74.125.68.0-255,5738,294302,76,410195
18554,0.057734,172.31.40.0-255,66,294368,76,410195
18555,0.059736,74.125.68.0-255,5738,300106,76,410195
18556,0.059743,172.31.40.0-255,66,300172,76,410195
18557,0.061738,74.125.68.0-255,5738,305910,76,410195
18558,0.061745,172.31.40.0-255,66,305976,76,410195
18559,0.063755,74.125.68.0-255,5738,311714,76,410195
18560,0.063761,172.31.40.0-255,66,311780,76,410195
18561,0.065767,74.125.68.0-255,5738,317518,76,410195
18562,0.065775,172.31.40.0-255,66,317584,76,410195
18563,0.067775,74.125.68.0-255,5738,323322,76,410195
18564,0.067783,172.31.40.0-255,66,323388,76,410195
18565,0.069784,74.125.68.0-255,5738,329126,76,410195
18566,0.069792,172.31.40.0-255,66,329192,76,410195
18567,0.071788,74.125.68.0-255,5738,334930,76,410195
18568,0.071796,172.31.40.0-255,66,334996,76,410195
18569,0.073793,74.125.68.0-255,5738,340734,76,410195
18570,0.0738,172.31.40.0-255,66,340800,76,410195
18571,0.075803,74.125.68.0-255,5738,346538,76,410195
18572,0.07581,172.31.40.0-255,66,346604,76,410195
18573,0.077808,74.125.68.0-255,5738,352342,76,410195
18574,0.077815,172.31.40.0-255,66,352408,76,410195
18575,0.07982,74.125.68.0-255,5738,358146,76,410195
18576,0.079829,172.31.40.0-255,66,358212,76,410195
18577,0.081826,74.125.68.0-255,5738,363950,76,410195
18578,0.081834,172.31.40.0-255,66,364016,76,410195
18579,0.083832,74.125.68.0-255,5738,369754,76,410195
18580,0.083843,172.31.40.0-255,66,369820,76,410195
18581,0.085859,74.125.68.0-255,5738,375558,76,410195
18582,0.085867,172.31.40.0-255,66,375624,76,410195
18583,0.08788,74.125.68.0-255,5738,381362,76,410195
18584,0.087895,172.31.40.0-255,66,381428,76,410195
18585,0.089932,74.125.68.0-255,5738,387166,76,410195
18586,0.08994,172.31.40.0-255,66,387232,76,410195
18587,0.091947,74.125.68.0-255,5738,392970,76,410195
18588,0.091955,172.31.40.0-255,66,393036,76,410195
18589,0.093965,74.125.68.0-255,5738,398774,76,410195
18590,0.093971,172.31.40.0-255,66,398840,76,410195
18591,0.095964,74.125.68.0-255,5738,404578,76,410195
18592,0.09597,172.31.40.0-255,66,404644,76,410195
18593,0.09797,74.125.68.0-255,5380,410024,76,410195
18594,0.097977,172.31.40.0-255,66,410090,76,410195
18595,0.098174,172.31.40.0-255,105,410195,76,410195
18596,0.0,172.217.194.0-255,152,152,76,224951
18597,2.1e-05,172.31.40.0-255,66,218,76,224951
18598,2.7e-05,172.217.194.0-255,1484,1702,76,224951
18599,3.1e-05,172.31.40.0-255,66,1768,76,224951
18600,3.7e-05,172.217.194.0-255,2902,4670,76,224951
18601,4e-05,172.31.40.0-255,66,4736,76,224951
18602,5.8e-05,172.217.194.0-255,4320,9056,76,224951
18603,6.1e-05,172.31.40.0-255,66,9122,76,224951
18604,7.1e-05,172.217.194.0-255,1484,10606,76,224951
18605,7.3e-05,172.31.40.0-255,66,10672,76,224951
18606,8.8e-05,172.31.40.0-255,66,10738,76,224951
18607,0.000117,172.217.194.0-255,6797,17535,76,224951
18608,0.00012,172.31.40.0-255,66,17601,76,224951
18609,0.000385,172.217.194.0-255,1484,19085,76,224951
18610,0.000391,172.31.40.0-255,66,19151,76,224951
18611,0.000395,172.217.194.0-255,1484,20635,76,224951
18612,0.000397,172.31.40.0-255,66,20701,76,224951
18613,0.000412,172.217.194.0-255,1484,22185,76,224951
18614,0.000414,172.31.40.0-255,66,22251,76,224951
18615,0.000435,172.217.194.0-255,4320,26571,76,224951
18616,0.000438,172.31.40.0-255,66,26637,76,224951
18617,0.000455,172.217.194.0-255,1484,28121,76,224951
18618,0.000457,172.31.40.0-255,66,28187,76,224951
18619,0.000469,172.31.40.0-255,66,28253,76,224951
18620,0.000472,172.217.194.0-255,1484,29737,76,224951
18621,0.000474,172.31.40.0-255,66,29803,76,224951
18622,0.000506,172.31.40.0-255,66,29869,76,224951
18623,0.000509,172.217.194.0-255,646,30515,76,224951
18624,0.00051,172.31.40.0-255,66,30581,76,224951
18625,0.000597,172.217.194.0-255,1484,32065,76,224951
18626,0.000609,172.217.194.0-255,2902,34967,76,224951
18627,0.000612,172.31.40.0-255,66,35033,76,224951
18628,0.00063,172.217.194.0-255,1484,36517,76,224951
18629,0.000643,172.217.194.0-255,2902,39419,76,224951
18630,0.000646,172.31.40.0-255,66,39485,76,224951
18631,0.00066,172.217.194.0-255,1484,40969,76,224951
18632,0.000664,172.217.194.0-255,2902,43871,76,224951
18633,0.000667,172.31.40.0-255,66,43937,76,224951
18634,0.000692,172.217.194.0-255,7156,51093,76,224951
18635,0.000695,172.31.40.0-255,66,51159,76,224951
18636,0.000718,172.217.194.0-255,4320,55479,76,224951
18637,0.000721,172.31.40.0-255,66,55545,76,224951
18638,0.00075,172.31.40.0-255,66,55611,76,224951
18639,0.000877,172.217.194.0-255,1484,57095,76,224951
18640,0.000893,172.217.194.0-255,2902,59997,76,224951
18641,0.000896,172.31.40.0-255,66,60063,76,224951
18642,0.0009,172.217.194.0-255,2902,62965,76,224951
18643,0.000902,172.31.40.0-255,66,63031,76,224951
18644,0.00092,172.217.194.0-255,2902,65933,76,224951
18645,0.000922,172.31.40.0-255,66,65999,76,224951
18646,0.000927,172.217.194.0-255,5738,71737,76,224951
18647,0.000929,172.31.40.0-255,66,71803,76,224951
18648,0.00095,172.217.194.0-255,7156,78959,76,224951
18649,0.000952,172.31.40.0-255,66,79025,76,224951
18650,0.000975,172.217.194.0-255,2902,81927,76,224951
18651,0.000978,172.31.40.0-255,66,81993,76,224951
18652,0.001008,172.31.40.0-255,66,82059,76,224951
18653,0.001153,172.217.194.0-255,1484,83543,76,224951
18654,0.001167,172.217.194.0-255,2902,86445,76,224951
18655,0.00117,172.31.40.0-255,66,86511,76,224951
18656,0.001199,172.217.194.0-255,4320,90831,76,224951
18657,0.001201,172.31.40.0-255,66,90897,76,224951
18658,0.001221,172.217.194.0-255,1484,92381,76,224951
18659,0.001234,172.31.40.0-255,66,92447,76,224951
18660,0.001239,172.217.194.0-255,4320,96767,76,224951
18661,0.00124,172.31.40.0-255,66,96833,76,224951
18662,0.001257,172.217.194.0-255,5738,102571,76,224951
18663,0.00126,172.31.40.0-255,66,102637,76,224951
18664,0.001273,172.217.194.0-255,766,103403,76,224951
18665,0.001286,172.31.40.0-255,66,103469,76,224951
18666,0.001293,172.217.194.0-255,7156,110625,76,224951
18667,0.001295,172.31.40.0-255,66,110691,76,224951
18668,0.001335,172.217.194.0-255,5738,116429,76,224951
18669,0.001338,172.31.40.0-255,66,116495,76,224951
18670,0.00138,172.31.40.0-255,66,116561,76,224951
18671,0.001388,172.217.194.0-255,1484,118045,76,224951
18672,0.0014,172.217.194.0-255,2902,120947,76,224951
18673,0.001406,172.31.40.0-255,66,121013,76,224951
18674,0.001414,172.217.194.0-255,2902,123915,76,224951
18675,0.001418,172.31.40.0-255,66,123981,76,224951
18676,0.001426,172.217.194.0-255,2902,126883,76,224951
18677,0.001444,172.31.40.0-255,66,126949,76,224951
18678,0.001475,172.31.40.0-255,66,127015,76,224951
18679,0.001487,172.217.194.0-255,1484,128499,76,224951
18680,0.001516,172.217.194.0-255,2184,130683,76,224951
18681,0.001525,172.31.40.0-255,66,130749,76,224951
18682,0.001544,172.217.194.0-255,1484,132233,76,224951
18683,0.001561,172.217.194.0-255,1484,133717,76,224951
18684,0.001566,172.31.40.0-255,66,133783,76,224951
18685,0.001576,172.217.194.0-255,1484,135267,76,224951
18686,0.001594,172.217.194.0-255,4320,139587,76,224951
18687,0.001596,172.31.40.0-255,66,139653,76,224951
18688,0.0016,172.217.194.0-255,4320,143973,76,224951
18689,0.001611,172.31.40.0-255,66,144039,76,224951
18690,0.001626,172.217.194.0-255,4320,148359,76,224951
18691,0.001643,172.31.40.0-255,66,148425,76,224951
18692,0.001656,172.217.194.0-255,2902,151327,76,224951
18693,0.001668,172.31.40.0-255,66,151393,76,224951
18694,0.001689,172.31.40.0-255,66,151459,76,224951
18695,0.001797,172.217.194.0-255,1484,152943,76,224951
18696,0.00181,172.217.194.0-255,2902,155845,76,224951
18697,0.001817,172.31.40.0-255,66,155911,76,224951
18698,0.001825,172.217.194.0-255,2902,158813,76,224951
18699,0.001829,172.31.40.0-255,66,158879,76,224951
18700,0.001841,172.217.194.0-255,2902,161781,76,224951
18701,0.001849,172.31.40.0-255,66,161847,76,224951
18702,0.001867,172.217.194.0-255,4320,166167,76,224951
18703,0.001876,172.31.40.0-255,66,166233,76,224951
18704,0.001883,172.217.194.0-255,2902,169135,76,224951
18705,0.001897,172.31.40.0-255,66,169201,76,224951
18706,0.001907,172.217.194.0-255,2902,172103,76,224951
18707,0.00192,172.217.194.0-255,5738,177841,76,224951
18708,0.001925,172.31.40.0-255,66,177907,76,224951
18709,0.001934,172.217.194.0-255,5738,183645,76,224951
18710,0.001938,172.31.40.0-255,66,183711,76,224951
18711,0.001947,172.217.194.0-255,2902,186613,76,224951
18712,0.001962,172.217.194.0-255,7156,193769,76,224951
18713,0.001971,172.31.40.0-255,66,193835,76,224951
18714,0.001976,172.217.194.0-255,3602,197437,76,224951
18715,0.00198,172.31.40.0-255,66,197503,76,224951
18716,0.001987,172.217.194.0-255,1484,198987,76,224951
18717,0.001997,172.217.194.0-255,1484,200471,76,224951
18718,0.002009,172.31.40.0-255,66,200537,76,224951
18719,0.002053,172.31.40.0-255,66,200603,76,224951
18720,0.002082,172.217.194.0-255,5738,206341,76,224951
18721,0.002091,172.31.40.0-255,66,206407,76,224951
18722,0.002098,172.217.194.0-255,2902,209309,76,224951
18723,0.002102,172.217.194.0-255,2902,212211,76,224951
18724,0.002106,172.31.40.0-255,66,212277,76,224951
18725,0.002142,172.217.194.0-255,1484,213761,76,224951
18726,0.002174,172.31.40.0-255,66,213827,76,224951
18727,0.002201,172.217.194.0-255,1484,215311,76,224951
18728,0.002215,172.217.194.0-255,5738,221049,76,224951
18729,0.002223,172.31.40.0-255,66,221115,76,224951
18730,0.002253,172.217.194.0-255,97,221212,76,224951
18731,0.007076,172.31.40.0-255,66,221278,76,224951
18732,0.009327,172.217.194.0-255,105,221383,76,224951
18733,0.010519,172.31.40.0-255,66,221449,76,224951
18734,0.010557,172.31.40.0-255,105,221554,76,224951
18735,0.012814,172.217.194.0-255,66,221620,76,224951
18736,0.033176,172.31.40.0-255,171,221791,76,224951
18737,0.033213,172.31.40.0-255,1133,222924,76,224951
18738,0.033276,172.31.40.0-255,1514,224438,76,224951
18739,0.033278,172.31.40.0-255,315,224753,76,224951
18740,0.034736,104.244.42.0-255,66,224819,76,224951
18741,0.034784,104.244.42.0-255,66,224885,76,224951
18742,0.034828,104.244.42.0-255,66,224951,76,224951
18743,0.0,74.125.68.0-255,153,153,76,386309
18744,2.3e-05,172.31.40.0-255,66,219,76,386309
18745,3.1e-05,74.125.68.0-255,1484,1703,76,386309
18746,3.6e-05,172.31.40.0-255,66,1769,76,386309
18747,4.9e-05,74.125.68.0-255,2902,4671,76,386309
18748,5.3e-05,172.31.40.0-255,66,4737,76,386309
18749,6.1e-05,74.125.68.0-255,7156,11893,76,386309
18750,6.5e-05,172.31.40.0-255,66,11959,76,386309
18751,6.9e-05,74.125.68.0-255,2089,14048,76,386309
18752,7.2e-05,172.31.40.0-255,66,14114,76,386309
18753,7.7e-05,74.125.68.0-255,2902,17016,76,386309
18754,7.9e-05,172.31.40.0-255,66,17082,76,386309
18755,0.00012,74.125.68.0-255,7156,24238,76,386309
18756,0.000123,172.31.40.0-255,66,24304,76,386309
18757,0.000128,74.125.68.0-255,2902,27206,76,386309
18758,0.00013,172.31.40.0-255,66,27272,76,386309
18759,0.000136,74.125.68.0-255,3961,31233,76,386309
18760,0.000143,172.31.40.0-255,66,31299,76,386309
18761,0.000299,74.125.68.0-255,1484,32783,76,386309
18762,0.000303,172.31.40.0-255,66,32849,76,386309
18763,0.000335,74.125.68.0-255,2902,35751,76,386309
18764,0.000338,172.31.40.0-255,66,35817,76,386309
18765,0.000342,74.125.68.0-255,2902,38719,76,386309
18766,0.000345,172.31.40.0-255,66,38785,76,386309
18767,0.000351,74.125.68.0-255,4320,43105,76,386309
18768,0.000353,172.31.40.0-255,66,43171,76,386309
18769,0.00037,172.31.40.0-255,66,43237,76,386309
18770,0.000375,74.125.68.0-255,4320,47557,76,386309
18771,0.000377,172.31.40.0-255,66,47623,76,386309
18772,0.000405,74.125.68.0-255,1484,49107,76,386309
18773,0.000408,172.31.40.0-255,66,49173,76,386309
18774,0.000417,74.125.68.0-255,7156,56329,76,386309
18775,0.000425,74.125.68.0-255,766,57095,76,386309
18776,0.00045,74.125.68.0-255,645,57740,76,386309
18777,0.000523,172.31.40.0-255,66,57806,76,386309
18778,0.000893,74.125.68.0-255,1484,59290,76,386309
18779,0.000899,74.125.68.0-255,2902,62192,76,386309
18780,0.000903,172.31.40.0-255,66,62258,76,386309
18781,0.000933,74.125.68.0-255,5738,67996,76,386309
18782,0.000937,74.125.68.0-255,2902,70898,76,386309
18783,0.000941,74.125.68.0-255,4320,75218,76,386309
18784,0.000953,172.31.40.0-255,66,75284,76,386309
18785,0.00096,74.125.68.0-255,1484,76768,76,386309
18786,0.000982,74.125.68.0-255,7156,83924,76,386309
18787,0.000985,74.125.68.0-255,1484,85408,76,386309
18788,0.000999,74.125.68.0-255,1484,86892,76,386309
18789,0.001004,74.125.68.0-255,4320,91212,76,386309
18790,0.001012,172.31.40.0-255,66,91278,76,386309
18791,0.001024,74.125.68.0-255,766,92044,76,386309
18792,0.001402,172.31.40.0-255,66,92110,76,386309
18793,0.00162,74.125.68.0-255,1484,93594,76,386309
18794,0.001629,74.125.68.0-255,1484,95078,76,386309
18795,0.001647,74.125.68.0-255,1484,96562,76,386309
18796,0.001653,74.125.68.0-255,4320,100882,76,386309
18797,0.001675,74.125.68.0-255,2902,103784,76,386309
18798,0.001699,74.125.68.0-255,5738,109522,76,386309
18799,0.001704,74.125.68.0-255,4320,113842,76,386309
18800,0.001707,74.125.68.0-255,1484,115326,76,386309
18801,0.001726,74.125.68.0-255,4320,119646,76,386309
18802,0.001743,74.125.68.0-255,4320,123966,76,386309
18803,0.00176,74.125.68.0-255,2184,126150,76,386309
18804,0.002052,74.125.68.0-255,1484,127634,76,386309
18805,0.002088,74.125.68.0-255,2902,130536,76,386309
18806,0.002154,74.125.68.0-255,1484,132020,76,386309
18807,0.002222,74.125.68.0-255,1484,133504,76,386309
18808,0.002241,74.125.68.0-255,1484,134988,76,386309
18809,0.002255,74.125.68.0-255,2902,137890,76,386309
18810,0.002284,74.125.68.0-255,5738,143628,76,386309
18811,0.002305,74.125.68.0-255,7156,150784,76,386309
18812,0.002359,74.125.68.0-255,766,151550,76,386309
18813,0.002672,74.125.68.0-255,1484,153034,76,386309
18814,0.002686,74.125.68.0-255,2902,155936,76,386309
18815,0.002702,74.125.68.0-255,1484,157420,76,386309
18816,0.002718,74.125.68.0-255,1484,158904,76,386309
18817,0.002722,74.125.68.0-255,2902,161806,76,386309
18818,0.002739,74.125.68.0-255,4320,166126,76,386309
18819,0.002761,74.125.68.0-255,5738,171864,76,386309
18820,0.002765,74.125.68.0-255,2902,174766,76,386309
18821,0.002807,74.125.68.0-255,4320,179086,76,386309
18822,0.002822,74.125.68.0-255,4320,183406,76,386309
18823,0.002825,74.125.68.0-255,1484,184890,76,386309
18824,0.002828,74.125.68.0-255,766,185656,76,386309
18825,0.002863,74.125.68.0-255,2902,188558,76,386309
18826,0.002878,74.125.68.0-255,4320,192878,76,386309
18827,0.002907,74.125.68.0-255,2902,195780,76,386309
18828,0.002924,74.125.68.0-255,2902,198682,76,386309
18829,0.002927,74.125.68.0-255,1484,200166,76,386309
18830,0.002956,74.125.68.0-255,5738,205904,76,386309
18831,0.002962,74.125.68.0-255,4320,210224,76,386309
18832,0.002991,74.125.68.0-255,5738,215962,76,386309
18833,0.003014,74.125.68.0-255,3602,219564,76,386309
18834,0.003054,74.125.68.0-255,1484,221048,76,386309
18835,0.003069,74.125.68.0-255,1484,222532,76,386309
18836,0.003088,74.125.68.0-255,1484,224016,76,386309
18837,0.003091,74.125.68.0-255,1484,225500,76,386309
18838,0.003093,74.125.68.0-255,1484,226984,76,386309
18839,0.00311,74.125.68.0-255,5738,232722,76,386309
18840,0.003166,74.125.68.0-255,5738,238460,76,386309
18841,0.003186,74.125.68.0-255,4320,242780,76,386309
18842,0.003201,74.125.68.0-255,2184,244964,76,386309
18843,0.003204,74.125.68.0-255,1484,246448,76,386309
18844,0.003218,74.125.68.0-255,2902,249350,76,386309
18845,0.003236,74.125.68.0-255,2902,252252,76,386309
18846,0.003256,74.125.68.0-255,2902,255154,76,386309
18847,0.003271,74.125.68.0-255,4320,259474,76,386309
18848,0.003281,74.125.68.0-255,1484,260958,76,386309
18849,0.003302,74.125.68.0-255,4320,265278,76,386309
18850,0.00332,74.125.68.0-255,2902,268180,76,386309
18851,0.003323,74.125.68.0-255,1484,269664,76,386309
18852,0.003327,74.125.68.0-255,2902,272566,76,386309
18853,0.00334,74.125.68.0-255,2902,275468,76,386309
18854,0.003352,74.125.68.0-255,2902,278370,76,386309
18855,0.003355,74.125.68.0-255,766,279136,76,386309
18856,0.003383,74.125.68.0-255,1484,280620,76,386309
18857,0.003413,74.125.68.0-255,1484,282104,76,386309
18858,0.003432,74.125.68.0-255,2902,285006,76,386309
18859,0.003435,74.125.68.0-255,1484,286490,76,386309
18860,0.003454,74.125.68.0-255,4320,290810,76,386309
18861,0.003458,74.125.68.0-255,2902,293712,76,386309
18862,0.003472,74.125.68.0-255,4320,298032,76,386309
18863,0.003479,74.125.68.0-255,7156,305188,76,386309
18864,0.003501,74.125.68.0-255,5738,310926,76,386309
18865,0.003505,74.125.68.0-255,2184,313110,76,386309
18866,0.003843,74.125.68.0-255,1484,314594,76,386309
18867,0.003889,74.125.68.0-255,1484,316078,76,386309
18868,0.003904,74.125.68.0-255,1484,317562,76,386309
18869,0.003907,74.125.68.0-255,1484,319046,76,386309
18870,0.003911,74.125.68.0-255,2902,321948,76,386309
18871,0.003918,74.125.68.0-255,5738,327686,76,386309
18872,0.003922,74.125.68.0-255,2902,330588,76,386309
18873,0.003946,74.125.68.0-255,7156,337744,76,386309
18874,0.00397,74.125.68.0-255,1484,339228,76,386309
18875,0.004088,74.125.68.0-255,1484,340712,76,386309
18876,0.004103,74.125.68.0-255,2902,343614,76,386309
18877,0.004132,74.125.68.0-255,4320,347934,76,386309
18878,0.004151,74.125.68.0-255,4320,352254,76,386309
18879,0.004167,74.125.68.0-255,1484,353738,76,386309
18880,0.004171,74.125.68.0-255,2902,356640,76,386309
18881,0.004192,74.125.68.0-255,5738,362378,76,386309
18882,0.004197,74.125.68.0-255,2902,365280,76,386309
18883,0.004216,74.125.68.0-255,7156,372436,76,386309
18884,0.00422,74.125.68.0-255,2184,374620,76,386309
18885,0.004233,74.125.68.0-255,2902,377522,76,386309
18886,0.004275,74.125.68.0-255,4145,381667,76,386309
18887,0.004345,74.125.68.0-255,105,381772,76,386309
18888,0.006375,172.31.40.0-255,66,381838,76,386309
18889,0.008756,172.31.40.0-255,105,381943,76,386309
18890,0.011412,74.125.68.0-255,66,382009,76,386309
18891,0.03381,172.31.40.0-255,172,382181,76,386309
18892,0.033854,172.31.40.0-255,1109,383290,76,386309
18893,0.033917,172.31.40.0-255,1514,384804,76,386309
18894,0.033944,172.31.40.0-255,1307,386111,76,386309
18895,0.035491,104.244.42.0-255,66,386177,76,386309
18896,0.035533,104.244.42.0-255,66,386243,76,386309
18897,0.035584,104.244.42.0-255,66,386309,76,386309
