,TIME,SRC,PACKET_SIZE,CUMULATIVE_PACKET_SIZE,PAGE_NUMBER,TOTAL_PACKET_SIZE
0,0.0,74.125.24.0-255,153,153,69,329277
1,2.3e-05,172.31.40.0-255,66,219,69,329277
2,3e-05,74.125.24.0-255,1484,1703,69,329277
3,3.5e-05,172.31.40.0-255,66,1769,69,329277
4,4.1e-05,74.125.24.0-255,2902,4671,69,329277
5,4.5e-05,172.31.40.0-255,66,4737,69,329277
6,5.3e-05,74.125.24.0-255,7156,11893,69,329277
7,5.6e-05,172.31.40.0-255,66,11959,69,329277
8,6.1e-05,74.125.24.0-255,2902,14861,69,329277
9,6.4e-05,172.31.40.0-255,66,14927,69,329277
10,9.4e-05,74.125.24.0-255,657,15584,69,329277
11,9.7e-05,172.31.40.0-255,66,15650,69,329277
12,0.000103,74.125.24.0-255,4320,19970,69,329277
13,0.000106,172.31.40.0-255,66,20036,69,329277
14,0.000117,172.31.40.0-255,66,20102,69,329277
15,0.000128,172.31.40.0-255,66,20168,69,329277
16,0.000152,74.125.24.0-255,4320,24488,69,329277
17,0.000154,172.31.40.0-255,66,24554,69,329277
18,0.000161,74.125.24.0-255,5020,29574,69,329277
19,0.000163,172.31.40.0-255,66,29640,69,329277
20,0.000168,74.125.24.0-255,4320,33960,69,329277
21,0.00017,172.31.40.0-255,66,34026,69,329277
22,0.000183,74.125.24.0-255,1484,35510,69,329277
23,0.000185,172.31.40.0-255,66,35576,69,329277
24,0.000216,74.125.24.0-255,4320,39896,69,329277
25,0.000219,172.31.40.0-255,66,39962,69,329277
26,0.000244,74.125.24.0-255,7137,47099,69,329277
27,0.000247,172.31.40.0-255,66,47165,69,329277
28,0.000249,74.125.24.0-255,347,47512,69,329277
29,0.000251,172.31.40.0-255,66,47578,69,329277
30,0.000386,74.125.24.0-255,1484,49062,69,329277
31,0.000402,74.125.24.0-255,2902,51964,69,329277
32,0.000406,172.31.40.0-255,66,52030,69,329277
33,0.000413,74.125.24.0-255,4320,56350,69,329277
34,0.000415,172.31.40.0-255,66,56416,69,329277
35,0.000431,74.125.24.0-255,1484,57900,69,329277
36,0.000469,74.125.24.0-255,4320,62220,69,329277
37,0.000472,172.31.40.0-255,66,62286,69,329277
38,0.000497,74.125.24.0-255,6797,69083,69,329277
39,0.0005,172.31.40.0-255,66,69149,69,329277
40,0.000511,172.31.40.0-255,66,69215,69,329277
41,0.000525,74.125.24.0-255,1125,70340,69,329277
42,0.001219,74.125.24.0-255,1484,71824,69,329277
43,0.001224,172.31.40.0-255,66,71890,69,329277
44,0.00123,74.125.24.0-255,2902,74792,69,329277
45,0.001232,172.31.40.0-255,66,74858,69,329277
46,0.001236,74.125.24.0-255,2902,77760,69,329277
47,0.001252,172.31.40.0-255,66,77826,69,329277
48,0.001281,74.125.24.0-255,2902,80728,69,329277
49,0.001284,172.31.40.0-255,66,80794,69,329277
50,0.001297,172.31.40.0-255,66,80860,69,329277
51,0.001304,74.125.24.0-255,7156,88016,69,329277
52,0.001306,172.31.40.0-255,66,88082,69,329277
53,0.001331,74.125.24.0-255,3602,91684,69,329277
54,0.001334,172.31.40.0-255,66,91750,69,329277
55,0.001704,74.125.24.0-255,1484,93234,69,329277
56,0.001727,74.125.24.0-255,2902,96136,69,329277
57,0.001732,172.31.40.0-255,66,96202,69,329277
58,0.00174,74.125.24.0-255,5738,101940,69,329277
59,0.001742,172.31.40.0-255,66,102006,69,329277
60,0.001775,74.125.24.0-255,2902,104908,69,329277
61,0.001777,172.31.40.0-255,66,104974,69,329277
62,0.001816,172.31.40.0-255,66,105040,69,329277
63,0.001828,172.31.40.0-255,66,105106,69,329277
64,0.002081,74.125.24.0-255,1484,106590,69,329277
65,0.002087,74.125.24.0-255,1484,108074,69,329277
66,0.002091,172.31.40.0-255,66,108140,69,329277
67,0.002112,74.125.24.0-255,1484,109624,69,329277
68,0.002118,74.125.24.0-255,5738,115362,69,329277
69,0.002121,172.31.40.0-255,66,115428,69,329277
70,0.002132,172.31.40.0-255,66,115494,69,329277
71,0.002157,74.125.24.0-255,4320,119814,69,329277
72,0.002159,172.31.40.0-255,66,119880,69,329277
73,0.002171,172.31.40.0-255,66,119946,69,329277
74,0.002185,74.125.24.0-255,2184,122130,69,329277
75,0.002187,172.31.40.0-255,66,122196,69,329277
76,0.002484,74.125.24.0-255,1484,123680,69,329277
77,0.002497,74.125.24.0-255,2902,126582,69,329277
78,0.0025,172.31.40.0-255,66,126648,69,329277
79,0.002503,74.125.24.0-255,1484,128132,69,329277
80,0.002525,74.125.24.0-255,4320,132452,69,329277
81,0.002527,172.31.40.0-255,66,132518,69,329277
82,0.002562,74.125.24.0-255,4320,136838,69,329277
83,0.002583,74.125.24.0-255,6438,143276,69,329277
84,0.004246,172.31.40.0-255,66,143342,69,329277
85,0.006882,74.125.24.0-255,5738,149080,69,329277
86,0.006888,172.31.40.0-255,66,149146,69,329277
87,0.009496,74.125.24.0-255,5738,154884,69,329277
88,0.009504,172.31.40.0-255,66,154950,69,329277
89,0.012146,74.125.24.0-255,5738,160688,69,329277
90,0.012155,172.31.40.0-255,66,160754,69,329277
91,0.014749,74.125.24.0-255,5738,166492,69,329277
92,0.014757,172.31.40.0-255,66,166558,69,329277
93,0.017417,74.125.24.0-255,5738,172296,69,329277
94,0.017428,172.31.40.0-255,66,172362,69,329277
95,0.020063,74.125.24.0-255,5738,178100,69,329277
96,0.020072,172.31.40.0-255,66,178166,69,329277
97,0.02269,74.125.24.0-255,5738,183904,69,329277
98,0.022697,172.31.40.0-255,66,183970,69,329277
99,0.025325,74.125.24.0-255,4320,188290,69,329277
100,0.025332,172.31.40.0-255,66,188356,69,329277
101,0.025354,74.125.24.0-255,1484,189840,69,329277
102,0.027947,74.125.24.0-255,4320,194160,69,329277
103,0.027957,172.31.40.0-255,66,194226,69,329277
104,0.030569,74.125.24.0-255,5738,199964,69,329277
105,0.030578,172.31.40.0-255,66,200030,69,329277
106,0.033231,74.125.24.0-255,5738,205768,69,329277
107,0.033258,172.31.40.0-255,66,205834,69,329277
108,0.034666,172.31.40.0-255,172,206006,69,329277
109,0.034699,172.31.40.0-255,1116,207122,69,329277
110,0.034767,172.31.40.0-255,1514,208636,69,329277
111,0.03477,172.31.40.0-255,1514,210150,69,329277
112,0.034771,172.31.40.0-255,1514,211664,69,329277
113,0.034785,172.31.40.0-255,1514,213178,69,329277
114,0.034786,172.31.40.0-255,1499,214677,69,329277
115,0.03589,74.125.24.0-255,5738,220415,69,329277
116,0.035898,172.31.40.0-255,66,220481,69,329277
117,0.03623,104.244.42.0-255,66,220547,69,329277
118,0.036266,104.244.42.0-255,66,220613,69,329277
119,0.036388,104.244.42.0-255,66,220679,69,329277
120,0.038517,74.125.24.0-255,4320,224999,69,329277
121,0.038524,172.31.40.0-255,66,225065,69,329277
122,0.038543,74.125.24.0-255,1484,226549,69,329277
123,0.041106,74.125.24.0-255,4320,230869,69,329277
124,0.041113,172.31.40.0-255,66,230935,69,329277
125,0.043743,74.125.24.0-255,5738,236673,69,329277
126,0.043752,172.31.40.0-255,66,236739,69,329277
127,0.046364,74.125.24.0-255,5738,242477,69,329277
128,0.046371,172.31.40.0-255,66,242543,69,329277
129,0.049034,74.125.24.0-255,5738,248281,69,329277
130,0.049042,172.31.40.0-255,66,248347,69,329277
131,0.05166,74.125.24.0-255,5738,254085,69,329277
132,0.051667,172.31.40.0-255,66,254151,69,329277
133,0.054294,74.125.24.0-255,5738,259889,69,329277
134,0.054301,172.31.40.0-255,66,259955,69,329277
135,0.056953,74.125.24.0-255,5738,265693,69,329277
136,0.056961,172.31.40.0-255,66,265759,69,329277
137,0.05961,74.125.24.0-255,5738,271497,69,329277
138,0.059626,172.31.40.0-255,66,271563,69,329277
139,0.062236,74.125.24.0-255,5738,277301,69,329277
140,0.062243,172.31.40.0-255,66,277367,69,329277
141,0.064866,74.125.24.0-255,5738,283105,69,329277
142,0.064872,172.31.40.0-255,66,283171,69,329277
143,0.067514,74.125.24.0-255,5738,288909,69,329277
144,0.067521,172.31.40.0-255,66,288975,69,329277
145,0.070095,74.125.24.0-255,5738,294713,69,329277
146,0.070101,172.31.40.0-255,66,294779,69,329277
147,0.07057,172.31.40.0-255,101,294880,69,329277
148,0.072738,74.125.24.0-255,5738,300618,69,329277
149,0.072744,172.31.40.0-255,66,300684,69,329277
150,0.073121,74.125.24.0-255,66,300750,69,329277
151,0.075379,74.125.24.0-255,5738,306488,69,329277
152,0.075387,172.31.40.0-255,66,306554,69,329277
153,0.078033,74.125.24.0-255,5738,312292,69,329277
154,0.078044,172.31.40.0-255,66,312358,69,329277
155,0.080651,74.125.24.0-255,5738,318096,69,329277
156,0.080658,172.31.40.0-255,66,318162,69,329277
157,0.083282,74.125.24.0-255,5738,323900,69,329277
158,0.083288,172.31.40.0-255,66,323966,69,329277
159,0.085917,74.125.24.0-255,5140,329106,69,329277
160,0.085924,172.31.40.0-255,66,329172,69,329277
161,0.086124,172.31.40.0-255,105,329277,69,329277
162,0.0,172.217.194.0-255,152,152,69,200835
163,2.2e-05,172.31.40.0-255,66,218,69,200835
164,2.9e-05,172.217.194.0-255,1484,1702,69,200835
165,3.3e-05,172.31.40.0-255,66,1768,69,200835
166,4.6e-05,172.217.194.0-255,2902,4670,69,200835
167,4.9e-05,172.31.40.0-255,66,4736,69,200835
168,5.4e-05,172.217.194.0-255,4320,9056,69,200835
169,5.7e-05,172.31.40.0-255,66,9122,69,200835
170,6.9e-05,172.31.40.0-255,66,9188,69,200835
171,0.000103,172.217.194.0-255,671,9859,69,200835
172,0.000106,172.31.40.0-255,66,9925,69,200835
173,0.000114,172.217.194.0-255,7156,17081,69,200835
174,0.000117,172.31.40.0-255,66,17147,69,200835
175,0.000127,172.217.194.0-255,5379,22526,69,200835
176,0.000129,172.31.40.0-255,66,22592,69,200835
177,0.000156,172.217.194.0-255,5738,28330,69,200835
178,0.00016,172.31.40.0-255,66,28396,69,200835
179,0.000163,172.217.194.0-255,1484,29880,69,200835
180,0.000165,172.31.40.0-255,66,29946,69,200835
181,0.000201,172.31.40.0-255,66,30012,69,200835
182,0.000871,172.217.194.0-255,1484,31496,69,200835
183,0.000877,172.31.40.0-255,66,31562,69,200835
184,0.000882,172.217.194.0-255,2902,34464,69,200835
185,0.000885,172.31.40.0-255,66,34530,69,200835
186,0.000891,172.217.194.0-255,5738,40268,69,200835
187,0.000894,172.31.40.0-255,66,40334,69,200835
188,0.000941,172.217.194.0-255,6797,47131,69,200835
189,0.000944,172.31.40.0-255,66,47197,69,200835
190,0.000968,172.217.194.0-255,2902,50099,69,200835
191,0.00097,172.31.40.0-255,66,50165,69,200835
192,0.000986,172.217.194.0-255,4320,54485,69,200835
193,0.000992,172.31.40.0-255,66,54551,69,200835
194,0.000998,172.217.194.0-255,5738,60289,69,200835
195,0.001,172.31.40.0-255,66,60355,69,200835
196,0.001029,172.217.194.0-255,1484,61839,69,200835
197,0.001058,172.217.194.0-255,4541,66380,69,200835
198,0.001062,172.31.40.0-255,66,66446,69,200835
199,0.001069,172.217.194.0-255,7156,73602,69,200835
200,0.001071,172.31.40.0-255,66,73668,69,200835
201,0.00108,172.217.194.0-255,2902,76570,69,200835
202,0.001082,172.31.40.0-255,66,76636,69,200835
203,0.001118,172.217.194.0-255,5379,82015,69,200835
204,0.001123,172.31.40.0-255,66,82081,69,200835
205,0.001249,172.217.194.0-255,1484,83565,69,200835
206,0.001254,172.217.194.0-255,1484,85049,69,200835
207,0.001257,172.31.40.0-255,66,85115,69,200835
208,0.001288,172.217.194.0-255,1484,86599,69,200835
209,0.001295,172.217.194.0-255,5738,92337,69,200835
210,0.001298,172.31.40.0-255,66,92403,69,200835
211,0.001334,172.31.40.0-255,66,92469,69,200835
212,0.001361,172.217.194.0-255,4320,96789,69,200835
213,0.001364,172.31.40.0-255,66,96855,69,200835
214,0.001367,172.217.194.0-255,2902,99757,69,200835
215,0.001369,172.31.40.0-255,66,99823,69,200835
216,0.001378,172.31.40.0-255,66,99889,69,200835
217,0.001473,172.217.194.0-255,1484,101373,69,200835
218,0.001487,172.217.194.0-255,2902,104275,69,200835
219,0.00149,172.31.40.0-255,66,104341,69,200835
220,0.001497,172.217.194.0-255,5738,110079,69,200835
221,0.001498,172.31.40.0-255,66,110145,69,200835
222,0.00154,172.217.194.0-255,1484,111629,69,200835
223,0.001591,172.31.40.0-255,66,111695,69,200835
224,0.001595,172.31.40.0-255,66,111761,69,200835
225,0.001634,172.217.194.0-255,1484,113245,69,200835
226,0.001638,172.217.194.0-255,2902,116147,69,200835
227,0.001642,172.31.40.0-255,66,116213,69,200835
228,0.001647,172.217.194.0-255,2902,119115,69,200835
229,0.001649,172.31.40.0-255,66,119181,69,200835
230,0.001671,172.217.194.0-255,2902,122083,69,200835
231,0.001674,172.31.40.0-255,66,122149,69,200835
232,0.001681,172.217.194.0-255,7156,129305,69,200835
233,0.001687,172.31.40.0-255,66,129371,69,200835
234,0.00172,172.217.194.0-255,5738,135109,69,200835
235,0.001724,172.31.40.0-255,66,135175,69,200835
236,0.001736,172.31.40.0-255,66,135241,69,200835
237,0.001791,172.31.40.0-255,66,135307,69,200835
238,0.001796,172.217.194.0-255,2902,138209,69,200835
239,0.001798,172.31.40.0-255,66,138275,69,200835
240,0.001838,172.31.40.0-255,66,138341,69,200835
241,0.001874,172.217.194.0-255,766,139107,69,200835
242,0.001909,172.217.194.0-255,2184,141291,69,200835
243,0.001913,172.217.194.0-255,2902,144193,69,200835
244,0.001918,172.31.40.0-255,66,144259,69,200835
245,0.001921,172.31.40.0-255,66,144325,69,200835
246,0.001924,172.31.40.0-255,66,144391,69,200835
247,0.001927,172.31.40.0-255,66,144457,69,200835
248,0.001955,172.217.194.0-255,7156,151613,69,200835
249,0.001958,172.31.40.0-255,66,151679,69,200835
250,0.001975,172.31.40.0-255,66,151745,69,200835
251,0.001982,172.217.194.0-255,6438,158183,69,200835
252,0.001985,172.31.40.0-255,66,158249,69,200835
253,0.002026,172.31.40.0-255,66,158315,69,200835
254,0.002066,172.31.40.0-255,66,158381,69,200835
255,0.002121,172.31.40.0-255,66,158447,69,200835
256,0.002153,172.217.194.0-255,6438,164885,69,200835
257,0.002156,172.31.40.0-255,66,164951,69,200835
258,0.002175,172.31.40.0-255,66,165017,69,200835
259,0.002186,172.31.40.0-255,66,165083,69,200835
260,0.00219,172.217.194.0-255,2184,167267,69,200835
261,0.002192,172.31.40.0-255,66,167333,69,200835
262,0.002195,172.217.194.0-255,2902,170235,69,200835
263,0.002198,172.31.40.0-255,66,170301,69,200835
264,0.002204,172.217.194.0-255,7156,177457,69,200835
265,0.002206,172.31.40.0-255,66,177523,69,200835
266,0.002211,172.217.194.0-255,2902,180425,69,200835
267,0.002213,172.31.40.0-255,66,180491,69,200835
268,0.002259,172.31.40.0-255,66,180557,69,200835
269,0.002266,172.217.194.0-255,5738,186295,69,200835
270,0.002268,172.31.40.0-255,66,186361,69,200835
271,0.002323,172.31.40.0-255,66,186427,69,200835
272,0.00233,172.217.194.0-255,4957,191384,69,200835
273,0.002332,172.31.40.0-255,66,191450,69,200835
274,0.002335,172.217.194.0-255,105,191555,69,200835
275,0.004558,172.31.40.0-255,66,191621,69,200835
276,0.004594,172.31.40.0-255,105,191726,69,200835
277,0.007277,172.217.194.0-255,66,191792,69,200835
278,0.040287,172.31.40.0-255,172,191964,69,200835
279,0.040323,172.31.40.0-255,1116,193080,69,200835
280,0.040416,172.31.40.0-255,1514,194594,69,200835
281,0.040418,172.31.40.0-255,1514,196108,69,200835
282,0.04042,172.31.40.0-255,1514,197622,69,200835
283,0.040425,172.31.40.0-255,1514,199136,69,200835
284,0.040426,172.31.40.0-255,1501,200637,69,200835
285,0.041928,104.244.42.0-255,66,200703,69,200835
286,0.041974,104.244.42.0-255,66,200769,69,200835
287,0.042066,104.244.42.0-255,66,200835,69,200835
288,0.0,216.58.221.0-255,153,153,69,371076
289,2.1e-05,172.31.40.0-255,66,219,69,371076
290,2.8e-05,216.58.221.0-255,1484,1703,69,371076
291,3.2e-05,172.31.40.0-255,66,1769,69,371076
292,3.7e-05,216.58.221.0-255,2902,4671,69,371076
293,4.7e-05,172.31.40.0-255,66,4737,69,371076
294,5.5e-05,216.58.221.0-255,7156,11893,69,371076
295,5.8e-05,172.31.40.0-255,66,11959,69,371076
296,6.1e-05,216.58.221.0-255,2091,14050,69,371076
297,6.4e-05,172.31.40.0-255,66,14116,69,371076
298,0.000155,216.58.221.0-255,1484,15600,69,371076
299,0.000158,172.31.40.0-255,66,15666,69,371076
300,0.000173,216.58.221.0-255,1484,17150,69,371076
301,0.000175,172.31.40.0-255,66,17216,69,371076
302,0.000204,216.58.221.0-255,1484,18700,69,371076
303,0.000206,172.31.40.0-255,66,18766,69,371076
304,0.000212,216.58.221.0-255,5738,24504,69,371076
305,0.000214,172.31.40.0-255,66,24570,69,371076
306,0.00022,216.58.221.0-255,6797,31367,69,371076
307,0.000226,172.31.40.0-255,66,31433,69,371076
308,0.000259,216.58.221.0-255,7156,38589,69,371076
309,0.000262,172.31.40.0-255,66,38655,69,371076
310,0.000287,216.58.221.0-255,5738,44393,69,371076
311,0.00029,172.31.40.0-255,66,44459,69,371076
312,0.000308,216.58.221.0-255,3961,48420,69,371076
313,0.00031,172.31.40.0-255,66,48486,69,371076
314,0.000636,216.58.221.0-255,1484,49970,69,371076
315,0.000642,172.31.40.0-255,66,50036,69,371076
316,0.00065,216.58.221.0-255,1484,51520,69,371076
317,0.000652,172.31.40.0-255,66,51586,69,371076
318,0.000676,216.58.221.0-255,1484,53070,69,371076
319,0.000678,172.31.40.0-255,66,53136,69,371076
320,0.000683,216.58.221.0-255,4320,57456,69,371076
321,0.000685,172.31.40.0-255,66,57522,69,371076
322,0.000709,216.58.221.0-255,2902,60424,69,371076
323,0.000711,172.31.40.0-255,66,60490,69,371076
324,0.000736,216.58.221.0-255,5379,65869,69,371076
325,0.000738,172.31.40.0-255,66,65935,69,371076
326,0.000741,216.58.221.0-255,362,66297,69,371076
327,0.000945,172.31.40.0-255,66,66363,69,371076
328,0.001097,216.58.221.0-255,382,66745,69,371076
329,0.001196,216.58.221.0-255,1484,68229,69,371076
330,0.0012,172.31.40.0-255,66,68295,69,371076
331,0.001204,216.58.221.0-255,1484,69779,69,371076
332,0.001236,216.58.221.0-255,1484,71263,69,371076
333,0.001238,172.31.40.0-255,66,71329,69,371076
334,0.001244,216.58.221.0-255,4320,75649,69,371076
335,0.001245,172.31.40.0-255,66,75715,69,371076
336,0.00125,216.58.221.0-255,5738,81453,69,371076
337,0.001256,172.31.40.0-255,66,81519,69,371076
338,0.00126,216.58.221.0-255,2543,84062,69,371076
339,0.001262,172.31.40.0-255,66,84128,69,371076
340,0.001322,216.58.221.0-255,1484,85612,69,371076
341,0.001326,216.58.221.0-255,1484,87096,69,371076
342,0.001328,172.31.40.0-255,66,87162,69,371076
343,0.001333,216.58.221.0-255,2902,90064,69,371076
344,0.001334,172.31.40.0-255,66,90130,69,371076
345,0.001339,216.58.221.0-255,4320,94450,69,371076
346,0.001341,172.31.40.0-255,66,94516,69,371076
347,0.001362,216.58.221.0-255,1484,96000,69,371076
348,0.001365,216.58.221.0-255,1484,97484,69,371076
349,0.001367,172.31.40.0-255,66,97550,69,371076
350,0.001399,216.58.221.0-255,3961,101511,69,371076
351,0.001401,172.31.40.0-255,66,101577,69,371076
352,0.001615,216.58.221.0-255,1484,103061,69,371076
353,0.001621,216.58.221.0-255,2902,105963,69,371076
354,0.001625,172.31.40.0-255,66,106029,69,371076
355,0.001631,216.58.221.0-255,5738,111767,69,371076
356,0.001633,172.31.40.0-255,66,111833,69,371076
357,0.001685,172.31.40.0-255,66,111899,69,371076
358,0.001691,216.58.221.0-255,7156,119055,69,371076
359,0.001693,172.31.40.0-255,66,119121,69,371076
360,0.00173,216.58.221.0-255,3602,122723,69,371076
361,0.001732,172.31.40.0-255,66,122789,69,371076
362,0.001764,216.58.221.0-255,2902,125691,69,371076
363,0.001766,172.31.40.0-255,66,125757,69,371076
364,0.001791,216.58.221.0-255,1484,127241,69,371076
365,0.001797,216.58.221.0-255,5738,132979,69,371076
366,0.001799,172.31.40.0-255,66,133045,69,371076
367,0.001842,172.31.40.0-255,66,133111,69,371076
368,0.001856,172.31.40.0-255,66,133177,69,371076
369,0.001886,216.58.221.0-255,3602,136779,69,371076
370,0.001888,172.31.40.0-255,66,136845,69,371076
371,0.001915,216.58.221.0-255,4320,141165,69,371076
372,0.001917,172.31.40.0-255,66,141231,69,371076
373,0.001921,216.58.221.0-255,2902,144133,69,371076
374,0.001923,172.31.40.0-255,66,144199,69,371076
375,0.001968,216.58.221.0-255,7156,151355,69,371076
376,0.00197,172.31.40.0-255,66,151421,69,371076
377,0.001982,172.31.40.0-255,66,151487,69,371076
378,0.001991,172.31.40.0-255,66,151553,69,371076
379,0.002041,216.58.221.0-255,1484,153037,69,371076
380,0.002056,216.58.221.0-255,2902,155939,69,371076
381,0.002058,172.31.40.0-255,66,156005,69,371076
382,0.002061,216.58.221.0-255,1484,157489,69,371076
383,0.002073,216.58.221.0-255,2902,160391,69,371076
384,0.002078,172.31.40.0-255,66,160457,69,371076
385,0.002106,216.58.221.0-255,1484,161941,69,371076
386,0.002112,216.58.221.0-255,4320,166261,69,371076
387,0.002114,172.31.40.0-255,66,166327,69,371076
388,0.002119,216.58.221.0-255,5738,172065,69,371076
389,0.002121,172.31.40.0-255,66,172131,69,371076
390,0.002124,216.58.221.0-255,2902,175033,69,371076
391,0.002127,172.31.40.0-255,66,175099,69,371076
392,0.002168,172.31.40.0-255,66,175165,69,371076
393,0.00421,216.58.221.0-255,5738,180903,69,371076
394,0.004217,172.31.40.0-255,66,180969,69,371076
395,0.006257,216.58.221.0-255,5738,186707,69,371076
396,0.006263,172.31.40.0-255,66,186773,69,371076
397,0.008351,216.58.221.0-255,4320,191093,69,371076
398,0.008363,172.31.40.0-255,66,191159,69,371076
399,0.008392,216.58.221.0-255,1484,192643,69,371076
400,0.010428,216.58.221.0-255,4320,196963,69,371076
401,0.010435,172.31.40.0-255,66,197029,69,371076
402,0.012485,216.58.221.0-255,5738,202767,69,371076
403,0.012492,172.31.40.0-255,66,202833,69,371076
404,0.014557,216.58.221.0-255,5738,208571,69,371076
405,0.014564,172.31.40.0-255,66,208637,69,371076
406,0.016632,216.58.221.0-255,5738,214375,69,371076
407,0.016642,172.31.40.0-255,66,214441,69,371076
408,0.018703,216.58.221.0-255,5738,220179,69,371076
409,0.018712,172.31.40.0-255,66,220245,69,371076
410,0.020775,216.58.221.0-255,4320,224565,69,371076
411,0.020781,172.31.40.0-255,66,224631,69,371076
412,0.020801,216.58.221.0-255,1484,226115,69,371076
413,0.022846,216.58.221.0-255,4320,230435,69,371076
414,0.022853,172.31.40.0-255,66,230501,69,371076
415,0.024924,216.58.221.0-255,5738,236239,69,371076
416,0.024931,172.31.40.0-255,66,236305,69,371076
417,0.026985,216.58.221.0-255,4320,240625,69,371076
418,0.026992,172.31.40.0-255,66,240691,69,371076
419,0.027021,216.58.221.0-255,1484,242175,69,371076
420,0.02904,216.58.221.0-255,4320,246495,69,371076
421,0.029048,172.31.40.0-255,66,246561,69,371076
422,0.031105,216.58.221.0-255,5738,252299,69,371076
423,0.031112,172.31.40.0-255,66,252365,69,371076
424,0.031983,172.31.40.0-255,172,252537,69,371076
425,0.032022,172.31.40.0-255,1112,253649,69,371076
426,0.032085,172.31.40.0-255,1514,255163,69,371076
427,0.032087,172.31.40.0-255,1514,256677,69,371076
428,0.032088,172.31.40.0-255,1514,258191,69,371076
429,0.032093,172.31.40.0-255,1514,259705,69,371076
430,0.032094,172.31.40.0-255,1503,261208,69,371076
431,0.033171,216.58.221.0-255,5738,266946,69,371076
432,0.033177,172.31.40.0-255,66,267012,69,371076
433,0.033674,104.244.42.0-255,66,267078,69,371076
434,0.033712,104.244.42.0-255,66,267144,69,371076
435,0.033795,104.244.42.0-255,66,267210,69,371076
436,0.035234,216.58.221.0-255,5738,272948,69,371076
437,0.035241,172.31.40.0-255,66,273014,69,371076
438,0.037309,216.58.221.0-255,5738,278752,69,371076
439,0.037316,172.31.40.0-255,66,278818,69,371076
440,0.039366,216.58.221.0-255,5738,284556,69,371076
441,0.039372,172.31.40.0-255,66,284622,69,371076
442,0.041443,216.58.221.0-255,5738,290360,69,371076
443,0.04145,172.31.40.0-255,66,290426,69,371076
444,0.043515,216.58.221.0-255,5738,296164,69,371076
445,0.043521,172.31.40.0-255,66,296230,69,371076
446,0.045598,216.58.221.0-255,5738,301968,69,371076
447,0.045604,172.31.40.0-255,66,302034,69,371076
448,0.047671,216.58.221.0-255,5738,307772,69,371076
449,0.047677,172.31.40.0-255,66,307838,69,371076
450,0.049754,216.58.221.0-255,5738,313576,69,371076
451,0.04976,172.31.40.0-255,66,313642,69,371076
452,0.051831,216.58.221.0-255,5738,319380,69,371076
453,0.051837,172.31.40.0-255,66,319446,69,371076
454,0.053912,216.58.221.0-255,5738,325184,69,371076
455,0.053919,172.31.40.0-255,66,325250,69,371076
456,0.055987,216.58.221.0-255,5738,330988,69,371076
457,0.055993,172.31.40.0-255,66,331054,69,371076
458,0.058059,216.58.221.0-255,5738,336792,69,371076
459,0.058065,172.31.40.0-255,66,336858,69,371076
460,0.06013,216.58.221.0-255,5738,342596,69,371076
461,0.060136,172.31.40.0-255,66,342662,69,371076
462,0.062202,216.58.221.0-255,5738,348400,69,371076
463,0.062209,172.31.40.0-255,66,348466,69,371076
464,0.064286,216.58.221.0-255,5738,354204,69,371076
465,0.064292,172.31.40.0-255,66,354270,69,371076
466,0.066366,216.58.221.0-255,5738,360008,69,371076
467,0.066375,172.31.40.0-255,66,360074,69,371076
468,0.06844,216.58.221.0-255,5738,365812,69,371076
469,0.068447,172.31.40.0-255,66,365878,69,371076
470,0.07051,216.58.221.0-255,4961,370839,69,371076
471,0.070517,172.31.40.0-255,66,370905,69,371076
472,0.070701,172.31.40.0-255,105,371010,69,371076
473,0.072725,216.58.221.0-255,66,371076,69,371076
474,0.0,172.31.40.0-255,105,105,69,276
475,0.00178,157.240.13.0-255,105,210,69,276
476,0.001795,172.31.40.0-255,66,276,69,276
477,0.0,172.217.194.0-255,150,150,69,254564
478,2.1e-05,172.31.40.0-255,66,216,69,254564
479,2.9e-05,172.217.194.0-255,1484,1700,69,254564
480,3.4e-05,172.31.40.0-255,66,1766,69,254564
481,4e-05,172.217.194.0-255,2902,4668,69,254564
482,4.3e-05,172.31.40.0-255,66,4734,69,254564
483,5.1e-05,172.217.194.0-255,7156,11890,69,254564
484,5.4e-05,172.31.40.0-255,66,11956,69,254564
485,9.9e-05,172.31.40.0-255,66,12022,69,254564
486,0.000122,172.217.194.0-255,4876,16898,69,254564
487,0.000125,172.31.40.0-255,66,16964,69,254564
488,0.000129,172.217.194.0-255,2543,19507,69,254564
489,0.000131,172.31.40.0-255,66,19573,69,254564
490,0.000167,172.217.194.0-255,1484,21057,69,254564
491,0.000169,172.31.40.0-255,66,21123,69,254564
492,0.000199,172.217.194.0-255,2902,24025,69,254564
493,0.000202,172.31.40.0-255,66,24091,69,254564
494,0.000208,172.217.194.0-255,5738,29829,69,254564
495,0.000211,172.31.40.0-255,66,29895,69,254564
496,0.000216,172.217.194.0-255,4320,34215,69,254564
497,0.000218,172.31.40.0-255,66,34281,69,254564
498,0.000241,172.217.194.0-255,2543,36824,69,254564
499,0.000243,172.31.40.0-255,66,36890,69,254564
500,0.000276,172.217.194.0-255,2902,39792,69,254564
501,0.000279,172.31.40.0-255,66,39858,69,254564
502,0.000285,172.217.194.0-255,5738,45596,69,254564
503,0.000287,172.31.40.0-255,66,45662,69,254564
504,0.000332,172.217.194.0-255,2902,48564,69,254564
505,0.000336,172.31.40.0-255,66,48630,69,254564
506,0.000356,172.217.194.0-255,5723,54353,69,254564
507,0.000359,172.31.40.0-255,66,54419,69,254564
508,0.000459,172.217.194.0-255,363,54782,69,254564
509,0.000564,172.217.194.0-255,1484,56266,69,254564
510,0.000569,172.31.40.0-255,66,56332,69,254564
511,0.000575,172.217.194.0-255,2902,59234,69,254564
512,0.000578,172.31.40.0-255,66,59300,69,254564
513,0.000604,172.217.194.0-255,5738,65038,69,254564
514,0.000607,172.31.40.0-255,66,65104,69,254564
515,0.00061,172.217.194.0-255,1484,66588,69,254564
516,0.00065,172.31.40.0-255,66,66654,69,254564
517,0.000674,172.217.194.0-255,5379,72033,69,254564
518,0.000677,172.31.40.0-255,66,72099,69,254564
519,0.000702,172.31.40.0-255,66,72165,69,254564
520,0.000993,172.217.194.0-255,1484,73649,69,254564
521,0.001001,172.217.194.0-255,2902,76551,69,254564
522,0.001004,172.31.40.0-255,66,76617,69,254564
523,0.001011,172.217.194.0-255,5738,82355,69,254564
524,0.001013,172.31.40.0-255,66,82421,69,254564
525,0.001036,172.217.194.0-255,5738,88159,69,254564
526,0.001039,172.31.40.0-255,66,88225,69,254564
527,0.001065,172.217.194.0-255,7156,95381,69,254564
528,0.001067,172.31.40.0-255,66,95447,69,254564
529,0.001075,172.217.194.0-255,7156,102603,69,254564
530,0.001077,172.31.40.0-255,66,102669,69,254564
531,0.001094,172.217.194.0-255,3602,106271,69,254564
532,0.001098,172.31.40.0-255,66,106337,69,254564
533,0.001209,172.217.194.0-255,1484,107821,69,254564
534,0.001213,172.217.194.0-255,1484,109305,69,254564
535,0.001216,172.31.40.0-255,66,109371,69,254564
536,0.00124,172.217.194.0-255,1484,110855,69,254564
537,0.001246,172.217.194.0-255,5738,116593,69,254564
538,0.001249,172.31.40.0-255,66,116659,69,254564
539,0.001253,172.217.194.0-255,2902,119561,69,254564
540,0.001256,172.31.40.0-255,66,119627,69,254564
541,0.001272,172.217.194.0-255,4320,123947,69,254564
542,0.001275,172.31.40.0-255,66,124013,69,254564
543,0.001303,172.217.194.0-255,2902,126915,69,254564
544,0.001307,172.31.40.0-255,66,126981,69,254564
545,0.001319,172.31.40.0-255,66,127047,69,254564
546,0.001323,172.217.194.0-255,2184,129231,69,254564
547,0.001326,172.31.40.0-255,66,129297,69,254564
548,0.001386,172.217.194.0-255,1484,130781,69,254564
549,0.0014,172.217.194.0-255,2902,133683,69,254564
550,0.001403,172.31.40.0-255,66,133749,69,254564
551,0.001418,172.217.194.0-255,2902,136651,69,254564
552,0.00142,172.31.40.0-255,66,136717,69,254564
553,0.001432,172.217.194.0-255,2902,139619,69,254564
554,0.001435,172.31.40.0-255,66,139685,69,254564
555,0.001441,172.217.194.0-255,5738,145423,69,254564
556,0.001443,172.31.40.0-255,66,145489,69,254564
557,0.001477,172.217.194.0-255,7156,152645,69,254564
558,0.00148,172.31.40.0-255,66,152711,69,254564
559,0.001493,172.31.40.0-255,66,152777,69,254564
560,0.001979,172.217.194.0-255,1484,154261,69,254564
561,0.001985,172.217.194.0-255,2902,157163,69,254564
562,0.001989,172.31.40.0-255,66,157229,69,254564
563,0.002023,172.217.194.0-255,1484,158713,69,254564
564,0.002039,172.217.194.0-255,4320,163033,69,254564
565,0.002041,172.31.40.0-255,66,163099,69,254564
566,0.002053,172.31.40.0-255,66,163165,69,254564
567,0.00207,172.217.194.0-255,2902,166067,69,254564
568,0.002073,172.31.40.0-255,66,166133,69,254564
569,0.002105,172.31.40.0-255,66,166199,69,254564
570,0.002122,172.217.194.0-255,1484,167683,69,254564
571,0.002126,172.217.194.0-255,1484,169167,69,254564
572,0.002128,172.31.40.0-255,66,169233,69,254564
573,0.002148,172.217.194.0-255,1484,170717,69,254564
574,0.002154,172.217.194.0-255,5738,176455,69,254564
575,0.002156,172.31.40.0-255,66,176521,69,254564
576,0.002161,172.217.194.0-255,2902,179423,69,254564
577,0.002163,172.31.40.0-255,66,179489,69,254564
578,0.002186,172.217.194.0-255,7156,186645,69,254564
579,0.002188,172.31.40.0-255,66,186711,69,254564
580,0.002211,172.217.194.0-255,2902,189613,69,254564
581,0.002213,172.31.40.0-255,66,189679,69,254564
582,0.002225,172.31.40.0-255,66,189745,69,254564
583,0.002228,172.217.194.0-255,766,190511,69,254564
584,0.002313,172.217.194.0-255,1484,191995,69,254564
585,0.002317,172.31.40.0-255,66,192061,69,254564
586,0.002322,172.217.194.0-255,2902,194963,69,254564
587,0.002324,172.31.40.0-255,66,195029,69,254564
588,0.002326,172.217.194.0-255,1484,196513,69,254564
589,0.002359,172.217.194.0-255,2902,199415,69,254564
590,0.002362,172.31.40.0-255,66,199481,69,254564
591,0.002368,172.217.194.0-255,5738,205219,69,254564
592,0.002371,172.31.40.0-255,66,205285,69,254564
593,0.002374,172.217.194.0-255,1484,206769,69,254564
594,0.002406,172.31.40.0-255,66,206835,69,254564
595,0.002419,172.217.194.0-255,2902,209737,69,254564
596,0.002421,172.31.40.0-255,66,209803,69,254564
597,0.002424,172.217.194.0-255,1484,211287,69,254564
598,0.00245,172.217.194.0-255,5020,216307,69,254564
599,0.002453,172.31.40.0-255,66,216373,69,254564
600,0.002467,172.217.194.0-255,2902,219275,69,254564
601,0.002469,172.31.40.0-255,66,219341,69,254564
602,0.002495,172.217.194.0-255,4320,223661,69,254564
603,0.002498,172.31.40.0-255,66,223727,69,254564
604,0.002505,172.217.194.0-255,5738,229465,69,254564
605,0.002507,172.31.40.0-255,66,229531,69,254564
606,0.002513,172.217.194.0-255,5738,235269,69,254564
607,0.002515,172.31.40.0-255,66,235335,69,254564
608,0.002548,172.31.40.0-255,66,235401,69,254564
609,0.002553,172.217.194.0-255,4320,239721,69,254564
610,0.002555,172.31.40.0-255,66,239787,69,254564
611,0.00258,172.217.194.0-255,7156,246943,69,254564
612,0.002583,172.31.40.0-255,66,247009,69,254564
613,0.002634,172.31.40.0-255,66,247075,69,254564
614,0.002652,172.31.40.0-255,66,247141,69,254564
615,0.002664,172.31.40.0-255,66,247207,69,254564
616,0.002748,172.217.194.0-255,4903,252110,69,254564
617,0.00302,172.31.40.0-255,66,252176,69,254564
618,0.005602,172.217.194.0-255,105,252281,69,254564
619,0.00873,172.31.40.0-255,66,252347,69,254564
620,0.008768,172.31.40.0-255,105,252452,69,254564
621,0.011542,172.217.194.0-255,66,252518,69,254564
622,0.034237,172.31.40.0-255,172,252690,69,254564
623,0.034269,172.31.40.0-255,1116,253806,69,254564
624,0.034334,172.31.40.0-255,560,254366,69,254564
625,0.03591,104.244.42.0-255,66,254432,69,254564
626,0.035944,104.244.42.0-255,66,254498,69,254564
627,0.035946,104.244.42.0-255,66,254564,69,254564
628,0.0,74.125.200.0-255,152,152,69,374709
629,2.2e-05,172.31.40.0-255,66,218,69,374709
630,2.9e-05,74.125.200.0-255,1484,1702,69,374709
631,3.3e-05,172.31.40.0-255,66,1768,69,374709
632,3.9e-05,74.125.200.0-255,2902,4670,69,374709
633,5e-05,172.31.40.0-255,66,4736,69,374709
634,7.1e-05,74.125.200.0-255,2902,7638,69,374709
635,7.4e-05,172.31.40.0-255,66,7704,69,374709
636,9.1e-05,74.125.200.0-255,2902,10606,69,374709
637,9.5e-05,172.31.40.0-255,66,10672,69,374709
638,0.000107,74.125.200.0-255,6317,16989,69,374709
639,0.000109,172.31.40.0-255,66,17055,69,374709
640,0.000113,74.125.200.0-255,2902,19957,69,374709
641,0.000115,172.31.40.0-255,66,20023,69,374709
642,0.000121,74.125.200.0-255,4320,24343,69,374709
643,0.000124,172.31.40.0-255,66,24409,69,374709
644,0.000128,74.125.200.0-255,2902,27311,69,374709
645,0.000131,172.31.40.0-255,66,27377,69,374709
646,0.000162,74.125.200.0-255,5738,33115,69,374709
647,0.000165,172.31.40.0-255,66,33181,69,374709
648,0.000172,74.125.200.0-255,7156,40337,69,374709
649,0.000175,172.31.40.0-255,66,40403,69,374709
650,0.00018,74.125.200.0-255,4320,44723,69,374709
651,0.000182,172.31.40.0-255,66,44789,69,374709
652,0.000214,74.125.200.0-255,3602,48391,69,374709
653,0.000217,172.31.40.0-255,66,48457,69,374709
654,0.000506,74.125.200.0-255,1484,49941,69,374709
655,0.000511,172.31.40.0-255,66,50007,69,374709
656,0.000517,74.125.200.0-255,2902,52909,69,374709
657,0.00052,172.31.40.0-255,66,52975,69,374709
658,0.000525,74.125.200.0-255,2902,55877,69,374709
659,0.000532,172.31.40.0-255,66,55943,69,374709
660,0.000566,74.125.200.0-255,2902,58845,69,374709
661,0.00057,74.125.200.0-255,1484,60329,69,374709
662,0.000574,74.125.200.0-255,2902,63231,69,374709
663,0.000594,74.125.200.0-255,2876,66107,69,374709
664,0.000612,172.31.40.0-255,66,66173,69,374709
665,0.0007,74.125.200.0-255,1484,67657,69,374709
666,0.000719,74.125.200.0-255,2902,70559,69,374709
667,0.000728,172.31.40.0-255,66,70625,69,374709
668,0.000738,74.125.200.0-255,4320,74945,69,374709
669,0.00076,74.125.200.0-255,1484,76429,69,374709
670,0.000782,74.125.200.0-255,7156,83585,69,374709
671,0.000789,172.31.40.0-255,66,83651,69,374709
672,0.000799,74.125.200.0-255,2902,86553,69,374709
673,0.000818,74.125.200.0-255,4320,90873,69,374709
674,0.000838,172.31.40.0-255,66,90939,69,374709
675,0.000847,74.125.200.0-255,4320,95259,69,374709
676,0.000852,172.31.40.0-255,66,95325,69,374709
677,0.000879,74.125.200.0-255,4320,99645,69,374709
678,0.000894,74.125.200.0-255,1043,100688,69,374709
679,0.000904,172.31.40.0-255,66,100754,69,374709
680,0.001637,74.125.200.0-255,1484,102238,69,374709
681,0.001646,74.125.200.0-255,2902,105140,69,374709
682,0.001651,172.31.40.0-255,66,105206,69,374709
683,0.001678,74.125.200.0-255,4320,109526,69,374709
684,0.001715,74.125.200.0-255,2902,112428,69,374709
685,0.001729,74.125.200.0-255,5738,118166,69,374709
686,0.001768,74.125.200.0-255,5738,123904,69,374709
687,0.001782,74.125.200.0-255,4320,128224,69,374709
688,0.001816,74.125.200.0-255,4320,132544,69,374709
689,0.001828,74.125.200.0-255,2184,134728,69,374709
690,0.006942,172.31.40.0-255,66,134794,69,374709
691,0.008973,74.125.200.0-255,5738,140532,69,374709
692,0.008983,172.31.40.0-255,66,140598,69,374709
693,0.011008,74.125.200.0-255,5738,146336,69,374709
694,0.011209,172.31.40.0-255,66,146402,69,374709
695,0.013229,74.125.200.0-255,5738,152140,69,374709
696,0.013237,172.31.40.0-255,66,152206,69,374709
697,0.015263,74.125.200.0-255,5738,157944,69,374709
698,0.015273,172.31.40.0-255,66,158010,69,374709
699,0.017295,74.125.200.0-255,5738,163748,69,374709
700,0.017302,172.31.40.0-255,66,163814,69,374709
701,0.019332,74.125.200.0-255,5738,169552,69,374709
702,0.019342,172.31.40.0-255,66,169618,69,374709
703,0.021378,74.125.200.0-255,5738,175356,69,374709
704,0.021385,172.31.40.0-255,66,175422,69,374709
705,0.023411,74.125.200.0-255,5738,181160,69,374709
706,0.02342,172.31.40.0-255,66,181226,69,374709
707,0.025457,74.125.200.0-255,5738,186964,69,374709
708,0.025464,172.31.40.0-255,66,187030,69,374709
709,0.027568,74.125.200.0-255,5738,192768,69,374709
710,0.027577,172.31.40.0-255,66,192834,69,374709
711,0.029613,74.125.200.0-255,5738,198572,69,374709
712,0.02962,172.31.40.0-255,66,198638,69,374709
713,0.031645,74.125.200.0-255,5738,204376,69,374709
714,0.031654,172.31.40.0-255,66,204442,69,374709
715,0.033683,74.125.200.0-255,5738,210180,69,374709
716,0.033691,172.31.40.0-255,66,210246,69,374709
717,0.035712,74.125.200.0-255,5738,215984,69,374709
718,0.035719,172.31.40.0-255,66,216050,69,374709
719,0.037759,74.125.200.0-255,5738,221788,69,374709
720,0.037767,172.31.40.0-255,66,221854,69,374709
721,0.038596,172.31.40.0-255,172,222026,69,374709
722,0.038627,172.31.40.0-255,1114,223140,69,374709
723,0.0387,172.31.40.0-255,1514,224654,69,374709
724,0.038702,172.31.40.0-255,1514,226168,69,374709
725,0.038707,172.31.40.0-255,1514,227682,69,374709
726,0.038708,172.31.40.0-255,1514,229196,69,374709
727,0.038728,172.31.40.0-255,1501,230697,69,374709
728,0.039786,74.125.200.0-255,5738,236435,69,374709
729,0.039793,172.31.40.0-255,66,236501,69,374709
730,0.040155,104.244.42.0-255,66,236567,69,374709
731,0.040209,104.244.42.0-255,66,236633,69,374709
732,0.040265,104.244.42.0-255,66,236699,69,374709
733,0.040306,104.244.42.0-255,66,236765,69,374709
734,0.041819,74.125.200.0-255,5738,242503,69,374709
735,0.041826,172.31.40.0-255,66,242569,69,374709
736,0.043856,74.125.200.0-255,5738,248307,69,374709
737,0.043861,172.31.40.0-255,66,248373,69,374709
738,0.045893,74.125.200.0-255,5738,254111,69,374709
739,0.045898,172.31.40.0-255,66,254177,69,374709
740,0.047928,74.125.200.0-255,5738,259915,69,374709
741,0.047933,172.31.40.0-255,66,259981,69,374709
742,0.04998,74.125.200.0-255,5738,265719,69,374709
743,0.049986,172.31.40.0-255,66,265785,69,374709
744,0.052037,74.125.200.0-255,5738,271523,69,374709
745,0.052047,172.31.40.0-255,66,271589,69,374709
746,0.054073,74.125.200.0-255,5738,277327,69,374709
747,0.054078,172.31.40.0-255,66,277393,69,374709
748,0.056105,74.125.200.0-255,5738,283131,69,374709
749,0.05611,172.31.40.0-255,66,283197,69,374709
750,0.05815,74.125.200.0-255,5738,288935,69,374709
751,0.058155,172.31.40.0-255,66,289001,69,374709
752,0.060205,74.125.200.0-255,5738,294739,69,374709
753,0.060211,172.31.40.0-255,66,294805,69,374709
754,0.062244,74.125.200.0-255,5738,300543,69,374709
755,0.062249,172.31.40.0-255,66,300609,69,374709
756,0.064288,74.125.200.0-255,5738,306347,69,374709
757,0.064295,172.31.40.0-255,66,306413,69,374709
758,0.066325,74.125.200.0-255,5738,312151,69,374709
759,0.066332,172.31.40.0-255,66,312217,69,374709
760,0.068359,74.125.200.0-255,5738,317955,69,374709
761,0.068366,172.31.40.0-255,66,318021,69,374709
762,0.070408,74.125.200.0-255,5738,323759,69,374709
763,0.070414,172.31.40.0-255,66,323825,69,374709
764,0.072456,74.125.200.0-255,5738,329563,69,374709
765,0.072463,172.31.40.0-255,66,329629,69,374709
766,0.074489,74.125.200.0-255,5738,335367,69,374709
767,0.074496,172.31.40.0-255,66,335433,69,374709
768,0.076524,74.125.200.0-255,5738,341171,69,374709
769,0.07653,172.31.40.0-255,66,341237,69,374709
770,0.078571,74.125.200.0-255,5738,346975,69,374709
771,0.078577,172.31.40.0-255,66,347041,69,374709
772,0.080594,74.125.200.0-255,5738,352779,69,374709
773,0.080601,172.31.40.0-255,66,352845,69,374709
774,0.082633,74.125.200.0-255,5738,358583,69,374709
775,0.082639,172.31.40.0-255,66,358649,69,374709
776,0.084647,74.125.200.0-255,4320,362969,69,374709
777,0.084653,172.31.40.0-255,66,363035,69,374709
778,0.084683,74.125.200.0-255,1484,364519,69,374709
779,0.086678,74.125.200.0-255,4320,368839,69,374709
780,0.087185,172.31.40.0-255,66,368905,69,374709
781,0.089218,74.125.200.0-255,5738,374643,69,374709
782,0.089225,172.31.40.0-255,66,374709,69,374709
783,0.0,74.125.24.0-255,152,152,69,333276
784,2.3e-05,172.31.40.0-255,66,218,69,333276
785,3.1e-05,74.125.24.0-255,1484,1702,69,333276
786,3.7e-05,172.31.40.0-255,66,1768,69,333276
787,4.2e-05,74.125.24.0-255,2902,4670,69,333276
788,4.5e-05,172.31.40.0-255,66,4736,69,333276
789,5e-05,74.125.24.0-255,4320,9056,69,333276
790,5.3e-05,172.31.40.0-255,66,9122,69,333276
791,7.6e-05,74.125.24.0-255,1484,10606,69,333276
792,7.9e-05,172.31.40.0-255,66,10672,69,333276
793,9.8e-05,74.125.24.0-255,3514,14186,69,333276
794,0.000101,172.31.40.0-255,66,14252,69,333276
795,0.000134,74.125.24.0-255,2902,17154,69,333276
796,0.000136,172.31.40.0-255,66,17220,69,333276
797,0.00014,74.125.24.0-255,2902,20122,69,333276
798,0.000143,172.31.40.0-255,66,20188,69,333276
799,0.000157,74.125.24.0-255,1484,21672,69,333276
800,0.000159,172.31.40.0-255,66,21738,69,333276
801,0.000163,74.125.24.0-255,2902,24640,69,333276
802,0.000165,172.31.40.0-255,66,24706,69,333276
803,0.000186,74.125.24.0-255,5738,30444,69,333276
804,0.000189,172.31.40.0-255,66,30510,69,333276
805,0.000192,74.125.24.0-255,1125,31635,69,333276
806,0.000194,172.31.40.0-255,66,31701,69,333276
807,0.000303,74.125.24.0-255,1484,33185,69,333276
808,0.000307,172.31.40.0-255,66,33251,69,333276
809,0.000311,74.125.24.0-255,1484,34735,69,333276
810,0.000312,172.31.40.0-255,66,34801,69,333276
811,0.000328,74.125.24.0-255,1484,36285,69,333276
812,0.000331,172.31.40.0-255,66,36351,69,333276
813,0.000338,74.125.24.0-255,5738,42089,69,333276
814,0.00034,172.31.40.0-255,66,42155,69,333276
815,0.000375,74.125.24.0-255,1484,43639,69,333276
816,0.000406,172.31.40.0-255,66,43705,69,333276
817,0.00042,172.31.40.0-255,66,43771,69,333276
818,0.000453,74.125.24.0-255,1419,45190,69,333276
819,0.000465,74.125.24.0-255,382,45572,69,333276
820,0.000468,172.31.40.0-255,66,45638,69,333276
821,0.000848,74.125.24.0-255,1484,47122,69,333276
822,0.000852,74.125.24.0-255,1484,48606,69,333276
823,0.000856,172.31.40.0-255,66,48672,69,333276
824,0.000878,74.125.24.0-255,1484,50156,69,333276
825,0.000885,74.125.24.0-255,5738,55894,69,333276
826,0.000888,172.31.40.0-255,66,55960,69,333276
827,0.000896,74.125.24.0-255,5738,61698,69,333276
828,0.000898,172.31.40.0-255,66,61764,69,333276
829,0.000924,172.31.40.0-255,66,61830,69,333276
830,0.000931,74.125.24.0-255,5738,67568,69,333276
831,0.000933,172.31.40.0-255,66,67634,69,333276
832,0.000952,74.125.24.0-255,3961,71595,69,333276
833,0.000955,172.31.40.0-255,66,71661,69,333276
834,0.00161,74.125.24.0-255,1484,73145,69,333276
835,0.00162,74.125.24.0-255,2902,76047,69,333276
836,0.001625,172.31.40.0-255,66,76113,69,333276
837,0.001633,74.125.24.0-255,5738,81851,69,333276
838,0.001635,172.31.40.0-255,66,81917,69,333276
839,0.001638,74.125.24.0-255,1484,83401,69,333276
840,0.001642,74.125.24.0-255,2902,86303,69,333276
841,0.001644,172.31.40.0-255,66,86369,69,333276
842,0.001663,74.125.24.0-255,5738,92107,69,333276
843,0.001665,172.31.40.0-255,66,92173,69,333276
844,0.00169,74.125.24.0-255,4320,96493,69,333276
845,0.001693,172.31.40.0-255,66,96559,69,333276
846,0.001717,172.31.40.0-255,66,96625,69,333276
847,0.003888,74.125.24.0-255,4320,100945,69,333276
848,0.003895,172.31.40.0-255,66,101011,69,333276
849,0.003915,74.125.24.0-255,1484,102495,69,333276
850,0.006055,74.125.24.0-255,4320,106815,69,333276
851,0.006062,172.31.40.0-255,66,106881,69,333276
852,0.008207,74.125.24.0-255,2902,109783,69,333276
853,0.008214,172.31.40.0-255,66,109849,69,333276
854,0.008234,74.125.24.0-255,2902,112751,69,333276
855,0.008236,172.31.40.0-255,66,112817,69,333276
856,0.010356,74.125.24.0-255,2902,115719,69,333276
857,0.010363,172.31.40.0-255,66,115785,69,333276
858,0.010391,74.125.24.0-255,2902,118687,69,333276
859,0.010393,172.31.40.0-255,66,118753,69,333276
860,0.012522,74.125.24.0-255,2902,121655,69,333276
861,0.012529,172.31.40.0-255,66,121721,69,333276
862,0.012575,74.125.24.0-255,1484,123205,69,333276
863,0.012587,74.125.24.0-255,1484,124689,69,333276
864,0.01259,172.31.40.0-255,66,124755,69,333276
865,0.014706,74.125.24.0-255,2902,127657,69,333276
866,0.014715,172.31.40.0-255,66,127723,69,333276
867,0.014792,74.125.24.0-255,2902,130625,69,333276
868,0.014796,172.31.40.0-255,66,130691,69,333276
869,0.016948,74.125.24.0-255,5738,136429,69,333276
870,0.016955,172.31.40.0-255,66,136495,69,333276
871,0.019153,74.125.24.0-255,4320,140815,69,333276
872,0.01916,172.31.40.0-255,66,140881,69,333276
873,0.01918,74.125.24.0-255,1484,142365,69,333276
874,0.021348,74.125.24.0-255,4320,146685,69,333276
875,0.021354,172.31.40.0-255,66,146751,69,333276
876,0.023534,74.125.24.0-255,5738,152489,69,333276
877,0.023543,172.31.40.0-255,66,152555,69,333276
878,0.025684,74.125.24.0-255,5738,158293,69,333276
879,0.025691,172.31.40.0-255,66,158359,69,333276
880,0.027902,74.125.24.0-255,5738,164097,69,333276
881,0.02791,172.31.40.0-255,66,164163,69,333276
882,0.029656,172.31.40.0-255,172,164335,69,333276
883,0.029683,172.31.40.0-255,1112,165447,69,333276
884,0.029763,172.31.40.0-255,1514,166961,69,333276
885,0.029765,172.31.40.0-255,1514,168475,69,333276
886,0.029771,172.31.40.0-255,1514,169989,69,333276
887,0.029773,172.31.40.0-255,1514,171503,69,333276
888,0.029804,172.31.40.0-255,1503,173006,69,333276
889,0.03005,74.125.24.0-255,5738,178744,69,333276
890,0.030056,172.31.40.0-255,66,178810,69,333276
891,0.031301,104.244.42.0-255,66,178876,69,333276
892,0.031327,104.244.42.0-255,66,178942,69,333276
893,0.031458,104.244.42.0-255,66,179008,69,333276
894,0.031509,104.244.42.0-255,66,179074,69,333276
895,0.032189,74.125.24.0-255,1484,180558,69,333276
896,0.032209,74.125.24.0-255,4320,184878,69,333276
897,0.032214,172.31.40.0-255,66,184944,69,333276
898,0.03441,74.125.24.0-255,4320,189264,69,333276
899,0.034435,172.31.40.0-255,66,189330,69,333276
900,0.034458,74.125.24.0-255,1484,190814,69,333276
901,0.036593,74.125.24.0-255,4320,195134,69,333276
902,0.0366,172.31.40.0-255,66,195200,69,333276
903,0.038794,74.125.24.0-255,2902,198102,69,333276
904,0.038802,172.31.40.0-255,66,198168,69,333276
905,0.038821,74.125.24.0-255,2902,201070,69,333276
906,0.038824,172.31.40.0-255,66,201136,69,333276
907,0.040966,74.125.24.0-255,5738,206874,69,333276
908,0.040974,172.31.40.0-255,66,206940,69,333276
909,0.043158,74.125.24.0-255,5738,212678,69,333276
910,0.043165,172.31.40.0-255,66,212744,69,333276
911,0.045354,74.125.24.0-255,5738,218482,69,333276
912,0.04536,172.31.40.0-255,66,218548,69,333276
913,0.047504,74.125.24.0-255,5738,224286,69,333276
914,0.04751,172.31.40.0-255,66,224352,69,333276
915,0.049661,74.125.24.0-255,5738,230090,69,333276
916,0.049667,172.31.40.0-255,66,230156,69,333276
917,0.051824,74.125.24.0-255,5738,235894,69,333276
918,0.051829,172.31.40.0-255,66,235960,69,333276
919,0.054015,74.125.24.0-255,5738,241698,69,333276
920,0.054021,172.31.40.0-255,66,241764,69,333276
921,0.056183,74.125.24.0-255,5738,247502,69,333276
922,0.056189,172.31.40.0-255,66,247568,69,333276
923,0.058355,74.125.24.0-255,5738,253306,69,333276
924,0.058361,172.31.40.0-255,66,253372,69,333276
925,0.060531,74.125.24.0-255,5738,259110,69,333276
926,0.060537,172.31.40.0-255,66,259176,69,333276
927,0.062736,74.125.24.0-255,5738,264914,69,333276
928,0.062743,172.31.40.0-255,66,264980,69,333276
929,0.064896,74.125.24.0-255,5738,270718,69,333276
930,0.064902,172.31.40.0-255,66,270784,69,333276
931,0.067039,74.125.24.0-255,5738,276522,69,333276
932,0.067044,172.31.40.0-255,66,276588,69,333276
933,0.069211,74.125.24.0-255,5738,282326,69,333276
934,0.069228,172.31.40.0-255,66,282392,69,333276
935,0.071382,74.125.24.0-255,5738,288130,69,333276
936,0.071388,172.31.40.0-255,66,288196,69,333276
937,0.073571,74.125.24.0-255,5738,293934,69,333276
938,0.073577,172.31.40.0-255,66,294000,69,333276
939,0.07573,74.125.24.0-255,5738,299738,69,333276
940,0.07574,172.31.40.0-255,66,299804,69,333276
941,0.077888,74.125.24.0-255,5738,305542,69,333276
942,0.077893,172.31.40.0-255,66,305608,69,333276
943,0.080034,74.125.24.0-255,5738,311346,69,333276
944,0.080039,172.31.40.0-255,66,311412,69,333276
945,0.08224,74.125.24.0-255,5738,317150,69,333276
946,0.082247,172.31.40.0-255,66,317216,69,333276
947,0.084409,74.125.24.0-255,4320,321536,69,333276
948,0.084427,172.31.40.0-255,66,321602,69,333276
949,0.084447,74.125.24.0-255,1484,323086,69,333276
950,0.086567,74.125.24.0-255,4320,327406,69,333276
951,0.086573,172.31.40.0-255,66,327472,69,333276
952,0.088709,74.125.24.0-255,5738,333210,69,333276
953,0.088715,172.31.40.0-255,66,333276,69,333276
954,0.0,172.217.194.0-255,298,298,69,262956
955,2.2e-05,172.31.40.0-255,66,364,69,262956
956,2.8e-05,172.217.194.0-255,1484,1848,69,262956
957,3.3e-05,172.31.40.0-255,66,1914,69,262956
958,4.5e-05,172.217.194.0-255,4320,6234,69,262956
959,4.9e-05,172.31.40.0-255,66,6300,69,262956
960,7.9e-05,172.31.40.0-255,66,6366,69,262956
961,0.000103,172.217.194.0-255,1484,7850,69,262956
962,0.000105,172.31.40.0-255,66,7916,69,262956
963,0.000109,172.217.194.0-255,2902,10818,69,262956
964,0.000111,172.31.40.0-255,66,10884,69,262956
965,0.000114,172.217.194.0-255,1484,12368,69,262956
966,0.000116,172.31.40.0-255,66,12434,69,262956
967,0.000143,172.217.194.0-255,4320,16754,69,262956
968,0.000145,172.31.40.0-255,66,16820,69,262956
969,0.000151,172.217.194.0-255,1484,18304,69,262956
970,0.000153,172.31.40.0-255,66,18370,69,262956
971,0.000174,172.217.194.0-255,5379,23749,69,262956
972,0.000179,172.31.40.0-255,66,23815,69,262956
973,0.000196,172.217.194.0-255,1484,25299,69,262956
974,0.000198,172.31.40.0-255,66,25365,69,262956
975,0.000218,172.217.194.0-255,1484,26849,69,262956
976,0.00022,172.31.40.0-255,66,26915,69,262956
977,0.000226,172.217.194.0-255,4320,31235,69,262956
978,0.000228,172.31.40.0-255,66,31301,69,262956
979,0.000234,172.217.194.0-255,7156,38457,69,262956
980,0.000237,172.31.40.0-255,66,38523,69,262956
981,0.000262,172.217.194.0-255,1484,40007,69,262956
982,0.000264,172.31.40.0-255,66,40073,69,262956
983,0.000267,172.217.194.0-255,1125,41198,69,262956
984,0.000269,172.31.40.0-255,66,41264,69,262956
985,0.000271,172.217.194.0-255,1484,42748,69,262956
986,0.000277,172.217.194.0-255,4320,47068,69,262956
987,0.000279,172.31.40.0-255,66,47134,69,262956
988,0.000285,172.217.194.0-255,5738,52872,69,262956
989,0.000287,172.31.40.0-255,66,52938,69,262956
990,0.000317,172.217.194.0-255,4320,57258,69,262956
991,0.00032,172.31.40.0-255,66,57324,69,262956
992,0.000323,172.217.194.0-255,1125,58449,69,262956
993,0.000717,172.217.194.0-255,645,59094,69,262956
994,0.000723,172.31.40.0-255,66,59160,69,262956
995,0.000802,172.217.194.0-255,1484,60644,69,262956
996,0.000806,172.217.194.0-255,1484,62128,69,262956
997,0.000808,172.31.40.0-255,66,62194,69,262956
998,0.000835,172.217.194.0-255,1484,63678,69,262956
999,0.000842,172.217.194.0-255,5738,69416,69,262956
1000,0.000845,172.31.40.0-255,66,69482,69,262956
1001,0.000852,172.217.194.0-255,7156,76638,69,262956
1002,0.000854,172.31.40.0-255,66,76704,69,262956
1003,0.000878,172.217.194.0-255,5738,82442,69,262956
1004,0.00088,172.31.40.0-255,66,82508,69,262956
1005,0.000891,172.31.40.0-255,66,82574,69,262956
1006,0.001095,172.217.194.0-255,1484,84058,69,262956
1007,0.001101,172.217.194.0-255,2902,86960,69,262956
1008,0.001103,172.31.40.0-255,66,87026,69,262956
1009,0.001138,172.217.194.0-255,1484,88510,69,262956
1010,0.001155,172.217.194.0-255,4320,92830,69,262956
1011,0.001158,172.31.40.0-255,66,92896,69,262956
1012,0.001176,172.31.40.0-255,66,92962,69,262956
1013,0.001187,172.31.40.0-255,66,93028,69,262956
1014,0.001216,172.217.194.0-255,766,93794,69,262956
1015,0.001768,172.31.40.0-255,66,93860,69,262956
1016,0.001794,172.217.194.0-255,1484,95344,69,262956
1017,0.0018,172.217.194.0-255,2902,98246,69,262956
1018,0.001802,172.31.40.0-255,66,98312,69,262956
1019,0.001808,172.217.194.0-255,4320,102632,69,262956
1020,0.00181,172.31.40.0-255,66,102698,69,262956
1021,0.001837,172.217.194.0-255,1484,104182,69,262956
1022,0.001851,172.31.40.0-255,66,104248,69,262956
1023,0.001892,172.217.194.0-255,5738,109986,69,262956
1024,0.001896,172.31.40.0-255,66,110052,69,262956
1025,0.001926,172.217.194.0-255,6438,116490,69,262956
1026,0.001929,172.31.40.0-255,66,116556,69,262956
1027,0.001932,172.217.194.0-255,1484,118040,69,262956
1028,0.001955,172.217.194.0-255,2902,120942,69,262956
1029,0.001957,172.31.40.0-255,66,121008,69,262956
1030,0.001964,172.217.194.0-255,5738,126746,69,262956
1031,0.001966,172.31.40.0-255,66,126812,69,262956
1032,0.001994,172.217.194.0-255,7156,133968,69,262956
1033,0.001996,172.31.40.0-255,66,134034,69,262956
1034,0.002027,172.217.194.0-255,5738,139772,69,262956
1035,0.00203,172.31.40.0-255,66,139838,69,262956
1036,0.002041,172.31.40.0-255,66,139904,69,262956
1037,0.002058,172.31.40.0-255,66,139970,69,262956
1038,0.002102,172.31.40.0-255,66,140036,69,262956
1039,0.002114,172.31.40.0-255,66,140102,69,262956
1040,0.002117,172.217.194.0-255,1484,141586,69,262956
1041,0.002121,172.217.194.0-255,2902,144488,69,262956
1042,0.002124,172.31.40.0-255,66,144554,69,262956
1043,0.00213,172.217.194.0-255,5738,150292,69,262956
1044,0.002136,172.31.40.0-255,66,150358,69,262956
1045,0.002186,172.31.40.0-255,66,150424,69,262956
1046,0.002196,172.31.40.0-255,66,150490,69,262956
1047,0.002234,172.31.40.0-255,66,150556,69,262956
1048,0.002238,172.217.194.0-255,2902,153458,69,262956
1049,0.00224,172.31.40.0-255,66,153524,69,262956
1050,0.002281,172.217.194.0-255,7156,160680,69,262956
1051,0.002284,172.31.40.0-255,66,160746,69,262956
1052,0.002301,172.31.40.0-255,66,160812,69,262956
1053,0.002339,172.217.194.0-255,2902,163714,69,262956
1054,0.002342,172.31.40.0-255,66,163780,69,262956
1055,0.002398,172.31.40.0-255,66,163846,69,262956
1056,0.002405,172.217.194.0-255,5020,168866,69,262956
1057,0.002407,172.31.40.0-255,66,168932,69,262956
1058,0.002428,172.217.194.0-255,1484,170416,69,262956
1059,0.002433,172.217.194.0-255,2902,173318,69,262956
1060,0.002436,172.31.40.0-255,66,173384,69,262956
1061,0.002441,172.217.194.0-255,2902,176286,69,262956
1062,0.002443,172.31.40.0-255,66,176352,69,262956
1063,0.002468,172.217.194.0-255,2902,179254,69,262956
1064,0.002474,172.217.194.0-255,5738,184992,69,262956
1065,0.002498,172.217.194.0-255,4320,189312,69,262956
1066,0.002509,172.217.194.0-255,2902,192214,69,262956
1067,0.002515,172.31.40.0-255,66,192280,69,262956
1068,0.00494,172.217.194.0-255,5738,198018,69,262956
1069,0.004948,172.31.40.0-255,66,198084,69,262956
1070,0.007409,172.217.194.0-255,4320,202404,69,262956
1071,0.007415,172.31.40.0-255,66,202470,69,262956
1072,0.00744,172.217.194.0-255,1484,203954,69,262956
1073,0.009858,172.217.194.0-255,2902,206856,69,262956
1074,0.009864,172.31.40.0-255,66,206922,69,262956
1075,0.009888,172.217.194.0-255,1484,208406,69,262956
1076,0.012324,172.217.194.0-255,4320,212726,69,262956
1077,0.01233,172.31.40.0-255,66,212792,69,262956
1078,0.014766,172.217.194.0-255,5738,218530,69,262956
1079,0.014775,172.31.40.0-255,66,218596,69,262956
1080,0.017258,172.217.194.0-255,5738,224334,69,262956
1081,0.017266,172.31.40.0-255,66,224400,69,262956
1082,0.01973,172.217.194.0-255,5738,230138,69,262956
1083,0.019738,172.31.40.0-255,66,230204,69,262956
1084,0.022191,172.217.194.0-255,4320,234524,69,262956
1085,0.022198,172.31.40.0-255,66,234590,69,262956
1086,0.022218,172.217.194.0-255,1484,236074,69,262956
1087,0.024712,172.217.194.0-255,4320,240394,69,262956
1088,0.024727,172.31.40.0-255,66,240460,69,262956
1089,0.027227,172.217.194.0-255,4320,244780,69,262956
1090,0.027235,172.31.40.0-255,66,244846,69,262956
1091,0.027268,172.217.194.0-255,1484,246330,69,262956
1092,0.029682,172.217.194.0-255,4320,250650,69,262956
1093,0.029689,172.31.40.0-255,66,250716,69,262956
1094,0.032147,172.217.194.0-255,2896,253612,69,262956
1095,0.032157,172.31.40.0-255,66,253678,69,262956
1096,0.032352,172.31.40.0-255,105,253783,69,262956
1097,0.034736,172.217.194.0-255,66,253849,69,262956
1098,0.036323,172.31.40.0-255,172,254021,69,262956
1099,0.036348,172.31.40.0-255,1112,255133,69,262956
1100,0.036422,172.31.40.0-255,1514,256647,69,262956
1101,0.036445,172.31.40.0-255,1514,258161,69,262956
1102,0.036446,172.31.40.0-255,1514,259675,69,262956
1103,0.036468,172.31.40.0-255,1514,261189,69,262956
1104,0.03647,172.31.40.0-255,1503,262692,69,262956
1105,0.037992,104.244.42.0-255,66,262758,69,262956
1106,0.038028,104.244.42.0-255,66,262824,69,262956
1107,0.038145,104.244.42.0-255,66,262890,69,262956
1108,0.038205,104.244.42.0-255,66,262956,69,262956
1109,0.0,74.125.68.0-255,152,152,69,385887
1110,1.8e-05,172.31.40.0-255,66,218,69,385887
1111,2.6e-05,74.125.68.0-255,1484,1702,69,385887
1112,3.1e-05,172.31.40.0-255,66,1768,69,385887
1113,3.6e-05,74.125.68.0-255,2902,4670,69,385887
1114,4.6e-05,172.31.40.0-255,66,4736,69,385887
1115,5.2e-05,74.125.68.0-255,4320,9056,69,385887
1116,5.6e-05,172.31.40.0-255,66,9122,69,385887
1117,7.5e-05,74.125.68.0-255,2902,12024,69,385887
1118,7.8e-05,172.31.40.0-255,66,12090,69,385887
1119,0.0001,74.125.68.0-255,1484,13574,69,385887
1120,0.000102,172.31.40.0-255,66,13640,69,385887
1121,0.000113,74.125.68.0-255,4899,18539,69,385887
1122,0.000116,172.31.40.0-255,66,18605,69,385887
1123,0.000151,74.125.68.0-255,4320,22925,69,385887
1124,0.000154,172.31.40.0-255,66,22991,69,385887
1125,0.00016,74.125.68.0-255,5738,28729,69,385887
1126,0.000163,172.31.40.0-255,66,28795,69,385887
1127,0.000188,74.125.68.0-255,2543,31338,69,385887
1128,0.00019,172.31.40.0-255,66,31404,69,385887
1129,0.000334,74.125.68.0-255,1484,32888,69,385887
1130,0.000338,172.31.40.0-255,66,32954,69,385887
1131,0.000358,74.125.68.0-255,2902,35856,69,385887
1132,0.000361,172.31.40.0-255,66,35922,69,385887
1133,0.000368,74.125.68.0-255,5738,41660,69,385887
1134,0.00037,172.31.40.0-255,66,41726,69,385887
1135,0.000406,74.125.68.0-255,5738,47464,69,385887
1136,0.000409,172.31.40.0-255,66,47530,69,385887
1137,0.000414,74.125.68.0-255,2902,50432,69,385887
1138,0.000415,172.31.40.0-255,66,50498,69,385887
1139,0.000449,74.125.68.0-255,3961,54459,69,385887
1140,0.000452,172.31.40.0-255,66,54525,69,385887
1141,0.000459,74.125.68.0-255,5738,60263,69,385887
1142,0.000461,172.31.40.0-255,66,60329,69,385887
1143,0.00049,74.125.68.0-255,5691,66020,69,385887
1144,0.000493,172.31.40.0-255,66,66086,69,385887
1145,0.000504,74.125.68.0-255,343,66429,69,385887
1146,0.000567,74.125.68.0-255,1484,67913,69,385887
1147,0.000571,172.31.40.0-255,66,67979,69,385887
1148,0.000579,74.125.68.0-255,1484,69463,69,385887
1149,0.000582,74.125.68.0-255,1484,70947,69,385887
1150,0.000588,172.31.40.0-255,66,71013,69,385887
1151,0.000611,74.125.68.0-255,1484,72497,69,385887
1152,0.000619,74.125.68.0-255,5738,78235,69,385887
1153,0.000621,172.31.40.0-255,66,78301,69,385887
1154,0.000657,172.31.40.0-255,66,78367,69,385887
1155,0.000696,172.31.40.0-255,66,78433,69,385887
1156,0.000699,74.125.68.0-255,766,79199,69,385887
1157,0.000789,74.125.68.0-255,1484,80683,69,385887
1158,0.000792,172.31.40.0-255,66,80749,69,385887
1159,0.00082,74.125.68.0-255,2902,83651,69,385887
1160,0.000823,172.31.40.0-255,66,83717,69,385887
1161,0.000853,74.125.68.0-255,5738,89455,69,385887
1162,0.000856,172.31.40.0-255,66,89521,69,385887
1163,0.000859,74.125.68.0-255,1484,91005,69,385887
1164,0.000894,172.31.40.0-255,66,91071,69,385887
1165,0.000925,74.125.68.0-255,5738,96809,69,385887
1166,0.000929,172.31.40.0-255,66,96875,69,385887
1167,0.000937,74.125.68.0-255,7156,104031,69,385887
1168,0.000939,172.31.40.0-255,66,104097,69,385887
1169,0.000947,74.125.68.0-255,766,104863,69,385887
1170,0.001002,74.125.68.0-255,1484,106347,69,385887
1171,0.001005,172.31.40.0-255,66,106413,69,385887
1172,0.001025,74.125.68.0-255,2902,109315,69,385887
1173,0.001027,172.31.40.0-255,66,109381,69,385887
1174,0.001031,74.125.68.0-255,2902,112283,69,385887
1175,0.001034,172.31.40.0-255,66,112349,69,385887
1176,0.001057,74.125.68.0-255,2902,115251,69,385887
1177,0.001059,172.31.40.0-255,66,115317,69,385887
1178,0.001069,74.125.68.0-255,4320,119637,69,385887
1179,0.001071,172.31.40.0-255,66,119703,69,385887
1180,0.001078,74.125.68.0-255,5738,125441,69,385887
1181,0.00108,172.31.40.0-255,66,125507,69,385887
1182,0.001106,74.125.68.0-255,5738,131245,69,385887
1183,0.001109,172.31.40.0-255,66,131311,69,385887
1184,0.00114,74.125.68.0-255,5738,137049,69,385887
1185,0.001142,172.31.40.0-255,66,137115,69,385887
1186,0.001147,74.125.68.0-255,2184,139299,69,385887
1187,0.001149,172.31.40.0-255,66,139365,69,385887
1188,0.001248,74.125.68.0-255,1484,140849,69,385887
1189,0.001268,74.125.68.0-255,2902,143751,69,385887
1190,0.001271,172.31.40.0-255,66,143817,69,385887
1191,0.001303,74.125.68.0-255,5738,149555,69,385887
1192,0.001306,172.31.40.0-255,66,149621,69,385887
1193,0.001333,74.125.68.0-255,5738,155359,69,385887
1194,0.001336,172.31.40.0-255,66,155425,69,385887
1195,0.001359,74.125.68.0-255,1484,156909,69,385887
1196,0.001364,74.125.68.0-255,4320,161229,69,385887
1197,0.001367,172.31.40.0-255,66,161295,69,385887
1198,0.001393,74.125.68.0-255,5738,167033,69,385887
1199,0.001396,172.31.40.0-255,66,167099,69,385887
1200,0.001423,74.125.68.0-255,6438,173537,69,385887
1201,0.001426,172.31.40.0-255,66,173603,69,385887
1202,0.001507,74.125.68.0-255,1484,175087,69,385887
1203,0.001525,74.125.68.0-255,2902,177989,69,385887
1204,0.001528,172.31.40.0-255,66,178055,69,385887
1205,0.001563,74.125.68.0-255,5738,183793,69,385887
1206,0.001566,172.31.40.0-255,66,183859,69,385887
1207,0.001571,74.125.68.0-255,2902,186761,69,385887
1208,0.001573,172.31.40.0-255,66,186827,69,385887
1209,0.001583,74.125.68.0-255,4320,191147,69,385887
1210,0.001586,172.31.40.0-255,66,191213,69,385887
1211,0.001617,172.31.40.0-255,66,191279,69,385887
1212,0.001624,74.125.68.0-255,5738,197017,69,385887
1213,0.001626,172.31.40.0-255,66,197083,69,385887
1214,0.00167,74.125.68.0-255,2184,199267,69,385887
1215,0.001672,172.31.40.0-255,66,199333,69,385887
1216,0.001733,74.125.68.0-255,1484,200817,69,385887
1217,0.001739,74.125.68.0-255,2902,203719,69,385887
1218,0.001742,172.31.40.0-255,66,203785,69,385887
1219,0.00176,74.125.68.0-255,2902,206687,69,385887
1220,0.001765,172.31.40.0-255,66,206753,69,385887
1221,0.001798,74.125.68.0-255,4320,211073,69,385887
1222,0.001802,172.31.40.0-255,66,211139,69,385887
1223,0.001805,74.125.68.0-255,1484,212623,69,385887
1224,0.001837,74.125.68.0-255,2902,215525,69,385887
1225,0.001841,172.31.40.0-255,66,215591,69,385887
1226,0.00185,74.125.68.0-255,2902,218493,69,385887
1227,0.001853,172.31.40.0-255,66,218559,69,385887
1228,0.001883,74.125.68.0-255,2902,221461,69,385887
1229,0.001887,172.31.40.0-255,66,221527,69,385887
1230,0.00189,74.125.68.0-255,1484,223011,69,385887
1231,0.001895,74.125.68.0-255,2902,225913,69,385887
1232,0.001897,172.31.40.0-255,66,225979,69,385887
1233,0.001901,74.125.68.0-255,2902,228881,69,385887
1234,0.001905,172.31.40.0-255,66,228947,69,385887
1235,0.001918,74.125.68.0-255,2902,231849,69,385887
1236,0.001921,172.31.40.0-255,66,231915,69,385887
1237,0.001924,74.125.68.0-255,2184,234099,69,385887
1238,0.001931,172.31.40.0-255,66,234165,69,385887
1239,0.002122,74.125.68.0-255,1484,235649,69,385887
1240,0.002144,74.125.68.0-255,2902,238551,69,385887
1241,0.002147,172.31.40.0-255,66,238617,69,385887
1242,0.002174,74.125.68.0-255,4320,242937,69,385887
1243,0.002176,172.31.40.0-255,66,243003,69,385887
1244,0.002182,74.125.68.0-255,2902,245905,69,385887
1245,0.002184,172.31.40.0-255,66,245971,69,385887
1246,0.002207,74.125.68.0-255,2902,248873,69,385887
1247,0.002209,172.31.40.0-255,66,248939,69,385887
1248,0.002251,74.125.68.0-255,2902,251841,69,385887
1249,0.002253,172.31.40.0-255,66,251907,69,385887
1250,0.002275,172.31.40.0-255,66,251973,69,385887
1251,0.002279,74.125.68.0-255,2902,254875,69,385887
1252,0.002282,172.31.40.0-255,66,254941,69,385887
1253,0.002288,74.125.68.0-255,5738,260679,69,385887
1254,0.002291,172.31.40.0-255,66,260745,69,385887
1255,0.002313,74.125.68.0-255,766,261511,69,385887
1256,0.002339,74.125.68.0-255,7156,268667,69,385887
1257,0.002341,172.31.40.0-255,66,268733,69,385887
1258,0.002344,74.125.68.0-255,1484,270217,69,385887
1259,0.002365,74.125.68.0-255,2902,273119,69,385887
1260,0.002368,172.31.40.0-255,66,273185,69,385887
1261,0.004672,74.125.68.0-255,1484,274669,69,385887
1262,0.00469,74.125.68.0-255,4320,278989,69,385887
1263,0.004695,172.31.40.0-255,66,279055,69,385887
1264,0.007036,74.125.68.0-255,2902,281957,69,385887
1265,0.007039,172.31.40.0-255,66,282023,69,385887
1266,0.007064,74.125.68.0-255,2902,284925,69,385887
1267,0.007067,172.31.40.0-255,66,284991,69,385887
1268,0.007641,172.31.40.0-255,101,285092,69,385887
1269,0.009391,74.125.68.0-255,4320,289412,69,385887
1270,0.009397,172.31.40.0-255,66,289478,69,385887
1271,0.009427,74.125.68.0-255,1484,290962,69,385887
1272,0.009928,74.125.68.0-255,66,291028,69,385887
1273,0.011743,74.125.68.0-255,4320,295348,69,385887
1274,0.01175,172.31.40.0-255,66,295414,69,385887
1275,0.0141,74.125.68.0-255,5738,301152,69,385887
1276,0.014108,172.31.40.0-255,66,301218,69,385887
1277,0.016445,74.125.68.0-255,5738,306956,69,385887
1278,0.016453,172.31.40.0-255,66,307022,69,385887
1279,0.018795,74.125.68.0-255,5738,312760,69,385887
1280,0.018803,172.31.40.0-255,66,312826,69,385887
1281,0.021145,74.125.68.0-255,5738,318564,69,385887
1282,0.021153,172.31.40.0-255,66,318630,69,385887
1283,0.023521,74.125.68.0-255,5738,324368,69,385887
1284,0.023529,172.31.40.0-255,66,324434,69,385887
1285,0.025876,74.125.68.0-255,4320,328754,69,385887
1286,0.025883,172.31.40.0-255,66,328820,69,385887
1287,0.025912,74.125.68.0-255,1484,330304,69,385887
1288,0.028273,74.125.68.0-255,4320,334624,69,385887
1289,0.028282,172.31.40.0-255,66,334690,69,385887
1290,0.030643,74.125.68.0-255,5738,340428,69,385887
1291,0.030651,172.31.40.0-255,66,340494,69,385887
1292,0.032999,74.125.68.0-255,5738,346232,69,385887
1293,0.033006,172.31.40.0-255,66,346298,69,385887
1294,0.035342,74.125.68.0-255,5738,352036,69,385887
1295,0.035349,172.31.40.0-255,66,352102,69,385887
1296,0.037708,74.125.68.0-255,5738,357840,69,385887
1297,0.037716,172.31.40.0-255,66,357906,69,385887
1298,0.040067,74.125.68.0-255,5738,363644,69,385887
1299,0.040075,172.31.40.0-255,66,363710,69,385887
1300,0.041949,172.31.40.0-255,172,363882,69,385887
1301,0.041982,172.31.40.0-255,1114,364996,69,385887
1302,0.042049,172.31.40.0-255,1514,366510,69,385887
1303,0.042051,172.31.40.0-255,1514,368024,69,385887
1304,0.042052,172.31.40.0-255,1514,369538,69,385887
1305,0.042058,172.31.40.0-255,1514,371052,69,385887
1306,0.042059,172.31.40.0-255,1501,372553,69,385887
1307,0.042413,74.125.68.0-255,5738,378291,69,385887
1308,0.042421,172.31.40.0-255,66,378357,69,385887
1309,0.043472,104.244.42.0-255,66,378423,69,385887
1310,0.043569,104.244.42.0-255,66,378489,69,385887
1311,0.043751,104.244.42.0-255,66,378555,69,385887
1312,0.044774,74.125.68.0-255,5738,384293,69,385887
1313,0.044781,172.31.40.0-255,66,384359,69,385887
1314,0.047128,74.125.68.0-255,1357,385716,69,385887
1315,0.047316,172.31.40.0-255,105,385821,69,385887
1316,0.054282,74.125.68.0-255,66,385887,69,385887
1317,0.0,74.125.68.0-255,296,296,69,323074
1318,1.5e-05,172.31.40.0-255,66,362,69,323074
1319,3.9e-05,74.125.68.0-255,1484,1846,69,323074
1320,4.4e-05,172.31.40.0-255,66,1912,69,323074
1321,4.7e-05,74.125.68.0-255,1484,3396,69,323074
1322,4.9e-05,172.31.40.0-255,66,3462,69,323074
1323,7.3e-05,74.125.68.0-255,2902,6364,69,323074
1324,7.6e-05,172.31.40.0-255,66,6430,69,323074
1325,9.4e-05,74.125.68.0-255,2902,9332,69,323074
1326,9.6e-05,172.31.40.0-255,66,9398,69,323074
1327,0.000119,74.125.68.0-255,2902,12300,69,323074
1328,0.000121,172.31.40.0-255,66,12366,69,323074
1329,0.000138,74.125.68.0-255,1484,13850,69,323074
1330,0.00014,172.31.40.0-255,66,13916,69,323074
1331,0.000158,74.125.68.0-255,1926,15842,69,323074
1332,0.000161,172.31.40.0-255,66,15908,69,323074
1333,0.000166,74.125.68.0-255,4320,20228,69,323074
1334,0.000168,172.31.40.0-255,66,20294,69,323074
1335,0.000216,74.125.68.0-255,2902,23196,69,323074
1336,0.000219,172.31.40.0-255,66,23262,69,323074
1337,0.000237,74.125.68.0-255,4320,27582,69,323074
1338,0.00024,172.31.40.0-255,66,27648,69,323074
1339,0.000242,74.125.68.0-255,1484,29132,69,323074
1340,0.000245,172.31.40.0-255,66,29198,69,323074
1341,0.000266,74.125.68.0-255,2902,32100,69,323074
1342,0.000268,172.31.40.0-255,66,32166,69,323074
1343,0.000287,74.125.68.0-255,5738,37904,69,323074
1344,0.00029,172.31.40.0-255,66,37970,69,323074
1345,0.000324,74.125.68.0-255,1484,39454,69,323074
1346,0.000327,172.31.40.0-255,66,39520,69,323074
1347,0.000346,74.125.68.0-255,2902,42422,69,323074
1348,0.000348,172.31.40.0-255,66,42488,69,323074
1349,0.000351,74.125.68.0-255,1484,43972,69,323074
1350,0.000372,74.125.68.0-255,4320,48292,69,323074
1351,0.000375,172.31.40.0-255,66,48358,69,323074
1352,0.000378,74.125.68.0-255,766,49124,69,323074
1353,0.000626,74.125.68.0-255,1484,50608,69,323074
1354,0.000632,172.31.40.0-255,66,50674,69,323074
1355,0.000649,74.125.68.0-255,2902,53576,69,323074
1356,0.000652,172.31.40.0-255,66,53642,69,323074
1357,0.000655,74.125.68.0-255,1484,55126,69,323074
1358,0.000677,74.125.68.0-255,2902,58028,69,323074
1359,0.00068,172.31.40.0-255,66,58094,69,323074
1360,0.000707,74.125.68.0-255,4320,62414,69,323074
1361,0.00071,172.31.40.0-255,66,62480,69,323074
1362,0.000728,74.125.68.0-255,1484,63964,69,323074
1363,0.000758,74.125.68.0-255,2543,66507,69,323074
1364,0.000768,172.31.40.0-255,66,66573,69,323074
1365,0.002942,74.125.68.0-255,1484,68057,69,323074
1366,0.002952,74.125.68.0-255,2902,70959,69,323074
1367,0.002958,172.31.40.0-255,66,71025,69,323074
1368,0.002963,74.125.68.0-255,1484,72509,69,323074
1369,0.004981,74.125.68.0-255,4320,76829,69,323074
1370,0.004985,172.31.40.0-255,66,76895,69,323074
1371,0.007009,74.125.68.0-255,5738,82633,69,323074
1372,0.007015,172.31.40.0-255,66,82699,69,323074
1373,0.009042,74.125.68.0-255,5738,88437,69,323074
1374,0.009051,172.31.40.0-255,66,88503,69,323074
1375,0.011085,74.125.68.0-255,5738,94241,69,323074
1376,0.011095,172.31.40.0-255,66,94307,69,323074
1377,0.013129,74.125.68.0-255,5738,100045,69,323074
1378,0.013137,172.31.40.0-255,66,100111,69,323074
1379,0.015187,74.125.68.0-255,5738,105849,69,323074
1380,0.015194,172.31.40.0-255,66,105915,69,323074
1381,0.01726,74.125.68.0-255,5738,111653,69,323074
1382,0.017269,172.31.40.0-255,66,111719,69,323074
1383,0.019298,74.125.68.0-255,5738,117457,69,323074
1384,0.019305,172.31.40.0-255,66,117523,69,323074
1385,0.021341,74.125.68.0-255,1484,119007,69,323074
1386,0.021365,74.125.68.0-255,4320,123327,69,323074
1387,0.02137,172.31.40.0-255,66,123393,69,323074
1388,0.022787,172.31.40.0-255,172,123565,69,323074
1389,0.022832,172.31.40.0-255,1111,124676,69,323074
1390,0.022899,172.31.40.0-255,1514,126190,69,323074
1391,0.022901,172.31.40.0-255,1514,127704,69,323074
1392,0.022902,172.31.40.0-255,1514,129218,69,323074
1393,0.022903,172.31.40.0-255,1514,130732,69,323074
1394,0.022904,172.31.40.0-255,546,131278,69,323074
1395,0.023423,74.125.68.0-255,5738,137016,69,323074
1396,0.02343,172.31.40.0-255,66,137082,69,323074
1397,0.024382,104.244.42.0-255,66,137148,69,323074
1398,0.024419,104.244.42.0-255,66,137214,69,323074
1399,0.024454,104.244.42.0-255,66,137280,69,323074
1400,0.024467,104.244.42.0-255,66,137346,69,323074
1401,0.025469,74.125.68.0-255,5738,143084,69,323074
1402,0.025474,172.31.40.0-255,66,143150,69,323074
1403,0.027515,74.125.68.0-255,5738,148888,69,323074
1404,0.027523,172.31.40.0-255,66,148954,69,323074
1405,0.029575,74.125.68.0-255,5738,154692,69,323074
1406,0.029583,172.31.40.0-255,66,154758,69,323074
1407,0.03167,74.125.68.0-255,5738,160496,69,323074
1408,0.031677,172.31.40.0-255,66,160562,69,323074
1409,0.033716,74.125.68.0-255,5738,166300,69,323074
1410,0.033724,172.31.40.0-255,66,166366,69,323074
1411,0.035786,74.125.68.0-255,5738,172104,69,323074
1412,0.035794,172.31.40.0-255,66,172170,69,323074
1413,0.037827,74.125.68.0-255,5738,177908,69,323074
1414,0.037832,172.31.40.0-255,66,177974,69,323074
1415,0.039902,74.125.68.0-255,5738,183712,69,323074
1416,0.03991,172.31.40.0-255,66,183778,69,323074
1417,0.041952,74.125.68.0-255,5738,189516,69,323074
1418,0.041959,172.31.40.0-255,66,189582,69,323074
1419,0.043989,74.125.68.0-255,5738,195320,69,323074
1420,0.043997,172.31.40.0-255,66,195386,69,323074
1421,0.046038,74.125.68.0-255,5738,201124,69,323074
1422,0.046044,172.31.40.0-255,66,201190,69,323074
1423,0.048078,74.125.68.0-255,5738,206928,69,323074
1424,0.048084,172.31.40.0-255,66,206994,69,323074
1425,0.050119,74.125.68.0-255,5738,212732,69,323074
1426,0.050126,172.31.40.0-255,66,212798,69,323074
1427,0.052165,74.125.68.0-255,5738,218536,69,323074
1428,0.052173,172.31.40.0-255,66,218602,69,323074
1429,0.054217,74.125.68.0-255,5738,224340,69,323074
1430,0.054225,172.31.40.0-255,66,224406,69,323074
1431,0.056264,74.125.68.0-255,5738,230144,69,323074
1432,0.05627,172.31.40.0-255,66,230210,69,323074
1433,0.058305,74.125.68.0-255,5738,235948,69,323074
1434,0.058312,172.31.40.0-255,66,236014,69,323074
1435,0.060347,74.125.68.0-255,5738,241752,69,323074
1436,0.060357,172.31.40.0-255,66,241818,69,323074
1437,0.062392,74.125.68.0-255,5738,247556,69,323074
1438,0.062399,172.31.40.0-255,66,247622,69,323074
1439,0.064449,74.125.68.0-255,5738,253360,69,323074
1440,0.064456,172.31.40.0-255,66,253426,69,323074
1441,0.066508,74.125.68.0-255,5738,259164,69,323074
1442,0.066525,172.31.40.0-255,66,259230,69,323074
1443,0.068579,74.125.68.0-255,5738,264968,69,323074
1444,0.068598,172.31.40.0-255,66,265034,69,323074
1445,0.070647,74.125.68.0-255,5738,270772,69,323074
1446,0.070665,172.31.40.0-255,66,270838,69,323074
1447,0.072709,74.125.68.0-255,5738,276576,69,323074
1448,0.072717,172.31.40.0-255,66,276642,69,323074
1449,0.074768,74.125.68.0-255,5738,282380,69,323074
1450,0.074775,172.31.40.0-255,66,282446,69,323074
1451,0.076816,74.125.68.0-255,5738,288184,69,323074
1452,0.076823,172.31.40.0-255,66,288250,69,323074
1453,0.078865,74.125.68.0-255,5738,293988,69,323074
1454,0.078872,172.31.40.0-255,66,294054,69,323074
1455,0.080929,74.125.68.0-255,5738,299792,69,323074
1456,0.080936,172.31.40.0-255,66,299858,69,323074
1457,0.082988,74.125.68.0-255,5738,305596,69,323074
1458,0.082995,172.31.40.0-255,66,305662,69,323074
1459,0.085041,74.125.68.0-255,5738,311400,69,323074
1460,0.085049,172.31.40.0-255,66,311466,69,323074
1461,0.087084,74.125.68.0-255,5738,317204,69,323074
1462,0.087091,172.31.40.0-255,66,317270,69,323074
1463,0.089124,74.125.68.0-255,5738,323008,69,323074
1464,0.089131,172.31.40.0-255,66,323074,69,323074
1465,0.0,74.125.68.0-255,145,145,69,369472
1466,2.7e-05,172.31.40.0-255,66,211,69,369472
1467,3.3e-05,74.125.68.0-255,1484,1695,69,369472
1468,3.7e-05,172.31.40.0-255,66,1761,69,369472
1469,6.2e-05,74.125.68.0-255,2902,4663,69,369472
1470,6.5e-05,172.31.40.0-255,66,4729,69,369472
1471,7e-05,74.125.68.0-255,4320,9049,69,369472
1472,7.4e-05,172.31.40.0-255,66,9115,69,369472
1473,8.4e-05,74.125.68.0-255,1484,10599,69,369472
1474,8.7e-05,172.31.40.0-255,66,10665,69,369472
1475,9.2e-05,74.125.68.0-255,2902,13567,69,369472
1476,9.4e-05,172.31.40.0-255,66,13633,69,369472
1477,0.000111,74.125.68.0-255,681,14314,69,369472
1478,0.000113,172.31.40.0-255,66,14380,69,369472
1479,0.000252,74.125.68.0-255,1484,15864,69,369472
1480,0.000256,172.31.40.0-255,66,15930,69,369472
1481,0.000261,74.125.68.0-255,2902,18832,69,369472
1482,0.000263,172.31.40.0-255,66,18898,69,369472
1483,0.000282,74.125.68.0-255,2902,21800,69,369472
1484,0.000285,172.31.40.0-255,66,21866,69,369472
1485,0.000317,74.125.68.0-255,2902,24768,69,369472
1486,0.00032,172.31.40.0-255,66,24834,69,369472
1487,0.000331,74.125.68.0-255,1484,26318,69,369472
1488,0.000334,172.31.40.0-255,66,26384,69,369472
1489,0.000337,74.125.68.0-255,1484,27868,69,369472
1490,0.000339,172.31.40.0-255,66,27934,69,369472
1491,0.000344,74.125.68.0-255,2902,30836,69,369472
1492,0.000346,172.31.40.0-255,66,30902,69,369472
1493,0.00038,74.125.68.0-255,2543,33445,69,369472
1494,0.000384,172.31.40.0-255,66,33511,69,369472
1495,0.0004,74.125.68.0-255,2902,36413,69,369472
1496,0.000403,172.31.40.0-255,66,36479,69,369472
1497,0.00043,74.125.68.0-255,4320,40799,69,369472
1498,0.000434,172.31.40.0-255,66,40865,69,369472
1499,0.000454,74.125.68.0-255,2902,43767,69,369472
1500,0.000457,172.31.40.0-255,66,43833,69,369472
1501,0.000474,74.125.68.0-255,1484,45317,69,369472
1502,0.000492,74.125.68.0-255,3961,49278,69,369472
1503,0.000495,172.31.40.0-255,66,49344,69,369472
1504,0.000555,74.125.68.0-255,1484,50828,69,369472
1505,0.000561,74.125.68.0-255,2902,53730,69,369472
1506,0.000564,172.31.40.0-255,66,53796,69,369472
1507,0.000569,74.125.68.0-255,2902,56698,69,369472
1508,0.000571,172.31.40.0-255,66,56764,69,369472
1509,0.000588,74.125.68.0-255,2902,59666,69,369472
1510,0.00059,172.31.40.0-255,66,59732,69,369472
1511,0.000596,74.125.68.0-255,5738,65470,69,369472
1512,0.000598,172.31.40.0-255,66,65536,69,369472
1513,0.000632,74.125.68.0-255,1706,67242,69,369472
1514,0.000635,172.31.40.0-255,66,67308,69,369472
1515,0.000882,74.125.68.0-255,1484,68792,69,369472
1516,0.000899,74.125.68.0-255,2902,71694,69,369472
1517,0.000904,172.31.40.0-255,66,71760,69,369472
1518,0.000923,74.125.68.0-255,5738,77498,69,369472
1519,0.000926,172.31.40.0-255,66,77564,69,369472
1520,0.000944,74.125.68.0-255,4320,81884,69,369472
1521,0.000947,172.31.40.0-255,66,81950,69,369472
1522,0.000963,74.125.68.0-255,2902,84852,69,369472
1523,0.000967,172.31.40.0-255,66,84918,69,369472
1524,0.000978,172.31.40.0-255,66,84984,69,369472
1525,0.000992,74.125.68.0-255,2902,87886,69,369472
1526,0.000995,172.31.40.0-255,66,87952,69,369472
1527,0.001015,74.125.68.0-255,5020,92972,69,369472
1528,0.001018,172.31.40.0-255,66,93038,69,369472
1529,0.001224,74.125.68.0-255,1484,94522,69,369472
1530,0.001236,74.125.68.0-255,1484,96006,69,369472
1531,0.001239,172.31.40.0-255,66,96072,69,369472
1532,0.001254,74.125.68.0-255,1484,97556,69,369472
1533,0.001259,74.125.68.0-255,2902,100458,69,369472
1534,0.001261,172.31.40.0-255,66,100524,69,369472
1535,0.001281,74.125.68.0-255,1484,102008,69,369472
1536,0.001291,172.31.40.0-255,66,102074,69,369472
1537,0.001293,74.125.68.0-255,1484,103558,69,369472
1538,0.001309,74.125.68.0-255,5738,109296,69,369472
1539,0.001312,172.31.40.0-255,66,109362,69,369472
1540,0.001346,74.125.68.0-255,2902,112264,69,369472
1541,0.001348,172.31.40.0-255,66,112330,69,369472
1542,0.001362,74.125.68.0-255,5738,118068,69,369472
1543,0.001364,172.31.40.0-255,66,118134,69,369472
1544,0.001366,74.125.68.0-255,766,118900,69,369472
1545,0.002238,74.125.68.0-255,1484,120384,69,369472
1546,0.002241,172.31.40.0-255,66,120450,69,369472
1547,0.002255,74.125.68.0-255,2902,123352,69,369472
1548,0.002257,172.31.40.0-255,66,123418,69,369472
1549,0.002261,74.125.68.0-255,2902,126320,69,369472
1550,0.002263,172.31.40.0-255,66,126386,69,369472
1551,0.002288,74.125.68.0-255,4320,130706,69,369472
1552,0.002293,74.125.68.0-255,4320,135026,69,369472
1553,0.002312,74.125.68.0-255,4320,139346,69,369472
1554,0.002315,74.125.68.0-255,2902,142248,69,369472
1555,0.003347,172.31.40.0-255,66,142314,69,369472
1556,0.005629,74.125.68.0-255,5738,148052,69,369472
1557,0.005635,172.31.40.0-255,66,148118,69,369472
1558,0.007927,74.125.68.0-255,5738,153856,69,369472
1559,0.007934,172.31.40.0-255,66,153922,69,369472
1560,0.010228,74.125.68.0-255,5738,159660,69,369472
1561,0.010235,172.31.40.0-255,66,159726,69,369472
1562,0.012519,74.125.68.0-255,5738,165464,69,369472
1563,0.012544,172.31.40.0-255,66,165530,69,369472
1564,0.014838,74.125.68.0-255,5738,171268,69,369472
1565,0.014846,172.31.40.0-255,66,171334,69,369472
1566,0.01715,74.125.68.0-255,5738,177072,69,369472
1567,0.017162,172.31.40.0-255,66,177138,69,369472
1568,0.018439,172.31.40.0-255,167,177305,69,369472
1569,0.018479,172.31.40.0-255,1111,178416,69,369472
1570,0.018561,172.31.40.0-255,1514,179930,69,369472
1571,0.018563,172.31.40.0-255,1514,181444,69,369472
1572,0.018564,172.31.40.0-255,1514,182958,69,369472
1573,0.018565,172.31.40.0-255,1514,184472,69,369472
1574,0.018566,172.31.40.0-255,546,185018,69,369472
1575,0.019457,74.125.68.0-255,5738,190756,69,369472
1576,0.019462,172.31.40.0-255,66,190822,69,369472
1577,0.01997,104.244.42.0-255,66,190888,69,369472
1578,0.020062,104.244.42.0-255,66,190954,69,369472
1579,0.020148,104.244.42.0-255,66,191020,69,369472
1580,0.02015,104.244.42.0-255,66,191086,69,369472
1581,0.021628,104.244.42.0-255,108,191194,69,369472
1582,0.021647,172.31.40.0-255,66,191260,69,369472
1583,0.02175,74.125.68.0-255,2902,194162,69,369472
1584,0.021754,172.31.40.0-255,66,194228,69,369472
1585,0.021783,74.125.68.0-255,2902,197130,69,369472
1586,0.021786,172.31.40.0-255,66,197196,69,369472
1587,0.024029,74.125.68.0-255,2902,200098,69,369472
1588,0.024034,172.31.40.0-255,66,200164,69,369472
1589,0.024065,74.125.68.0-255,2902,203066,69,369472
1590,0.024068,172.31.40.0-255,66,203132,69,369472
1591,0.02632,74.125.68.0-255,2902,206034,69,369472
1592,0.026326,172.31.40.0-255,66,206100,69,369472
1593,0.026354,74.125.68.0-255,2902,209002,69,369472
1594,0.026356,172.31.40.0-255,66,209068,69,369472
1595,0.028609,74.125.68.0-255,2902,211970,69,369472
1596,0.028614,172.31.40.0-255,66,212036,69,369472
1597,0.028641,74.125.68.0-255,2902,214938,69,369472
1598,0.028644,172.31.40.0-255,66,215004,69,369472
1599,0.030897,74.125.68.0-255,2902,217906,69,369472
1600,0.030902,172.31.40.0-255,66,217972,69,369472
1601,0.030934,74.125.68.0-255,2902,220874,69,369472
1602,0.030937,172.31.40.0-255,66,220940,69,369472
1603,0.033183,74.125.68.0-255,2902,223842,69,369472
1604,0.033188,172.31.40.0-255,66,223908,69,369472
1605,0.033221,74.125.68.0-255,2902,226810,69,369472
1606,0.033224,172.31.40.0-255,66,226876,69,369472
1607,0.035472,74.125.68.0-255,2902,229778,69,369472
1608,0.035478,172.31.40.0-255,66,229844,69,369472
1609,0.035524,74.125.68.0-255,2902,232746,69,369472
1610,0.035528,172.31.40.0-255,66,232812,69,369472
1611,0.037769,74.125.68.0-255,2902,235714,69,369472
1612,0.037787,172.31.40.0-255,66,235780,69,369472
1613,0.037824,74.125.68.0-255,2902,238682,69,369472
1614,0.037827,172.31.40.0-255,66,238748,69,369472
1615,0.040096,74.125.68.0-255,2902,241650,69,369472
1616,0.040112,172.31.40.0-255,66,241716,69,369472
1617,0.040155,74.125.68.0-255,2902,244618,69,369472
1618,0.040158,172.31.40.0-255,66,244684,69,369472
1619,0.042421,74.125.68.0-255,2902,247586,69,369472
1620,0.042465,172.31.40.0-255,66,247652,69,369472
1621,0.042487,74.125.68.0-255,2902,250554,69,369472
1622,0.042491,172.31.40.0-255,66,250620,69,369472
1623,0.044753,74.125.68.0-255,2902,253522,69,369472
1624,0.04477,172.31.40.0-255,66,253588,69,369472
1625,0.04481,74.125.68.0-255,2902,256490,69,369472
1626,0.044813,172.31.40.0-255,66,256556,69,369472
1627,0.047062,74.125.68.0-255,2902,259458,69,369472
1628,0.047071,172.31.40.0-255,66,259524,69,369472
1629,0.047106,74.125.68.0-255,2902,262426,69,369472
1630,0.047108,172.31.40.0-255,66,262492,69,369472
1631,0.049352,74.125.68.0-255,2902,265394,69,369472
1632,0.049358,172.31.40.0-255,66,265460,69,369472
1633,0.049391,74.125.68.0-255,2902,268362,69,369472
1634,0.049394,172.31.40.0-255,66,268428,69,369472
1635,0.051638,74.125.68.0-255,2902,271330,69,369472
1636,0.051646,172.31.40.0-255,66,271396,69,369472
1637,0.051684,74.125.68.0-255,2902,274298,69,369472
1638,0.051687,172.31.40.0-255,66,274364,69,369472
1639,0.053925,74.125.68.0-255,2902,277266,69,369472
1640,0.053931,172.31.40.0-255,66,277332,69,369472
1641,0.053976,74.125.68.0-255,1484,278816,69,369472
1642,0.053992,74.125.68.0-255,1484,280300,69,369472
1643,0.053995,172.31.40.0-255,66,280366,69,369472
1644,0.056228,74.125.68.0-255,2902,283268,69,369472
1645,0.056234,172.31.40.0-255,66,283334,69,369472
1646,0.056282,74.125.68.0-255,2902,286236,69,369472
1647,0.056286,172.31.40.0-255,66,286302,69,369472
1648,0.058514,74.125.68.0-255,2902,289204,69,369472
1649,0.05852,172.31.40.0-255,66,289270,69,369472
1650,0.058558,74.125.68.0-255,2902,292172,69,369472
1651,0.058561,172.31.40.0-255,66,292238,69,369472
1652,0.060809,74.125.68.0-255,2902,295140,69,369472
1653,0.060815,172.31.40.0-255,66,295206,69,369472
1654,0.060845,74.125.68.0-255,2902,298108,69,369472
1655,0.060848,172.31.40.0-255,66,298174,69,369472
1656,0.063094,74.125.68.0-255,2902,301076,69,369472
1657,0.063099,172.31.40.0-255,66,301142,69,369472
1658,0.063132,74.125.68.0-255,2902,304044,69,369472
1659,0.063135,172.31.40.0-255,66,304110,69,369472
1660,0.06538,74.125.68.0-255,2902,307012,69,369472
1661,0.065385,172.31.40.0-255,66,307078,69,369472
1662,0.065453,74.125.68.0-255,2902,309980,69,369472
1663,0.06546,172.31.40.0-255,66,310046,69,369472
1664,0.067675,74.125.68.0-255,2902,312948,69,369472
1665,0.067682,172.31.40.0-255,66,313014,69,369472
1666,0.067727,74.125.68.0-255,1484,314498,69,369472
1667,0.067739,74.125.68.0-255,1484,315982,69,369472
1668,0.067743,172.31.40.0-255,66,316048,69,369472
1669,0.069964,74.125.68.0-255,2902,318950,69,369472
1670,0.06997,172.31.40.0-255,66,319016,69,369472
1671,0.07001,74.125.68.0-255,2902,321918,69,369472
1672,0.070013,172.31.40.0-255,66,321984,69,369472
1673,0.072248,74.125.68.0-255,2902,324886,69,369472
1674,0.072253,172.31.40.0-255,66,324952,69,369472
1675,0.072291,74.125.68.0-255,2902,327854,69,369472
1676,0.072295,172.31.40.0-255,66,327920,69,369472
1677,0.074527,74.125.68.0-255,2902,330822,69,369472
1678,0.074532,172.31.40.0-255,66,330888,69,369472
1679,0.074572,74.125.68.0-255,2902,333790,69,369472
1680,0.074575,172.31.40.0-255,66,333856,69,369472
1681,0.076806,74.125.68.0-255,2902,336758,69,369472
1682,0.076811,172.31.40.0-255,66,336824,69,369472
1683,0.076861,74.125.68.0-255,2902,339726,69,369472
1684,0.076864,172.31.40.0-255,66,339792,69,369472
1685,0.079089,74.125.68.0-255,2902,342694,69,369472
1686,0.079095,172.31.40.0-255,66,342760,69,369472
1687,0.079128,74.125.68.0-255,2902,345662,69,369472
1688,0.079131,172.31.40.0-255,66,345728,69,369472
1689,0.081369,74.125.68.0-255,2902,348630,69,369472
1690,0.081374,172.31.40.0-255,66,348696,69,369472
1691,0.081406,74.125.68.0-255,2902,351598,69,369472
1692,0.081409,172.31.40.0-255,66,351664,69,369472
1693,0.083648,74.125.68.0-255,2902,354566,69,369472
1694,0.083654,172.31.40.0-255,66,354632,69,369472
1695,0.083685,74.125.68.0-255,2902,357534,69,369472
1696,0.083688,172.31.40.0-255,66,357600,69,369472
1697,0.085944,74.125.68.0-255,2902,360502,69,369472
1698,0.085949,172.31.40.0-255,66,360568,69,369472
1699,0.085977,74.125.68.0-255,2902,363470,69,369472
1700,0.085981,172.31.40.0-255,66,363536,69,369472
1701,0.088226,74.125.68.0-255,2902,366438,69,369472
1702,0.088231,172.31.40.0-255,66,366504,69,369472
1703,0.088266,74.125.68.0-255,2902,369406,69,369472
1704,0.088269,172.31.40.0-255,66,369472,69,369472
1705,0.0,172.253.118.0-255,152,152,69,329420
1706,1.6e-05,172.31.40.0-255,66,218,69,329420
1707,2.3e-05,172.253.118.0-255,1484,1702,69,329420
1708,2.7e-05,172.31.40.0-255,66,1768,69,329420
1709,3.2e-05,172.253.118.0-255,2902,4670,69,329420
1710,4.4e-05,172.31.40.0-255,66,4736,69,329420
1711,5e-05,172.253.118.0-255,4320,9056,69,329420
1712,5.3e-05,172.31.40.0-255,66,9122,69,329420
1713,8.6e-05,172.253.118.0-255,2902,12024,69,329420
1714,8.8e-05,172.31.40.0-255,66,12090,69,329420
1715,9.3e-05,172.253.118.0-255,2141,14231,69,329420
1716,9.6e-05,172.31.40.0-255,66,14297,69,329420
1717,0.000205,172.253.118.0-255,1484,15781,69,329420
1718,0.000209,172.31.40.0-255,66,15847,69,329420
1719,0.000215,172.253.118.0-255,2902,18749,69,329420
1720,0.000217,172.31.40.0-255,66,18815,69,329420
1721,0.000228,172.253.118.0-255,4320,23135,69,329420
1722,0.000231,172.31.40.0-255,66,23201,69,329420
1723,0.000266,172.253.118.0-255,7156,30357,69,329420
1724,0.000269,172.31.40.0-255,66,30423,69,329420
1725,0.000297,172.253.118.0-255,2543,32966,69,329420
1726,0.000299,172.31.40.0-255,66,33032,69,329420
1727,0.000303,172.253.118.0-255,2902,35934,69,329420
1728,0.000305,172.31.40.0-255,66,36000,69,329420
1729,0.000324,172.31.40.0-255,66,36066,69,329420
1730,0.000337,172.31.40.0-255,66,36132,69,329420
1731,0.000388,172.253.118.0-255,3892,40024,69,329420
1732,0.000391,172.31.40.0-255,66,40090,69,329420
1733,0.00045,172.253.118.0-255,1484,41574,69,329420
1734,0.000453,172.31.40.0-255,66,41640,69,329420
1735,0.00048,172.253.118.0-255,2902,44542,69,329420
1736,0.000487,172.253.118.0-255,5738,50280,69,329420
1737,0.000534,172.253.118.0-255,5120,55400,69,329420
1738,0.000586,172.31.40.0-255,66,55466,69,329420
1739,0.000819,172.253.118.0-255,1484,56950,69,329420
1740,0.000846,172.253.118.0-255,2902,59852,69,329420
1741,0.000853,172.253.118.0-255,5738,65590,69,329420
1742,0.000859,172.31.40.0-255,66,65656,69,329420
1743,0.000892,172.253.118.0-255,2902,68558,69,329420
1744,0.000898,172.253.118.0-255,5738,74296,69,329420
1745,0.000916,172.31.40.0-255,66,74362,69,329420
1746,0.000935,172.253.118.0-255,2902,77264,69,329420
1747,0.000949,172.253.118.0-255,2184,79448,69,329420
1748,0.000958,172.31.40.0-255,66,79514,69,329420
1749,0.001634,172.253.118.0-255,1484,80998,69,329420
1750,0.001647,172.253.118.0-255,1484,82482,69,329420
1751,0.001651,172.31.40.0-255,66,82548,69,329420
1752,0.001684,172.253.118.0-255,1484,84032,69,329420
1753,0.001691,172.253.118.0-255,5738,89770,69,329420
1754,0.001704,172.253.118.0-255,1484,91254,69,329420
1755,0.001716,172.31.40.0-255,66,91320,69,329420
1756,0.001748,172.253.118.0-255,1484,92804,69,329420
1757,0.001783,172.31.40.0-255,66,92870,69,329420
1758,0.001842,172.253.118.0-255,1484,94354,69,329420
1759,0.001847,172.253.118.0-255,2902,97256,69,329420
1760,0.00186,172.31.40.0-255,66,97322,69,329420
1761,0.001865,172.253.118.0-255,2902,100224,69,329420
1762,0.001869,172.31.40.0-255,66,100290,69,329420
1763,0.001889,172.253.118.0-255,2902,103192,69,329420
1764,0.001906,172.253.118.0-255,5738,108930,69,329420
1765,0.001933,172.31.40.0-255,66,108996,69,329420
1766,0.001943,172.253.118.0-255,1484,110480,69,329420
1767,0.001965,172.253.118.0-255,3602,114082,69,329420
1768,0.001971,172.253.118.0-255,5738,119820,69,329420
1769,0.001987,172.31.40.0-255,66,119886,69,329420
1770,0.001992,172.253.118.0-255,2902,122788,69,329420
1771,0.001998,172.31.40.0-255,66,122854,69,329420
1772,0.002042,172.253.118.0-255,4320,127174,69,329420
1773,0.002046,172.253.118.0-255,2902,130076,69,329420
1774,0.002052,172.31.40.0-255,66,130142,69,329420
1775,0.00407,172.253.118.0-255,5738,135880,69,329420
1776,0.004077,172.31.40.0-255,66,135946,69,329420
1777,0.006083,172.253.118.0-255,5738,141684,69,329420
1778,0.008335,172.31.40.0-255,66,141750,69,329420
1779,0.010369,172.253.118.0-255,5738,147488,69,329420
1780,0.010376,172.31.40.0-255,66,147554,69,329420
1781,0.012392,172.253.118.0-255,5738,153292,69,329420
1782,0.013184,172.31.40.0-255,66,153358,69,329420
1783,0.015186,172.253.118.0-255,5738,159096,69,329420
1784,0.015194,172.31.40.0-255,66,159162,69,329420
1785,0.017226,172.253.118.0-255,5738,164900,69,329420
1786,0.02085,172.31.40.0-255,66,164966,69,329420
1787,0.022881,172.253.118.0-255,5738,170704,69,329420
1788,0.022899,172.31.40.0-255,66,170770,69,329420
1789,0.024932,172.253.118.0-255,5738,176508,69,329420
1790,0.024939,172.31.40.0-255,66,176574,69,329420
1791,0.026978,172.253.118.0-255,5738,182312,69,329420
1792,0.026986,172.31.40.0-255,66,182378,69,329420
1793,0.028999,172.253.118.0-255,5738,188116,69,329420
1794,0.029006,172.31.40.0-255,66,188182,69,329420
1795,0.031011,172.253.118.0-255,5738,193920,69,329420
1796,0.031019,172.31.40.0-255,66,193986,69,329420
1797,0.033029,172.253.118.0-255,5738,199724,69,329420
1798,0.033036,172.31.40.0-255,66,199790,69,329420
1799,0.034448,172.31.40.0-255,172,199962,69,329420
1800,0.034482,172.31.40.0-255,1111,201073,69,329420
1801,0.034547,172.31.40.0-255,1514,202587,69,329420
1802,0.034549,172.31.40.0-255,1514,204101,69,329420
1803,0.03455,172.31.40.0-255,1514,205615,69,329420
1804,0.034551,172.31.40.0-255,1514,207129,69,329420
1805,0.034552,172.31.40.0-255,546,207675,69,329420
1806,0.035054,172.253.118.0-255,5738,213413,69,329420
1807,0.035061,172.31.40.0-255,66,213479,69,329420
1808,0.036058,104.244.42.0-255,66,213545,69,329420
1809,0.036086,104.244.42.0-255,66,213611,69,329420
1810,0.036139,104.244.42.0-255,66,213677,69,329420
1811,0.036152,104.244.42.0-255,66,213743,69,329420
1812,0.036758,104.244.42.0-255,108,213851,69,329420
1813,0.036765,172.31.40.0-255,66,213917,69,329420
1814,0.037068,172.253.118.0-255,5738,219655,69,329420
1815,0.037072,172.31.40.0-255,66,219721,69,329420
1816,0.039105,172.253.118.0-255,5738,225459,69,329420
1817,0.039111,172.31.40.0-255,66,225525,69,329420
1818,0.041164,172.253.118.0-255,5738,231263,69,329420
1819,0.041171,172.31.40.0-255,66,231329,69,329420
1820,0.043177,172.253.118.0-255,5738,237067,69,329420
1821,0.043183,172.31.40.0-255,66,237133,69,329420
1822,0.045207,172.253.118.0-255,5738,242871,69,329420
1823,0.045213,172.31.40.0-255,66,242937,69,329420
1824,0.047234,172.253.118.0-255,5738,248675,69,329420
1825,0.04724,172.31.40.0-255,66,248741,69,329420
1826,0.049242,172.253.118.0-255,5738,254479,69,329420
1827,0.049249,172.31.40.0-255,66,254545,69,329420
1828,0.051268,172.253.118.0-255,5738,260283,69,329420
1829,0.051274,172.31.40.0-255,66,260349,69,329420
1830,0.053286,172.253.118.0-255,5738,266087,69,329420
1831,0.053293,172.31.40.0-255,66,266153,69,329420
1832,0.055311,172.253.118.0-255,5738,271891,69,329420
1833,0.055319,172.31.40.0-255,66,271957,69,329420
1834,0.057322,172.253.118.0-255,5738,277695,69,329420
1835,0.057331,172.31.40.0-255,66,277761,69,329420
1836,0.05934,172.253.118.0-255,5738,283499,69,329420
1837,0.059346,172.31.40.0-255,66,283565,69,329420
1838,0.061374,172.253.118.0-255,5738,289303,69,329420
1839,0.061382,172.31.40.0-255,66,289369,69,329420
1840,0.063404,172.253.118.0-255,5738,295107,69,329420
1841,0.063411,172.31.40.0-255,66,295173,69,329420
1842,0.065442,172.253.118.0-255,5738,300911,69,329420
1843,0.065448,172.31.40.0-255,66,300977,69,329420
1844,0.067469,172.253.118.0-255,5738,306715,69,329420
1845,0.067475,172.31.40.0-255,66,306781,69,329420
1846,0.069491,172.253.118.0-255,5738,312519,69,329420
1847,0.069498,172.31.40.0-255,66,312585,69,329420
1848,0.071515,172.253.118.0-255,5738,318323,69,329420
1849,0.071521,172.31.40.0-255,66,318389,69,329420
1850,0.07355,172.253.118.0-255,5738,324127,69,329420
1851,0.073556,172.31.40.0-255,66,324193,69,329420
1852,0.07558,172.253.118.0-255,4990,329183,69,329420
1853,0.075586,172.31.40.0-255,66,329249,69,329420
1854,0.07577,172.31.40.0-255,105,329354,69,329420
1855,0.077762,172.253.118.0-255,66,329420,69,329420
1856,0.0,172.217.194.0-255,146,146,69,370057
1857,1.6e-05,172.31.40.0-255,66,212,69,370057
1858,2.2e-05,172.217.194.0-255,1484,1696,69,370057
1859,2.6e-05,172.31.40.0-255,66,1762,69,370057
1860,3.1e-05,172.217.194.0-255,2902,4664,69,370057
1861,3.3e-05,172.31.40.0-255,66,4730,69,370057
1862,4.7e-05,172.217.194.0-255,5738,10468,69,370057
1863,5e-05,172.31.40.0-255,66,10534,69,370057
1864,8.2e-05,172.217.194.0-255,3449,13983,69,370057
1865,8.5e-05,172.31.40.0-255,66,14049,69,370057
1866,0.000286,172.217.194.0-255,1484,15533,69,370057
1867,0.000291,172.31.40.0-255,66,15599,69,370057
1868,0.000296,172.217.194.0-255,2902,18501,69,370057
1869,0.000298,172.31.40.0-255,66,18567,69,370057
1870,0.000339,172.217.194.0-255,5738,24305,69,370057
1871,0.000342,172.31.40.0-255,66,24371,69,370057
1872,0.000348,172.217.194.0-255,6797,31168,69,370057
1873,0.00035,172.31.40.0-255,66,31234,69,370057
1874,0.000422,172.217.194.0-255,1484,32718,69,370057
1875,0.000425,172.31.40.0-255,66,32784,69,370057
1876,0.00043,172.217.194.0-255,2902,35686,69,370057
1877,0.000431,172.31.40.0-255,66,35752,69,370057
1878,0.00046,172.217.194.0-255,5738,41490,69,370057
1879,0.000463,172.31.40.0-255,66,41556,69,370057
1880,0.000466,172.217.194.0-255,1484,43040,69,370057
1881,0.000467,172.31.40.0-255,66,43106,69,370057
1882,0.0005,172.31.40.0-255,66,43172,69,370057
1883,0.000525,172.217.194.0-255,4320,47492,69,370057
1884,0.000528,172.31.40.0-255,66,47558,69,370057
1885,0.000551,172.217.194.0-255,2902,50460,69,370057
1886,0.000553,172.31.40.0-255,66,50526,69,370057
1887,0.000557,172.217.194.0-255,2817,53343,69,370057
1888,0.000559,172.31.40.0-255,66,53409,69,370057
1889,0.000584,172.217.194.0-255,118,53527,69,370057
1890,0.000586,172.31.40.0-255,66,53593,69,370057
1891,0.00066,172.217.194.0-255,381,53974,69,370057
1892,0.000663,172.31.40.0-255,66,54040,69,370057
1893,0.000996,172.217.194.0-255,1484,55524,69,370057
1894,0.001,172.31.40.0-255,66,55590,69,370057
1895,0.001005,172.217.194.0-255,2902,58492,69,370057
1896,0.001007,172.31.40.0-255,66,58558,69,370057
1897,0.001012,172.217.194.0-255,4320,62878,69,370057
1898,0.001013,172.31.40.0-255,66,62944,69,370057
1899,0.00105,172.217.194.0-255,1484,64428,69,370057
1900,0.001052,172.31.40.0-255,66,64494,69,370057
1901,0.001066,172.31.40.0-255,66,64560,69,370057
1902,0.001097,172.217.194.0-255,7156,71716,69,370057
1903,0.001099,172.31.40.0-255,66,71782,69,370057
1904,0.001122,172.217.194.0-255,2902,74684,69,370057
1905,0.001124,172.31.40.0-255,66,74750,69,370057
1906,0.001126,172.217.194.0-255,766,75516,69,370057
1907,0.001128,172.31.40.0-255,66,75582,69,370057
1908,0.001343,172.217.194.0-255,1484,77066,69,370057
1909,0.001346,172.31.40.0-255,66,77132,69,370057
1910,0.001351,172.217.194.0-255,2902,80034,69,370057
1911,0.001353,172.31.40.0-255,66,80100,69,370057
1912,0.001372,172.217.194.0-255,4320,84420,69,370057
1913,0.001373,172.31.40.0-255,66,84486,69,370057
1914,0.001391,172.217.194.0-255,1484,85970,69,370057
1915,0.001393,172.31.40.0-255,66,86036,69,370057
1916,0.001399,172.217.194.0-255,5738,91774,69,370057
1917,0.001401,172.31.40.0-255,66,91840,69,370057
1918,0.001427,172.217.194.0-255,7156,98996,69,370057
1919,0.001429,172.31.40.0-255,66,99062,69,370057
1920,0.001448,172.217.194.0-255,4320,103382,69,370057
1921,0.001474,172.217.194.0-255,6438,109820,69,370057
1922,0.001477,172.31.40.0-255,66,109886,69,370057
1923,0.001481,172.31.40.0-255,66,109952,69,370057
1924,0.001973,172.217.194.0-255,1484,111436,69,370057
1925,0.001978,172.31.40.0-255,66,111502,69,370057
1926,0.001986,172.217.194.0-255,2902,114404,69,370057
1927,0.001988,172.31.40.0-255,66,114470,69,370057
1928,0.001998,172.217.194.0-255,5738,120208,69,370057
1929,0.002041,172.217.194.0-255,1484,121692,69,370057
1930,0.002086,172.217.194.0-255,7156,128848,69,370057
1931,0.002106,172.217.194.0-255,3602,132450,69,370057
1932,0.002143,172.217.194.0-255,1484,133934,69,370057
1933,0.002147,172.217.194.0-255,2902,136836,69,370057
1934,0.002163,172.217.194.0-255,1484,138320,69,370057
1935,0.002178,172.217.194.0-255,2902,141222,69,370057
1936,0.00218,172.217.194.0-255,1484,142706,69,370057
1937,0.002201,172.217.194.0-255,4320,147026,69,370057
1938,0.002215,172.217.194.0-255,4320,151346,69,370057
1939,0.002233,172.217.194.0-255,7156,158502,69,370057
1940,0.002266,172.217.194.0-255,5738,164240,69,370057
1941,0.002276,172.217.194.0-255,2184,166424,69,370057
1942,0.002634,172.217.194.0-255,1484,167908,69,370057
1943,0.002641,172.217.194.0-255,2902,170810,69,370057
1944,0.002644,172.217.194.0-255,1484,172294,69,370057
1945,0.002662,172.217.194.0-255,4320,176614,69,370057
1946,0.002673,172.217.194.0-255,2902,179516,69,370057
1947,0.002689,172.217.194.0-255,5738,185254,69,370057
1948,0.002698,172.217.194.0-255,1484,186738,69,370057
1949,0.002708,172.217.194.0-255,1484,188222,69,370057
1950,0.00272,172.217.194.0-255,2902,191124,69,370057
1951,0.002731,172.217.194.0-255,2902,194026,69,370057
1952,0.006397,172.31.40.0-255,66,194092,69,370057
1953,0.009078,172.217.194.0-255,4320,198412,69,370057
1954,0.009084,172.31.40.0-255,66,198478,69,370057
1955,0.009111,172.217.194.0-255,1484,199962,69,370057
1956,0.011777,172.217.194.0-255,4320,204282,69,370057
1957,0.015296,172.31.40.0-255,66,204348,69,370057
1958,0.017966,172.217.194.0-255,5738,210086,69,370057
1959,0.017978,172.31.40.0-255,66,210152,69,370057
1960,0.020679,172.217.194.0-255,5738,215890,69,370057
1961,0.020687,172.31.40.0-255,66,215956,69,370057
1962,0.023352,172.217.194.0-255,5738,221694,69,370057
1963,0.023359,172.31.40.0-255,66,221760,69,370057
1964,0.024875,172.31.40.0-255,167,221927,69,370057
1965,0.024903,172.31.40.0-255,1116,223043,69,370057
1966,0.024955,172.31.40.0-255,1514,224557,69,370057
1967,0.024957,172.31.40.0-255,1514,226071,69,370057
1968,0.024958,172.31.40.0-255,1514,227585,69,370057
1969,0.024959,172.31.40.0-255,1514,229099,69,370057
1970,0.02496,172.31.40.0-255,540,229639,69,370057
1971,0.026035,172.217.194.0-255,5738,235377,69,370057
1972,0.026042,172.31.40.0-255,66,235443,69,370057
1973,0.026434,104.244.42.0-255,66,235509,69,370057
1974,0.026477,104.244.42.0-255,66,235575,69,370057
1975,0.026531,104.244.42.0-255,66,235641,69,370057
1976,0.026544,104.244.42.0-255,66,235707,69,370057
1977,0.0287,172.217.194.0-255,5738,241445,69,370057
1978,0.028705,172.31.40.0-255,66,241511,69,370057
1979,0.031364,172.217.194.0-255,5738,247249,69,370057
1980,0.031369,172.31.40.0-255,66,247315,69,370057
1981,0.034032,172.217.194.0-255,5738,253053,69,370057
1982,0.034039,172.31.40.0-255,66,253119,69,370057
1983,0.036693,172.217.194.0-255,5738,258857,69,370057
1984,0.0367,172.31.40.0-255,66,258923,69,370057
1985,0.039357,172.217.194.0-255,5738,264661,69,370057
1986,0.039363,172.31.40.0-255,66,264727,69,370057
1987,0.042045,172.217.194.0-255,5738,270465,69,370057
1988,0.042051,172.31.40.0-255,66,270531,69,370057
1989,0.044731,172.217.194.0-255,5738,276269,69,370057
1990,0.044737,172.31.40.0-255,66,276335,69,370057
1991,0.047382,172.217.194.0-255,5738,282073,69,370057
1992,0.047391,172.31.40.0-255,66,282139,69,370057
1993,0.05007,172.217.194.0-255,5738,287877,69,370057
1994,0.050076,172.31.40.0-255,66,287943,69,370057
1995,0.052754,172.217.194.0-255,5738,293681,69,370057
1996,0.052762,172.31.40.0-255,66,293747,69,370057
1997,0.05544,172.217.194.0-255,5738,299485,69,370057
1998,0.055447,172.31.40.0-255,66,299551,69,370057
1999,0.058113,172.217.194.0-255,2902,302453,69,370057
2000,0.05812,172.31.40.0-255,66,302519,69,370057
2001,0.058149,172.217.194.0-255,2902,305421,69,370057
2002,0.058153,172.31.40.0-255,66,305487,69,370057
2003,0.060797,172.217.194.0-255,2902,308389,69,370057
2004,0.060803,172.31.40.0-255,66,308455,69,370057
2005,0.060829,172.217.194.0-255,2902,311357,69,370057
2006,0.060832,172.31.40.0-255,66,311423,69,370057
2007,0.063489,172.217.194.0-255,2902,314325,69,370057
2008,0.063494,172.31.40.0-255,66,314391,69,370057
2009,0.063552,172.217.194.0-255,2902,317293,69,370057
2010,0.063554,172.31.40.0-255,66,317359,69,370057
2011,0.066184,172.217.194.0-255,2902,320261,69,370057
2012,0.06619,172.31.40.0-255,66,320327,69,370057
2013,0.066218,172.217.194.0-255,2902,323229,69,370057
2014,0.066221,172.31.40.0-255,66,323295,69,370057
2015,0.06886,172.217.194.0-255,2902,326197,69,370057
2016,0.068867,172.31.40.0-255,66,326263,69,370057
2017,0.068902,172.217.194.0-255,2902,329165,69,370057
2018,0.068905,172.31.40.0-255,66,329231,69,370057
2019,0.071534,172.217.194.0-255,2902,332133,69,370057
2020,0.071539,172.31.40.0-255,66,332199,69,370057
2021,0.071567,172.217.194.0-255,2902,335101,69,370057
2022,0.07157,172.31.40.0-255,66,335167,69,370057
2023,0.074194,172.217.194.0-255,1484,336651,69,370057
2024,0.074226,172.217.194.0-255,4320,340971,69,370057
2025,0.074229,172.31.40.0-255,66,341037,69,370057
2026,0.076891,172.217.194.0-255,5738,346775,69,370057
2027,0.076898,172.31.40.0-255,66,346841,69,370057
2028,0.07957,172.217.194.0-255,5738,352579,69,370057
2029,0.079575,172.31.40.0-255,66,352645,69,370057
2030,0.082249,172.217.194.0-255,5738,358383,69,370057
2031,0.082254,172.31.40.0-255,66,358449,69,370057
2032,0.084919,172.217.194.0-255,5738,364187,69,370057
2033,0.084925,172.31.40.0-255,66,364253,69,370057
2034,0.087606,172.217.194.0-255,5738,369991,69,370057
2035,0.087613,172.31.40.0-255,66,370057,69,370057
2036,0.0,74.125.24.0-255,153,153,69,233257
2037,1.8e-05,172.31.40.0-255,66,219,69,233257
2038,2.5e-05,74.125.24.0-255,1484,1703,69,233257
2039,2.9e-05,172.31.40.0-255,66,1769,69,233257
2040,3.3e-05,74.125.24.0-255,1484,3253,69,233257
2041,3.5e-05,172.31.40.0-255,66,3319,69,233257
2042,5.4e-05,74.125.24.0-255,1484,4803,69,233257
2043,5.6e-05,172.31.40.0-255,66,4869,69,233257
2044,6.3e-05,74.125.24.0-255,5738,10607,69,233257
2045,6.6e-05,172.31.40.0-255,66,10673,69,233257
2046,7.1e-05,74.125.24.0-255,6355,17028,69,233257
2047,7.4e-05,172.31.40.0-255,66,17094,69,233257
2048,9.3e-05,74.125.24.0-255,4320,21414,69,233257
2049,9.6e-05,172.31.40.0-255,66,21480,69,233257
2050,0.000131,172.31.40.0-255,66,21546,69,233257
2051,0.000135,74.125.24.0-255,2902,24448,69,233257
2052,0.000137,172.31.40.0-255,66,24514,69,233257
2053,0.000141,74.125.24.0-255,4320,28834,69,233257
2054,0.000143,172.31.40.0-255,66,28900,69,233257
2055,0.000146,74.125.24.0-255,1484,30384,69,233257
2056,0.000148,172.31.40.0-255,66,30450,69,233257
2057,0.000174,74.125.24.0-255,7156,37606,69,233257
2058,0.000176,172.31.40.0-255,66,37672,69,233257
2059,0.000178,74.125.24.0-255,1125,38797,69,233257
2060,0.00018,172.31.40.0-255,66,38863,69,233257
2061,0.000265,74.125.24.0-255,1484,40347,69,233257
2062,0.000267,172.31.40.0-255,66,40413,69,233257
2063,0.000272,74.125.24.0-255,2902,43315,69,233257
2064,0.000274,172.31.40.0-255,66,43381,69,233257
2065,0.000277,74.125.24.0-255,1484,44865,69,233257
2066,0.000278,172.31.40.0-255,66,44931,69,233257
2067,0.00031,74.125.24.0-255,4320,49251,69,233257
2068,0.000337,74.125.24.0-255,7090,56341,69,233257
2069,0.000469,172.31.40.0-255,66,56407,69,233257
2070,0.000527,74.125.24.0-255,134,56541,69,233257
2071,0.000531,74.125.24.0-255,346,56887,69,233257
2072,0.000782,74.125.24.0-255,1484,58371,69,233257
2073,0.000788,74.125.24.0-255,2902,61273,69,233257
2074,0.000793,172.31.40.0-255,66,61339,69,233257
2075,0.000802,74.125.24.0-255,1484,62823,69,233257
2076,0.000819,74.125.24.0-255,4320,67143,69,233257
2077,0.000829,172.31.40.0-255,66,67209,69,233257
2078,0.000841,74.125.24.0-255,7156,74365,69,233257
2079,0.000845,172.31.40.0-255,66,74431,69,233257
2080,0.000861,74.125.24.0-255,5738,80169,69,233257
2081,0.00089,172.31.40.0-255,66,80235,69,233257
2082,0.000915,74.125.24.0-255,1484,81719,69,233257
2083,0.00093,74.125.24.0-255,2902,84621,69,233257
2084,0.000942,172.31.40.0-255,66,84687,69,233257
2085,0.000947,74.125.24.0-255,4320,89007,69,233257
2086,0.000951,172.31.40.0-255,66,89073,69,233257
2087,0.000965,74.125.24.0-255,1484,90557,69,233257
2088,0.00097,74.125.24.0-255,4320,94877,69,233257
2089,0.000988,74.125.24.0-255,4320,99197,69,233257
2090,0.000992,172.31.40.0-255,66,99263,69,233257
2091,0.001023,74.125.24.0-255,7156,106419,69,233257
2092,0.001043,172.31.40.0-255,66,106485,69,233257
2093,0.001137,74.125.24.0-255,1484,107969,69,233257
2094,0.001153,74.125.24.0-255,2902,110871,69,233257
2095,0.001162,172.31.40.0-255,66,110937,69,233257
2096,0.001187,74.125.24.0-255,5738,116675,69,233257
2097,0.001195,172.31.40.0-255,66,116741,69,233257
2098,0.001202,74.125.24.0-255,1484,118225,69,233257
2099,0.001232,74.125.24.0-255,4320,122545,69,233257
2100,0.001245,74.125.24.0-255,1484,124029,69,233257
2101,0.00125,172.31.40.0-255,66,124095,69,233257
2102,0.001289,74.125.24.0-255,5020,129115,69,233257
2103,0.001303,172.31.40.0-255,66,129181,69,233257
2104,0.001323,74.125.24.0-255,1484,130665,69,233257
2105,0.001335,74.125.24.0-255,1484,132149,69,233257
2106,0.001341,172.31.40.0-255,66,132215,69,233257
2107,0.001351,74.125.24.0-255,1484,133699,69,233257
2108,0.001367,74.125.24.0-255,5738,139437,69,233257
2109,0.001375,74.125.24.0-255,7156,146593,69,233257
2110,0.001405,74.125.24.0-255,7156,153749,69,233257
2111,0.00141,172.31.40.0-255,66,153815,69,233257
2112,0.001446,74.125.24.0-255,7156,160971,69,233257
2113,0.001451,74.125.24.0-255,2184,163155,69,233257
2114,0.001499,172.31.40.0-255,66,163221,69,233257
2115,0.001665,74.125.24.0-255,1484,164705,69,233257
2116,0.001669,74.125.24.0-255,1484,166189,69,233257
2117,0.001676,172.31.40.0-255,66,166255,69,233257
2118,0.001685,74.125.24.0-255,1484,167739,69,233257
2119,0.001697,74.125.24.0-255,5738,173477,69,233257
2120,0.001709,74.125.24.0-255,2902,176379,69,233257
2121,0.001742,172.31.40.0-255,66,176445,69,233257
2122,0.001748,172.31.40.0-255,66,176511,69,233257
2123,0.001802,172.31.40.0-255,66,176577,69,233257
2124,0.001866,172.31.40.0-255,66,176643,69,233257
2125,0.001875,74.125.24.0-255,1484,178127,69,233257
2126,0.001922,172.31.40.0-255,66,178193,69,233257
2127,0.00197,172.31.40.0-255,66,178259,69,233257
2128,0.001981,74.125.24.0-255,2902,181161,69,233257
2129,0.002013,74.125.24.0-255,5738,186899,69,233257
2130,0.002029,172.31.40.0-255,66,186965,69,233257
2131,0.002078,172.31.40.0-255,66,187031,69,233257
2132,0.002092,74.125.24.0-255,5020,192051,69,233257
2133,0.002117,74.125.24.0-255,7156,199207,69,233257
2134,0.002124,172.31.40.0-255,66,199273,69,233257
2135,0.002131,74.125.24.0-255,1484,200757,69,233257
2136,0.002163,74.125.24.0-255,1484,202241,69,233257
2137,0.002246,172.31.40.0-255,66,202307,69,233257
2138,0.002267,74.125.24.0-255,4320,206627,69,233257
2139,0.002281,74.125.24.0-255,4320,210947,69,233257
2140,0.002284,172.31.40.0-255,66,211013,69,233257
2141,0.002294,74.125.24.0-255,3602,214615,69,233257
2142,0.002315,74.125.24.0-255,5738,220353,69,233257
2143,0.00233,74.125.24.0-255,3455,223808,69,233257
2144,0.002337,172.31.40.0-255,66,223874,69,233257
2145,0.002361,74.125.24.0-255,105,223979,69,233257
2146,0.009965,172.31.40.0-255,66,224045,69,233257
2147,0.010004,172.31.40.0-255,105,224150,69,233257
2148,0.01258,74.125.24.0-255,66,224216,69,233257
2149,0.033944,172.31.40.0-255,172,224388,69,233257
2150,0.03397,172.31.40.0-255,1114,225502,69,233257
2151,0.034047,172.31.40.0-255,1514,227016,69,233257
2152,0.034049,172.31.40.0-255,1514,228530,69,233257
2153,0.03405,172.31.40.0-255,1514,230044,69,233257
2154,0.034055,172.31.40.0-255,1514,231558,69,233257
2155,0.034056,172.31.40.0-255,1501,233059,69,233257
2156,0.035484,104.244.42.0-255,66,233125,69,233257
2157,0.035542,104.244.42.0-255,66,233191,69,233257
2158,0.035649,104.244.42.0-255,66,233257,69,233257
2159,0.0,74.125.24.0-255,146,146,69,353932
2160,1.5e-05,172.31.40.0-255,66,212,69,353932
2161,2.1e-05,74.125.24.0-255,1484,1696,69,353932
2162,2.5e-05,172.31.40.0-255,66,1762,69,353932
2163,3e-05,74.125.24.0-255,2902,4664,69,353932
2164,3.3e-05,172.31.40.0-255,66,4730,69,353932
2165,7e-05,74.125.24.0-255,7156,11886,69,353932
2166,7.4e-05,172.31.40.0-255,66,11952,69,353932
2167,7.8e-05,74.125.24.0-255,2076,14028,69,353932
2168,8e-05,172.31.40.0-255,66,14094,69,353932
2169,0.000151,74.125.24.0-255,1484,15578,69,353932
2170,0.000154,172.31.40.0-255,66,15644,69,353932
2171,0.000158,74.125.24.0-255,1484,17128,69,353932
2172,0.00016,172.31.40.0-255,66,17194,69,353932
2173,0.000173,74.125.24.0-255,1484,18678,69,353932
2174,0.000176,172.31.40.0-255,66,18744,69,353932
2175,0.000183,74.125.24.0-255,5738,24482,69,353932
2176,0.000186,172.31.40.0-255,66,24548,69,353932
2177,0.000215,172.31.40.0-255,66,24614,69,353932
2178,0.00022,74.125.24.0-255,2902,27516,69,353932
2179,0.000223,172.31.40.0-255,66,27582,69,353932
2180,0.000245,74.125.24.0-255,5738,33320,69,353932
2181,0.000248,172.31.40.0-255,66,33386,69,353932
2182,0.000279,74.125.24.0-255,6797,40183,69,353932
2183,0.000281,172.31.40.0-255,66,40249,69,353932
2184,0.000381,74.125.24.0-255,1484,41733,69,353932
2185,0.000385,172.31.40.0-255,66,41799,69,353932
2186,0.000389,74.125.24.0-255,1484,43283,69,353932
2187,0.000391,172.31.40.0-255,66,43349,69,353932
2188,0.000405,74.125.24.0-255,1484,44833,69,353932
2189,0.000408,172.31.40.0-255,66,44899,69,353932
2190,0.000414,74.125.24.0-255,5738,50637,69,353932
2191,0.000417,172.31.40.0-255,66,50703,69,353932
2192,0.000419,74.125.24.0-255,1484,52187,69,353932
2193,0.000458,74.125.24.0-255,5711,57898,69,353932
2194,0.000477,172.31.40.0-255,66,57964,69,353932
2195,0.000515,74.125.24.0-255,347,58311,69,353932
2196,0.000955,74.125.24.0-255,1484,59795,69,353932
2197,0.000961,74.125.24.0-255,2902,62697,69,353932
2198,0.000963,74.125.24.0-255,1484,64181,69,353932
2199,0.000968,172.31.40.0-255,66,64247,69,353932
2200,0.000988,74.125.24.0-255,4320,68567,69,353932
2201,0.000996,74.125.24.0-255,7156,75723,69,353932
2202,0.001005,172.31.40.0-255,66,75789,69,353932
2203,0.001017,74.125.24.0-255,5738,81527,69,353932
2204,0.001021,74.125.24.0-255,2902,84429,69,353932
2205,0.001025,172.31.40.0-255,66,84495,69,353932
2206,0.001059,172.31.40.0-255,66,84561,69,353932
2207,0.001852,74.125.24.0-255,1484,86045,69,353932
2208,0.00186,172.31.40.0-255,66,86111,69,353932
2209,0.001869,74.125.24.0-255,2902,89013,69,353932
2210,0.001901,74.125.24.0-255,5738,94751,69,353932
2211,0.001904,74.125.24.0-255,1484,96235,69,353932
2212,0.00191,74.125.24.0-255,5738,101973,69,353932
2213,0.001934,74.125.24.0-255,7156,109129,69,353932
2214,0.001955,74.125.24.0-255,2902,112031,69,353932
2215,0.001971,74.125.24.0-255,6438,118469,69,353932
2216,0.006152,172.31.40.0-255,66,118535,69,353932
2217,0.008246,74.125.24.0-255,5738,124273,69,353932
2218,0.008253,172.31.40.0-255,66,124339,69,353932
2219,0.01032,74.125.24.0-255,5738,130077,69,353932
2220,0.012938,172.31.40.0-255,66,130143,69,353932
2221,0.015012,74.125.24.0-255,5738,135881,69,353932
2222,0.015023,172.31.40.0-255,66,135947,69,353932
2223,0.017086,74.125.24.0-255,5738,141685,69,353932
2224,0.017093,172.31.40.0-255,66,141751,69,353932
2225,0.01916,74.125.24.0-255,5738,147489,69,353932
2226,0.019166,172.31.40.0-255,66,147555,69,353932
2227,0.02121,74.125.24.0-255,5738,153293,69,353932
2228,0.021218,172.31.40.0-255,66,153359,69,353932
2229,0.023325,74.125.24.0-255,5738,159097,69,353932
2230,0.023334,172.31.40.0-255,66,159163,69,353932
2231,0.025406,74.125.24.0-255,5738,164901,69,353932
2232,0.025414,172.31.40.0-255,66,164967,69,353932
2233,0.027458,74.125.24.0-255,5738,170705,69,353932
2234,0.027466,172.31.40.0-255,66,170771,69,353932
2235,0.029509,74.125.24.0-255,5738,176509,69,353932
2236,0.029517,172.31.40.0-255,66,176575,69,353932
2237,0.030703,172.31.40.0-255,172,176747,69,353932
2238,0.030737,172.31.40.0-255,1116,177863,69,353932
2239,0.030798,172.31.40.0-255,1514,179377,69,353932
2240,0.0308,172.31.40.0-255,1514,180891,69,353932
2241,0.030801,172.31.40.0-255,1514,182405,69,353932
2242,0.030802,172.31.40.0-255,1514,183919,69,353932
2243,0.030836,172.31.40.0-255,1499,185418,69,353932
2244,0.031569,74.125.24.0-255,5738,191156,69,353932
2245,0.031576,172.31.40.0-255,66,191222,69,353932
2246,0.032225,104.244.42.0-255,66,191288,69,353932
2247,0.03235,104.244.42.0-255,66,191354,69,353932
2248,0.03241,104.244.42.0-255,66,191420,69,353932
2249,0.0336,74.125.24.0-255,5738,197158,69,353932
2250,0.033607,172.31.40.0-255,66,197224,69,353932
2251,0.035661,74.125.24.0-255,5738,202962,69,353932
2252,0.035668,172.31.40.0-255,66,203028,69,353932
2253,0.037691,74.125.24.0-255,5738,208766,69,353932
2254,0.037697,172.31.40.0-255,66,208832,69,353932
2255,0.039727,74.125.24.0-255,5738,214570,69,353932
2256,0.039733,172.31.40.0-255,66,214636,69,353932
2257,0.041859,74.125.24.0-255,5738,220374,69,353932
2258,0.041868,172.31.40.0-255,66,220440,69,353932
2259,0.043919,74.125.24.0-255,5738,226178,69,353932
2260,0.043924,172.31.40.0-255,66,226244,69,353932
2261,0.046008,74.125.24.0-255,5738,231982,69,353932
2262,0.046015,172.31.40.0-255,66,232048,69,353932
2263,0.048104,74.125.24.0-255,5738,237786,69,353932
2264,0.04811,172.31.40.0-255,66,237852,69,353932
2265,0.050145,74.125.24.0-255,5738,243590,69,353932
2266,0.050155,172.31.40.0-255,66,243656,69,353932
2267,0.052204,74.125.24.0-255,5738,249394,69,353932
2268,0.05221,172.31.40.0-255,66,249460,69,353932
2269,0.054247,74.125.24.0-255,5738,255198,69,353932
2270,0.054254,172.31.40.0-255,66,255264,69,353932
2271,0.056336,74.125.24.0-255,5738,261002,69,353932
2272,0.056341,172.31.40.0-255,66,261068,69,353932
2273,0.058443,74.125.24.0-255,5738,266806,69,353932
2274,0.058449,172.31.40.0-255,66,266872,69,353932
2275,0.060492,74.125.24.0-255,5738,272610,69,353932
2276,0.060514,172.31.40.0-255,66,272676,69,353932
2277,0.062578,74.125.24.0-255,5738,278414,69,353932
2278,0.062584,172.31.40.0-255,66,278480,69,353932
2279,0.064646,74.125.24.0-255,5738,284218,69,353932
2280,0.064653,172.31.40.0-255,66,284284,69,353932
2281,0.066733,74.125.24.0-255,5738,290022,69,353932
2282,0.06674,172.31.40.0-255,66,290088,69,353932
2283,0.068825,74.125.24.0-255,5738,295826,69,353932
2284,0.068831,172.31.40.0-255,66,295892,69,353932
2285,0.070889,74.125.24.0-255,5738,301630,69,353932
2286,0.070895,172.31.40.0-255,66,301696,69,353932
2287,0.072971,74.125.24.0-255,5738,307434,69,353932
2288,0.072977,172.31.40.0-255,66,307500,69,353932
2289,0.074987,74.125.24.0-255,5738,313238,69,353932
2290,0.074994,172.31.40.0-255,66,313304,69,353932
2291,0.0771,74.125.24.0-255,5738,319042,69,353932
2292,0.077106,172.31.40.0-255,66,319108,69,353932
2293,0.079187,74.125.24.0-255,5738,324846,69,353932
2294,0.079193,172.31.40.0-255,66,324912,69,353932
2295,0.081274,74.125.24.0-255,5738,330650,69,353932
2296,0.081281,172.31.40.0-255,66,330716,69,353932
2297,0.08335,74.125.24.0-255,5738,336454,69,353932
2298,0.083356,172.31.40.0-255,66,336520,69,353932
2299,0.085378,74.125.24.0-255,5738,342258,69,353932
2300,0.085383,172.31.40.0-255,66,342324,69,353932
2301,0.087432,74.125.24.0-255,5738,348062,69,353932
2302,0.087439,172.31.40.0-255,66,348128,69,353932
2303,0.089515,74.125.24.0-255,5738,353866,69,353932
2304,0.08952,172.31.40.0-255,66,353932,69,353932
2305,0.0,74.125.200.0-255,153,153,69,372949
2306,1.2e-05,172.31.40.0-255,66,219,69,372949
2307,1.8e-05,74.125.200.0-255,1484,1703,69,372949
2308,2.3e-05,172.31.40.0-255,66,1769,69,372949
2309,2.6e-05,74.125.200.0-255,1484,3253,69,372949
2310,2.8e-05,172.31.40.0-255,66,3319,69,372949
2311,5.3e-05,74.125.200.0-255,1484,4803,69,372949
2312,5.5e-05,172.31.40.0-255,66,4869,69,372949
2313,6.3e-05,74.125.200.0-255,4320,9189,69,372949
2314,6.9e-05,172.31.40.0-255,66,9255,69,372949
2315,9.2e-05,74.125.200.0-255,2902,12157,69,372949
2316,9.4e-05,172.31.40.0-255,66,12223,69,372949
2317,0.000116,74.125.200.0-255,2039,14262,69,372949
2318,0.000118,172.31.40.0-255,66,14328,69,372949
2319,0.000123,74.125.200.0-255,2902,17230,69,372949
2320,0.000125,172.31.40.0-255,66,17296,69,372949
2321,0.000149,74.125.200.0-255,4320,21616,69,372949
2322,0.000152,172.31.40.0-255,66,21682,69,372949
2323,0.000182,74.125.200.0-255,2902,24584,69,372949
2324,0.000185,172.31.40.0-255,66,24650,69,372949
2325,0.000191,74.125.200.0-255,5738,30388,69,372949
2326,0.000193,172.31.40.0-255,66,30454,69,372949
2327,0.000215,74.125.200.0-255,1125,31579,69,372949
2328,0.000217,172.31.40.0-255,66,31645,69,372949
2329,0.000235,74.125.200.0-255,1484,33129,69,372949
2330,0.000237,172.31.40.0-255,66,33195,69,372949
2331,0.000239,74.125.200.0-255,1484,34679,69,372949
2332,0.000241,172.31.40.0-255,66,34745,69,372949
2333,0.000264,74.125.200.0-255,2902,37647,69,372949
2334,0.000269,172.31.40.0-255,66,37713,69,372949
2335,0.000276,74.125.200.0-255,7156,44869,69,372949
2336,0.000278,172.31.40.0-255,66,44935,69,372949
2337,0.000305,74.125.200.0-255,1484,46419,69,372949
2338,0.000319,74.125.200.0-255,2543,48962,69,372949
2339,0.000321,172.31.40.0-255,66,49028,69,372949
2340,0.000686,74.125.200.0-255,1484,50512,69,372949
2341,0.000702,74.125.200.0-255,2902,53414,69,372949
2342,0.000706,172.31.40.0-255,66,53480,69,372949
2343,0.00071,74.125.200.0-255,1484,54964,69,372949
2344,0.000736,74.125.200.0-255,4320,59284,69,372949
2345,0.00074,74.125.200.0-255,2902,62186,69,372949
2346,0.000743,172.31.40.0-255,66,62252,69,372949
2347,0.000746,172.31.40.0-255,66,62318,69,372949
2348,0.000817,74.125.200.0-255,1484,63802,69,372949
2349,0.000836,74.125.200.0-255,3122,66924,69,372949
2350,0.000839,172.31.40.0-255,66,66990,69,372949
2351,0.000912,74.125.200.0-255,1484,68474,69,372949
2352,0.000921,74.125.200.0-255,1484,69958,69,372949
2353,0.000924,172.31.40.0-255,66,70024,69,372949
2354,0.000953,74.125.200.0-255,1484,71508,69,372949
2355,0.000959,74.125.200.0-255,5738,77246,69,372949
2356,0.000961,172.31.40.0-255,66,77312,69,372949
2357,0.000966,74.125.200.0-255,4320,81632,69,372949
2358,0.000968,172.31.40.0-255,66,81698,69,372949
2359,0.000971,74.125.200.0-255,2543,84241,69,372949
2360,0.000973,172.31.40.0-255,66,84307,69,372949
2361,0.001015,74.125.200.0-255,2902,87209,69,372949
2362,0.001017,172.31.40.0-255,66,87275,69,372949
2363,0.001048,74.125.200.0-255,4320,91595,69,372949
2364,0.00105,172.31.40.0-255,66,91661,69,372949
2365,0.001057,74.125.200.0-255,7156,98817,69,372949
2366,0.001059,172.31.40.0-255,66,98883,69,372949
2367,0.001084,74.125.200.0-255,1484,100367,69,372949
2368,0.001087,74.125.200.0-255,1125,101492,69,372949
2369,0.001089,172.31.40.0-255,66,101558,69,372949
2370,0.001144,74.125.200.0-255,1484,103042,69,372949
2371,0.001162,74.125.200.0-255,2902,105944,69,372949
2372,0.001164,172.31.40.0-255,66,106010,69,372949
2373,0.001194,74.125.200.0-255,5738,111748,69,372949
2374,0.001196,172.31.40.0-255,66,111814,69,372949
2375,0.0012,74.125.200.0-255,2902,114716,69,372949
2376,0.001202,172.31.40.0-255,66,114782,69,372949
2377,0.001222,74.125.200.0-255,2902,117684,69,372949
2378,0.001224,172.31.40.0-255,66,117750,69,372949
2379,0.001258,74.125.200.0-255,4320,122070,69,372949
2380,0.001263,172.31.40.0-255,66,122136,69,372949
2381,0.001265,172.31.40.0-255,66,122202,69,372949
2382,0.001299,172.31.40.0-255,66,122268,69,372949
2383,0.001319,74.125.200.0-255,4320,126588,69,372949
2384,0.001321,172.31.40.0-255,66,126654,69,372949
2385,0.001327,74.125.200.0-255,5020,131674,69,372949
2386,0.001329,172.31.40.0-255,66,131740,69,372949
2387,0.00208,74.125.200.0-255,1484,133224,69,372949
2388,0.002091,74.125.200.0-255,2902,136126,69,372949
2389,0.002095,172.31.40.0-255,66,136192,69,372949
2390,0.0021,74.125.200.0-255,1484,137676,69,372949
2391,0.002127,74.125.200.0-255,4320,141996,69,372949
2392,0.002129,172.31.40.0-255,66,142062,69,372949
2393,0.002176,74.125.200.0-255,5738,147800,69,372949
2394,0.002179,172.31.40.0-255,66,147866,69,372949
2395,0.002188,74.125.200.0-255,7156,155022,69,372949
2396,0.00219,172.31.40.0-255,66,155088,69,372949
2397,0.002201,74.125.200.0-255,4320,159408,69,372949
2398,0.002203,172.31.40.0-255,66,159474,69,372949
2399,0.002258,74.125.200.0-255,5738,165212,69,372949
2400,0.002261,172.31.40.0-255,66,165278,69,372949
2401,0.002264,74.125.200.0-255,766,166044,69,372949
2402,0.004095,172.31.40.0-255,66,166110,69,372949
2403,0.004674,74.125.200.0-255,4320,170430,69,372949
2404,0.004679,172.31.40.0-255,66,170496,69,372949
2405,0.006531,74.125.200.0-255,1484,171980,69,372949
2406,0.007096,74.125.200.0-255,4320,176300,69,372949
2407,0.007101,172.31.40.0-255,66,176366,69,372949
2408,0.009594,74.125.200.0-255,5738,182104,69,372949
2409,0.009601,172.31.40.0-255,66,182170,69,372949
2410,0.012014,74.125.200.0-255,5738,187908,69,372949
2411,0.012022,172.31.40.0-255,66,187974,69,372949
2412,0.014437,74.125.200.0-255,5738,193712,69,372949
2413,0.014445,172.31.40.0-255,66,193778,69,372949
2414,0.016853,74.125.200.0-255,4320,198098,69,372949
2415,0.01686,172.31.40.0-255,66,198164,69,372949
2416,0.016887,74.125.200.0-255,1484,199648,69,372949
2417,0.019291,74.125.200.0-255,4320,203968,69,372949
2418,0.0193,172.31.40.0-255,66,204034,69,372949
2419,0.021748,74.125.200.0-255,4320,208354,69,372949
2420,0.021756,172.31.40.0-255,66,208420,69,372949
2421,0.021787,74.125.200.0-255,1484,209904,69,372949
2422,0.024172,74.125.200.0-255,4320,214224,69,372949
2423,0.024181,172.31.40.0-255,66,214290,69,372949
2424,0.026601,74.125.200.0-255,5738,220028,69,372949
2425,0.026609,172.31.40.0-255,66,220094,69,372949
2426,0.029039,74.125.200.0-255,5738,225832,69,372949
2427,0.029047,172.31.40.0-255,66,225898,69,372949
2428,0.029974,172.31.40.0-255,172,226070,69,372949
2429,0.030003,172.31.40.0-255,1116,227186,69,372949
2430,0.030074,172.31.40.0-255,1514,228700,69,372949
2431,0.030096,172.31.40.0-255,1514,230214,69,372949
2432,0.030101,172.31.40.0-255,1514,231728,69,372949
2433,0.030124,172.31.40.0-255,1514,233242,69,372949
2434,0.03013,172.31.40.0-255,1499,234741,69,372949
2435,0.031461,74.125.200.0-255,5738,240479,69,372949
2436,0.031467,172.31.40.0-255,66,240545,69,372949
2437,0.031662,104.244.42.0-255,66,240611,69,372949
2438,0.03169,104.244.42.0-255,66,240677,69,372949
2439,0.031769,104.244.42.0-255,66,240743,69,372949
2440,0.031807,104.244.42.0-255,66,240809,69,372949
2441,0.033897,74.125.200.0-255,5738,246547,69,372949
2442,0.033904,172.31.40.0-255,66,246613,69,372949
2443,0.036327,74.125.200.0-255,5738,252351,69,372949
2444,0.036334,172.31.40.0-255,66,252417,69,372949
2445,0.038777,74.125.200.0-255,5738,258155,69,372949
2446,0.038784,172.31.40.0-255,66,258221,69,372949
2447,0.041196,74.125.200.0-255,5738,263959,69,372949
2448,0.041203,172.31.40.0-255,66,264025,69,372949
2449,0.043628,74.125.200.0-255,5738,269763,69,372949
2450,0.043634,172.31.40.0-255,66,269829,69,372949
2451,0.046075,74.125.200.0-255,5738,275567,69,372949
2452,0.04608,172.31.40.0-255,66,275633,69,372949
2453,0.048506,74.125.200.0-255,5738,281371,69,372949
2454,0.048513,172.31.40.0-255,66,281437,69,372949
2455,0.050951,74.125.200.0-255,5738,287175,69,372949
2456,0.050956,172.31.40.0-255,66,287241,69,372949
2457,0.053398,74.125.200.0-255,5738,292979,69,372949
2458,0.053405,172.31.40.0-255,66,293045,69,372949
2459,0.055822,74.125.200.0-255,5738,298783,69,372949
2460,0.055828,172.31.40.0-255,66,298849,69,372949
2461,0.058263,74.125.200.0-255,5738,304587,69,372949
2462,0.058271,172.31.40.0-255,66,304653,69,372949
2463,0.060697,74.125.200.0-255,5738,310391,69,372949
2464,0.060708,172.31.40.0-255,66,310457,69,372949
2465,0.063126,74.125.200.0-255,5738,316195,69,372949
2466,0.063132,172.31.40.0-255,66,316261,69,372949
2467,0.065572,74.125.200.0-255,5738,321999,69,372949
2468,0.065579,172.31.40.0-255,66,322065,69,372949
2469,0.06801,74.125.200.0-255,5738,327803,69,372949
2470,0.068015,172.31.40.0-255,66,327869,69,372949
2471,0.07044,74.125.200.0-255,4320,332189,69,372949
2472,0.070447,172.31.40.0-255,66,332255,69,372949
2473,0.070479,74.125.200.0-255,1484,333739,69,372949
2474,0.072892,74.125.200.0-255,4320,338059,69,372949
2475,0.072899,172.31.40.0-255,66,338125,69,372949
2476,0.075377,74.125.200.0-255,5738,343863,69,372949
2477,0.075384,172.31.40.0-255,66,343929,69,372949
2478,0.07781,74.125.200.0-255,5738,349667,69,372949
2479,0.077817,172.31.40.0-255,66,349733,69,372949
2480,0.080278,74.125.200.0-255,5738,355471,69,372949
2481,0.080286,172.31.40.0-255,66,355537,69,372949
2482,0.082713,74.125.200.0-255,5738,361275,69,372949
2483,0.08272,172.31.40.0-255,66,361341,69,372949
2484,0.085137,74.125.200.0-255,5738,367079,69,372949
2485,0.085145,172.31.40.0-255,66,367145,69,372949
2486,0.087576,74.125.200.0-255,5738,372883,69,372949
2487,0.087583,172.31.40.0-255,66,372949,69,372949
2488,0.0,172.217.194.0-255,152,152,69,287130
2489,2.2e-05,172.31.40.0-255,66,218,69,287130
2490,2.9e-05,172.217.194.0-255,1484,1702,69,287130
2491,3.3e-05,172.31.40.0-255,66,1768,69,287130
2492,4.9e-05,172.217.194.0-255,2902,4670,69,287130
2493,5.3e-05,172.31.40.0-255,66,4736,69,287130
2494,6e-05,172.217.194.0-255,7156,11892,69,287130
2495,6.3e-05,172.31.40.0-255,66,11958,69,287130
2496,0.00011,172.31.40.0-255,66,12024,69,287130
2497,0.000127,172.31.40.0-255,66,12090,69,287130
2498,0.000185,172.217.194.0-255,1484,13574,69,287130
2499,0.000188,172.31.40.0-255,66,13640,69,287130
2500,0.000218,172.217.194.0-255,2902,16542,69,287130
2501,0.000221,172.31.40.0-255,66,16608,69,287130
2502,0.000225,172.217.194.0-255,1484,18092,69,287130
2503,0.000227,172.31.40.0-255,66,18158,69,287130
2504,0.000247,172.217.194.0-255,4320,22478,69,287130
2505,0.000254,172.31.40.0-255,66,22544,69,287130
2506,0.000258,172.217.194.0-255,1484,24028,69,287130
2507,0.00026,172.31.40.0-255,66,24094,69,287130
2508,0.000277,172.217.194.0-255,5379,29473,69,287130
2509,0.00028,172.31.40.0-255,66,29539,69,287130
2510,0.000344,172.217.194.0-255,1484,31023,69,287130
2511,0.000348,172.31.40.0-255,66,31089,69,287130
2512,0.000353,172.217.194.0-255,2902,33991,69,287130
2513,0.000355,172.31.40.0-255,66,34057,69,287130
2514,0.000358,172.217.194.0-255,1484,35541,69,287130
2515,0.00036,172.31.40.0-255,66,35607,69,287130
2516,0.000396,172.217.194.0-255,4320,39927,69,287130
2517,0.000399,172.31.40.0-255,66,39993,69,287130
2518,0.000402,172.217.194.0-255,1484,41477,69,287130
2519,0.000425,172.217.194.0-255,5671,47148,69,287130
2520,0.000428,172.31.40.0-255,66,47214,69,287130
2521,0.000865,172.217.194.0-255,385,47599,69,287130
2522,0.00092,172.217.194.0-255,1484,49083,69,287130
2523,0.000925,172.31.40.0-255,66,49149,69,287130
2524,0.00093,172.217.194.0-255,2902,52051,69,287130
2525,0.000932,172.31.40.0-255,66,52117,69,287130
2526,0.000935,172.217.194.0-255,1484,53601,69,287130
2527,0.000957,172.217.194.0-255,4320,57921,69,287130
2528,0.000961,172.217.194.0-255,2902,60823,69,287130
2529,0.000971,172.31.40.0-255,66,60889,69,287130
2530,0.000974,172.31.40.0-255,66,60955,69,287130
2531,0.000999,172.31.40.0-255,66,61021,69,287130
2532,0.001032,172.31.40.0-255,66,61087,69,287130
2533,0.003319,172.217.194.0-255,5738,66825,69,287130
2534,0.003327,172.31.40.0-255,66,66891,69,287130
2535,0.005629,172.217.194.0-255,5738,72629,69,287130
2536,0.005636,172.31.40.0-255,66,72695,69,287130
2537,0.007945,172.217.194.0-255,5738,78433,69,287130
2538,0.007952,172.31.40.0-255,66,78499,69,287130
2539,0.010247,172.217.194.0-255,5738,84237,69,287130
2540,0.010255,172.31.40.0-255,66,84303,69,287130
2541,0.012554,172.217.194.0-255,5738,90041,69,287130
2542,0.012562,172.31.40.0-255,66,90107,69,287130
2543,0.014835,172.217.194.0-255,5738,95845,69,287130
2544,0.014842,172.31.40.0-255,66,95911,69,287130
2545,0.017132,172.217.194.0-255,5738,101649,69,287130
2546,0.017138,172.31.40.0-255,66,101715,69,287130
2547,0.019428,172.217.194.0-255,5738,107453,69,287130
2548,0.019434,172.31.40.0-255,66,107519,69,287130
2549,0.021732,172.217.194.0-255,5738,113257,69,287130
2550,0.021739,172.31.40.0-255,66,113323,69,287130
2551,0.024031,172.217.194.0-255,5738,119061,69,287130
2552,0.024038,172.31.40.0-255,66,119127,69,287130
2553,0.024241,172.31.40.0-255,172,119299,69,287130
2554,0.024269,172.31.40.0-255,1111,120410,69,287130
2555,0.02439,172.31.40.0-255,1514,121924,69,287130
2556,0.024392,172.31.40.0-255,1514,123438,69,287130
2557,0.024394,172.31.40.0-255,1514,124952,69,287130
2558,0.024395,172.31.40.0-255,1514,126466,69,287130
2559,0.024396,172.31.40.0-255,547,127013,69,287130
2560,0.02581,104.244.42.0-255,66,127079,69,287130
2561,0.025873,104.244.42.0-255,66,127145,69,287130
2562,0.026047,104.244.42.0-255,66,127211,69,287130
2563,0.026102,104.244.42.0-255,66,127277,69,287130
2564,0.026351,172.217.194.0-255,5738,133015,69,287130
2565,0.026357,172.31.40.0-255,66,133081,69,287130
2566,0.026778,104.244.42.0-255,108,133189,69,287130
2567,0.026787,172.31.40.0-255,66,133255,69,287130
2568,0.028652,172.217.194.0-255,4320,137575,69,287130
2569,0.028658,172.31.40.0-255,66,137641,69,287130
2570,0.028685,172.217.194.0-255,1484,139125,69,287130
2571,0.030945,172.217.194.0-255,2902,142027,69,287130
2572,0.030951,172.31.40.0-255,66,142093,69,287130
2573,0.033244,172.217.194.0-255,5738,147831,69,287130
2574,0.033251,172.31.40.0-255,66,147897,69,287130
2575,0.035533,172.217.194.0-255,5738,153635,69,287130
2576,0.03554,172.31.40.0-255,66,153701,69,287130
2577,0.037837,172.217.194.0-255,5738,159439,69,287130
2578,0.037844,172.31.40.0-255,66,159505,69,287130
2579,0.040134,172.217.194.0-255,5738,165243,69,287130
2580,0.040141,172.31.40.0-255,66,165309,69,287130
2581,0.042427,172.217.194.0-255,5738,171047,69,287130
2582,0.042434,172.31.40.0-255,66,171113,69,287130
2583,0.044708,172.217.194.0-255,4320,175433,69,287130
2584,0.044715,172.31.40.0-255,66,175499,69,287130
2585,0.044745,172.217.194.0-255,1484,176983,69,287130
2586,0.046996,172.217.194.0-255,4320,181303,69,287130
2587,0.047002,172.31.40.0-255,66,181369,69,287130
2588,0.049313,172.217.194.0-255,5738,187107,69,287130
2589,0.04932,172.31.40.0-255,66,187173,69,287130
2590,0.051617,172.217.194.0-255,5738,192911,69,287130
2591,0.051623,172.31.40.0-255,66,192977,69,287130
2592,0.053923,172.217.194.0-255,5738,198715,69,287130
2593,0.053929,172.31.40.0-255,66,198781,69,287130
2594,0.05624,172.217.194.0-255,5738,204519,69,287130
2595,0.056246,172.31.40.0-255,66,204585,69,287130
2596,0.058566,172.217.194.0-255,5738,210323,69,287130
2597,0.058573,172.31.40.0-255,66,210389,69,287130
2598,0.060873,172.217.194.0-255,5738,216127,69,287130
2599,0.060879,172.31.40.0-255,66,216193,69,287130
2600,0.063171,172.217.194.0-255,5738,221931,69,287130
2601,0.06319,172.31.40.0-255,66,221997,69,287130
2602,0.065524,172.217.194.0-255,5738,227735,69,287130
2603,0.065541,172.31.40.0-255,66,227801,69,287130
2604,0.067695,172.31.40.0-255,101,227902,69,287130
2605,0.067846,172.217.194.0-255,5738,233640,69,287130
2606,0.067855,172.31.40.0-255,66,233706,69,287130
2607,0.069964,172.217.194.0-255,66,233772,69,287130
2608,0.070145,172.217.194.0-255,2902,236674,69,287130
2609,0.07015,172.31.40.0-255,66,236740,69,287130
2610,0.070179,172.217.194.0-255,2902,239642,69,287130
2611,0.070183,172.31.40.0-255,66,239708,69,287130
2612,0.072464,172.217.194.0-255,2902,242610,69,287130
2613,0.07248,172.31.40.0-255,66,242676,69,287130
2614,0.072518,172.217.194.0-255,2902,245578,69,287130
2615,0.072521,172.31.40.0-255,66,245644,69,287130
2616,0.074756,172.217.194.0-255,2902,248546,69,287130
2617,0.074764,172.31.40.0-255,66,248612,69,287130
2618,0.074791,172.217.194.0-255,1484,250096,69,287130
2619,0.074809,172.217.194.0-255,1484,251580,69,287130
2620,0.074812,172.31.40.0-255,66,251646,69,287130
2621,0.077046,172.217.194.0-255,2902,254548,69,287130
2622,0.077053,172.31.40.0-255,66,254614,69,287130
2623,0.077092,172.217.194.0-255,2902,257516,69,287130
2624,0.077095,172.31.40.0-255,66,257582,69,287130
2625,0.079334,172.217.194.0-255,2902,260484,69,287130
2626,0.079341,172.31.40.0-255,66,260550,69,287130
2627,0.079381,172.217.194.0-255,1484,262034,69,287130
2628,0.079449,172.217.194.0-255,1484,263518,69,287130
2629,0.079452,172.31.40.0-255,66,263584,69,287130
2630,0.081643,172.217.194.0-255,2902,266486,69,287130
2631,0.08165,172.31.40.0-255,66,266552,69,287130
2632,0.081716,172.217.194.0-255,2902,269454,69,287130
2633,0.081721,172.31.40.0-255,66,269520,69,287130
2634,0.083983,172.217.194.0-255,2902,272422,69,287130
2635,0.083989,172.31.40.0-255,66,272488,69,287130
2636,0.084024,172.217.194.0-255,2902,275390,69,287130
2637,0.084027,172.31.40.0-255,66,275456,69,287130
2638,0.086322,172.217.194.0-255,1484,276940,69,287130
2639,0.086357,172.217.194.0-255,4320,281260,69,287130
2640,0.086362,172.31.40.0-255,66,281326,69,287130
2641,0.088644,172.217.194.0-255,5738,287064,69,287130
2642,0.08865,172.31.40.0-255,66,287130,69,287130
2643,0.0,74.125.24.0-255,153,153,69,341574
2644,2.1e-05,172.31.40.0-255,66,219,69,341574
2645,2.9e-05,74.125.24.0-255,1484,1703,69,341574
2646,3.3e-05,172.31.40.0-255,66,1769,69,341574
2647,3.9e-05,74.125.24.0-255,2902,4671,69,341574
2648,4.3e-05,172.31.40.0-255,66,4737,69,341574
2649,5e-05,74.125.24.0-255,7156,11893,69,341574
2650,5.5e-05,172.31.40.0-255,66,11959,69,341574
2651,5.9e-05,74.125.24.0-255,2054,14013,69,341574
2652,6.3e-05,172.31.40.0-255,66,14079,69,341574
2653,0.000387,74.125.24.0-255,1484,15563,69,341574
2654,0.000393,172.31.40.0-255,66,15629,69,341574
2655,0.0004,74.125.24.0-255,2902,18531,69,341574
2656,0.000403,172.31.40.0-255,66,18597,69,341574
2657,0.000406,74.125.24.0-255,1484,20081,69,341574
2658,0.000408,172.31.40.0-255,66,20147,69,341574
2659,0.00044,74.125.24.0-255,4320,24467,69,341574
2660,0.000444,172.31.40.0-255,66,24533,69,341574
2661,0.000467,74.125.24.0-255,2902,27435,69,341574
2662,0.00047,172.31.40.0-255,66,27501,69,341574
2663,0.000491,74.125.24.0-255,3961,31462,69,341574
2664,0.000494,172.31.40.0-255,66,31528,69,341574
2665,0.00051,74.125.24.0-255,1484,33012,69,341574
2666,0.000512,172.31.40.0-255,66,33078,69,341574
2667,0.000518,74.125.24.0-255,2902,35980,69,341574
2668,0.00052,172.31.40.0-255,66,36046,69,341574
2669,0.000525,74.125.24.0-255,4320,40366,69,341574
2670,0.000527,172.31.40.0-255,66,40432,69,341574
2671,0.000545,74.125.24.0-255,1484,41916,69,341574
2672,0.000547,172.31.40.0-255,66,41982,69,341574
2673,0.000553,74.125.24.0-255,5738,47720,69,341574
2674,0.000556,172.31.40.0-255,66,47786,69,341574
2675,0.000589,172.31.40.0-255,66,47852,69,341574
2676,0.000642,172.31.40.0-255,66,47918,69,341574
2677,0.000754,74.125.24.0-255,116,48034,69,341574
2678,0.000775,74.125.24.0-255,1484,49518,69,341574
2679,0.000778,172.31.40.0-255,66,49584,69,341574
2680,0.000782,74.125.24.0-255,1484,51068,69,341574
2681,0.000794,74.125.24.0-255,1484,52552,69,341574
2682,0.000796,172.31.40.0-255,66,52618,69,341574
2683,0.000834,74.125.24.0-255,7156,59774,69,341574
2684,0.000837,172.31.40.0-255,66,59840,69,341574
2685,0.000843,74.125.24.0-255,5379,65219,69,341574
2686,0.000845,172.31.40.0-255,66,65285,69,341574
2687,0.000865,74.125.24.0-255,1484,66769,69,341574
2688,0.000908,172.31.40.0-255,66,66835,69,341574
2689,0.00093,74.125.24.0-255,2543,69378,69,341574
2690,0.000932,172.31.40.0-255,66,69444,69,341574
2691,0.001881,74.125.24.0-255,1484,70928,69,341574
2692,0.001891,74.125.24.0-255,2902,73830,69,341574
2693,0.001895,172.31.40.0-255,66,73896,69,341574
2694,0.001901,74.125.24.0-255,2902,76798,69,341574
2695,0.001903,172.31.40.0-255,66,76864,69,341574
2696,0.001921,74.125.24.0-255,2902,79766,69,341574
2697,0.001923,172.31.40.0-255,66,79832,69,341574
2698,0.00193,74.125.24.0-255,7156,86988,69,341574
2699,0.001932,172.31.40.0-255,66,87054,69,341574
2700,0.001963,74.125.24.0-255,5738,92792,69,341574
2701,0.001966,172.31.40.0-255,66,92858,69,341574
2702,0.001976,172.31.40.0-255,66,92924,69,341574
2703,0.001997,74.125.24.0-255,766,93690,69,341574
2704,0.002001,74.125.24.0-255,2902,96592,69,341574
2705,0.002003,172.31.40.0-255,66,96658,69,341574
2706,0.00203,172.31.40.0-255,66,96724,69,341574
2707,0.002042,172.31.40.0-255,66,96790,69,341574
2708,0.002082,74.125.24.0-255,4320,101110,69,341574
2709,0.002084,172.31.40.0-255,66,101176,69,341574
2710,0.002101,74.125.24.0-255,2902,104078,69,341574
2711,0.002103,172.31.40.0-255,66,104144,69,341574
2712,0.002116,74.125.24.0-255,1484,105628,69,341574
2713,0.002127,74.125.24.0-255,2902,108530,69,341574
2714,0.002128,172.31.40.0-255,66,108596,69,341574
2715,0.002141,74.125.24.0-255,2902,111498,69,341574
2716,0.002143,172.31.40.0-255,66,111564,69,341574
2717,0.002161,74.125.24.0-255,2902,114466,69,341574
2718,0.002163,172.31.40.0-255,66,114532,69,341574
2719,0.002177,74.125.24.0-255,4320,118852,69,341574
2720,0.002179,172.31.40.0-255,66,118918,69,341574
2721,0.002194,74.125.24.0-255,2184,121102,69,341574
2722,0.002196,172.31.40.0-255,66,121168,69,341574
2723,0.002201,74.125.24.0-255,5738,126906,69,341574
2724,0.002203,172.31.40.0-255,66,126972,69,341574
2725,0.002254,74.125.24.0-255,1484,128456,69,341574
2726,0.002257,74.125.24.0-255,2902,131358,69,341574
2727,0.002263,74.125.24.0-255,5738,137096,69,341574
2728,0.002275,74.125.24.0-255,1484,138580,69,341574
2729,0.002288,74.125.24.0-255,2902,141482,69,341574
2730,0.002307,74.125.24.0-255,6438,147920,69,341574
2731,0.007267,172.31.40.0-255,66,147986,69,341574
2732,0.009658,74.125.24.0-255,5738,153724,69,341574
2733,0.009666,172.31.40.0-255,66,153790,69,341574
2734,0.012064,74.125.24.0-255,5738,159528,69,341574
2735,0.012072,172.31.40.0-255,66,159594,69,341574
2736,0.014503,74.125.24.0-255,5738,165332,69,341574
2737,0.014514,172.31.40.0-255,66,165398,69,341574
2738,0.01689,74.125.24.0-255,5738,171136,69,341574
2739,0.016897,172.31.40.0-255,66,171202,69,341574
2740,0.019318,74.125.24.0-255,5738,176940,69,341574
2741,0.019326,172.31.40.0-255,66,177006,69,341574
2742,0.021731,74.125.24.0-255,5738,182744,69,341574
2743,0.021739,172.31.40.0-255,66,182810,69,341574
2744,0.024162,74.125.24.0-255,5738,188548,69,341574
2745,0.024171,172.31.40.0-255,66,188614,69,341574
2746,0.026578,74.125.24.0-255,5738,194352,69,341574
2747,0.026586,172.31.40.0-255,66,194418,69,341574
2748,0.028951,74.125.24.0-255,5738,200156,69,341574
2749,0.028959,172.31.40.0-255,66,200222,69,341574
2750,0.031353,74.125.24.0-255,5738,205960,69,341574
2751,0.031362,172.31.40.0-255,66,206026,69,341574
2752,0.033757,74.125.24.0-255,5738,211764,69,341574
2753,0.033764,172.31.40.0-255,66,211830,69,341574
2754,0.034487,172.31.40.0-255,172,212002,69,341574
2755,0.034516,172.31.40.0-255,1112,213114,69,341574
2756,0.034586,172.31.40.0-255,1514,214628,69,341574
2757,0.034588,172.31.40.0-255,1514,216142,69,341574
2758,0.034589,172.31.40.0-255,1514,217656,69,341574
2759,0.034594,172.31.40.0-255,1514,219170,69,341574
2760,0.034596,172.31.40.0-255,1503,220673,69,341574
2761,0.036133,74.125.24.0-255,5738,226411,69,341574
2762,0.03614,172.31.40.0-255,66,226477,69,341574
2763,0.036164,104.244.42.0-255,66,226543,69,341574
2764,0.036229,104.244.42.0-255,66,226609,69,341574
2765,0.036359,104.244.42.0-255,66,226675,69,341574
2766,0.038516,74.125.24.0-255,5738,232413,69,341574
2767,0.038524,172.31.40.0-255,66,232479,69,341574
2768,0.040923,74.125.24.0-255,5738,238217,69,341574
2769,0.040932,172.31.40.0-255,66,238283,69,341574
2770,0.043389,74.125.24.0-255,5738,244021,69,341574
2771,0.043397,172.31.40.0-255,66,244087,69,341574
2772,0.045776,74.125.24.0-255,5738,249825,69,341574
2773,0.045782,172.31.40.0-255,66,249891,69,341574
2774,0.048162,74.125.24.0-255,5738,255629,69,341574
2775,0.048167,172.31.40.0-255,66,255695,69,341574
2776,0.050545,74.125.24.0-255,5738,261433,69,341574
2777,0.050552,172.31.40.0-255,66,261499,69,341574
2778,0.052981,74.125.24.0-255,5738,267237,69,341574
2779,0.052988,172.31.40.0-255,66,267303,69,341574
2780,0.055428,74.125.24.0-255,5738,273041,69,341574
2781,0.055435,172.31.40.0-255,66,273107,69,341574
2782,0.057836,74.125.24.0-255,5738,278845,69,341574
2783,0.057842,172.31.40.0-255,66,278911,69,341574
2784,0.060227,74.125.24.0-255,5738,284649,69,341574
2785,0.060234,172.31.40.0-255,66,284715,69,341574
2786,0.062623,74.125.24.0-255,5738,290453,69,341574
2787,0.062628,172.31.40.0-255,66,290519,69,341574
2788,0.065046,74.125.24.0-255,5738,296257,69,341574
2789,0.065052,172.31.40.0-255,66,296323,69,341574
2790,0.067453,74.125.24.0-255,5738,302061,69,341574
2791,0.067459,172.31.40.0-255,66,302127,69,341574
2792,0.069861,74.125.24.0-255,5738,307865,69,341574
2793,0.069868,172.31.40.0-255,66,307931,69,341574
2794,0.072265,74.125.24.0-255,5738,313669,69,341574
2795,0.072271,172.31.40.0-255,66,313735,69,341574
2796,0.074674,74.125.24.0-255,4320,318055,69,341574
2797,0.07468,172.31.40.0-255,66,318121,69,341574
2798,0.074699,74.125.24.0-255,1484,319605,69,341574
2799,0.077076,74.125.24.0-255,4320,323925,69,341574
2800,0.077082,172.31.40.0-255,66,323991,69,341574
2801,0.079465,74.125.24.0-255,5738,329729,69,341574
2802,0.079472,172.31.40.0-255,66,329795,69,341574
2803,0.081854,74.125.24.0-255,5738,335533,69,341574
2804,0.08186,172.31.40.0-255,66,335599,69,341574
2805,0.084261,74.125.24.0-255,5738,341337,69,341574
2806,0.084267,172.31.40.0-255,66,341403,69,341574
2807,0.084451,172.31.40.0-255,105,341508,69,341574
2808,0.086822,74.125.24.0-255,66,341574,69,341574
2809,0.0,172.217.194.0-255,151,151,69,272291
2810,2.4e-05,172.31.40.0-255,66,217,69,272291
2811,3.2e-05,172.217.194.0-255,1484,1701,69,272291
2812,3.6e-05,172.31.40.0-255,66,1767,69,272291
2813,4.2e-05,172.217.194.0-255,2902,4669,69,272291
2814,4.5e-05,172.31.40.0-255,66,4735,69,272291
2815,5.1e-05,172.217.194.0-255,4320,9055,69,272291
2816,5.4e-05,172.31.40.0-255,66,9121,69,272291
2817,7.5e-05,172.217.194.0-255,4320,13441,69,272291
2818,7.8e-05,172.31.40.0-255,66,13507,69,272291
2819,9.4e-05,172.217.194.0-255,657,14164,69,272291
2820,9.6e-05,172.31.40.0-255,66,14230,69,272291
2821,0.000119,172.217.194.0-255,1484,15714,69,272291
2822,0.000121,172.31.40.0-255,66,15780,69,272291
2823,0.000147,172.217.194.0-255,4320,20100,69,272291
2824,0.000149,172.31.40.0-255,66,20166,69,272291
2825,0.000152,172.217.194.0-255,1484,21650,69,272291
2826,0.000154,172.31.40.0-255,66,21716,69,272291
2827,0.000165,172.31.40.0-255,66,21782,69,272291
2828,0.000168,172.217.194.0-255,1125,22907,69,272291
2829,0.00017,172.31.40.0-255,66,22973,69,272291
2830,0.000264,172.217.194.0-255,1484,24457,69,272291
2831,0.000269,172.31.40.0-255,66,24523,69,272291
2832,0.000291,172.217.194.0-255,2902,27425,69,272291
2833,0.000294,172.31.40.0-255,66,27491,69,272291
2834,0.0003,172.217.194.0-255,5738,33229,69,272291
2835,0.000302,172.31.40.0-255,66,33295,69,272291
2836,0.000342,172.217.194.0-255,6797,40092,69,272291
2837,0.000346,172.31.40.0-255,66,40158,69,272291
2838,0.000512,172.217.194.0-255,1484,41642,69,272291
2839,0.000517,172.31.40.0-255,66,41708,69,272291
2840,0.000523,172.217.194.0-255,2902,44610,69,272291
2841,0.000525,172.31.40.0-255,66,44676,69,272291
2842,0.000532,172.217.194.0-255,5738,50414,69,272291
2843,0.000535,172.31.40.0-255,66,50480,69,272291
2844,0.000538,172.217.194.0-255,1484,51964,69,272291
2845,0.000568,172.217.194.0-255,4320,56284,69,272291
2846,0.000571,172.31.40.0-255,66,56350,69,272291
2847,0.0006,172.217.194.0-255,1706,58056,69,272291
2848,0.000603,172.31.40.0-255,66,58122,69,272291
2849,0.001688,172.217.194.0-255,1484,59606,69,272291
2850,0.001701,172.217.194.0-255,2902,62508,69,272291
2851,0.001705,172.31.40.0-255,66,62574,69,272291
2852,0.001714,172.217.194.0-255,5738,68312,69,272291
2853,0.001716,172.31.40.0-255,66,68378,69,272291
2854,0.001729,172.217.194.0-255,1484,69862,69,272291
2855,0.001772,172.31.40.0-255,66,69928,69,272291
2856,0.001775,172.217.194.0-255,1484,71412,69,272291
2857,0.001796,172.31.40.0-255,66,71478,69,272291
2858,0.004354,172.217.194.0-255,5738,77216,69,272291
2859,0.004359,172.31.40.0-255,66,77282,69,272291
2860,0.006995,172.217.194.0-255,5738,83020,69,272291
2861,0.007004,172.31.40.0-255,66,83086,69,272291
2862,0.009606,172.217.194.0-255,5738,88824,69,272291
2863,0.009618,172.31.40.0-255,66,88890,69,272291
2864,0.012218,172.217.194.0-255,5738,94628,69,272291
2865,0.012232,172.31.40.0-255,66,94694,69,272291
2866,0.014796,172.217.194.0-255,5738,100432,69,272291
2867,0.014813,172.31.40.0-255,66,100498,69,272291
2868,0.017395,172.217.194.0-255,5738,106236,69,272291
2869,0.017409,172.31.40.0-255,66,106302,69,272291
2870,0.020013,172.217.194.0-255,5738,112040,69,272291
2871,0.020029,172.31.40.0-255,66,112106,69,272291
2872,0.022628,172.217.194.0-255,5738,117844,69,272291
2873,0.022643,172.31.40.0-255,66,117910,69,272291
2874,0.025207,172.217.194.0-255,5738,123648,69,272291
2875,0.025219,172.31.40.0-255,66,123714,69,272291
2876,0.0278,172.217.194.0-255,5738,129452,69,272291
2877,0.02781,172.31.40.0-255,66,129518,69,272291
2878,0.03044,172.217.194.0-255,5738,135256,69,272291
2879,0.03045,172.31.40.0-255,66,135322,69,272291
2880,0.033024,172.217.194.0-255,5738,141060,69,272291
2881,0.033029,172.31.40.0-255,66,141126,69,272291
2882,0.033389,172.31.40.0-255,172,141298,69,272291
2883,0.033419,172.31.40.0-255,1116,142414,69,272291
2884,0.033486,172.31.40.0-255,1514,143928,69,272291
2885,0.033488,172.31.40.0-255,1514,145442,69,272291
2886,0.033489,172.31.40.0-255,1514,146956,69,272291
2887,0.03349,172.31.40.0-255,1514,148470,69,272291
2888,0.03352,172.31.40.0-255,1499,149969,69,272291
2889,0.034964,104.244.42.0-255,66,150035,69,272291
2890,0.035003,104.244.42.0-255,66,150101,69,272291
2891,0.035106,104.244.42.0-255,66,150167,69,272291
2892,0.035154,104.244.42.0-255,66,150233,69,272291
2893,0.035604,172.217.194.0-255,5738,155971,69,272291
2894,0.035611,172.31.40.0-255,66,156037,69,272291
2895,0.036097,104.244.42.0-255,108,156145,69,272291
2896,0.036104,172.31.40.0-255,66,156211,69,272291
2897,0.038231,172.217.194.0-255,5738,161949,69,272291
2898,0.038238,172.31.40.0-255,66,162015,69,272291
2899,0.040836,172.217.194.0-255,5738,167753,69,272291
2900,0.040853,172.31.40.0-255,66,167819,69,272291
2901,0.043425,172.217.194.0-255,5738,173557,69,272291
2902,0.043432,172.31.40.0-255,66,173623,69,272291
2903,0.045987,172.217.194.0-255,5738,179361,69,272291
2904,0.045994,172.31.40.0-255,66,179427,69,272291
2905,0.048566,172.217.194.0-255,5738,185165,69,272291
2906,0.048573,172.31.40.0-255,66,185231,69,272291
2907,0.051122,172.217.194.0-255,5738,190969,69,272291
2908,0.051129,172.31.40.0-255,66,191035,69,272291
2909,0.053715,172.217.194.0-255,5738,196773,69,272291
2910,0.053722,172.31.40.0-255,66,196839,69,272291
2911,0.056287,172.217.194.0-255,5738,202577,69,272291
2912,0.056296,172.31.40.0-255,66,202643,69,272291
2913,0.058911,172.217.194.0-255,5738,208381,69,272291
2914,0.058921,172.31.40.0-255,66,208447,69,272291
2915,0.061513,172.217.194.0-255,5738,214185,69,272291
2916,0.061521,172.31.40.0-255,66,214251,69,272291
2917,0.064099,172.217.194.0-255,5738,219989,69,272291
2918,0.064106,172.31.40.0-255,66,220055,69,272291
2919,0.066689,172.217.194.0-255,5738,225793,69,272291
2920,0.066698,172.31.40.0-255,66,225859,69,272291
2921,0.069263,172.217.194.0-255,5738,231597,69,272291
2922,0.069273,172.31.40.0-255,66,231663,69,272291
2923,0.071892,172.217.194.0-255,5738,237401,69,272291
2924,0.071904,172.31.40.0-255,66,237467,69,272291
2925,0.074495,172.217.194.0-255,5738,243205,69,272291
2926,0.074512,172.31.40.0-255,66,243271,69,272291
2927,0.077083,172.217.194.0-255,5738,249009,69,272291
2928,0.077091,172.31.40.0-255,66,249075,69,272291
2929,0.07971,172.217.194.0-255,5738,254813,69,272291
2930,0.079718,172.31.40.0-255,66,254879,69,272291
2931,0.082287,172.217.194.0-255,5738,260617,69,272291
2932,0.082299,172.31.40.0-255,66,260683,69,272291
2933,0.084859,172.217.194.0-255,5738,266421,69,272291
2934,0.084868,172.31.40.0-255,66,266487,69,272291
2935,0.087433,172.217.194.0-255,5738,272225,69,272291
2936,0.087441,172.31.40.0-255,66,272291,69,272291
2937,0.0,74.125.24.0-255,153,153,69,318655
2938,2.6e-05,172.31.40.0-255,66,219,69,318655
2939,3.3e-05,74.125.24.0-255,1484,1703,69,318655
2940,3.8e-05,172.31.40.0-255,66,1769,69,318655
2941,5.2e-05,74.125.24.0-255,2902,4671,69,318655
2942,5.6e-05,172.31.40.0-255,66,4737,69,318655
2943,6.1e-05,74.125.24.0-255,2902,7639,69,318655
2944,6.3e-05,172.31.40.0-255,66,7705,69,318655
2945,8.7e-05,74.125.24.0-255,6307,14012,69,318655
2946,9.4e-05,172.31.40.0-255,66,14078,69,318655
2947,0.00023,74.125.24.0-255,1484,15562,69,318655
2948,0.000234,172.31.40.0-255,66,15628,69,318655
2949,0.00024,74.125.24.0-255,2902,18530,69,318655
2950,0.000242,172.31.40.0-255,66,18596,69,318655
2951,0.000249,74.125.24.0-255,5738,24334,69,318655
2952,0.000256,172.31.40.0-255,66,24400,69,318655
2953,0.000294,74.125.24.0-255,6797,31197,69,318655
2954,0.000296,172.31.40.0-255,66,31263,69,318655
2955,0.00044,74.125.24.0-255,1484,32747,69,318655
2956,0.000444,172.31.40.0-255,66,32813,69,318655
2957,0.00045,74.125.24.0-255,2902,35715,69,318655
2958,0.000452,172.31.40.0-255,66,35781,69,318655
2959,0.000456,74.125.24.0-255,2902,38683,69,318655
2960,0.000464,172.31.40.0-255,66,38749,69,318655
2961,0.000506,74.125.24.0-255,2902,41651,69,318655
2962,0.000509,172.31.40.0-255,66,41717,69,318655
2963,0.000526,172.31.40.0-255,66,41783,69,318655
2964,0.000538,172.31.40.0-255,66,41849,69,318655
2965,0.000543,74.125.24.0-255,3961,45810,69,318655
2966,0.000545,172.31.40.0-255,66,45876,69,318655
2967,0.000926,74.125.24.0-255,646,46522,69,318655
2968,0.00108,172.31.40.0-255,66,46588,69,318655
2969,0.001113,74.125.24.0-255,1484,48072,69,318655
2970,0.001129,74.125.24.0-255,2902,50974,69,318655
2971,0.001132,172.31.40.0-255,66,51040,69,318655
2972,0.001167,74.125.24.0-255,5738,56778,69,318655
2973,0.001169,172.31.40.0-255,66,56844,69,318655
2974,0.001175,74.125.24.0-255,5738,62582,69,318655
2975,0.001177,172.31.40.0-255,66,62648,69,318655
2976,0.001194,172.31.40.0-255,66,62714,69,318655
2977,0.0012,74.125.24.0-255,5020,67734,69,318655
2978,0.001202,172.31.40.0-255,66,67800,69,318655
2979,0.001755,74.125.24.0-255,1484,69284,69,318655
2980,0.001765,74.125.24.0-255,2902,72186,69,318655
2981,0.001769,172.31.40.0-255,66,72252,69,318655
2982,0.001777,74.125.24.0-255,5738,77990,69,318655
2983,0.001779,172.31.40.0-255,66,78056,69,318655
2984,0.001822,172.31.40.0-255,66,78122,69,318655
2985,0.001829,74.125.24.0-255,7156,85278,69,318655
2986,0.001831,172.31.40.0-255,66,85344,69,318655
2987,0.001863,74.125.24.0-255,3602,88946,69,318655
2988,0.001866,172.31.40.0-255,66,89012,69,318655
2989,0.00206,74.125.24.0-255,1484,90496,69,318655
2990,0.002067,74.125.24.0-255,2902,93398,69,318655
2991,0.002071,172.31.40.0-255,66,93464,69,318655
2992,0.002076,74.125.24.0-255,2902,96366,69,318655
2993,0.002079,172.31.40.0-255,66,96432,69,318655
2994,0.002102,74.125.24.0-255,2902,99334,69,318655
2995,0.002109,172.31.40.0-255,66,99400,69,318655
2996,0.002123,172.31.40.0-255,66,99466,69,318655
2997,0.00213,74.125.24.0-255,5738,105204,69,318655
2998,0.002132,172.31.40.0-255,66,105270,69,318655
2999,0.002165,74.125.24.0-255,4320,109590,69,318655
3000,0.002167,172.31.40.0-255,66,109656,69,318655
3001,0.00217,74.125.24.0-255,766,110422,69,318655
3002,0.004615,74.125.24.0-255,4320,114742,69,318655
3003,0.004623,172.31.40.0-255,66,114808,69,318655
3004,0.007078,74.125.24.0-255,5738,120546,69,318655
3005,0.007085,172.31.40.0-255,66,120612,69,318655
3006,0.009551,74.125.24.0-255,5738,126350,69,318655
3007,0.00956,172.31.40.0-255,66,126416,69,318655
3008,0.012008,74.125.24.0-255,5738,132154,69,318655
3009,0.012019,172.31.40.0-255,66,132220,69,318655
3010,0.01449,74.125.24.0-255,5738,137958,69,318655
3011,0.014504,172.31.40.0-255,66,138024,69,318655
3012,0.016948,74.125.24.0-255,5738,143762,69,318655
3013,0.016965,172.31.40.0-255,66,143828,69,318655
3014,0.019423,74.125.24.0-255,5738,149566,69,318655
3015,0.019433,172.31.40.0-255,66,149632,69,318655
3016,0.021898,74.125.24.0-255,5738,155370,69,318655
3017,0.021908,172.31.40.0-255,66,155436,69,318655
3018,0.024337,74.125.24.0-255,5738,161174,69,318655
3019,0.024345,172.31.40.0-255,66,161240,69,318655
3020,0.026828,74.125.24.0-255,5738,166978,69,318655
3021,0.026839,172.31.40.0-255,66,167044,69,318655
3022,0.029288,74.125.24.0-255,5738,172782,69,318655
3023,0.029298,172.31.40.0-255,66,172848,69,318655
3024,0.031748,74.125.24.0-255,5738,178586,69,318655
3025,0.03176,172.31.40.0-255,66,178652,69,318655
3026,0.033228,172.31.40.0-255,172,178824,69,318655
3027,0.033261,172.31.40.0-255,1112,179936,69,318655
3028,0.033326,172.31.40.0-255,1514,181450,69,318655
3029,0.033327,172.31.40.0-255,1514,182964,69,318655
3030,0.033329,172.31.40.0-255,1514,184478,69,318655
3031,0.033334,172.31.40.0-255,1514,185992,69,318655
3032,0.033335,172.31.40.0-255,1503,187495,69,318655
3033,0.034226,74.125.24.0-255,5738,193233,69,318655
3034,0.034234,172.31.40.0-255,66,193299,69,318655
3035,0.034876,104.244.42.0-255,66,193365,69,318655
3036,0.034923,104.244.42.0-255,66,193431,69,318655
3037,0.03502,104.244.42.0-255,66,193497,69,318655
3038,0.035667,104.244.42.0-255,108,193605,69,318655
3039,0.035677,172.31.40.0-255,66,193671,69,318655
3040,0.03669,74.125.24.0-255,5738,199409,69,318655
3041,0.036696,172.31.40.0-255,66,199475,69,318655
3042,0.039174,74.125.24.0-255,5738,205213,69,318655
3043,0.039184,172.31.40.0-255,66,205279,69,318655
3044,0.041622,74.125.24.0-255,5738,211017,69,318655
3045,0.041631,172.31.40.0-255,66,211083,69,318655
3046,0.044087,74.125.24.0-255,5738,216821,69,318655
3047,0.044094,172.31.40.0-255,66,216887,69,318655
3048,0.046566,74.125.24.0-255,5738,222625,69,318655
3049,0.046578,172.31.40.0-255,66,222691,69,318655
3050,0.04909,74.125.24.0-255,5738,228429,69,318655
3051,0.049097,172.31.40.0-255,66,228495,69,318655
3052,0.05155,74.125.24.0-255,5738,234233,69,318655
3053,0.051556,172.31.40.0-255,66,234299,69,318655
3054,0.054003,74.125.24.0-255,5738,240037,69,318655
3055,0.054012,172.31.40.0-255,66,240103,69,318655
3056,0.05644,74.125.24.0-255,5738,245841,69,318655
3057,0.056447,172.31.40.0-255,66,245907,69,318655
3058,0.058886,74.125.24.0-255,5738,251645,69,318655
3059,0.058895,172.31.40.0-255,66,251711,69,318655
3060,0.061349,74.125.24.0-255,5738,257449,69,318655
3061,0.06136,172.31.40.0-255,66,257515,69,318655
3062,0.063816,74.125.24.0-255,5738,263253,69,318655
3063,0.063827,172.31.40.0-255,66,263319,69,318655
3064,0.066311,74.125.24.0-255,5738,269057,69,318655
3065,0.066326,172.31.40.0-255,66,269123,69,318655
3066,0.068807,74.125.24.0-255,5738,274861,69,318655
3067,0.068815,172.31.40.0-255,66,274927,69,318655
3068,0.071268,74.125.24.0-255,5738,280665,69,318655
3069,0.071276,172.31.40.0-255,66,280731,69,318655
3070,0.07375,74.125.24.0-255,5738,286469,69,318655
3071,0.073757,172.31.40.0-255,66,286535,69,318655
3072,0.076188,74.125.24.0-255,4320,290855,69,318655
3073,0.076195,172.31.40.0-255,66,290921,69,318655
3074,0.07622,74.125.24.0-255,1484,292405,69,318655
3075,0.078674,74.125.24.0-255,4320,296725,69,318655
3076,0.078682,172.31.40.0-255,66,296791,69,318655
3077,0.081144,74.125.24.0-255,5738,302529,69,318655
3078,0.081151,172.31.40.0-255,66,302595,69,318655
3079,0.083599,74.125.24.0-255,4320,306915,69,318655
3080,0.083609,172.31.40.0-255,66,306981,69,318655
3081,0.083637,74.125.24.0-255,1484,308465,69,318655
3082,0.086073,74.125.24.0-255,4320,312785,69,318655
3083,0.086084,172.31.40.0-255,66,312851,69,318655
3084,0.088541,74.125.24.0-255,5738,318589,69,318655
3085,0.088552,172.31.40.0-255,66,318655,69,318655
3086,0.0,74.125.24.0-255,152,152,69,256567
3087,2.4e-05,172.31.40.0-255,66,218,69,256567
3088,3.1e-05,74.125.24.0-255,1484,1702,69,256567
3089,3.6e-05,172.31.40.0-255,66,1768,69,256567
3090,4.2e-05,74.125.24.0-255,2902,4670,69,256567
3091,4.6e-05,172.31.40.0-255,66,4736,69,256567
3092,4.9e-05,74.125.24.0-255,1484,6220,69,256567
3093,5.1e-05,172.31.40.0-255,66,6286,69,256567
3094,8.9e-05,74.125.24.0-255,5738,12024,69,256567
3095,9.1e-05,172.31.40.0-255,66,12090,69,256567
3096,0.000112,74.125.24.0-255,2128,14218,69,256567
3097,0.000114,172.31.40.0-255,66,14284,69,256567
3098,0.000128,74.125.24.0-255,2902,17186,69,256567
3099,0.000131,172.31.40.0-255,66,17252,69,256567
3100,0.000151,74.125.24.0-255,5738,22990,69,256567
3101,0.000154,172.31.40.0-255,66,23056,69,256567
3102,0.00019,74.125.24.0-255,4320,27376,69,256567
3103,0.000193,172.31.40.0-255,66,27442,69,256567
3104,0.000213,74.125.24.0-255,3961,31403,69,256567
3105,0.000215,172.31.40.0-255,66,31469,69,256567
3106,0.000283,74.125.24.0-255,1484,32953,69,256567
3107,0.000287,172.31.40.0-255,66,33019,69,256567
3108,0.00029,74.125.24.0-255,1484,34503,69,256567
3109,0.000292,172.31.40.0-255,66,34569,69,256567
3110,0.000316,74.125.24.0-255,1484,36053,69,256567
3111,0.000318,172.31.40.0-255,66,36119,69,256567
3112,0.000324,74.125.24.0-255,5738,41857,69,256567
3113,0.000327,172.31.40.0-255,66,41923,69,256567
3114,0.000344,74.125.24.0-255,4320,46243,69,256567
3115,0.000347,172.31.40.0-255,66,46309,69,256567
3116,0.00038,172.31.40.0-255,66,46375,69,256567
3117,0.000396,74.125.24.0-255,5738,52113,69,256567
3118,0.000399,172.31.40.0-255,66,52179,69,256567
3119,0.000418,74.125.24.0-255,3961,56140,69,256567
3120,0.000421,172.31.40.0-255,66,56206,69,256567
3121,0.000456,74.125.24.0-255,414,56620,69,256567
3122,0.000522,74.125.24.0-255,331,56951,69,256567
3123,0.000768,74.125.24.0-255,1484,58435,69,256567
3124,0.000773,172.31.40.0-255,66,58501,69,256567
3125,0.00078,74.125.24.0-255,2902,61403,69,256567
3126,0.000783,172.31.40.0-255,66,61469,69,256567
3127,0.000786,74.125.24.0-255,1484,62953,69,256567
3128,0.000801,74.125.24.0-255,1484,64437,69,256567
3129,0.000803,172.31.40.0-255,66,64503,69,256567
3130,0.000806,74.125.24.0-255,1484,65987,69,256567
3131,0.000829,74.125.24.0-255,5738,71725,69,256567
3132,0.000835,172.31.40.0-255,66,71791,69,256567
3133,0.000862,172.31.40.0-255,66,71857,69,256567
3134,0.000881,74.125.24.0-255,2902,74759,69,256567
3135,0.000885,172.31.40.0-255,66,74825,69,256567
3136,0.000925,74.125.24.0-255,5020,79845,69,256567
3137,0.000929,172.31.40.0-255,66,79911,69,256567
3138,0.001063,74.125.24.0-255,1484,81395,69,256567
3139,0.001067,74.125.24.0-255,1484,82879,69,256567
3140,0.00107,172.31.40.0-255,66,82945,69,256567
3141,0.001092,74.125.24.0-255,1484,84429,69,256567
3142,0.001099,74.125.24.0-255,5738,90167,69,256567
3143,0.001102,172.31.40.0-255,66,90233,69,256567
3144,0.001108,74.125.24.0-255,2902,93135,69,256567
3145,0.00111,172.31.40.0-255,66,93201,69,256567
3146,0.001155,172.31.40.0-255,66,93267,69,256567
3147,0.001167,172.31.40.0-255,66,93333,69,256567
3148,0.001187,74.125.24.0-255,766,94099,69,256567
3149,0.001203,74.125.24.0-255,1484,95583,69,256567
3150,0.001205,172.31.40.0-255,66,95649,69,256567
3151,0.001241,74.125.24.0-255,4320,99969,69,256567
3152,0.001244,172.31.40.0-255,66,100035,69,256567
3153,0.001251,74.125.24.0-255,5738,105773,69,256567
3154,0.001253,172.31.40.0-255,66,105839,69,256567
3155,0.00129,74.125.24.0-255,5738,111577,69,256567
3156,0.001293,172.31.40.0-255,66,111643,69,256567
3157,0.001323,74.125.24.0-255,5738,117381,69,256567
3158,0.001326,172.31.40.0-255,66,117447,69,256567
3159,0.001338,172.31.40.0-255,66,117513,69,256567
3160,0.001341,74.125.24.0-255,766,118279,69,256567
3161,0.001364,74.125.24.0-255,1484,119763,69,256567
3162,0.001366,172.31.40.0-255,66,119829,69,256567
3163,0.001383,74.125.24.0-255,4320,124149,69,256567
3164,0.001385,172.31.40.0-255,66,124215,69,256567
3165,0.001425,172.31.40.0-255,66,124281,69,256567
3166,0.001431,74.125.24.0-255,5738,130019,69,256567
3167,0.001434,172.31.40.0-255,66,130085,69,256567
3168,0.001465,172.31.40.0-255,66,130151,69,256567
3169,0.001469,74.125.24.0-255,2184,132335,69,256567
3170,0.001471,172.31.40.0-255,66,132401,69,256567
3171,0.002009,74.125.24.0-255,1484,133885,69,256567
3172,0.002029,74.125.24.0-255,2902,136787,69,256567
3173,0.002033,172.31.40.0-255,66,136853,69,256567
3174,0.002039,74.125.24.0-255,4320,141173,69,256567
3175,0.002041,172.31.40.0-255,66,141239,69,256567
3176,0.002054,74.125.24.0-255,1484,142723,69,256567
3177,0.00207,74.125.24.0-255,5738,148461,69,256567
3178,0.002073,172.31.40.0-255,66,148527,69,256567
3179,0.002097,74.125.24.0-255,7156,155683,69,256567
3180,0.0021,172.31.40.0-255,66,155749,69,256567
3181,0.002112,172.31.40.0-255,66,155815,69,256567
3182,0.002114,74.125.24.0-255,766,156581,69,256567
3183,0.002142,74.125.24.0-255,1484,158065,69,256567
3184,0.002144,172.31.40.0-255,66,158131,69,256567
3185,0.00215,74.125.24.0-255,4320,162451,69,256567
3186,0.002153,172.31.40.0-255,66,162517,69,256567
3187,0.002204,172.31.40.0-255,66,162583,69,256567
3188,0.002212,74.125.24.0-255,7156,169739,69,256567
3189,0.002214,172.31.40.0-255,66,169805,69,256567
3190,0.002237,172.31.40.0-255,66,169871,69,256567
3191,0.002241,74.125.24.0-255,2184,172055,69,256567
3192,0.002243,172.31.40.0-255,66,172121,69,256567
3193,0.00254,74.125.24.0-255,1484,173605,69,256567
3194,0.002568,74.125.24.0-255,2902,176507,69,256567
3195,0.002571,172.31.40.0-255,66,176573,69,256567
3196,0.002587,74.125.24.0-255,5738,182311,69,256567
3197,0.002589,172.31.40.0-255,66,182377,69,256567
3198,0.002624,172.31.40.0-255,66,182443,69,256567
3199,0.00263,74.125.24.0-255,5738,188181,69,256567
3200,0.002633,172.31.40.0-255,66,188247,69,256567
3201,0.002679,74.125.24.0-255,5020,193267,69,256567
3202,0.002682,172.31.40.0-255,66,193333,69,256567
3203,0.002768,74.125.24.0-255,1484,194817,69,256567
3204,0.002791,74.125.24.0-255,2902,197719,69,256567
3205,0.002794,172.31.40.0-255,66,197785,69,256567
3206,0.002801,74.125.24.0-255,5738,203523,69,256567
3207,0.002804,172.31.40.0-255,66,203589,69,256567
3208,0.002807,74.125.24.0-255,1484,205073,69,256567
3209,0.002834,74.125.24.0-255,5738,210811,69,256567
3210,0.002837,172.31.40.0-255,66,210877,69,256567
3211,0.002839,74.125.24.0-255,1484,212361,69,256567
3212,0.002851,172.31.40.0-255,66,212427,69,256567
3213,0.002856,74.125.24.0-255,4320,216747,69,256567
3214,0.002859,172.31.40.0-255,66,216813,69,256567
3215,0.002861,74.125.24.0-255,766,217579,69,256567
3216,0.002884,74.125.24.0-255,1484,219063,69,256567
3217,0.002886,172.31.40.0-255,66,219129,69,256567
3218,0.002902,74.125.24.0-255,4320,223449,69,256567
3219,0.002905,172.31.40.0-255,66,223515,69,256567
3220,0.002907,74.125.24.0-255,1484,224999,69,256567
3221,0.00291,74.125.24.0-255,1484,226483,69,256567
3222,0.002912,172.31.40.0-255,66,226549,69,256567
3223,0.002919,74.125.24.0-255,5738,232287,69,256567
3224,0.002921,172.31.40.0-255,66,232353,69,256567
3225,0.002961,74.125.24.0-255,2902,235255,69,256567
3226,0.002964,172.31.40.0-255,66,235321,69,256567
3227,0.002969,74.125.24.0-255,4320,239641,69,256567
3228,0.002972,172.31.40.0-255,66,239707,69,256567
3229,0.002984,172.31.40.0-255,66,239773,69,256567
3230,0.002987,74.125.24.0-255,766,240539,69,256567
3231,0.003033,172.31.40.0-255,66,240605,69,256567
3232,0.003044,172.31.40.0-255,66,240671,69,256567
3233,0.003062,74.125.24.0-255,1484,242155,69,256567
3234,0.003094,172.31.40.0-255,66,242221,69,256567
3235,0.003105,172.31.40.0-255,66,242287,69,256567
3236,0.003129,74.125.24.0-255,2902,245189,69,256567
3237,0.003132,172.31.40.0-255,66,245255,69,256567
3238,0.003136,74.125.24.0-255,1960,247215,69,256567
3239,0.003138,172.31.40.0-255,66,247281,69,256567
3240,0.003173,74.125.24.0-255,105,247386,69,256567
3241,0.003192,74.125.24.0-255,129,247515,69,256567
3242,0.013685,172.31.40.0-255,105,247620,69,256567
3243,0.013737,172.31.40.0-255,105,247725,69,256567
3244,0.013918,74.125.24.0-255,129,247854,69,256567
3245,0.01393,172.31.40.0-255,78,247932,69,256567
3246,0.01401,172.31.40.0-255,90,248022,69,256567
3247,0.014027,172.31.40.0-255,66,248088,69,256567
3248,0.016161,74.125.24.0-255,66,248154,69,256567
3249,0.016208,74.125.24.0-255,66,248220,69,256567
3250,0.016497,74.125.24.0-255,66,248286,69,256567
3251,0.016518,74.125.24.0-255,66,248352,69,256567
3252,0.016524,172.31.40.0-255,66,248418,69,256567
3253,0.037349,172.31.40.0-255,172,248590,69,256567
3254,0.037385,172.31.40.0-255,1111,249701,69,256567
3255,0.037453,172.31.40.0-255,1514,251215,69,256567
3256,0.037455,172.31.40.0-255,1514,252729,69,256567
3257,0.037457,172.31.40.0-255,1514,254243,69,256567
3258,0.037458,172.31.40.0-255,1514,255757,69,256567
3259,0.037459,172.31.40.0-255,546,256303,69,256567
3260,0.038902,104.244.42.0-255,66,256369,69,256567
3261,0.038978,104.244.42.0-255,66,256435,69,256567
3262,0.039045,104.244.42.0-255,66,256501,69,256567
3263,0.039068,104.244.42.0-255,66,256567,69,256567
3264,0.0,74.125.24.0-255,146,146,69,252328
3265,1.5e-05,172.31.40.0-255,66,212,69,252328
3266,2.2e-05,74.125.24.0-255,1484,1696,69,252328
3267,2.6e-05,172.31.40.0-255,66,1762,69,252328
3268,5.2e-05,74.125.24.0-255,2902,4664,69,252328
3269,5.9e-05,172.31.40.0-255,66,4730,69,252328
3270,0.000164,74.125.24.0-255,1484,6214,69,252328
3271,0.000167,172.31.40.0-255,66,6280,69,252328
3272,0.000196,74.125.24.0-255,5738,12018,69,252328
3273,0.0002,172.31.40.0-255,66,12084,69,252328
3274,0.000474,74.125.24.0-255,2075,14159,69,252328
3275,0.000478,172.31.40.0-255,66,14225,69,252328
3276,0.000566,74.125.24.0-255,5738,19963,69,252328
3277,0.00057,172.31.40.0-255,66,20029,69,252328
3278,0.000611,172.31.40.0-255,66,20095,69,252328
3279,0.001268,172.31.40.0-255,66,20161,69,252328
3280,0.001302,172.31.40.0-255,66,20227,69,252328
3281,0.002039,74.125.24.0-255,7156,27383,69,252328
3282,0.002045,172.31.40.0-255,66,27449,69,252328
3283,0.002085,172.31.40.0-255,66,27515,69,252328
3284,0.002783,74.125.24.0-255,1484,28999,69,252328
3285,0.002786,172.31.40.0-255,66,29065,69,252328
3286,0.002831,172.31.40.0-255,66,29131,69,252328
3287,0.003788,74.125.24.0-255,4320,33451,69,252328
3288,0.003791,172.31.40.0-255,66,33517,69,252328
3289,0.003805,74.125.24.0-255,7156,40673,69,252328
3290,0.003807,172.31.40.0-255,66,40739,69,252328
3291,0.005653,172.31.40.0-255,66,40805,69,252328
3292,0.008005,74.125.24.0-255,1484,42289,69,252328
3293,0.008026,74.125.24.0-255,4320,46609,69,252328
3294,0.008032,172.31.40.0-255,66,46675,69,252328
3295,0.01042,74.125.24.0-255,5738,52413,69,252328
3296,0.010429,172.31.40.0-255,66,52479,69,252328
3297,0.012821,74.125.24.0-255,5738,58217,69,252328
3298,0.012831,172.31.40.0-255,66,58283,69,252328
3299,0.015199,74.125.24.0-255,5738,64021,69,252328
3300,0.015208,172.31.40.0-255,66,64087,69,252328
3301,0.017568,74.125.24.0-255,5738,69825,69,252328
3302,0.017575,172.31.40.0-255,66,69891,69,252328
3303,0.019927,74.125.24.0-255,5738,75629,69,252328
3304,0.019934,172.31.40.0-255,66,75695,69,252328
3305,0.022296,74.125.24.0-255,5738,81433,69,252328
3306,0.022305,172.31.40.0-255,66,81499,69,252328
3307,0.024703,74.125.24.0-255,5738,87237,69,252328
3308,0.024711,172.31.40.0-255,66,87303,69,252328
3309,0.027086,74.125.24.0-255,5738,93041,69,252328
3310,0.027094,172.31.40.0-255,66,93107,69,252328
3311,0.028851,172.31.40.0-255,171,93278,69,252328
3312,0.028882,172.31.40.0-255,1140,94418,69,252328
3313,0.028948,172.31.40.0-255,1514,95932,69,252328
3314,0.02895,172.31.40.0-255,1514,97446,69,252328
3315,0.028955,172.31.40.0-255,1514,98960,69,252328
3316,0.028957,172.31.40.0-255,1514,100474,69,252328
3317,0.028977,172.31.40.0-255,322,100796,69,252328
3318,0.029469,74.125.24.0-255,5738,106534,69,252328
3319,0.029476,172.31.40.0-255,66,106600,69,252328
3320,0.030552,104.244.42.0-255,66,106666,69,252328
3321,0.030561,104.244.42.0-255,66,106732,69,252328
3322,0.030658,104.244.42.0-255,66,106798,69,252328
3323,0.030671,104.244.42.0-255,66,106864,69,252328
3324,0.032006,74.125.24.0-255,5738,112602,69,252328
3325,0.032013,172.31.40.0-255,66,112668,69,252328
3326,0.034421,74.125.24.0-255,4320,116988,69,252328
3327,0.034428,172.31.40.0-255,66,117054,69,252328
3328,0.034474,74.125.24.0-255,1484,118538,69,252328
3329,0.036812,74.125.24.0-255,4320,122858,69,252328
3330,0.036818,172.31.40.0-255,66,122924,69,252328
3331,0.039211,74.125.24.0-255,5738,128662,69,252328
3332,0.039261,172.31.40.0-255,66,128728,69,252328
3333,0.041653,74.125.24.0-255,5738,134466,69,252328
3334,0.041659,172.31.40.0-255,66,134532,69,252328
3335,0.044045,74.125.24.0-255,5738,140270,69,252328
3336,0.044052,172.31.40.0-255,66,140336,69,252328
3337,0.046486,74.125.24.0-255,5738,146074,69,252328
3338,0.046493,172.31.40.0-255,66,146140,69,252328
3339,0.048903,74.125.24.0-255,5738,151878,69,252328
3340,0.048909,172.31.40.0-255,66,151944,69,252328
3341,0.05136,74.125.24.0-255,5738,157682,69,252328
3342,0.051366,172.31.40.0-255,66,157748,69,252328
3343,0.053743,74.125.24.0-255,5738,163486,69,252328
3344,0.053751,172.31.40.0-255,66,163552,69,252328
3345,0.056163,74.125.24.0-255,5738,169290,69,252328
3346,0.056169,172.31.40.0-255,66,169356,69,252328
3347,0.05854,74.125.24.0-255,5738,175094,69,252328
3348,0.058546,172.31.40.0-255,66,175160,69,252328
3349,0.060905,74.125.24.0-255,5738,180898,69,252328
3350,0.060911,172.31.40.0-255,66,180964,69,252328
3351,0.063287,74.125.24.0-255,2902,183866,69,252328
3352,0.063294,172.31.40.0-255,66,183932,69,252328
3353,0.063324,74.125.24.0-255,2902,186834,69,252328
3354,0.063327,172.31.40.0-255,66,186900,69,252328
3355,0.065675,74.125.24.0-255,2902,189802,69,252328
3356,0.065682,172.31.40.0-255,66,189868,69,252328
3357,0.065714,74.125.24.0-255,2902,192770,69,252328
3358,0.065717,172.31.40.0-255,66,192836,69,252328
3359,0.06805,74.125.24.0-255,2902,195738,69,252328
3360,0.068056,172.31.40.0-255,66,195804,69,252328
3361,0.068091,74.125.24.0-255,2902,198706,69,252328
3362,0.068093,172.31.40.0-255,66,198772,69,252328
3363,0.070432,74.125.24.0-255,2902,201674,69,252328
3364,0.070437,172.31.40.0-255,66,201740,69,252328
3365,0.070481,74.125.24.0-255,2902,204642,69,252328
3366,0.070484,172.31.40.0-255,66,204708,69,252328
3367,0.072789,74.125.24.0-255,2902,207610,69,252328
3368,0.072796,172.31.40.0-255,66,207676,69,252328
3369,0.072864,74.125.24.0-255,2902,210578,69,252328
3370,0.072868,172.31.40.0-255,66,210644,69,252328
3371,0.075189,74.125.24.0-255,2902,213546,69,252328
3372,0.075194,172.31.40.0-255,66,213612,69,252328
3373,0.075228,74.125.24.0-255,2902,216514,69,252328
3374,0.075231,172.31.40.0-255,66,216580,69,252328
3375,0.07757,74.125.24.0-255,2902,219482,69,252328
3376,0.077577,172.31.40.0-255,66,219548,69,252328
3377,0.077629,74.125.24.0-255,2902,222450,69,252328
3378,0.077635,172.31.40.0-255,66,222516,69,252328
3379,0.07999,74.125.24.0-255,2902,225418,69,252328
3380,0.079995,172.31.40.0-255,66,225484,69,252328
3381,0.080019,74.125.24.0-255,1484,226968,69,252328
3382,0.080021,172.31.40.0-255,66,227034,69,252328
3383,0.080046,74.125.24.0-255,1484,228518,69,252328
3384,0.080048,172.31.40.0-255,66,228584,69,252328
3385,0.082367,74.125.24.0-255,2902,231486,69,252328
3386,0.082374,172.31.40.0-255,66,231552,69,252328
3387,0.082411,74.125.24.0-255,2902,234454,69,252328
3388,0.082414,172.31.40.0-255,66,234520,69,252328
3389,0.084756,74.125.24.0-255,2902,237422,69,252328
3390,0.084764,172.31.40.0-255,66,237488,69,252328
3391,0.084796,74.125.24.0-255,2902,240390,69,252328
3392,0.084799,172.31.40.0-255,66,240456,69,252328
3393,0.087564,74.125.24.0-255,2902,243358,69,252328
3394,0.087572,172.31.40.0-255,66,243424,69,252328
3395,0.087605,74.125.24.0-255,2902,246326,69,252328
3396,0.087608,172.31.40.0-255,66,246392,69,252328
3397,0.089961,74.125.24.0-255,2902,249294,69,252328
3398,0.089968,172.31.40.0-255,66,249360,69,252328
3399,0.089995,74.125.24.0-255,2902,252262,69,252328
3400,0.089998,172.31.40.0-255,66,252328,69,252328
3401,0.0,172.217.194.0-255,152,152,69,155543
3402,2.2e-05,172.31.40.0-255,66,218,69,155543
3403,3e-05,172.217.194.0-255,1484,1702,69,155543
3404,3.4e-05,172.31.40.0-255,66,1768,69,155543
3405,4.7e-05,172.217.194.0-255,2902,4670,69,155543
3406,5e-05,172.31.40.0-255,66,4736,69,155543
3407,5.9e-05,172.217.194.0-255,7156,11892,69,155543
3408,6.2e-05,172.31.40.0-255,66,11958,69,155543
3409,9e-05,172.31.40.0-255,66,12024,69,155543
3410,0.000131,172.217.194.0-255,5738,17762,69,155543
3411,0.000134,172.31.40.0-255,66,17828,69,155543
3412,0.000159,172.217.194.0-255,3961,21789,69,155543
3413,0.000162,172.31.40.0-255,66,21855,69,155543
3414,0.000165,172.217.194.0-255,1484,23339,69,155543
3415,0.000171,172.31.40.0-255,66,23405,69,155543
3416,0.000177,172.217.194.0-255,2902,26307,69,155543
3417,0.000179,172.31.40.0-255,66,26373,69,155543
3418,0.000182,172.217.194.0-255,1484,27857,69,155543
3419,0.000184,172.31.40.0-255,66,27923,69,155543
3420,0.00022,172.217.194.0-255,4320,32243,69,155543
3421,0.000223,172.31.40.0-255,66,32309,69,155543
3422,0.000237,172.31.40.0-255,66,32375,69,155543
3423,0.000255,172.31.40.0-255,66,32441,69,155543
3424,0.000274,172.217.194.0-255,364,32805,69,155543
3425,0.000276,172.31.40.0-255,66,32871,69,155543
3426,0.000482,172.217.194.0-255,1484,34355,69,155543
3427,0.000488,172.31.40.0-255,66,34421,69,155543
3428,0.000495,172.217.194.0-255,2902,37323,69,155543
3429,0.000498,172.31.40.0-255,66,37389,69,155543
3430,0.000507,172.217.194.0-255,2902,40291,69,155543
3431,0.00051,172.31.40.0-255,66,40357,69,155543
3432,0.000556,172.217.194.0-255,2902,43259,69,155543
3433,0.000559,172.31.40.0-255,66,43325,69,155543
3434,0.000578,172.31.40.0-255,66,43391,69,155543
3435,0.000591,172.31.40.0-255,66,43457,69,155543
3436,0.00097,172.31.40.0-255,101,43558,69,155543
3437,0.001148,172.217.194.0-255,1484,45042,69,155543
3438,0.001154,172.217.194.0-255,1484,46526,69,155543
3439,0.001157,172.31.40.0-255,66,46592,69,155543
3440,0.001186,172.217.194.0-255,1484,48076,69,155543
3441,0.001194,172.217.194.0-255,5738,53814,69,155543
3442,0.001196,172.31.40.0-255,66,53880,69,155543
3443,0.001204,172.217.194.0-255,7156,61036,69,155543
3444,0.001206,172.31.40.0-255,66,61102,69,155543
3445,0.00124,172.217.194.0-255,5738,66840,69,155543
3446,0.001242,172.217.194.0-255,1484,68324,69,155543
3447,0.001247,172.217.194.0-255,2902,71226,69,155543
3448,0.00125,172.31.40.0-255,66,71292,69,155543
3449,0.001254,172.31.40.0-255,66,71358,69,155543
3450,0.001283,172.217.194.0-255,6438,77796,69,155543
3451,0.00129,172.31.40.0-255,66,77862,69,155543
3452,0.001363,172.217.194.0-255,1484,79346,69,155543
3453,0.001369,172.217.194.0-255,2902,82248,69,155543
3454,0.001371,172.31.40.0-255,66,82314,69,155543
3455,0.001376,172.217.194.0-255,2902,85216,69,155543
3456,0.001378,172.31.40.0-255,66,85282,69,155543
3457,0.001413,172.217.194.0-255,2902,88184,69,155543
3458,0.001416,172.31.40.0-255,66,88250,69,155543
3459,0.001422,172.217.194.0-255,2902,91152,69,155543
3460,0.001424,172.31.40.0-255,66,91218,69,155543
3461,0.00144,172.31.40.0-255,66,91284,69,155543
3462,0.001495,172.31.40.0-255,66,91350,69,155543
3463,0.001672,172.217.194.0-255,1484,92834,69,155543
3464,0.001677,172.217.194.0-255,1484,94318,69,155543
3465,0.00168,172.31.40.0-255,66,94384,69,155543
3466,0.001706,172.217.194.0-255,1484,95868,69,155543
3467,0.001714,172.217.194.0-255,5738,101606,69,155543
3468,0.001716,172.31.40.0-255,66,101672,69,155543
3469,0.001745,172.217.194.0-255,7156,108828,69,155543
3470,0.001748,172.31.40.0-255,66,108894,69,155543
3471,0.001753,172.217.194.0-255,2902,111796,69,155543
3472,0.001755,172.31.40.0-255,66,111862,69,155543
3473,0.001794,172.31.40.0-255,66,111928,69,155543
3474,0.001798,172.217.194.0-255,2184,114112,69,155543
3475,0.001801,172.31.40.0-255,66,114178,69,155543
3476,0.001876,172.217.194.0-255,1484,115662,69,155543
3477,0.001894,172.217.194.0-255,2902,118564,69,155543
3478,0.001897,172.31.40.0-255,66,118630,69,155543
3479,0.001935,172.217.194.0-255,4320,122950,69,155543
3480,0.001937,172.31.40.0-255,66,123016,69,155543
3481,0.001965,172.217.194.0-255,1484,124500,69,155543
3482,0.00198,172.31.40.0-255,66,124566,69,155543
3483,0.001998,172.31.40.0-255,66,124632,69,155543
3484,0.002001,172.217.194.0-255,1484,126116,69,155543
3485,0.002026,172.217.194.0-255,2902,129018,69,155543
3486,0.002028,172.31.40.0-255,66,129084,69,155543
3487,0.002035,172.217.194.0-255,5738,134822,69,155543
3488,0.002038,172.31.40.0-255,66,134888,69,155543
3489,0.002042,172.217.194.0-255,2902,137790,69,155543
3490,0.002051,172.31.40.0-255,66,137856,69,155543
3491,0.0021,172.31.40.0-255,66,137922,69,155543
3492,0.002112,172.31.40.0-255,66,137988,69,155543
3493,0.002119,172.217.194.0-255,4320,142308,69,155543
3494,0.002122,172.31.40.0-255,66,142374,69,155543
3495,0.002175,172.31.40.0-255,66,142440,69,155543
3496,0.002192,172.31.40.0-255,66,142506,69,155543
3497,0.002228,172.31.40.0-255,66,142572,69,155543
3498,0.002245,172.31.40.0-255,66,142638,69,155543
3499,0.002273,172.217.194.0-255,2184,144822,69,155543
3500,0.002275,172.31.40.0-255,66,144888,69,155543
3501,0.002294,172.31.40.0-255,66,144954,69,155543
3502,0.002346,172.31.40.0-255,66,145020,69,155543
3503,0.002372,172.31.40.0-255,66,145086,69,155543
3504,0.002395,172.31.40.0-255,66,145152,69,155543
3505,0.003204,172.217.194.0-255,66,145218,69,155543
3506,0.004671,172.217.194.0-255,1111,146329,69,155543
3507,0.006727,172.31.40.0-255,105,146434,69,155543
3508,0.013338,172.217.194.0-255,66,146500,69,155543
3509,0.034263,172.31.40.0-255,172,146672,69,155543
3510,0.034294,172.31.40.0-255,1116,147788,69,155543
3511,0.034357,172.31.40.0-255,1514,149302,69,155543
3512,0.034359,172.31.40.0-255,1514,150816,69,155543
3513,0.03436,172.31.40.0-255,1514,152330,69,155543
3514,0.034365,172.31.40.0-255,1514,153844,69,155543
3515,0.034366,172.31.40.0-255,1501,155345,69,155543
3516,0.035838,104.244.42.0-255,66,155411,69,155543
3517,0.035876,104.244.42.0-255,66,155477,69,155543
3518,0.035936,104.244.42.0-255,66,155543,69,155543
3519,0.0,74.125.24.0-255,301,301,69,242525
3520,1.2e-05,172.31.40.0-255,66,367,69,242525
3521,1.8e-05,74.125.24.0-255,1484,1851,69,242525
3522,2.2e-05,172.31.40.0-255,66,1917,69,242525
3523,2.8e-05,74.125.24.0-255,4320,6237,69,242525
3524,3e-05,172.31.40.0-255,66,6303,69,242525
3525,4.6e-05,74.125.24.0-255,5738,12041,69,242525
3526,4.8e-05,172.31.40.0-255,66,12107,69,242525
3527,6.1e-05,74.125.24.0-255,1867,13974,69,242525
3528,6.2e-05,172.31.40.0-255,66,14040,69,242525
3529,6.8e-05,74.125.24.0-255,5738,19778,69,242525
3530,7e-05,172.31.40.0-255,66,19844,69,242525
3531,9.6e-05,74.125.24.0-255,2902,22746,69,242525
3532,9.8e-05,172.31.40.0-255,66,22812,69,242525
3533,0.000109,172.31.40.0-255,66,22878,69,242525
3534,0.000132,74.125.24.0-255,7156,30034,69,242525
3535,0.000134,172.31.40.0-255,66,30100,69,242525
3536,0.00014,74.125.24.0-255,5738,35838,69,242525
3537,0.000142,172.31.40.0-255,66,35904,69,242525
3538,0.000155,74.125.24.0-255,766,36670,69,242525
3539,0.000157,172.31.40.0-255,66,36736,69,242525
3540,0.00016,74.125.24.0-255,2902,39638,69,242525
3541,0.000163,172.31.40.0-255,66,39704,69,242525
3542,0.000168,74.125.24.0-255,4320,44024,69,242525
3543,0.00017,172.31.40.0-255,66,44090,69,242525
3544,0.000175,74.125.24.0-255,4320,48410,69,242525
3545,0.000177,172.31.40.0-255,66,48476,69,242525
3546,0.000204,74.125.24.0-255,4320,52796,69,242525
3547,0.000206,172.31.40.0-255,66,52862,69,242525
3548,0.000209,74.125.24.0-255,1457,54319,69,242525
3549,0.00021,172.31.40.0-255,66,54385,69,242525
3550,0.000281,74.125.24.0-255,344,54729,69,242525
3551,0.000559,74.125.24.0-255,1484,56213,69,242525
3552,0.000563,172.31.40.0-255,66,56279,69,242525
3553,0.000568,74.125.24.0-255,2902,59181,69,242525
3554,0.00057,172.31.40.0-255,66,59247,69,242525
3555,0.000573,74.125.24.0-255,1484,60731,69,242525
3556,0.000587,74.125.24.0-255,2902,63633,69,242525
3557,0.000589,172.31.40.0-255,66,63699,69,242525
3558,0.000604,74.125.24.0-255,1484,65183,69,242525
3559,0.000615,74.125.24.0-255,1484,66667,69,242525
3560,0.000617,172.31.40.0-255,66,66733,69,242525
3561,0.000637,74.125.24.0-255,1484,68217,69,242525
3562,0.000642,74.125.24.0-255,4320,72537,69,242525
3563,0.000644,172.31.40.0-255,66,72603,69,242525
3564,0.000653,172.31.40.0-255,66,72669,69,242525
3565,0.000656,74.125.24.0-255,1484,74153,69,242525
3566,0.000678,74.125.24.0-255,6438,80591,69,242525
3567,0.000681,172.31.40.0-255,66,80657,69,242525
3568,0.00116,74.125.24.0-255,1484,82141,69,242525
3569,0.001165,74.125.24.0-255,1484,83625,69,242525
3570,0.001168,172.31.40.0-255,66,83691,69,242525
3571,0.001187,74.125.24.0-255,1484,85175,69,242525
3572,0.001194,74.125.24.0-255,5738,90913,69,242525
3573,0.00122,74.125.24.0-255,2902,93815,69,242525
3574,0.001225,172.31.40.0-255,66,93881,69,242525
3575,0.001228,172.31.40.0-255,66,93947,69,242525
3576,0.001254,172.31.40.0-255,66,94013,69,242525
3577,0.001264,172.31.40.0-255,66,94079,69,242525
3578,0.001267,74.125.24.0-255,766,94845,69,242525
3579,0.001508,74.125.24.0-255,1484,96329,69,242525
3580,0.001513,172.31.40.0-255,66,96395,69,242525
3581,0.001528,74.125.24.0-255,2902,99297,69,242525
3582,0.00153,172.31.40.0-255,66,99363,69,242525
3583,0.001534,74.125.24.0-255,2902,102265,69,242525
3584,0.001536,172.31.40.0-255,66,102331,69,242525
3585,0.001552,74.125.24.0-255,2902,105233,69,242525
3586,0.001554,172.31.40.0-255,66,105299,69,242525
3587,0.001571,74.125.24.0-255,4320,109619,69,242525
3588,0.001573,172.31.40.0-255,66,109685,69,242525
3589,0.001592,74.125.24.0-255,5738,115423,69,242525
3590,0.001595,172.31.40.0-255,66,115489,69,242525
3591,0.001626,74.125.24.0-255,2902,118391,69,242525
3592,0.001629,172.31.40.0-255,66,118457,69,242525
3593,0.00164,172.31.40.0-255,66,118523,69,242525
3594,0.001643,74.125.24.0-255,766,119289,69,242525
3595,0.001739,74.125.24.0-255,1484,120773,69,242525
3596,0.001742,74.125.24.0-255,1484,122257,69,242525
3597,0.001746,172.31.40.0-255,66,122323,69,242525
3598,0.001755,74.125.24.0-255,1484,123807,69,242525
3599,0.001757,172.31.40.0-255,66,123873,69,242525
3600,0.001764,74.125.24.0-255,5738,129611,69,242525
3601,0.001766,172.31.40.0-255,66,129677,69,242525
3602,0.001772,74.125.24.0-255,4320,133997,69,242525
3603,0.001774,172.31.40.0-255,66,134063,69,242525
3604,0.001802,172.31.40.0-255,66,134129,69,242525
3605,0.001812,172.31.40.0-255,66,134195,69,242525
3606,0.001855,74.125.24.0-255,2184,136379,69,242525
3607,0.001858,172.31.40.0-255,66,136445,69,242525
3608,0.001888,74.125.24.0-255,1484,137929,69,242525
3609,0.001891,74.125.24.0-255,1484,139413,69,242525
3610,0.001894,172.31.40.0-255,66,139479,69,242525
3611,0.001917,74.125.24.0-255,1484,140963,69,242525
3612,0.001924,74.125.24.0-255,5738,146701,69,242525
3613,0.001926,172.31.40.0-255,66,146767,69,242525
3614,0.001931,74.125.24.0-255,2902,149669,69,242525
3615,0.001933,172.31.40.0-255,66,149735,69,242525
3616,0.001968,172.31.40.0-255,66,149801,69,242525
3617,0.001986,74.125.24.0-255,4320,154121,69,242525
3618,0.001989,172.31.40.0-255,66,154187,69,242525
3619,0.002018,74.125.24.0-255,6438,160625,69,242525
3620,0.002021,172.31.40.0-255,66,160691,69,242525
3621,0.002036,74.125.24.0-255,1484,162175,69,242525
3622,0.002091,172.31.40.0-255,66,162241,69,242525
3623,0.002108,172.31.40.0-255,66,162307,69,242525
3624,0.00212,172.31.40.0-255,66,162373,69,242525
3625,0.002174,172.31.40.0-255,66,162439,69,242525
3626,0.002194,74.125.24.0-255,5738,168177,69,242525
3627,0.002196,172.31.40.0-255,66,168243,69,242525
3628,0.002244,172.31.40.0-255,66,168309,69,242525
3629,0.002265,74.125.24.0-255,766,169075,69,242525
3630,0.002282,172.31.40.0-255,66,169141,69,242525
3631,0.002293,172.31.40.0-255,66,169207,69,242525
3632,0.002297,74.125.24.0-255,2902,172109,69,242525
3633,0.002299,172.31.40.0-255,66,172175,69,242525
3634,0.002332,172.31.40.0-255,66,172241,69,242525
3635,0.002364,74.125.24.0-255,6438,178679,69,242525
3636,0.002367,172.31.40.0-255,66,178745,69,242525
3637,0.002388,74.125.24.0-255,5738,184483,69,242525
3638,0.002391,172.31.40.0-255,66,184549,69,242525
3639,0.00242,172.31.40.0-255,66,184615,69,242525
3640,0.003567,74.125.24.0-255,1484,186099,69,242525
3641,0.003584,74.125.24.0-255,2902,189001,69,242525
3642,0.00359,172.31.40.0-255,66,189067,69,242525
3643,0.003618,74.125.24.0-255,5738,194805,69,242525
3644,0.003621,172.31.40.0-255,66,194871,69,242525
3645,0.003629,74.125.24.0-255,7156,202027,69,242525
3646,0.00363,172.31.40.0-255,66,202093,69,242525
3647,0.003636,74.125.24.0-255,4320,206413,69,242525
3648,0.003638,172.31.40.0-255,66,206479,69,242525
3649,0.00364,74.125.24.0-255,1484,207963,69,242525
3650,0.003677,74.125.24.0-255,1484,209447,69,242525
3651,0.00368,172.31.40.0-255,66,209513,69,242525
3652,0.003722,74.125.24.0-255,4320,213833,69,242525
3653,0.003726,172.31.40.0-255,66,213899,69,242525
3654,0.003742,74.125.24.0-255,2902,216801,69,242525
3655,0.003744,172.31.40.0-255,66,216867,69,242525
3656,0.003778,74.125.24.0-255,2184,219051,69,242525
3657,0.003782,172.31.40.0-255,66,219117,69,242525
3658,0.005075,74.125.24.0-255,1484,220601,69,242525
3659,0.005087,74.125.24.0-255,2902,223503,69,242525
3660,0.005091,172.31.40.0-255,66,223569,69,242525
3661,0.005096,74.125.24.0-255,1484,225053,69,242525
3662,0.005164,74.125.24.0-255,5738,230791,69,242525
3663,0.005167,172.31.40.0-255,66,230857,69,242525
3664,0.005172,74.125.24.0-255,2153,233010,69,242525
3665,0.005174,172.31.40.0-255,66,233076,69,242525
3666,0.005227,74.125.24.0-255,105,233181,69,242525
3667,0.01044,172.31.40.0-255,66,233247,69,242525
3668,0.010481,172.31.40.0-255,105,233352,69,242525
3669,0.012855,74.125.24.0-255,66,233418,69,242525
3670,0.0356,172.31.40.0-255,172,233590,69,242525
3671,0.035634,172.31.40.0-255,1114,234704,69,242525
3672,0.03573,172.31.40.0-255,1514,236218,69,242525
3673,0.03575,172.31.40.0-255,1514,237732,69,242525
3674,0.035752,172.31.40.0-255,1514,239246,69,242525
3675,0.035774,172.31.40.0-255,1514,240760,69,242525
3676,0.035775,172.31.40.0-255,1501,242261,69,242525
3677,0.037236,104.244.42.0-255,66,242327,69,242525
3678,0.037266,104.244.42.0-255,66,242393,69,242525
3679,0.037429,104.244.42.0-255,66,242459,69,242525
3680,0.03748,104.244.42.0-255,66,242525,69,242525
3681,0.0,74.125.68.0-255,149,149,69,394475
3682,2.3e-05,172.31.40.0-255,66,215,69,394475
3683,3e-05,74.125.68.0-255,1484,1699,69,394475
3684,3.4e-05,172.31.40.0-255,66,1765,69,394475
3685,3.9e-05,74.125.68.0-255,2902,4667,69,394475
3686,4.2e-05,172.31.40.0-255,66,4733,69,394475
3687,4.9e-05,74.125.68.0-255,5738,10471,69,394475
3688,5.2e-05,172.31.40.0-255,66,10537,69,394475
3689,7.6e-05,74.125.68.0-255,2902,13439,69,394475
3690,7.9e-05,172.31.40.0-255,66,13505,69,394475
3691,0.0001,74.125.68.0-255,646,14151,69,394475
3692,0.000102,172.31.40.0-255,66,14217,69,394475
3693,0.000122,74.125.68.0-255,1484,15701,69,394475
3694,0.000124,172.31.40.0-255,66,15767,69,394475
3695,0.000146,74.125.68.0-255,2902,18669,69,394475
3696,0.000149,172.31.40.0-255,66,18735,69,394475
3697,0.000155,74.125.68.0-255,5738,24473,69,394475
3698,0.000157,172.31.40.0-255,66,24539,69,394475
3699,0.000178,74.125.68.0-255,1484,26023,69,394475
3700,0.00018,172.31.40.0-255,66,26089,69,394475
3701,0.000201,74.125.68.0-255,5379,31468,69,394475
3702,0.000204,172.31.40.0-255,66,31534,69,394475
3703,0.000211,74.125.68.0-255,7156,38690,69,394475
3704,0.000214,172.31.40.0-255,66,38756,69,394475
3705,0.000236,74.125.68.0-255,1484,40240,69,394475
3706,0.000238,172.31.40.0-255,66,40306,69,394475
3707,0.000268,172.31.40.0-255,66,40372,69,394475
3708,0.000287,74.125.68.0-255,1484,41856,69,394475
3709,0.000289,172.31.40.0-255,66,41922,69,394475
3710,0.000304,74.125.68.0-255,1484,43406,69,394475
3711,0.000306,172.31.40.0-255,66,43472,69,394475
3712,0.000321,74.125.68.0-255,1484,44956,69,394475
3713,0.000329,74.125.68.0-255,5738,50694,69,394475
3714,0.000331,172.31.40.0-255,66,50760,69,394475
3715,0.000336,74.125.68.0-255,2902,53662,69,394475
3716,0.000337,172.31.40.0-255,66,53728,69,394475
3717,0.00034,74.125.68.0-255,1484,55212,69,394475
3718,0.000364,74.125.68.0-255,2543,57755,69,394475
3719,0.00038,172.31.40.0-255,66,57821,69,394475
3720,0.000383,74.125.68.0-255,402,58223,69,394475
3721,0.000489,74.125.68.0-255,1484,59707,69,394475
3722,0.000493,172.31.40.0-255,66,59773,69,394475
3723,0.000498,74.125.68.0-255,2902,62675,69,394475
3724,0.000501,172.31.40.0-255,66,62741,69,394475
3725,0.000517,74.125.68.0-255,4320,67061,69,394475
3726,0.00052,172.31.40.0-255,66,67127,69,394475
3727,0.000538,74.125.68.0-255,1484,68611,69,394475
3728,0.000544,74.125.68.0-255,4320,72931,69,394475
3729,0.000547,172.31.40.0-255,66,72997,69,394475
3730,0.000584,74.125.68.0-255,4237,77234,69,394475
3731,0.000598,74.125.68.0-255,4320,81554,69,394475
3732,0.000652,74.125.68.0-255,4320,85874,69,394475
3733,0.000671,74.125.68.0-255,5738,91612,69,394475
3734,0.000674,74.125.68.0-255,1125,92737,69,394475
3735,0.000731,74.125.68.0-255,1484,94221,69,394475
3736,0.000736,74.125.68.0-255,2902,97123,69,394475
3737,0.000755,74.125.68.0-255,5738,102861,69,394475
3738,0.000789,74.125.68.0-255,4320,107181,69,394475
3739,0.000811,74.125.68.0-255,7156,114337,69,394475
3740,0.000828,74.125.68.0-255,1484,115821,69,394475
3741,0.000834,74.125.68.0-255,4320,120141,69,394475
3742,0.000851,74.125.68.0-255,1484,121625,69,394475
3743,0.000865,74.125.68.0-255,5020,126645,69,394475
3744,0.000882,172.31.40.0-255,66,126711,69,394475
3745,0.000932,74.125.68.0-255,1484,128195,69,394475
3746,0.000938,74.125.68.0-255,2902,131097,69,394475
3747,0.000943,172.31.40.0-255,66,131163,69,394475
3748,0.000962,74.125.68.0-255,4320,135483,69,394475
3749,0.000984,74.125.68.0-255,4320,139803,69,394475
3750,0.00099,172.31.40.0-255,66,139869,69,394475
3751,0.001008,74.125.68.0-255,4320,144189,69,394475
3752,0.001015,74.125.68.0-255,7156,151345,69,394475
3753,0.001018,74.125.68.0-255,1484,152829,69,394475
3754,0.001029,172.31.40.0-255,66,152895,69,394475
3755,0.001044,74.125.68.0-255,7156,160051,69,394475
3756,0.001048,74.125.68.0-255,766,160817,69,394475
3757,0.001068,172.31.40.0-255,66,160883,69,394475
3758,0.001156,74.125.68.0-255,1484,162367,69,394475
3759,0.001179,74.125.68.0-255,2902,165269,69,394475
3760,0.001184,74.125.68.0-255,4320,169589,69,394475
3761,0.001188,172.31.40.0-255,66,169655,69,394475
3762,0.001195,74.125.68.0-255,1484,171139,69,394475
3763,0.001215,74.125.68.0-255,1484,172623,69,394475
3764,0.001225,74.125.68.0-255,2902,175525,69,394475
3765,0.001236,74.125.68.0-255,2902,178427,69,394475
3766,0.001239,172.31.40.0-255,66,178493,69,394475
3767,0.001248,74.125.68.0-255,2902,181395,69,394475
3768,0.00126,74.125.68.0-255,1484,182879,69,394475
3769,0.001281,74.125.68.0-255,2184,185063,69,394475
3770,0.001298,172.31.40.0-255,66,185129,69,394475
3771,0.001345,74.125.68.0-255,1484,186613,69,394475
3772,0.001359,74.125.68.0-255,2902,189515,69,394475
3773,0.001364,172.31.40.0-255,66,189581,69,394475
3774,0.001375,74.125.68.0-255,4320,193901,69,394475
3775,0.001384,172.31.40.0-255,66,193967,69,394475
3776,0.001397,74.125.68.0-255,5738,199705,69,394475
3777,0.00141,74.125.68.0-255,2902,202607,69,394475
3778,0.001416,74.125.68.0-255,5738,208345,69,394475
3779,0.001426,74.125.68.0-255,1484,209829,69,394475
3780,0.001437,74.125.68.0-255,2902,212731,69,394475
3781,0.001445,172.31.40.0-255,66,212797,69,394475
3782,0.001461,74.125.68.0-255,5738,218535,69,394475
3783,0.001464,74.125.68.0-255,766,219301,69,394475
3784,0.001487,172.31.40.0-255,66,219367,69,394475
3785,0.001533,74.125.68.0-255,1484,220851,69,394475
3786,0.001552,74.125.68.0-255,2902,223753,69,394475
3787,0.00157,74.125.68.0-255,2902,226655,69,394475
3788,0.001578,172.31.40.0-255,66,226721,69,394475
3789,0.001583,74.125.68.0-255,2902,229623,69,394475
3790,0.001587,74.125.68.0-255,2902,232525,69,394475
3791,0.001593,172.31.40.0-255,66,232591,69,394475
3792,0.001611,74.125.68.0-255,2902,235493,69,394475
3793,0.001637,74.125.68.0-255,7156,242649,69,394475
3794,0.001659,172.31.40.0-255,66,242715,69,394475
3795,0.001696,74.125.68.0-255,1484,244199,69,394475
3796,0.001713,74.125.68.0-255,2902,247101,69,394475
3797,0.001715,74.125.68.0-255,1484,248585,69,394475
3798,0.001767,172.31.40.0-255,66,248651,69,394475
3799,0.001774,74.125.68.0-255,2902,251553,69,394475
3800,0.001779,74.125.68.0-255,5738,257291,69,394475
3801,0.001793,172.31.40.0-255,66,257357,69,394475
3802,0.001802,74.125.68.0-255,1484,258841,69,394475
3803,0.001826,74.125.68.0-255,4320,263161,69,394475
3804,0.001835,172.31.40.0-255,66,263227,69,394475
3805,0.001854,74.125.68.0-255,6438,269665,69,394475
3806,0.001857,74.125.68.0-255,1484,271149,69,394475
3807,0.001871,172.31.40.0-255,66,271215,69,394475
3808,0.001877,74.125.68.0-255,2902,274117,69,394475
3809,0.001881,172.31.40.0-255,66,274183,69,394475
3810,0.001892,74.125.68.0-255,4320,278503,69,394475
3811,0.001911,74.125.68.0-255,7156,285659,69,394475
3812,0.001918,74.125.68.0-255,7156,292815,69,394475
3813,0.001923,74.125.68.0-255,2902,295717,69,394475
3814,0.001942,74.125.68.0-255,5738,301455,69,394475
3815,0.001945,74.125.68.0-255,766,302221,69,394475
3816,0.001949,172.31.40.0-255,66,302287,69,394475
3817,0.004062,74.125.68.0-255,5738,308025,69,394475
3818,0.004068,172.31.40.0-255,66,308091,69,394475
3819,0.006183,74.125.68.0-255,5738,313829,69,394475
3820,0.006193,172.31.40.0-255,66,313895,69,394475
3821,0.008311,74.125.68.0-255,5738,319633,69,394475
3822,0.008316,172.31.40.0-255,66,319699,69,394475
3823,0.010434,74.125.68.0-255,5738,325437,69,394475
3824,0.010442,172.31.40.0-255,66,325503,69,394475
3825,0.012562,74.125.68.0-255,5738,331241,69,394475
3826,0.01257,172.31.40.0-255,66,331307,69,394475
3827,0.014693,74.125.68.0-255,5738,337045,69,394475
3828,0.014701,172.31.40.0-255,66,337111,69,394475
3829,0.01682,74.125.68.0-255,2902,340013,69,394475
3830,0.01683,172.31.40.0-255,66,340079,69,394475
3831,0.016852,74.125.68.0-255,2902,342981,69,394475
3832,0.016854,172.31.40.0-255,66,343047,69,394475
3833,0.018946,74.125.68.0-255,2902,345949,69,394475
3834,0.018952,172.31.40.0-255,66,346015,69,394475
3835,0.018974,74.125.68.0-255,2902,348917,69,394475
3836,0.018976,172.31.40.0-255,66,348983,69,394475
3837,0.021067,74.125.68.0-255,2902,351885,69,394475
3838,0.021077,172.31.40.0-255,66,351951,69,394475
3839,0.021098,74.125.68.0-255,2902,354853,69,394475
3840,0.0211,172.31.40.0-255,66,354919,69,394475
3841,0.023192,74.125.68.0-255,2902,357821,69,394475
3842,0.023199,172.31.40.0-255,66,357887,69,394475
3843,0.023222,74.125.68.0-255,2902,360789,69,394475
3844,0.023224,172.31.40.0-255,66,360855,69,394475
3845,0.025308,74.125.68.0-255,2902,363757,69,394475
3846,0.025317,172.31.40.0-255,66,363823,69,394475
3847,0.02534,74.125.68.0-255,2902,366725,69,394475
3848,0.025343,172.31.40.0-255,66,366791,69,394475
3849,0.027422,74.125.68.0-255,2902,369693,69,394475
3850,0.027428,172.31.40.0-255,66,369759,69,394475
3851,0.027446,74.125.68.0-255,2902,372661,69,394475
3852,0.027449,172.31.40.0-255,66,372727,69,394475
3853,0.029558,74.125.68.0-255,4320,377047,69,394475
3854,0.029563,172.31.40.0-255,66,377113,69,394475
3855,0.029583,74.125.68.0-255,1484,378597,69,394475
3856,0.03168,74.125.68.0-255,4320,382917,69,394475
3857,0.031687,172.31.40.0-255,66,382983,69,394475
3858,0.033801,74.125.68.0-255,1974,384957,69,394475
3859,0.033808,172.31.40.0-255,66,385023,69,394475
3860,0.033985,172.31.40.0-255,105,385128,69,394475
3861,0.036068,74.125.68.0-255,66,385194,69,394475
3862,0.038013,172.31.40.0-255,172,385366,69,394475
3863,0.038043,172.31.40.0-255,1114,386480,69,394475
3864,0.038104,172.31.40.0-255,1514,387994,69,394475
3865,0.038106,172.31.40.0-255,1514,389508,69,394475
3866,0.038111,172.31.40.0-255,1514,391022,69,394475
3867,0.038112,172.31.40.0-255,1514,392536,69,394475
3868,0.038134,172.31.40.0-255,1501,394037,69,394475
3869,0.039706,104.244.42.0-255,66,394103,69,394475
3870,0.039735,104.244.42.0-255,66,394169,69,394475
3871,0.039778,104.244.42.0-255,66,394235,69,394475
3872,0.039883,104.244.42.0-255,66,394301,69,394475
3873,0.040653,104.244.42.0-255,108,394409,69,394475
3874,0.04066,172.31.40.0-255,66,394475,69,394475
3875,0.0,74.125.68.0-255,153,153,69,379968
3876,2.2e-05,172.31.40.0-255,66,219,69,379968
3877,2.9e-05,74.125.68.0-255,1484,1703,69,379968
3878,3.4e-05,172.31.40.0-255,66,1769,69,379968
3879,3.7e-05,74.125.68.0-255,1484,3253,69,379968
3880,4e-05,172.31.40.0-255,66,3319,69,379968
3881,6.8e-05,74.125.68.0-255,2902,6221,69,379968
3882,7.2e-05,172.31.40.0-255,66,6287,69,379968
3883,7.9e-05,74.125.68.0-255,5738,12025,69,379968
3884,8.2e-05,172.31.40.0-255,66,12091,69,379968
3885,8.5e-05,74.125.68.0-255,1484,13575,69,379968
3886,8.7e-05,172.31.40.0-255,66,13641,69,379968
3887,0.000104,74.125.68.0-255,645,14286,69,379968
3888,0.000107,172.31.40.0-255,66,14352,69,379968
3889,0.000551,74.125.68.0-255,1484,15836,69,379968
3890,0.000557,172.31.40.0-255,66,15902,69,379968
3891,0.000566,74.125.68.0-255,2902,18804,69,379968
3892,0.000569,172.31.40.0-255,66,18870,69,379968
3893,0.000574,74.125.68.0-255,2902,21772,69,379968
3894,0.000576,172.31.40.0-255,66,21838,69,379968
3895,0.000594,74.125.68.0-255,2902,24740,69,379968
3896,0.000597,172.31.40.0-255,66,24806,69,379968
3897,0.000613,74.125.68.0-255,4320,29126,69,379968
3898,0.000616,172.31.40.0-255,66,29192,69,379968
3899,0.000638,74.125.68.0-255,1484,30676,69,379968
3900,0.000641,172.31.40.0-255,66,30742,69,379968
3901,0.000644,74.125.68.0-255,1125,31867,69,379968
3902,0.000646,172.31.40.0-255,66,31933,69,379968
3903,0.00107,74.125.68.0-255,1484,33417,69,379968
3904,0.001078,172.31.40.0-255,66,33483,69,379968
3905,0.001084,74.125.68.0-255,2902,36385,69,379968
3906,0.001087,172.31.40.0-255,66,36451,69,379968
3907,0.001091,74.125.68.0-255,2902,39353,69,379968
3908,0.001094,172.31.40.0-255,66,39419,69,379968
3909,0.001108,74.125.68.0-255,2902,42321,69,379968
3910,0.001111,172.31.40.0-255,66,42387,69,379968
3911,0.001115,74.125.68.0-255,2902,45289,69,379968
3912,0.001117,172.31.40.0-255,66,45355,69,379968
3913,0.001151,172.31.40.0-255,66,45421,69,379968
3914,0.001164,74.125.68.0-255,2543,47964,69,379968
3915,0.001166,172.31.40.0-255,66,48030,69,379968
3916,0.001171,74.125.68.0-255,4320,52350,69,379968
3917,0.001173,172.31.40.0-255,66,52416,69,379968
3918,0.001208,74.125.68.0-255,5690,58106,69,379968
3919,0.001211,172.31.40.0-255,66,58172,69,379968
3920,0.001248,74.125.68.0-255,111,58283,69,379968
3921,0.001403,74.125.68.0-255,1484,59767,69,379968
3922,0.001408,172.31.40.0-255,66,59833,69,379968
3923,0.001412,74.125.68.0-255,1484,61317,69,379968
3924,0.001427,74.125.68.0-255,1484,62801,69,379968
3925,0.00143,172.31.40.0-255,66,62867,69,379968
3926,0.001433,74.125.68.0-255,1484,64351,69,379968
3927,0.001452,74.125.68.0-255,4320,68671,69,379968
3928,0.001455,172.31.40.0-255,66,68737,69,379968
3929,0.001476,74.125.68.0-255,7156,75893,69,379968
3930,0.001479,172.31.40.0-255,66,75959,69,379968
3931,0.001501,74.125.68.0-255,1125,77084,69,379968
3932,0.001512,172.31.40.0-255,66,77150,69,379968
3933,0.00152,74.125.68.0-255,6797,83947,69,379968
3934,0.001522,172.31.40.0-255,66,84013,69,379968
3935,0.001666,74.125.68.0-255,1484,85497,69,379968
3936,0.001688,74.125.68.0-255,2902,88399,69,379968
3937,0.001692,172.31.40.0-255,66,88465,69,379968
3938,0.00172,74.125.68.0-255,1484,89949,69,379968
3939,0.001739,74.125.68.0-255,2902,92851,69,379968
3940,0.001742,172.31.40.0-255,66,92917,69,379968
3941,0.001757,74.125.68.0-255,2902,95819,69,379968
3942,0.00176,172.31.40.0-255,66,95885,69,379968
3943,0.001785,74.125.68.0-255,2902,98787,69,379968
3944,0.001788,172.31.40.0-255,66,98853,69,379968
3945,0.001796,74.125.68.0-255,7156,106009,69,379968
3946,0.001798,172.31.40.0-255,66,106075,69,379968
3947,0.001823,74.125.68.0-255,7156,113231,69,379968
3948,0.001826,172.31.40.0-255,66,113297,69,379968
3949,0.001847,74.125.68.0-255,5020,118317,69,379968
3950,0.00185,172.31.40.0-255,66,118383,69,379968
3951,0.001867,74.125.68.0-255,1484,119867,69,379968
3952,0.001883,74.125.68.0-255,2902,122769,69,379968
3953,0.001886,172.31.40.0-255,66,122835,69,379968
3954,0.001889,74.125.68.0-255,1484,124319,69,379968
3955,0.001906,74.125.68.0-255,4320,128639,69,379968
3956,0.00191,172.31.40.0-255,66,128705,69,379968
3957,0.001916,74.125.68.0-255,5738,134443,69,379968
3958,0.001948,172.31.40.0-255,66,134509,69,379968
3959,0.001955,74.125.68.0-255,5738,140247,69,379968
3960,0.00196,172.31.40.0-255,66,140313,69,379968
3961,0.001967,74.125.68.0-255,1484,141797,69,379968
3962,0.00197,74.125.68.0-255,1484,143281,69,379968
3963,0.00199,74.125.68.0-255,5738,149019,69,379968
3964,0.002002,172.31.40.0-255,66,149085,69,379968
3965,0.002021,74.125.68.0-255,1484,150569,69,379968
3966,0.002038,74.125.68.0-255,2184,152753,69,379968
3967,0.00206,172.31.40.0-255,66,152819,69,379968
3968,0.002289,74.125.68.0-255,1484,154303,69,379968
3969,0.002335,74.125.68.0-255,1484,155787,69,379968
3970,0.002338,172.31.40.0-255,66,155853,69,379968
3971,0.002343,74.125.68.0-255,1484,157337,69,379968
3972,0.004372,74.125.68.0-255,1484,158821,69,379968
3973,0.004377,172.31.40.0-255,66,158887,69,379968
3974,0.004662,74.125.68.0-255,2902,161789,69,379968
3975,0.004665,172.31.40.0-255,66,161855,69,379968
3976,0.006707,74.125.68.0-255,2902,164757,69,379968
3977,0.006714,172.31.40.0-255,66,164823,69,379968
3978,0.00699,74.125.68.0-255,2902,167725,69,379968
3979,0.006997,172.31.40.0-255,66,167791,69,379968
3980,0.009073,74.125.68.0-255,2902,170693,69,379968
3981,0.009082,172.31.40.0-255,66,170759,69,379968
3982,0.009313,74.125.68.0-255,2902,173661,69,379968
3983,0.009316,172.31.40.0-255,66,173727,69,379968
3984,0.011405,74.125.68.0-255,2902,176629,69,379968
3985,0.011412,172.31.40.0-255,66,176695,69,379968
3986,0.011633,74.125.68.0-255,2902,179597,69,379968
3987,0.011638,172.31.40.0-255,66,179663,69,379968
3988,0.013732,74.125.68.0-255,2902,182565,69,379968
3989,0.013741,172.31.40.0-255,66,182631,69,379968
3990,0.013984,74.125.68.0-255,2902,185533,69,379968
3991,0.01399,172.31.40.0-255,66,185599,69,379968
3992,0.016078,74.125.68.0-255,2902,188501,69,379968
3993,0.016086,172.31.40.0-255,66,188567,69,379968
3994,0.016321,74.125.68.0-255,2902,191469,69,379968
3995,0.016326,172.31.40.0-255,66,191535,69,379968
3996,0.018424,74.125.68.0-255,2902,194437,69,379968
3997,0.018434,172.31.40.0-255,66,194503,69,379968
3998,0.018702,74.125.68.0-255,2902,197405,69,379968
3999,0.018708,172.31.40.0-255,66,197471,69,379968
4000,0.020762,74.125.68.0-255,2902,200373,69,379968
4001,0.020769,172.31.40.0-255,66,200439,69,379968
4002,0.021045,74.125.68.0-255,2902,203341,69,379968
4003,0.021053,172.31.40.0-255,66,203407,69,379968
4004,0.023109,74.125.68.0-255,2902,206309,69,379968
4005,0.023117,172.31.40.0-255,66,206375,69,379968
4006,0.023379,74.125.68.0-255,2902,209277,69,379968
4007,0.023385,172.31.40.0-255,66,209343,69,379968
4008,0.025442,74.125.68.0-255,2902,212245,69,379968
4009,0.025451,172.31.40.0-255,66,212311,69,379968
4010,0.025714,74.125.68.0-255,2902,215213,69,379968
4011,0.025721,172.31.40.0-255,66,215279,69,379968
4012,0.027768,74.125.68.0-255,1484,216763,69,379968
4013,0.027793,74.125.68.0-255,1484,218247,69,379968
4014,0.027798,172.31.40.0-255,66,218313,69,379968
4015,0.028041,74.125.68.0-255,2902,221215,69,379968
4016,0.028047,172.31.40.0-255,66,221281,69,379968
4017,0.030123,74.125.68.0-255,1484,222765,69,379968
4018,0.030369,74.125.68.0-255,4320,227085,69,379968
4019,0.030378,172.31.40.0-255,66,227151,69,379968
4020,0.032713,74.125.68.0-255,5738,232889,69,379968
4021,0.032721,172.31.40.0-255,66,232955,69,379968
4022,0.034632,172.31.40.0-255,199,233154,69,379968
4023,0.034663,172.31.40.0-255,1114,234268,69,379968
4024,0.034734,172.31.40.0-255,1514,235782,69,379968
4025,0.034736,172.31.40.0-255,1514,237296,69,379968
4026,0.034737,172.31.40.0-255,1514,238810,69,379968
4027,0.034742,172.31.40.0-255,1514,240324,69,379968
4028,0.034744,172.31.40.0-255,1502,241826,69,379968
4029,0.035049,74.125.68.0-255,5738,247564,69,379968
4030,0.035054,172.31.40.0-255,66,247630,69,379968
4031,0.036158,104.244.42.0-255,66,247696,69,379968
4032,0.036223,104.244.42.0-255,66,247762,69,379968
4033,0.03631,104.244.42.0-255,66,247828,69,379968
4034,0.037393,74.125.68.0-255,5738,253566,69,379968
4035,0.0374,172.31.40.0-255,66,253632,69,379968
4036,0.039733,74.125.68.0-255,5738,259370,69,379968
4037,0.03974,172.31.40.0-255,66,259436,69,379968
4038,0.042068,74.125.68.0-255,5738,265174,69,379968
4039,0.042074,172.31.40.0-255,66,265240,69,379968
4040,0.044415,74.125.68.0-255,5738,270978,69,379968
4041,0.044423,172.31.40.0-255,66,271044,69,379968
4042,0.046757,74.125.68.0-255,5738,276782,69,379968
4043,0.046764,172.31.40.0-255,66,276848,69,379968
4044,0.049088,74.125.68.0-255,4320,281168,69,379968
4045,0.049094,172.31.40.0-255,66,281234,69,379968
4046,0.049115,74.125.68.0-255,1484,282718,69,379968
4047,0.051419,74.125.68.0-255,4320,287038,69,379968
4048,0.051425,172.31.40.0-255,66,287104,69,379968
4049,0.053764,74.125.68.0-255,5738,292842,69,379968
4050,0.05377,172.31.40.0-255,66,292908,69,379968
4051,0.05611,74.125.68.0-255,5738,298646,69,379968
4052,0.056116,172.31.40.0-255,66,298712,69,379968
4053,0.058473,74.125.68.0-255,5738,304450,69,379968
4054,0.058479,172.31.40.0-255,66,304516,69,379968
4055,0.060822,74.125.68.0-255,5738,310254,69,379968
4056,0.060829,172.31.40.0-255,66,310320,69,379968
4057,0.06316,74.125.68.0-255,5738,316058,69,379968
4058,0.063166,172.31.40.0-255,66,316124,69,379968
4059,0.065487,74.125.68.0-255,5738,321862,69,379968
4060,0.065494,172.31.40.0-255,66,321928,69,379968
4061,0.067828,74.125.68.0-255,5738,327666,69,379968
4062,0.067834,172.31.40.0-255,66,327732,69,379968
4063,0.070165,74.125.68.0-255,5738,333470,69,379968
4064,0.070172,172.31.40.0-255,66,333536,69,379968
4065,0.072517,74.125.68.0-255,5738,339274,69,379968
4066,0.072524,172.31.40.0-255,66,339340,69,379968
4067,0.074851,74.125.68.0-255,5738,345078,69,379968
4068,0.074858,172.31.40.0-255,66,345144,69,379968
4069,0.0772,74.125.68.0-255,5738,350882,69,379968
4070,0.077206,172.31.40.0-255,66,350948,69,379968
4071,0.07955,74.125.68.0-255,5738,356686,69,379968
4072,0.079557,172.31.40.0-255,66,356752,69,379968
4073,0.0819,74.125.68.0-255,5738,362490,69,379968
4074,0.081906,172.31.40.0-255,66,362556,69,379968
4075,0.084249,74.125.68.0-255,5738,368294,69,379968
4076,0.084254,172.31.40.0-255,66,368360,69,379968
4077,0.086601,74.125.68.0-255,5738,374098,69,379968
4078,0.08661,172.31.40.0-255,66,374164,69,379968
4079,0.088944,74.125.68.0-255,5738,379902,69,379968
4080,0.08895,172.31.40.0-255,66,379968,69,379968
4081,0.0,172.217.194.0-255,152,152,69,308463
4082,1.6e-05,172.31.40.0-255,66,218,69,308463
4083,2.3e-05,172.217.194.0-255,1484,1702,69,308463
4084,2.8e-05,172.31.40.0-255,66,1768,69,308463
4085,4.2e-05,172.217.194.0-255,2902,4670,69,308463
4086,4.7e-05,172.31.40.0-255,66,4736,69,308463
4087,5.5e-05,172.217.194.0-255,7156,11892,69,308463
4088,5.8e-05,172.31.40.0-255,66,11958,69,308463
4089,9.2e-05,172.217.194.0-255,2102,14060,69,308463
4090,9.5e-05,172.31.40.0-255,66,14126,69,308463
4091,0.000132,172.217.194.0-255,1484,15610,69,308463
4092,0.000135,172.31.40.0-255,66,15676,69,308463
4093,0.000139,172.217.194.0-255,1484,17160,69,308463
4094,0.000142,172.31.40.0-255,66,17226,69,308463
4095,0.000175,172.217.194.0-255,1484,18710,69,308463
4096,0.000178,172.31.40.0-255,66,18776,69,308463
4097,0.000185,172.217.194.0-255,5738,24514,69,308463
4098,0.000188,172.31.40.0-255,66,24580,69,308463
4099,0.000199,172.217.194.0-255,6797,31377,69,308463
4100,0.000202,172.31.40.0-255,66,31443,69,308463
4101,0.000253,172.217.194.0-255,1484,32927,69,308463
4102,0.000257,172.31.40.0-255,66,32993,69,308463
4103,0.000262,172.217.194.0-255,2902,35895,69,308463
4104,0.000264,172.31.40.0-255,66,35961,69,308463
4105,0.000269,172.217.194.0-255,2902,38863,69,308463
4106,0.000276,172.31.40.0-255,66,38929,69,308463
4107,0.00031,172.217.194.0-255,2902,41831,69,308463
4108,0.000313,172.31.40.0-255,66,41897,69,308463
4109,0.000319,172.217.194.0-255,4320,46217,69,308463
4110,0.000321,172.31.40.0-255,66,46283,69,308463
4111,0.000329,172.217.194.0-255,7156,53439,69,308463
4112,0.000332,172.31.40.0-255,66,53505,69,308463
4113,0.000368,172.217.194.0-255,5379,58884,69,308463
4114,0.000372,172.31.40.0-255,66,58950,69,308463
4115,0.000379,172.217.194.0-255,7049,65999,69,308463
4116,0.000381,172.31.40.0-255,66,66065,69,308463
4117,0.000385,172.217.194.0-255,118,66183,69,308463
4118,0.000388,172.217.194.0-255,381,66564,69,308463
4119,0.000751,172.217.194.0-255,1484,68048,69,308463
4120,0.000757,172.31.40.0-255,66,68114,69,308463
4121,0.000763,172.217.194.0-255,2902,71016,69,308463
4122,0.000766,172.31.40.0-255,66,71082,69,308463
4123,0.000769,172.217.194.0-255,1484,72566,69,308463
4124,0.000803,172.217.194.0-255,4320,76886,69,308463
4125,0.000806,172.31.40.0-255,66,76952,69,308463
4126,0.00082,172.31.40.0-255,66,77018,69,308463
4127,0.000822,172.217.194.0-255,1484,78502,69,308463
4128,0.000868,172.31.40.0-255,66,78568,69,308463
4129,0.001124,172.217.194.0-255,1484,80052,69,308463
4130,0.001146,172.217.194.0-255,2902,82954,69,308463
4131,0.001149,172.31.40.0-255,66,83020,69,308463
4132,0.001156,172.217.194.0-255,5738,88758,69,308463
4133,0.001158,172.31.40.0-255,66,88824,69,308463
4134,0.001197,172.31.40.0-255,66,88890,69,308463
4135,0.001209,172.31.40.0-255,66,88956,69,308463
4136,0.001219,172.217.194.0-255,5020,93976,69,308463
4137,0.001223,172.31.40.0-255,66,94042,69,308463
4138,0.001266,172.217.194.0-255,1484,95526,69,308463
4139,0.00128,172.217.194.0-255,2902,98428,69,308463
4140,0.001283,172.31.40.0-255,66,98494,69,308463
4141,0.001287,172.217.194.0-255,1484,99978,69,308463
4142,0.00131,172.217.194.0-255,4320,104298,69,308463
4143,0.001313,172.31.40.0-255,66,104364,69,308463
4144,0.001316,172.217.194.0-255,1484,105848,69,308463
4145,0.001333,172.217.194.0-255,7156,113004,69,308463
4146,0.001336,172.31.40.0-255,66,113070,69,308463
4147,0.001367,172.217.194.0-255,1484,114554,69,308463
4148,0.001429,172.31.40.0-255,66,114620,69,308463
4149,0.001459,172.217.194.0-255,2184,116804,69,308463
4150,0.001462,172.31.40.0-255,66,116870,69,308463
4151,0.001643,172.217.194.0-255,1484,118354,69,308463
4152,0.00165,172.217.194.0-255,2902,121256,69,308463
4153,0.001653,172.31.40.0-255,66,121322,69,308463
4154,0.001659,172.217.194.0-255,5738,127060,69,308463
4155,0.001661,172.31.40.0-255,66,127126,69,308463
4156,0.001693,172.217.194.0-255,7156,134282,69,308463
4157,0.001696,172.31.40.0-255,66,134348,69,308463
4158,0.001701,172.217.194.0-255,2902,137250,69,308463
4159,0.001703,172.31.40.0-255,66,137316,69,308463
4160,0.001744,172.31.40.0-255,66,137382,69,308463
4161,0.001748,172.217.194.0-255,2184,139566,69,308463
4162,0.00175,172.31.40.0-255,66,139632,69,308463
4163,0.001755,172.217.194.0-255,2902,142534,69,308463
4164,0.001762,172.31.40.0-255,66,142600,69,308463
4165,0.001769,172.217.194.0-255,7156,149756,69,308463
4166,0.001771,172.31.40.0-255,66,149822,69,308463
4167,0.001779,172.217.194.0-255,7156,156978,69,308463
4168,0.001782,172.31.40.0-255,66,157044,69,308463
4169,0.001831,172.31.40.0-255,66,157110,69,308463
4170,0.001834,172.217.194.0-255,766,157876,69,308463
4171,0.002338,172.217.194.0-255,1484,159360,69,308463
4172,0.002343,172.31.40.0-255,66,159426,69,308463
4173,0.002348,172.217.194.0-255,2902,162328,69,308463
4174,0.002351,172.31.40.0-255,66,162394,69,308463
4175,0.002361,172.217.194.0-255,5738,168132,69,308463
4176,0.002364,172.31.40.0-255,66,168198,69,308463
4177,0.002417,172.31.40.0-255,66,168264,69,308463
4178,0.00243,172.31.40.0-255,66,168330,69,308463
4179,0.002489,172.217.194.0-255,1484,169814,69,308463
4180,0.002493,172.217.194.0-255,1484,171298,69,308463
4181,0.002496,172.31.40.0-255,66,171364,69,308463
4182,0.00251,172.217.194.0-255,1484,172848,69,308463
4183,0.002521,172.217.194.0-255,5738,178586,69,308463
4184,0.002523,172.31.40.0-255,66,178652,69,308463
4185,0.002529,172.217.194.0-255,4320,182972,69,308463
4186,0.002531,172.31.40.0-255,66,183038,69,308463
4187,0.002579,172.31.40.0-255,66,183104,69,308463
4188,0.002591,172.31.40.0-255,66,183170,69,308463
4189,0.005145,172.217.194.0-255,5738,188908,69,308463
4190,0.005154,172.31.40.0-255,66,188974,69,308463
4191,0.007718,172.217.194.0-255,5738,194712,69,308463
4192,0.007723,172.31.40.0-255,66,194778,69,308463
4193,0.010301,172.217.194.0-255,5738,200516,69,308463
4194,0.010308,172.31.40.0-255,66,200582,69,308463
4195,0.012888,172.217.194.0-255,5738,206320,69,308463
4196,0.012897,172.31.40.0-255,66,206386,69,308463
4197,0.01547,172.217.194.0-255,5738,212124,69,308463
4198,0.015477,172.31.40.0-255,66,212190,69,308463
4199,0.018028,172.217.194.0-255,5738,217928,69,308463
4200,0.018036,172.31.40.0-255,66,217994,69,308463
4201,0.020617,172.217.194.0-255,5738,223732,69,308463
4202,0.020628,172.31.40.0-255,66,223798,69,308463
4203,0.023247,172.217.194.0-255,5738,229536,69,308463
4204,0.023255,172.31.40.0-255,66,229602,69,308463
4205,0.025834,172.217.194.0-255,5738,235340,69,308463
4206,0.025841,172.31.40.0-255,66,235406,69,308463
4207,0.028408,172.217.194.0-255,5738,241144,69,308463
4208,0.028414,172.31.40.0-255,66,241210,69,308463
4209,0.030993,172.217.194.0-255,5738,246948,69,308463
4210,0.031001,172.31.40.0-255,66,247014,69,308463
4211,0.033594,172.217.194.0-255,5738,252752,69,308463
4212,0.033601,172.31.40.0-255,66,252818,69,308463
4213,0.036155,172.217.194.0-255,5738,258556,69,308463
4214,0.036163,172.31.40.0-255,66,258622,69,308463
4215,0.038744,172.217.194.0-255,5738,264360,69,308463
4216,0.038757,172.31.40.0-255,66,264426,69,308463
4217,0.041335,172.217.194.0-255,5738,270164,69,308463
4218,0.041343,172.31.40.0-255,66,270230,69,308463
4219,0.043806,172.31.40.0-255,172,270402,69,308463
4220,0.043838,172.31.40.0-255,1114,271516,69,308463
4221,0.043905,172.217.194.0-255,5738,277254,69,308463
4222,0.043912,172.31.40.0-255,66,277320,69,308463
4223,0.043938,172.31.40.0-255,1514,278834,69,308463
4224,0.043958,172.31.40.0-255,1514,280348,69,308463
4225,0.043961,172.31.40.0-255,1514,281862,69,308463
4226,0.043977,172.31.40.0-255,1514,283376,69,308463
4227,0.043997,172.31.40.0-255,1502,284878,69,308463
4228,0.045371,104.244.42.0-255,66,284944,69,308463
4229,0.045393,104.244.42.0-255,66,285010,69,308463
4230,0.045466,104.244.42.0-255,66,285076,69,308463
4231,0.045598,104.244.42.0-255,66,285142,69,308463
4232,0.045678,104.244.42.0-255,66,285208,69,308463
4233,0.046494,172.217.194.0-255,5738,290946,69,308463
4234,0.046501,172.31.40.0-255,66,291012,69,308463
4235,0.049088,172.217.194.0-255,5738,296750,69,308463
4236,0.049095,172.31.40.0-255,66,296816,69,308463
4237,0.051697,172.217.194.0-255,5738,302554,69,308463
4238,0.051705,172.31.40.0-255,66,302620,69,308463
4239,0.054279,172.217.194.0-255,5606,308226,69,308463
4240,0.054286,172.31.40.0-255,66,308292,69,308463
4241,0.05448,172.31.40.0-255,105,308397,69,308463
4242,0.057011,172.217.194.0-255,66,308463,69,308463
4243,0.0,172.217.194.0-255,167,167,69,161644
4244,2.8e-05,172.31.40.0-255,66,233,69,161644
4245,3.6e-05,172.217.194.0-255,1484,1717,69,161644
4246,4.1e-05,172.31.40.0-255,66,1783,69,161644
4247,5.5e-05,172.217.194.0-255,2902,4685,69,161644
4248,5.9e-05,172.31.40.0-255,66,4751,69,161644
4249,6.7e-05,172.217.194.0-255,7156,11907,69,161644
4250,7e-05,172.31.40.0-255,66,11973,69,161644
4251,0.000116,172.217.194.0-255,2056,14029,69,161644
4252,0.00012,172.31.40.0-255,66,14095,69,161644
4253,0.000126,172.217.194.0-255,2902,16997,69,161644
4254,0.000129,172.31.40.0-255,66,17063,69,161644
4255,0.000158,172.217.194.0-255,7156,24219,69,161644
4256,0.000161,172.31.40.0-255,66,24285,69,161644
4257,0.000236,172.217.194.0-255,4320,28605,69,161644
4258,0.000239,172.31.40.0-255,66,28671,69,161644
4259,0.000266,172.217.194.0-255,2543,31214,69,161644
4260,0.000269,172.31.40.0-255,66,31280,69,161644
4261,0.000302,172.217.194.0-255,2902,34182,69,161644
4262,0.000304,172.31.40.0-255,66,34248,69,161644
4263,0.000332,172.217.194.0-255,4320,38568,69,161644
4264,0.000335,172.31.40.0-255,66,38634,69,161644
4265,0.000391,172.217.194.0-255,5738,44372,69,161644
4266,0.000394,172.31.40.0-255,66,44438,69,161644
4267,0.000428,172.31.40.0-255,66,44504,69,161644
4268,0.000584,172.31.40.0-255,66,44570,69,161644
4269,0.000603,172.217.194.0-255,2832,47402,69,161644
4270,0.000606,172.31.40.0-255,66,47468,69,161644
4271,0.000652,172.217.194.0-255,398,47866,69,161644
4272,0.000655,172.31.40.0-255,66,47932,69,161644
4273,0.000686,172.217.194.0-255,1484,49416,69,161644
4274,0.000703,172.217.194.0-255,4320,53736,69,161644
4275,0.000723,172.217.194.0-255,4320,58056,69,161644
4276,0.00074,172.217.194.0-255,4320,62376,69,161644
4277,0.000758,172.31.40.0-255,66,62442,69,161644
4278,0.000853,172.217.194.0-255,4320,66762,69,161644
4279,0.000869,172.217.194.0-255,5738,72500,69,161644
4280,0.000884,172.31.40.0-255,66,72566,69,161644
4281,0.000893,172.217.194.0-255,7156,79722,69,161644
4282,0.000907,172.31.40.0-255,66,79788,69,161644
4283,0.000911,172.217.194.0-255,2184,81972,69,161644
4284,0.000934,172.31.40.0-255,66,82038,69,161644
4285,0.001056,172.217.194.0-255,2902,84940,69,161644
4286,0.001077,172.31.40.0-255,66,85006,69,161644
4287,0.001145,172.31.40.0-255,66,85072,69,161644
4288,0.001367,172.217.194.0-255,7156,92228,69,161644
4289,0.001382,172.31.40.0-255,66,92294,69,161644
4290,0.00145,172.31.40.0-255,66,92360,69,161644
4291,0.001808,172.217.194.0-255,2902,95262,69,161644
4292,0.001814,172.31.40.0-255,66,95328,69,161644
4293,0.001836,172.217.194.0-255,7156,102484,69,161644
4294,0.001875,172.31.40.0-255,66,102550,69,161644
4295,0.001901,172.31.40.0-255,66,102616,69,161644
4296,0.002183,172.217.194.0-255,5738,108354,69,161644
4297,0.002187,172.31.40.0-255,66,108420,69,161644
4298,0.002261,172.31.40.0-255,66,108486,69,161644
4299,0.002917,172.217.194.0-255,7156,115642,69,161644
4300,0.003643,172.217.194.0-255,4320,119962,69,161644
4301,0.00367,172.217.194.0-255,7156,127118,69,161644
4302,0.003712,172.217.194.0-255,7156,134274,69,161644
4303,0.008551,172.31.40.0-255,66,134340,69,161644
4304,0.011052,172.217.194.0-255,5738,140078,69,161644
4305,0.011065,172.31.40.0-255,66,140144,69,161644
4306,0.0136,172.217.194.0-255,5738,145882,69,161644
4307,0.013613,172.31.40.0-255,66,145948,69,161644
4308,0.0161,172.217.194.0-255,5738,151686,69,161644
4309,0.016108,172.31.40.0-255,66,151752,69,161644
4310,0.018543,172.217.194.0-255,613,152365,69,161644
4311,0.020986,172.31.40.0-255,66,152431,69,161644
4312,0.021041,172.31.40.0-255,105,152536,69,161644
4313,0.023465,172.217.194.0-255,66,152602,69,161644
4314,0.049649,172.31.40.0-255,172,152774,69,161644
4315,0.049685,172.31.40.0-255,1116,153890,69,161644
4316,0.049756,172.31.40.0-255,1514,155404,69,161644
4317,0.049758,172.31.40.0-255,1514,156918,69,161644
4318,0.049759,172.31.40.0-255,1514,158432,69,161644
4319,0.04976,172.31.40.0-255,1514,159946,69,161644
4320,0.04979,172.31.40.0-255,1500,161446,69,161644
4321,0.051366,104.244.42.0-255,66,161512,69,161644
4322,0.05141,104.244.42.0-255,66,161578,69,161644
4323,0.051494,104.244.42.0-255,66,161644,69,161644
4324,0.0,74.125.24.0-255,150,150,69,335190
4325,1.5e-05,172.31.40.0-255,66,216,69,335190
4326,3.6e-05,74.125.24.0-255,1484,1700,69,335190
4327,4.1e-05,172.31.40.0-255,66,1766,69,335190
4328,4.6e-05,74.125.24.0-255,2902,4668,69,335190
4329,4.9e-05,172.31.40.0-255,66,4734,69,335190
4330,5.4e-05,74.125.24.0-255,2902,7636,69,335190
4331,5.8e-05,172.31.40.0-255,66,7702,69,335190
4332,7.9e-05,74.125.24.0-255,4320,12022,69,335190
4333,8.2e-05,172.31.40.0-255,66,12088,69,335190
4334,9.7e-05,74.125.24.0-255,2062,14150,69,335190
4335,0.0001,172.31.40.0-255,66,14216,69,335190
4336,0.000158,74.125.24.0-255,1484,15700,69,335190
4337,0.00016,172.31.40.0-255,66,15766,69,335190
4338,0.000163,74.125.24.0-255,1484,17250,69,335190
4339,0.000165,172.31.40.0-255,66,17316,69,335190
4340,0.00018,74.125.24.0-255,1484,18800,69,335190
4341,0.000182,172.31.40.0-255,66,18866,69,335190
4342,0.000188,74.125.24.0-255,5738,24604,69,335190
4343,0.00019,172.31.40.0-255,66,24670,69,335190
4344,0.000195,74.125.24.0-255,5738,30408,69,335190
4345,0.000198,172.31.40.0-255,66,30474,69,335190
4346,0.000234,74.125.24.0-255,1484,31958,69,335190
4347,0.000237,172.31.40.0-255,66,32024,69,335190
4348,0.000269,172.31.40.0-255,66,32090,69,335190
4349,0.000274,74.125.24.0-255,3961,36051,69,335190
4350,0.000275,172.31.40.0-255,66,36117,69,335190
4351,0.0003,74.125.24.0-255,4320,40437,69,335190
4352,0.000302,172.31.40.0-255,66,40503,69,335190
4353,0.000305,74.125.24.0-255,1484,41987,69,335190
4354,0.000306,172.31.40.0-255,66,42053,69,335190
4355,0.000324,74.125.24.0-255,4320,46373,69,335190
4356,0.000326,172.31.40.0-255,66,46439,69,335190
4357,0.000362,74.125.24.0-255,6797,53236,69,335190
4358,0.000365,172.31.40.0-255,66,53302,69,335190
4359,0.000573,74.125.24.0-255,414,53716,69,335190
4360,0.000629,74.125.24.0-255,328,54044,69,335190
4361,0.00093,172.31.40.0-255,66,54110,69,335190
4362,0.001161,74.125.24.0-255,1484,55594,69,335190
4363,0.00117,74.125.24.0-255,2902,58496,69,335190
4364,0.001174,172.31.40.0-255,66,58562,69,335190
4365,0.001182,74.125.24.0-255,5738,64300,69,335190
4366,0.001185,172.31.40.0-255,66,64366,69,335190
4367,0.001228,172.31.40.0-255,66,64432,69,335190
4368,0.001235,74.125.24.0-255,5738,70170,69,335190
4369,0.001237,172.31.40.0-255,66,70236,69,335190
4370,0.001255,74.125.24.0-255,5020,75256,69,335190
4371,0.001258,172.31.40.0-255,66,75322,69,335190
4372,0.001897,74.125.24.0-255,1484,76806,69,335190
4373,0.001906,74.125.24.0-255,2902,79708,69,335190
4374,0.00191,172.31.40.0-255,66,79774,69,335190
4375,0.001919,74.125.24.0-255,5738,85512,69,335190
4376,0.001921,172.31.40.0-255,66,85578,69,335190
4377,0.001955,172.31.40.0-255,66,85644,69,335190
4378,0.001984,172.31.40.0-255,66,85710,69,335190
4379,0.002018,74.125.24.0-255,1484,87194,69,335190
4380,0.002022,74.125.24.0-255,1484,88678,69,335190
4381,0.002024,172.31.40.0-255,66,88744,69,335190
4382,0.002047,74.125.24.0-255,1484,90228,69,335190
4383,0.002053,74.125.24.0-255,5738,95966,69,335190
4384,0.002056,172.31.40.0-255,66,96032,69,335190
4385,0.002114,172.31.40.0-255,66,96098,69,335190
4386,0.002117,74.125.24.0-255,1484,97582,69,335190
4387,0.002133,74.125.24.0-255,1484,99066,69,335190
4388,0.002136,172.31.40.0-255,66,99132,69,335190
4389,0.002165,172.31.40.0-255,66,99198,69,335190
4390,0.002206,172.31.40.0-255,66,99264,69,335190
4391,0.00221,74.125.24.0-255,2902,102166,69,335190
4392,0.002212,172.31.40.0-255,66,102232,69,335190
4393,0.002232,172.31.40.0-255,66,102298,69,335190
4394,0.002235,74.125.24.0-255,1484,103782,69,335190
4395,0.004431,74.125.24.0-255,4320,108102,69,335190
4396,0.004436,172.31.40.0-255,66,108168,69,335190
4397,0.006615,74.125.24.0-255,1484,109652,69,335190
4398,0.006638,74.125.24.0-255,4320,113972,69,335190
4399,0.006642,172.31.40.0-255,66,114038,69,335190
4400,0.008839,74.125.24.0-255,5738,119776,69,335190
4401,0.008846,172.31.40.0-255,66,119842,69,335190
4402,0.011053,74.125.24.0-255,5738,125580,69,335190
4403,0.01106,172.31.40.0-255,66,125646,69,335190
4404,0.013247,74.125.24.0-255,5738,131384,69,335190
4405,0.013254,172.31.40.0-255,66,131450,69,335190
4406,0.015534,74.125.24.0-255,5738,137188,69,335190
4407,0.015541,172.31.40.0-255,66,137254,69,335190
4408,0.017756,74.125.24.0-255,5738,142992,69,335190
4409,0.017772,172.31.40.0-255,66,143058,69,335190
4410,0.019981,74.125.24.0-255,5738,148796,69,335190
4411,0.019988,172.31.40.0-255,66,148862,69,335190
4412,0.022188,74.125.24.0-255,5738,154600,69,335190
4413,0.022196,172.31.40.0-255,66,154666,69,335190
4414,0.024405,74.125.24.0-255,5738,160404,69,335190
4415,0.024412,172.31.40.0-255,66,160470,69,335190
4416,0.026611,74.125.24.0-255,5738,166208,69,335190
4417,0.026618,172.31.40.0-255,66,166274,69,335190
4418,0.028819,74.125.24.0-255,5738,172012,69,335190
4419,0.028827,172.31.40.0-255,66,172078,69,335190
4420,0.031003,74.125.24.0-255,5738,177816,69,335190
4421,0.03101,172.31.40.0-255,66,177882,69,335190
4422,0.033224,74.125.24.0-255,5738,183620,69,335190
4423,0.033231,172.31.40.0-255,66,183686,69,335190
4424,0.035451,74.125.24.0-255,5738,189424,69,335190
4425,0.035458,172.31.40.0-255,66,189490,69,335190
4426,0.036828,172.31.40.0-255,172,189662,69,335190
4427,0.036863,172.31.40.0-255,1114,190776,69,335190
4428,0.036925,172.31.40.0-255,1514,192290,69,335190
4429,0.036926,172.31.40.0-255,1514,193804,69,335190
4430,0.036928,172.31.40.0-255,1514,195318,69,335190
4431,0.036929,172.31.40.0-255,1514,196832,69,335190
4432,0.036957,172.31.40.0-255,1502,198334,69,335190
4433,0.037669,74.125.24.0-255,5738,204072,69,335190
4434,0.037676,172.31.40.0-255,66,204138,69,335190
4435,0.038482,104.244.42.0-255,66,204204,69,335190
4436,0.0385,104.244.42.0-255,66,204270,69,335190
4437,0.038588,104.244.42.0-255,66,204336,69,335190
4438,0.038733,104.244.42.0-255,66,204402,69,335190
4439,0.039879,74.125.24.0-255,5738,210140,69,335190
4440,0.039886,172.31.40.0-255,66,210206,69,335190
4441,0.042081,74.125.24.0-255,5738,215944,69,335190
4442,0.042087,172.31.40.0-255,66,216010,69,335190
4443,0.044267,74.125.24.0-255,5738,221748,69,335190
4444,0.044273,172.31.40.0-255,66,221814,69,335190
4445,0.046495,74.125.24.0-255,5738,227552,69,335190
4446,0.046504,172.31.40.0-255,66,227618,69,335190
4447,0.048712,74.125.24.0-255,4320,231938,69,335190
4448,0.048719,172.31.40.0-255,66,232004,69,335190
4449,0.048738,74.125.24.0-255,1484,233488,69,335190
4450,0.050924,74.125.24.0-255,4320,237808,69,335190
4451,0.05093,172.31.40.0-255,66,237874,69,335190
4452,0.053173,74.125.24.0-255,5738,243612,69,335190
4453,0.05318,172.31.40.0-255,66,243678,69,335190
4454,0.055404,74.125.24.0-255,5738,249416,69,335190
4455,0.055411,172.31.40.0-255,66,249482,69,335190
4456,0.057608,74.125.24.0-255,5738,255220,69,335190
4457,0.057614,172.31.40.0-255,66,255286,69,335190
4458,0.059832,74.125.24.0-255,5738,261024,69,335190
4459,0.059839,172.31.40.0-255,66,261090,69,335190
4460,0.062061,74.125.24.0-255,5738,266828,69,335190
4461,0.062066,172.31.40.0-255,66,266894,69,335190
4462,0.064262,74.125.24.0-255,5738,272632,69,335190
4463,0.064268,172.31.40.0-255,66,272698,69,335190
4464,0.066457,74.125.24.0-255,5738,278436,69,335190
4465,0.066464,172.31.40.0-255,66,278502,69,335190
4466,0.068672,74.125.24.0-255,4320,282822,69,335190
4467,0.068677,172.31.40.0-255,66,282888,69,335190
4468,0.068696,74.125.24.0-255,1484,284372,69,335190
4469,0.070902,74.125.24.0-255,4320,288692,69,335190
4470,0.070909,172.31.40.0-255,66,288758,69,335190
4471,0.073093,74.125.24.0-255,5738,294496,69,335190
4472,0.0731,172.31.40.0-255,66,294562,69,335190
4473,0.075294,74.125.24.0-255,5738,300300,69,335190
4474,0.075299,172.31.40.0-255,66,300366,69,335190
4475,0.077528,74.125.24.0-255,5738,306104,69,335190
4476,0.077535,172.31.40.0-255,66,306170,69,335190
4477,0.079761,74.125.24.0-255,5738,311908,69,335190
4478,0.079766,172.31.40.0-255,66,311974,69,335190
4479,0.081972,74.125.24.0-255,5738,317712,69,335190
4480,0.081979,172.31.40.0-255,66,317778,69,335190
4481,0.084218,74.125.24.0-255,5738,323516,69,335190
4482,0.084229,172.31.40.0-255,66,323582,69,335190
4483,0.086443,74.125.24.0-255,5738,329320,69,335190
4484,0.08645,172.31.40.0-255,66,329386,69,335190
4485,0.088651,74.125.24.0-255,5738,335124,69,335190
4486,0.08866,172.31.40.0-255,66,335190,69,335190
4487,0.0,172.217.194.0-255,146,146,69,135029
4488,2.1e-05,172.31.40.0-255,66,212,69,135029
4489,2.9e-05,172.217.194.0-255,1484,1696,69,135029
4490,3.4e-05,172.31.40.0-255,66,1762,69,135029
4491,4e-05,172.217.194.0-255,2902,4664,69,135029
4492,5.1e-05,172.31.40.0-255,66,4730,69,135029
4493,5.7e-05,172.217.194.0-255,5738,10468,69,135029
4494,6.2e-05,172.31.40.0-255,66,10534,69,135029
4495,7.6e-05,172.31.40.0-255,66,10600,69,135029
4496,8.8e-05,172.31.40.0-255,66,10666,69,135029
4497,0.000127,172.217.194.0-255,1484,12150,69,135029
4498,0.00013,172.31.40.0-255,66,12216,69,135029
4499,0.000135,172.217.194.0-255,2902,15118,69,135029
4500,0.000137,172.31.40.0-255,66,15184,69,135029
4501,0.000144,172.217.194.0-255,5738,20922,69,135029
4502,0.000147,172.31.40.0-255,66,20988,69,135029
4503,0.000177,172.217.194.0-255,7156,28144,69,135029
4504,0.00018,172.31.40.0-255,66,28210,69,135029
4505,0.000212,172.217.194.0-255,6797,35007,69,135029
4506,0.000214,172.31.40.0-255,66,35073,69,135029
4507,0.000226,172.31.40.0-255,66,35139,69,135029
4508,0.000233,172.217.194.0-255,398,35537,69,135029
4509,0.000236,172.31.40.0-255,66,35603,69,135029
4510,0.000328,172.217.194.0-255,1484,37087,69,135029
4511,0.000332,172.31.40.0-255,66,37153,69,135029
4512,0.000337,172.217.194.0-255,2902,40055,69,135029
4513,0.000339,172.31.40.0-255,66,40121,69,135029
4514,0.000345,172.217.194.0-255,4320,44441,69,135029
4515,0.000352,172.31.40.0-255,66,44507,69,135029
4516,0.000391,172.217.194.0-255,1484,45991,69,135029
4517,0.000407,172.31.40.0-255,66,46057,69,135029
4518,0.000419,172.31.40.0-255,66,46123,69,135029
4519,0.00058,172.217.194.0-255,1484,47607,69,135029
4520,0.000601,172.217.194.0-255,2902,50509,69,135029
4521,0.000606,172.31.40.0-255,66,50575,69,135029
4522,0.000613,172.217.194.0-255,5738,56313,69,135029
4523,0.000615,172.31.40.0-255,66,56379,69,135029
4524,0.000628,172.217.194.0-255,7156,63535,69,135029
4525,0.00063,172.31.40.0-255,66,63601,69,135029
4526,0.000671,172.217.194.0-255,5738,69339,69,135029
4527,0.000675,172.31.40.0-255,66,69405,69,135029
4528,0.000688,172.31.40.0-255,66,69471,69,135029
4529,0.000701,172.31.40.0-255,66,69537,69,135029
4530,0.000713,172.31.40.0-255,66,69603,69,135029
4531,0.000782,172.31.40.0-255,66,69669,69,135029
4532,0.001091,172.217.194.0-255,1484,71153,69,135029
4533,0.001098,172.217.194.0-255,2902,74055,69,135029
4534,0.001101,172.31.40.0-255,66,74121,69,135029
4535,0.001106,172.217.194.0-255,2902,77023,69,135029
4536,0.001108,172.31.40.0-255,66,77089,69,135029
4537,0.001152,172.217.194.0-255,2902,79991,69,135029
4538,0.001154,172.31.40.0-255,66,80057,69,135029
4539,0.001169,172.31.40.0-255,66,80123,69,135029
4540,0.001181,172.31.40.0-255,66,80189,69,135029
4541,0.001308,172.217.194.0-255,1484,81673,69,135029
4542,0.001328,172.217.194.0-255,2902,84575,69,135029
4543,0.001332,172.31.40.0-255,66,84641,69,135029
4544,0.001338,172.217.194.0-255,2902,87543,69,135029
4545,0.00134,172.31.40.0-255,66,87609,69,135029
4546,0.00136,172.217.194.0-255,2902,90511,69,135029
4547,0.001362,172.31.40.0-255,66,90577,69,135029
4548,0.001368,172.217.194.0-255,4320,94897,69,135029
4549,0.00137,172.31.40.0-255,66,94963,69,135029
4550,0.001403,172.217.194.0-255,4320,99283,69,135029
4551,0.001406,172.31.40.0-255,66,99349,69,135029
4552,0.001422,172.31.40.0-255,66,99415,69,135029
4553,0.001435,172.31.40.0-255,66,99481,69,135029
4554,0.00146,172.217.194.0-255,2902,102383,69,135029
4555,0.001463,172.31.40.0-255,66,102449,69,135029
4556,0.001468,172.217.194.0-255,2902,105351,69,135029
4557,0.00147,172.31.40.0-255,66,105417,69,135029
4558,0.001526,172.31.40.0-255,66,105483,69,135029
4559,0.001533,172.217.194.0-255,7156,112639,69,135029
4560,0.001535,172.31.40.0-255,66,112705,69,135029
4561,0.001581,172.31.40.0-255,66,112771,69,135029
4562,0.001587,172.217.194.0-255,4320,117091,69,135029
4563,0.001589,172.31.40.0-255,66,117157,69,135029
4564,0.001679,172.217.194.0-255,1484,118641,69,135029
4565,0.001737,172.31.40.0-255,66,118707,69,135029
4566,0.00174,172.31.40.0-255,66,118773,69,135029
4567,0.001743,172.31.40.0-255,66,118839,69,135029
4568,0.001788,172.31.40.0-255,66,118905,69,135029
4569,0.001795,172.217.194.0-255,6673,125578,69,135029
4570,0.001799,172.31.40.0-255,66,125644,69,135029
4571,0.001801,172.217.194.0-255,105,125749,69,135029
4572,0.009423,172.31.40.0-255,66,125815,69,135029
4573,0.009461,172.31.40.0-255,105,125920,69,135029
4574,0.011892,172.217.194.0-255,66,125986,69,135029
4575,0.036567,172.31.40.0-255,172,126158,69,135029
4576,0.036601,172.31.40.0-255,1112,127270,69,135029
4577,0.036668,172.31.40.0-255,1514,128784,69,135029
4578,0.03667,172.31.40.0-255,1514,130298,69,135029
4579,0.036671,172.31.40.0-255,1514,131812,69,135029
4580,0.036676,172.31.40.0-255,1514,133326,69,135029
4581,0.036678,172.31.40.0-255,1505,134831,69,135029
4582,0.038249,104.244.42.0-255,66,134897,69,135029
4583,0.038275,104.244.42.0-255,66,134963,69,135029
4584,0.038342,104.244.42.0-255,66,135029,69,135029
4585,0.0,172.217.194.0-255,146,146,69,250596
4586,1.4e-05,172.31.40.0-255,66,212,69,250596
4587,2.1e-05,172.217.194.0-255,1484,1696,69,250596
4588,2.5e-05,172.31.40.0-255,66,1762,69,250596
4589,3.9e-05,172.217.194.0-255,2902,4664,69,250596
4590,4.3e-05,172.31.40.0-255,66,4730,69,250596
4591,4.6e-05,172.217.194.0-255,1484,6214,69,250596
4592,4.8e-05,172.31.40.0-255,66,6280,69,250596
4593,5.5e-05,172.217.194.0-255,5738,12018,69,250596
4594,5.8e-05,172.31.40.0-255,66,12084,69,250596
4595,7.7e-05,172.217.194.0-255,5738,17822,69,250596
4596,8e-05,172.31.40.0-255,66,17888,69,250596
4597,0.000117,172.31.40.0-255,66,17954,69,250596
4598,0.000124,172.217.194.0-255,5379,23333,69,250596
4599,0.000126,172.31.40.0-255,66,23399,69,250596
4600,0.000167,172.217.194.0-255,1484,24883,69,250596
4601,0.00017,172.31.40.0-255,66,24949,69,250596
4602,0.000174,172.217.194.0-255,2902,27851,69,250596
4603,0.000177,172.31.40.0-255,66,27917,69,250596
4604,0.000212,172.217.194.0-255,5738,33655,69,250596
4605,0.000215,172.31.40.0-255,66,33721,69,250596
4606,0.000226,172.31.40.0-255,66,33787,69,250596
4607,0.000254,172.217.194.0-255,3961,37748,69,250596
4608,0.000257,172.31.40.0-255,66,37814,69,250596
4609,0.000274,172.31.40.0-255,66,37880,69,250596
4610,0.000276,172.217.194.0-255,377,38257,69,250596
4611,0.000278,172.31.40.0-255,66,38323,69,250596
4612,0.000315,172.217.194.0-255,98,38421,69,250596
4613,0.000318,172.31.40.0-255,66,38487,69,250596
4614,0.000396,172.217.194.0-255,1484,39971,69,250596
4615,0.000403,172.217.194.0-255,2902,42873,69,250596
4616,0.000405,172.31.40.0-255,66,42939,69,250596
4617,0.000413,172.217.194.0-255,5738,48677,69,250596
4618,0.000416,172.31.40.0-255,66,48743,69,250596
4619,0.000442,172.217.194.0-255,2902,51645,69,250596
4620,0.000446,172.31.40.0-255,66,51711,69,250596
4621,0.000478,172.217.194.0-255,4261,55972,69,250596
4622,0.000481,172.31.40.0-255,66,56038,69,250596
4623,0.000594,172.217.194.0-255,1484,57522,69,250596
4624,0.0006,172.217.194.0-255,2902,60424,69,250596
4625,0.000603,172.31.40.0-255,66,60490,69,250596
4626,0.000609,172.217.194.0-255,5738,66228,69,250596
4627,0.000612,172.31.40.0-255,66,66294,69,250596
4628,0.000651,172.31.40.0-255,66,66360,69,250596
4629,0.000661,172.31.40.0-255,66,66426,69,250596
4630,0.000693,172.217.194.0-255,1634,68060,69,250596
4631,0.000696,172.31.40.0-255,66,68126,69,250596
4632,0.000778,172.217.194.0-255,1484,69610,69,250596
4633,0.000785,172.217.194.0-255,2902,72512,69,250596
4634,0.000789,172.31.40.0-255,66,72578,69,250596
4635,0.000796,172.217.194.0-255,5738,78316,69,250596
4636,0.000799,172.31.40.0-255,66,78382,69,250596
4637,0.000807,172.217.194.0-255,1484,79866,69,250596
4638,0.000811,172.217.194.0-255,2902,82768,69,250596
4639,0.000814,172.31.40.0-255,66,82834,69,250596
4640,0.000854,172.31.40.0-255,66,82900,69,250596
4641,0.000865,172.31.40.0-255,66,82966,69,250596
4642,0.000882,172.31.40.0-255,66,83032,69,250596
4643,0.000911,172.217.194.0-255,6797,89829,69,250596
4644,0.000918,172.31.40.0-255,66,89895,69,250596
4645,0.000957,172.217.194.0-255,1484,91379,69,250596
4646,0.000961,172.217.194.0-255,2902,94281,69,250596
4647,0.000964,172.31.40.0-255,66,94347,69,250596
4648,0.00097,172.217.194.0-255,5738,100085,69,250596
4649,0.000972,172.31.40.0-255,66,100151,69,250596
4650,0.001053,172.31.40.0-255,66,100217,69,250596
4651,0.00107,172.31.40.0-255,66,100283,69,250596
4652,0.001206,172.217.194.0-255,1484,101767,69,250596
4653,0.001212,172.217.194.0-255,2902,104669,69,250596
4654,0.001215,172.31.40.0-255,66,104735,69,250596
4655,0.001219,172.217.194.0-255,1484,106219,69,250596
4656,0.001245,172.217.194.0-255,4320,110539,69,250596
4657,0.001247,172.31.40.0-255,66,110605,69,250596
4658,0.001264,172.217.194.0-255,4320,114925,69,250596
4659,0.001277,172.31.40.0-255,66,114991,69,250596
4660,0.001296,172.217.194.0-255,6438,121429,69,250596
4661,0.001306,172.31.40.0-255,66,121495,69,250596
4662,0.001618,172.217.194.0-255,1484,122979,69,250596
4663,0.001623,172.217.194.0-255,2902,125881,69,250596
4664,0.001627,172.31.40.0-255,66,125947,69,250596
4665,0.001632,172.217.194.0-255,2902,128849,69,250596
4666,0.001652,172.31.40.0-255,66,128915,69,250596
4667,0.001657,172.217.194.0-255,2902,131817,69,250596
4668,0.001661,172.217.194.0-255,4320,136137,69,250596
4669,0.001683,172.31.40.0-255,66,136203,69,250596
4670,0.001749,172.31.40.0-255,66,136269,69,250596
4671,0.001782,172.217.194.0-255,1484,137753,69,250596
4672,0.001789,172.217.194.0-255,5738,143491,69,250596
4673,0.001795,172.217.194.0-255,6438,149929,69,250596
4674,0.001798,172.31.40.0-255,66,149995,69,250596
4675,0.00184,172.31.40.0-255,66,150061,69,250596
4676,0.001907,172.217.194.0-255,1484,151545,69,250596
4677,0.001912,172.217.194.0-255,2902,154447,69,250596
4678,0.001927,172.217.194.0-255,5738,160185,69,250596
4679,0.001941,172.31.40.0-255,66,160251,69,250596
4680,0.001945,172.217.194.0-255,1484,161735,69,250596
4681,0.001983,172.31.40.0-255,66,161801,69,250596
4682,0.002027,172.31.40.0-255,66,161867,69,250596
4683,0.004035,172.217.194.0-255,5738,167605,69,250596
4684,0.00404,172.31.40.0-255,66,167671,69,250596
4685,0.006083,172.217.194.0-255,5738,173409,69,250596
4686,0.006089,172.31.40.0-255,66,173475,69,250596
4687,0.008148,172.217.194.0-255,5738,179213,69,250596
4688,0.008155,172.31.40.0-255,66,179279,69,250596
4689,0.010216,172.217.194.0-255,5738,185017,69,250596
4690,0.010221,172.31.40.0-255,66,185083,69,250596
4691,0.012243,172.217.194.0-255,5738,190821,69,250596
4692,0.01225,172.31.40.0-255,66,190887,69,250596
4693,0.014264,172.217.194.0-255,5738,196625,69,250596
4694,0.014271,172.31.40.0-255,66,196691,69,250596
4695,0.016276,172.217.194.0-255,5738,202429,69,250596
4696,0.016283,172.31.40.0-255,66,202495,69,250596
4697,0.018346,172.217.194.0-255,5738,208233,69,250596
4698,0.018353,172.31.40.0-255,66,208299,69,250596
4699,0.020383,172.217.194.0-255,5738,214037,69,250596
4700,0.020391,172.31.40.0-255,66,214103,69,250596
4701,0.022398,172.217.194.0-255,5738,219841,69,250596
4702,0.022408,172.31.40.0-255,66,219907,69,250596
4703,0.024429,172.217.194.0-255,5738,225645,69,250596
4704,0.024435,172.31.40.0-255,66,225711,69,250596
4705,0.026468,172.217.194.0-255,5738,231449,69,250596
4706,0.026474,172.31.40.0-255,66,231515,69,250596
4707,0.02853,172.217.194.0-255,5738,237253,69,250596
4708,0.028537,172.31.40.0-255,66,237319,69,250596
4709,0.030587,172.217.194.0-255,4889,242208,69,250596
4710,0.030594,172.31.40.0-255,66,242274,69,250596
4711,0.03091,172.31.40.0-255,105,242379,69,250596
4712,0.031813,172.31.40.0-255,172,242551,69,250596
4713,0.031844,172.31.40.0-255,1111,243662,69,250596
4714,0.031909,172.31.40.0-255,1514,245176,69,250596
4715,0.031911,172.31.40.0-255,1514,246690,69,250596
4716,0.031912,172.31.40.0-255,1514,248204,69,250596
4717,0.031913,172.31.40.0-255,1514,249718,69,250596
4718,0.031914,172.31.40.0-255,548,250266,69,250596
4719,0.032924,172.217.194.0-255,66,250332,69,250596
4720,0.03334,104.244.42.0-255,66,250398,69,250596
4721,0.033353,104.244.42.0-255,66,250464,69,250596
4722,0.03346,104.244.42.0-255,66,250530,69,250596
4723,0.033464,104.244.42.0-255,66,250596,69,250596
4724,0.0,74.125.24.0-255,147,147,69,327666
4725,2e-05,172.31.40.0-255,66,213,69,327666
4726,2.6e-05,74.125.24.0-255,1484,1697,69,327666
4727,3.1e-05,172.31.40.0-255,66,1763,69,327666
4728,3.7e-05,74.125.24.0-255,2902,4665,69,327666
4729,4e-05,172.31.40.0-255,66,4731,69,327666
4730,4.8e-05,74.125.24.0-255,7156,11887,69,327666
4731,5e-05,172.31.40.0-255,66,11953,69,327666
4732,9.4e-05,172.31.40.0-255,66,12019,69,327666
4733,9.7e-05,74.125.24.0-255,1484,13503,69,327666
4734,9.9e-05,172.31.40.0-255,66,13569,69,327666
4735,0.000121,74.125.24.0-255,7156,20725,69,327666
4736,0.000123,172.31.40.0-255,66,20791,69,327666
4737,0.000126,74.125.24.0-255,2543,23334,69,327666
4738,0.000128,172.31.40.0-255,66,23400,69,327666
4739,0.000249,74.125.24.0-255,1484,24884,69,327666
4740,0.000253,172.31.40.0-255,66,24950,69,327666
4741,0.000257,74.125.24.0-255,1484,26434,69,327666
4742,0.000258,172.31.40.0-255,66,26500,69,327666
4743,0.000272,74.125.24.0-255,1484,27984,69,327666
4744,0.000275,172.31.40.0-255,66,28050,69,327666
4745,0.00029,74.125.24.0-255,1484,29534,69,327666
4746,0.000292,172.31.40.0-255,66,29600,69,327666
4747,0.000305,74.125.24.0-255,4320,33920,69,327666
4748,0.000307,172.31.40.0-255,66,33986,69,327666
4749,0.000328,74.125.24.0-255,1484,35470,69,327666
4750,0.000329,172.31.40.0-255,66,35536,69,327666
4751,0.000353,74.125.24.0-255,5379,40915,69,327666
4752,0.000355,172.31.40.0-255,66,40981,69,327666
4753,0.00036,74.125.24.0-255,4320,45301,69,327666
4754,0.000362,172.31.40.0-255,66,45367,69,327666
4755,0.000376,74.125.24.0-255,2902,48269,69,327666
4756,0.000378,172.31.40.0-255,66,48335,69,327666
4757,0.000384,74.125.24.0-255,5738,54073,69,327666
4758,0.000386,172.31.40.0-255,66,54139,69,327666
4759,0.000403,74.125.24.0-255,3961,58100,69,327666
4760,0.000406,172.31.40.0-255,66,58166,69,327666
4761,0.000709,74.125.24.0-255,645,58811,69,327666
4762,0.000717,172.31.40.0-255,101,58912,69,327666
4763,0.001417,74.125.24.0-255,1484,60396,69,327666
4764,0.001424,172.31.40.0-255,66,60462,69,327666
4765,0.001434,74.125.24.0-255,2902,63364,69,327666
4766,0.001437,172.31.40.0-255,66,63430,69,327666
4767,0.001463,74.125.24.0-255,4320,67750,69,327666
4768,0.001466,172.31.40.0-255,66,67816,69,327666
4769,0.001472,74.125.24.0-255,5738,73554,69,327666
4770,0.001475,172.31.40.0-255,66,73620,69,327666
4771,0.001502,74.125.24.0-255,2902,76522,69,327666
4772,0.001505,172.31.40.0-255,66,76588,69,327666
4773,0.001512,74.125.24.0-255,7156,83744,69,327666
4774,0.001514,172.31.40.0-255,66,83810,69,327666
4775,0.001547,172.31.40.0-255,66,83876,69,327666
4776,0.00155,74.125.24.0-255,766,84642,69,327666
4777,0.002243,74.125.24.0-255,1484,86126,69,327666
4778,0.00225,172.31.40.0-255,66,86192,69,327666
4779,0.002255,74.125.24.0-255,1484,87676,69,327666
4780,0.002269,74.125.24.0-255,2902,90578,69,327666
4781,0.002272,172.31.40.0-255,66,90644,69,327666
4782,0.002279,74.125.24.0-255,4320,94964,69,327666
4783,0.00228,172.31.40.0-255,66,95030,69,327666
4784,0.002297,74.125.24.0-255,1484,96514,69,327666
4785,0.002301,74.125.24.0-255,1484,97998,69,327666
4786,0.002303,172.31.40.0-255,66,98064,69,327666
4787,0.002331,172.31.40.0-255,66,98130,69,327666
4788,0.002334,74.125.24.0-255,1484,99614,69,327666
4789,0.002397,172.31.40.0-255,66,99680,69,327666
4790,0.002403,74.125.24.0-255,5738,105418,69,327666
4791,0.002406,172.31.40.0-255,66,105484,69,327666
4792,0.002422,74.125.24.0-255,7156,112640,69,327666
4793,0.002425,172.31.40.0-255,66,112706,69,327666
4794,0.002461,172.31.40.0-255,66,112772,69,327666
4795,0.002464,74.125.24.0-255,766,113538,69,327666
4796,0.002467,74.125.24.0-255,1484,115022,69,327666
4797,0.002469,172.31.40.0-255,66,115088,69,327666
4798,0.003051,74.125.24.0-255,66,115154,69,327666
4799,0.004839,74.125.24.0-255,4320,119474,69,327666
4800,0.004844,172.31.40.0-255,66,119540,69,327666
4801,0.004861,74.125.24.0-255,1484,121024,69,327666
4802,0.007218,74.125.24.0-255,2902,123926,69,327666
4803,0.007224,172.31.40.0-255,66,123992,69,327666
4804,0.00724,74.125.24.0-255,1484,125476,69,327666
4805,0.0096,74.125.24.0-255,4320,129796,69,327666
4806,0.009607,172.31.40.0-255,66,129862,69,327666
4807,0.011993,74.125.24.0-255,5738,135600,69,327666
4808,0.012002,172.31.40.0-255,66,135666,69,327666
4809,0.014404,74.125.24.0-255,5738,141404,69,327666
4810,0.014414,172.31.40.0-255,66,141470,69,327666
4811,0.016816,74.125.24.0-255,5738,147208,69,327666
4812,0.016824,172.31.40.0-255,66,147274,69,327666
4813,0.019181,74.125.24.0-255,5738,153012,69,327666
4814,0.019187,172.31.40.0-255,66,153078,69,327666
4815,0.021562,74.125.24.0-255,5738,158816,69,327666
4816,0.02157,172.31.40.0-255,66,158882,69,327666
4817,0.023944,74.125.24.0-255,5738,164620,69,327666
4818,0.023951,172.31.40.0-255,66,164686,69,327666
4819,0.026328,74.125.24.0-255,5738,170424,69,327666
4820,0.026336,172.31.40.0-255,66,170490,69,327666
4821,0.028738,74.125.24.0-255,5738,176228,69,327666
4822,0.028747,172.31.40.0-255,66,176294,69,327666
4823,0.031104,74.125.24.0-255,5738,182032,69,327666
4824,0.031112,172.31.40.0-255,66,182098,69,327666
4825,0.033499,74.125.24.0-255,5738,187836,69,327666
4826,0.033507,172.31.40.0-255,66,187902,69,327666
4827,0.033844,172.31.40.0-255,172,188074,69,327666
4828,0.033874,172.31.40.0-255,1116,189190,69,327666
4829,0.033935,172.31.40.0-255,1514,190704,69,327666
4830,0.033936,172.31.40.0-255,1514,192218,69,327666
4831,0.033938,172.31.40.0-255,1514,193732,69,327666
4832,0.033942,172.31.40.0-255,1514,195246,69,327666
4833,0.033949,172.31.40.0-255,1500,196746,69,327666
4834,0.035526,104.244.42.0-255,66,196812,69,327666
4835,0.035534,104.244.42.0-255,66,196878,69,327666
4836,0.035624,104.244.42.0-255,66,196944,69,327666
4837,0.035889,74.125.24.0-255,5738,202682,69,327666
4838,0.035895,172.31.40.0-255,66,202748,69,327666
4839,0.03828,74.125.24.0-255,5738,208486,69,327666
4840,0.038286,172.31.40.0-255,66,208552,69,327666
4841,0.040669,74.125.24.0-255,5738,214290,69,327666
4842,0.040675,172.31.40.0-255,66,214356,69,327666
4843,0.043036,74.125.24.0-255,5738,220094,69,327666
4844,0.043043,172.31.40.0-255,66,220160,69,327666
4845,0.045419,74.125.24.0-255,5738,225898,69,327666
4846,0.045428,172.31.40.0-255,66,225964,69,327666
4847,0.04782,74.125.24.0-255,5738,231702,69,327666
4848,0.047827,172.31.40.0-255,66,231768,69,327666
4849,0.050204,74.125.24.0-255,5738,237506,69,327666
4850,0.05021,172.31.40.0-255,66,237572,69,327666
4851,0.0526,74.125.24.0-255,5738,243310,69,327666
4852,0.052605,172.31.40.0-255,66,243376,69,327666
4853,0.054988,74.125.24.0-255,5738,249114,69,327666
4854,0.054994,172.31.40.0-255,66,249180,69,327666
4855,0.057377,74.125.24.0-255,4320,253500,69,327666
4856,0.057383,172.31.40.0-255,66,253566,69,327666
4857,0.057401,74.125.24.0-255,1484,255050,69,327666
4858,0.059792,74.125.24.0-255,2902,257952,69,327666
4859,0.0598,172.31.40.0-255,66,258018,69,327666
4860,0.062241,74.125.24.0-255,5738,263756,69,327666
4861,0.062248,172.31.40.0-255,66,263822,69,327666
4862,0.064636,74.125.24.0-255,5738,269560,69,327666
4863,0.064643,172.31.40.0-255,66,269626,69,327666
4864,0.067141,74.125.24.0-255,5738,275364,69,327666
4865,0.067147,172.31.40.0-255,66,275430,69,327666
4866,0.069546,74.125.24.0-255,5738,281168,69,327666
4867,0.069552,172.31.40.0-255,66,281234,69,327666
4868,0.071945,74.125.24.0-255,5738,286972,69,327666
4869,0.071951,172.31.40.0-255,66,287038,69,327666
4870,0.074357,74.125.24.0-255,5738,292776,69,327666
4871,0.074364,172.31.40.0-255,66,292842,69,327666
4872,0.076726,74.125.24.0-255,5738,298580,69,327666
4873,0.076732,172.31.40.0-255,66,298646,69,327666
4874,0.079121,74.125.24.0-255,5738,304384,69,327666
4875,0.079127,172.31.40.0-255,66,304450,69,327666
4876,0.081513,74.125.24.0-255,5738,310188,69,327666
4877,0.081519,172.31.40.0-255,66,310254,69,327666
4878,0.08407,74.125.24.0-255,5738,315992,69,327666
4879,0.084075,172.31.40.0-255,66,316058,69,327666
4880,0.086459,74.125.24.0-255,5738,321796,69,327666
4881,0.086465,172.31.40.0-255,66,321862,69,327666
4882,0.088825,74.125.24.0-255,5738,327600,69,327666
4883,0.08883,172.31.40.0-255,66,327666,69,327666
4884,0.0,172.217.194.0-255,153,153,69,163277
4885,2.2e-05,172.31.40.0-255,66,219,69,163277
4886,2.9e-05,172.217.194.0-255,1484,1703,69,163277
4887,3.4e-05,172.31.40.0-255,66,1769,69,163277
4888,4e-05,172.217.194.0-255,2902,4671,69,163277
4889,4.3e-05,172.31.40.0-255,66,4737,69,163277
4890,4.8e-05,172.217.194.0-255,4320,9057,69,163277
4891,5.1e-05,172.31.40.0-255,66,9123,69,163277
4892,7e-05,172.217.194.0-255,4320,13443,69,163277
4893,7.2e-05,172.31.40.0-255,66,13509,69,163277
4894,9.7e-05,172.31.40.0-255,66,13575,69,163277
4895,0.000103,172.217.194.0-255,5738,19313,69,163277
4896,0.000106,172.31.40.0-255,66,19379,69,163277
4897,0.00013,172.217.194.0-255,3961,23340,69,163277
4898,0.000133,172.31.40.0-255,66,23406,69,163277
4899,0.000181,172.217.194.0-255,1484,24890,69,163277
4900,0.000183,172.31.40.0-255,66,24956,69,163277
4901,0.000187,172.217.194.0-255,1484,26440,69,163277
4902,0.000189,172.31.40.0-255,66,26506,69,163277
4903,0.000205,172.217.194.0-255,1484,27990,69,163277
4904,0.000207,172.31.40.0-255,66,28056,69,163277
4905,0.000212,172.217.194.0-255,2902,30958,69,163277
4906,0.000215,172.31.40.0-255,66,31024,69,163277
4907,0.000236,172.217.194.0-255,2902,33926,69,163277
4908,0.000239,172.31.40.0-255,66,33992,69,163277
4909,0.000277,172.31.40.0-255,66,34058,69,163277
4910,0.000285,172.217.194.0-255,5738,39796,69,163277
4911,0.000288,172.31.40.0-255,66,39862,69,163277
4912,0.000305,172.217.194.0-255,4249,44111,69,163277
4913,0.000308,172.31.40.0-255,66,44177,69,163277
4914,0.000311,172.217.194.0-255,100,44277,69,163277
4915,0.000314,172.217.194.0-255,364,44641,69,163277
4916,0.000428,172.217.194.0-255,1484,46125,69,163277
4917,0.000431,172.31.40.0-255,66,46191,69,163277
4918,0.000436,172.217.194.0-255,2902,49093,69,163277
4919,0.000439,172.31.40.0-255,66,49159,69,163277
4920,0.000444,172.217.194.0-255,4320,53479,69,163277
4921,0.000446,172.31.40.0-255,66,53545,69,163277
4922,0.000469,172.217.194.0-255,1484,55029,69,163277
4923,0.000476,172.217.194.0-255,5738,60767,69,163277
4924,0.000479,172.31.40.0-255,66,60833,69,163277
4925,0.000507,172.217.194.0-255,7156,67989,69,163277
4926,0.000509,172.31.40.0-255,66,68055,69,163277
4927,0.00052,172.31.40.0-255,66,68121,69,163277
4928,0.000973,172.217.194.0-255,1484,69605,69,163277
4929,0.000991,172.217.194.0-255,2902,72507,69,163277
4930,0.000995,172.31.40.0-255,66,72573,69,163277
4931,0.001001,172.217.194.0-255,4320,76893,69,163277
4932,0.001003,172.31.40.0-255,66,76959,69,163277
4933,0.001018,172.217.194.0-255,1484,78443,69,163277
4934,0.00103,172.31.40.0-255,66,78509,69,163277
4935,0.00104,172.31.40.0-255,66,78575,69,163277
4936,0.001059,172.217.194.0-255,2184,80759,69,163277
4937,0.001061,172.31.40.0-255,66,80825,69,163277
4938,0.001077,172.217.194.0-255,1484,82309,69,163277
4939,0.001096,172.217.194.0-255,2902,85211,69,163277
4940,0.001099,172.31.40.0-255,66,85277,69,163277
4941,0.001105,172.217.194.0-255,5738,91015,69,163277
4942,0.001107,172.31.40.0-255,66,91081,69,163277
4943,0.001119,172.217.194.0-255,1484,92565,69,163277
4944,0.00115,172.31.40.0-255,66,92631,69,163277
4945,0.00119,172.31.40.0-255,66,92697,69,163277
4946,0.001201,172.217.194.0-255,1484,94181,69,163277
4947,0.001203,172.217.194.0-255,766,94947,69,163277
4948,0.001205,172.31.40.0-255,66,95013,69,163277
4949,0.001208,172.217.194.0-255,1484,96497,69,163277
4950,0.001212,172.217.194.0-255,4320,100817,69,163277
4951,0.001215,172.31.40.0-255,66,100883,69,163277
4952,0.001218,172.217.194.0-255,2902,103785,69,163277
4953,0.00122,172.31.40.0-255,66,103851,69,163277
4954,0.001252,172.217.194.0-255,7156,111007,69,163277
4955,0.001255,172.31.40.0-255,66,111073,69,163277
4956,0.001265,172.31.40.0-255,66,111139,69,163277
4957,0.0013,172.31.40.0-255,66,111205,69,163277
4958,0.001377,172.217.194.0-255,1484,112689,69,163277
4959,0.001387,172.217.194.0-255,1484,114173,69,163277
4960,0.00139,172.31.40.0-255,66,114239,69,163277
4961,0.001409,172.217.194.0-255,1484,115723,69,163277
4962,0.001414,172.217.194.0-255,5738,121461,69,163277
4963,0.001417,172.31.40.0-255,66,121527,69,163277
4964,0.001421,172.217.194.0-255,4320,125847,69,163277
4965,0.001423,172.31.40.0-255,66,125913,69,163277
4966,0.001449,172.31.40.0-255,66,125979,69,163277
4967,0.001463,172.31.40.0-255,66,126045,69,163277
4968,0.001643,172.217.194.0-255,1484,127529,69,163277
4969,0.001649,172.217.194.0-255,2902,130431,69,163277
4970,0.001652,172.31.40.0-255,66,130497,69,163277
4971,0.00167,172.217.194.0-255,5738,136235,69,163277
4972,0.001672,172.31.40.0-255,66,136301,69,163277
4973,0.001676,172.217.194.0-255,1484,137785,69,163277
4974,0.001716,172.31.40.0-255,66,137851,69,163277
4975,0.001728,172.31.40.0-255,66,137917,69,163277
4976,0.001788,172.31.40.0-255,66,137983,69,163277
4977,0.001805,172.217.194.0-255,3602,141585,69,163277
4978,0.001808,172.31.40.0-255,66,141651,69,163277
4979,0.001813,172.217.194.0-255,4320,145971,69,163277
4980,0.001816,172.31.40.0-255,66,146037,69,163277
4981,0.001839,172.217.194.0-255,7156,153193,69,163277
4982,0.001842,172.31.40.0-255,66,153259,69,163277
4983,0.001872,172.31.40.0-255,66,153325,69,163277
4984,0.001884,172.31.40.0-255,66,153391,69,163277
4985,0.001918,172.31.40.0-255,66,153457,69,163277
4986,0.001929,172.31.40.0-255,66,153523,69,163277
4987,0.001958,172.31.40.0-255,66,153589,69,163277
4988,0.002042,172.31.40.0-255,66,153655,69,163277
4989,0.002057,172.31.40.0-255,66,153721,69,163277
4990,0.002083,172.31.40.0-255,66,153787,69,163277
4991,0.002086,172.217.194.0-255,105,153892,69,163277
4992,0.002602,172.31.40.0-255,101,153993,69,163277
4993,0.005255,172.217.194.0-255,66,154059,69,163277
4994,0.010502,172.31.40.0-255,105,154164,69,163277
4995,0.013166,172.217.194.0-255,66,154230,69,163277
4996,0.044038,172.31.40.0-255,176,154406,69,163277
4997,0.044065,172.31.40.0-255,1114,155520,69,163277
4998,0.044125,172.31.40.0-255,1514,157034,69,163277
4999,0.044126,172.31.40.0-255,1514,158548,69,163277
5000,0.044127,172.31.40.0-255,1514,160062,69,163277
5001,0.044132,172.31.40.0-255,1514,161576,69,163277
5002,0.044133,172.31.40.0-255,1503,163079,69,163277
5003,0.045729,104.244.42.0-255,66,163145,69,163277
5004,0.045767,104.244.42.0-255,66,163211,69,163277
5005,0.045844,104.244.42.0-255,66,163277,69,163277
5006,0.0,172.217.194.0-255,297,297,69,249839
5007,2.2e-05,172.31.40.0-255,66,363,69,249839
5008,2.9e-05,172.217.194.0-255,1484,1847,69,249839
5009,3.2e-05,172.31.40.0-255,66,1913,69,249839
5010,4.7e-05,172.217.194.0-255,4320,6233,69,249839
5011,5e-05,172.31.40.0-255,66,6299,69,249839
5012,0.000146,172.217.194.0-255,7156,13455,69,249839
5013,0.00015,172.31.40.0-255,66,13521,69,249839
5014,0.000174,172.217.194.0-255,517,14038,69,249839
5015,0.000177,172.31.40.0-255,66,14104,69,249839
5016,0.000362,172.217.194.0-255,2902,17006,69,249839
5017,0.000367,172.31.40.0-255,66,17072,69,249839
5018,0.000397,172.217.194.0-255,5738,22810,69,249839
5019,0.000403,172.31.40.0-255,66,22876,69,249839
5020,0.000622,172.217.194.0-255,7156,30032,69,249839
5021,0.000627,172.31.40.0-255,66,30098,69,249839
5022,0.000653,172.217.194.0-255,1125,31223,69,249839
5023,0.000656,172.31.40.0-255,66,31289,69,249839
5024,0.000871,172.31.40.0-255,66,31355,69,249839
5025,0.000908,172.31.40.0-255,66,31421,69,249839
5026,0.001413,172.31.40.0-255,66,31487,69,249839
5027,0.001866,172.31.40.0-255,66,31553,69,249839
5028,0.001913,172.31.40.0-255,66,31619,69,249839
5029,0.002833,172.217.194.0-255,4320,35939,69,249839
5030,0.002847,172.31.40.0-255,66,36005,69,249839
5031,0.002909,172.31.40.0-255,66,36071,69,249839
5032,0.003829,172.31.40.0-255,66,36137,69,249839
5033,0.003865,172.31.40.0-255,66,36203,69,249839
5034,0.006213,172.217.194.0-255,5738,41941,69,249839
5035,0.00622,172.31.40.0-255,66,42007,69,249839
5036,0.008558,172.217.194.0-255,5738,47745,69,249839
5037,0.008566,172.31.40.0-255,66,47811,69,249839
5038,0.010913,172.217.194.0-255,5738,53549,69,249839
5039,0.010924,172.31.40.0-255,66,53615,69,249839
5040,0.013269,172.217.194.0-255,5738,59353,69,249839
5041,0.013278,172.31.40.0-255,66,59419,69,249839
5042,0.015582,172.217.194.0-255,5738,65157,69,249839
5043,0.015592,172.31.40.0-255,66,65223,69,249839
5044,0.017961,172.217.194.0-255,5738,70961,69,249839
5045,0.017971,172.31.40.0-255,66,71027,69,249839
5046,0.020294,172.217.194.0-255,5738,76765,69,249839
5047,0.020304,172.31.40.0-255,66,76831,69,249839
5048,0.022618,172.217.194.0-255,5738,82569,69,249839
5049,0.022627,172.31.40.0-255,66,82635,69,249839
5050,0.02498,172.217.194.0-255,5738,88373,69,249839
5051,0.024989,172.31.40.0-255,66,88439,69,249839
5052,0.025501,172.31.40.0-255,167,88606,69,249839
5053,0.025532,172.31.40.0-255,1111,89717,69,249839
5054,0.0256,172.31.40.0-255,1514,91231,69,249839
5055,0.025602,172.31.40.0-255,1514,92745,69,249839
5056,0.025603,172.31.40.0-255,1514,94259,69,249839
5057,0.025604,172.31.40.0-255,1514,95773,69,249839
5058,0.025605,172.31.40.0-255,546,96319,69,249839
5059,0.02705,104.244.42.0-255,66,96385,69,249839
5060,0.027105,104.244.42.0-255,66,96451,69,249839
5061,0.02715,104.244.42.0-255,66,96517,69,249839
5062,0.027194,104.244.42.0-255,66,96583,69,249839
5063,0.027309,172.217.194.0-255,5738,102321,69,249839
5064,0.027315,172.31.40.0-255,66,102387,69,249839
5065,0.027782,104.244.42.0-255,108,102495,69,249839
5066,0.027791,172.31.40.0-255,66,102561,69,249839
5067,0.029709,172.217.194.0-255,5738,108299,69,249839
5068,0.029715,172.31.40.0-255,66,108365,69,249839
5069,0.032045,172.217.194.0-255,2902,111267,69,249839
5070,0.032053,172.31.40.0-255,66,111333,69,249839
5071,0.032081,172.217.194.0-255,2902,114235,69,249839
5072,0.032103,172.31.40.0-255,66,114301,69,249839
5073,0.034397,172.217.194.0-255,2902,117203,69,249839
5074,0.034402,172.31.40.0-255,66,117269,69,249839
5075,0.034432,172.217.194.0-255,2902,120171,69,249839
5076,0.034464,172.31.40.0-255,66,120237,69,249839
5077,0.036718,172.217.194.0-255,2902,123139,69,249839
5078,0.036725,172.31.40.0-255,66,123205,69,249839
5079,0.036798,172.217.194.0-255,2902,126107,69,249839
5080,0.036825,172.31.40.0-255,66,126173,69,249839
5081,0.039074,172.217.194.0-255,2902,129075,69,249839
5082,0.039093,172.31.40.0-255,66,129141,69,249839
5083,0.039146,172.217.194.0-255,2902,132043,69,249839
5084,0.041417,172.217.194.0-255,2902,134945,69,249839
5085,0.042905,172.31.40.0-255,66,135011,69,249839
5086,0.045232,172.217.194.0-255,5738,140749,69,249839
5087,0.04525,172.31.40.0-255,66,140815,69,249839
5088,0.047618,172.217.194.0-255,5738,146553,69,249839
5089,0.047628,172.31.40.0-255,66,146619,69,249839
5090,0.050006,172.217.194.0-255,5738,152357,69,249839
5091,0.050014,172.31.40.0-255,66,152423,69,249839
5092,0.052402,172.217.194.0-255,5738,158161,69,249839
5093,0.052408,172.31.40.0-255,66,158227,69,249839
5094,0.054753,172.217.194.0-255,5738,163965,69,249839
5095,0.05476,172.31.40.0-255,66,164031,69,249839
5096,0.057091,172.217.194.0-255,5738,169769,69,249839
5097,0.057097,172.31.40.0-255,66,169835,69,249839
5098,0.059447,172.217.194.0-255,5738,175573,69,249839
5099,0.059453,172.31.40.0-255,66,175639,69,249839
5100,0.061758,172.217.194.0-255,2902,178541,69,249839
5101,0.061763,172.31.40.0-255,66,178607,69,249839
5102,0.061793,172.217.194.0-255,2902,181509,69,249839
5103,0.061817,172.31.40.0-255,66,181575,69,249839
5104,0.06412,172.217.194.0-255,2902,184477,69,249839
5105,0.064126,172.31.40.0-255,66,184543,69,249839
5106,0.064183,172.217.194.0-255,2902,187445,69,249839
5107,0.064193,172.31.40.0-255,66,187511,69,249839
5108,0.066482,172.217.194.0-255,2902,190413,69,249839
5109,0.066489,172.31.40.0-255,66,190479,69,249839
5110,0.066554,172.217.194.0-255,2902,193381,69,249839
5111,0.066581,172.31.40.0-255,66,193447,69,249839
5112,0.068823,172.217.194.0-255,2902,196349,69,249839
5113,0.06883,172.31.40.0-255,66,196415,69,249839
5114,0.068889,172.217.194.0-255,2902,199317,69,249839
5115,0.068926,172.31.40.0-255,66,199383,69,249839
5116,0.071147,172.217.194.0-255,2902,202285,69,249839
5117,0.071154,172.31.40.0-255,66,202351,69,249839
5118,0.07121,172.217.194.0-255,2902,205253,69,249839
5119,0.071218,172.31.40.0-255,66,205319,69,249839
5120,0.073514,172.217.194.0-255,2902,208221,69,249839
5121,0.07352,172.31.40.0-255,66,208287,69,249839
5122,0.07355,172.217.194.0-255,2902,211189,69,249839
5123,0.073581,172.31.40.0-255,66,211255,69,249839
5124,0.075856,172.217.194.0-255,2902,214157,69,249839
5125,0.075863,172.31.40.0-255,66,214223,69,249839
5126,0.07591,172.217.194.0-255,2902,217125,69,249839
5127,0.075966,172.31.40.0-255,66,217191,69,249839
5128,0.078195,172.217.194.0-255,2902,220093,69,249839
5129,0.078201,172.31.40.0-255,66,220159,69,249839
5130,0.078253,172.217.194.0-255,2902,223061,69,249839
5131,0.078267,172.31.40.0-255,66,223127,69,249839
5132,0.080571,172.217.194.0-255,2902,226029,69,249839
5133,0.080578,172.31.40.0-255,66,226095,69,249839
5134,0.08061,172.217.194.0-255,2902,228997,69,249839
5135,0.080648,172.31.40.0-255,66,229063,69,249839
5136,0.082919,172.217.194.0-255,2902,231965,69,249839
5137,0.082925,172.31.40.0-255,66,232031,69,249839
5138,0.082955,172.217.194.0-255,2902,234933,69,249839
5139,0.082987,172.31.40.0-255,66,234999,69,249839
5140,0.085242,172.217.194.0-255,2902,237901,69,249839
5141,0.085248,172.31.40.0-255,66,237967,69,249839
5142,0.085329,172.217.194.0-255,2902,240869,69,249839
5143,0.085345,172.31.40.0-255,66,240935,69,249839
5144,0.087609,172.217.194.0-255,2902,243837,69,249839
5145,0.087615,172.31.40.0-255,66,243903,69,249839
5146,0.08769,172.217.194.0-255,2902,246805,69,249839
5147,0.087724,172.31.40.0-255,66,246871,69,249839
5148,0.089967,172.217.194.0-255,2902,249773,69,249839
5149,0.089973,172.31.40.0-255,66,249839,69,249839
5150,0.0,172.31.40.0-255,105,105,69,276
5151,0.001896,157.240.7.0-255,105,210,69,276
5152,0.00191,172.31.40.0-255,66,276,69,276
5153,0.0,74.125.130.0-255,219,219,69,355821
5154,1.9e-05,172.31.40.0-255,66,285,69,355821
5155,2.6e-05,74.125.130.0-255,1484,1769,69,355821
5156,3.1e-05,172.31.40.0-255,66,1835,69,355821
5157,3.7e-05,74.125.130.0-255,2902,4737,69,355821
5158,4.8e-05,172.31.40.0-255,66,4803,69,355821
5159,5.5e-05,74.125.130.0-255,4320,9123,69,355821
5160,5.8e-05,172.31.40.0-255,66,9189,69,355821
5161,0.000104,74.125.130.0-255,4731,13920,69,355821
5162,0.000113,172.31.40.0-255,66,13986,69,355821
5163,0.00012,74.125.130.0-255,5738,19724,69,355821
5164,0.000122,172.31.40.0-255,66,19790,69,355821
5165,0.000125,74.125.130.0-255,1484,21274,69,355821
5166,0.000128,172.31.40.0-255,66,21340,69,355821
5167,0.000166,74.125.130.0-255,7156,28496,69,355821
5168,0.000169,172.31.40.0-255,66,28562,69,355821
5169,0.000172,74.125.130.0-255,1484,30046,69,355821
5170,0.000174,172.31.40.0-255,66,30112,69,355821
5171,0.000196,74.125.130.0-255,1125,31237,69,355821
5172,0.000198,172.31.40.0-255,66,31303,69,355821
5173,0.000272,74.125.130.0-255,1484,32787,69,355821
5174,0.000275,172.31.40.0-255,66,32853,69,355821
5175,0.000303,74.125.130.0-255,2902,35755,69,355821
5176,0.000306,172.31.40.0-255,66,35821,69,355821
5177,0.000334,74.125.130.0-255,5738,41559,69,355821
5178,0.000337,172.31.40.0-255,66,41625,69,355821
5179,0.00034,74.125.130.0-255,1484,43109,69,355821
5180,0.000342,172.31.40.0-255,66,43175,69,355821
5181,0.000346,74.125.130.0-255,2902,46077,69,355821
5182,0.000348,172.31.40.0-255,66,46143,69,355821
5183,0.000385,74.125.130.0-255,2543,48686,69,355821
5184,0.000388,172.31.40.0-255,66,48752,69,355821
5185,0.000492,74.125.130.0-255,1484,50236,69,355821
5186,0.000513,74.125.130.0-255,2902,53138,69,355821
5187,0.000534,74.125.130.0-255,1484,54622,69,355821
5188,0.000548,74.125.130.0-255,2902,57524,69,355821
5189,0.00058,74.125.130.0-255,2902,60426,69,355821
5190,0.000593,74.125.130.0-255,2902,63328,69,355821
5191,0.000633,74.125.130.0-255,2543,65871,69,355821
5192,0.000646,172.31.40.0-255,66,65937,69,355821
5193,0.000701,74.125.130.0-255,645,66582,69,355821
5194,0.000739,74.125.130.0-255,1484,68066,69,355821
5195,0.000747,172.31.40.0-255,66,68132,69,355821
5196,0.000766,74.125.130.0-255,2902,71034,69,355821
5197,0.000782,74.125.130.0-255,4320,75354,69,355821
5198,0.000798,74.125.130.0-255,1484,76838,69,355821
5199,0.000804,172.31.40.0-255,66,76904,69,355821
5200,0.000826,74.125.130.0-255,5738,82642,69,355821
5201,0.000837,74.125.130.0-255,1125,83767,69,355821
5202,0.000846,172.31.40.0-255,66,83833,69,355821
5203,0.000873,74.125.130.0-255,1484,85317,69,355821
5204,0.000877,74.125.130.0-255,1484,86801,69,355821
5205,0.000883,172.31.40.0-255,66,86867,69,355821
5206,0.000895,74.125.130.0-255,2902,89769,69,355821
5207,0.000917,74.125.130.0-255,5738,95507,69,355821
5208,0.000937,172.31.40.0-255,66,95573,69,355821
5209,0.000962,74.125.130.0-255,2902,98475,69,355821
5210,0.000978,74.125.130.0-255,2543,101018,69,355821
5211,0.000985,172.31.40.0-255,66,101084,69,355821
5212,0.001759,74.125.130.0-255,1484,102568,69,355821
5213,0.001771,74.125.130.0-255,2902,105470,69,355821
5214,0.001775,172.31.40.0-255,66,105536,69,355821
5215,0.00178,74.125.130.0-255,1484,107020,69,355821
5216,0.001805,74.125.130.0-255,4320,111340,69,355821
5217,0.00181,74.125.130.0-255,2902,114242,69,355821
5218,0.001834,74.125.130.0-255,4320,118562,69,355821
5219,0.001842,74.125.130.0-255,7156,125718,69,355821
5220,0.001855,74.125.130.0-255,1484,127202,69,355821
5221,0.001868,74.125.130.0-255,1484,128686,69,355821
5222,0.001881,74.125.130.0-255,2902,131588,69,355821
5223,0.001901,74.125.130.0-255,3602,135190,69,355821
5224,0.002188,74.125.130.0-255,1484,136674,69,355821
5225,0.002194,74.125.130.0-255,1484,138158,69,355821
5226,0.002213,74.125.130.0-255,1484,139642,69,355821
5227,0.002224,74.125.130.0-255,1484,141126,69,355821
5228,0.002227,74.125.130.0-255,1484,142610,69,355821
5229,0.002246,74.125.130.0-255,2902,145512,69,355821
5230,0.002259,74.125.130.0-255,1484,146996,69,355821
5231,0.002282,74.125.130.0-255,5738,152734,69,355821
5232,0.002294,74.125.130.0-255,1484,154218,69,355821
5233,0.002306,74.125.130.0-255,1484,155702,69,355821
5234,0.002325,74.125.130.0-255,5738,161440,69,355821
5235,0.00234,74.125.130.0-255,1484,162924,69,355821
5236,0.002367,74.125.130.0-255,1484,164408,69,355821
5237,0.002382,74.125.130.0-255,5020,169428,69,355821
5238,0.006032,172.31.40.0-255,66,169494,69,355821
5239,0.008654,74.125.130.0-255,1484,170978,69,355821
5240,0.008672,74.125.130.0-255,2902,173880,69,355821
5241,0.008675,172.31.40.0-255,66,173946,69,355821
5242,0.008687,74.125.130.0-255,1484,175430,69,355821
5243,0.011288,74.125.130.0-255,4320,179750,69,355821
5244,0.011296,172.31.40.0-255,66,179816,69,355821
5245,0.013911,74.125.130.0-255,5738,185554,69,355821
5246,0.013966,172.31.40.0-255,66,185620,69,355821
5247,0.01658,74.125.130.0-255,5738,191358,69,355821
5248,0.01659,172.31.40.0-255,66,191424,69,355821
5249,0.019243,74.125.130.0-255,5738,197162,69,355821
5250,0.019251,172.31.40.0-255,66,197228,69,355821
5251,0.02186,74.125.130.0-255,5738,202966,69,355821
5252,0.021869,172.31.40.0-255,66,203032,69,355821
5253,0.0245,74.125.130.0-255,5738,208770,69,355821
5254,0.024508,172.31.40.0-255,66,208836,69,355821
5255,0.027201,74.125.130.0-255,5738,214574,69,355821
5256,0.02721,172.31.40.0-255,66,214640,69,355821
5257,0.029825,74.125.130.0-255,5738,220378,69,355821
5258,0.029833,172.31.40.0-255,66,220444,69,355821
5259,0.032481,74.125.130.0-255,5738,226182,69,355821
5260,0.032491,172.31.40.0-255,66,226248,69,355821
5261,0.034987,172.31.40.0-255,172,226420,69,355821
5262,0.035023,172.31.40.0-255,1116,227536,69,355821
5263,0.035089,172.31.40.0-255,1514,229050,69,355821
5264,0.035091,172.31.40.0-255,1514,230564,69,355821
5265,0.035092,172.31.40.0-255,1514,232078,69,355821
5266,0.035097,172.31.40.0-255,1514,233592,69,355821
5267,0.035098,172.31.40.0-255,1499,235091,69,355821
5268,0.035137,74.125.130.0-255,4320,239411,69,355821
5269,0.035142,172.31.40.0-255,66,239477,69,355821
5270,0.035169,74.125.130.0-255,1484,240961,69,355821
5271,0.036649,104.244.42.0-255,66,241027,69,355821
5272,0.036696,104.244.42.0-255,66,241093,69,355821
5273,0.036819,104.244.42.0-255,66,241159,69,355821
5274,0.037758,74.125.130.0-255,4320,245479,69,355821
5275,0.037765,172.31.40.0-255,66,245545,69,355821
5276,0.040401,74.125.130.0-255,5738,251283,69,355821
5277,0.040796,172.31.40.0-255,66,251349,69,355821
5278,0.043438,74.125.130.0-255,5738,257087,69,355821
5279,0.043443,172.31.40.0-255,66,257153,69,355821
5280,0.046066,74.125.130.0-255,5738,262891,69,355821
5281,0.046073,172.31.40.0-255,66,262957,69,355821
5282,0.048695,74.125.130.0-255,5738,268695,69,355821
5283,0.0487,172.31.40.0-255,66,268761,69,355821
5284,0.051319,74.125.130.0-255,5738,274499,69,355821
5285,0.051326,172.31.40.0-255,66,274565,69,355821
5286,0.053966,74.125.130.0-255,5738,280303,69,355821
5287,0.053973,172.31.40.0-255,66,280369,69,355821
5288,0.056608,74.125.130.0-255,5738,286107,69,355821
5289,0.056615,172.31.40.0-255,66,286173,69,355821
5290,0.059243,74.125.130.0-255,5738,291911,69,355821
5291,0.05925,172.31.40.0-255,66,291977,69,355821
5292,0.061865,74.125.130.0-255,5738,297715,69,355821
5293,0.061871,172.31.40.0-255,66,297781,69,355821
5294,0.064492,74.125.130.0-255,5738,303519,69,355821
5295,0.064498,172.31.40.0-255,66,303585,69,355821
5296,0.067103,74.125.130.0-255,5738,309323,69,355821
5297,0.067109,172.31.40.0-255,66,309389,69,355821
5298,0.06972,74.125.130.0-255,5738,315127,69,355821
5299,0.069727,172.31.40.0-255,66,315193,69,355821
5300,0.072336,74.125.130.0-255,5738,320931,69,355821
5301,0.072341,172.31.40.0-255,66,320997,69,355821
5302,0.074963,74.125.130.0-255,5738,326735,69,355821
5303,0.07497,172.31.40.0-255,66,326801,69,355821
5304,0.077619,74.125.130.0-255,5738,332539,69,355821
5305,0.077628,172.31.40.0-255,66,332605,69,355821
5306,0.08024,74.125.130.0-255,5738,338343,69,355821
5307,0.080247,172.31.40.0-255,66,338409,69,355821
5308,0.08286,74.125.130.0-255,5738,344147,69,355821
5309,0.082865,172.31.40.0-255,66,344213,69,355821
5310,0.085506,74.125.130.0-255,5738,349951,69,355821
5311,0.085512,172.31.40.0-255,66,350017,69,355821
5312,0.088123,74.125.130.0-255,5738,355755,69,355821
5313,0.08813,172.31.40.0-255,66,355821,69,355821
5314,0.0,74.125.68.0-255,153,153,69,411085
5315,2.4e-05,172.31.40.0-255,66,219,69,411085
5316,3.1e-05,74.125.68.0-255,1484,1703,69,411085
5317,3.6e-05,172.31.40.0-255,66,1769,69,411085
5318,4.2e-05,74.125.68.0-255,2902,4671,69,411085
5319,4.5e-05,172.31.40.0-255,66,4737,69,411085
5320,8.3e-05,74.125.68.0-255,4320,9057,69,411085
5321,8.7e-05,172.31.40.0-255,66,9123,69,411085
5322,9.8e-05,74.125.68.0-255,1484,10607,69,411085
5323,0.0001,172.31.40.0-255,66,10673,69,411085
5324,0.000105,74.125.68.0-255,2902,13575,69,411085
5325,0.000108,172.31.40.0-255,66,13641,69,411085
5326,0.000135,74.125.68.0-255,2902,16543,69,411085
5327,0.000138,172.31.40.0-255,66,16609,69,411085
5328,0.000159,74.125.68.0-255,3573,20182,69,411085
5329,0.000162,172.31.40.0-255,66,20248,69,411085
5330,0.000166,74.125.68.0-255,2902,23150,69,411085
5331,0.000168,172.31.40.0-255,66,23216,69,411085
5332,0.000202,74.125.68.0-255,5738,28954,69,411085
5333,0.000205,172.31.40.0-255,66,29020,69,411085
5334,0.000223,74.125.68.0-255,2543,31563,69,411085
5335,0.000227,172.31.40.0-255,66,31629,69,411085
5336,0.000301,74.125.68.0-255,1484,33113,69,411085
5337,0.000304,172.31.40.0-255,66,33179,69,411085
5338,0.000322,74.125.68.0-255,2902,36081,69,411085
5339,0.000325,172.31.40.0-255,66,36147,69,411085
5340,0.000353,74.125.68.0-255,5738,41885,69,411085
5341,0.000356,172.31.40.0-255,66,41951,69,411085
5342,0.000361,74.125.68.0-255,2902,44853,69,411085
5343,0.000363,172.31.40.0-255,66,44919,69,411085
5344,0.000368,74.125.68.0-255,3961,48880,69,411085
5345,0.000371,172.31.40.0-255,66,48946,69,411085
5346,0.000412,74.125.68.0-255,1484,50430,69,411085
5347,0.000437,74.125.68.0-255,2902,53332,69,411085
5348,0.000441,172.31.40.0-255,66,53398,69,411085
5349,0.000444,74.125.68.0-255,1484,54882,69,411085
5350,0.00046,74.125.68.0-255,1484,56366,69,411085
5351,0.000462,172.31.40.0-255,66,56432,69,411085
5352,0.000466,74.125.68.0-255,1484,57916,69,411085
5353,0.000484,74.125.68.0-255,2902,60818,69,411085
5354,0.000487,172.31.40.0-255,66,60884,69,411085
5355,0.000505,74.125.68.0-255,1484,62368,69,411085
5356,0.000518,74.125.68.0-255,4236,66604,69,411085
5357,0.000522,172.31.40.0-255,66,66670,69,411085
5358,0.000524,74.125.68.0-255,132,66802,69,411085
5359,0.000616,74.125.68.0-255,1484,68286,69,411085
5360,0.000619,172.31.40.0-255,66,68352,69,411085
5361,0.000663,74.125.68.0-255,2902,71254,69,411085
5362,0.000667,172.31.40.0-255,66,71320,69,411085
5363,0.000683,74.125.68.0-255,4320,75640,69,411085
5364,0.000686,172.31.40.0-255,66,75706,69,411085
5365,0.000706,74.125.68.0-255,1484,77190,69,411085
5366,0.000732,74.125.68.0-255,7156,84346,69,411085
5367,0.000736,172.31.40.0-255,66,84412,69,411085
5368,0.000741,74.125.68.0-255,4320,88732,69,411085
5369,0.000743,172.31.40.0-255,66,88798,69,411085
5370,0.00076,74.125.68.0-255,5738,94536,69,411085
5371,0.000763,172.31.40.0-255,66,94602,69,411085
5372,0.000768,74.125.68.0-255,2902,97504,69,411085
5373,0.00077,172.31.40.0-255,66,97570,69,411085
5374,0.000795,74.125.68.0-255,2902,100472,69,411085
5375,0.000797,172.31.40.0-255,66,100538,69,411085
5376,0.00083,74.125.68.0-255,766,101304,69,411085
5377,0.000846,74.125.68.0-255,1765,103069,69,411085
5378,0.000849,172.31.40.0-255,66,103135,69,411085
5379,0.000854,74.125.68.0-255,4320,107455,69,411085
5380,0.000856,172.31.40.0-255,66,107521,69,411085
5381,0.000884,74.125.68.0-255,5738,113259,69,411085
5382,0.000887,172.31.40.0-255,66,113325,69,411085
5383,0.000891,74.125.68.0-255,1484,114809,69,411085
5384,0.000918,172.31.40.0-255,66,114875,69,411085
5385,0.000923,74.125.68.0-255,4320,119195,69,411085
5386,0.000925,172.31.40.0-255,66,119261,69,411085
5387,0.000965,74.125.68.0-255,4320,123581,69,411085
5388,0.000968,172.31.40.0-255,66,123647,69,411085
5389,0.000984,74.125.68.0-255,2184,125831,69,411085
5390,0.000987,172.31.40.0-255,66,125897,69,411085
5391,0.001302,74.125.68.0-255,1484,127381,69,411085
5392,0.001322,74.125.68.0-255,2902,130283,69,411085
5393,0.001326,172.31.40.0-255,66,130349,69,411085
5394,0.001349,74.125.68.0-255,5738,136087,69,411085
5395,0.001352,172.31.40.0-255,66,136153,69,411085
5396,0.001367,74.125.68.0-255,4320,140473,69,411085
5397,0.00137,172.31.40.0-255,66,140539,69,411085
5398,0.001386,74.125.68.0-255,5738,146277,69,411085
5399,0.001388,172.31.40.0-255,66,146343,69,411085
5400,0.001414,74.125.68.0-255,4320,150663,69,411085
5401,0.001417,172.31.40.0-255,66,150729,69,411085
5402,0.001433,74.125.68.0-255,7156,157885,69,411085
5403,0.001437,172.31.40.0-255,66,157951,69,411085
5404,0.001475,74.125.68.0-255,2184,160135,69,411085
5405,0.001478,172.31.40.0-255,66,160201,69,411085
5406,0.001561,74.125.68.0-255,1484,161685,69,411085
5407,0.001565,74.125.68.0-255,1484,163169,69,411085
5408,0.001567,172.31.40.0-255,66,163235,69,411085
5409,0.001583,74.125.68.0-255,1484,164719,69,411085
5410,0.001589,74.125.68.0-255,4320,169039,69,411085
5411,0.001591,172.31.40.0-255,66,169105,69,411085
5412,0.001607,74.125.68.0-255,1484,170589,69,411085
5413,0.001622,74.125.68.0-255,1484,172073,69,411085
5414,0.001625,172.31.40.0-255,66,172139,69,411085
5415,0.00165,74.125.68.0-255,2902,175041,69,411085
5416,0.001654,172.31.40.0-255,66,175107,69,411085
5417,0.00169,74.125.68.0-255,1484,176591,69,411085
5418,0.001695,74.125.68.0-255,2902,179493,69,411085
5419,0.001697,172.31.40.0-255,66,179559,69,411085
5420,0.001724,74.125.68.0-255,4320,183879,69,411085
5421,0.001727,172.31.40.0-255,66,183945,69,411085
5422,0.001748,74.125.68.0-255,5738,189683,69,411085
5423,0.00175,172.31.40.0-255,66,189749,69,411085
5424,0.001767,74.125.68.0-255,1484,191233,69,411085
5425,0.001781,74.125.68.0-255,1484,192717,69,411085
5426,0.001784,172.31.40.0-255,66,192783,69,411085
5427,0.001821,74.125.68.0-255,2184,194967,69,411085
5428,0.001824,172.31.40.0-255,66,195033,69,411085
5429,0.002025,74.125.68.0-255,1484,196517,69,411085
5430,0.002038,74.125.68.0-255,1484,198001,69,411085
5431,0.002042,172.31.40.0-255,66,198067,69,411085
5432,0.002059,74.125.68.0-255,1484,199551,69,411085
5433,0.002066,74.125.68.0-255,5738,205289,69,411085
5434,0.002068,172.31.40.0-255,66,205355,69,411085
5435,0.002089,74.125.68.0-255,7156,212511,69,411085
5436,0.002092,172.31.40.0-255,66,212577,69,411085
5437,0.002096,74.125.68.0-255,2902,215479,69,411085
5438,0.002098,172.31.40.0-255,66,215545,69,411085
5439,0.002118,74.125.68.0-255,5738,221283,69,411085
5440,0.002122,172.31.40.0-255,66,221349,69,411085
5441,0.002156,74.125.68.0-255,1484,222833,69,411085
5442,0.002175,74.125.68.0-255,6438,229271,69,411085
5443,0.002178,172.31.40.0-255,66,229337,69,411085
5444,0.002233,74.125.68.0-255,1484,230821,69,411085
5445,0.00225,74.125.68.0-255,2902,233723,69,411085
5446,0.002253,172.31.40.0-255,66,233789,69,411085
5447,0.002275,74.125.68.0-255,5738,239527,69,411085
5448,0.002278,172.31.40.0-255,66,239593,69,411085
5449,0.002287,74.125.68.0-255,2902,242495,69,411085
5450,0.00229,172.31.40.0-255,66,242561,69,411085
5451,0.00231,74.125.68.0-255,2902,245463,69,411085
5452,0.002312,172.31.40.0-255,66,245529,69,411085
5453,0.002319,74.125.68.0-255,7156,252685,69,411085
5454,0.002322,172.31.40.0-255,66,252751,69,411085
5455,0.00236,172.31.40.0-255,66,252817,69,411085
5456,0.004676,74.125.68.0-255,5738,258555,69,411085
5457,0.0047,172.31.40.0-255,66,258621,69,411085
5458,0.007027,74.125.68.0-255,5738,264359,69,411085
5459,0.007048,172.31.40.0-255,66,264425,69,411085
5460,0.009373,74.125.68.0-255,5738,270163,69,411085
5461,0.009396,172.31.40.0-255,66,270229,69,411085
5462,0.011739,74.125.68.0-255,5738,275967,69,411085
5463,0.011752,172.31.40.0-255,66,276033,69,411085
5464,0.014117,74.125.68.0-255,5738,281771,69,411085
5465,0.014128,172.31.40.0-255,66,281837,69,411085
5466,0.016434,74.125.68.0-255,5738,287575,69,411085
5467,0.016442,172.31.40.0-255,66,287641,69,411085
5468,0.018774,74.125.68.0-255,5738,293379,69,411085
5469,0.018797,172.31.40.0-255,66,293445,69,411085
5470,0.021118,74.125.68.0-255,5738,299183,69,411085
5471,0.021134,172.31.40.0-255,66,299249,69,411085
5472,0.023464,74.125.68.0-255,5738,304987,69,411085
5473,0.023482,172.31.40.0-255,66,305053,69,411085
5474,0.025813,74.125.68.0-255,5738,310791,69,411085
5475,0.025831,172.31.40.0-255,66,310857,69,411085
5476,0.028155,74.125.68.0-255,5738,316595,69,411085
5477,0.028171,172.31.40.0-255,66,316661,69,411085
5478,0.030501,74.125.68.0-255,5738,322399,69,411085
5479,0.030518,172.31.40.0-255,66,322465,69,411085
5480,0.03284,74.125.68.0-255,5738,328203,69,411085
5481,0.032856,172.31.40.0-255,66,328269,69,411085
5482,0.035181,74.125.68.0-255,5738,334007,69,411085
5483,0.035199,172.31.40.0-255,66,334073,69,411085
5484,0.037529,74.125.68.0-255,5738,339811,69,411085
5485,0.037548,172.31.40.0-255,66,339877,69,411085
5486,0.03987,74.125.68.0-255,5738,345615,69,411085
5487,0.039886,172.31.40.0-255,66,345681,69,411085
5488,0.042197,74.125.68.0-255,5738,351419,69,411085
5489,0.042206,172.31.40.0-255,66,351485,69,411085
5490,0.044218,172.31.40.0-255,172,351657,69,411085
5491,0.044297,172.31.40.0-255,1111,352768,69,411085
5492,0.044375,172.31.40.0-255,1514,354282,69,411085
5493,0.044377,172.31.40.0-255,1514,355796,69,411085
5494,0.044378,172.31.40.0-255,1514,357310,69,411085
5495,0.044379,172.31.40.0-255,1514,358824,69,411085
5496,0.04438,172.31.40.0-255,547,359371,69,411085
5497,0.04452,74.125.68.0-255,5738,365109,69,411085
5498,0.044529,172.31.40.0-255,66,365175,69,411085
5499,0.046365,104.244.42.0-255,66,365241,69,411085
5500,0.046843,74.125.68.0-255,5738,370979,69,411085
5501,0.046854,172.31.40.0-255,66,371045,69,411085
5502,0.049172,74.125.68.0-255,5738,376783,69,411085
5503,0.049188,172.31.40.0-255,66,376849,69,411085
5504,0.051531,74.125.68.0-255,5738,382587,69,411085
5505,0.051546,172.31.40.0-255,66,382653,69,411085
5506,0.053863,74.125.68.0-255,5738,388391,69,411085
5507,0.053878,172.31.40.0-255,66,388457,69,411085
5508,0.056208,74.125.68.0-255,5738,394195,69,411085
5509,0.05622,172.31.40.0-255,66,394261,69,411085
5510,0.058559,74.125.68.0-255,5738,399999,69,411085
5511,0.058575,172.31.40.0-255,66,400065,69,411085
5512,0.060934,74.125.68.0-255,5738,405803,69,411085
5513,0.06095,172.31.40.0-255,66,405869,69,411085
5514,0.063274,74.125.68.0-255,4979,410848,69,411085
5515,0.063289,172.31.40.0-255,66,410914,69,411085
5516,0.063515,172.31.40.0-255,105,411019,69,411085
5517,0.065788,74.125.68.0-255,66,411085,69,411085
5518,0.0,74.125.68.0-255,150,150,69,390904
5519,2.1e-05,172.31.40.0-255,66,216,69,390904
5520,2.8e-05,74.125.68.0-255,1484,1700,69,390904
5521,3.2e-05,172.31.40.0-255,66,1766,69,390904
5522,3.6e-05,74.125.68.0-255,2902,4668,69,390904
5523,4.8e-05,172.31.40.0-255,66,4734,69,390904
5524,5.6e-05,74.125.68.0-255,7156,11890,69,390904
5525,5.9e-05,172.31.40.0-255,66,11956,69,390904
5526,0.0001,172.31.40.0-255,66,12022,69,390904
5527,0.000111,172.31.40.0-255,66,12088,69,390904
5528,0.00015,74.125.68.0-255,2543,14631,69,390904
5529,0.000152,172.31.40.0-255,66,14697,69,390904
5530,0.000213,74.125.68.0-255,1484,16181,69,390904
5531,0.000217,172.31.40.0-255,66,16247,69,390904
5532,0.000244,74.125.68.0-255,2902,19149,69,390904
5533,0.000246,172.31.40.0-255,66,19215,69,390904
5534,0.00025,74.125.68.0-255,1484,20699,69,390904
5535,0.000252,172.31.40.0-255,66,20765,69,390904
5536,0.000272,74.125.68.0-255,2902,23667,69,390904
5537,0.000274,172.31.40.0-255,66,23733,69,390904
5538,0.000282,74.125.68.0-255,7156,30889,69,390904
5539,0.000285,172.31.40.0-255,66,30955,69,390904
5540,0.000318,74.125.68.0-255,1484,32439,69,390904
5541,0.000321,172.31.40.0-255,66,32505,69,390904
5542,0.000334,172.31.40.0-255,66,32571,69,390904
5543,0.000373,74.125.68.0-255,2902,35473,69,390904
5544,0.000376,172.31.40.0-255,66,35539,69,390904
5545,0.000403,74.125.68.0-255,2477,38016,69,390904
5546,0.000406,172.31.40.0-255,66,38082,69,390904
5547,0.000409,74.125.68.0-255,133,38215,69,390904
5548,0.000413,74.125.68.0-255,347,38562,69,390904
5549,0.000658,74.125.68.0-255,1484,40046,69,390904
5550,0.000665,172.31.40.0-255,66,40112,69,390904
5551,0.000684,74.125.68.0-255,2902,43014,69,390904
5552,0.000708,74.125.68.0-255,5738,48752,69,390904
5553,0.000714,172.31.40.0-255,66,48818,69,390904
5554,0.000725,74.125.68.0-255,4320,53138,69,390904
5555,0.000739,74.125.68.0-255,2543,55681,69,390904
5556,0.000742,172.31.40.0-255,66,55747,69,390904
5557,0.000768,172.31.40.0-255,66,55813,69,390904
5558,0.000858,74.125.68.0-255,1484,57297,69,390904
5559,0.000888,74.125.68.0-255,1484,58781,69,390904
5560,0.000893,172.31.40.0-255,66,58847,69,390904
5561,0.0009,74.125.68.0-255,1484,60331,69,390904
5562,0.000902,74.125.68.0-255,1484,61815,69,390904
5563,0.000931,74.125.68.0-255,1484,63299,69,390904
5564,0.000945,74.125.68.0-255,1484,64783,69,390904
5565,0.000951,74.125.68.0-255,5738,70521,69,390904
5566,0.000954,74.125.68.0-255,1484,72005,69,390904
5567,0.000968,74.125.68.0-255,1484,73489,69,390904
5568,0.000982,74.125.68.0-255,4320,77809,69,390904
5569,0.000988,172.31.40.0-255,66,77875,69,390904
5570,0.001019,74.125.68.0-255,4320,82195,69,390904
5571,0.001029,172.31.40.0-255,66,82261,69,390904
5572,0.001037,74.125.68.0-255,2902,85163,69,390904
5573,0.001042,172.31.40.0-255,66,85229,69,390904
5574,0.001066,74.125.68.0-255,5020,90249,69,390904
5575,0.001089,172.31.40.0-255,66,90315,69,390904
5576,0.001419,74.125.68.0-255,1484,91799,69,390904
5577,0.001438,74.125.68.0-255,2902,94701,69,390904
5578,0.001441,172.31.40.0-255,66,94767,69,390904
5579,0.001447,74.125.68.0-255,5738,100505,69,390904
5580,0.001468,74.125.68.0-255,6249,106754,69,390904
5581,0.001483,172.31.40.0-255,66,106820,69,390904
5582,0.001489,74.125.68.0-255,1484,108304,69,390904
5583,0.001509,74.125.68.0-255,5738,114042,69,390904
5584,0.001521,172.31.40.0-255,66,114108,69,390904
5585,0.001539,74.125.68.0-255,7156,121264,69,390904
5586,0.001543,74.125.68.0-255,2902,124166,69,390904
5587,0.001548,172.31.40.0-255,66,124232,69,390904
5588,0.001564,74.125.68.0-255,5738,129970,69,390904
5589,0.001582,74.125.68.0-255,5738,135708,69,390904
5590,0.001591,172.31.40.0-255,66,135774,69,390904
5591,0.001597,74.125.68.0-255,5020,140794,69,390904
5592,0.0016,172.31.40.0-255,66,140860,69,390904
5593,0.001887,74.125.68.0-255,1484,142344,69,390904
5594,0.001893,74.125.68.0-255,2902,145246,69,390904
5595,0.001895,172.31.40.0-255,66,145312,69,390904
5596,0.001925,74.125.68.0-255,5738,151050,69,390904
5597,0.001939,74.125.68.0-255,2902,153952,69,390904
5598,0.001945,172.31.40.0-255,66,154018,69,390904
5599,0.001962,74.125.68.0-255,4320,158338,69,390904
5600,0.001966,74.125.68.0-255,2902,161240,69,390904
5601,0.001972,172.31.40.0-255,66,161306,69,390904
5602,0.001998,74.125.68.0-255,4320,165626,69,390904
5603,0.002003,74.125.68.0-255,4320,169946,69,390904
5604,0.002009,172.31.40.0-255,66,170012,69,390904
5605,0.002027,74.125.68.0-255,4320,174332,69,390904
5606,0.00203,74.125.68.0-255,766,175098,69,390904
5607,0.00204,172.31.40.0-255,66,175164,69,390904
5608,0.004332,74.125.68.0-255,5738,180902,69,390904
5609,0.004338,172.31.40.0-255,66,180968,69,390904
5610,0.006631,74.125.68.0-255,5738,186706,69,390904
5611,0.007704,172.31.40.0-255,66,186772,69,390904
5612,0.010021,74.125.68.0-255,5738,192510,69,390904
5613,0.010029,172.31.40.0-255,66,192576,69,390904
5614,0.012339,74.125.68.0-255,5738,198314,69,390904
5615,0.015675,172.31.40.0-255,66,198380,69,390904
5616,0.017991,74.125.68.0-255,5738,204118,69,390904
5617,0.018001,172.31.40.0-255,66,204184,69,390904
5618,0.020304,74.125.68.0-255,5738,209922,69,390904
5619,0.020312,172.31.40.0-255,66,209988,69,390904
5620,0.022621,74.125.68.0-255,5738,215726,69,390904
5621,0.022629,172.31.40.0-255,66,215792,69,390904
5622,0.024934,74.125.68.0-255,5738,221530,69,390904
5623,0.02494,172.31.40.0-255,66,221596,69,390904
5624,0.026881,172.31.40.0-255,172,221768,69,390904
5625,0.026909,172.31.40.0-255,1116,222884,69,390904
5626,0.026964,172.31.40.0-255,1514,224398,69,390904
5627,0.02697,172.31.40.0-255,1514,225912,69,390904
5628,0.026971,172.31.40.0-255,1514,227426,69,390904
5629,0.026971,172.31.40.0-255,1514,228940,69,390904
5630,0.026972,172.31.40.0-255,540,229480,69,390904
5631,0.027233,74.125.68.0-255,5738,235218,69,390904
5632,0.027239,172.31.40.0-255,66,235284,69,390904
5633,0.02846,104.244.42.0-255,66,235350,69,390904
5634,0.028495,104.244.42.0-255,66,235416,69,390904
5635,0.028557,104.244.42.0-255,66,235482,69,390904
5636,0.028579,104.244.42.0-255,66,235548,69,390904
5637,0.029537,74.125.68.0-255,5738,241286,69,390904
5638,0.029543,172.31.40.0-255,66,241352,69,390904
5639,0.031853,74.125.68.0-255,5738,247090,69,390904
5640,0.031859,172.31.40.0-255,66,247156,69,390904
5641,0.034214,74.125.68.0-255,5738,252894,69,390904
5642,0.034219,172.31.40.0-255,66,252960,69,390904
5643,0.036523,74.125.68.0-255,5738,258698,69,390904
5644,0.036529,172.31.40.0-255,66,258764,69,390904
5645,0.03885,74.125.68.0-255,5738,264502,69,390904
5646,0.038857,172.31.40.0-255,66,264568,69,390904
5647,0.041153,74.125.68.0-255,5738,270306,69,390904
5648,0.04116,172.31.40.0-255,66,270372,69,390904
5649,0.043467,74.125.68.0-255,5738,276110,69,390904
5650,0.043474,172.31.40.0-255,66,276176,69,390904
5651,0.045793,74.125.68.0-255,5738,281914,69,390904
5652,0.0458,172.31.40.0-255,66,281980,69,390904
5653,0.048096,74.125.68.0-255,5738,287718,69,390904
5654,0.048102,172.31.40.0-255,66,287784,69,390904
5655,0.050416,74.125.68.0-255,5738,293522,69,390904
5656,0.050423,172.31.40.0-255,66,293588,69,390904
5657,0.052727,74.125.68.0-255,5738,299326,69,390904
5658,0.052736,172.31.40.0-255,66,299392,69,390904
5659,0.055048,74.125.68.0-255,5738,305130,69,390904
5660,0.055054,172.31.40.0-255,66,305196,69,390904
5661,0.057361,74.125.68.0-255,5738,310934,69,390904
5662,0.057367,172.31.40.0-255,66,311000,69,390904
5663,0.059683,74.125.68.0-255,5738,316738,69,390904
5664,0.059691,172.31.40.0-255,66,316804,69,390904
5665,0.062018,74.125.68.0-255,5738,322542,69,390904
5666,0.062024,172.31.40.0-255,66,322608,69,390904
5667,0.06435,74.125.68.0-255,5738,328346,69,390904
5668,0.064356,172.31.40.0-255,66,328412,69,390904
5669,0.066686,74.125.68.0-255,5738,334150,69,390904
5670,0.066693,172.31.40.0-255,66,334216,69,390904
5671,0.069019,74.125.68.0-255,5738,339954,69,390904
5672,0.069025,172.31.40.0-255,66,340020,69,390904
5673,0.071344,74.125.68.0-255,5738,345758,69,390904
5674,0.071349,172.31.40.0-255,66,345824,69,390904
5675,0.073662,74.125.68.0-255,5738,351562,69,390904
5676,0.073668,172.31.40.0-255,66,351628,69,390904
5677,0.07596,74.125.68.0-255,4320,355948,69,390904
5678,0.075967,172.31.40.0-255,66,356014,69,390904
5679,0.075997,74.125.68.0-255,1484,357498,69,390904
5680,0.078277,74.125.68.0-255,4320,361818,69,390904
5681,0.078284,172.31.40.0-255,66,361884,69,390904
5682,0.080592,74.125.68.0-255,5738,367622,69,390904
5683,0.08064,172.31.40.0-255,66,367688,69,390904
5684,0.082947,74.125.68.0-255,5738,373426,69,390904
5685,0.082954,172.31.40.0-255,66,373492,69,390904
5686,0.085256,74.125.68.0-255,5738,379230,69,390904
5687,0.085263,172.31.40.0-255,66,379296,69,390904
5688,0.087565,74.125.68.0-255,5738,385034,69,390904
5689,0.087572,172.31.40.0-255,66,385100,69,390904
5690,0.089882,74.125.68.0-255,5738,390838,69,390904
5691,0.089889,172.31.40.0-255,66,390904,69,390904
5692,0.0,172.217.160.0-255,153,153,69,379194
5693,2e-05,172.31.40.0-255,66,219,69,379194
5694,2.6e-05,172.217.160.0-255,1484,1703,69,379194
5695,2.9e-05,172.31.40.0-255,66,1769,69,379194
5696,3.4e-05,172.217.160.0-255,2902,4671,69,379194
5697,3.6e-05,172.31.40.0-255,66,4737,69,379194
5698,4.2e-05,172.217.160.0-255,7156,11893,69,379194
5699,4.5e-05,172.31.40.0-255,66,11959,69,379194
5700,6.9e-05,172.217.160.0-255,2077,14036,69,379194
5701,7.2e-05,172.31.40.0-255,66,14102,69,379194
5702,0.000104,172.217.160.0-255,2902,17004,69,379194
5703,0.000106,172.31.40.0-255,66,17070,69,379194
5704,0.00011,172.217.160.0-255,1484,18554,69,379194
5705,0.000111,172.31.40.0-255,66,18620,69,379194
5706,0.000126,172.217.160.0-255,1484,20104,69,379194
5707,0.000128,172.31.40.0-255,66,20170,69,379194
5708,0.000135,172.217.160.0-255,7156,27326,69,379194
5709,0.000137,172.31.40.0-255,66,27392,69,379194
5710,0.000165,172.217.160.0-255,2902,30294,69,379194
5711,0.000169,172.31.40.0-255,66,30360,69,379194
5712,0.000195,172.31.40.0-255,66,30426,69,379194
5713,0.000214,172.217.160.0-255,2543,32969,69,379194
5714,0.000216,172.31.40.0-255,66,33035,69,379194
5715,0.000222,172.217.160.0-255,6797,39832,69,379194
5716,0.000223,172.31.40.0-255,66,39898,69,379194
5717,0.000627,172.217.160.0-255,1484,41382,69,379194
5718,0.000633,172.31.40.0-255,66,41448,69,379194
5719,0.000638,172.217.160.0-255,2902,44350,69,379194
5720,0.00064,172.31.40.0-255,66,44416,69,379194
5721,0.000643,172.217.160.0-255,1484,45900,69,379194
5722,0.000646,172.31.40.0-255,66,45966,69,379194
5723,0.000666,172.217.160.0-255,4320,50286,69,379194
5724,0.00067,172.31.40.0-255,66,50352,69,379194
5725,0.000673,172.217.160.0-255,1484,51836,69,379194
5726,0.00069,172.217.160.0-255,5646,57482,69,379194
5727,0.000693,172.31.40.0-255,66,57548,69,379194
5728,0.000706,172.217.160.0-255,409,57957,69,379194
5729,0.000794,172.217.160.0-255,1484,59441,69,379194
5730,0.000797,172.31.40.0-255,66,59507,69,379194
5731,0.000802,172.217.160.0-255,2902,62409,69,379194
5732,0.000804,172.217.160.0-255,1484,63893,69,379194
5733,0.000806,172.31.40.0-255,66,63959,69,379194
5734,0.000822,172.217.160.0-255,4320,68279,69,379194
5735,0.000824,172.31.40.0-255,66,68345,69,379194
5736,0.000828,172.217.160.0-255,1484,69829,69,379194
5737,0.000848,172.217.160.0-255,5379,75208,69,379194
5738,0.000852,172.31.40.0-255,66,75274,69,379194
5739,0.000873,172.217.160.0-255,5738,81012,69,379194
5740,0.000876,172.31.40.0-255,66,81078,69,379194
5741,0.000896,172.31.40.0-255,66,81144,69,379194
5742,0.0009,172.217.160.0-255,1995,83139,69,379194
5743,0.000903,172.31.40.0-255,66,83205,69,379194
5744,0.000942,172.217.160.0-255,4320,87525,69,379194
5745,0.000946,172.31.40.0-255,66,87591,69,379194
5746,0.00097,172.31.40.0-255,66,87657,69,379194
5747,0.001068,172.217.160.0-255,200,87857,69,379194
5748,0.001374,172.217.160.0-255,1484,89341,69,379194
5749,0.00138,172.31.40.0-255,66,89407,69,379194
5750,0.001386,172.217.160.0-255,2902,92309,69,379194
5751,0.001389,172.31.40.0-255,66,92375,69,379194
5752,0.001395,172.217.160.0-255,5738,98113,69,379194
5753,0.001398,172.31.40.0-255,66,98179,69,379194
5754,0.001427,172.31.40.0-255,66,98245,69,379194
5755,0.001449,172.217.160.0-255,4320,102565,69,379194
5756,0.001452,172.31.40.0-255,66,102631,69,379194
5757,0.001486,172.217.160.0-255,2902,105533,69,379194
5758,0.001491,172.31.40.0-255,66,105599,69,379194
5759,0.001516,172.31.40.0-255,66,105665,69,379194
5760,0.001711,172.217.160.0-255,1484,107149,69,379194
5761,0.001717,172.217.160.0-255,2902,110051,69,379194
5762,0.001721,172.31.40.0-255,66,110117,69,379194
5763,0.001746,172.217.160.0-255,5738,115855,69,379194
5764,0.001751,172.31.40.0-255,66,115921,69,379194
5765,0.001756,172.217.160.0-255,5738,121659,69,379194
5766,0.001759,172.31.40.0-255,66,121725,69,379194
5767,0.001774,172.217.160.0-255,2902,124627,69,379194
5768,0.001777,172.31.40.0-255,66,124693,69,379194
5769,0.001803,172.217.160.0-255,4320,129013,69,379194
5770,0.001807,172.31.40.0-255,66,129079,69,379194
5771,0.00183,172.31.40.0-255,66,129145,69,379194
5772,0.003603,172.217.160.0-255,4320,133465,69,379194
5773,0.00361,172.31.40.0-255,66,133531,69,379194
5774,0.003625,172.217.160.0-255,1484,135015,69,379194
5775,0.005374,172.217.160.0-255,2902,137917,69,379194
5776,0.005379,172.31.40.0-255,66,137983,69,379194
5777,0.005397,172.217.160.0-255,1484,139467,69,379194
5778,0.007148,172.217.160.0-255,4320,143787,69,379194
5779,0.007153,172.31.40.0-255,66,143853,69,379194
5780,0.008927,172.217.160.0-255,4320,148173,69,379194
5781,0.008933,172.31.40.0-255,66,148239,69,379194
5782,0.008954,172.217.160.0-255,1484,149723,69,379194
5783,0.0107,172.217.160.0-255,4320,154043,69,379194
5784,0.010708,172.31.40.0-255,66,154109,69,379194
5785,0.012476,172.217.160.0-255,4320,158429,69,379194
5786,0.012482,172.31.40.0-255,66,158495,69,379194
5787,0.012509,172.217.160.0-255,1484,159979,69,379194
5788,0.014272,172.217.160.0-255,4320,164299,69,379194
5789,0.01428,172.31.40.0-255,66,164365,69,379194
5790,0.016062,172.217.160.0-255,5738,170103,69,379194
5791,0.016069,172.31.40.0-255,66,170169,69,379194
5792,0.017843,172.217.160.0-255,5738,175907,69,379194
5793,0.017849,172.31.40.0-255,66,175973,69,379194
5794,0.019645,172.217.160.0-255,5738,181711,69,379194
5795,0.01965,172.31.40.0-255,66,181777,69,379194
5796,0.021463,172.217.160.0-255,2902,184679,69,379194
5797,0.021468,172.31.40.0-255,66,184745,69,379194
5798,0.0215,172.217.160.0-255,2902,187647,69,379194
5799,0.021503,172.31.40.0-255,66,187713,69,379194
5800,0.023266,172.217.160.0-255,2902,190615,69,379194
5801,0.023272,172.31.40.0-255,66,190681,69,379194
5802,0.023314,172.217.160.0-255,1484,192165,69,379194
5803,0.023328,172.217.160.0-255,1484,193649,69,379194
5804,0.023331,172.31.40.0-255,66,193715,69,379194
5805,0.02512,172.217.160.0-255,2902,196617,69,379194
5806,0.025126,172.31.40.0-255,66,196683,69,379194
5807,0.025151,172.217.160.0-255,2902,199585,69,379194
5808,0.025154,172.31.40.0-255,66,199651,69,379194
5809,0.026985,172.217.160.0-255,2902,202553,69,379194
5810,0.026993,172.31.40.0-255,66,202619,69,379194
5811,0.027031,172.217.160.0-255,2902,205521,69,379194
5812,0.027035,172.31.40.0-255,66,205587,69,379194
5813,0.02879,172.217.160.0-255,2902,208489,69,379194
5814,0.028797,172.31.40.0-255,66,208555,69,379194
5815,0.028831,172.217.160.0-255,2902,211457,69,379194
5816,0.028835,172.31.40.0-255,66,211523,69,379194
5817,0.03057,172.217.160.0-255,2902,214425,69,379194
5818,0.030577,172.31.40.0-255,66,214491,69,379194
5819,0.030608,172.217.160.0-255,2902,217393,69,379194
5820,0.030612,172.31.40.0-255,66,217459,69,379194
5821,0.032346,172.217.160.0-255,2902,220361,69,379194
5822,0.032351,172.31.40.0-255,66,220427,69,379194
5823,0.032376,172.217.160.0-255,2902,223329,69,379194
5824,0.032379,172.31.40.0-255,66,223395,69,379194
5825,0.033659,172.31.40.0-255,172,223567,69,379194
5826,0.033686,172.31.40.0-255,1112,224679,69,379194
5827,0.033722,172.31.40.0-255,1514,226193,69,379194
5828,0.033723,172.31.40.0-255,1514,227707,69,379194
5829,0.033727,172.31.40.0-255,1514,229221,69,379194
5830,0.033729,172.31.40.0-255,1514,230735,69,379194
5831,0.033756,172.31.40.0-255,1503,232238,69,379194
5832,0.034133,172.217.160.0-255,2902,235140,69,379194
5833,0.034138,172.31.40.0-255,66,235206,69,379194
5834,0.034162,172.217.160.0-255,2902,238108,69,379194
5835,0.034165,172.31.40.0-255,66,238174,69,379194
5836,0.035323,104.244.42.0-255,66,238240,69,379194
5837,0.035381,104.244.42.0-255,66,238306,69,379194
5838,0.035432,104.244.42.0-255,66,238372,69,379194
5839,0.03592,172.217.160.0-255,2902,241274,69,379194
5840,0.035924,172.31.40.0-255,66,241340,69,379194
5841,0.035951,172.217.160.0-255,2902,244242,69,379194
5842,0.035953,172.31.40.0-255,66,244308,69,379194
5843,0.037691,172.217.160.0-255,2902,247210,69,379194
5844,0.037695,172.31.40.0-255,66,247276,69,379194
5845,0.037719,172.217.160.0-255,2902,250178,69,379194
5846,0.037721,172.31.40.0-255,66,250244,69,379194
5847,0.039474,172.217.160.0-255,2902,253146,69,379194
5848,0.03948,172.31.40.0-255,66,253212,69,379194
5849,0.039508,172.217.160.0-255,2902,256114,69,379194
5850,0.03951,172.31.40.0-255,66,256180,69,379194
5851,0.04125,172.217.160.0-255,2902,259082,69,379194
5852,0.041256,172.31.40.0-255,66,259148,69,379194
5853,0.041283,172.217.160.0-255,1484,260632,69,379194
5854,0.041299,172.217.160.0-255,1484,262116,69,379194
5855,0.041302,172.31.40.0-255,66,262182,69,379194
5856,0.043038,172.217.160.0-255,2902,265084,69,379194
5857,0.043043,172.31.40.0-255,66,265150,69,379194
5858,0.043073,172.217.160.0-255,2902,268052,69,379194
5859,0.043076,172.31.40.0-255,66,268118,69,379194
5860,0.044806,172.217.160.0-255,2902,271020,69,379194
5861,0.044811,172.31.40.0-255,66,271086,69,379194
5862,0.044838,172.217.160.0-255,2902,273988,69,379194
5863,0.04484,172.31.40.0-255,66,274054,69,379194
5864,0.046585,172.217.160.0-255,2902,276956,69,379194
5865,0.04659,172.31.40.0-255,66,277022,69,379194
5866,0.046624,172.217.160.0-255,2902,279924,69,379194
5867,0.046627,172.31.40.0-255,66,279990,69,379194
5868,0.048353,172.217.160.0-255,2902,282892,69,379194
5869,0.048358,172.31.40.0-255,66,282958,69,379194
5870,0.048454,172.217.160.0-255,2902,285860,69,379194
5871,0.048458,172.31.40.0-255,66,285926,69,379194
5872,0.05012,172.217.160.0-255,1484,287410,69,379194
5873,0.050143,172.217.160.0-255,1484,288894,69,379194
5874,0.050146,172.31.40.0-255,66,288960,69,379194
5875,0.050235,172.217.160.0-255,2902,291862,69,379194
5876,0.050239,172.31.40.0-255,66,291928,69,379194
5877,0.051905,172.217.160.0-255,2902,294830,69,379194
5878,0.051909,172.31.40.0-255,66,294896,69,379194
5879,0.052017,172.217.160.0-255,2902,297798,69,379194
5880,0.05202,172.31.40.0-255,66,297864,69,379194
5881,0.05367,172.217.160.0-255,2902,300766,69,379194
5882,0.053674,172.31.40.0-255,66,300832,69,379194
5883,0.053784,172.217.160.0-255,2902,303734,69,379194
5884,0.053788,172.31.40.0-255,66,303800,69,379194
5885,0.05544,172.217.160.0-255,2902,306702,69,379194
5886,0.055444,172.31.40.0-255,66,306768,69,379194
5887,0.05554,172.217.160.0-255,2902,309670,69,379194
5888,0.055543,172.31.40.0-255,66,309736,69,379194
5889,0.057206,172.217.160.0-255,2902,312638,69,379194
5890,0.057211,172.31.40.0-255,66,312704,69,379194
5891,0.0573,172.217.160.0-255,1484,314188,69,379194
5892,0.057314,172.217.160.0-255,1484,315672,69,379194
5893,0.057317,172.31.40.0-255,66,315738,69,379194
5894,0.058982,172.217.160.0-255,2902,318640,69,379194
5895,0.058987,172.31.40.0-255,66,318706,69,379194
5896,0.059098,172.217.160.0-255,2902,321608,69,379194
5897,0.059102,172.31.40.0-255,66,321674,69,379194
5898,0.060756,172.217.160.0-255,2902,324576,69,379194
5899,0.060761,172.31.40.0-255,66,324642,69,379194
5900,0.060857,172.217.160.0-255,2902,327544,69,379194
5901,0.060861,172.31.40.0-255,66,327610,69,379194
5902,0.062516,172.217.160.0-255,2902,330512,69,379194
5903,0.062521,172.31.40.0-255,66,330578,69,379194
5904,0.062647,172.217.160.0-255,2902,333480,69,379194
5905,0.062652,172.31.40.0-255,66,333546,69,379194
5906,0.064283,172.217.160.0-255,2902,336448,69,379194
5907,0.064288,172.31.40.0-255,66,336514,69,379194
5908,0.064411,172.217.160.0-255,2902,339416,69,379194
5909,0.064416,172.31.40.0-255,66,339482,69,379194
5910,0.066048,172.217.160.0-255,2902,342384,69,379194
5911,0.066054,172.31.40.0-255,66,342450,69,379194
5912,0.066184,172.217.160.0-255,1484,343934,69,379194
5913,0.0662,172.217.160.0-255,1484,345418,69,379194
5914,0.066204,172.31.40.0-255,66,345484,69,379194
5915,0.067825,172.217.160.0-255,2902,348386,69,379194
5916,0.067831,172.31.40.0-255,66,348452,69,379194
5917,0.067968,172.217.160.0-255,2902,351354,69,379194
5918,0.067973,172.31.40.0-255,66,351420,69,379194
5919,0.069604,172.217.160.0-255,2902,354322,69,379194
5920,0.069609,172.31.40.0-255,66,354388,69,379194
5921,0.069733,172.217.160.0-255,2902,357290,69,379194
5922,0.069738,172.31.40.0-255,66,357356,69,379194
5923,0.071374,172.217.160.0-255,2902,360258,69,379194
5924,0.071379,172.31.40.0-255,66,360324,69,379194
5925,0.071494,172.217.160.0-255,2902,363226,69,379194
5926,0.071499,172.31.40.0-255,66,363292,69,379194
5927,0.073149,172.217.160.0-255,1484,364776,69,379194
5928,0.073178,172.217.160.0-255,1484,366260,69,379194
5929,0.073182,172.31.40.0-255,66,366326,69,379194
5930,0.073257,172.217.160.0-255,2902,369228,69,379194
5931,0.073261,172.31.40.0-255,66,369294,69,379194
5932,0.074951,172.217.160.0-255,2902,372196,69,379194
5933,0.074955,172.31.40.0-255,66,372262,69,379194
5934,0.075011,172.217.160.0-255,2902,375164,69,379194
5935,0.075015,172.31.40.0-255,66,375230,69,379194
5936,0.076718,172.217.160.0-255,2902,378132,69,379194
5937,0.076722,172.31.40.0-255,66,378198,69,379194
5938,0.076754,172.217.160.0-255,759,378957,69,379194
5939,0.076883,172.31.40.0-255,66,379023,69,379194
5940,0.07691,172.31.40.0-255,105,379128,69,379194
5941,0.078633,172.217.160.0-255,66,379194,69,379194
5942,0.0,172.31.40.0-255,105,105,69,459
5943,0.000206,172.31.40.0-255,90,195,69,459
5944,0.000217,172.31.40.0-255,66,261,69,459
5945,0.002548,74.125.130.0-255,66,327,69,459
5946,0.002576,74.125.130.0-255,66,393,69,459
5947,0.002596,172.31.40.0-255,66,459,69,459
5948,0.0,74.125.24.0-255,295,295,69,224920
5949,2.3e-05,172.31.40.0-255,66,361,69,224920
5950,2.9e-05,74.125.24.0-255,1484,1845,69,224920
5951,3.4e-05,172.31.40.0-255,66,1911,69,224920
5952,3.9e-05,74.125.24.0-255,2902,4813,69,224920
5953,4.2e-05,172.31.40.0-255,66,4879,69,224920
5954,4.9e-05,74.125.24.0-255,5738,10617,69,224920
5955,5.2e-05,172.31.40.0-255,66,10683,69,224920
5956,7.1e-05,74.125.24.0-255,5738,16421,69,224920
5957,7.3e-05,172.31.40.0-255,66,16487,69,224920
5958,0.000111,172.31.40.0-255,66,16553,69,224920
5959,0.000118,74.125.24.0-255,6797,23350,69,224920
5960,0.00012,172.31.40.0-255,66,23416,69,224920
5961,0.000164,74.125.24.0-255,1484,24900,69,224920
5962,0.000167,172.31.40.0-255,66,24966,69,224920
5963,0.000179,74.125.24.0-255,2902,27868,69,224920
5964,0.000181,172.31.40.0-255,66,27934,69,224920
5965,0.000184,74.125.24.0-255,1484,29418,69,224920
5966,0.000185,172.31.40.0-255,66,29484,69,224920
5967,0.000213,74.125.24.0-255,4320,33804,69,224920
5968,0.000216,172.31.40.0-255,66,33870,69,224920
5969,0.000223,74.125.24.0-255,7156,41026,69,224920
5970,0.000225,172.31.40.0-255,66,41092,69,224920
5971,0.000242,74.125.24.0-255,5738,46830,69,224920
5972,0.000244,172.31.40.0-255,66,46896,69,224920
5973,0.00025,74.125.24.0-255,7156,54052,69,224920
5974,0.000252,172.31.40.0-255,66,54118,69,224920
5975,0.00028,74.125.24.0-255,3902,58020,69,224920
5976,0.000282,172.31.40.0-255,66,58086,69,224920
5977,0.000512,74.125.24.0-255,131,58217,69,224920
5978,0.000518,172.31.40.0-255,66,58283,69,224920
5979,0.000692,74.125.24.0-255,1484,59767,69,224920
5980,0.000699,74.125.24.0-255,2902,62669,69,224920
5981,0.000702,172.31.40.0-255,66,62735,69,224920
5982,0.000709,74.125.24.0-255,4320,67055,69,224920
5983,0.000711,172.31.40.0-255,66,67121,69,224920
5984,0.000724,74.125.24.0-255,1484,68605,69,224920
5985,0.000731,74.125.24.0-255,7156,75761,69,224920
5986,0.000734,172.31.40.0-255,66,75827,69,224920
5987,0.000771,172.31.40.0-255,66,75893,69,224920
5988,0.000776,74.125.24.0-255,2184,78077,69,224920
5989,0.000778,172.31.40.0-255,66,78143,69,224920
5990,0.000828,74.125.24.0-255,5738,83881,69,224920
5991,0.000832,172.31.40.0-255,66,83947,69,224920
5992,0.000857,74.125.24.0-255,7156,91103,69,224920
5993,0.00086,172.31.40.0-255,66,91169,69,224920
5994,0.000875,172.31.40.0-255,66,91235,69,224920
5995,0.000917,172.31.40.0-255,66,91301,69,224920
5996,0.000967,172.31.40.0-255,66,91367,69,224920
5997,0.000994,74.125.24.0-255,5738,97105,69,224920
5998,0.000996,172.31.40.0-255,66,97171,69,224920
5999,0.001004,74.125.24.0-255,6718,103889,69,224920
6000,0.001006,172.31.40.0-255,66,103955,69,224920
6001,0.001331,74.125.24.0-255,1484,105439,69,224920
6002,0.001364,74.125.24.0-255,2902,108341,69,224920
6003,0.001368,172.31.40.0-255,66,108407,69,224920
6004,0.001375,74.125.24.0-255,5738,114145,69,224920
6005,0.001377,172.31.40.0-255,66,114211,69,224920
6006,0.001383,74.125.24.0-255,4320,118531,69,224920
6007,0.001385,172.31.40.0-255,66,118597,69,224920
6008,0.001406,74.125.24.0-255,2902,121499,69,224920
6009,0.001408,172.31.40.0-255,66,121565,69,224920
6010,0.001437,74.125.24.0-255,7156,128721,69,224920
6011,0.00144,172.31.40.0-255,66,128787,69,224920
6012,0.00147,172.31.40.0-255,66,128853,69,224920
6013,0.001477,74.125.24.0-255,5738,134591,69,224920
6014,0.001479,172.31.40.0-255,66,134657,69,224920
6015,0.001483,74.125.24.0-255,2902,137559,69,224920
6016,0.001485,172.31.40.0-255,66,137625,69,224920
6017,0.00151,74.125.24.0-255,4320,141945,69,224920
6018,0.001513,172.31.40.0-255,66,142011,69,224920
6019,0.001525,172.31.40.0-255,66,142077,69,224920
6020,0.001549,74.125.24.0-255,4320,146397,69,224920
6021,0.001552,172.31.40.0-255,66,146463,69,224920
6022,0.001559,74.125.24.0-255,6438,152901,69,224920
6023,0.001562,172.31.40.0-255,66,152967,69,224920
6024,0.00166,74.125.24.0-255,1484,154451,69,224920
6025,0.001666,74.125.24.0-255,2902,157353,69,224920
6026,0.00167,172.31.40.0-255,66,157419,69,224920
6027,0.001696,74.125.24.0-255,5738,163157,69,224920
6028,0.001698,172.31.40.0-255,66,163223,69,224920
6029,0.001705,74.125.24.0-255,5738,168961,69,224920
6030,0.001707,172.31.40.0-255,66,169027,69,224920
6031,0.001733,74.125.24.0-255,7156,176183,69,224920
6032,0.001735,172.31.40.0-255,66,176249,69,224920
6033,0.001749,172.31.40.0-255,66,176315,69,224920
6034,0.001976,74.125.24.0-255,1484,177799,69,224920
6035,0.001983,74.125.24.0-255,2902,180701,69,224920
6036,0.001986,172.31.40.0-255,66,180767,69,224920
6037,0.001992,74.125.24.0-255,4320,185087,69,224920
6038,0.001995,172.31.40.0-255,66,185153,69,224920
6039,0.002009,74.125.24.0-255,1484,186637,69,224920
6040,0.002013,74.125.24.0-255,2902,189539,69,224920
6041,0.002016,172.31.40.0-255,66,189605,69,224920
6042,0.002047,172.31.40.0-255,66,189671,69,224920
6043,0.00206,172.31.40.0-255,66,189737,69,224920
6044,0.002106,74.125.24.0-255,1484,191221,69,224920
6045,0.002112,74.125.24.0-255,2902,194123,69,224920
6046,0.002115,172.31.40.0-255,66,194189,69,224920
6047,0.002119,74.125.24.0-255,2902,197091,69,224920
6048,0.002121,172.31.40.0-255,66,197157,69,224920
6049,0.002135,74.125.24.0-255,2902,200059,69,224920
6050,0.002138,172.31.40.0-255,66,200125,69,224920
6051,0.002145,74.125.24.0-255,5738,205863,69,224920
6052,0.002148,172.31.40.0-255,66,205929,69,224920
6053,0.002154,74.125.24.0-255,4320,210249,69,224920
6054,0.002155,172.31.40.0-255,66,210315,69,224920
6055,0.002188,172.31.40.0-255,66,210381,69,224920
6056,0.002192,74.125.24.0-255,2902,213283,69,224920
6057,0.002194,172.31.40.0-255,66,213349,69,224920
6058,0.002238,172.31.40.0-255,66,213415,69,224920
6059,0.002253,172.31.40.0-255,66,213481,69,224920
6060,0.002269,172.31.40.0-255,66,213547,69,224920
6061,0.002361,172.31.40.0-255,66,213613,69,224920
6062,0.002365,74.125.24.0-255,1617,215230,69,224920
6063,0.002368,172.31.40.0-255,66,215296,69,224920
6064,0.002371,74.125.24.0-255,105,215401,69,224920
6065,0.011402,172.31.40.0-255,66,215467,69,224920
6066,0.011448,172.31.40.0-255,105,215572,69,224920
6067,0.014017,74.125.24.0-255,66,215638,69,224920
6068,0.03813,172.31.40.0-255,172,215810,69,224920
6069,0.038163,172.31.40.0-255,1116,216926,69,224920
6070,0.038226,172.31.40.0-255,1514,218440,69,224920
6071,0.038228,172.31.40.0-255,1514,219954,69,224920
6072,0.03823,172.31.40.0-255,1514,221468,69,224920
6073,0.038231,172.31.40.0-255,1514,222982,69,224920
6074,0.038263,172.31.40.0-255,1500,224482,69,224920
6075,0.039632,104.244.42.0-255,66,224548,69,224920
6076,0.03973,104.244.42.0-255,66,224614,69,224920
6077,0.039775,104.244.42.0-255,66,224680,69,224920
6078,0.039829,104.244.42.0-255,66,224746,69,224920
6079,0.040446,104.244.42.0-255,108,224854,69,224920
6080,0.040457,172.31.40.0-255,66,224920,69,224920
6081,0.0,172.217.194.0-255,146,146,69,334974
6082,2.3e-05,172.31.40.0-255,66,212,69,334974
6083,3e-05,172.217.194.0-255,1484,1696,69,334974
6084,3.5e-05,172.31.40.0-255,66,1762,69,334974
6085,6.1e-05,172.217.194.0-255,2902,4664,69,334974
6086,6.5e-05,172.31.40.0-255,66,4730,69,334974
6087,7.7e-05,172.217.194.0-255,7156,11886,69,334974
6088,7.9e-05,172.31.40.0-255,66,11952,69,334974
6089,8.4e-05,172.217.194.0-255,2161,14113,69,334974
6090,8.6e-05,172.31.40.0-255,66,14179,69,334974
6091,0.000172,172.217.194.0-255,1484,15663,69,334974
6092,0.000175,172.31.40.0-255,66,15729,69,334974
6093,0.000181,172.217.194.0-255,2902,18631,69,334974
6094,0.000183,172.31.40.0-255,66,18697,69,334974
6095,0.000204,172.217.194.0-255,5738,24435,69,334974
6096,0.000208,172.31.40.0-255,66,24501,69,334974
6097,0.000242,172.217.194.0-255,6797,31298,69,334974
6098,0.000245,172.31.40.0-255,66,31364,69,334974
6099,0.000275,172.217.194.0-255,7156,38520,69,334974
6100,0.000278,172.31.40.0-255,66,38586,69,334974
6101,0.000283,172.217.194.0-255,4320,42906,69,334974
6102,0.000286,172.31.40.0-255,66,42972,69,334974
6103,0.000338,172.217.194.0-255,1484,44456,69,334974
6104,0.000341,172.31.40.0-255,66,44522,69,334974
6105,0.000369,172.217.194.0-255,3961,48483,69,334974
6106,0.000371,172.31.40.0-255,66,48549,69,334974
6107,0.000378,172.217.194.0-255,2902,51451,69,334974
6108,0.000381,172.31.40.0-255,66,51517,69,334974
6109,0.00041,172.217.194.0-255,2902,54419,69,334974
6110,0.000413,172.31.40.0-255,66,54485,69,334974
6111,0.000421,172.217.194.0-255,7156,61641,69,334974
6112,0.000423,172.31.40.0-255,66,61707,69,334974
6113,0.000453,172.217.194.0-255,3961,65668,69,334974
6114,0.000456,172.31.40.0-255,66,65734,69,334974
6115,0.000512,172.217.194.0-255,362,66096,69,334974
6116,0.000555,172.217.194.0-255,380,66476,69,334974
6117,0.000995,172.217.194.0-255,1484,67960,69,334974
6118,0.000999,172.31.40.0-255,66,68026,69,334974
6119,0.001005,172.217.194.0-255,2902,70928,69,334974
6120,0.001007,172.31.40.0-255,66,70994,69,334974
6121,0.001037,172.217.194.0-255,5738,76732,69,334974
6122,0.00104,172.31.40.0-255,66,76798,69,334974
6123,0.001045,172.217.194.0-255,2902,79700,69,334974
6124,0.001047,172.31.40.0-255,66,79766,69,334974
6125,0.001085,172.31.40.0-255,66,79832,69,334974
6126,0.001133,172.31.40.0-255,66,79898,69,334974
6127,0.001137,172.217.194.0-255,1484,81382,69,334974
6128,0.001167,172.217.194.0-255,1484,82866,69,334974
6129,0.001172,172.217.194.0-255,4320,87186,69,334974
6130,0.00119,172.31.40.0-255,66,87252,69,334974
6131,0.001194,172.31.40.0-255,66,87318,69,334974
6132,0.001197,172.31.40.0-255,66,87384,69,334974
6133,0.001203,172.217.194.0-255,4320,91704,69,334974
6134,0.001205,172.31.40.0-255,66,91770,69,334974
6135,0.001238,172.31.40.0-255,66,91836,69,334974
6136,0.001756,172.217.194.0-255,1484,93320,69,334974
6137,0.001762,172.217.194.0-255,2902,96222,69,334974
6138,0.001766,172.31.40.0-255,66,96288,69,334974
6139,0.00177,172.217.194.0-255,1484,97772,69,334974
6140,0.001798,172.217.194.0-255,4320,102092,69,334974
6141,0.001801,172.31.40.0-255,66,102158,69,334974
6142,0.001815,172.31.40.0-255,66,102224,69,334974
6143,0.001846,172.217.194.0-255,1484,103708,69,334974
6144,0.001858,172.31.40.0-255,66,103774,69,334974
6145,0.001894,172.217.194.0-255,5738,109512,69,334974
6146,0.001898,172.31.40.0-255,66,109578,69,334974
6147,0.001939,172.31.40.0-255,66,109644,69,334974
6148,0.001959,172.31.40.0-255,66,109710,69,334974
6149,0.001969,172.31.40.0-255,66,109776,69,334974
6150,0.002006,172.217.194.0-255,1484,111260,69,334974
6151,0.00201,172.217.194.0-255,1484,112744,69,334974
6152,0.002013,172.31.40.0-255,66,112810,69,334974
6153,0.002039,172.217.194.0-255,1484,114294,69,334974
6154,0.002046,172.217.194.0-255,5738,120032,69,334974
6155,0.002048,172.31.40.0-255,66,120098,69,334974
6156,0.002054,172.217.194.0-255,4320,124418,69,334974
6157,0.002056,172.31.40.0-255,66,124484,69,334974
6158,0.002078,172.217.194.0-255,1484,125968,69,334974
6159,0.004099,172.217.194.0-255,4320,130288,69,334974
6160,0.00411,172.31.40.0-255,66,130354,69,334974
6161,0.006112,172.217.194.0-255,2902,133256,69,334974
6162,0.006116,172.31.40.0-255,66,133322,69,334974
6163,0.006142,172.217.194.0-255,2902,136224,69,334974
6164,0.006144,172.31.40.0-255,66,136290,69,334974
6165,0.008093,172.217.194.0-255,2902,139192,69,334974
6166,0.008096,172.31.40.0-255,66,139258,69,334974
6167,0.00814,172.217.194.0-255,2902,142160,69,334974
6168,0.008142,172.31.40.0-255,66,142226,69,334974
6169,0.010097,172.217.194.0-255,2902,145128,69,334974
6170,0.010108,172.31.40.0-255,66,145194,69,334974
6171,0.010192,172.217.194.0-255,2902,148096,69,334974
6172,0.010197,172.31.40.0-255,66,148162,69,334974
6173,0.012117,172.217.194.0-255,2902,151064,69,334974
6174,0.012126,172.31.40.0-255,66,151130,69,334974
6175,0.012207,172.217.194.0-255,2902,154032,69,334974
6176,0.012211,172.31.40.0-255,66,154098,69,334974
6177,0.014165,172.217.194.0-255,2902,157000,69,334974
6178,0.014175,172.31.40.0-255,66,157066,69,334974
6179,0.014212,172.217.194.0-255,2902,159968,69,334974
6180,0.014215,172.31.40.0-255,66,160034,69,334974
6181,0.016163,172.217.194.0-255,5738,165772,69,334974
6182,0.016184,172.31.40.0-255,66,165838,69,334974
6183,0.018192,172.217.194.0-255,5738,171576,69,334974
6184,0.018209,172.31.40.0-255,66,171642,69,334974
6185,0.020216,172.217.194.0-255,5738,177380,69,334974
6186,0.020234,172.31.40.0-255,66,177446,69,334974
6187,0.022248,172.217.194.0-255,5738,183184,69,334974
6188,0.022259,172.31.40.0-255,66,183250,69,334974
6189,0.024288,172.217.194.0-255,5738,188988,69,334974
6190,0.024301,172.31.40.0-255,66,189054,69,334974
6191,0.026336,172.217.194.0-255,5738,194792,69,334974
6192,0.026353,172.31.40.0-255,66,194858,69,334974
6193,0.028417,172.217.194.0-255,5738,200596,69,334974
6194,0.028427,172.31.40.0-255,66,200662,69,334974
6195,0.030423,172.217.194.0-255,5738,206400,69,334974
6196,0.030431,172.31.40.0-255,66,206466,69,334974
6197,0.032442,172.217.194.0-255,5738,212204,69,334974
6198,0.032453,172.31.40.0-255,66,212270,69,334974
6199,0.034493,172.217.194.0-255,5738,218008,69,334974
6200,0.034504,172.31.40.0-255,66,218074,69,334974
6201,0.03654,172.217.194.0-255,5738,223812,69,334974
6202,0.036549,172.31.40.0-255,66,223878,69,334974
6203,0.037599,172.31.40.0-255,172,224050,69,334974
6204,0.037635,172.31.40.0-255,1111,225161,69,334974
6205,0.0377,172.31.40.0-255,1514,226675,69,334974
6206,0.037702,172.31.40.0-255,1514,228189,69,334974
6207,0.037703,172.31.40.0-255,1514,229703,69,334974
6208,0.037704,172.31.40.0-255,1514,231217,69,334974
6209,0.037705,172.31.40.0-255,546,231763,69,334974
6210,0.038535,172.217.194.0-255,5738,237501,69,334974
6211,0.038543,172.31.40.0-255,66,237567,69,334974
6212,0.039124,104.244.42.0-255,66,237633,69,334974
6213,0.039186,104.244.42.0-255,66,237699,69,334974
6214,0.039297,104.244.42.0-255,66,237765,69,334974
6215,0.0393,104.244.42.0-255,66,237831,69,334974
6216,0.040512,172.217.194.0-255,5738,243569,69,334974
6217,0.040522,172.31.40.0-255,66,243635,69,334974
6218,0.042526,172.217.194.0-255,5738,249373,69,334974
6219,0.042533,172.31.40.0-255,66,249439,69,334974
6220,0.044573,172.217.194.0-255,5738,255177,69,334974
6221,0.044581,172.31.40.0-255,66,255243,69,334974
6222,0.046567,172.217.194.0-255,5738,260981,69,334974
6223,0.046573,172.31.40.0-255,66,261047,69,334974
6224,0.048575,172.217.194.0-255,5738,266785,69,334974
6225,0.04858,172.31.40.0-255,66,266851,69,334974
6226,0.050544,172.217.194.0-255,5738,272589,69,334974
6227,0.050551,172.31.40.0-255,66,272655,69,334974
6228,0.052543,172.217.194.0-255,4320,276975,69,334974
6229,0.052551,172.31.40.0-255,66,277041,69,334974
6230,0.052579,172.217.194.0-255,1484,278525,69,334974
6231,0.054538,172.217.194.0-255,4320,282845,69,334974
6232,0.054548,172.31.40.0-255,66,282911,69,334974
6233,0.056549,172.217.194.0-255,5738,288649,69,334974
6234,0.056557,172.31.40.0-255,66,288715,69,334974
6235,0.058571,172.217.194.0-255,5738,294453,69,334974
6236,0.05858,172.31.40.0-255,66,294519,69,334974
6237,0.06059,172.217.194.0-255,5738,300257,69,334974
6238,0.060603,172.31.40.0-255,66,300323,69,334974
6239,0.062606,172.217.194.0-255,5738,306061,69,334974
6240,0.062613,172.31.40.0-255,66,306127,69,334974
6241,0.064644,172.217.194.0-255,5738,311865,69,334974
6242,0.064652,172.31.40.0-255,66,311931,69,334974
6243,0.066654,172.217.194.0-255,5738,317669,69,334974
6244,0.066671,172.31.40.0-255,66,317735,69,334974
6245,0.068663,172.217.194.0-255,5738,323473,69,334974
6246,0.068676,172.31.40.0-255,66,323539,69,334974
6247,0.070681,172.217.194.0-255,5738,329277,69,334974
6248,0.070688,172.31.40.0-255,66,329343,69,334974
6249,0.072717,172.217.194.0-255,5394,334737,69,334974
6250,0.072725,172.31.40.0-255,66,334803,69,334974
6251,0.07293,172.31.40.0-255,105,334908,69,334974
6252,0.075005,172.217.194.0-255,66,334974,69,334974
6253,0.0,172.217.194.0-255,146,146,69,153452
6254,2.3e-05,172.31.40.0-255,66,212,69,153452
6255,3e-05,172.217.194.0-255,1484,1696,69,153452
6256,3.4e-05,172.31.40.0-255,66,1762,69,153452
6257,3.9e-05,172.217.194.0-255,2902,4664,69,153452
6258,4.2e-05,172.31.40.0-255,66,4730,69,153452
6259,5e-05,172.217.194.0-255,7156,11886,69,153452
6260,5.2e-05,172.31.40.0-255,66,11952,69,153452
6261,5.6e-05,172.217.194.0-255,2138,14090,69,153452
6262,6e-05,172.31.40.0-255,66,14156,69,153452
6263,9.5e-05,172.31.40.0-255,66,14222,69,153452
6264,0.000125,172.217.194.0-255,2902,17124,69,153452
6265,0.000127,172.31.40.0-255,66,17190,69,153452
6266,0.000134,172.217.194.0-255,5379,22569,69,153452
6267,0.000137,172.31.40.0-255,66,22635,69,153452
6268,0.000143,172.217.194.0-255,5738,28373,69,153452
6269,0.000146,172.31.40.0-255,66,28439,69,153452
6270,0.000152,172.217.194.0-255,7156,35595,69,153452
6271,0.000155,172.31.40.0-255,66,35661,69,153452
6272,0.000179,172.217.194.0-255,3961,39622,69,153452
6273,0.000181,172.31.40.0-255,66,39688,69,153452
6274,0.000338,172.217.194.0-255,1484,41172,69,153452
6275,0.000342,172.31.40.0-255,66,41238,69,153452
6276,0.00037,172.217.194.0-255,2902,44140,69,153452
6277,0.000373,172.31.40.0-255,66,44206,69,153452
6278,0.000378,172.217.194.0-255,4320,48526,69,153452
6279,0.00038,172.31.40.0-255,66,48592,69,153452
6280,0.000396,172.217.194.0-255,1484,50076,69,153452
6281,0.000398,172.31.40.0-255,66,50142,69,153452
6282,0.000405,172.217.194.0-255,5738,55880,69,153452
6283,0.000407,172.31.40.0-255,66,55946,69,153452
6284,0.000428,172.217.194.0-255,1739,57685,69,153452
6285,0.00043,172.31.40.0-255,66,57751,69,153452
6286,0.000517,172.217.194.0-255,1484,59235,69,153452
6287,0.000522,172.217.194.0-255,1484,60719,69,153452
6288,0.000525,172.31.40.0-255,66,60785,69,153452
6289,0.000539,172.217.194.0-255,1484,62269,69,153452
6290,0.000546,172.217.194.0-255,5738,68007,69,153452
6291,0.000549,172.31.40.0-255,66,68073,69,153452
6292,0.000553,172.217.194.0-255,2902,70975,69,153452
6293,0.000555,172.31.40.0-255,66,71041,69,153452
6294,0.00058,172.217.194.0-255,3961,75002,69,153452
6295,0.000583,172.31.40.0-255,66,75068,69,153452
6296,0.000626,172.31.40.0-255,66,75134,69,153452
6297,0.000641,172.217.194.0-255,1484,76618,69,153452
6298,0.000648,172.217.194.0-255,3961,80579,69,153452
6299,0.00065,172.31.40.0-255,66,80645,69,153452
6300,0.000935,172.217.194.0-255,1484,82129,69,153452
6301,0.000942,172.217.194.0-255,2902,85031,69,153452
6302,0.000945,172.31.40.0-255,66,85097,69,153452
6303,0.000952,172.217.194.0-255,5738,90835,69,153452
6304,0.000955,172.31.40.0-255,66,90901,69,153452
6305,0.000981,172.31.40.0-255,66,90967,69,153452
6306,0.001004,172.217.194.0-255,4320,95287,69,153452
6307,0.001007,172.31.40.0-255,66,95353,69,153452
6308,0.001015,172.217.194.0-255,7156,102509,69,153452
6309,0.001017,172.31.40.0-255,66,102575,69,153452
6310,0.001033,172.217.194.0-255,3602,106177,69,153452
6311,0.001036,172.31.40.0-255,66,106243,69,153452
6312,0.001155,172.217.194.0-255,1484,107727,69,153452
6313,0.001162,172.217.194.0-255,2902,110629,69,153452
6314,0.001165,172.31.40.0-255,66,110695,69,153452
6315,0.001172,172.217.194.0-255,5738,116433,69,153452
6316,0.001174,172.31.40.0-255,66,116499,69,153452
6317,0.001208,172.31.40.0-255,66,116565,69,153452
6318,0.00123,172.217.194.0-255,1484,118049,69,153452
6319,0.001243,172.31.40.0-255,66,118115,69,153452
6320,0.001306,172.217.194.0-255,1484,119599,69,153452
6321,0.001321,172.217.194.0-255,2902,122501,69,153452
6322,0.001324,172.31.40.0-255,66,122567,69,153452
6323,0.001331,172.217.194.0-255,5738,128305,69,153452
6324,0.001333,172.31.40.0-255,66,128371,69,153452
6325,0.001346,172.217.194.0-255,1484,129855,69,153452
6326,0.001374,172.31.40.0-255,66,129921,69,153452
6327,0.001387,172.31.40.0-255,66,129987,69,153452
6328,0.00177,172.217.194.0-255,1484,131471,69,153452
6329,0.001777,172.217.194.0-255,2902,134373,69,153452
6330,0.001781,172.31.40.0-255,66,134439,69,153452
6331,0.001788,172.217.194.0-255,5738,140177,69,153452
6332,0.001791,172.31.40.0-255,66,140243,69,153452
6333,0.001805,172.31.40.0-255,66,140309,69,153452
6334,0.001911,172.31.40.0-255,66,140375,69,153452
6335,0.001958,172.31.40.0-255,66,140441,69,153452
6336,0.002044,172.31.40.0-255,66,140507,69,153452
6337,0.002076,172.217.194.0-255,4320,144827,69,153452
6338,0.002101,172.31.40.0-255,66,144893,69,153452
6339,0.002142,172.31.40.0-255,66,144959,69,153452
6340,0.002205,172.217.194.0-255,105,145064,69,153452
6341,0.002226,172.31.40.0-255,66,145130,69,153452
6342,0.012944,172.31.40.0-255,105,145235,69,153452
6343,0.015188,172.217.194.0-255,66,145301,69,153452
6344,0.039817,172.31.40.0-255,172,145473,69,153452
6345,0.039852,172.31.40.0-255,1111,146584,69,153452
6346,0.039916,172.31.40.0-255,1514,148098,69,153452
6347,0.039918,172.31.40.0-255,1514,149612,69,153452
6348,0.03992,172.31.40.0-255,1514,151126,69,153452
6349,0.039921,172.31.40.0-255,1514,152640,69,153452
6350,0.039946,172.31.40.0-255,548,153188,69,153452
6351,0.04131,104.244.42.0-255,66,153254,69,153452
6352,0.041341,104.244.42.0-255,66,153320,69,153452
6353,0.041422,104.244.42.0-255,66,153386,69,153452
6354,0.041427,104.244.42.0-255,66,153452,69,153452
6355,0.0,216.58.221.0-255,153,153,69,254517
6356,2.5e-05,172.31.40.0-255,66,219,69,254517
6357,3e-05,216.58.221.0-255,1484,1703,69,254517
6358,3.4e-05,172.31.40.0-255,66,1769,69,254517
6359,3.8e-05,216.58.221.0-255,2902,4671,69,254517
6360,4e-05,172.31.40.0-255,66,4737,69,254517
6361,7.2e-05,216.58.221.0-255,7156,11893,69,254517
6362,7.5e-05,172.31.40.0-255,66,11959,69,254517
6363,9.8e-05,216.58.221.0-255,1484,13443,69,254517
6364,0.0001,172.31.40.0-255,66,13509,69,254517
6365,0.000116,216.58.221.0-255,687,14196,69,254517
6366,0.000118,172.31.40.0-255,66,14262,69,254517
6367,0.000212,216.58.221.0-255,1484,15746,69,254517
6368,0.000215,172.31.40.0-255,66,15812,69,254517
6369,0.000218,216.58.221.0-255,1484,17296,69,254517
6370,0.00022,172.31.40.0-255,66,17362,69,254517
6371,0.000246,216.58.221.0-255,1484,18846,69,254517
6372,0.000248,172.31.40.0-255,66,18912,69,254517
6373,0.000253,216.58.221.0-255,2902,21814,69,254517
6374,0.000257,216.58.221.0-255,4320,26134,69,254517
6375,0.000257,172.31.40.0-255,66,26200,69,254517
6376,0.000259,172.31.40.0-255,66,26266,69,254517
6377,0.000285,216.58.221.0-255,1484,27750,69,254517
6378,0.000288,172.31.40.0-255,66,27816,69,254517
6379,0.000322,172.31.40.0-255,66,27882,69,254517
6380,0.000359,216.58.221.0-255,4320,32202,69,254517
6381,0.000363,172.31.40.0-255,66,32268,69,254517
6382,0.00039,216.58.221.0-255,5738,38006,69,254517
6383,0.000394,172.31.40.0-255,66,38072,69,254517
6384,0.000436,216.58.221.0-255,2543,40615,69,254517
6385,0.000439,172.31.40.0-255,66,40681,69,254517
6386,0.000443,216.58.221.0-255,2902,43583,69,254517
6387,0.000445,172.31.40.0-255,66,43649,69,254517
6388,0.000474,216.58.221.0-255,7156,50805,69,254517
6389,0.000477,172.31.40.0-255,66,50871,69,254517
6390,0.000517,216.58.221.0-255,1484,52355,69,254517
6391,0.000533,216.58.221.0-255,5669,58024,69,254517
6392,0.000536,172.31.40.0-255,66,58090,69,254517
6393,0.001163,216.58.221.0-255,135,58225,69,254517
6394,0.001327,216.58.221.0-255,1484,59709,69,254517
6395,0.001332,172.31.40.0-255,66,59775,69,254517
6396,0.001338,216.58.221.0-255,2902,62677,69,254517
6397,0.00134,172.31.40.0-255,66,62743,69,254517
6398,0.001345,216.58.221.0-255,4320,67063,69,254517
6399,0.001351,172.31.40.0-255,66,67129,69,254517
6400,0.001373,216.58.221.0-255,1484,68613,69,254517
6401,0.001376,216.58.221.0-255,1484,70097,69,254517
6402,0.001377,172.31.40.0-255,66,70163,69,254517
6403,0.001399,216.58.221.0-255,2902,73065,69,254517
6404,0.001401,172.31.40.0-255,66,73131,69,254517
6405,0.001405,216.58.221.0-255,2543,75674,69,254517
6406,0.001407,172.31.40.0-255,66,75740,69,254517
6407,0.001452,216.58.221.0-255,2902,78642,69,254517
6408,0.001454,172.31.40.0-255,66,78708,69,254517
6409,0.001476,216.58.221.0-255,2902,81610,69,254517
6410,0.001477,172.31.40.0-255,66,81676,69,254517
6411,0.001483,216.58.221.0-255,7156,88832,69,254517
6412,0.001485,172.31.40.0-255,66,88898,69,254517
6413,0.001534,216.58.221.0-255,3961,92859,69,254517
6414,0.001536,172.31.40.0-255,66,92925,69,254517
6415,0.001848,216.58.221.0-255,1484,94409,69,254517
6416,0.001864,216.58.221.0-255,2902,97311,69,254517
6417,0.001866,172.31.40.0-255,66,97377,69,254517
6418,0.001876,216.58.221.0-255,1484,98861,69,254517
6419,0.001896,216.58.221.0-255,4320,103181,69,254517
6420,0.001898,172.31.40.0-255,66,103247,69,254517
6421,0.00191,216.58.221.0-255,1484,104731,69,254517
6422,0.001928,216.58.221.0-255,7156,111887,69,254517
6423,0.001931,172.31.40.0-255,66,111953,69,254517
6424,0.001954,216.58.221.0-255,4320,116273,69,254517
6425,0.001956,172.31.40.0-255,66,116339,69,254517
6426,0.00201,216.58.221.0-255,4320,120659,69,254517
6427,0.002012,172.31.40.0-255,66,120725,69,254517
6428,0.00203,216.58.221.0-255,5738,126463,69,254517
6429,0.002032,172.31.40.0-255,66,126529,69,254517
6430,0.002055,216.58.221.0-255,766,127295,69,254517
6431,0.002086,216.58.221.0-255,1484,128779,69,254517
6432,0.002088,172.31.40.0-255,66,128845,69,254517
6433,0.002119,172.31.40.0-255,66,128911,69,254517
6434,0.002174,216.58.221.0-255,1484,130395,69,254517
6435,0.002183,216.58.221.0-255,2902,133297,69,254517
6436,0.002185,172.31.40.0-255,66,133363,69,254517
6437,0.002204,172.31.40.0-255,66,133429,69,254517
6438,0.002226,172.31.40.0-255,66,133495,69,254517
6439,0.002331,216.58.221.0-255,2902,136397,69,254517
6440,0.002332,172.31.40.0-255,66,136463,69,254517
6441,0.002354,216.58.221.0-255,4320,140783,69,254517
6442,0.002357,172.31.40.0-255,66,140849,69,254517
6443,0.002376,216.58.221.0-255,1484,142333,69,254517
6444,0.002391,216.58.221.0-255,2902,145235,69,254517
6445,0.002393,172.31.40.0-255,66,145301,69,254517
6446,0.002418,172.31.40.0-255,66,145367,69,254517
6447,0.002444,216.58.221.0-255,4320,149687,69,254517
6448,0.002446,172.31.40.0-255,66,149753,69,254517
6449,0.002506,216.58.221.0-255,1484,151237,69,254517
6450,0.002524,216.58.221.0-255,6438,157675,69,254517
6451,0.002526,172.31.40.0-255,66,157741,69,254517
6452,0.002586,216.58.221.0-255,5738,163479,69,254517
6453,0.002589,172.31.40.0-255,66,163545,69,254517
6454,0.002625,172.31.40.0-255,66,163611,69,254517
6455,0.002672,216.58.221.0-255,1484,165095,69,254517
6456,0.002703,172.31.40.0-255,66,165161,69,254517
6457,0.002781,216.58.221.0-255,2902,168063,69,254517
6458,0.002785,172.31.40.0-255,66,168129,69,254517
6459,0.00281,216.58.221.0-255,1484,169613,69,254517
6460,0.002813,216.58.221.0-255,766,170379,69,254517
6461,0.002815,172.31.40.0-255,66,170445,69,254517
6462,0.002822,216.58.221.0-255,7156,177601,69,254517
6463,0.002824,172.31.40.0-255,66,177667,69,254517
6464,0.002866,172.31.40.0-255,66,177733,69,254517
6465,0.002891,216.58.221.0-255,1484,179217,69,254517
6466,0.002973,216.58.221.0-255,1484,180701,69,254517
6467,0.002976,172.31.40.0-255,66,180767,69,254517
6468,0.002998,172.31.40.0-255,66,180833,69,254517
6469,0.003037,216.58.221.0-255,766,181599,69,254517
6470,0.003063,216.58.221.0-255,4320,185919,69,254517
6471,0.003065,172.31.40.0-255,66,185985,69,254517
6472,0.003099,172.31.40.0-255,66,186051,69,254517
6473,0.003148,216.58.221.0-255,2902,188953,69,254517
6474,0.003151,172.31.40.0-255,66,189019,69,254517
6475,0.003186,172.31.40.0-255,66,189085,69,254517
6476,0.003262,216.58.221.0-255,2902,191987,69,254517
6477,0.003265,172.31.40.0-255,66,192053,69,254517
6478,0.003295,216.58.221.0-255,5020,197073,69,254517
6479,0.003298,172.31.40.0-255,66,197139,69,254517
6480,0.003339,216.58.221.0-255,4320,201459,69,254517
6481,0.003343,172.31.40.0-255,66,201525,69,254517
6482,0.003388,172.31.40.0-255,66,201591,69,254517
6483,0.003512,216.58.221.0-255,2902,204493,69,254517
6484,0.003516,172.31.40.0-255,66,204559,69,254517
6485,0.003539,216.58.221.0-255,2184,206743,69,254517
6486,0.003542,172.31.40.0-255,66,206809,69,254517
6487,0.003571,216.58.221.0-255,5738,212547,69,254517
6488,0.003574,172.31.40.0-255,66,212613,69,254517
6489,0.003608,172.31.40.0-255,66,212679,69,254517
6490,0.003632,216.58.221.0-255,4320,216999,69,254517
6491,0.003634,172.31.40.0-255,66,217065,69,254517
6492,0.003709,216.58.221.0-255,1484,218549,69,254517
6493,0.003723,216.58.221.0-255,4320,222869,69,254517
6494,0.003726,172.31.40.0-255,66,222935,69,254517
6495,0.003762,172.31.40.0-255,66,223001,69,254517
6496,0.003785,216.58.221.0-255,1484,224485,69,254517
6497,0.003811,216.58.221.0-255,1484,225969,69,254517
6498,0.003814,172.31.40.0-255,66,226035,69,254517
6499,0.003821,216.58.221.0-255,7156,233191,69,254517
6500,0.003823,172.31.40.0-255,66,233257,69,254517
6501,0.003843,216.58.221.0-255,5738,238995,69,254517
6502,0.003847,172.31.40.0-255,66,239061,69,254517
6503,0.003904,216.58.221.0-255,1484,240545,69,254517
6504,0.00393,172.31.40.0-255,66,240611,69,254517
6505,0.003982,216.58.221.0-255,1484,242095,69,254517
6506,0.003998,216.58.221.0-255,2902,244997,69,254517
6507,0.004001,172.31.40.0-255,66,245063,69,254517
6508,0.004037,172.31.40.0-255,66,245129,69,254517
6509,0.004116,216.58.221.0-255,105,245234,69,254517
6510,0.004991,172.31.40.0-255,66,245300,69,254517
6511,0.005014,172.31.40.0-255,105,245405,69,254517
6512,0.007056,216.58.221.0-255,66,245471,69,254517
6513,0.033072,172.31.40.0-255,176,245647,69,254517
6514,0.033102,172.31.40.0-255,1114,246761,69,254517
6515,0.033146,172.31.40.0-255,1514,248275,69,254517
6516,0.033148,172.31.40.0-255,1514,249789,69,254517
6517,0.033153,172.31.40.0-255,1514,251303,69,254517
6518,0.033154,172.31.40.0-255,1514,252817,69,254517
6519,0.033171,172.31.40.0-255,1502,254319,69,254517
6520,0.034746,104.244.42.0-255,66,254385,69,254517
6521,0.034781,104.244.42.0-255,66,254451,69,254517
6522,0.034866,104.244.42.0-255,66,254517,69,254517
6523,0.0,172.217.194.0-255,153,153,69,328955
6524,2.1e-05,172.31.40.0-255,66,219,69,328955
6525,2.8e-05,172.217.194.0-255,1484,1703,69,328955
6526,3.2e-05,172.31.40.0-255,66,1769,69,328955
6527,3.9e-05,172.217.194.0-255,2902,4671,69,328955
6528,4.2e-05,172.31.40.0-255,66,4737,69,328955
6529,5.8e-05,172.217.194.0-255,7156,11893,69,328955
6530,6.1e-05,172.31.40.0-255,66,11959,69,328955
6531,6.5e-05,172.217.194.0-255,2095,14054,69,328955
6532,6.8e-05,172.31.40.0-255,66,14120,69,328955
6533,0.000111,172.31.40.0-255,66,14186,69,328955
6534,0.000117,172.217.194.0-255,5379,19565,69,328955
6535,0.000119,172.31.40.0-255,66,19631,69,328955
6536,0.00027,172.217.194.0-255,1484,21115,69,328955
6537,0.000274,172.31.40.0-255,66,21181,69,328955
6538,0.00028,172.217.194.0-255,2902,24083,69,328955
6539,0.000282,172.31.40.0-255,66,24149,69,328955
6540,0.000314,172.217.194.0-255,5738,29887,69,328955
6541,0.000317,172.31.40.0-255,66,29953,69,328955
6542,0.000325,172.217.194.0-255,6797,36750,69,328955
6543,0.000327,172.31.40.0-255,66,36816,69,328955
6544,0.000394,172.31.40.0-255,66,36882,69,328955
6545,0.000422,172.217.194.0-255,2902,39784,69,328955
6546,0.000424,172.31.40.0-255,66,39850,69,328955
6547,0.000428,172.217.194.0-255,2844,42694,69,328955
6548,0.00043,172.31.40.0-255,66,42760,69,328955
6549,0.000867,172.217.194.0-255,384,43144,69,328955
6550,0.000872,172.31.40.0-255,66,43210,69,328955
6551,0.001189,172.217.194.0-255,1484,44694,69,328955
6552,0.001195,172.31.40.0-255,66,44760,69,328955
6553,0.001203,172.217.194.0-255,2902,47662,69,328955
6554,0.001205,172.31.40.0-255,66,47728,69,328955
6555,0.001212,172.217.194.0-255,5738,53466,69,328955
6556,0.001219,172.31.40.0-255,66,53532,69,328955
6557,0.001226,172.217.194.0-255,7156,60688,69,328955
6558,0.001229,172.31.40.0-255,66,60754,69,328955
6559,0.001276,172.31.40.0-255,66,60820,69,328955
6560,0.00128,172.217.194.0-255,2184,63004,69,328955
6561,0.001282,172.31.40.0-255,66,63070,69,328955
6562,0.001735,172.217.194.0-255,1484,64554,69,328955
6563,0.001744,172.217.194.0-255,2902,67456,69,328955
6564,0.001748,172.31.40.0-255,66,67522,69,328955
6565,0.001756,172.217.194.0-255,5738,73260,69,328955
6566,0.001758,172.31.40.0-255,66,73326,69,328955
6567,0.001779,172.31.40.0-255,66,73392,69,328955
6568,0.001831,172.31.40.0-255,66,73458,69,328955
6569,0.002288,172.217.194.0-255,1484,74942,69,328955
6570,0.002297,172.217.194.0-255,2902,77844,69,328955
6571,0.002302,172.31.40.0-255,66,77910,69,328955
6572,0.002308,172.217.194.0-255,4320,82230,69,328955
6573,0.002311,172.31.40.0-255,66,82296,69,328955
6574,0.002337,172.217.194.0-255,1484,83780,69,328955
6575,0.002351,172.31.40.0-255,66,83846,69,328955
6576,0.002359,172.217.194.0-255,7156,91002,69,328955
6577,0.002361,172.31.40.0-255,66,91068,69,328955
6578,0.002387,172.217.194.0-255,2902,93970,69,328955
6579,0.002389,172.31.40.0-255,66,94036,69,328955
6580,0.002392,172.217.194.0-255,766,94802,69,328955
6581,0.00243,172.217.194.0-255,1484,96286,69,328955
6582,0.002433,172.31.40.0-255,66,96352,69,328955
6583,0.002436,172.217.194.0-255,1484,97836,69,328955
6584,0.002456,172.217.194.0-255,1484,99320,69,328955
6585,0.002459,172.31.40.0-255,66,99386,69,328955
6586,0.002465,172.217.194.0-255,5738,105124,69,328955
6587,0.002468,172.31.40.0-255,66,105190,69,328955
6588,0.002478,172.217.194.0-255,4320,109510,69,328955
6589,0.002481,172.31.40.0-255,66,109576,69,328955
6590,0.00251,172.31.40.0-255,66,109642,69,328955
6591,0.002515,172.217.194.0-255,4320,113962,69,328955
6592,0.002521,172.31.40.0-255,66,114028,69,328955
6593,0.002555,172.217.194.0-255,6438,120466,69,328955
6594,0.002562,172.31.40.0-255,66,120532,69,328955
6595,0.00502,172.217.194.0-255,4320,124852,69,328955
6596,0.005029,172.31.40.0-255,66,124918,69,328955
6597,0.005047,172.217.194.0-255,1484,126402,69,328955
6598,0.007494,172.217.194.0-255,4320,130722,69,328955
6599,0.007499,172.31.40.0-255,66,130788,69,328955
6600,0.009984,172.217.194.0-255,1484,132272,69,328955
6601,0.01001,172.217.194.0-255,4320,136592,69,328955
6602,0.010014,172.31.40.0-255,66,136658,69,328955
6603,0.012485,172.217.194.0-255,5738,142396,69,328955
6604,0.012495,172.31.40.0-255,66,142462,69,328955
6605,0.015001,172.217.194.0-255,5738,148200,69,328955
6606,0.01501,172.31.40.0-255,66,148266,69,328955
6607,0.017498,172.217.194.0-255,4320,152586,69,328955
6608,0.017507,172.31.40.0-255,66,152652,69,328955
6609,0.017547,172.217.194.0-255,1484,154136,69,328955
6610,0.019967,172.217.194.0-255,4320,158456,69,328955
6611,0.019975,172.31.40.0-255,66,158522,69,328955
6612,0.022482,172.217.194.0-255,5738,164260,69,328955
6613,0.02249,172.31.40.0-255,66,164326,69,328955
6614,0.024953,172.217.194.0-255,5738,170064,69,328955
6615,0.024961,172.31.40.0-255,66,170130,69,328955
6616,0.027481,172.217.194.0-255,5738,175868,69,328955
6617,0.027489,172.31.40.0-255,66,175934,69,328955
6618,0.029965,172.217.194.0-255,5738,181672,69,328955
6619,0.029972,172.31.40.0-255,66,181738,69,328955
6620,0.032463,172.217.194.0-255,5738,187476,69,328955
6621,0.032471,172.31.40.0-255,66,187542,69,328955
6622,0.03423,172.31.40.0-255,172,187714,69,328955
6623,0.034263,172.31.40.0-255,1112,188826,69,328955
6624,0.034329,172.31.40.0-255,1514,190340,69,328955
6625,0.03433,172.31.40.0-255,1514,191854,69,328955
6626,0.034332,172.31.40.0-255,1514,193368,69,328955
6627,0.034332,172.31.40.0-255,1514,194882,69,328955
6628,0.034363,172.31.40.0-255,1503,196385,69,328955
6629,0.03495,172.217.194.0-255,5738,202123,69,328955
6630,0.034957,172.31.40.0-255,66,202189,69,328955
6631,0.035857,104.244.42.0-255,66,202255,69,328955
6632,0.035955,104.244.42.0-255,66,202321,69,328955
6633,0.036021,104.244.42.0-255,66,202387,69,328955
6634,0.036059,104.244.42.0-255,66,202453,69,328955
6635,0.037417,172.217.194.0-255,5738,208191,69,328955
6636,0.037424,172.31.40.0-255,66,208257,69,328955
6637,0.039879,172.217.194.0-255,5738,213995,69,328955
6638,0.039885,172.31.40.0-255,66,214061,69,328955
6639,0.042345,172.217.194.0-255,4320,218381,69,328955
6640,0.042351,172.31.40.0-255,66,218447,69,328955
6641,0.042382,172.217.194.0-255,1484,219931,69,328955
6642,0.044807,172.217.194.0-255,4320,224251,69,328955
6643,0.044813,172.31.40.0-255,66,224317,69,328955
6644,0.047304,172.217.194.0-255,2902,227219,69,328955
6645,0.04731,172.31.40.0-255,66,227285,69,328955
6646,0.047338,172.217.194.0-255,2902,230187,69,328955
6647,0.047341,172.31.40.0-255,66,230253,69,328955
6648,0.04975,172.217.194.0-255,2902,233155,69,328955
6649,0.049756,172.31.40.0-255,66,233221,69,328955
6650,0.04979,172.217.194.0-255,2902,236123,69,328955
6651,0.049793,172.31.40.0-255,66,236189,69,328955
6652,0.052232,172.217.194.0-255,2902,239091,69,328955
6653,0.052241,172.31.40.0-255,66,239157,69,328955
6654,0.052273,172.217.194.0-255,2902,242059,69,328955
6655,0.052276,172.31.40.0-255,66,242125,69,328955
6656,0.054694,172.217.194.0-255,2902,245027,69,328955
6657,0.0547,172.31.40.0-255,66,245093,69,328955
6658,0.054729,172.217.194.0-255,2902,247995,69,328955
6659,0.054733,172.31.40.0-255,66,248061,69,328955
6660,0.057147,172.217.194.0-255,2902,250963,69,328955
6661,0.057154,172.31.40.0-255,66,251029,69,328955
6662,0.057211,172.217.194.0-255,1484,252513,69,328955
6663,0.057237,172.217.194.0-255,1484,253997,69,328955
6664,0.05724,172.31.40.0-255,66,254063,69,328955
6665,0.059636,172.217.194.0-255,2902,256965,69,328955
6666,0.059643,172.31.40.0-255,66,257031,69,328955
6667,0.059702,172.217.194.0-255,2902,259933,69,328955
6668,0.059706,172.31.40.0-255,66,259999,69,328955
6669,0.062091,172.217.194.0-255,2902,262901,69,328955
6670,0.062098,172.31.40.0-255,66,262967,69,328955
6671,0.062147,172.217.194.0-255,2902,265869,69,328955
6672,0.062152,172.31.40.0-255,66,265935,69,328955
6673,0.064535,172.217.194.0-255,2902,268837,69,328955
6674,0.064541,172.31.40.0-255,66,268903,69,328955
6675,0.064587,172.217.194.0-255,2902,271805,69,328955
6676,0.06459,172.31.40.0-255,66,271871,69,328955
6677,0.067024,172.217.194.0-255,2902,274773,69,328955
6678,0.06703,172.31.40.0-255,66,274839,69,328955
6679,0.067064,172.217.194.0-255,2902,277741,69,328955
6680,0.067067,172.31.40.0-255,66,277807,69,328955
6681,0.069476,172.217.194.0-255,2902,280709,69,328955
6682,0.069482,172.31.40.0-255,66,280775,69,328955
6683,0.069534,172.217.194.0-255,2902,283677,69,328955
6684,0.069537,172.31.40.0-255,66,283743,69,328955
6685,0.071958,172.217.194.0-255,2902,286645,69,328955
6686,0.071965,172.31.40.0-255,66,286711,69,328955
6687,0.071998,172.217.194.0-255,2902,289613,69,328955
6688,0.072,172.31.40.0-255,66,289679,69,328955
6689,0.074444,172.217.194.0-255,5738,295417,69,328955
6690,0.07445,172.31.40.0-255,66,295483,69,328955
6691,0.076948,172.217.194.0-255,4320,299803,69,328955
6692,0.076954,172.31.40.0-255,66,299869,69,328955
6693,0.076987,172.217.194.0-255,1484,301353,69,328955
6694,0.079446,172.217.194.0-255,4320,305673,69,328955
6695,0.079466,172.31.40.0-255,66,305739,69,328955
6696,0.08193,172.217.194.0-255,5738,311477,69,328955
6697,0.081936,172.31.40.0-255,66,311543,69,328955
6698,0.084414,172.217.194.0-255,5738,317281,69,328955
6699,0.084422,172.31.40.0-255,66,317347,69,328955
6700,0.086902,172.217.194.0-255,5738,323085,69,328955
6701,0.086909,172.31.40.0-255,66,323151,69,328955
6702,0.08938,172.217.194.0-255,5738,328889,69,328955
6703,0.089386,172.31.40.0-255,66,328955,69,328955
6704,0.0,172.217.194.0-255,143,143,69,219258
6705,2.2e-05,172.31.40.0-255,66,209,69,219258
6706,3e-05,172.217.194.0-255,1484,1693,69,219258
6707,3.5e-05,172.31.40.0-255,66,1759,69,219258
6708,4.1e-05,172.217.194.0-255,2902,4661,69,219258
6709,4.4e-05,172.31.40.0-255,66,4727,69,219258
6710,5e-05,172.217.194.0-255,4320,9047,69,219258
6711,5.3e-05,172.31.40.0-255,66,9113,69,219258
6712,5.9e-05,172.217.194.0-255,4320,13433,69,219258
6713,6.3e-05,172.31.40.0-255,66,13499,69,219258
6714,9.1e-05,172.217.194.0-255,4933,18432,69,219258
6715,9.3e-05,172.31.40.0-255,66,18498,69,219258
6716,0.000104,172.31.40.0-255,66,18564,69,219258
6717,0.000123,172.217.194.0-255,1484,20048,69,219258
6718,0.000126,172.31.40.0-255,66,20114,69,219258
6719,0.000143,172.217.194.0-255,2543,22657,69,219258
6720,0.000146,172.31.40.0-255,66,22723,69,219258
6721,0.000167,172.217.194.0-255,2902,25625,69,219258
6722,0.00017,172.31.40.0-255,66,25691,69,219258
6723,0.000178,172.217.194.0-255,7156,32847,69,219258
6724,0.00018,172.31.40.0-255,66,32913,69,219258
6725,0.000183,172.217.194.0-255,1484,34397,69,219258
6726,0.000185,172.31.40.0-255,66,34463,69,219258
6727,0.000215,172.217.194.0-255,5379,39842,69,219258
6728,0.000217,172.31.40.0-255,66,39908,69,219258
6729,0.000232,172.31.40.0-255,66,39974,69,219258
6730,0.000247,172.217.194.0-255,2902,42876,69,219258
6731,0.000249,172.31.40.0-255,66,42942,69,219258
6732,0.000252,172.217.194.0-255,1383,44325,69,219258
6733,0.000255,172.31.40.0-255,66,44391,69,219258
6734,0.000257,172.217.194.0-255,428,44819,69,219258
6735,0.000529,172.217.194.0-255,1484,46303,69,219258
6736,0.000533,172.31.40.0-255,66,46369,69,219258
6737,0.000538,172.217.194.0-255,2902,49271,69,219258
6738,0.00054,172.31.40.0-255,66,49337,69,219258
6739,0.000544,172.217.194.0-255,2902,52239,69,219258
6740,0.000546,172.31.40.0-255,66,52305,69,219258
6741,0.000571,172.217.194.0-255,2902,55207,69,219258
6742,0.000574,172.31.40.0-255,66,55273,69,219258
6743,0.00059,172.31.40.0-255,66,55339,69,219258
6744,0.000624,172.31.40.0-255,66,55405,69,219258
6745,0.00071,172.217.194.0-255,1484,56889,69,219258
6746,0.000715,172.217.194.0-255,2902,59791,69,219258
6747,0.000718,172.31.40.0-255,66,59857,69,219258
6748,0.000744,172.217.194.0-255,5738,65595,69,219258
6749,0.000746,172.31.40.0-255,66,65661,69,219258
6750,0.000751,172.217.194.0-255,2902,68563,69,219258
6751,0.000754,172.31.40.0-255,66,68629,69,219258
6752,0.000776,172.31.40.0-255,66,68695,69,219258
6753,0.000818,172.217.194.0-255,4320,73015,69,219258
6754,0.000821,172.31.40.0-255,66,73081,69,219258
6755,0.000846,172.217.194.0-255,6438,79519,69,219258
6756,0.000849,172.31.40.0-255,66,79585,69,219258
6757,0.000876,172.217.194.0-255,1484,81069,69,219258
6758,0.000891,172.217.194.0-255,2902,83971,69,219258
6759,0.000894,172.31.40.0-255,66,84037,69,219258
6760,0.0009,172.217.194.0-255,5738,89775,69,219258
6761,0.000903,172.31.40.0-255,66,89841,69,219258
6762,0.000906,172.217.194.0-255,1484,91325,69,219258
6763,0.000922,172.217.194.0-255,1484,92809,69,219258
6764,0.000924,172.31.40.0-255,66,92875,69,219258
6765,0.000936,172.31.40.0-255,66,92941,69,219258
6766,0.000954,172.217.194.0-255,1484,94425,69,219258
6767,0.00097,172.217.194.0-255,5738,100163,69,219258
6768,0.000972,172.31.40.0-255,66,100229,69,219258
6769,0.000992,172.217.194.0-255,5020,105249,69,219258
6770,0.000995,172.31.40.0-255,66,105315,69,219258
6771,0.001157,172.217.194.0-255,1484,106799,69,219258
6772,0.001164,172.217.194.0-255,2902,109701,69,219258
6773,0.001167,172.31.40.0-255,66,109767,69,219258
6774,0.001173,172.217.194.0-255,2902,112669,69,219258
6775,0.001175,172.31.40.0-255,66,112735,69,219258
6776,0.00119,172.217.194.0-255,2902,115637,69,219258
6777,0.001192,172.31.40.0-255,66,115703,69,219258
6778,0.001197,172.217.194.0-255,2902,118605,69,219258
6779,0.001199,172.31.40.0-255,66,118671,69,219258
6780,0.001234,172.31.40.0-255,66,118737,69,219258
6781,0.001252,172.217.194.0-255,4320,123057,69,219258
6782,0.001254,172.31.40.0-255,66,123123,69,219258
6783,0.00127,172.217.194.0-255,6438,129561,69,219258
6784,0.001272,172.31.40.0-255,66,129627,69,219258
6785,0.001332,172.31.40.0-255,66,129693,69,219258
6786,0.001346,172.31.40.0-255,66,129759,69,219258
6787,0.001368,172.217.194.0-255,1484,131243,69,219258
6788,0.001375,172.217.194.0-255,5738,136981,69,219258
6789,0.001377,172.31.40.0-255,66,137047,69,219258
6790,0.001392,172.217.194.0-255,2184,139231,69,219258
6791,0.001395,172.31.40.0-255,66,139297,69,219258
6792,0.001559,172.217.194.0-255,1484,140781,69,219258
6793,0.001566,172.217.194.0-255,2902,143683,69,219258
6794,0.00157,172.31.40.0-255,66,143749,69,219258
6795,0.001573,172.217.194.0-255,1484,145233,69,219258
6796,0.00159,172.217.194.0-255,4320,149553,69,219258
6797,0.001593,172.31.40.0-255,66,149619,69,219258
6798,0.001604,172.217.194.0-255,5738,155357,69,219258
6799,0.001607,172.31.40.0-255,66,155423,69,219258
6800,0.001654,172.217.194.0-255,7156,162579,69,219258
6801,0.001658,172.31.40.0-255,66,162645,69,219258
6802,0.001671,172.31.40.0-255,66,162711,69,219258
6803,0.001798,172.217.194.0-255,1484,164195,69,219258
6804,0.001802,172.217.194.0-255,1484,165679,69,219258
6805,0.001805,172.31.40.0-255,66,165745,69,219258
6806,0.001821,172.217.194.0-255,1484,167229,69,219258
6807,0.001828,172.217.194.0-255,5738,172967,69,219258
6808,0.00183,172.31.40.0-255,66,173033,69,219258
6809,0.001876,172.31.40.0-255,66,173099,69,219258
6810,0.001902,172.217.194.0-255,1484,174583,69,219258
6811,0.001934,172.31.40.0-255,66,174649,69,219258
6812,0.001996,172.217.194.0-255,1484,176133,69,219258
6813,0.001999,172.217.194.0-255,1484,177617,69,219258
6814,0.002002,172.31.40.0-255,66,177683,69,219258
6815,0.002008,172.31.40.0-255,66,177749,69,219258
6816,0.002022,172.217.194.0-255,1484,179233,69,219258
6817,0.002029,172.217.194.0-255,5738,184971,69,219258
6818,0.002034,172.217.194.0-255,4320,189291,69,219258
6819,0.002046,172.31.40.0-255,66,189357,69,219258
6820,0.002058,172.217.194.0-255,4320,193677,69,219258
6821,0.002063,172.31.40.0-255,66,193743,69,219258
6822,0.002089,172.217.194.0-255,2902,196645,69,219258
6823,0.002098,172.31.40.0-255,66,196711,69,219258
6824,0.002146,172.31.40.0-255,66,196777,69,219258
6825,0.002158,172.217.194.0-255,5738,202515,69,219258
6826,0.002175,172.31.40.0-255,66,202581,69,219258
6827,0.002199,172.217.194.0-255,7156,209737,69,219258
6828,0.002208,172.31.40.0-255,66,209803,69,219258
6829,0.002237,172.217.194.0-255,105,209908,69,219258
6830,0.002272,172.31.40.0-255,66,209974,69,219258
6831,0.004834,172.31.40.0-255,105,210079,69,219258
6832,0.007196,172.217.194.0-255,66,210145,69,219258
6833,0.043769,172.31.40.0-255,176,210321,69,219258
6834,0.043805,172.31.40.0-255,1114,211435,69,219258
6835,0.043892,172.31.40.0-255,1514,212949,69,219258
6836,0.043894,172.31.40.0-255,1514,214463,69,219258
6837,0.043896,172.31.40.0-255,1514,215977,69,219258
6838,0.0439,172.31.40.0-255,1514,217491,69,219258
6839,0.043902,172.31.40.0-255,1503,218994,69,219258
6840,0.045397,104.244.42.0-255,66,219060,69,219258
6841,0.045507,104.244.42.0-255,66,219126,69,219258
6842,0.045579,104.244.42.0-255,66,219192,69,219258
6843,0.045625,104.244.42.0-255,66,219258,69,219258
6844,0.0,74.125.200.0-255,152,152,69,374990
6845,1.6e-05,172.31.40.0-255,66,218,69,374990
6846,2.2e-05,74.125.200.0-255,1484,1702,69,374990
6847,2.5e-05,172.31.40.0-255,66,1768,69,374990
6848,3.1e-05,74.125.200.0-255,2902,4670,69,374990
6849,3.4e-05,172.31.40.0-255,66,4736,69,374990
6850,5.4e-05,74.125.200.0-255,4320,9056,69,374990
6851,5.6e-05,172.31.40.0-255,66,9122,69,374990
6852,8.8e-05,74.125.200.0-255,5738,14860,69,374990
6853,9e-05,172.31.40.0-255,66,14926,69,374990
6854,0.000103,74.125.200.0-255,3402,18328,69,374990
6855,0.000105,172.31.40.0-255,66,18394,69,374990
6856,0.00011,74.125.200.0-255,4320,22714,69,374990
6857,0.000112,172.31.40.0-255,66,22780,69,374990
6858,0.000138,74.125.200.0-255,5738,28518,69,374990
6859,0.00014,172.31.40.0-255,66,28584,69,374990
6860,0.000144,74.125.200.0-255,2543,31127,69,374990
6861,0.000145,172.31.40.0-255,66,31193,69,374990
6862,0.000183,74.125.200.0-255,1484,32677,69,374990
6863,0.000185,172.31.40.0-255,66,32743,69,374990
6864,0.000196,74.125.200.0-255,2902,35645,69,374990
6865,0.000198,172.31.40.0-255,66,35711,69,374990
6866,0.000227,74.125.200.0-255,5738,41449,69,374990
6867,0.00023,172.31.40.0-255,66,41515,69,374990
6868,0.000247,74.125.200.0-255,1484,42999,69,374990
6869,0.000249,172.31.40.0-255,66,43065,69,374990
6870,0.000268,74.125.200.0-255,5379,48444,69,374990
6871,0.00027,172.31.40.0-255,66,48510,69,374990
6872,0.000607,74.125.200.0-255,1484,49994,69,374990
6873,0.000612,172.31.40.0-255,66,50060,69,374990
6874,0.000618,74.125.200.0-255,2902,52962,69,374990
6875,0.00062,172.31.40.0-255,66,53028,69,374990
6876,0.000653,74.125.200.0-255,4320,57348,69,374990
6877,0.000656,74.125.200.0-255,1484,58832,69,374990
6878,0.00067,74.125.200.0-255,4320,63152,69,374990
6879,0.000673,172.31.40.0-255,66,63218,69,374990
6880,0.000697,74.125.200.0-255,2543,65761,69,374990
6881,0.000704,172.31.40.0-255,66,65827,69,374990
6882,0.000735,74.125.200.0-255,2902,68729,69,374990
6883,0.000752,172.31.40.0-255,66,68795,69,374990
6884,0.000771,74.125.200.0-255,4320,73115,69,374990
6885,0.000785,74.125.200.0-255,2902,76017,69,374990
6886,0.000789,172.31.40.0-255,66,76083,69,374990
6887,0.000802,74.125.200.0-255,4320,80403,69,374990
6888,0.000818,74.125.200.0-255,2543,82946,69,374990
6889,0.000825,172.31.40.0-255,66,83012,69,374990
6890,0.000855,74.125.200.0-255,645,83657,69,374990
6891,0.000982,74.125.200.0-255,1484,85141,69,374990
6892,0.000986,172.31.40.0-255,66,85207,69,374990
6893,0.000991,74.125.200.0-255,2902,88109,69,374990
6894,0.000998,74.125.200.0-255,5738,93847,69,374990
6895,0.001,74.125.200.0-255,1484,95331,69,374990
6896,0.001015,172.31.40.0-255,66,95397,69,374990
6897,0.001026,74.125.200.0-255,4320,99717,69,374990
6898,0.001028,74.125.200.0-255,1484,101201,69,374990
6899,0.001033,172.31.40.0-255,66,101267,69,374990
6900,0.001059,74.125.200.0-255,5738,107005,69,374990
6901,0.001064,74.125.200.0-255,4320,111325,69,374990
6902,0.001078,74.125.200.0-255,1484,112809,69,374990
6903,0.001081,172.31.40.0-255,66,112875,69,374990
6904,0.001092,74.125.200.0-255,4320,117195,69,374990
6905,0.001094,74.125.200.0-255,103,117298,69,374990
6906,0.001105,74.125.200.0-255,198,117496,69,374990
6907,0.001149,172.31.40.0-255,66,117562,69,374990
6908,0.001475,74.125.200.0-255,1484,119046,69,374990
6909,0.001481,74.125.200.0-255,1484,120530,69,374990
6910,0.001484,172.31.40.0-255,66,120596,69,374990
6911,0.001506,74.125.200.0-255,1484,122080,69,374990
6912,0.001513,74.125.200.0-255,5738,127818,69,374990
6913,0.001531,172.31.40.0-255,66,127884,69,374990
6914,0.001564,172.31.40.0-255,66,127950,69,374990
6915,0.001569,74.125.200.0-255,2902,130852,69,374990
6916,0.001588,74.125.200.0-255,2184,133036,69,374990
6917,0.001591,172.31.40.0-255,66,133102,69,374990
6918,0.001604,172.31.40.0-255,66,133168,69,374990
6919,0.001878,74.125.200.0-255,1484,134652,69,374990
6920,0.001885,74.125.200.0-255,2902,137554,69,374990
6921,0.001888,172.31.40.0-255,66,137620,69,374990
6922,0.001906,74.125.200.0-255,5738,143358,69,374990
6923,0.001917,172.31.40.0-255,66,143424,69,374990
6924,0.00194,74.125.200.0-255,7156,150580,69,374990
6925,0.001958,74.125.200.0-255,4320,154900,69,374990
6926,0.001962,74.125.200.0-255,2902,157802,69,374990
6927,0.001969,172.31.40.0-255,66,157868,69,374990
6928,0.002025,172.31.40.0-255,66,157934,69,374990
6929,0.002222,172.31.40.0-255,101,158035,69,374990
6930,0.004298,74.125.200.0-255,5738,163773,69,374990
6931,0.004305,172.31.40.0-255,66,163839,69,374990
6932,0.004457,74.125.200.0-255,66,163905,69,374990
6933,0.00657,74.125.200.0-255,5738,169643,69,374990
6934,0.008192,172.31.40.0-255,66,169709,69,374990
6935,0.010476,74.125.200.0-255,5738,175447,69,374990
6936,0.010483,172.31.40.0-255,66,175513,69,374990
6937,0.012773,74.125.200.0-255,5738,181251,69,374990
6938,0.01278,172.31.40.0-255,66,181317,69,374990
6939,0.015056,74.125.200.0-255,5738,187055,69,374990
6940,0.015063,172.31.40.0-255,66,187121,69,374990
6941,0.017349,74.125.200.0-255,5738,192859,69,374990
6942,0.017357,172.31.40.0-255,66,192925,69,374990
6943,0.019643,74.125.200.0-255,5738,198663,69,374990
6944,0.01965,172.31.40.0-255,66,198729,69,374990
6945,0.021927,74.125.200.0-255,5738,204467,69,374990
6946,0.021934,172.31.40.0-255,66,204533,69,374990
6947,0.02422,74.125.200.0-255,5738,210271,69,374990
6948,0.024227,172.31.40.0-255,66,210337,69,374990
6949,0.025698,172.31.40.0-255,167,210504,69,374990
6950,0.025726,172.31.40.0-255,1116,211620,69,374990
6951,0.025782,172.31.40.0-255,1514,213134,69,374990
6952,0.025783,172.31.40.0-255,1514,214648,69,374990
6953,0.025784,172.31.40.0-255,1514,216162,69,374990
6954,0.025785,172.31.40.0-255,1514,217676,69,374990
6955,0.025786,172.31.40.0-255,540,218216,69,374990
6956,0.026511,74.125.200.0-255,5738,223954,69,374990
6957,0.026522,172.31.40.0-255,66,224020,69,374990
6958,0.028469,104.244.42.0-255,66,224086,69,374990
6959,0.028796,74.125.200.0-255,5738,229824,69,374990
6960,0.028801,172.31.40.0-255,66,229890,69,374990
6961,0.031092,74.125.200.0-255,5738,235628,69,374990
6962,0.031098,172.31.40.0-255,66,235694,69,374990
6963,0.033377,74.125.200.0-255,5738,241432,69,374990
6964,0.033383,172.31.40.0-255,66,241498,69,374990
6965,0.035667,74.125.200.0-255,5738,247236,69,374990
6966,0.035674,172.31.40.0-255,66,247302,69,374990
6967,0.03796,74.125.200.0-255,5738,253040,69,374990
6968,0.037967,172.31.40.0-255,66,253106,69,374990
6969,0.040247,74.125.200.0-255,5738,258844,69,374990
6970,0.04025,172.31.40.0-255,66,258910,69,374990
6971,0.042541,74.125.200.0-255,5738,264648,69,374990
6972,0.042548,172.31.40.0-255,66,264714,69,374990
6973,0.044841,74.125.200.0-255,5738,270452,69,374990
6974,0.044846,172.31.40.0-255,66,270518,69,374990
6975,0.047152,74.125.200.0-255,5738,276256,69,374990
6976,0.047161,172.31.40.0-255,66,276322,69,374990
6977,0.049463,74.125.200.0-255,5738,282060,69,374990
6978,0.049468,172.31.40.0-255,66,282126,69,374990
6979,0.051771,74.125.200.0-255,5738,287864,69,374990
6980,0.051777,172.31.40.0-255,66,287930,69,374990
6981,0.054067,74.125.200.0-255,5738,293668,69,374990
6982,0.054072,172.31.40.0-255,66,293734,69,374990
6983,0.05636,74.125.200.0-255,5738,299472,69,374990
6984,0.056367,172.31.40.0-255,66,299538,69,374990
6985,0.058649,74.125.200.0-255,5738,305276,69,374990
6986,0.058655,172.31.40.0-255,66,305342,69,374990
6987,0.06094,74.125.200.0-255,5738,311080,69,374990
6988,0.060947,172.31.40.0-255,66,311146,69,374990
6989,0.063225,74.125.200.0-255,5738,316884,69,374990
6990,0.063231,172.31.40.0-255,66,316950,69,374990
6991,0.065518,74.125.200.0-255,5738,322688,69,374990
6992,0.065525,172.31.40.0-255,66,322754,69,374990
6993,0.067803,74.125.200.0-255,5738,328492,69,374990
6994,0.06781,172.31.40.0-255,66,328558,69,374990
6995,0.07009,74.125.200.0-255,5738,334296,69,374990
6996,0.070096,172.31.40.0-255,66,334362,69,374990
6997,0.072377,74.125.200.0-255,5738,340100,69,374990
6998,0.074104,172.31.40.0-255,66,340166,69,374990
6999,0.076401,74.125.200.0-255,5738,345904,69,374990
7000,0.07641,172.31.40.0-255,66,345970,69,374990
7001,0.078693,74.125.200.0-255,5738,351708,69,374990
7002,0.0787,172.31.40.0-255,66,351774,69,374990
7003,0.080981,74.125.200.0-255,5738,357512,69,374990
7004,0.080987,172.31.40.0-255,66,357578,69,374990
7005,0.083266,74.125.200.0-255,5738,363316,69,374990
7006,0.083273,172.31.40.0-255,66,363382,69,374990
7007,0.08556,74.125.200.0-255,5738,369120,69,374990
7008,0.085566,172.31.40.0-255,66,369186,69,374990
7009,0.087853,74.125.200.0-255,5738,374924,69,374990
7010,0.087861,172.31.40.0-255,66,374990,69,374990
7011,0.0,172.217.194.0-255,146,146,69,277106
7012,1.6e-05,172.31.40.0-255,66,212,69,277106
7013,2.3e-05,172.217.194.0-255,1484,1696,69,277106
7014,2.8e-05,172.31.40.0-255,66,1762,69,277106
7015,3.5e-05,172.217.194.0-255,2902,4664,69,277106
7016,3.8e-05,172.31.40.0-255,66,4730,69,277106
7017,5.4e-05,172.217.194.0-255,7156,11886,69,277106
7018,5.7e-05,172.31.40.0-255,66,11952,69,277106
7019,6.1e-05,172.217.194.0-255,1484,13436,69,277106
7020,6.3e-05,172.31.40.0-255,66,13502,69,277106
7021,0.000105,172.217.194.0-255,4891,18393,69,277106
7022,0.000109,172.31.40.0-255,66,18459,69,277106
7023,0.000115,172.217.194.0-255,5738,24197,69,277106
7024,0.000118,172.31.40.0-255,66,24263,69,277106
7025,0.000148,172.217.194.0-255,6797,31060,69,277106
7026,0.000151,172.31.40.0-255,66,31126,69,277106
7027,0.0002,172.217.194.0-255,1484,32610,69,277106
7028,0.000203,172.31.40.0-255,66,32676,69,277106
7029,0.000208,172.217.194.0-255,2902,35578,69,277106
7030,0.00021,172.31.40.0-255,66,35644,69,277106
7031,0.000216,172.217.194.0-255,5738,41382,69,277106
7032,0.000219,172.31.40.0-255,66,41448,69,277106
7033,0.000262,172.31.40.0-255,66,41514,69,277106
7034,0.000291,172.217.194.0-255,3961,45475,69,277106
7035,0.000294,172.31.40.0-255,66,45541,69,277106
7036,0.000307,172.31.40.0-255,66,45607,69,277106
7037,0.000314,172.217.194.0-255,364,45971,69,277106
7038,0.000316,172.31.40.0-255,66,46037,69,277106
7039,0.000582,172.217.194.0-255,1484,47521,69,277106
7040,0.000588,172.31.40.0-255,66,47587,69,277106
7041,0.000594,172.217.194.0-255,2902,50489,69,277106
7042,0.000596,172.31.40.0-255,66,50555,69,277106
7043,0.000602,172.217.194.0-255,5738,56293,69,277106
7044,0.000605,172.31.40.0-255,66,56359,69,277106
7045,0.00068,172.31.40.0-255,66,56425,69,277106
7046,0.000692,172.31.40.0-255,66,56491,69,277106
7047,0.000884,172.217.194.0-255,1484,57975,69,277106
7048,0.000892,172.217.194.0-255,2902,60877,69,277106
7049,0.000895,172.31.40.0-255,66,60943,69,277106
7050,0.000929,172.217.194.0-255,5738,66681,69,277106
7051,0.000932,172.31.40.0-255,66,66747,69,277106
7052,0.000946,172.31.40.0-255,66,66813,69,277106
7053,0.000952,172.217.194.0-255,5738,72551,69,277106
7054,0.000955,172.31.40.0-255,66,72617,69,277106
7055,0.000981,172.217.194.0-255,5020,77637,69,277106
7056,0.000984,172.31.40.0-255,66,77703,69,277106
7057,0.001239,172.217.194.0-255,1484,79187,69,277106
7058,0.001246,172.217.194.0-255,2902,82089,69,277106
7059,0.001249,172.31.40.0-255,66,82155,69,277106
7060,0.001283,172.217.194.0-255,5738,87893,69,277106
7061,0.001286,172.31.40.0-255,66,87959,69,277106
7062,0.001299,172.31.40.0-255,66,88025,69,277106
7063,0.00131,172.217.194.0-255,1484,89509,69,277106
7064,0.001339,172.31.40.0-255,66,89575,69,277106
7065,0.001364,172.217.194.0-255,766,90341,69,277106
7066,0.001397,172.217.194.0-255,1484,91825,69,277106
7067,0.001401,172.31.40.0-255,66,91891,69,277106
7068,0.001405,172.217.194.0-255,2902,94793,69,277106
7069,0.001407,172.31.40.0-255,66,94859,69,277106
7070,0.001434,172.217.194.0-255,5738,100597,69,277106
7071,0.001441,172.31.40.0-255,66,100663,69,277106
7072,0.001453,172.31.40.0-255,66,100729,69,277106
7073,0.00149,172.217.194.0-255,4320,105049,69,277106
7074,0.001493,172.31.40.0-255,66,105115,69,277106
7075,0.001506,172.31.40.0-255,66,105181,69,277106
7076,0.001878,172.217.194.0-255,1484,106665,69,277106
7077,0.001884,172.217.194.0-255,2902,109567,69,277106
7078,0.001888,172.31.40.0-255,66,109633,69,277106
7079,0.001923,172.217.194.0-255,5738,115371,69,277106
7080,0.001926,172.31.40.0-255,66,115437,69,277106
7081,0.001937,172.31.40.0-255,66,115503,69,277106
7082,0.00197,172.217.194.0-255,2902,118405,69,277106
7083,0.001973,172.31.40.0-255,66,118471,69,277106
7084,0.001999,172.31.40.0-255,66,118537,69,277106
7085,0.002022,172.217.194.0-255,2184,120721,69,277106
7086,0.002024,172.31.40.0-255,66,120787,69,277106
7087,0.002036,172.217.194.0-255,1484,122271,69,277106
7088,0.002057,172.217.194.0-255,2902,125173,69,277106
7089,0.00206,172.31.40.0-255,66,125239,69,277106
7090,0.002067,172.217.194.0-255,5738,130977,69,277106
7091,0.002069,172.31.40.0-255,66,131043,69,277106
7092,0.002088,172.217.194.0-255,4320,135363,69,277106
7093,0.002096,172.31.40.0-255,66,135429,69,277106
7094,0.002137,172.31.40.0-255,66,135495,69,277106
7095,0.002171,172.217.194.0-255,1484,136979,69,277106
7096,0.002194,172.217.194.0-255,6438,143417,69,277106
7097,0.002196,172.31.40.0-255,66,143483,69,277106
7098,0.00229,172.217.194.0-255,1484,144967,69,277106
7099,0.002313,172.217.194.0-255,2902,147869,69,277106
7100,0.002317,172.31.40.0-255,66,147935,69,277106
7101,0.002323,172.217.194.0-255,4320,152255,69,277106
7102,0.002325,172.31.40.0-255,66,152321,69,277106
7103,0.002347,172.217.194.0-255,1484,153805,69,277106
7104,0.002357,172.217.194.0-255,4320,158125,69,277106
7105,0.00236,172.31.40.0-255,66,158191,69,277106
7106,0.002374,172.31.40.0-255,66,158257,69,277106
7107,0.002407,172.31.40.0-255,66,158323,69,277106
7108,0.002458,172.31.40.0-255,66,158389,69,277106
7109,0.002463,172.217.194.0-255,4320,162709,69,277106
7110,0.002465,172.31.40.0-255,66,162775,69,277106
7111,0.002489,172.217.194.0-255,4320,167095,69,277106
7112,0.002495,172.31.40.0-255,66,167161,69,277106
7113,0.004904,172.217.194.0-255,5738,172899,69,277106
7114,0.004913,172.31.40.0-255,66,172965,69,277106
7115,0.007353,172.217.194.0-255,2902,175867,69,277106
7116,0.007358,172.31.40.0-255,66,175933,69,277106
7117,0.007383,172.217.194.0-255,2902,178835,69,277106
7118,0.009488,172.31.40.0-255,66,178901,69,277106
7119,0.009792,172.217.194.0-255,2902,181803,69,277106
7120,0.009797,172.31.40.0-255,66,181869,69,277106
7121,0.011918,172.217.194.0-255,2902,184771,69,277106
7122,0.011923,172.31.40.0-255,66,184837,69,277106
7123,0.012238,172.217.194.0-255,2902,187739,69,277106
7124,0.012243,172.31.40.0-255,66,187805,69,277106
7125,0.014373,172.217.194.0-255,2902,190707,69,277106
7126,0.01438,172.31.40.0-255,66,190773,69,277106
7127,0.014671,172.217.194.0-255,2902,193675,69,277106
7128,0.014674,172.31.40.0-255,66,193741,69,277106
7129,0.016802,172.217.194.0-255,2902,196643,69,277106
7130,0.01681,172.31.40.0-255,66,196709,69,277106
7131,0.017101,172.217.194.0-255,2902,199611,69,277106
7132,0.017107,172.31.40.0-255,66,199677,69,277106
7133,0.019259,172.217.194.0-255,2902,202579,69,277106
7134,0.019268,172.31.40.0-255,66,202645,69,277106
7135,0.019555,172.217.194.0-255,2902,205547,69,277106
7136,0.01956,172.31.40.0-255,66,205613,69,277106
7137,0.021706,172.217.194.0-255,2902,208515,69,277106
7138,0.021712,172.31.40.0-255,66,208581,69,277106
7139,0.021996,172.217.194.0-255,2902,211483,69,277106
7140,0.022001,172.31.40.0-255,66,211549,69,277106
7141,0.024177,172.217.194.0-255,2902,214451,69,277106
7142,0.024184,172.31.40.0-255,66,214517,69,277106
7143,0.024421,172.217.194.0-255,2902,217419,69,277106
7144,0.024426,172.31.40.0-255,66,217485,69,277106
7145,0.026618,172.217.194.0-255,2902,220387,69,277106
7146,0.026627,172.31.40.0-255,66,220453,69,277106
7147,0.026857,172.217.194.0-255,2902,223355,69,277106
7148,0.026862,172.31.40.0-255,66,223421,69,277106
7149,0.029066,172.217.194.0-255,2902,226323,69,277106
7150,0.029073,172.31.40.0-255,66,226389,69,277106
7151,0.029299,172.217.194.0-255,2902,229291,69,277106
7152,0.029306,172.31.40.0-255,66,229357,69,277106
7153,0.031516,172.217.194.0-255,2902,232259,69,277106
7154,0.031523,172.31.40.0-255,66,232325,69,277106
7155,0.031774,172.217.194.0-255,2902,235227,69,277106
7156,0.03178,172.31.40.0-255,66,235293,69,277106
7157,0.03397,172.217.194.0-255,2902,238195,69,277106
7158,0.033978,172.31.40.0-255,66,238261,69,277106
7159,0.034209,172.217.194.0-255,2902,241163,69,277106
7160,0.034214,172.31.40.0-255,66,241229,69,277106
7161,0.036405,172.217.194.0-255,2902,244131,69,277106
7162,0.036412,172.31.40.0-255,66,244197,69,277106
7163,0.036632,172.217.194.0-255,2902,247099,69,277106
7164,0.036638,172.31.40.0-255,66,247165,69,277106
7165,0.037612,172.31.40.0-255,172,247337,69,277106
7166,0.037645,172.31.40.0-255,1116,248453,69,277106
7167,0.037712,172.31.40.0-255,1514,249967,69,277106
7168,0.037713,172.31.40.0-255,1514,251481,69,277106
7169,0.037715,172.31.40.0-255,1514,252995,69,277106
7170,0.037719,172.31.40.0-255,1514,254509,69,277106
7171,0.037721,172.31.40.0-255,1499,256008,69,277106
7172,0.038846,172.217.194.0-255,2902,258910,69,277106
7173,0.038853,172.31.40.0-255,66,258976,69,277106
7174,0.039067,172.217.194.0-255,2902,261878,69,277106
7175,0.039073,172.31.40.0-255,66,261944,69,277106
7176,0.039296,104.244.42.0-255,66,262010,69,277106
7177,0.039377,104.244.42.0-255,66,262076,69,277106
7178,0.039422,104.244.42.0-255,66,262142,69,277106
7179,0.041266,172.217.194.0-255,2902,265044,69,277106
7180,0.041273,172.31.40.0-255,66,265110,69,277106
7181,0.041488,172.217.194.0-255,2902,268012,69,277106
7182,0.041494,172.31.40.0-255,66,268078,69,277106
7183,0.043699,172.217.194.0-255,2902,270980,69,277106
7184,0.043704,172.31.40.0-255,66,271046,69,277106
7185,0.043907,172.217.194.0-255,2902,273948,69,277106
7186,0.043912,172.31.40.0-255,66,274014,69,277106
7187,0.046143,172.217.194.0-255,2855,276869,69,277106
7188,0.04615,172.31.40.0-255,66,276935,69,277106
7189,0.046318,172.31.40.0-255,105,277040,69,277106
7190,0.048708,172.217.194.0-255,66,277106,69,277106
7191,0.0,74.125.24.0-255,146,146,69,288218
7192,3.3e-05,172.31.40.0-255,66,212,69,288218
7193,4e-05,74.125.24.0-255,1484,1696,69,288218
7194,4.5e-05,172.31.40.0-255,66,1762,69,288218
7195,5.8e-05,74.125.24.0-255,2902,4664,69,288218
7196,6.3e-05,172.31.40.0-255,66,4730,69,288218
7197,7e-05,74.125.24.0-255,5738,10468,69,288218
7198,7.4e-05,172.31.40.0-255,66,10534,69,288218
7199,7.9e-05,74.125.24.0-255,3474,14008,69,288218
7200,8.1e-05,172.31.40.0-255,66,14074,69,288218
7201,0.000419,74.125.24.0-255,1484,15558,69,288218
7202,0.000426,172.31.40.0-255,66,15624,69,288218
7203,0.000432,74.125.24.0-255,2902,18526,69,288218
7204,0.000435,172.31.40.0-255,66,18592,69,288218
7205,0.000467,74.125.24.0-255,2902,21494,69,288218
7206,0.00047,172.31.40.0-255,66,21560,69,288218
7207,0.000479,74.125.24.0-255,7156,28716,69,288218
7208,0.000481,172.31.40.0-255,66,28782,69,288218
7209,0.000492,74.125.24.0-255,2543,31325,69,288218
7210,0.000495,172.31.40.0-255,66,31391,69,288218
7211,0.000529,74.125.24.0-255,2902,34293,69,288218
7212,0.000531,172.31.40.0-255,66,34359,69,288218
7213,0.00054,74.125.24.0-255,7156,41515,69,288218
7214,0.000542,172.31.40.0-255,66,41581,69,288218
7215,0.000575,74.125.24.0-255,4320,45901,69,288218
7216,0.000577,172.31.40.0-255,66,45967,69,288218
7217,0.000604,74.125.24.0-255,2543,48510,69,288218
7218,0.00061,172.31.40.0-255,66,48576,69,288218
7219,0.001178,74.125.24.0-255,1484,50060,69,288218
7220,0.001184,172.31.40.0-255,66,50126,69,288218
7221,0.001193,74.125.24.0-255,2902,53028,69,288218
7222,0.001195,172.31.40.0-255,66,53094,69,288218
7223,0.001207,74.125.24.0-255,4320,57414,69,288218
7224,0.001209,172.31.40.0-255,66,57480,69,288218
7225,0.001236,74.125.24.0-255,1484,58964,69,288218
7226,0.001249,74.125.24.0-255,6797,65761,69,288218
7227,0.001252,172.31.40.0-255,66,65827,69,288218
7228,0.001307,74.125.24.0-255,1484,67311,69,288218
7229,0.001313,74.125.24.0-255,2902,70213,69,288218
7230,0.001315,172.31.40.0-255,66,70279,69,288218
7231,0.001346,74.125.24.0-255,5738,76017,69,288218
7232,0.001349,172.31.40.0-255,66,76083,69,288218
7233,0.001353,74.125.24.0-255,1484,77567,69,288218
7234,0.001377,74.125.24.0-255,4320,81887,69,288218
7235,0.001379,172.31.40.0-255,66,81953,69,288218
7236,0.001419,172.31.40.0-255,66,82019,69,288218
7237,0.001438,172.31.40.0-255,66,82085,69,288218
7238,0.001577,74.125.24.0-255,646,82731,69,288218
7239,0.002633,74.125.24.0-255,1484,84215,69,288218
7240,0.00264,172.31.40.0-255,66,84281,69,288218
7241,0.002648,74.125.24.0-255,2902,87183,69,288218
7242,0.00265,172.31.40.0-255,66,87249,69,288218
7243,0.002653,74.125.24.0-255,1484,88733,69,288218
7244,0.002691,74.125.24.0-255,4320,93053,69,288218
7245,0.002695,172.31.40.0-255,66,93119,69,288218
7246,0.002715,172.31.40.0-255,66,93185,69,288218
7247,0.002728,172.31.40.0-255,66,93251,69,288218
7248,0.005381,74.125.24.0-255,1484,94735,69,288218
7249,0.005402,74.125.24.0-255,4320,99055,69,288218
7250,0.005406,172.31.40.0-255,66,99121,69,288218
7251,0.008064,74.125.24.0-255,2902,102023,69,288218
7252,0.008077,172.31.40.0-255,66,102089,69,288218
7253,0.008083,74.125.24.0-255,2902,104991,69,288218
7254,0.008086,172.31.40.0-255,66,105057,69,288218
7255,0.01077,74.125.24.0-255,5738,110795,69,288218
7256,0.010776,172.31.40.0-255,66,110861,69,288218
7257,0.013439,74.125.24.0-255,5738,116599,69,288218
7258,0.013448,172.31.40.0-255,66,116665,69,288218
7259,0.016132,74.125.24.0-255,5738,122403,69,288218
7260,0.016146,172.31.40.0-255,66,122469,69,288218
7261,0.018856,74.125.24.0-255,5738,128207,69,288218
7262,0.018868,172.31.40.0-255,66,128273,69,288218
7263,0.02156,74.125.24.0-255,5738,134011,69,288218
7264,0.021572,172.31.40.0-255,66,134077,69,288218
7265,0.024261,74.125.24.0-255,5738,139815,69,288218
7266,0.024269,172.31.40.0-255,66,139881,69,288218
7267,0.026971,74.125.24.0-255,5738,145619,69,288218
7268,0.026978,172.31.40.0-255,66,145685,69,288218
7269,0.029661,74.125.24.0-255,5738,151423,69,288218
7270,0.029669,172.31.40.0-255,66,151489,69,288218
7271,0.032347,74.125.24.0-255,5738,157227,69,288218
7272,0.032357,172.31.40.0-255,66,157293,69,288218
7273,0.035037,74.125.24.0-255,5738,163031,69,288218
7274,0.035043,172.31.40.0-255,66,163097,69,288218
7275,0.035074,172.31.40.0-255,172,163269,69,288218
7276,0.035097,172.31.40.0-255,1116,164385,69,288218
7277,0.03521,172.31.40.0-255,1514,165899,69,288218
7278,0.035212,172.31.40.0-255,1514,167413,69,288218
7279,0.035217,172.31.40.0-255,1514,168927,69,288218
7280,0.035219,172.31.40.0-255,1514,170441,69,288218
7281,0.035237,172.31.40.0-255,1499,171940,69,288218
7282,0.036741,104.244.42.0-255,66,172006,69,288218
7283,0.03679,104.244.42.0-255,66,172072,69,288218
7284,0.036917,104.244.42.0-255,66,172138,69,288218
7285,0.037705,74.125.24.0-255,5738,177876,69,288218
7286,0.037711,172.31.40.0-255,66,177942,69,288218
7287,0.040364,74.125.24.0-255,5738,183680,69,288218
7288,0.04037,172.31.40.0-255,66,183746,69,288218
7289,0.043037,74.125.24.0-255,5738,189484,69,288218
7290,0.043043,172.31.40.0-255,66,189550,69,288218
7291,0.045774,74.125.24.0-255,5738,195288,69,288218
7292,0.045783,172.31.40.0-255,66,195354,69,288218
7293,0.048485,74.125.24.0-255,5738,201092,69,288218
7294,0.04849,172.31.40.0-255,66,201158,69,288218
7295,0.051155,74.125.24.0-255,5738,206896,69,288218
7296,0.051162,172.31.40.0-255,66,206962,69,288218
7297,0.053849,74.125.24.0-255,5738,212700,69,288218
7298,0.053856,172.31.40.0-255,66,212766,69,288218
7299,0.056586,74.125.24.0-255,5738,218504,69,288218
7300,0.056592,172.31.40.0-255,66,218570,69,288218
7301,0.059276,74.125.24.0-255,5738,224308,69,288218
7302,0.059283,172.31.40.0-255,66,224374,69,288218
7303,0.062064,74.125.24.0-255,5738,230112,69,288218
7304,0.06207,172.31.40.0-255,66,230178,69,288218
7305,0.064737,74.125.24.0-255,5738,235916,69,288218
7306,0.064742,172.31.40.0-255,66,235982,69,288218
7307,0.067421,74.125.24.0-255,5738,241720,69,288218
7308,0.067426,172.31.40.0-255,66,241786,69,288218
7309,0.070138,74.125.24.0-255,5738,247524,69,288218
7310,0.070145,172.31.40.0-255,66,247590,69,288218
7311,0.072831,74.125.24.0-255,5738,253328,69,288218
7312,0.072836,172.31.40.0-255,66,253394,69,288218
7313,0.07551,74.125.24.0-255,5738,259132,69,288218
7314,0.075515,172.31.40.0-255,66,259198,69,288218
7315,0.078262,74.125.24.0-255,5738,264936,69,288218
7316,0.078268,172.31.40.0-255,66,265002,69,288218
7317,0.080972,74.125.24.0-255,5738,270740,69,288218
7318,0.080978,172.31.40.0-255,66,270806,69,288218
7319,0.083638,74.125.24.0-255,5738,276544,69,288218
7320,0.083643,172.31.40.0-255,66,276610,69,288218
7321,0.086296,74.125.24.0-255,5738,282348,69,288218
7322,0.086301,172.31.40.0-255,66,282414,69,288218
7323,0.088981,74.125.24.0-255,5738,288152,69,288218
7324,0.088987,172.31.40.0-255,66,288218,69,288218
7325,0.0,74.125.68.0-255,149,149,69,379596
7326,3e-05,172.31.40.0-255,66,215,69,379596
7327,3.7e-05,74.125.68.0-255,1484,1699,69,379596
7328,4.1e-05,172.31.40.0-255,66,1765,69,379596
7329,4.7e-05,74.125.68.0-255,2902,4667,69,379596
7330,5.6e-05,172.31.40.0-255,66,4733,69,379596
7331,6.2e-05,74.125.68.0-255,4320,9053,69,379596
7332,6.5e-05,172.31.40.0-255,66,9119,69,379596
7333,9.4e-05,74.125.68.0-255,2902,12021,69,379596
7334,9.7e-05,172.31.40.0-255,66,12087,69,379596
7335,0.000102,74.125.68.0-255,2063,14150,69,379596
7336,0.000104,172.31.40.0-255,66,14216,69,379596
7337,0.000108,74.125.68.0-255,2902,17118,69,379596
7338,0.000111,172.31.40.0-255,66,17184,69,379596
7339,0.000118,74.125.68.0-255,7156,24340,69,379596
7340,0.000121,172.31.40.0-255,66,24406,69,379596
7341,0.000134,74.125.68.0-255,1484,25890,69,379596
7342,0.000136,172.31.40.0-255,66,25956,69,379596
7343,0.000169,74.125.68.0-255,5379,31335,69,379596
7344,0.000172,172.31.40.0-255,66,31401,69,379596
7345,0.000243,74.125.68.0-255,1484,32885,69,379596
7346,0.000248,172.31.40.0-255,66,32951,69,379596
7347,0.000252,74.125.68.0-255,2902,35853,69,379596
7348,0.000255,172.31.40.0-255,66,35919,69,379596
7349,0.000301,74.125.68.0-255,5738,41657,69,379596
7350,0.000305,172.31.40.0-255,66,41723,69,379596
7351,0.00031,74.125.68.0-255,2902,44625,69,379596
7352,0.000312,172.31.40.0-255,66,44691,69,379596
7353,0.000317,74.125.68.0-255,3961,48652,69,379596
7354,0.00032,172.31.40.0-255,66,48718,69,379596
7355,0.000358,74.125.68.0-255,2902,51620,69,379596
7356,0.00036,172.31.40.0-255,66,51686,69,379596
7357,0.000364,172.31.40.0-255,66,51752,69,379596
7358,0.000394,74.125.68.0-255,4320,56072,69,379596
7359,0.000398,172.31.40.0-255,66,56138,69,379596
7360,0.000419,74.125.68.0-255,1439,57577,69,379596
7361,0.000422,74.125.68.0-255,108,57685,69,379596
7362,0.0005,74.125.68.0-255,1484,59169,69,379596
7363,0.000503,172.31.40.0-255,66,59235,69,379596
7364,0.000509,74.125.68.0-255,2902,62137,69,379596
7365,0.000511,172.31.40.0-255,66,62203,69,379596
7366,0.000545,74.125.68.0-255,5738,67941,69,379596
7367,0.000548,172.31.40.0-255,66,68007,69,379596
7368,0.000551,74.125.68.0-255,1484,69491,69,379596
7369,0.000557,74.125.68.0-255,2902,72393,69,379596
7370,0.000559,172.31.40.0-255,66,72459,69,379596
7371,0.000595,74.125.68.0-255,2806,75265,69,379596
7372,0.000598,172.31.40.0-255,66,75331,69,379596
7373,0.000625,74.125.68.0-255,1484,76815,69,379596
7374,0.000635,74.125.68.0-255,1484,78299,69,379596
7375,0.000638,172.31.40.0-255,66,78365,69,379596
7376,0.000641,74.125.68.0-255,1484,79849,69,379596
7377,0.000664,74.125.68.0-255,2902,82751,69,379596
7378,0.000668,172.31.40.0-255,66,82817,69,379596
7379,0.000674,74.125.68.0-255,5738,88555,69,379596
7380,0.000676,172.31.40.0-255,66,88621,69,379596
7381,0.000707,74.125.68.0-255,3961,92582,69,379596
7382,0.00071,172.31.40.0-255,66,92648,69,379596
7383,0.000744,74.125.68.0-255,1484,94132,69,379596
7384,0.00077,74.125.68.0-255,2902,97034,69,379596
7385,0.000775,74.125.68.0-255,4320,101354,69,379596
7386,0.000775,172.31.40.0-255,66,101420,69,379596
7387,0.000778,172.31.40.0-255,66,101486,69,379596
7388,0.000808,74.125.68.0-255,1484,102970,69,379596
7389,0.000816,74.125.68.0-255,5738,108708,69,379596
7390,0.000819,172.31.40.0-255,66,108774,69,379596
7391,0.000826,74.125.68.0-255,7156,115930,69,379596
7392,0.000829,172.31.40.0-255,66,115996,69,379596
7393,0.000859,74.125.68.0-255,2902,118898,69,379596
7394,0.000862,172.31.40.0-255,66,118964,69,379596
7395,0.000898,172.31.40.0-255,66,119030,69,379596
7396,0.001179,74.125.68.0-255,1484,120514,69,379596
7397,0.001199,74.125.68.0-255,2902,123416,69,379596
7398,0.001202,172.31.40.0-255,66,123482,69,379596
7399,0.001207,74.125.68.0-255,2902,126384,69,379596
7400,0.001209,172.31.40.0-255,66,126450,69,379596
7401,0.001229,74.125.68.0-255,1484,127934,69,379596
7402,0.001235,74.125.68.0-255,4320,132254,69,379596
7403,0.001238,172.31.40.0-255,66,132320,69,379596
7404,0.00127,74.125.68.0-255,4320,136640,69,379596
7405,0.001274,172.31.40.0-255,66,136706,69,379596
7406,0.001279,74.125.68.0-255,4320,141026,69,379596
7407,0.001282,172.31.40.0-255,66,141092,69,379596
7408,0.001287,74.125.68.0-255,5738,146830,69,379596
7409,0.00129,172.31.40.0-255,66,146896,69,379596
7410,0.001329,74.125.68.0-255,6438,153334,69,379596
7411,0.001334,172.31.40.0-255,66,153400,69,379596
7412,0.001449,74.125.68.0-255,1484,154884,69,379596
7413,0.001453,74.125.68.0-255,1484,156368,69,379596
7414,0.001456,172.31.40.0-255,66,156434,69,379596
7415,0.001472,74.125.68.0-255,1484,157918,69,379596
7416,0.001483,74.125.68.0-255,5738,163656,69,379596
7417,0.001486,172.31.40.0-255,66,163722,69,379596
7418,0.001581,172.31.40.0-255,66,163788,69,379596
7419,0.001593,172.31.40.0-255,66,163854,69,379596
7420,0.001597,74.125.68.0-255,2184,166038,69,379596
7421,0.001599,172.31.40.0-255,66,166104,69,379596
7422,0.001603,74.125.68.0-255,2902,169006,69,379596
7423,0.001604,172.31.40.0-255,66,169072,69,379596
7424,0.001608,74.125.68.0-255,2902,171974,69,379596
7425,0.001612,172.31.40.0-255,66,172040,69,379596
7426,0.001647,74.125.68.0-255,1484,173524,69,379596
7427,0.001682,74.125.68.0-255,2902,176426,69,379596
7428,0.001686,172.31.40.0-255,66,176492,69,379596
7429,0.001698,172.31.40.0-255,66,176558,69,379596
7430,0.001703,74.125.68.0-255,5738,182296,69,379596
7431,0.001705,172.31.40.0-255,66,182362,69,379596
7432,0.001712,74.125.68.0-255,7156,189518,69,379596
7433,0.001716,74.125.68.0-255,2184,191702,69,379596
7434,0.001716,172.31.40.0-255,66,191768,69,379596
7435,0.001719,172.31.40.0-255,66,191834,69,379596
7436,0.001748,74.125.68.0-255,1484,193318,69,379596
7437,0.001777,74.125.68.0-255,2902,196220,69,379596
7438,0.001781,172.31.40.0-255,66,196286,69,379596
7439,0.001786,74.125.68.0-255,2902,199188,69,379596
7440,0.001788,172.31.40.0-255,66,199254,69,379596
7441,0.001806,74.125.68.0-255,2902,202156,69,379596
7442,0.001809,172.31.40.0-255,66,202222,69,379596
7443,0.001822,74.125.68.0-255,7156,209378,69,379596
7444,0.001825,172.31.40.0-255,66,209444,69,379596
7445,0.001871,74.125.68.0-255,4320,213764,69,379596
7446,0.001874,172.31.40.0-255,66,213830,69,379596
7447,0.001909,74.125.68.0-255,2902,216732,69,379596
7448,0.001912,172.31.40.0-255,66,216798,69,379596
7449,0.001923,172.31.40.0-255,66,216864,69,379596
7450,0.001926,74.125.68.0-255,766,217630,69,379596
7451,0.00206,74.125.68.0-255,1484,219114,69,379596
7452,0.002064,172.31.40.0-255,66,219180,69,379596
7453,0.002069,74.125.68.0-255,2902,222082,69,379596
7454,0.002071,172.31.40.0-255,66,222148,69,379596
7455,0.002097,74.125.68.0-255,5738,227886,69,379596
7456,0.0021,172.31.40.0-255,66,227952,69,379596
7457,0.002126,74.125.68.0-255,7156,235108,69,379596
7458,0.002129,172.31.40.0-255,66,235174,69,379596
7459,0.002133,74.125.68.0-255,2902,238076,69,379596
7460,0.002136,172.31.40.0-255,66,238142,69,379596
7461,0.002156,74.125.68.0-255,5738,243880,69,379596
7462,0.002159,172.31.40.0-255,66,243946,69,379596
7463,0.002164,74.125.68.0-255,4320,248266,69,379596
7464,0.002165,172.31.40.0-255,66,248332,69,379596
7465,0.002195,74.125.68.0-255,3602,251934,69,379596
7466,0.002198,172.31.40.0-255,66,252000,69,379596
7467,0.002274,74.125.68.0-255,1484,253484,69,379596
7468,0.002287,74.125.68.0-255,2902,256386,69,379596
7469,0.00229,172.31.40.0-255,66,256452,69,379596
7470,0.002319,74.125.68.0-255,5738,262190,69,379596
7471,0.002322,172.31.40.0-255,66,262256,69,379596
7472,0.004605,74.125.68.0-255,5738,267994,69,379596
7473,0.004612,172.31.40.0-255,66,268060,69,379596
7474,0.00691,74.125.68.0-255,5738,273798,69,379596
7475,0.006914,172.31.40.0-255,66,273864,69,379596
7476,0.009215,74.125.68.0-255,5738,279602,69,379596
7477,0.009222,172.31.40.0-255,66,279668,69,379596
7478,0.011514,74.125.68.0-255,5738,285406,69,379596
7479,0.01152,172.31.40.0-255,66,285472,69,379596
7480,0.013865,74.125.68.0-255,5738,291210,69,379596
7481,0.013873,172.31.40.0-255,66,291276,69,379596
7482,0.016182,74.125.68.0-255,4320,295596,69,379596
7483,0.016191,172.31.40.0-255,66,295662,69,379596
7484,0.016231,74.125.68.0-255,1484,297146,69,379596
7485,0.018491,74.125.68.0-255,4320,301466,69,379596
7486,0.018498,172.31.40.0-255,66,301532,69,379596
7487,0.020811,74.125.68.0-255,5738,307270,69,379596
7488,0.020817,172.31.40.0-255,66,307336,69,379596
7489,0.023114,74.125.68.0-255,5738,313074,69,379596
7490,0.023121,172.31.40.0-255,66,313140,69,379596
7491,0.025426,74.125.68.0-255,5738,318878,69,379596
7492,0.025433,172.31.40.0-255,66,318944,69,379596
7493,0.027735,74.125.68.0-255,5738,324682,69,379596
7494,0.027743,172.31.40.0-255,66,324748,69,379596
7495,0.030031,74.125.68.0-255,4320,329068,69,379596
7496,0.030038,172.31.40.0-255,66,329134,69,379596
7497,0.030078,74.125.68.0-255,1484,330618,69,379596
7498,0.032333,74.125.68.0-255,4320,334938,69,379596
7499,0.032342,172.31.40.0-255,66,335004,69,379596
7500,0.034321,172.31.40.0-255,172,335176,69,379596
7501,0.034353,172.31.40.0-255,1114,336290,69,379596
7502,0.034393,172.31.40.0-255,1514,337804,69,379596
7503,0.034395,172.31.40.0-255,1514,339318,69,379596
7504,0.034402,172.31.40.0-255,1514,340832,69,379596
7505,0.034403,172.31.40.0-255,1514,342346,69,379596
7506,0.034427,172.31.40.0-255,1501,343847,69,379596
7507,0.034713,74.125.68.0-255,4320,348167,69,379596
7508,0.034719,172.31.40.0-255,66,348233,69,379596
7509,0.034747,74.125.68.0-255,1484,349717,69,379596
7510,0.035876,104.244.42.0-255,66,349783,69,379596
7511,0.035933,104.244.42.0-255,66,349849,69,379596
7512,0.035983,104.244.42.0-255,66,349915,69,379596
7513,0.037002,74.125.68.0-255,4320,354235,69,379596
7514,0.037008,172.31.40.0-255,66,354301,69,379596
7515,0.039311,74.125.68.0-255,4320,358621,69,379596
7516,0.039315,172.31.40.0-255,66,358687,69,379596
7517,0.039351,74.125.68.0-255,1484,360171,69,379596
7518,0.0416,74.125.68.0-255,2902,363073,69,379596
7519,0.041605,172.31.40.0-255,66,363139,69,379596
7520,0.041654,74.125.68.0-255,1484,364623,69,379596
7521,0.043906,74.125.68.0-255,4320,368943,69,379596
7522,0.043912,172.31.40.0-255,66,369009,69,379596
7523,0.046217,74.125.68.0-255,5738,374747,69,379596
7524,0.046223,172.31.40.0-255,66,374813,69,379596
7525,0.04851,74.125.68.0-255,4546,379359,69,379596
7526,0.048516,172.31.40.0-255,66,379425,69,379596
7527,0.048702,172.31.40.0-255,105,379530,69,379596
7528,0.050949,74.125.68.0-255,66,379596,69,379596
7529,0.0,172.31.40.0-255,162,162,69,228
7530,0.007192,74.125.24.0-255,66,228,69,228
7531,0.0,74.125.24.0-255,153,153,69,381948
7532,1.8e-05,172.31.40.0-255,66,219,69,381948
7533,3.3e-05,74.125.24.0-255,1484,1703,69,381948
7534,3.7e-05,172.31.40.0-255,66,1769,69,381948
7535,6.1e-05,74.125.24.0-255,1484,3253,69,381948
7536,6.4e-05,172.31.40.0-255,66,3319,69,381948
7537,6.9e-05,74.125.24.0-255,2902,6221,69,381948
7538,7.2e-05,172.31.40.0-255,66,6287,69,381948
7539,0.000104,74.125.24.0-255,1484,7771,69,381948
7540,0.000106,172.31.40.0-255,66,7837,69,381948
7541,0.000118,74.125.24.0-255,2902,10739,69,381948
7542,0.00012,172.31.40.0-255,66,10805,69,381948
7543,0.000148,74.125.24.0-255,6355,17160,69,381948
7544,0.00015,172.31.40.0-255,66,17226,69,381948
7545,0.000156,74.125.24.0-255,5738,22964,69,381948
7546,0.000158,172.31.40.0-255,66,23030,69,381948
7547,0.000173,74.125.24.0-255,4320,27350,69,381948
7548,0.000175,172.31.40.0-255,66,27416,69,381948
7549,0.000207,74.125.24.0-255,3961,31377,69,381948
7550,0.000209,172.31.40.0-255,66,31443,69,381948
7551,0.000281,74.125.24.0-255,1484,32927,69,381948
7552,0.000284,172.31.40.0-255,66,32993,69,381948
7553,0.000289,74.125.24.0-255,2902,35895,69,381948
7554,0.000291,172.31.40.0-255,66,35961,69,381948
7555,0.000312,74.125.24.0-255,4320,40281,69,381948
7556,0.000314,172.31.40.0-255,66,40347,69,381948
7557,0.00033,74.125.24.0-255,1484,41831,69,381948
7558,0.000331,172.31.40.0-255,66,41897,69,381948
7559,0.000338,74.125.24.0-255,7156,49053,69,381948
7560,0.00034,172.31.40.0-255,66,49119,69,381948
7561,0.000368,172.31.40.0-255,66,49185,69,381948
7562,0.00039,74.125.24.0-255,5738,54923,69,381948
7563,0.000393,172.31.40.0-255,66,54989,69,381948
7564,0.000397,74.125.24.0-255,2184,57173,69,381948
7565,0.0004,172.31.40.0-255,66,57239,69,381948
7566,0.000403,74.125.24.0-255,362,57601,69,381948
7567,0.000455,74.125.24.0-255,126,57727,69,381948
7568,0.000688,74.125.24.0-255,1484,59211,69,381948
7569,0.000693,172.31.40.0-255,66,59277,69,381948
7570,0.000699,74.125.24.0-255,2902,62179,69,381948
7571,0.000702,172.31.40.0-255,66,62245,69,381948
7572,0.000709,74.125.24.0-255,5738,67983,69,381948
7573,0.000711,172.31.40.0-255,66,68049,69,381948
7574,0.000714,74.125.24.0-255,1484,69533,69,381948
7575,0.000739,74.125.24.0-255,4320,73853,69,381948
7576,0.000742,172.31.40.0-255,66,73919,69,381948
7577,0.000747,74.125.24.0-255,4320,78239,69,381948
7578,0.000749,172.31.40.0-255,66,78305,69,381948
7579,0.000764,74.125.24.0-255,5738,84043,69,381948
7580,0.000779,74.125.24.0-255,2902,86945,69,381948
7581,0.0008,74.125.24.0-255,5020,91965,69,381948
7582,0.000834,74.125.24.0-255,7156,99121,69,381948
7583,0.000863,74.125.24.0-255,5738,104859,69,381948
7584,0.000878,74.125.24.0-255,2902,107761,69,381948
7585,0.000912,74.125.24.0-255,1484,109245,69,381948
7586,0.000929,74.125.24.0-255,4726,113971,69,381948
7587,0.000988,74.125.24.0-255,1484,115455,69,381948
7588,0.00101,74.125.24.0-255,2902,118357,69,381948
7589,0.001026,74.125.24.0-255,2902,121259,69,381948
7590,0.00104,74.125.24.0-255,1484,122743,69,381948
7591,0.001078,74.125.24.0-255,5738,128481,69,381948
7592,0.001095,74.125.24.0-255,2902,131383,69,381948
7593,0.001102,74.125.24.0-255,5738,137121,69,381948
7594,0.001116,74.125.24.0-255,4320,141441,69,381948
7595,0.001131,74.125.24.0-255,6438,147879,69,381948
7596,0.001317,74.125.24.0-255,1484,149363,69,381948
7597,0.001331,74.125.24.0-255,2902,152265,69,381948
7598,0.001343,74.125.24.0-255,4320,156585,69,381948
7599,0.001355,74.125.24.0-255,1484,158069,69,381948
7600,0.001358,74.125.24.0-255,1484,159553,69,381948
7601,0.00142,74.125.24.0-255,2184,161737,69,381948
7602,0.002003,74.125.24.0-255,1484,163221,69,381948
7603,0.002024,74.125.24.0-255,2902,166123,69,381948
7604,0.002044,74.125.24.0-255,4320,170443,69,381948
7605,0.002061,74.125.24.0-255,1484,171927,69,381948
7606,0.002069,74.125.24.0-255,7156,179083,69,381948
7607,0.002084,74.125.24.0-255,2902,181985,69,381948
7608,0.00209,74.125.24.0-255,4320,186305,69,381948
7609,0.002112,74.125.24.0-255,7156,193461,69,381948
7610,0.002133,74.125.24.0-255,2184,195645,69,381948
7611,0.002367,74.125.24.0-255,1484,197129,69,381948
7612,0.00237,74.125.24.0-255,1484,198613,69,381948
7613,0.002384,74.125.24.0-255,1484,200097,69,381948
7614,0.002397,74.125.24.0-255,2902,202999,69,381948
7615,0.002412,74.125.24.0-255,2902,205901,69,381948
7616,0.002456,74.125.24.0-255,2902,208803,69,381948
7617,0.002459,74.125.24.0-255,1484,210287,69,381948
7618,0.004616,172.31.40.0-255,66,210353,69,381948
7619,0.007053,74.125.24.0-255,5738,216091,69,381948
7620,0.00706,172.31.40.0-255,66,216157,69,381948
7621,0.009489,74.125.24.0-255,5738,221895,69,381948
7622,0.009495,172.31.40.0-255,66,221961,69,381948
7623,0.011942,74.125.24.0-255,5738,227699,69,381948
7624,0.011949,172.31.40.0-255,66,227765,69,381948
7625,0.014453,74.125.24.0-255,5738,233503,69,381948
7626,0.014462,172.31.40.0-255,66,233569,69,381948
7627,0.016893,74.125.24.0-255,5738,239307,69,381948
7628,0.016899,172.31.40.0-255,66,239373,69,381948
7629,0.019374,74.125.24.0-255,5738,245111,69,381948
7630,0.019384,172.31.40.0-255,66,245177,69,381948
7631,0.02185,74.125.24.0-255,5738,250915,69,381948
7632,0.021858,172.31.40.0-255,66,250981,69,381948
7633,0.02431,74.125.24.0-255,5738,256719,69,381948
7634,0.024317,172.31.40.0-255,66,256785,69,381948
7635,0.026795,74.125.24.0-255,5738,262523,69,381948
7636,0.026802,172.31.40.0-255,66,262589,69,381948
7637,0.029244,74.125.24.0-255,5738,268327,69,381948
7638,0.029251,172.31.40.0-255,66,268393,69,381948
7639,0.0309,172.31.40.0-255,172,268565,69,381948
7640,0.030931,172.31.40.0-255,1114,269679,69,381948
7641,0.030999,172.31.40.0-255,1514,271193,69,381948
7642,0.031001,172.31.40.0-255,1514,272707,69,381948
7643,0.031003,172.31.40.0-255,1514,274221,69,381948
7644,0.031008,172.31.40.0-255,1514,275735,69,381948
7645,0.031009,172.31.40.0-255,1502,277237,69,381948
7646,0.03171,74.125.24.0-255,5738,282975,69,381948
7647,0.031718,172.31.40.0-255,66,283041,69,381948
7648,0.032576,104.244.42.0-255,66,283107,69,381948
7649,0.032605,104.244.42.0-255,66,283173,69,381948
7650,0.032675,104.244.42.0-255,66,283239,69,381948
7651,0.034161,74.125.24.0-255,5738,288977,69,381948
7652,0.034169,172.31.40.0-255,66,289043,69,381948
7653,0.036666,74.125.24.0-255,5738,294781,69,381948
7654,0.036672,172.31.40.0-255,66,294847,69,381948
7655,0.039116,74.125.24.0-255,5738,300585,69,381948
7656,0.039123,172.31.40.0-255,66,300651,69,381948
7657,0.041559,74.125.24.0-255,5738,306389,69,381948
7658,0.041565,172.31.40.0-255,66,306455,69,381948
7659,0.044007,74.125.24.0-255,2902,309357,69,381948
7660,0.044014,172.31.40.0-255,66,309423,69,381948
7661,0.044038,74.125.24.0-255,2902,312325,69,381948
7662,0.044042,172.31.40.0-255,66,312391,69,381948
7663,0.046482,74.125.24.0-255,1484,313875,69,381948
7664,0.046506,74.125.24.0-255,4320,318195,69,381948
7665,0.046511,172.31.40.0-255,66,318261,69,381948
7666,0.048953,74.125.24.0-255,5738,323999,69,381948
7667,0.048958,172.31.40.0-255,66,324065,69,381948
7668,0.051419,74.125.24.0-255,4320,328385,69,381948
7669,0.051425,172.31.40.0-255,66,328451,69,381948
7670,0.051441,74.125.24.0-255,1484,329935,69,381948
7671,0.053871,74.125.24.0-255,4320,334255,69,381948
7672,0.053877,172.31.40.0-255,66,334321,69,381948
7673,0.056323,74.125.24.0-255,5738,340059,69,381948
7674,0.056329,172.31.40.0-255,66,340125,69,381948
7675,0.058818,74.125.24.0-255,5738,345863,69,381948
7676,0.058823,172.31.40.0-255,66,345929,69,381948
7677,0.061305,74.125.24.0-255,4320,350249,69,381948
7678,0.06131,172.31.40.0-255,66,350315,69,381948
7679,0.061323,74.125.24.0-255,1484,351799,69,381948
7680,0.06375,74.125.24.0-255,2902,354701,69,381948
7681,0.063756,172.31.40.0-255,66,354767,69,381948
7682,0.063776,74.125.24.0-255,1484,356251,69,381948
7683,0.066194,74.125.24.0-255,4320,360571,69,381948
7684,0.066201,172.31.40.0-255,66,360637,69,381948
7685,0.068652,74.125.24.0-255,5738,366375,69,381948
7686,0.068658,172.31.40.0-255,66,366441,69,381948
7687,0.071119,74.125.24.0-255,5738,372179,69,381948
7688,0.071124,172.31.40.0-255,66,372245,69,381948
7689,0.073566,74.125.24.0-255,5738,377983,69,381948
7690,0.073573,172.31.40.0-255,66,378049,69,381948
7691,0.076039,74.125.24.0-255,3662,381711,69,381948
7692,0.076045,172.31.40.0-255,66,381777,69,381948
7693,0.076218,172.31.40.0-255,105,381882,69,381948
7694,0.078585,74.125.24.0-255,66,381948,69,381948
7695,0.0,172.31.40.0-255,66,66,69,66
7696,0.0,74.125.68.0-255,153,153,69,273842
7697,1.2e-05,172.31.40.0-255,66,219,69,273842
7698,4.6e-05,74.125.68.0-255,1484,1703,69,273842
7699,5e-05,172.31.40.0-255,66,1769,69,273842
7700,5.6e-05,74.125.68.0-255,2902,4671,69,273842
7701,5.9e-05,172.31.40.0-255,66,4737,69,273842
7702,0.000159,74.125.68.0-255,7156,11893,69,273842
7703,0.000163,172.31.40.0-255,66,11959,69,273842
7704,0.000412,74.125.68.0-255,2076,14035,69,273842
7705,0.000417,172.31.40.0-255,66,14101,69,273842
7706,0.000479,74.125.68.0-255,7156,21257,69,273842
7707,0.000483,172.31.40.0-255,66,21323,69,273842
7708,0.000514,74.125.68.0-255,4320,25643,69,273842
7709,0.000517,172.31.40.0-255,66,25709,69,273842
7710,0.000879,74.125.68.0-255,1484,27193,69,273842
7711,0.000886,172.31.40.0-255,66,27259,69,273842
7712,0.000922,74.125.68.0-255,3961,31220,69,273842
7713,0.000925,172.31.40.0-255,66,31286,69,273842
7714,0.00112,74.125.68.0-255,7156,38442,69,273842
7715,0.001127,172.31.40.0-255,66,38508,69,273842
7716,0.001169,172.31.40.0-255,66,38574,69,273842
7717,0.001837,172.31.40.0-255,66,38640,69,273842
7718,0.001875,172.31.40.0-255,66,38706,69,273842
7719,0.002771,74.125.68.0-255,7156,45862,69,273842
7720,0.002774,172.31.40.0-255,66,45928,69,273842
7721,0.002819,172.31.40.0-255,66,45994,69,273842
7722,0.003719,74.125.68.0-255,4320,50314,69,273842
7723,0.003725,172.31.40.0-255,66,50380,69,273842
7724,0.004489,172.31.40.0-255,66,50446,69,273842
7725,0.006759,74.125.68.0-255,1484,51930,69,273842
7726,0.006787,74.125.68.0-255,4320,56250,69,273842
7727,0.006792,172.31.40.0-255,66,56316,69,273842
7728,0.009067,74.125.68.0-255,5738,62054,69,273842
7729,0.009074,172.31.40.0-255,66,62120,69,273842
7730,0.01137,74.125.68.0-255,5738,67858,69,273842
7731,0.011379,172.31.40.0-255,66,67924,69,273842
7732,0.013656,74.125.68.0-255,5738,73662,69,273842
7733,0.013665,172.31.40.0-255,66,73728,69,273842
7734,0.015929,74.125.68.0-255,4320,78048,69,273842
7735,0.015936,172.31.40.0-255,66,78114,69,273842
7736,0.015964,74.125.68.0-255,1484,79598,69,273842
7737,0.018229,74.125.68.0-255,4320,83918,69,273842
7738,0.018238,172.31.40.0-255,66,83984,69,273842
7739,0.020513,74.125.68.0-255,5738,89722,69,273842
7740,0.020522,172.31.40.0-255,66,89788,69,273842
7741,0.022792,74.125.68.0-255,5738,95526,69,273842
7742,0.022801,172.31.40.0-255,66,95592,69,273842
7743,0.02507,74.125.68.0-255,5738,101330,69,273842
7744,0.025078,172.31.40.0-255,66,101396,69,273842
7745,0.027356,74.125.68.0-255,5738,107134,69,273842
7746,0.027363,172.31.40.0-255,66,107200,69,273842
7747,0.029629,74.125.68.0-255,5738,112938,69,273842
7748,0.029636,172.31.40.0-255,66,113004,69,273842
7749,0.031906,74.125.68.0-255,1484,114488,69,273842
7750,0.03193,74.125.68.0-255,4320,118808,69,273842
7751,0.031935,172.31.40.0-255,66,118874,69,273842
7752,0.033772,172.31.40.0-255,172,119046,69,273842
7753,0.033797,172.31.40.0-255,1116,120162,69,273842
7754,0.033851,172.31.40.0-255,1514,121676,69,273842
7755,0.033853,172.31.40.0-255,1514,123190,69,273842
7756,0.033857,172.31.40.0-255,1514,124704,69,273842
7757,0.033858,172.31.40.0-255,1514,126218,69,273842
7758,0.033876,172.31.40.0-255,1499,127717,69,273842
7759,0.034199,74.125.68.0-255,5738,133455,69,273842
7760,0.034204,172.31.40.0-255,66,133521,69,273842
7761,0.035331,104.244.42.0-255,66,133587,69,273842
7762,0.035377,104.244.42.0-255,66,133653,69,273842
7763,0.035419,104.244.42.0-255,66,133719,69,273842
7764,0.036475,74.125.68.0-255,5738,139457,69,273842
7765,0.036482,172.31.40.0-255,66,139523,69,273842
7766,0.038749,74.125.68.0-255,5738,145261,69,273842
7767,0.038756,172.31.40.0-255,66,145327,69,273842
7768,0.041036,74.125.68.0-255,5738,151065,69,273842
7769,0.041042,172.31.40.0-255,66,151131,69,273842
7770,0.043309,74.125.68.0-255,5738,156869,69,273842
7771,0.043316,172.31.40.0-255,66,156935,69,273842
7772,0.045595,74.125.68.0-255,5738,162673,69,273842
7773,0.045602,172.31.40.0-255,66,162739,69,273842
7774,0.047893,74.125.68.0-255,5738,168477,69,273842
7775,0.047901,172.31.40.0-255,66,168543,69,273842
7776,0.050171,74.125.68.0-255,5738,174281,69,273842
7777,0.050176,172.31.40.0-255,66,174347,69,273842
7778,0.052446,74.125.68.0-255,5738,180085,69,273842
7779,0.052453,172.31.40.0-255,66,180151,69,273842
7780,0.05474,74.125.68.0-255,5738,185889,69,273842
7781,0.054747,172.31.40.0-255,66,185955,69,273842
7782,0.05703,74.125.68.0-255,1484,187439,69,273842
7783,0.057061,74.125.68.0-255,4320,191759,69,273842
7784,0.057067,172.31.40.0-255,66,191825,69,273842
7785,0.059341,74.125.68.0-255,5738,197563,69,273842
7786,0.059346,172.31.40.0-255,66,197629,69,273842
7787,0.061617,74.125.68.0-255,5738,203367,69,273842
7788,0.061622,172.31.40.0-255,66,203433,69,273842
7789,0.063892,74.125.68.0-255,5738,209171,69,273842
7790,0.063897,172.31.40.0-255,66,209237,69,273842
7791,0.066184,74.125.68.0-255,5738,214975,69,273842
7792,0.066191,172.31.40.0-255,66,215041,69,273842
7793,0.066301,172.31.40.0-255,101,215142,69,273842
7794,0.068479,74.125.68.0-255,5738,220880,69,273842
7795,0.068485,172.31.40.0-255,66,220946,69,273842
7796,0.06852,74.125.68.0-255,66,221012,69,273842
7797,0.070746,74.125.68.0-255,5738,226750,69,273842
7798,0.070752,172.31.40.0-255,66,226816,69,273842
7799,0.073005,74.125.68.0-255,2902,229718,69,273842
7800,0.073011,172.31.40.0-255,66,229784,69,273842
7801,0.07304,74.125.68.0-255,2902,232686,69,273842
7802,0.073043,172.31.40.0-255,66,232752,69,273842
7803,0.075277,74.125.68.0-255,2902,235654,69,273842
7804,0.075284,172.31.40.0-255,66,235720,69,273842
7805,0.075312,74.125.68.0-255,2902,238622,69,273842
7806,0.075315,172.31.40.0-255,66,238688,69,273842
7807,0.077547,74.125.68.0-255,2902,241590,69,273842
7808,0.077554,172.31.40.0-255,66,241656,69,273842
7809,0.077581,74.125.68.0-255,2902,244558,69,273842
7810,0.077584,172.31.40.0-255,66,244624,69,273842
7811,0.079807,74.125.68.0-255,2902,247526,69,273842
7812,0.079812,172.31.40.0-255,66,247592,69,273842
7813,0.079859,74.125.68.0-255,2902,250494,69,273842
7814,0.079862,172.31.40.0-255,66,250560,69,273842
7815,0.082066,74.125.68.0-255,1484,252044,69,273842
7816,0.082111,74.125.68.0-255,4320,256364,69,273842
7817,0.082117,172.31.40.0-255,66,256430,69,273842
7818,0.084442,74.125.68.0-255,5738,262168,69,273842
7819,0.084449,172.31.40.0-255,66,262234,69,273842
7820,0.086729,74.125.68.0-255,5738,267972,69,273842
7821,0.086745,172.31.40.0-255,66,268038,69,273842
7822,0.089029,74.125.68.0-255,5738,273776,69,273842
7823,0.089044,172.31.40.0-255,66,273842,69,273842
7824,0.0,74.125.24.0-255,149,149,69,284717
7825,2.2e-05,172.31.40.0-255,66,215,69,284717
7826,2.9e-05,74.125.24.0-255,1484,1699,69,284717
7827,3.3e-05,172.31.40.0-255,66,1765,69,284717
7828,3.9e-05,74.125.24.0-255,2902,4667,69,284717
7829,4.2e-05,172.31.40.0-255,66,4733,69,284717
7830,4.9e-05,74.125.24.0-255,5738,10471,69,284717
7831,5.3e-05,172.31.40.0-255,66,10537,69,284717
7832,5.6e-05,74.125.24.0-255,1484,12021,69,284717
7833,5.9e-05,172.31.40.0-255,66,12087,69,284717
7834,0.000104,172.31.40.0-255,66,12153,69,284717
7835,0.000131,74.125.24.0-255,6797,18950,69,284717
7836,0.000134,172.31.40.0-255,66,19016,69,284717
7837,0.000199,74.125.24.0-255,1484,20500,69,284717
7838,0.000202,172.31.40.0-255,66,20566,69,284717
7839,0.000206,74.125.24.0-255,1484,22050,69,284717
7840,0.000208,172.31.40.0-255,66,22116,69,284717
7841,0.000223,74.125.24.0-255,1484,23600,69,284717
7842,0.000226,172.31.40.0-255,66,23666,69,284717
7843,0.000233,74.125.24.0-255,5738,29404,69,284717
7844,0.000236,172.31.40.0-255,66,29470,69,284717
7845,0.000256,74.125.24.0-255,2902,32372,69,284717
7846,0.000259,172.31.40.0-255,66,32438,69,284717
7847,0.000289,172.31.40.0-255,66,32504,69,284717
7848,0.000299,172.31.40.0-255,66,32570,69,284717
7849,0.000322,74.125.24.0-255,1424,33994,69,284717
7850,0.000325,172.31.40.0-255,66,34060,69,284717
7851,0.000342,74.125.24.0-255,126,34186,69,284717
7852,0.000344,172.31.40.0-255,66,34252,69,284717
7853,0.000426,74.125.24.0-255,350,34602,69,284717
7854,0.000762,74.125.24.0-255,1484,36086,69,284717
7855,0.000768,172.31.40.0-255,66,36152,69,284717
7856,0.000773,74.125.24.0-255,2902,39054,69,284717
7857,0.000775,172.31.40.0-255,66,39120,69,284717
7858,0.000778,74.125.24.0-255,1484,40604,69,284717
7859,0.000798,74.125.24.0-255,4320,44924,69,284717
7860,0.0008,172.31.40.0-255,66,44990,69,284717
7861,0.000833,172.31.40.0-255,66,45056,69,284717
7862,0.000839,74.125.24.0-255,4320,49376,69,284717
7863,0.000842,172.31.40.0-255,66,49442,69,284717
7864,0.000855,74.125.24.0-255,2902,52344,69,284717
7865,0.000857,172.31.40.0-255,66,52410,69,284717
7866,0.00089,74.125.24.0-255,3602,56012,69,284717
7867,0.000894,172.31.40.0-255,66,56078,69,284717
7868,0.001404,74.125.24.0-255,1484,57562,69,284717
7869,0.00141,74.125.24.0-255,2902,60464,69,284717
7870,0.001414,172.31.40.0-255,66,60530,69,284717
7871,0.001418,74.125.24.0-255,1484,62014,69,284717
7872,0.001442,74.125.24.0-255,4320,66334,69,284717
7873,0.001445,172.31.40.0-255,66,66400,69,284717
7874,0.001451,74.125.24.0-255,5738,72138,69,284717
7875,0.001453,172.31.40.0-255,66,72204,69,284717
7876,0.00148,74.125.24.0-255,7156,79360,69,284717
7877,0.001483,172.31.40.0-255,66,79426,69,284717
7878,0.001518,172.31.40.0-255,66,79492,69,284717
7879,0.001534,74.125.24.0-255,2184,81676,69,284717
7880,0.001536,172.31.40.0-255,66,81742,69,284717
7881,0.00154,74.125.24.0-255,1484,83226,69,284717
7882,0.001543,74.125.24.0-255,1484,84710,69,284717
7883,0.001545,172.31.40.0-255,66,84776,69,284717
7884,0.00156,74.125.24.0-255,1484,86260,69,284717
7885,0.001567,74.125.24.0-255,5738,91998,69,284717
7886,0.001569,172.31.40.0-255,66,92064,69,284717
7887,0.001574,74.125.24.0-255,4320,96384,69,284717
7888,0.001576,172.31.40.0-255,66,96450,69,284717
7889,0.001613,172.31.40.0-255,66,96516,69,284717
7890,0.001617,74.125.24.0-255,2902,99418,69,284717
7891,0.001619,172.31.40.0-255,66,99484,69,284717
7892,0.001636,74.125.24.0-255,5020,104504,69,284717
7893,0.001639,172.31.40.0-255,66,104570,69,284717
7894,0.001686,74.125.24.0-255,2902,107472,69,284717
7895,0.00169,172.31.40.0-255,66,107538,69,284717
7896,0.001712,74.125.24.0-255,4320,111858,69,284717
7897,0.001715,172.31.40.0-255,66,111924,69,284717
7898,0.001745,172.31.40.0-255,66,111990,69,284717
7899,0.001753,74.125.24.0-255,7156,119146,69,284717
7900,0.001755,172.31.40.0-255,66,119212,69,284717
7901,0.001801,172.31.40.0-255,66,119278,69,284717
7902,0.001918,74.125.24.0-255,1484,120762,69,284717
7903,0.001923,74.125.24.0-255,2902,123664,69,284717
7904,0.001926,172.31.40.0-255,66,123730,69,284717
7905,0.001938,74.125.24.0-255,2902,126632,69,284717
7906,0.001941,172.31.40.0-255,66,126698,69,284717
7907,0.001956,74.125.24.0-255,2902,129600,69,284717
7908,0.001958,172.31.40.0-255,66,129666,69,284717
7909,0.001963,74.125.24.0-255,2902,132568,69,284717
7910,0.001964,172.31.40.0-255,66,132634,69,284717
7911,0.002008,172.31.40.0-255,66,132700,69,284717
7912,0.002019,172.31.40.0-255,66,132766,69,284717
7913,0.002022,74.125.24.0-255,766,133532,69,284717
7914,0.00218,74.125.24.0-255,1484,135016,69,284717
7915,0.002183,172.31.40.0-255,66,135082,69,284717
7916,0.002188,74.125.24.0-255,2902,137984,69,284717
7917,0.00219,172.31.40.0-255,66,138050,69,284717
7918,0.002216,74.125.24.0-255,5738,143788,69,284717
7919,0.002218,172.31.40.0-255,66,143854,69,284717
7920,0.002229,74.125.24.0-255,5738,149592,69,284717
7921,0.002231,172.31.40.0-255,66,149658,69,284717
7922,0.002263,74.125.24.0-255,7156,156814,69,284717
7923,0.002265,172.31.40.0-255,66,156880,69,284717
7924,0.002277,172.31.40.0-255,66,156946,69,284717
7925,0.002293,74.125.24.0-255,1484,158430,69,284717
7926,0.002319,172.31.40.0-255,66,158496,69,284717
7927,0.002349,172.31.40.0-255,66,158562,69,284717
7928,0.002357,172.31.40.0-255,66,158628,69,284717
7929,0.004645,74.125.24.0-255,5738,164366,69,284717
7930,0.004656,172.31.40.0-255,66,164432,69,284717
7931,0.006988,74.125.24.0-255,5738,170170,69,284717
7932,0.006994,172.31.40.0-255,66,170236,69,284717
7933,0.009293,74.125.24.0-255,5738,175974,69,284717
7934,0.0093,172.31.40.0-255,66,176040,69,284717
7935,0.011611,74.125.24.0-255,5738,181778,69,284717
7936,0.011626,172.31.40.0-255,66,181844,69,284717
7937,0.013938,74.125.24.0-255,5738,187582,69,284717
7938,0.013951,172.31.40.0-255,66,187648,69,284717
7939,0.016262,74.125.24.0-255,5738,193386,69,284717
7940,0.016276,172.31.40.0-255,66,193452,69,284717
7941,0.018594,74.125.24.0-255,5738,199190,69,284717
7942,0.018608,172.31.40.0-255,66,199256,69,284717
7943,0.020911,74.125.24.0-255,5738,204994,69,284717
7944,0.020919,172.31.40.0-255,66,205060,69,284717
7945,0.023252,74.125.24.0-255,5738,210798,69,284717
7946,0.023259,172.31.40.0-255,66,210864,69,284717
7947,0.025571,74.125.24.0-255,5738,216602,69,284717
7948,0.025583,172.31.40.0-255,66,216668,69,284717
7949,0.027894,74.125.24.0-255,5738,222406,69,284717
7950,0.027907,172.31.40.0-255,66,222472,69,284717
7951,0.030203,74.125.24.0-255,5738,228210,69,284717
7952,0.030212,172.31.40.0-255,66,228276,69,284717
7953,0.032535,74.125.24.0-255,5738,234014,69,284717
7954,0.032547,172.31.40.0-255,66,234080,69,284717
7955,0.034868,74.125.24.0-255,5738,239818,69,284717
7956,0.03488,172.31.40.0-255,66,239884,69,284717
7957,0.036984,172.31.40.0-255,172,240056,69,284717
7958,0.037017,172.31.40.0-255,1116,241172,69,284717
7959,0.037082,172.31.40.0-255,1514,242686,69,284717
7960,0.037084,172.31.40.0-255,1514,244200,69,284717
7961,0.037085,172.31.40.0-255,1514,245714,69,284717
7962,0.037086,172.31.40.0-255,1514,247228,69,284717
7963,0.037115,172.31.40.0-255,1499,248727,69,284717
7964,0.037196,74.125.24.0-255,5738,254465,69,284717
7965,0.037202,172.31.40.0-255,66,254531,69,284717
7966,0.038533,104.244.42.0-255,66,254597,69,284717
7967,0.038585,104.244.42.0-255,66,254663,69,284717
7968,0.038648,104.244.42.0-255,66,254729,69,284717
7969,0.038719,104.244.42.0-255,66,254795,69,284717
7970,0.039513,74.125.24.0-255,5738,260533,69,284717
7971,0.039524,172.31.40.0-255,66,260599,69,284717
7972,0.041831,74.125.24.0-255,5738,266337,69,284717
7973,0.041839,172.31.40.0-255,66,266403,69,284717
7974,0.044154,74.125.24.0-255,5738,272141,69,284717
7975,0.04416,172.31.40.0-255,66,272207,69,284717
7976,0.046464,74.125.24.0-255,5738,277945,69,284717
7977,0.04647,172.31.40.0-255,66,278011,69,284717
7978,0.048772,74.125.24.0-255,5738,283749,69,284717
7979,0.04878,172.31.40.0-255,66,283815,69,284717
7980,0.051081,74.125.24.0-255,665,284480,69,284717
7981,0.051211,172.31.40.0-255,66,284546,69,284717
7982,0.05125,172.31.40.0-255,105,284651,69,284717
7983,0.053534,74.125.24.0-255,66,284717,69,284717
7984,0.0,172.217.194.0-255,153,153,69,255582
7985,1.6e-05,172.31.40.0-255,66,219,69,255582
7986,2.3e-05,172.217.194.0-255,1484,1703,69,255582
7987,2.8e-05,172.31.40.0-255,66,1769,69,255582
7988,6.3e-05,172.217.194.0-255,2902,4671,69,255582
7989,6.6e-05,172.31.40.0-255,66,4737,69,255582
7990,7.8e-05,172.217.194.0-255,7156,11893,69,255582
7991,8.1e-05,172.31.40.0-255,66,11959,69,255582
7992,8.5e-05,172.217.194.0-255,2057,14016,69,255582
7993,8.8e-05,172.31.40.0-255,66,14082,69,255582
7994,9.3e-05,172.217.194.0-255,2902,16984,69,255582
7995,9.6e-05,172.31.40.0-255,66,17050,69,255582
7996,0.000103,172.217.194.0-255,7156,24206,69,255582
7997,0.000105,172.31.40.0-255,66,24272,69,255582
7998,0.000147,172.217.194.0-255,6797,31069,69,255582
7999,0.000151,172.31.40.0-255,66,31135,69,255582
8000,0.000295,172.217.194.0-255,1484,32619,69,255582
8001,0.0003,172.31.40.0-255,66,32685,69,255582
8002,0.000308,172.217.194.0-255,2902,35587,69,255582
8003,0.00031,172.31.40.0-255,66,35653,69,255582
8004,0.000316,172.217.194.0-255,2902,38555,69,255582
8005,0.000318,172.31.40.0-255,66,38621,69,255582
8006,0.000349,172.217.194.0-255,2902,41523,69,255582
8007,0.000351,172.31.40.0-255,66,41589,69,255582
8008,0.000357,172.217.194.0-255,4320,45909,69,255582
8009,0.000359,172.31.40.0-255,66,45975,69,255582
8010,0.000381,172.217.194.0-255,2543,48518,69,255582
8011,0.000384,172.31.40.0-255,66,48584,69,255582
8012,0.000388,172.217.194.0-255,2902,51486,69,255582
8013,0.00039,172.31.40.0-255,66,51552,69,255582
8014,0.000401,172.217.194.0-255,7156,58708,69,255582
8015,0.000404,172.31.40.0-255,66,58774,69,255582
8016,0.000439,172.217.194.0-255,6797,65571,69,255582
8017,0.000442,172.31.40.0-255,66,65637,69,255582
8018,0.001419,172.217.194.0-255,646,66283,69,255582
8019,0.00159,172.217.194.0-255,1484,67767,69,255582
8020,0.001597,172.31.40.0-255,66,67833,69,255582
8021,0.001603,172.217.194.0-255,2902,70735,69,255582
8022,0.001606,172.31.40.0-255,66,70801,69,255582
8023,0.001617,172.217.194.0-255,5738,76539,69,255582
8024,0.001619,172.31.40.0-255,66,76605,69,255582
8025,0.001622,172.217.194.0-255,1484,78089,69,255582
8026,0.001674,172.31.40.0-255,66,78155,69,255582
8027,0.001686,172.31.40.0-255,66,78221,69,255582
8028,0.001785,172.217.194.0-255,1484,79705,69,255582
8029,0.001791,172.217.194.0-255,2902,82607,69,255582
8030,0.001794,172.31.40.0-255,66,82673,69,255582
8031,0.001831,172.217.194.0-255,5738,88411,69,255582
8032,0.001833,172.31.40.0-255,66,88477,69,255582
8033,0.001842,172.217.194.0-255,7156,95633,69,255582
8034,0.001844,172.31.40.0-255,66,95699,69,255582
8035,0.001867,172.217.194.0-255,5738,101437,69,255582
8036,0.001873,172.31.40.0-255,66,101503,69,255582
8037,0.001886,172.31.40.0-255,66,101569,69,255582
8038,0.001891,172.217.194.0-255,2902,104471,69,255582
8039,0.001893,172.31.40.0-255,66,104537,69,255582
8040,0.001923,172.217.194.0-255,1484,106021,69,255582
8041,0.00193,172.217.194.0-255,5738,111759,69,255582
8042,0.001937,172.31.40.0-255,66,111825,69,255582
8043,0.001952,172.31.40.0-255,66,111891,69,255582
8044,0.001965,172.31.40.0-255,66,111957,69,255582
8045,0.001996,172.217.194.0-255,1484,113441,69,255582
8046,0.002008,172.217.194.0-255,2902,116343,69,255582
8047,0.002011,172.31.40.0-255,66,116409,69,255582
8048,0.002027,172.217.194.0-255,2902,119311,69,255582
8049,0.002033,172.31.40.0-255,66,119377,69,255582
8050,0.002057,172.217.194.0-255,2902,122279,69,255582
8051,0.002059,172.31.40.0-255,66,122345,69,255582
8052,0.002074,172.31.40.0-255,66,122411,69,255582
8053,0.002082,172.217.194.0-255,2902,125313,69,255582
8054,0.002084,172.31.40.0-255,66,125379,69,255582
8055,0.002122,172.31.40.0-255,66,125445,69,255582
8056,0.002157,172.217.194.0-255,1484,126929,69,255582
8057,0.002163,172.217.194.0-255,2902,129831,69,255582
8058,0.002165,172.31.40.0-255,66,129897,69,255582
8059,0.002171,172.217.194.0-255,4320,134217,69,255582
8060,0.002173,172.31.40.0-255,66,134283,69,255582
8061,0.002204,172.217.194.0-255,1484,135767,69,255582
8062,0.002219,172.31.40.0-255,66,135833,69,255582
8063,0.002232,172.31.40.0-255,66,135899,69,255582
8064,0.002258,172.217.194.0-255,766,136665,69,255582
8065,0.002293,172.217.194.0-255,1484,138149,69,255582
8066,0.002296,172.31.40.0-255,66,138215,69,255582
8067,0.0023,172.217.194.0-255,1484,139699,69,255582
8068,0.002315,172.217.194.0-255,1484,141183,69,255582
8069,0.002321,172.31.40.0-255,66,141249,69,255582
8070,0.002328,172.217.194.0-255,5738,146987,69,255582
8071,0.002331,172.31.40.0-255,66,147053,69,255582
8072,0.002381,172.31.40.0-255,66,147119,69,255582
8073,0.002394,172.31.40.0-255,66,147185,69,255582
8074,0.002485,172.31.40.0-255,66,147251,69,255582
8075,0.002497,172.31.40.0-255,66,147317,69,255582
8076,0.002502,172.217.194.0-255,4320,151637,69,255582
8077,0.002504,172.31.40.0-255,66,151703,69,255582
8078,0.002555,172.31.40.0-255,66,151769,69,255582
8079,0.002566,172.31.40.0-255,66,151835,69,255582
8080,0.005043,172.217.194.0-255,4320,156155,69,255582
8081,0.005047,172.31.40.0-255,66,156221,69,255582
8082,0.00507,172.217.194.0-255,1484,157705,69,255582
8083,0.007542,172.217.194.0-255,4320,162025,69,255582
8084,0.00755,172.31.40.0-255,66,162091,69,255582
8085,0.009544,172.31.40.0-255,101,162192,69,255582
8086,0.010045,172.217.194.0-255,5738,167930,69,255582
8087,0.010051,172.31.40.0-255,66,167996,69,255582
8088,0.01198,172.217.194.0-255,66,168062,69,255582
8089,0.01253,172.217.194.0-255,5738,173800,69,255582
8090,0.012537,172.31.40.0-255,66,173866,69,255582
8091,0.015046,172.217.194.0-255,5738,179604,69,255582
8092,0.015053,172.31.40.0-255,66,179670,69,255582
8093,0.01754,172.217.194.0-255,5738,185408,69,255582
8094,0.017551,172.31.40.0-255,66,185474,69,255582
8095,0.020063,172.217.194.0-255,5738,191212,69,255582
8096,0.020072,172.31.40.0-255,66,191278,69,255582
8097,0.022547,172.217.194.0-255,5738,197016,69,255582
8098,0.022553,172.31.40.0-255,66,197082,69,255582
8099,0.02504,172.217.194.0-255,5738,202820,69,255582
8100,0.025047,172.31.40.0-255,66,202886,69,255582
8101,0.027538,172.217.194.0-255,5738,208624,69,255582
8102,0.027547,172.31.40.0-255,66,208690,69,255582
8103,0.030025,172.217.194.0-255,5738,214428,69,255582
8104,0.030032,172.31.40.0-255,66,214494,69,255582
8105,0.032522,172.217.194.0-255,5738,220232,69,255582
8106,0.032533,172.31.40.0-255,66,220298,69,255582
8107,0.035017,172.217.194.0-255,5738,226036,69,255582
8108,0.035026,172.31.40.0-255,66,226102,69,255582
8109,0.037506,172.217.194.0-255,5738,231840,69,255582
8110,0.037513,172.31.40.0-255,66,231906,69,255582
8111,0.037521,172.31.40.0-255,172,232078,69,255582
8112,0.03757,172.31.40.0-255,1112,233190,69,255582
8113,0.037688,172.31.40.0-255,1514,234704,69,255582
8114,0.037691,172.31.40.0-255,1514,236218,69,255582
8115,0.037692,172.31.40.0-255,1514,237732,69,255582
8116,0.037693,172.31.40.0-255,1514,239246,69,255582
8117,0.037723,172.31.40.0-255,1505,240751,69,255582
8118,0.039147,104.244.42.0-255,66,240817,69,255582
8119,0.03917,104.244.42.0-255,66,240883,69,255582
8120,0.039331,104.244.42.0-255,66,240949,69,255582
8121,0.039361,104.244.42.0-255,66,241015,69,255582
8122,0.039896,104.244.42.0-255,108,241123,69,255582
8123,0.039903,172.31.40.0-255,66,241189,69,255582
8124,0.039994,172.217.194.0-255,5738,246927,69,255582
8125,0.039998,172.31.40.0-255,66,246993,69,255582
8126,0.042467,172.217.194.0-255,5738,252731,69,255582
8127,0.042473,172.31.40.0-255,66,252797,69,255582
8128,0.044949,172.217.194.0-255,2548,255345,69,255582
8129,0.044958,172.31.40.0-255,66,255411,69,255582
8130,0.045134,172.31.40.0-255,105,255516,69,255582
8131,0.0513,172.217.194.0-255,66,255582,69,255582
8132,0.0,172.31.40.0-255,105,105,69,276
8133,0.00185,157.240.7.0-255,105,210,69,276
8134,0.001864,172.31.40.0-255,66,276,69,276
8135,0.0,74.125.24.0-255,146,146,69,346968
8136,2.2e-05,172.31.40.0-255,66,212,69,346968
8137,2.9e-05,74.125.24.0-255,1484,1696,69,346968
8138,3.3e-05,172.31.40.0-255,66,1762,69,346968
8139,3.9e-05,74.125.24.0-255,2902,4664,69,346968
8140,4.2e-05,172.31.40.0-255,66,4730,69,346968
8141,4.9e-05,74.125.24.0-255,7156,11886,69,346968
8142,5.2e-05,172.31.40.0-255,66,11952,69,346968
8143,5.5e-05,74.125.24.0-255,1484,13436,69,346968
8144,5.7e-05,172.31.40.0-255,66,13502,69,346968
8145,7.9e-05,74.125.24.0-255,646,14148,69,346968
8146,8.1e-05,172.31.40.0-255,66,14214,69,346968
8147,0.000526,74.125.24.0-255,1484,15698,69,346968
8148,0.000532,172.31.40.0-255,66,15764,69,346968
8149,0.00054,74.125.24.0-255,2902,18666,69,346968
8150,0.000543,172.31.40.0-255,66,18732,69,346968
8151,0.000548,74.125.24.0-255,2902,21634,69,346968
8152,0.000549,172.31.40.0-255,66,21700,69,346968
8153,0.000578,74.125.24.0-255,7156,28856,69,346968
8154,0.00058,172.31.40.0-255,66,28922,69,346968
8155,0.0006,74.125.24.0-255,2543,31465,69,346968
8156,0.000604,172.31.40.0-255,66,31531,69,346968
8157,0.000635,74.125.24.0-255,2902,34433,69,346968
8158,0.000637,172.31.40.0-255,66,34499,69,346968
8159,0.000657,74.125.24.0-255,2902,37401,69,346968
8160,0.00066,172.31.40.0-255,66,37467,69,346968
8161,0.00068,74.125.24.0-255,2902,40369,69,346968
8162,0.000682,172.31.40.0-255,66,40435,69,346968
8163,0.000687,74.125.24.0-255,2902,43337,69,346968
8164,0.000689,172.31.40.0-255,66,43403,69,346968
8165,0.000708,74.125.24.0-255,4320,47723,69,346968
8166,0.000711,172.31.40.0-255,66,47789,69,346968
8167,0.000714,74.125.24.0-255,1125,48914,69,346968
8168,0.000764,74.125.24.0-255,1484,50398,69,346968
8169,0.000769,172.31.40.0-255,66,50464,69,346968
8170,0.000773,74.125.24.0-255,1484,51948,69,346968
8171,0.000789,74.125.24.0-255,1484,53432,69,346968
8172,0.000792,172.31.40.0-255,66,53498,69,346968
8173,0.000798,74.125.24.0-255,4320,57818,69,346968
8174,0.0008,172.31.40.0-255,66,57884,69,346968
8175,0.00082,74.125.24.0-255,1484,59368,69,346968
8176,0.000825,74.125.24.0-255,2902,62270,69,346968
8177,0.000827,172.31.40.0-255,66,62336,69,346968
8178,0.000866,74.125.24.0-255,3961,66297,69,346968
8179,0.000869,172.31.40.0-255,66,66363,69,346968
8180,0.000887,74.125.24.0-255,411,66774,69,346968
8181,0.000938,74.125.24.0-255,331,67105,69,346968
8182,0.001431,74.125.24.0-255,1484,68589,69,346968
8183,0.001438,172.31.40.0-255,66,68655,69,346968
8184,0.001445,74.125.24.0-255,2902,71557,69,346968
8185,0.001448,172.31.40.0-255,66,71623,69,346968
8186,0.001455,74.125.24.0-255,5738,77361,69,346968
8187,0.001457,172.31.40.0-255,66,77427,69,346968
8188,0.001488,74.125.24.0-255,7156,84583,69,346968
8189,0.001491,172.31.40.0-255,66,84649,69,346968
8190,0.001499,74.125.24.0-255,7156,91805,69,346968
8191,0.001501,172.31.40.0-255,66,91871,69,346968
8192,0.001525,74.125.24.0-255,1484,93355,69,346968
8193,0.001536,172.31.40.0-255,66,93421,69,346968
8194,0.00157,74.125.24.0-255,1484,94905,69,346968
8195,0.001573,74.125.24.0-255,1484,96389,69,346968
8196,0.001575,172.31.40.0-255,66,96455,69,346968
8197,0.001593,74.125.24.0-255,1484,97939,69,346968
8198,0.001598,74.125.24.0-255,4320,102259,69,346968
8199,0.0016,172.31.40.0-255,66,102325,69,346968
8200,0.001616,74.125.24.0-255,1484,103809,69,346968
8201,0.001621,74.125.24.0-255,5738,109547,69,346968
8202,0.001624,172.31.40.0-255,66,109613,69,346968
8203,0.001656,74.125.24.0-255,7156,116769,69,346968
8204,0.001659,172.31.40.0-255,66,116835,69,346968
8205,0.001672,172.31.40.0-255,66,116901,69,346968
8206,0.001674,74.125.24.0-255,766,117667,69,346968
8207,0.002269,74.125.24.0-255,1484,119151,69,346968
8208,0.002272,172.31.40.0-255,66,119217,69,346968
8209,0.002278,74.125.24.0-255,2902,122119,69,346968
8210,0.002281,172.31.40.0-255,66,122185,69,346968
8211,0.002283,74.125.24.0-255,1484,123669,69,346968
8212,0.002297,74.125.24.0-255,4320,127989,69,346968
8213,0.002527,74.125.24.0-255,1484,129473,69,346968
8214,0.002544,74.125.24.0-255,2902,132375,69,346968
8215,0.00256,74.125.24.0-255,5738,138113,69,346968
8216,0.002567,74.125.24.0-255,5738,143851,69,346968
8217,0.002581,74.125.24.0-255,1484,145335,69,346968
8218,0.002611,74.125.24.0-255,2902,148237,69,346968
8219,0.002614,74.125.24.0-255,1484,149721,69,346968
8220,0.002632,74.125.24.0-255,3602,153323,69,346968
8221,0.003831,172.31.40.0-255,66,153389,69,346968
8222,0.006399,74.125.24.0-255,5738,159127,69,346968
8223,0.006406,172.31.40.0-255,66,159193,69,346968
8224,0.008989,74.125.24.0-255,5738,164931,69,346968
8225,0.008997,172.31.40.0-255,66,164997,69,346968
8226,0.011605,74.125.24.0-255,5738,170735,69,346968
8227,0.011613,172.31.40.0-255,66,170801,69,346968
8228,0.014204,74.125.24.0-255,5738,176539,69,346968
8229,0.014214,172.31.40.0-255,66,176605,69,346968
8230,0.016801,74.125.24.0-255,5738,182343,69,346968
8231,0.01681,172.31.40.0-255,66,182409,69,346968
8232,0.019378,74.125.24.0-255,5738,188147,69,346968
8233,0.019385,172.31.40.0-255,66,188213,69,346968
8234,0.021977,74.125.24.0-255,5738,193951,69,346968
8235,0.021984,172.31.40.0-255,66,194017,69,346968
8236,0.024557,74.125.24.0-255,5738,199755,69,346968
8237,0.024565,172.31.40.0-255,66,199821,69,346968
8238,0.027165,74.125.24.0-255,5738,205559,69,346968
8239,0.027172,172.31.40.0-255,66,205625,69,346968
8240,0.029754,74.125.24.0-255,5738,211363,69,346968
8241,0.029762,172.31.40.0-255,66,211429,69,346968
8242,0.032322,172.31.40.0-255,172,211601,69,346968
8243,0.032351,74.125.24.0-255,5738,217339,69,346968
8244,0.032357,172.31.40.0-255,66,217405,69,346968
8245,0.032366,172.31.40.0-255,1114,218519,69,346968
8246,0.032483,172.31.40.0-255,563,219082,69,346968
8247,0.033865,104.244.42.0-255,66,219148,69,346968
8248,0.033968,104.244.42.0-255,66,219214,69,346968
8249,0.034022,104.244.42.0-255,66,219280,69,346968
8250,0.034938,74.125.24.0-255,5738,225018,69,346968
8251,0.034957,172.31.40.0-255,66,225084,69,346968
8252,0.037556,74.125.24.0-255,5738,230822,69,346968
8253,0.037563,172.31.40.0-255,66,230888,69,346968
8254,0.040133,74.125.24.0-255,5738,236626,69,346968
8255,0.040139,172.31.40.0-255,66,236692,69,346968
8256,0.042728,74.125.24.0-255,5738,242430,69,346968
8257,0.042736,172.31.40.0-255,66,242496,69,346968
8258,0.04533,74.125.24.0-255,5738,248234,69,346968
8259,0.045336,172.31.40.0-255,66,248300,69,346968
8260,0.047941,74.125.24.0-255,5738,254038,69,346968
8261,0.047948,172.31.40.0-255,66,254104,69,346968
8262,0.050532,74.125.24.0-255,5738,259842,69,346968
8263,0.050539,172.31.40.0-255,66,259908,69,346968
8264,0.05314,74.125.24.0-255,5738,265646,69,346968
8265,0.053146,172.31.40.0-255,66,265712,69,346968
8266,0.05574,74.125.24.0-255,5738,271450,69,346968
8267,0.055747,172.31.40.0-255,66,271516,69,346968
8268,0.058358,74.125.24.0-255,5738,277254,69,346968
8269,0.058365,172.31.40.0-255,66,277320,69,346968
8270,0.060947,74.125.24.0-255,5738,283058,69,346968
8271,0.060952,172.31.40.0-255,66,283124,69,346968
8272,0.063584,74.125.24.0-255,5738,288862,69,346968
8273,0.063592,172.31.40.0-255,66,288928,69,346968
8274,0.0662,74.125.24.0-255,5738,294666,69,346968
8275,0.066206,172.31.40.0-255,66,294732,69,346968
8276,0.068808,74.125.24.0-255,5738,300470,69,346968
8277,0.068815,172.31.40.0-255,66,300536,69,346968
8278,0.071431,74.125.24.0-255,5738,306274,69,346968
8279,0.071437,172.31.40.0-255,66,306340,69,346968
8280,0.074029,74.125.24.0-255,5738,312078,69,346968
8281,0.074035,172.31.40.0-255,66,312144,69,346968
8282,0.076635,74.125.24.0-255,5738,317882,69,346968
8283,0.076643,172.31.40.0-255,66,317948,69,346968
8284,0.079235,74.125.24.0-255,5738,323686,69,346968
8285,0.07924,172.31.40.0-255,66,323752,69,346968
8286,0.08183,74.125.24.0-255,5738,329490,69,346968
8287,0.081837,172.31.40.0-255,66,329556,69,346968
8288,0.08444,74.125.24.0-255,5738,335294,69,346968
8289,0.084446,172.31.40.0-255,66,335360,69,346968
8290,0.087067,74.125.24.0-255,5738,341098,69,346968
8291,0.087073,172.31.40.0-255,66,341164,69,346968
8292,0.089669,74.125.24.0-255,5738,346902,69,346968
8293,0.089675,172.31.40.0-255,66,346968,69,346968
8294,0.0,74.125.200.0-255,153,153,69,294070
8295,1.5e-05,172.31.40.0-255,66,219,69,294070
8296,2.2e-05,74.125.200.0-255,1484,1703,69,294070
8297,2.6e-05,172.31.40.0-255,66,1769,69,294070
8298,5.4e-05,74.125.200.0-255,2902,4671,69,294070
8299,5.7e-05,172.31.40.0-255,66,4737,69,294070
8300,6.3e-05,74.125.200.0-255,5738,10475,69,294070
8301,6.6e-05,172.31.40.0-255,66,10541,69,294070
8302,0.000109,74.125.200.0-255,2902,13443,69,294070
8303,0.000112,172.31.40.0-255,66,13509,69,294070
8304,0.000126,74.125.200.0-255,658,14167,69,294070
8305,0.000128,172.31.40.0-255,66,14233,69,294070
8306,0.00044,74.125.200.0-255,1484,15717,69,294070
8307,0.000446,172.31.40.0-255,66,15783,69,294070
8308,0.000454,74.125.200.0-255,2902,18685,69,294070
8309,0.000456,172.31.40.0-255,66,18751,69,294070
8310,0.000483,74.125.200.0-255,5738,24489,69,294070
8311,0.000485,172.31.40.0-255,66,24555,69,294070
8312,0.000521,74.125.200.0-255,1484,26039,69,294070
8313,0.000524,172.31.40.0-255,66,26105,69,294070
8314,0.000548,74.125.200.0-255,4320,30425,69,294070
8315,0.000551,172.31.40.0-255,66,30491,69,294070
8316,0.000581,74.125.200.0-255,1125,31616,69,294070
8317,0.000583,172.31.40.0-255,66,31682,69,294070
8318,0.000746,74.125.200.0-255,1484,33166,69,294070
8319,0.00075,172.31.40.0-255,66,33232,69,294070
8320,0.000756,74.125.200.0-255,2902,36134,69,294070
8321,0.000759,172.31.40.0-255,66,36200,69,294070
8322,0.00079,74.125.200.0-255,5738,41938,69,294070
8323,0.000794,172.31.40.0-255,66,42004,69,294070
8324,0.000814,74.125.200.0-255,4320,46324,69,294070
8325,0.000817,172.31.40.0-255,66,46390,69,294070
8326,0.000838,74.125.200.0-255,3961,50351,69,294070
8327,0.000891,74.125.200.0-255,4320,54671,69,294070
8328,0.000908,74.125.200.0-255,4320,58991,69,294070
8329,0.000979,74.125.200.0-255,4320,63311,69,294070
8330,0.000997,74.125.200.0-255,2543,65854,69,294070
8331,0.001484,74.125.200.0-255,394,66248,69,294070
8332,0.001536,74.125.200.0-255,348,66596,69,294070
8333,0.002027,74.125.200.0-255,1484,68080,69,294070
8334,0.002041,74.125.200.0-255,2902,70982,69,294070
8335,0.002062,74.125.200.0-255,5738,76720,69,294070
8336,0.002111,74.125.200.0-255,2902,79622,69,294070
8337,0.00213,74.125.200.0-255,4320,83942,69,294070
8338,0.002186,74.125.200.0-255,5738,89680,69,294070
8339,0.002201,74.125.200.0-255,5738,95418,69,294070
8340,0.002218,74.125.200.0-255,1484,96902,69,294070
8341,0.002301,74.125.200.0-255,1484,98386,69,294070
8342,0.002315,74.125.200.0-255,2184,100570,69,294070
8343,0.003477,172.31.40.0-255,66,100636,69,294070
8344,0.006228,74.125.200.0-255,5738,106374,69,294070
8345,0.006235,172.31.40.0-255,66,106440,69,294070
8346,0.008965,74.125.200.0-255,2902,109342,69,294070
8347,0.008972,172.31.40.0-255,66,109408,69,294070
8348,0.008992,74.125.200.0-255,2902,112310,69,294070
8349,0.009006,172.31.40.0-255,66,112376,69,294070
8350,0.011687,74.125.200.0-255,2902,115278,69,294070
8351,0.011695,172.31.40.0-255,66,115344,69,294070
8352,0.011717,74.125.200.0-255,2902,118246,69,294070
8353,0.011751,172.31.40.0-255,66,118312,69,294070
8354,0.014424,74.125.200.0-255,2902,121214,69,294070
8355,0.014435,172.31.40.0-255,66,121280,69,294070
8356,0.014463,74.125.200.0-255,2902,124182,69,294070
8357,0.014493,172.31.40.0-255,66,124248,69,294070
8358,0.017162,74.125.200.0-255,2902,127150,69,294070
8359,0.017169,172.31.40.0-255,66,127216,69,294070
8360,0.017204,74.125.200.0-255,1484,128700,69,294070
8361,0.017217,74.125.200.0-255,1484,130184,69,294070
8362,0.017829,172.31.40.0-255,66,130250,69,294070
8363,0.019896,74.125.200.0-255,2902,133152,69,294070
8364,0.019904,172.31.40.0-255,66,133218,69,294070
8365,0.020544,74.125.200.0-255,2902,136120,69,294070
8366,0.02055,172.31.40.0-255,66,136186,69,294070
8367,0.022629,74.125.200.0-255,2902,139088,69,294070
8368,0.022636,172.31.40.0-255,66,139154,69,294070
8369,0.023278,74.125.200.0-255,2902,142056,69,294070
8370,0.023284,172.31.40.0-255,66,142122,69,294070
8371,0.025364,74.125.200.0-255,2902,145024,69,294070
8372,0.02537,172.31.40.0-255,66,145090,69,294070
8373,0.026003,74.125.200.0-255,2902,147992,69,294070
8374,0.026009,172.31.40.0-255,66,148058,69,294070
8375,0.028089,74.125.200.0-255,2902,150960,69,294070
8376,0.028097,172.31.40.0-255,66,151026,69,294070
8377,0.028729,74.125.200.0-255,2902,153928,69,294070
8378,0.028736,172.31.40.0-255,66,153994,69,294070
8379,0.029461,172.31.40.0-255,172,154166,69,294070
8380,0.02949,172.31.40.0-255,1116,155282,69,294070
8381,0.02954,172.31.40.0-255,1514,156796,69,294070
8382,0.029542,172.31.40.0-255,1514,158310,69,294070
8383,0.029546,172.31.40.0-255,1514,159824,69,294070
8384,0.029548,172.31.40.0-255,1514,161338,69,294070
8385,0.029565,172.31.40.0-255,1499,162837,69,294070
8386,0.030814,74.125.200.0-255,2902,165739,69,294070
8387,0.030821,172.31.40.0-255,66,165805,69,294070
8388,0.031177,104.244.42.0-255,66,165871,69,294070
8389,0.031201,104.244.42.0-255,66,165937,69,294070
8390,0.031299,104.244.42.0-255,66,166003,69,294070
8391,0.031461,74.125.200.0-255,2902,168905,69,294070
8392,0.031466,172.31.40.0-255,66,168971,69,294070
8393,0.033556,74.125.200.0-255,2902,171873,69,294070
8394,0.033563,172.31.40.0-255,66,171939,69,294070
8395,0.034185,74.125.200.0-255,2902,174841,69,294070
8396,0.034192,172.31.40.0-255,66,174907,69,294070
8397,0.036293,74.125.200.0-255,2902,177809,69,294070
8398,0.0363,172.31.40.0-255,66,177875,69,294070
8399,0.036921,74.125.200.0-255,2902,180777,69,294070
8400,0.036928,172.31.40.0-255,66,180843,69,294070
8401,0.039029,74.125.200.0-255,2902,183745,69,294070
8402,0.039036,172.31.40.0-255,66,183811,69,294070
8403,0.039656,74.125.200.0-255,2902,186713,69,294070
8404,0.039664,172.31.40.0-255,66,186779,69,294070
8405,0.04176,74.125.200.0-255,2902,189681,69,294070
8406,0.041769,172.31.40.0-255,66,189747,69,294070
8407,0.042216,172.31.40.0-255,105,189852,69,294070
8408,0.042393,74.125.200.0-255,2902,192754,69,294070
8409,0.042399,172.31.40.0-255,66,192820,69,294070
8410,0.044115,157.240.7.0-255,105,192925,69,294070
8411,0.044125,172.31.40.0-255,66,192991,69,294070
8412,0.044498,74.125.200.0-255,2902,195893,69,294070
8413,0.044503,172.31.40.0-255,66,195959,69,294070
8414,0.045138,74.125.200.0-255,2902,198861,69,294070
8415,0.045146,172.31.40.0-255,66,198927,69,294070
8416,0.047221,74.125.200.0-255,2902,201829,69,294070
8417,0.047228,172.31.40.0-255,66,201895,69,294070
8418,0.047872,74.125.200.0-255,2902,204797,69,294070
8419,0.04788,172.31.40.0-255,66,204863,69,294070
8420,0.04996,74.125.200.0-255,2902,207765,69,294070
8421,0.049967,172.31.40.0-255,66,207831,69,294070
8422,0.050607,74.125.200.0-255,2902,210733,69,294070
8423,0.050614,172.31.40.0-255,66,210799,69,294070
8424,0.052684,74.125.200.0-255,2902,213701,69,294070
8425,0.05269,172.31.40.0-255,66,213767,69,294070
8426,0.053334,74.125.200.0-255,2902,216669,69,294070
8427,0.053972,172.31.40.0-255,66,216735,69,294070
8428,0.054059,172.31.40.0-255,101,216836,69,294070
8429,0.055435,74.125.200.0-255,2902,219738,69,294070
8430,0.055442,172.31.40.0-255,66,219804,69,294070
8431,0.056736,74.125.200.0-255,2902,222706,69,294070
8432,0.056743,172.31.40.0-255,66,222772,69,294070
8433,0.056747,74.125.200.0-255,66,222838,69,294070
8434,0.058168,74.125.200.0-255,2902,225740,69,294070
8435,0.058175,172.31.40.0-255,66,225806,69,294070
8436,0.059484,74.125.200.0-255,2902,228708,69,294070
8437,0.05949,172.31.40.0-255,66,228774,69,294070
8438,0.060903,74.125.200.0-255,2902,231676,69,294070
8439,0.06091,172.31.40.0-255,66,231742,69,294070
8440,0.062223,74.125.200.0-255,2902,234644,69,294070
8441,0.062229,172.31.40.0-255,66,234710,69,294070
8442,0.063645,74.125.200.0-255,2902,237612,69,294070
8443,0.063652,172.31.40.0-255,66,237678,69,294070
8444,0.064964,74.125.200.0-255,2902,240580,69,294070
8445,0.064971,172.31.40.0-255,66,240646,69,294070
8446,0.066395,74.125.200.0-255,2902,243548,69,294070
8447,0.0664,172.31.40.0-255,66,243614,69,294070
8448,0.067721,74.125.200.0-255,2902,246516,69,294070
8449,0.067728,172.31.40.0-255,66,246582,69,294070
8450,0.069143,74.125.200.0-255,2902,249484,69,294070
8451,0.06915,172.31.40.0-255,66,249550,69,294070
8452,0.070459,74.125.200.0-255,2902,252452,69,294070
8453,0.070466,172.31.40.0-255,66,252518,69,294070
8454,0.071883,74.125.200.0-255,2902,255420,69,294070
8455,0.07189,172.31.40.0-255,66,255486,69,294070
8456,0.073191,74.125.200.0-255,2902,258388,69,294070
8457,0.073198,172.31.40.0-255,66,258454,69,294070
8458,0.074609,74.125.200.0-255,2902,261356,69,294070
8459,0.074616,172.31.40.0-255,66,261422,69,294070
8460,0.075917,74.125.200.0-255,2902,264324,69,294070
8461,0.075923,172.31.40.0-255,66,264390,69,294070
8462,0.077333,74.125.200.0-255,2902,267292,69,294070
8463,0.077468,172.31.40.0-255,66,267358,69,294070
8464,0.07865,74.125.200.0-255,2902,270260,69,294070
8465,0.078657,172.31.40.0-255,66,270326,69,294070
8466,0.080202,74.125.200.0-255,2902,273228,69,294070
8467,0.080208,172.31.40.0-255,66,273294,69,294070
8468,0.081387,74.125.200.0-255,2902,276196,69,294070
8469,0.081394,172.31.40.0-255,66,276262,69,294070
8470,0.082943,74.125.200.0-255,2902,279164,69,294070
8471,0.08295,172.31.40.0-255,66,279230,69,294070
8472,0.084153,74.125.200.0-255,2902,282132,69,294070
8473,0.08416,172.31.40.0-255,66,282198,69,294070
8474,0.085672,74.125.200.0-255,2902,285100,69,294070
8475,0.085679,172.31.40.0-255,66,285166,69,294070
8476,0.086885,74.125.200.0-255,2902,288068,69,294070
8477,0.086892,172.31.40.0-255,66,288134,69,294070
8478,0.088412,74.125.200.0-255,2902,291036,69,294070
8479,0.088419,172.31.40.0-255,66,291102,69,294070
8480,0.089613,74.125.200.0-255,2902,294004,69,294070
8481,0.089619,172.31.40.0-255,66,294070,69,294070
8482,0.0,172.31.40.0-255,105,105,69,276
8483,0.067486,31.13.82.0-255,105,210,69,276
8484,0.067508,172.31.40.0-255,66,276,69,276
8485,0.0,74.125.200.0-255,152,152,69,369063
8486,2e-05,172.31.40.0-255,66,218,69,369063
8487,2.7e-05,74.125.200.0-255,1484,1702,69,369063
8488,3.1e-05,172.31.40.0-255,66,1768,69,369063
8489,3.8e-05,74.125.200.0-255,2902,4670,69,369063
8490,4.1e-05,172.31.40.0-255,66,4736,69,369063
8491,7.4e-05,74.125.200.0-255,7156,11892,69,369063
8492,7.6e-05,172.31.40.0-255,66,11958,69,369063
8493,8e-05,74.125.200.0-255,2055,14013,69,369063
8494,8.2e-05,172.31.40.0-255,66,14079,69,369063
8495,0.000118,74.125.200.0-255,2902,16981,69,369063
8496,0.000121,172.31.40.0-255,66,17047,69,369063
8497,0.000143,74.125.200.0-255,4320,21367,69,369063
8498,0.000145,172.31.40.0-255,66,21433,69,369063
8499,0.000148,74.125.200.0-255,1484,22917,69,369063
8500,0.000151,172.31.40.0-255,66,22983,69,369063
8501,0.000174,74.125.200.0-255,7156,30139,69,369063
8502,0.000176,172.31.40.0-255,66,30205,69,369063
8503,0.00018,74.125.200.0-255,1125,31330,69,369063
8504,0.000182,172.31.40.0-255,66,31396,69,369063
8505,0.000319,74.125.200.0-255,1484,32880,69,369063
8506,0.000322,172.31.40.0-255,66,32946,69,369063
8507,0.000328,74.125.200.0-255,2902,35848,69,369063
8508,0.000331,172.31.40.0-255,66,35914,69,369063
8509,0.000342,74.125.200.0-255,2902,38816,69,369063
8510,0.000344,172.31.40.0-255,66,38882,69,369063
8511,0.000367,74.125.200.0-255,2902,41784,69,369063
8512,0.00037,172.31.40.0-255,66,41850,69,369063
8513,0.000375,74.125.200.0-255,4320,46170,69,369063
8514,0.000376,172.31.40.0-255,66,46236,69,369063
8515,0.0004,74.125.200.0-255,4320,50556,69,369063
8516,0.000402,172.31.40.0-255,66,50622,69,369063
8517,0.000418,74.125.200.0-255,1125,51747,69,369063
8518,0.000422,74.125.200.0-255,1484,53231,69,369063
8519,0.000424,172.31.40.0-255,66,53297,69,369063
8520,0.000452,172.31.40.0-255,66,53363,69,369063
8521,0.000475,74.125.200.0-255,4315,57678,69,369063
8522,0.000477,172.31.40.0-255,66,57744,69,369063
8523,0.000494,74.125.200.0-255,332,58076,69,369063
8524,0.000788,74.125.200.0-255,1484,59560,69,369063
8525,0.000792,172.31.40.0-255,66,59626,69,369063
8526,0.000797,74.125.200.0-255,2902,62528,69,369063
8527,0.000799,172.31.40.0-255,66,62594,69,369063
8528,0.00081,74.125.200.0-255,1484,64078,69,369063
8529,0.000819,74.125.200.0-255,1484,65562,69,369063
8530,0.000821,172.31.40.0-255,66,65628,69,369063
8531,0.000834,74.125.200.0-255,2902,68530,69,369063
8532,0.000836,172.31.40.0-255,66,68596,69,369063
8533,0.000839,74.125.200.0-255,1484,70080,69,369063
8534,0.000841,74.125.200.0-255,1484,71564,69,369063
8535,0.000843,172.31.40.0-255,66,71630,69,369063
8536,0.000871,74.125.200.0-255,7156,78786,69,369063
8537,0.000873,172.31.40.0-255,66,78852,69,369063
8538,0.000903,172.31.40.0-255,66,78918,69,369063
8539,0.001064,74.125.200.0-255,1484,80402,69,369063
8540,0.001068,74.125.200.0-255,1484,81886,69,369063
8541,0.001071,172.31.40.0-255,66,81952,69,369063
8542,0.001091,74.125.200.0-255,1484,83436,69,369063
8543,0.001096,74.125.200.0-255,4320,87756,69,369063
8544,0.001098,172.31.40.0-255,66,87822,69,369063
8545,0.001119,74.125.200.0-255,5738,93560,69,369063
8546,0.001121,172.31.40.0-255,66,93626,69,369063
8547,0.001135,74.125.200.0-255,2902,96528,69,369063
8548,0.001138,172.31.40.0-255,66,96594,69,369063
8549,0.001143,74.125.200.0-255,5738,102332,69,369063
8550,0.001145,172.31.40.0-255,66,102398,69,369063
8551,0.001149,74.125.200.0-255,2902,105300,69,369063
8552,0.001151,172.31.40.0-255,66,105366,69,369063
8553,0.001173,74.125.200.0-255,4320,109686,69,369063
8554,0.001176,172.31.40.0-255,66,109752,69,369063
8555,0.001219,74.125.200.0-255,3602,113354,69,369063
8556,0.001222,172.31.40.0-255,66,113420,69,369063
8557,0.001239,74.125.200.0-255,1484,114904,69,369063
8558,0.00126,74.125.200.0-255,2902,117806,69,369063
8559,0.001264,172.31.40.0-255,66,117872,69,369063
8560,0.00129,74.125.200.0-255,5738,123610,69,369063
8561,0.001293,172.31.40.0-255,66,123676,69,369063
8562,0.001315,74.125.200.0-255,5738,129414,69,369063
8563,0.001319,172.31.40.0-255,66,129480,69,369063
8564,0.001333,74.125.200.0-255,1484,130964,69,369063
8565,0.001339,74.125.200.0-255,4320,135284,69,369063
8566,0.001342,172.31.40.0-255,66,135350,69,369063
8567,0.001363,74.125.200.0-255,1484,136834,69,369063
8568,0.001369,74.125.200.0-255,4320,141154,69,369063
8569,0.001372,172.31.40.0-255,66,141220,69,369063
8570,0.001393,74.125.200.0-255,2902,144122,69,369063
8571,0.001396,172.31.40.0-255,66,144188,69,369063
8572,0.0014,74.125.200.0-255,2902,147090,69,369063
8573,0.001402,172.31.40.0-255,66,147156,69,369063
8574,0.001415,74.125.200.0-255,766,147922,69,369063
8575,0.002035,172.31.40.0-255,66,147988,69,369063
8576,0.002168,74.125.200.0-255,1484,149472,69,369063
8577,0.002177,74.125.200.0-255,2902,152374,69,369063
8578,0.002181,172.31.40.0-255,66,152440,69,369063
8579,0.002185,74.125.200.0-255,1484,153924,69,369063
8580,0.002202,74.125.200.0-255,2902,156826,69,369063
8581,0.002204,172.31.40.0-255,66,156892,69,369063
8582,0.002207,74.125.200.0-255,1484,158376,69,369063
8583,0.002223,74.125.200.0-255,4320,162696,69,369063
8584,0.002225,172.31.40.0-255,66,162762,69,369063
8585,0.002245,74.125.200.0-255,5738,168500,69,369063
8586,0.002247,172.31.40.0-255,66,168566,69,369063
8587,0.002276,74.125.200.0-255,4320,172886,69,369063
8588,0.002278,172.31.40.0-255,66,172952,69,369063
8589,0.002297,74.125.200.0-255,5738,178690,69,369063
8590,0.002299,172.31.40.0-255,66,178756,69,369063
8591,0.002321,74.125.200.0-255,3602,182358,69,369063
8592,0.002324,172.31.40.0-255,66,182424,69,369063
8593,0.002378,74.125.200.0-255,1484,183908,69,369063
8594,0.002394,74.125.200.0-255,1484,185392,69,369063
8595,0.002397,172.31.40.0-255,66,185458,69,369063
8596,0.002402,74.125.200.0-255,2902,188360,69,369063
8597,0.002404,172.31.40.0-255,66,188426,69,369063
8598,0.002424,74.125.200.0-255,2902,191328,69,369063
8599,0.002426,172.31.40.0-255,66,191394,69,369063
8600,0.002445,74.125.200.0-255,5738,197132,69,369063
8601,0.002447,172.31.40.0-255,66,197198,69,369063
8602,0.002464,74.125.200.0-255,1484,198682,69,369063
8603,0.00249,74.125.200.0-255,7156,205838,69,369063
8604,0.002493,172.31.40.0-255,66,205904,69,369063
8605,0.002498,74.125.200.0-255,2902,208806,69,369063
8606,0.0025,172.31.40.0-255,66,208872,69,369063
8607,0.002503,74.125.200.0-255,1484,210356,69,369063
8608,0.002506,74.125.200.0-255,1484,211840,69,369063
8609,0.002508,172.31.40.0-255,66,211906,69,369063
8610,0.00253,74.125.200.0-255,5020,216926,69,369063
8611,0.002533,172.31.40.0-255,66,216992,69,369063
8612,0.002539,74.125.200.0-255,5738,222730,69,369063
8613,0.002541,172.31.40.0-255,66,222796,69,369063
8614,0.002544,74.125.200.0-255,1484,224280,69,369063
8615,0.002565,74.125.200.0-255,1484,225764,69,369063
8616,0.002567,172.31.40.0-255,66,225830,69,369063
8617,0.002604,74.125.200.0-255,1484,227314,69,369063
8618,0.002614,74.125.200.0-255,5738,233052,69,369063
8619,0.002617,172.31.40.0-255,66,233118,69,369063
8620,0.002623,74.125.200.0-255,4320,237438,69,369063
8621,0.002625,172.31.40.0-255,66,237504,69,369063
8622,0.002631,74.125.200.0-255,5738,243242,69,369063
8623,0.002633,172.31.40.0-255,66,243308,69,369063
8624,0.002668,172.31.40.0-255,66,243374,69,369063
8625,0.002723,74.125.200.0-255,1484,244858,69,369063
8626,0.00273,74.125.200.0-255,2902,247760,69,369063
8627,0.002733,172.31.40.0-255,66,247826,69,369063
8628,0.002754,74.125.200.0-255,2902,250728,69,369063
8629,0.002757,172.31.40.0-255,66,250794,69,369063
8630,0.002761,74.125.200.0-255,1484,252278,69,369063
8631,0.002781,74.125.200.0-255,2902,255180,69,369063
8632,0.002784,172.31.40.0-255,66,255246,69,369063
8633,0.002787,74.125.200.0-255,1484,256730,69,369063
8634,0.002802,74.125.200.0-255,1484,258214,69,369063
8635,0.002804,172.31.40.0-255,66,258280,69,369063
8636,0.002822,74.125.200.0-255,1484,259764,69,369063
8637,0.00286,74.125.200.0-255,4320,264084,69,369063
8638,0.002865,172.31.40.0-255,66,264150,69,369063
8639,0.002868,74.125.200.0-255,1484,265634,69,369063
8640,0.002873,74.125.200.0-255,2902,268536,69,369063
8641,0.002876,172.31.40.0-255,66,268602,69,369063
8642,0.00288,74.125.200.0-255,4320,272922,69,369063
8643,0.002883,172.31.40.0-255,66,272988,69,369063
8644,0.002889,74.125.200.0-255,5020,278008,69,369063
8645,0.002891,172.31.40.0-255,66,278074,69,369063
8646,0.002955,74.125.200.0-255,1484,279558,69,369063
8647,0.002969,74.125.200.0-255,2902,282460,69,369063
8648,0.002972,172.31.40.0-255,66,282526,69,369063
8649,0.002976,74.125.200.0-255,1484,284010,69,369063
8650,0.002995,74.125.200.0-255,4320,288330,69,369063
8651,0.00303,74.125.200.0-255,4320,292650,69,369063
8652,0.003044,74.125.200.0-255,2902,295552,69,369063
8653,0.003112,74.125.200.0-255,4320,299872,69,369063
8654,0.003129,74.125.200.0-255,7156,307028,69,369063
8655,0.003167,74.125.200.0-255,2902,309930,69,369063
8656,0.00317,74.125.200.0-255,766,310696,69,369063
8657,0.003204,74.125.200.0-255,5738,316434,69,369063
8658,0.003207,74.125.200.0-255,1484,317918,69,369063
8659,0.003217,74.125.200.0-255,1484,319402,69,369063
8660,0.003246,74.125.200.0-255,4320,323722,69,369063
8661,0.003267,74.125.200.0-255,7156,330878,69,369063
8662,0.003284,74.125.200.0-255,7156,338034,69,369063
8663,0.003306,74.125.200.0-255,5738,343772,69,369063
8664,0.00331,74.125.200.0-255,2184,345956,69,369063
8665,0.003323,74.125.200.0-255,2902,348858,69,369063
8666,0.003348,74.125.200.0-255,7156,356014,69,369063
8667,0.003362,74.125.200.0-255,3664,359678,69,369063
8668,0.003411,74.125.200.0-255,105,359783,69,369063
8669,0.006001,172.31.40.0-255,66,359849,69,369063
8670,0.007747,172.31.40.0-255,105,359954,69,369063
8671,0.010088,74.125.200.0-255,66,360020,69,369063
8672,0.036591,172.31.40.0-255,172,360192,69,369063
8673,0.036626,172.31.40.0-255,1116,361308,69,369063
8674,0.036711,172.31.40.0-255,1514,362822,69,369063
8675,0.036714,172.31.40.0-255,1514,364336,69,369063
8676,0.036715,172.31.40.0-255,1514,365850,69,369063
8677,0.036716,172.31.40.0-255,1514,367364,69,369063
8678,0.036746,172.31.40.0-255,1501,368865,69,369063
8679,0.038194,104.244.42.0-255,66,368931,69,369063
8680,0.038225,104.244.42.0-255,66,368997,69,369063
8681,0.038368,104.244.42.0-255,66,369063,69,369063
8682,0.0,74.125.24.0-255,150,150,69,313805
8683,2.4e-05,172.31.40.0-255,66,216,69,313805
8684,3.1e-05,74.125.24.0-255,1484,1700,69,313805
8685,3.5e-05,172.31.40.0-255,66,1766,69,313805
8686,4.1e-05,74.125.24.0-255,2902,4668,69,313805
8687,4.4e-05,172.31.40.0-255,66,4734,69,313805
8688,5.3e-05,74.125.24.0-255,7156,11890,69,313805
8689,5.6e-05,172.31.40.0-255,66,11956,69,313805
8690,6.7e-05,172.31.40.0-255,66,12022,69,313805
8691,0.000107,172.31.40.0-255,66,12088,69,313805
8692,0.000144,74.125.24.0-255,1484,13572,69,313805
8693,0.000146,172.31.40.0-255,66,13638,69,313805
8694,0.000167,74.125.24.0-255,2902,16540,69,313805
8695,0.000169,172.31.40.0-255,66,16606,69,313805
8696,0.000175,74.125.24.0-255,5738,22344,69,313805
8697,0.000177,172.31.40.0-255,66,22410,69,313805
8698,0.000197,172.31.40.0-255,66,22476,69,313805
8699,0.000244,172.31.40.0-255,66,22542,69,313805
8700,0.000478,74.125.24.0-255,132,22674,69,313805
8701,0.000484,172.31.40.0-255,66,22740,69,313805
8702,0.000586,74.125.24.0-255,1484,24224,69,313805
8703,0.00059,172.31.40.0-255,66,24290,69,313805
8704,0.000596,74.125.24.0-255,2902,27192,69,313805
8705,0.000598,172.31.40.0-255,66,27258,69,313805
8706,0.00061,74.125.24.0-255,1484,28742,69,313805
8707,0.000612,172.31.40.0-255,66,28808,69,313805
8708,0.000635,74.125.24.0-255,4320,33128,69,313805
8709,0.000639,172.31.40.0-255,66,33194,69,313805
8710,0.000659,74.125.24.0-255,6797,39991,69,313805
8711,0.000662,172.31.40.0-255,66,40057,69,313805
8712,0.000669,74.125.24.0-255,7156,47213,69,313805
8713,0.000671,172.31.40.0-255,66,47279,69,313805
8714,0.000702,74.125.24.0-255,4320,51599,69,313805
8715,0.000705,172.31.40.0-255,66,51665,69,313805
8716,0.000728,74.125.24.0-255,5379,57044,69,313805
8717,0.000733,172.31.40.0-255,66,57110,69,313805
8718,0.001978,74.125.24.0-255,1484,58594,69,313805
8719,0.00199,74.125.24.0-255,2902,61496,69,313805
8720,0.001995,172.31.40.0-255,66,61562,69,313805
8721,0.002004,74.125.24.0-255,5738,67300,69,313805
8722,0.002006,172.31.40.0-255,66,67366,69,313805
8723,0.002034,172.31.40.0-255,66,67432,69,313805
8724,0.002077,74.125.24.0-255,4320,71752,69,313805
8725,0.002079,172.31.40.0-255,66,71818,69,313805
8726,0.002104,74.125.24.0-255,6438,78256,69,313805
8727,0.002107,172.31.40.0-255,66,78322,69,313805
8728,0.004378,74.125.24.0-255,5738,84060,69,313805
8729,0.004381,172.31.40.0-255,66,84126,69,313805
8730,0.006641,74.125.24.0-255,5738,89864,69,313805
8731,0.006646,172.31.40.0-255,66,89930,69,313805
8732,0.008877,74.125.24.0-255,5738,95668,69,313805
8733,0.008888,172.31.40.0-255,66,95734,69,313805
8734,0.011113,74.125.24.0-255,5738,101472,69,313805
8735,0.011128,172.31.40.0-255,66,101538,69,313805
8736,0.013351,74.125.24.0-255,5738,107276,69,313805
8737,0.013363,172.31.40.0-255,66,107342,69,313805
8738,0.015625,74.125.24.0-255,5738,113080,69,313805
8739,0.015639,172.31.40.0-255,66,113146,69,313805
8740,0.017866,74.125.24.0-255,5738,118884,69,313805
8741,0.017877,172.31.40.0-255,66,118950,69,313805
8742,0.020089,74.125.24.0-255,5738,124688,69,313805
8743,0.020098,172.31.40.0-255,66,124754,69,313805
8744,0.022337,74.125.24.0-255,5738,130492,69,313805
8745,0.022345,172.31.40.0-255,66,130558,69,313805
8746,0.024608,74.125.24.0-255,5738,136296,69,313805
8747,0.024618,172.31.40.0-255,66,136362,69,313805
8748,0.026853,74.125.24.0-255,5738,142100,69,313805
8749,0.026866,172.31.40.0-255,66,142166,69,313805
8750,0.029097,74.125.24.0-255,5738,147904,69,313805
8751,0.029109,172.31.40.0-255,66,147970,69,313805
8752,0.031326,74.125.24.0-255,5738,153708,69,313805
8753,0.031335,172.31.40.0-255,66,153774,69,313805
8754,0.032585,172.31.40.0-255,192,153966,69,313805
8755,0.032617,172.31.40.0-255,1116,155082,69,313805
8756,0.032692,172.31.40.0-255,1514,156596,69,313805
8757,0.032694,172.31.40.0-255,1514,158110,69,313805
8758,0.032699,172.31.40.0-255,1514,159624,69,313805
8759,0.032701,172.31.40.0-255,1514,161138,69,313805
8760,0.03272,172.31.40.0-255,1499,162637,69,313805
8761,0.033568,74.125.24.0-255,5738,168375,69,313805
8762,0.033576,172.31.40.0-255,66,168441,69,313805
8763,0.034169,104.244.42.0-255,66,168507,69,313805
8764,0.034178,104.244.42.0-255,66,168573,69,313805
8765,0.034298,104.244.42.0-255,66,168639,69,313805
8766,0.034339,104.244.42.0-255,66,168705,69,313805
8767,0.035807,74.125.24.0-255,5738,174443,69,313805
8768,0.035815,172.31.40.0-255,66,174509,69,313805
8769,0.038035,74.125.24.0-255,5738,180247,69,313805
8770,0.038043,172.31.40.0-255,66,180313,69,313805
8771,0.040281,74.125.24.0-255,5738,186051,69,313805
8772,0.040289,172.31.40.0-255,66,186117,69,313805
8773,0.042551,74.125.24.0-255,5738,191855,69,313805
8774,0.04256,172.31.40.0-255,66,191921,69,313805
8775,0.044787,74.125.24.0-255,5738,197659,69,313805
8776,0.044795,172.31.40.0-255,66,197725,69,313805
8777,0.047024,74.125.24.0-255,5738,203463,69,313805
8778,0.047031,172.31.40.0-255,66,203529,69,313805
8779,0.049267,74.125.24.0-255,5738,209267,69,313805
8780,0.049273,172.31.40.0-255,66,209333,69,313805
8781,0.051524,74.125.24.0-255,5738,215071,69,313805
8782,0.051531,172.31.40.0-255,66,215137,69,313805
8783,0.05379,74.125.24.0-255,5738,220875,69,313805
8784,0.053797,172.31.40.0-255,66,220941,69,313805
8785,0.056023,74.125.24.0-255,5738,226679,69,313805
8786,0.05603,172.31.40.0-255,66,226745,69,313805
8787,0.058251,74.125.24.0-255,5738,232483,69,313805
8788,0.058258,172.31.40.0-255,66,232549,69,313805
8789,0.060478,74.125.24.0-255,5738,238287,69,313805
8790,0.060488,172.31.40.0-255,66,238353,69,313805
8791,0.062719,74.125.24.0-255,5738,244091,69,313805
8792,0.062727,172.31.40.0-255,66,244157,69,313805
8793,0.064963,74.125.24.0-255,5738,249895,69,313805
8794,0.064969,172.31.40.0-255,66,249961,69,313805
8795,0.067214,74.125.24.0-255,5738,255699,69,313805
8796,0.067222,172.31.40.0-255,66,255765,69,313805
8797,0.069478,74.125.24.0-255,5738,261503,69,313805
8798,0.069485,172.31.40.0-255,66,261569,69,313805
8799,0.071698,74.125.24.0-255,5738,267307,69,313805
8800,0.071705,172.31.40.0-255,66,267373,69,313805
8801,0.073945,74.125.24.0-255,5738,273111,69,313805
8802,0.073951,172.31.40.0-255,66,273177,69,313805
8803,0.076197,74.125.24.0-255,5738,278915,69,313805
8804,0.076204,172.31.40.0-255,66,278981,69,313805
8805,0.078484,74.125.24.0-255,5738,284719,69,313805
8806,0.078491,172.31.40.0-255,66,284785,69,313805
8807,0.080759,74.125.24.0-255,5738,290523,69,313805
8808,0.080766,172.31.40.0-255,66,290589,69,313805
8809,0.082997,74.125.24.0-255,5738,296327,69,313805
8810,0.083004,172.31.40.0-255,66,296393,69,313805
8811,0.085239,74.125.24.0-255,5738,302131,69,313805
8812,0.085245,172.31.40.0-255,66,302197,69,313805
8813,0.08748,74.125.24.0-255,5738,307935,69,313805
8814,0.087488,172.31.40.0-255,66,308001,69,313805
8815,0.089729,74.125.24.0-255,5738,313739,69,313805
8816,0.089736,172.31.40.0-255,66,313805,69,313805
8817,0.0,74.125.24.0-255,152,152,69,344984
8818,1.3e-05,172.31.40.0-255,66,218,69,344984
8819,1.9e-05,74.125.24.0-255,1484,1702,69,344984
8820,2.3e-05,172.31.40.0-255,66,1768,69,344984
8821,2.8e-05,74.125.24.0-255,2902,4670,69,344984
8822,3.1e-05,172.31.40.0-255,66,4736,69,344984
8823,3.6e-05,74.125.24.0-255,4320,9056,69,344984
8824,3.9e-05,172.31.40.0-255,66,9122,69,344984
8825,6.1e-05,74.125.24.0-255,2902,12024,69,344984
8826,6.3e-05,172.31.40.0-255,66,12090,69,344984
8827,8.4e-05,74.125.24.0-255,4320,16410,69,344984
8828,8.6e-05,172.31.40.0-255,66,16476,69,344984
8829,0.000108,74.125.24.0-255,6344,22820,69,344984
8830,0.00011,172.31.40.0-255,66,22886,69,344984
8831,0.000122,74.125.24.0-255,4320,27206,69,344984
8832,0.000124,172.31.40.0-255,66,27272,69,344984
8833,0.000142,74.125.24.0-255,3961,31233,69,344984
8834,0.000144,172.31.40.0-255,66,31299,69,344984
8835,0.000191,74.125.24.0-255,1484,32783,69,344984
8836,0.000194,172.31.40.0-255,66,32849,69,344984
8837,0.000198,74.125.24.0-255,2902,35751,69,344984
8838,0.000201,172.31.40.0-255,66,35817,69,344984
8839,0.000213,74.125.24.0-255,1484,37301,69,344984
8840,0.000215,172.31.40.0-255,66,37367,69,344984
8841,0.00023,74.125.24.0-255,4320,41687,69,344984
8842,0.000232,172.31.40.0-255,66,41753,69,344984
8843,0.000237,74.125.24.0-255,4320,46073,69,344984
8844,0.000239,172.31.40.0-255,66,46139,69,344984
8845,0.00026,74.125.24.0-255,1484,47623,69,344984
8846,0.000262,172.31.40.0-255,66,47689,69,344984
8847,0.000265,74.125.24.0-255,1125,48814,69,344984
8848,0.000267,172.31.40.0-255,66,48880,69,344984
8849,0.000841,74.125.24.0-255,1484,50364,69,344984
8850,0.00085,74.125.24.0-255,2902,53266,69,344984
8851,0.000854,172.31.40.0-255,66,53332,69,344984
8852,0.000858,74.125.24.0-255,1484,54816,69,344984
8853,0.000878,74.125.24.0-255,4320,59136,69,344984
8854,0.000881,172.31.40.0-255,66,59202,69,344984
8855,0.000887,74.125.24.0-255,6797,65999,69,344984
8856,0.00089,172.31.40.0-255,66,66065,69,344984
8857,0.001638,74.125.24.0-255,1484,67549,69,344984
8858,0.001654,74.125.24.0-255,2902,70451,69,344984
8859,0.001658,172.31.40.0-255,66,70517,69,344984
8860,0.001676,74.125.24.0-255,4320,74837,69,344984
8861,0.001679,172.31.40.0-255,66,74903,69,344984
8862,0.001689,74.125.24.0-255,1484,76387,69,344984
8863,0.001695,74.125.24.0-255,5738,82125,69,344984
8864,0.001697,172.31.40.0-255,66,82191,69,344984
8865,0.001724,74.125.24.0-255,7156,89347,69,344984
8866,0.001727,172.31.40.0-255,66,89413,69,344984
8867,0.001731,74.125.24.0-255,4320,93733,69,344984
8868,0.001733,172.31.40.0-255,66,93799,69,344984
8869,0.001767,74.125.24.0-255,2902,96701,69,344984
8870,0.001769,172.31.40.0-255,66,96767,69,344984
8871,0.001789,74.125.24.0-255,3602,100369,69,344984
8872,0.001791,172.31.40.0-255,66,100435,69,344984
8873,0.002562,74.125.24.0-255,1484,101919,69,344984
8874,0.002582,74.125.24.0-255,1484,103403,69,344984
8875,0.002584,172.31.40.0-255,66,103469,69,344984
8876,0.002594,74.125.24.0-255,1484,104953,69,344984
8877,0.002608,74.125.24.0-255,5738,110691,69,344984
8878,0.00261,172.31.40.0-255,66,110757,69,344984
8879,0.002621,74.125.24.0-255,2902,113659,69,344984
8880,0.002623,172.31.40.0-255,66,113725,69,344984
8881,0.002635,74.125.24.0-255,4320,118045,69,344984
8882,0.002637,172.31.40.0-255,66,118111,69,344984
8883,0.002657,74.125.24.0-255,2902,121013,69,344984
8884,0.00266,172.31.40.0-255,66,121079,69,344984
8885,0.002671,74.125.24.0-255,1484,122563,69,344984
8886,0.002683,74.125.24.0-255,1484,124047,69,344984
8887,0.002684,172.31.40.0-255,66,124113,69,344984
8888,0.002688,74.125.24.0-255,2902,127015,69,344984
8889,0.00269,172.31.40.0-255,66,127081,69,344984
8890,0.002705,74.125.24.0-255,2902,129983,69,344984
8891,0.002707,172.31.40.0-255,66,130049,69,344984
8892,0.002725,74.125.24.0-255,5020,135069,69,344984
8893,0.002727,172.31.40.0-255,66,135135,69,344984
8894,0.00275,74.125.24.0-255,4320,139455,69,344984
8895,0.002752,172.31.40.0-255,66,139521,69,344984
8896,0.002757,74.125.24.0-255,4320,143841,69,344984
8897,0.002759,172.31.40.0-255,66,143907,69,344984
8898,0.00277,74.125.24.0-255,1484,145391,69,344984
8899,0.002772,74.125.24.0-255,1484,146875,69,344984
8900,0.002774,172.31.40.0-255,66,146941,69,344984
8901,0.002791,74.125.24.0-255,4320,151261,69,344984
8902,0.002793,172.31.40.0-255,66,151327,69,344984
8903,0.002817,74.125.24.0-255,5738,157065,69,344984
8904,0.002819,172.31.40.0-255,66,157131,69,344984
8905,0.002822,74.125.24.0-255,1484,158615,69,344984
8906,0.00559,74.125.24.0-255,4320,162935,69,344984
8907,0.005598,172.31.40.0-255,66,163001,69,344984
8908,0.008343,74.125.24.0-255,4320,167321,69,344984
8909,0.008352,172.31.40.0-255,66,167387,69,344984
8910,0.008365,74.125.24.0-255,1484,168871,69,344984
8911,0.01106,74.125.24.0-255,4320,173191,69,344984
8912,0.01107,172.31.40.0-255,66,173257,69,344984
8913,0.013806,74.125.24.0-255,5738,178995,69,344984
8914,0.013815,172.31.40.0-255,66,179061,69,344984
8915,0.016553,74.125.24.0-255,5738,184799,69,344984
8916,0.016564,172.31.40.0-255,66,184865,69,344984
8917,0.019285,74.125.24.0-255,5738,190603,69,344984
8918,0.019294,172.31.40.0-255,66,190669,69,344984
8919,0.022024,74.125.24.0-255,5738,196407,69,344984
8920,0.022033,172.31.40.0-255,66,196473,69,344984
8921,0.02475,74.125.24.0-255,5738,202211,69,344984
8922,0.024759,172.31.40.0-255,66,202277,69,344984
8923,0.026961,172.31.40.0-255,172,202449,69,344984
8924,0.026992,172.31.40.0-255,1116,203565,69,344984
8925,0.027067,172.31.40.0-255,1514,205079,69,344984
8926,0.027069,172.31.40.0-255,1514,206593,69,344984
8927,0.027071,172.31.40.0-255,1514,208107,69,344984
8928,0.027072,172.31.40.0-255,1514,209621,69,344984
8929,0.0271,172.31.40.0-255,1499,211120,69,344984
8930,0.027477,74.125.24.0-255,5738,216858,69,344984
8931,0.027483,172.31.40.0-255,66,216924,69,344984
8932,0.028627,104.244.42.0-255,66,216990,69,344984
8933,0.028682,104.244.42.0-255,66,217056,69,344984
8934,0.028837,104.244.42.0-255,66,217122,69,344984
8935,0.029617,104.244.42.0-255,108,217230,69,344984
8936,0.029625,172.31.40.0-255,66,217296,69,344984
8937,0.03019,74.125.24.0-255,5738,223034,69,344984
8938,0.030195,172.31.40.0-255,66,223100,69,344984
8939,0.032962,74.125.24.0-255,5738,228838,69,344984
8940,0.032968,172.31.40.0-255,66,228904,69,344984
8941,0.035722,74.125.24.0-255,5738,234642,69,344984
8942,0.035729,172.31.40.0-255,66,234708,69,344984
8943,0.038508,74.125.24.0-255,5738,240446,69,344984
8944,0.038515,172.31.40.0-255,66,240512,69,344984
8945,0.041317,74.125.24.0-255,5738,246250,69,344984
8946,0.041324,172.31.40.0-255,66,246316,69,344984
8947,0.044061,74.125.24.0-255,5738,252054,69,344984
8948,0.044068,172.31.40.0-255,66,252120,69,344984
8949,0.046809,74.125.24.0-255,5738,257858,69,344984
8950,0.046818,172.31.40.0-255,66,257924,69,344984
8951,0.049558,74.125.24.0-255,5738,263662,69,344984
8952,0.049565,172.31.40.0-255,66,263728,69,344984
8953,0.052327,74.125.24.0-255,5738,269466,69,344984
8954,0.052334,172.31.40.0-255,66,269532,69,344984
8955,0.055048,74.125.24.0-255,5738,275270,69,344984
8956,0.055055,172.31.40.0-255,66,275336,69,344984
8957,0.057782,74.125.24.0-255,5738,281074,69,344984
8958,0.057788,172.31.40.0-255,66,281140,69,344984
8959,0.060611,74.125.24.0-255,5738,286878,69,344984
8960,0.060618,172.31.40.0-255,66,286944,69,344984
8961,0.0634,74.125.24.0-255,5738,292682,69,344984
8962,0.063405,172.31.40.0-255,66,292748,69,344984
8963,0.066147,74.125.24.0-255,5738,298486,69,344984
8964,0.066154,172.31.40.0-255,66,298552,69,344984
8965,0.068881,74.125.24.0-255,5738,304290,69,344984
8966,0.068887,172.31.40.0-255,66,304356,69,344984
8967,0.071596,74.125.24.0-255,5738,310094,69,344984
8968,0.071602,172.31.40.0-255,66,310160,69,344984
8969,0.074331,74.125.24.0-255,5738,315898,69,344984
8970,0.074337,172.31.40.0-255,66,315964,69,344984
8971,0.077079,74.125.24.0-255,5738,321702,69,344984
8972,0.077085,172.31.40.0-255,66,321768,69,344984
8973,0.079825,74.125.24.0-255,5738,327506,69,344984
8974,0.079831,172.31.40.0-255,66,327572,69,344984
8975,0.082573,74.125.24.0-255,5738,333310,69,344984
8976,0.082579,172.31.40.0-255,66,333376,69,344984
8977,0.085313,74.125.24.0-255,5738,339114,69,344984
8978,0.08532,172.31.40.0-255,66,339180,69,344984
8979,0.088069,74.125.24.0-255,5738,344918,69,344984
8980,0.088074,172.31.40.0-255,66,344984,69,344984
8981,0.0,74.125.200.0-255,153,153,69,373738
8982,1.9e-05,172.31.40.0-255,66,219,69,373738
8983,2.5e-05,74.125.200.0-255,1484,1703,69,373738
8984,2.9e-05,172.31.40.0-255,66,1769,69,373738
8985,3.4e-05,74.125.200.0-255,2902,4671,69,373738
8986,3.6e-05,172.31.40.0-255,66,4737,69,373738
8987,4.7e-05,74.125.200.0-255,4320,9057,69,373738
8988,5e-05,172.31.40.0-255,66,9123,69,373738
8989,8.5e-05,172.31.40.0-255,66,9189,69,373738
8990,9e-05,74.125.200.0-255,4320,13509,69,373738
8991,9.2e-05,172.31.40.0-255,66,13575,69,373738
8992,0.000132,74.125.200.0-255,7156,20731,69,373738
8993,0.000134,172.31.40.0-255,66,20797,69,373738
8994,0.000166,172.31.40.0-255,66,20863,69,373738
8995,0.00017,74.125.200.0-255,2902,23765,69,373738
8996,0.000172,172.31.40.0-255,66,23831,69,373738
8997,0.000176,74.125.200.0-255,4320,28151,69,373738
8998,0.000182,172.31.40.0-255,66,28217,69,373738
8999,0.000185,74.125.200.0-255,1484,29701,69,373738
9000,0.000189,172.31.40.0-255,66,29767,69,373738
9001,0.000203,74.125.200.0-255,766,30533,69,373738
9002,0.000205,172.31.40.0-255,66,30599,69,373738
9003,0.000596,74.125.200.0-255,1484,32083,69,373738
9004,0.000601,172.31.40.0-255,66,32149,69,373738
9005,0.000607,74.125.200.0-255,2902,35051,69,373738
9006,0.000609,172.31.40.0-255,66,35117,69,373738
9007,0.000653,74.125.200.0-255,5738,40855,69,373738
9008,0.000657,172.31.40.0-255,66,40921,69,373738
9009,0.000664,74.125.200.0-255,1484,42405,69,373738
9010,0.000666,172.31.40.0-255,66,42471,69,373738
9011,0.00067,74.125.200.0-255,2902,45373,69,373738
9012,0.000679,172.31.40.0-255,66,45439,69,373738
9013,0.000699,74.125.200.0-255,2899,48338,69,373738
9014,0.000719,172.31.40.0-255,66,48404,69,373738
9015,0.000811,74.125.200.0-255,1484,49888,69,373738
9016,0.000816,74.125.200.0-255,1484,51372,69,373738
9017,0.000828,74.125.200.0-255,1484,52856,69,373738
9018,0.000842,74.125.200.0-255,2902,55758,69,373738
9019,0.000859,74.125.200.0-255,2902,58660,69,373738
9020,0.000867,74.125.200.0-255,7156,65816,69,373738
9021,0.000879,172.31.40.0-255,66,65882,69,373738
9022,0.000933,172.31.40.0-255,66,65948,69,373738
9023,0.000941,74.125.200.0-255,2184,68132,69,373738
9024,0.000958,172.31.40.0-255,66,68198,69,373738
9025,0.001038,74.125.200.0-255,1484,69682,69,373738
9026,0.001062,74.125.200.0-255,2902,72584,69,373738
9027,0.001066,172.31.40.0-255,66,72650,69,373738
9028,0.001072,74.125.200.0-255,5738,78388,69,373738
9029,0.00109,74.125.200.0-255,2902,81290,69,373738
9030,0.001097,172.31.40.0-255,66,81356,69,373738
9031,0.001108,74.125.200.0-255,5063,86419,69,373738
9032,0.001113,74.125.200.0-255,5738,92157,69,373738
9033,0.001132,74.125.200.0-255,2902,95059,69,373738
9034,0.001136,172.31.40.0-255,66,95125,69,373738
9035,0.001146,74.125.200.0-255,2902,98027,69,373738
9036,0.001187,172.31.40.0-255,66,98093,69,373738
9037,0.001198,74.125.200.0-255,2902,100995,69,373738
9038,0.001223,74.125.200.0-255,6438,107433,69,373738
9039,0.00127,74.125.200.0-255,1484,108917,69,373738
9040,0.001274,74.125.200.0-255,2902,111819,69,373738
9041,0.001279,74.125.200.0-255,5738,117557,69,373738
9042,0.001282,172.31.40.0-255,66,117623,69,373738
9043,0.001288,172.31.40.0-255,66,117689,69,373738
9044,0.001342,172.31.40.0-255,66,117755,69,373738
9045,0.001355,74.125.200.0-255,5738,123493,69,373738
9046,0.001359,172.31.40.0-255,66,123559,69,373738
9047,0.00138,74.125.200.0-255,5020,128579,69,373738
9048,0.001402,172.31.40.0-255,66,128645,69,373738
9049,0.00146,74.125.200.0-255,1484,130129,69,373738
9050,0.001466,74.125.200.0-255,2902,133031,69,373738
9051,0.001486,74.125.200.0-255,4320,137351,69,373738
9052,0.001491,172.31.40.0-255,66,137417,69,373738
9053,0.001505,74.125.200.0-255,1484,138901,69,373738
9054,0.001516,74.125.200.0-255,5738,144639,69,373738
9055,0.001521,74.125.200.0-255,4320,148959,69,373738
9056,0.001533,74.125.200.0-255,2902,151861,69,373738
9057,0.001554,74.125.200.0-255,4320,156181,69,373738
9058,0.001558,172.31.40.0-255,66,156247,69,373738
9059,0.00157,74.125.200.0-255,6438,162685,69,373738
9060,0.00158,172.31.40.0-255,66,162751,69,373738
9061,0.001722,74.125.200.0-255,1484,164235,69,373738
9062,0.001754,74.125.200.0-255,1484,165719,69,373738
9063,0.001767,172.31.40.0-255,66,165785,69,373738
9064,0.001792,74.125.200.0-255,2902,168687,69,373738
9065,0.001797,172.31.40.0-255,66,168753,69,373738
9066,0.001825,74.125.200.0-255,4320,173073,69,373738
9067,0.001844,172.31.40.0-255,66,173139,69,373738
9068,0.001847,74.125.200.0-255,1484,174623,69,373738
9069,0.001849,74.125.200.0-255,1484,176107,69,373738
9070,0.001851,74.125.200.0-255,1484,177591,69,373738
9071,0.00187,74.125.200.0-255,7156,184747,69,373738
9072,0.001873,74.125.200.0-255,1484,186231,69,373738
9073,0.001876,172.31.40.0-255,66,186297,69,373738
9074,0.0019,74.125.200.0-255,7156,193453,69,373738
9075,0.001929,74.125.200.0-255,3602,197055,69,373738
9076,0.002242,74.125.200.0-255,1484,198539,69,373738
9077,0.002249,74.125.200.0-255,2902,201441,69,373738
9078,0.002262,74.125.200.0-255,1484,202925,69,373738
9079,0.002265,74.125.200.0-255,1484,204409,69,373738
9080,0.002282,74.125.200.0-255,1484,205893,69,373738
9081,0.002295,74.125.200.0-255,2902,208795,69,373738
9082,0.00231,74.125.200.0-255,2902,211697,69,373738
9083,0.002313,74.125.200.0-255,1484,213181,69,373738
9084,0.002343,74.125.200.0-255,1484,214665,69,373738
9085,0.006342,172.31.40.0-255,66,214731,69,373738
9086,0.008671,74.125.200.0-255,5738,220469,69,373738
9087,0.008678,172.31.40.0-255,66,220535,69,373738
9088,0.010982,74.125.200.0-255,5738,226273,69,373738
9089,0.010988,172.31.40.0-255,66,226339,69,373738
9090,0.013308,74.125.200.0-255,5738,232077,69,373738
9091,0.017636,172.31.40.0-255,66,232143,69,373738
9092,0.019958,74.125.200.0-255,5738,237881,69,373738
9093,0.01997,172.31.40.0-255,66,237947,69,373738
9094,0.022276,74.125.200.0-255,5738,243685,69,373738
9095,0.022283,172.31.40.0-255,66,243751,69,373738
9096,0.024589,74.125.200.0-255,5738,249489,69,373738
9097,0.024596,172.31.40.0-255,66,249555,69,373738
9098,0.026905,74.125.200.0-255,5738,255293,69,373738
9099,0.026912,172.31.40.0-255,66,255359,69,373738
9100,0.029223,74.125.200.0-255,5738,261097,69,373738
9101,0.029229,172.31.40.0-255,66,261163,69,373738
9102,0.031547,74.125.200.0-255,5738,266901,69,373738
9103,0.031555,172.31.40.0-255,66,266967,69,373738
9104,0.033377,172.31.40.0-255,172,267139,69,373738
9105,0.033417,172.31.40.0-255,1116,268255,69,373738
9106,0.033486,172.31.40.0-255,1514,269769,69,373738
9107,0.033513,172.31.40.0-255,1514,271283,69,373738
9108,0.033514,172.31.40.0-255,1514,272797,69,373738
9109,0.033538,172.31.40.0-255,1514,274311,69,373738
9110,0.033543,172.31.40.0-255,541,274852,69,373738
9111,0.033899,74.125.200.0-255,5738,280590,69,373738
9112,0.033929,172.31.40.0-255,66,280656,69,373738
9113,0.034968,104.244.42.0-255,66,280722,69,373738
9114,0.035017,104.244.42.0-255,66,280788,69,373738
9115,0.035044,104.244.42.0-255,66,280854,69,373738
9116,0.035105,104.244.42.0-255,66,280920,69,373738
9117,0.035126,104.244.42.0-255,66,280986,69,373738
9118,0.03571,104.244.42.0-255,108,281094,69,373738
9119,0.035714,172.31.40.0-255,66,281160,69,373738
9120,0.036284,74.125.200.0-255,5738,286898,69,373738
9121,0.036288,172.31.40.0-255,66,286964,69,373738
9122,0.038597,74.125.200.0-255,5738,292702,69,373738
9123,0.038604,172.31.40.0-255,66,292768,69,373738
9124,0.040922,74.125.200.0-255,5738,298506,69,373738
9125,0.040928,172.31.40.0-255,66,298572,69,373738
9126,0.043262,74.125.200.0-255,5738,304310,69,373738
9127,0.043269,172.31.40.0-255,66,304376,69,373738
9128,0.045579,74.125.200.0-255,5738,310114,69,373738
9129,0.045585,172.31.40.0-255,66,310180,69,373738
9130,0.047898,74.125.200.0-255,5738,315918,69,373738
9131,0.047904,172.31.40.0-255,66,315984,69,373738
9132,0.05022,74.125.200.0-255,5738,321722,69,373738
9133,0.050228,172.31.40.0-255,66,321788,69,373738
9134,0.05255,74.125.200.0-255,5738,327526,69,373738
9135,0.052556,172.31.40.0-255,66,327592,69,373738
9136,0.05488,74.125.200.0-255,5738,333330,69,373738
9137,0.054886,172.31.40.0-255,66,333396,69,373738
9138,0.057201,74.125.200.0-255,5738,339134,69,373738
9139,0.057206,172.31.40.0-255,66,339200,69,373738
9140,0.059511,74.125.200.0-255,5738,344938,69,373738
9141,0.05952,172.31.40.0-255,66,345004,69,373738
9142,0.061824,74.125.200.0-255,5738,350742,69,373738
9143,0.06183,172.31.40.0-255,66,350808,69,373738
9144,0.064161,74.125.200.0-255,5738,356546,69,373738
9145,0.064171,172.31.40.0-255,66,356612,69,373738
9146,0.066484,74.125.200.0-255,5738,362350,69,373738
9147,0.066491,172.31.40.0-255,66,362416,69,373738
9148,0.068816,74.125.200.0-255,5738,368154,69,373738
9149,0.068821,172.31.40.0-255,66,368220,69,373738
9150,0.071132,74.125.200.0-255,5281,373501,69,373738
9151,0.071139,172.31.40.0-255,66,373567,69,373738
9152,0.071332,172.31.40.0-255,105,373672,69,373738
9153,0.073594,74.125.200.0-255,66,373738,69,373738
9154,0.0,172.253.118.0-255,153,153,69,379501
9155,2.1e-05,172.31.40.0-255,66,219,69,379501
9156,2.7e-05,172.253.118.0-255,1484,1703,69,379501
9157,3.1e-05,172.31.40.0-255,66,1769,69,379501
9158,3.6e-05,172.253.118.0-255,2902,4671,69,379501
9159,4.5e-05,172.31.40.0-255,66,4737,69,379501
9160,7.7e-05,172.253.118.0-255,7156,11893,69,379501
9161,8e-05,172.31.40.0-255,66,11959,69,379501
9162,8.4e-05,172.253.118.0-255,2101,14060,69,379501
9163,8.6e-05,172.31.40.0-255,66,14126,69,379501
9164,9e-05,172.253.118.0-255,2902,17028,69,379501
9165,9.2e-05,172.31.40.0-255,66,17094,69,379501
9166,0.000133,172.31.40.0-255,66,17160,69,379501
9167,0.000151,172.253.118.0-255,4320,21480,69,379501
9168,0.000152,172.31.40.0-255,66,21546,69,379501
9169,0.000174,172.253.118.0-255,1125,22671,69,379501
9170,0.000177,172.31.40.0-255,66,22737,69,379501
9171,0.000226,172.253.118.0-255,1484,24221,69,379501
9172,0.000229,172.253.118.0-255,2902,27123,69,379501
9173,0.000233,172.31.40.0-255,66,27189,69,379501
9174,0.000236,172.31.40.0-255,66,27255,69,379501
9175,0.000245,172.253.118.0-255,5738,32993,69,379501
9176,0.000247,172.31.40.0-255,66,33059,69,379501
9177,0.000283,172.253.118.0-255,6797,39856,69,379501
9178,0.000286,172.31.40.0-255,66,39922,69,379501
9179,0.000323,172.253.118.0-255,1484,41406,69,379501
9180,0.000326,172.31.40.0-255,66,41472,69,379501
9181,0.000328,172.253.118.0-255,1484,42956,69,379501
9182,0.00033,172.31.40.0-255,66,43022,69,379501
9183,0.00036,172.253.118.0-255,1484,44506,69,379501
9184,0.000362,172.31.40.0-255,66,44572,69,379501
9185,0.000368,172.253.118.0-255,5738,50310,69,379501
9186,0.00037,172.31.40.0-255,66,50376,69,379501
9187,0.000375,172.253.118.0-255,5738,56114,69,379501
9188,0.000376,172.31.40.0-255,66,56180,69,379501
9189,0.000398,172.253.118.0-255,1418,57598,69,379501
9190,0.000402,172.253.118.0-255,383,57981,69,379501
9191,0.000403,172.31.40.0-255,66,58047,69,379501
9192,0.000446,172.253.118.0-255,1484,59531,69,379501
9193,0.000466,172.253.118.0-255,4320,63851,69,379501
9194,0.000468,172.31.40.0-255,66,63917,69,379501
9195,0.000474,172.253.118.0-255,5738,69655,69,379501
9196,0.000475,172.31.40.0-255,66,69721,69,379501
9197,0.000527,172.253.118.0-255,2902,72623,69,379501
9198,0.000529,172.31.40.0-255,66,72689,69,379501
9199,0.000554,172.253.118.0-255,2543,75232,69,379501
9200,0.000556,172.31.40.0-255,66,75298,69,379501
9201,0.000562,172.253.118.0-255,5738,81036,69,379501
9202,0.000563,172.31.40.0-255,66,81102,69,379501
9203,0.000596,172.31.40.0-255,66,81168,69,379501
9204,0.000621,172.253.118.0-255,7156,88324,69,379501
9205,0.000623,172.31.40.0-255,66,88390,69,379501
9206,0.000648,172.253.118.0-255,4320,92710,69,379501
9207,0.00065,172.31.40.0-255,66,92776,69,379501
9208,0.000683,172.253.118.0-255,5265,98041,69,379501
9209,0.000685,172.31.40.0-255,66,98107,69,379501
9210,0.000913,172.253.118.0-255,211,98318,69,379501
9211,0.001159,172.253.118.0-255,1484,99802,69,379501
9212,0.001164,172.31.40.0-255,66,99868,69,379501
9213,0.00117,172.253.118.0-255,2902,102770,69,379501
9214,0.001172,172.31.40.0-255,66,102836,69,379501
9215,0.001202,172.253.118.0-255,5738,108574,69,379501
9216,0.001204,172.31.40.0-255,66,108640,69,379501
9217,0.00121,172.253.118.0-255,5738,114378,69,379501
9218,0.001212,172.31.40.0-255,66,114444,69,379501
9219,0.001246,172.31.40.0-255,66,114510,69,379501
9220,0.001298,172.253.118.0-255,2902,117412,69,379501
9221,0.001302,172.31.40.0-255,66,117478,69,379501
9222,0.001333,172.253.118.0-255,2184,119662,69,379501
9223,0.001336,172.31.40.0-255,66,119728,69,379501
9224,0.001618,172.253.118.0-255,1484,121212,69,379501
9225,0.001625,172.253.118.0-255,2902,124114,69,379501
9226,0.001628,172.31.40.0-255,66,124180,69,379501
9227,0.001632,172.253.118.0-255,1484,125664,69,379501
9228,0.001652,172.253.118.0-255,4320,129984,69,379501
9229,0.001654,172.31.40.0-255,66,130050,69,379501
9230,0.001659,172.253.118.0-255,2902,132952,69,379501
9231,0.001661,172.31.40.0-255,66,133018,69,379501
9232,0.001691,172.253.118.0-255,1484,134502,69,379501
9233,0.001699,172.253.118.0-255,5738,140240,69,379501
9234,0.001702,172.31.40.0-255,66,140306,69,379501
9235,0.001707,172.253.118.0-255,4320,144626,69,379501
9236,0.001709,172.31.40.0-255,66,144692,69,379501
9237,0.001736,172.253.118.0-255,7156,151848,69,379501
9238,0.001744,172.31.40.0-255,66,151914,69,379501
9239,0.001773,172.253.118.0-255,2184,154098,69,379501
9240,0.001776,172.31.40.0-255,66,154164,69,379501
9241,0.002064,172.253.118.0-255,1484,155648,69,379501
9242,0.002068,172.253.118.0-255,1484,157132,69,379501
9243,0.002071,172.31.40.0-255,66,157198,69,379501
9244,0.002096,172.253.118.0-255,1484,158682,69,379501
9245,0.002102,172.253.118.0-255,5738,164420,69,379501
9246,0.002105,172.31.40.0-255,66,164486,69,379501
9247,0.002145,172.31.40.0-255,66,164552,69,379501
9248,0.002189,172.31.40.0-255,66,164618,69,379501
9249,0.002206,172.253.118.0-255,1484,166102,69,379501
9250,0.002211,172.253.118.0-255,2184,168286,69,379501
9251,0.002213,172.31.40.0-255,66,168352,69,379501
9252,0.004434,172.253.118.0-255,1484,169836,69,379501
9253,0.004458,172.253.118.0-255,1484,171320,69,379501
9254,0.004462,172.31.40.0-255,66,171386,69,379501
9255,0.004489,172.253.118.0-255,2902,174288,69,379501
9256,0.004491,172.31.40.0-255,66,174354,69,379501
9257,0.006705,172.253.118.0-255,2902,177256,69,379501
9258,0.00671,172.31.40.0-255,66,177322,69,379501
9259,0.006737,172.253.118.0-255,2902,180224,69,379501
9260,0.006739,172.31.40.0-255,66,180290,69,379501
9261,0.008967,172.253.118.0-255,5738,186028,69,379501
9262,0.008973,172.31.40.0-255,66,186094,69,379501
9263,0.011227,172.253.118.0-255,5738,191832,69,379501
9264,0.011234,172.31.40.0-255,66,191898,69,379501
9265,0.013498,172.253.118.0-255,5738,197636,69,379501
9266,0.013505,172.31.40.0-255,66,197702,69,379501
9267,0.015788,172.253.118.0-255,5738,203440,69,379501
9268,0.015798,172.31.40.0-255,66,203506,69,379501
9269,0.018064,172.253.118.0-255,5738,209244,69,379501
9270,0.018072,172.31.40.0-255,66,209310,69,379501
9271,0.020329,172.253.118.0-255,5738,215048,69,379501
9272,0.020337,172.31.40.0-255,66,215114,69,379501
9273,0.022601,172.253.118.0-255,5738,220852,69,379501
9274,0.022608,172.31.40.0-255,66,220918,69,379501
9275,0.024869,172.253.118.0-255,5738,226656,69,379501
9276,0.024877,172.31.40.0-255,66,226722,69,379501
9277,0.027146,172.253.118.0-255,5738,232460,69,379501
9278,0.027153,172.31.40.0-255,66,232526,69,379501
9279,0.029418,172.253.118.0-255,5738,238264,69,379501
9280,0.029426,172.31.40.0-255,66,238330,69,379501
9281,0.031691,172.253.118.0-255,5738,244068,69,379501
9282,0.031698,172.31.40.0-255,66,244134,69,379501
9283,0.033761,172.31.40.0-255,172,244306,69,379501
9284,0.033793,172.31.40.0-255,1114,245420,69,379501
9285,0.033872,172.31.40.0-255,1514,246934,69,379501
9286,0.033874,172.31.40.0-255,1514,248448,69,379501
9287,0.03388,172.31.40.0-255,1514,249962,69,379501
9288,0.033881,172.31.40.0-255,1514,251476,69,379501
9289,0.0339,172.31.40.0-255,1501,252977,69,379501
9290,0.03394,172.253.118.0-255,5738,258715,69,379501
9291,0.033944,172.31.40.0-255,66,258781,69,379501
9292,0.035323,104.244.42.0-255,66,258847,69,379501
9293,0.035331,104.244.42.0-255,66,258913,69,379501
9294,0.035435,104.244.42.0-255,66,258979,69,379501
9295,0.036183,172.253.118.0-255,5738,264717,69,379501
9296,0.036187,172.31.40.0-255,66,264783,69,379501
9297,0.03845,172.253.118.0-255,5738,270521,69,379501
9298,0.038455,172.31.40.0-255,66,270587,69,379501
9299,0.040765,172.253.118.0-255,5738,276325,69,379501
9300,0.040771,172.31.40.0-255,66,276391,69,379501
9301,0.043028,172.253.118.0-255,5738,282129,69,379501
9302,0.043034,172.31.40.0-255,66,282195,69,379501
9303,0.045294,172.253.118.0-255,5738,287933,69,379501
9304,0.045302,172.31.40.0-255,66,287999,69,379501
9305,0.047576,172.253.118.0-255,5738,293737,69,379501
9306,0.047583,172.31.40.0-255,66,293803,69,379501
9307,0.049849,172.253.118.0-255,5738,299541,69,379501
9308,0.049855,172.31.40.0-255,66,299607,69,379501
9309,0.05212,172.253.118.0-255,5738,305345,69,379501
9310,0.052126,172.31.40.0-255,66,305411,69,379501
9311,0.054397,172.253.118.0-255,5738,311149,69,379501
9312,0.054404,172.31.40.0-255,66,311215,69,379501
9313,0.056657,172.253.118.0-255,5738,316953,69,379501
9314,0.056663,172.31.40.0-255,66,317019,69,379501
9315,0.058922,172.253.118.0-255,5738,322757,69,379501
9316,0.058927,172.31.40.0-255,66,322823,69,379501
9317,0.061189,172.253.118.0-255,5738,328561,69,379501
9318,0.061195,172.31.40.0-255,66,328627,69,379501
9319,0.063462,172.253.118.0-255,5738,334365,69,379501
9320,0.063467,172.31.40.0-255,66,334431,69,379501
9321,0.065746,172.253.118.0-255,5738,340169,69,379501
9322,0.065753,172.31.40.0-255,66,340235,69,379501
9323,0.06803,172.253.118.0-255,5738,345973,69,379501
9324,0.068037,172.31.40.0-255,66,346039,69,379501
9325,0.070299,172.253.118.0-255,5738,351777,69,379501
9326,0.070305,172.31.40.0-255,66,351843,69,379501
9327,0.072587,172.253.118.0-255,5738,357581,69,379501
9328,0.072594,172.31.40.0-255,66,357647,69,379501
9329,0.074847,172.253.118.0-255,5738,363385,69,379501
9330,0.074854,172.31.40.0-255,66,363451,69,379501
9331,0.077111,172.253.118.0-255,5738,369189,69,379501
9332,0.077117,172.31.40.0-255,66,369255,69,379501
9333,0.079373,172.253.118.0-255,5738,374993,69,379501
9334,0.079379,172.31.40.0-255,66,375059,69,379501
9335,0.081644,172.253.118.0-255,4205,379264,69,379501
9336,0.081651,172.31.40.0-255,66,379330,69,379501
9337,0.08184,172.31.40.0-255,105,379435,69,379501
9338,0.084069,172.253.118.0-255,66,379501,69,379501
9339,0.0,172.217.194.0-255,150,150,69,197829
9340,1.6e-05,172.31.40.0-255,66,216,69,197829
9341,2.4e-05,172.217.194.0-255,1484,1700,69,197829
9342,2.8e-05,172.31.40.0-255,66,1766,69,197829
9343,3.1e-05,172.217.194.0-255,1484,3250,69,197829
9344,4.2e-05,172.31.40.0-255,66,3316,69,197829
9345,7.1e-05,172.217.194.0-255,1484,4800,69,197829
9346,7.4e-05,172.31.40.0-255,66,4866,69,197829
9347,8.3e-05,172.217.194.0-255,7156,12022,69,197829
9348,8.5e-05,172.31.40.0-255,66,12088,69,197829
9349,9.1e-05,172.217.194.0-255,5738,17826,69,197829
9350,9.4e-05,172.31.40.0-255,66,17892,69,197829
9351,0.000141,172.31.40.0-255,66,17958,69,197829
9352,0.000145,172.217.194.0-255,2543,20501,69,197829
9353,0.000148,172.31.40.0-255,66,20567,69,197829
9354,0.000159,172.31.40.0-255,66,20633,69,197829
9355,0.000179,172.217.194.0-255,4320,24953,69,197829
9356,0.000182,172.31.40.0-255,66,25019,69,197829
9357,0.000208,172.217.194.0-255,5738,30757,69,197829
9358,0.000211,172.31.40.0-255,66,30823,69,197829
9359,0.000218,172.217.194.0-255,7156,37979,69,197829
9360,0.00022,172.31.40.0-255,66,38045,69,197829
9361,0.00026,172.31.40.0-255,66,38111,69,197829
9362,0.000263,172.217.194.0-255,367,38478,69,197829
9363,0.000265,172.31.40.0-255,66,38544,69,197829
9364,0.000268,172.217.194.0-255,1484,40028,69,197829
9365,0.000271,172.31.40.0-255,66,40094,69,197829
9366,0.000277,172.217.194.0-255,4320,44414,69,197829
9367,0.000279,172.31.40.0-255,66,44480,69,197829
9368,0.000282,172.217.194.0-255,1484,45964,69,197829
9369,0.000315,172.31.40.0-255,66,46030,69,197829
9370,0.000327,172.31.40.0-255,66,46096,69,197829
9371,0.000353,172.217.194.0-255,2902,48998,69,197829
9372,0.000356,172.31.40.0-255,66,49064,69,197829
9373,0.000394,172.31.40.0-255,66,49130,69,197829
9374,0.00041,172.31.40.0-255,66,49196,69,197829
9375,0.000425,172.31.40.0-255,66,49262,69,197829
9376,0.000521,172.217.194.0-255,1484,50746,69,197829
9377,0.000526,172.217.194.0-255,2902,53648,69,197829
9378,0.00053,172.31.40.0-255,66,53714,69,197829
9379,0.000535,172.217.194.0-255,2902,56616,69,197829
9380,0.000538,172.31.40.0-255,66,56682,69,197829
9381,0.000565,172.217.194.0-255,2902,59584,69,197829
9382,0.000568,172.31.40.0-255,66,59650,69,197829
9383,0.000575,172.217.194.0-255,7156,66806,69,197829
9384,0.000582,172.217.194.0-255,7156,73962,69,197829
9385,0.00061,172.217.194.0-255,7156,81118,69,197829
9386,0.000614,172.217.194.0-255,2184,83302,69,197829
9387,0.00071,172.31.40.0-255,66,83368,69,197829
9388,0.000862,172.217.194.0-255,1484,84852,69,197829
9389,0.000867,172.217.194.0-255,2902,87754,69,197829
9390,0.00087,172.217.194.0-255,1484,89238,69,197829
9391,0.000877,172.31.40.0-255,66,89304,69,197829
9392,0.000898,172.217.194.0-255,4320,93624,69,197829
9393,0.000919,172.217.194.0-255,7156,100780,69,197829
9394,0.000941,172.217.194.0-255,3602,104382,69,197829
9395,0.000946,172.31.40.0-255,66,104448,69,197829
9396,0.001049,172.217.194.0-255,1484,105932,69,197829
9397,0.001055,172.217.194.0-255,2902,108834,69,197829
9398,0.001058,172.217.194.0-255,1484,110318,69,197829
9399,0.001066,172.31.40.0-255,66,110384,69,197829
9400,0.001093,172.217.194.0-255,4320,114704,69,197829
9401,0.001101,172.217.194.0-255,5738,120442,69,197829
9402,0.001116,172.217.194.0-255,7156,127598,69,197829
9403,0.001128,172.31.40.0-255,66,127664,69,197829
9404,0.001183,172.217.194.0-255,4320,131984,69,197829
9405,0.00119,172.31.40.0-255,66,132050,69,197829
9406,0.001201,172.217.194.0-255,6438,138488,69,197829
9407,0.001234,172.217.194.0-255,2902,141390,69,197829
9408,0.001239,172.217.194.0-255,4320,145710,69,197829
9409,0.001262,172.217.194.0-255,4320,150030,69,197829
9410,0.001276,172.31.40.0-255,66,150096,69,197829
9411,0.001296,172.217.194.0-255,5020,155116,69,197829
9412,0.001326,172.217.194.0-255,7156,162272,69,197829
9413,0.001362,172.217.194.0-255,1484,163756,69,197829
9414,0.001365,172.217.194.0-255,1484,165240,69,197829
9415,0.001376,172.217.194.0-255,1484,166724,69,197829
9416,0.001382,172.217.194.0-255,5738,172462,69,197829
9417,0.001388,172.31.40.0-255,66,172528,69,197829
9418,0.001454,172.31.40.0-255,66,172594,69,197829
9419,0.001483,172.217.194.0-255,2184,174778,69,197829
9420,0.00149,172.31.40.0-255,66,174844,69,197829
9421,0.001509,172.217.194.0-255,2902,177746,69,197829
9422,0.001515,172.217.194.0-255,5738,183484,69,197829
9423,0.001526,172.217.194.0-255,1484,184968,69,197829
9424,0.001563,172.31.40.0-255,66,185034,69,197829
9425,0.001631,172.217.194.0-255,1484,186518,69,197829
9426,0.001635,172.31.40.0-255,66,186584,69,197829
9427,0.001641,172.31.40.0-255,66,186650,69,197829
9428,0.001673,172.217.194.0-255,1484,188134,69,197829
9429,0.001685,172.31.40.0-255,66,188200,69,197829
9430,0.001723,172.217.194.0-255,105,188305,69,197829
9431,0.001776,172.31.40.0-255,66,188371,69,197829
9432,0.008938,172.31.40.0-255,105,188476,69,197829
9433,0.011637,172.217.194.0-255,66,188542,69,197829
9434,0.037552,172.31.40.0-255,176,188718,69,197829
9435,0.037585,172.31.40.0-255,1116,189834,69,197829
9436,0.037677,172.31.40.0-255,1514,191348,69,197829
9437,0.037679,172.31.40.0-255,1514,192862,69,197829
9438,0.03768,172.31.40.0-255,1514,194376,69,197829
9439,0.037681,172.31.40.0-255,1514,195890,69,197829
9440,0.03771,172.31.40.0-255,1501,197391,69,197829
9441,0.039198,104.244.42.0-255,66,197457,69,197829
9442,0.039237,104.244.42.0-255,66,197523,69,197829
9443,0.039357,104.244.42.0-255,66,197589,69,197829
9444,0.039378,104.244.42.0-255,66,197655,69,197829
9445,0.04005,104.244.42.0-255,108,197763,69,197829
9446,0.040059,172.31.40.0-255,66,197829,69,197829
9447,0.0,172.217.194.0-255,153,153,69,345096
9448,2.1e-05,172.31.40.0-255,66,219,69,345096
9449,2.8e-05,172.217.194.0-255,1484,1703,69,345096
9450,3.2e-05,172.31.40.0-255,66,1769,69,345096
9451,3.8e-05,172.217.194.0-255,2902,4671,69,345096
9452,5e-05,172.31.40.0-255,66,4737,69,345096
9453,5.7e-05,172.217.194.0-255,7156,11893,69,345096
9454,6.1e-05,172.31.40.0-255,66,11959,69,345096
9455,8.3e-05,172.217.194.0-255,4938,16897,69,345096
9456,8.6e-05,172.31.40.0-255,66,16963,69,345096
9457,9.5e-05,172.217.194.0-255,5738,22701,69,345096
9458,9.7e-05,172.31.40.0-255,66,22767,69,345096
9459,0.000129,172.217.194.0-255,7156,29923,69,345096
9460,0.000131,172.31.40.0-255,66,29989,69,345096
9461,0.000147,172.217.194.0-255,1125,31114,69,345096
9462,0.000149,172.31.40.0-255,66,31180,69,345096
9463,0.000352,172.217.194.0-255,1484,32664,69,345096
9464,0.000357,172.31.40.0-255,66,32730,69,345096
9465,0.000362,172.217.194.0-255,2902,35632,69,345096
9466,0.000365,172.31.40.0-255,66,35698,69,345096
9467,0.000368,172.217.194.0-255,2902,38600,69,345096
9468,0.000375,172.31.40.0-255,66,38666,69,345096
9469,0.000386,172.217.194.0-255,1484,40150,69,345096
9470,0.000388,172.31.40.0-255,66,40216,69,345096
9471,0.000415,172.217.194.0-255,4320,44536,69,345096
9472,0.000418,172.31.40.0-255,66,44602,69,345096
9473,0.000445,172.217.194.0-255,5379,49981,69,345096
9474,0.000448,172.31.40.0-255,66,50047,69,345096
9475,0.00045,172.217.194.0-255,1484,51531,69,345096
9476,0.000452,172.31.40.0-255,66,51597,69,345096
9477,0.000475,172.217.194.0-255,2902,54499,69,345096
9478,0.000478,172.31.40.0-255,66,54565,69,345096
9479,0.000482,172.217.194.0-255,2902,57467,69,345096
9480,0.000485,172.31.40.0-255,66,57533,69,345096
9481,0.000524,172.31.40.0-255,66,57599,69,345096
9482,0.00073,172.217.194.0-255,115,57714,69,345096
9483,0.000817,172.217.194.0-255,1484,59198,69,345096
9484,0.000821,172.31.40.0-255,66,59264,69,345096
9485,0.00085,172.217.194.0-255,2902,62166,69,345096
9486,0.000853,172.31.40.0-255,66,62232,69,345096
9487,0.00086,172.217.194.0-255,5738,67970,69,345096
9488,0.000862,172.31.40.0-255,66,68036,69,345096
9489,0.000904,172.31.40.0-255,66,68102,69,345096
9490,0.000915,172.31.40.0-255,66,68168,69,345096
9491,0.000943,172.217.194.0-255,3342,71510,69,345096
9492,0.000946,172.31.40.0-255,66,71576,69,345096
9493,0.000973,172.217.194.0-255,1484,73060,69,345096
9494,0.000978,172.217.194.0-255,2902,75962,69,345096
9495,0.00098,172.31.40.0-255,66,76028,69,345096
9496,0.000987,172.217.194.0-255,5738,81766,69,345096
9497,0.000989,172.31.40.0-255,66,81832,69,345096
9498,0.001027,172.31.40.0-255,66,81898,69,345096
9499,0.00106,172.31.40.0-255,66,81964,69,345096
9500,0.0032,172.217.194.0-255,1484,83448,69,345096
9501,0.003222,172.217.194.0-255,2902,86350,69,345096
9502,0.003226,172.31.40.0-255,66,86416,69,345096
9503,0.003231,172.217.194.0-255,1484,87900,69,345096
9504,0.005186,172.217.194.0-255,4320,92220,69,345096
9505,0.005189,172.31.40.0-255,66,92286,69,345096
9506,0.00717,172.217.194.0-255,5738,98024,69,345096
9507,0.007177,172.31.40.0-255,66,98090,69,345096
9508,0.009176,172.217.194.0-255,5738,103828,69,345096
9509,0.009182,172.31.40.0-255,66,103894,69,345096
9510,0.011163,172.217.194.0-255,5738,109632,69,345096
9511,0.011171,172.31.40.0-255,66,109698,69,345096
9512,0.013191,172.217.194.0-255,5738,115436,69,345096
9513,0.013199,172.31.40.0-255,66,115502,69,345096
9514,0.015214,172.217.194.0-255,5738,121240,69,345096
9515,0.015224,172.31.40.0-255,66,121306,69,345096
9516,0.017215,172.217.194.0-255,5738,127044,69,345096
9517,0.017223,172.31.40.0-255,66,127110,69,345096
9518,0.019204,172.217.194.0-255,5738,132848,69,345096
9519,0.019212,172.31.40.0-255,66,132914,69,345096
9520,0.021237,172.217.194.0-255,5738,138652,69,345096
9521,0.021244,172.31.40.0-255,66,138718,69,345096
9522,0.023229,172.217.194.0-255,5738,144456,69,345096
9523,0.023237,172.31.40.0-255,66,144522,69,345096
9524,0.025205,172.217.194.0-255,5738,150260,69,345096
9525,0.025213,172.31.40.0-255,66,150326,69,345096
9526,0.027185,172.217.194.0-255,5738,156064,69,345096
9527,0.027192,172.31.40.0-255,66,156130,69,345096
9528,0.029186,172.217.194.0-255,5738,161868,69,345096
9529,0.029195,172.31.40.0-255,66,161934,69,345096
9530,0.031195,172.217.194.0-255,5738,167672,69,345096
9531,0.031203,172.31.40.0-255,66,167738,69,345096
9532,0.033173,172.217.194.0-255,5738,173476,69,345096
9533,0.033178,172.31.40.0-255,66,173542,69,345096
9534,0.033931,172.31.40.0-255,172,173714,69,345096
9535,0.033957,172.31.40.0-255,1114,174828,69,345096
9536,0.034011,172.31.40.0-255,1514,176342,69,345096
9537,0.034013,172.31.40.0-255,1514,177856,69,345096
9538,0.034014,172.31.40.0-255,1514,179370,69,345096
9539,0.034018,172.31.40.0-255,1514,180884,69,345096
9540,0.034019,172.31.40.0-255,1502,182386,69,345096
9541,0.03514,172.217.194.0-255,5738,188124,69,345096
9542,0.035147,172.31.40.0-255,66,188190,69,345096
9543,0.035514,104.244.42.0-255,66,188256,69,345096
9544,0.035588,104.244.42.0-255,66,188322,69,345096
9545,0.035638,104.244.42.0-255,66,188388,69,345096
9546,0.037142,172.217.194.0-255,5738,194126,69,345096
9547,0.037149,172.31.40.0-255,66,194192,69,345096
9548,0.039132,172.217.194.0-255,5738,199930,69,345096
9549,0.039139,172.31.40.0-255,66,199996,69,345096
9550,0.04114,172.217.194.0-255,5738,205734,69,345096
9551,0.041146,172.31.40.0-255,66,205800,69,345096
9552,0.043218,172.217.194.0-255,5738,211538,69,345096
9553,0.043228,172.31.40.0-255,66,211604,69,345096
9554,0.045257,172.217.194.0-255,5738,217342,69,345096
9555,0.045263,172.31.40.0-255,66,217408,69,345096
9556,0.047289,172.217.194.0-255,5738,223146,69,345096
9557,0.047295,172.31.40.0-255,66,223212,69,345096
9558,0.049297,172.217.194.0-255,5738,228950,69,345096
9559,0.049303,172.31.40.0-255,66,229016,69,345096
9560,0.051317,172.217.194.0-255,5738,234754,69,345096
9561,0.051324,172.31.40.0-255,66,234820,69,345096
9562,0.053369,172.217.194.0-255,5738,240558,69,345096
9563,0.053374,172.31.40.0-255,66,240624,69,345096
9564,0.055392,172.217.194.0-255,5738,246362,69,345096
9565,0.055399,172.31.40.0-255,66,246428,69,345096
9566,0.057393,172.217.194.0-255,5738,252166,69,345096
9567,0.0574,172.31.40.0-255,66,252232,69,345096
9568,0.05937,172.217.194.0-255,5738,257970,69,345096
9569,0.059375,172.31.40.0-255,66,258036,69,345096
9570,0.061348,172.217.194.0-255,5738,263774,69,345096
9571,0.061355,172.31.40.0-255,66,263840,69,345096
9572,0.063361,172.217.194.0-255,5738,269578,69,345096
9573,0.063367,172.31.40.0-255,66,269644,69,345096
9574,0.065404,172.217.194.0-255,5738,275382,69,345096
9575,0.06541,172.31.40.0-255,66,275448,69,345096
9576,0.067435,172.217.194.0-255,5738,281186,69,345096
9577,0.067442,172.31.40.0-255,66,281252,69,345096
9578,0.069419,172.217.194.0-255,5738,286990,69,345096
9579,0.069425,172.31.40.0-255,66,287056,69,345096
9580,0.071421,172.217.194.0-255,5738,292794,69,345096
9581,0.071428,172.31.40.0-255,66,292860,69,345096
9582,0.07349,172.217.194.0-255,5738,298598,69,345096
9583,0.073497,172.31.40.0-255,66,298664,69,345096
9584,0.07551,172.217.194.0-255,5738,304402,69,345096
9585,0.075517,172.31.40.0-255,66,304468,69,345096
9586,0.077506,172.217.194.0-255,5738,310206,69,345096
9587,0.077514,172.31.40.0-255,66,310272,69,345096
9588,0.079505,172.217.194.0-255,5738,316010,69,345096
9589,0.079511,172.31.40.0-255,66,316076,69,345096
9590,0.081514,172.217.194.0-255,5738,321814,69,345096
9591,0.081521,172.31.40.0-255,66,321880,69,345096
9592,0.083516,172.217.194.0-255,5738,327618,69,345096
9593,0.083523,172.31.40.0-255,66,327684,69,345096
9594,0.085562,172.217.194.0-255,5738,333422,69,345096
9595,0.085568,172.31.40.0-255,66,333488,69,345096
9596,0.087606,172.217.194.0-255,5738,339226,69,345096
9597,0.087612,172.31.40.0-255,66,339292,69,345096
9598,0.089622,172.217.194.0-255,5738,345030,69,345096
9599,0.089629,172.31.40.0-255,66,345096,69,345096
9600,0.0,74.125.68.0-255,291,291,69,330424
9601,2.4e-05,172.31.40.0-255,66,357,69,330424
9602,3e-05,74.125.68.0-255,1484,1841,69,330424
9603,3.4e-05,172.31.40.0-255,66,1907,69,330424
9604,3.6e-05,74.125.68.0-255,1484,3391,69,330424
9605,3.9e-05,172.31.40.0-255,66,3457,69,330424
9606,6.1e-05,74.125.68.0-255,2902,6359,69,330424
9607,6.3e-05,172.31.40.0-255,66,6425,69,330424
9608,8.8e-05,74.125.68.0-255,2902,9327,69,330424
9609,9.1e-05,172.31.40.0-255,66,9393,69,330424
9610,0.000108,74.125.68.0-255,2902,12295,69,330424
9611,0.00011,172.31.40.0-255,66,12361,69,330424
9612,0.000152,74.125.68.0-255,1899,14260,69,330424
9613,0.000155,172.31.40.0-255,66,14326,69,330424
9614,0.00052,74.125.68.0-255,1484,15810,69,330424
9615,0.000526,172.31.40.0-255,66,15876,69,330424
9616,0.000536,74.125.68.0-255,2902,18778,69,330424
9617,0.000539,172.31.40.0-255,66,18844,69,330424
9618,0.000546,74.125.68.0-255,5738,24582,69,330424
9619,0.000548,172.31.40.0-255,66,24648,69,330424
9620,0.000553,74.125.68.0-255,2902,27550,69,330424
9621,0.000556,172.31.40.0-255,66,27616,69,330424
9622,0.000583,74.125.68.0-255,3961,31577,69,330424
9623,0.000587,172.31.40.0-255,66,31643,69,330424
9624,0.000704,74.125.68.0-255,1484,33127,69,330424
9625,0.000711,172.31.40.0-255,66,33193,69,330424
9626,0.000742,74.125.68.0-255,2902,36095,69,330424
9627,0.000747,172.31.40.0-255,66,36161,69,330424
9628,0.000767,74.125.68.0-255,1484,37645,69,330424
9629,0.00077,172.31.40.0-255,66,37711,69,330424
9630,0.000792,74.125.68.0-255,2902,40613,69,330424
9631,0.000796,172.31.40.0-255,66,40679,69,330424
9632,0.000826,74.125.68.0-255,1484,42163,69,330424
9633,0.000852,74.125.68.0-255,7156,49319,69,330424
9634,0.000857,74.125.68.0-255,4320,53639,69,330424
9635,0.000878,172.31.40.0-255,66,53705,69,330424
9636,0.000898,74.125.68.0-255,4306,58011,69,330424
9637,0.000931,172.31.40.0-255,66,58077,69,330424
9638,0.000999,74.125.68.0-255,341,58418,69,330424
9639,0.001311,74.125.68.0-255,1484,59902,69,330424
9640,0.001317,172.31.40.0-255,66,59968,69,330424
9641,0.001324,74.125.68.0-255,2902,62870,69,330424
9642,0.001326,172.31.40.0-255,66,62936,69,330424
9643,0.001332,74.125.68.0-255,5738,68674,69,330424
9644,0.001334,172.31.40.0-255,66,68740,69,330424
9645,0.001355,74.125.68.0-255,5738,74478,69,330424
9646,0.001358,172.31.40.0-255,66,74544,69,330424
9647,0.001386,74.125.68.0-255,5738,80282,69,330424
9648,0.001391,74.125.68.0-255,4320,84602,69,330424
9649,0.001417,172.31.40.0-255,66,84668,69,330424
9650,0.001429,172.31.40.0-255,66,84734,69,330424
9651,0.001602,172.31.40.0-255,101,84835,69,330424
9652,0.003553,74.125.68.0-255,5738,90573,69,330424
9653,0.003559,172.31.40.0-255,66,90639,69,330424
9654,0.003678,74.125.68.0-255,66,90705,69,330424
9655,0.005679,74.125.68.0-255,5738,96443,69,330424
9656,0.005683,172.31.40.0-255,66,96509,69,330424
9657,0.007801,74.125.68.0-255,5738,102247,69,330424
9658,0.007806,172.31.40.0-255,66,102313,69,330424
9659,0.009935,74.125.68.0-255,5738,108051,69,330424
9660,0.009941,172.31.40.0-255,66,108117,69,330424
9661,0.012081,74.125.68.0-255,5738,113855,69,330424
9662,0.012089,172.31.40.0-255,66,113921,69,330424
9663,0.014227,74.125.68.0-255,5738,119659,69,330424
9664,0.014238,172.31.40.0-255,66,119725,69,330424
9665,0.016399,74.125.68.0-255,5738,125463,69,330424
9666,0.016408,172.31.40.0-255,66,125529,69,330424
9667,0.01853,74.125.68.0-255,5738,131267,69,330424
9668,0.018534,172.31.40.0-255,66,131333,69,330424
9669,0.020666,74.125.68.0-255,5738,137071,69,330424
9670,0.020672,172.31.40.0-255,66,137137,69,330424
9671,0.022808,74.125.68.0-255,5738,142875,69,330424
9672,0.022815,172.31.40.0-255,66,142941,69,330424
9673,0.02495,74.125.68.0-255,5738,148679,69,330424
9674,0.024956,172.31.40.0-255,66,148745,69,330424
9675,0.02708,74.125.68.0-255,5738,154483,69,330424
9676,0.027087,172.31.40.0-255,66,154549,69,330424
9677,0.029218,74.125.68.0-255,5738,160287,69,330424
9678,0.029224,172.31.40.0-255,66,160353,69,330424
9679,0.029891,172.31.40.0-255,172,160525,69,330424
9680,0.029928,172.31.40.0-255,1114,161639,69,330424
9681,0.030057,172.31.40.0-255,1514,163153,69,330424
9682,0.030059,172.31.40.0-255,1514,164667,69,330424
9683,0.03006,172.31.40.0-255,1514,166181,69,330424
9684,0.030064,172.31.40.0-255,1514,167695,69,330424
9685,0.030065,172.31.40.0-255,1501,169196,69,330424
9686,0.031342,74.125.68.0-255,4320,173516,69,330424
9687,0.031348,172.31.40.0-255,66,173582,69,330424
9688,0.031362,74.125.68.0-255,1484,175066,69,330424
9689,0.031569,104.244.42.0-255,66,175132,69,330424
9690,0.031577,104.244.42.0-255,66,175198,69,330424
9691,0.031822,104.244.42.0-255,66,175264,69,330424
9692,0.033489,74.125.68.0-255,4320,179584,69,330424
9693,0.033493,172.31.40.0-255,66,179650,69,330424
9694,0.035616,74.125.68.0-255,5738,185388,69,330424
9695,0.035622,172.31.40.0-255,66,185454,69,330424
9696,0.037751,74.125.68.0-255,5738,191192,69,330424
9697,0.037756,172.31.40.0-255,66,191258,69,330424
9698,0.039884,74.125.68.0-255,5738,196996,69,330424
9699,0.039891,172.31.40.0-255,66,197062,69,330424
9700,0.04201,74.125.68.0-255,4320,201382,69,330424
9701,0.042015,172.31.40.0-255,66,201448,69,330424
9702,0.042045,74.125.68.0-255,1484,202932,69,330424
9703,0.044133,74.125.68.0-255,4320,207252,69,330424
9704,0.044139,172.31.40.0-255,66,207318,69,330424
9705,0.04627,74.125.68.0-255,4320,211638,69,330424
9706,0.046275,172.31.40.0-255,66,211704,69,330424
9707,0.046302,74.125.68.0-255,1484,213188,69,330424
9708,0.048386,74.125.68.0-255,4320,217508,69,330424
9709,0.04839,172.31.40.0-255,66,217574,69,330424
9710,0.050499,74.125.68.0-255,2902,220476,69,330424
9711,0.050503,172.31.40.0-255,66,220542,69,330424
9712,0.05053,74.125.68.0-255,2902,223444,69,330424
9713,0.050532,172.31.40.0-255,66,223510,69,330424
9714,0.052613,74.125.68.0-255,2902,226412,69,330424
9715,0.052618,172.31.40.0-255,66,226478,69,330424
9716,0.052655,74.125.68.0-255,2902,229380,69,330424
9717,0.052658,172.31.40.0-255,66,229446,69,330424
9718,0.054728,74.125.68.0-255,2902,232348,69,330424
9719,0.054733,172.31.40.0-255,66,232414,69,330424
9720,0.054786,74.125.68.0-255,2902,235316,69,330424
9721,0.054791,172.31.40.0-255,66,235382,69,330424
9722,0.056846,74.125.68.0-255,2902,238284,69,330424
9723,0.05685,172.31.40.0-255,66,238350,69,330424
9724,0.056982,74.125.68.0-255,2902,241252,69,330424
9725,0.056987,172.31.40.0-255,66,241318,69,330424
9726,0.058978,74.125.68.0-255,2902,244220,69,330424
9727,0.058982,172.31.40.0-255,66,244286,69,330424
9728,0.059103,74.125.68.0-255,2902,247188,69,330424
9729,0.059108,172.31.40.0-255,66,247254,69,330424
9730,0.061091,74.125.68.0-255,2902,250156,69,330424
9731,0.061098,172.31.40.0-255,66,250222,69,330424
9732,0.061221,74.125.68.0-255,2902,253124,69,330424
9733,0.061226,172.31.40.0-255,66,253190,69,330424
9734,0.063219,74.125.68.0-255,2902,256092,69,330424
9735,0.063225,172.31.40.0-255,66,256158,69,330424
9736,0.063341,74.125.68.0-255,2902,259060,69,330424
9737,0.063346,172.31.40.0-255,66,259126,69,330424
9738,0.065337,74.125.68.0-255,2902,262028,69,330424
9739,0.065341,172.31.40.0-255,66,262094,69,330424
9740,0.06546,74.125.68.0-255,2902,264996,69,330424
9741,0.065465,172.31.40.0-255,66,265062,69,330424
9742,0.067453,74.125.68.0-255,2902,267964,69,330424
9743,0.067459,172.31.40.0-255,66,268030,69,330424
9744,0.06758,74.125.68.0-255,2902,270932,69,330424
9745,0.067586,172.31.40.0-255,66,270998,69,330424
9746,0.069588,74.125.68.0-255,2902,273900,69,330424
9747,0.069594,172.31.40.0-255,66,273966,69,330424
9748,0.069705,74.125.68.0-255,2902,276868,69,330424
9749,0.06971,172.31.40.0-255,66,276934,69,330424
9750,0.071715,74.125.68.0-255,2902,279836,69,330424
9751,0.07172,172.31.40.0-255,66,279902,69,330424
9752,0.071815,74.125.68.0-255,2902,282804,69,330424
9753,0.071819,172.31.40.0-255,66,282870,69,330424
9754,0.073839,74.125.68.0-255,2902,285772,69,330424
9755,0.073844,172.31.40.0-255,66,285838,69,330424
9756,0.073928,74.125.68.0-255,2902,288740,69,330424
9757,0.073932,172.31.40.0-255,66,288806,69,330424
9758,0.075974,74.125.68.0-255,2902,291708,69,330424
9759,0.075979,172.31.40.0-255,66,291774,69,330424
9760,0.076045,74.125.68.0-255,2902,294676,69,330424
9761,0.076049,172.31.40.0-255,66,294742,69,330424
9762,0.078095,74.125.68.0-255,2902,297644,69,330424
9763,0.0781,172.31.40.0-255,66,297710,69,330424
9764,0.078147,74.125.68.0-255,1484,299194,69,330424
9765,0.078161,74.125.68.0-255,1484,300678,69,330424
9766,0.078164,172.31.40.0-255,66,300744,69,330424
9767,0.080214,74.125.68.0-255,2902,303646,69,330424
9768,0.080219,172.31.40.0-255,66,303712,69,330424
9769,0.080273,74.125.68.0-255,2902,306614,69,330424
9770,0.080277,172.31.40.0-255,66,306680,69,330424
9771,0.082347,74.125.68.0-255,2902,309582,69,330424
9772,0.082352,172.31.40.0-255,66,309648,69,330424
9773,0.082395,74.125.68.0-255,2902,312550,69,330424
9774,0.082398,172.31.40.0-255,66,312616,69,330424
9775,0.084465,74.125.68.0-255,2902,315518,69,330424
9776,0.08447,172.31.40.0-255,66,315584,69,330424
9777,0.084508,74.125.68.0-255,2902,318486,69,330424
9778,0.084512,172.31.40.0-255,66,318552,69,330424
9779,0.086594,74.125.68.0-255,2902,321454,69,330424
9780,0.086599,172.31.40.0-255,66,321520,69,330424
9781,0.086658,74.125.68.0-255,2902,324422,69,330424
9782,0.086661,172.31.40.0-255,66,324488,69,330424
9783,0.088713,74.125.68.0-255,2902,327390,69,330424
9784,0.088717,172.31.40.0-255,66,327456,69,330424
9785,0.088756,74.125.68.0-255,2902,330358,69,330424
9786,0.088759,172.31.40.0-255,66,330424,69,330424
9787,0.0,74.125.24.0-255,152,152,69,148331
9788,2.2e-05,172.31.40.0-255,66,218,69,148331
9789,2.8e-05,74.125.24.0-255,1484,1702,69,148331
9790,3.2e-05,172.31.40.0-255,66,1768,69,148331
9791,3.7e-05,74.125.24.0-255,2902,4670,69,148331
9792,4.1e-05,172.31.40.0-255,66,4736,69,148331
9793,4.4e-05,74.125.24.0-255,1484,6220,69,148331
9794,4.6e-05,172.31.40.0-255,66,6286,69,148331
9795,7.7e-05,74.125.24.0-255,5738,12024,69,148331
9796,8e-05,172.31.40.0-255,66,12090,69,148331
9797,0.000101,172.31.40.0-255,66,12156,69,148331
9798,0.000118,74.125.24.0-255,2074,14230,69,148331
9799,0.00012,172.31.40.0-255,66,14296,69,148331
9800,0.000131,172.31.40.0-255,66,14362,69,148331
9801,0.000155,74.125.24.0-255,5738,20100,69,148331
9802,0.000158,172.31.40.0-255,66,20166,69,148331
9803,0.00018,172.31.40.0-255,66,20232,69,148331
9804,0.000559,74.125.24.0-255,1484,21716,69,148331
9805,0.000563,172.31.40.0-255,66,21782,69,148331
9806,0.000569,74.125.24.0-255,2902,24684,69,148331
9807,0.000572,172.31.40.0-255,66,24750,69,148331
9808,0.000576,74.125.24.0-255,2902,27652,69,148331
9809,0.000579,172.31.40.0-255,66,27718,69,148331
9810,0.000598,74.125.24.0-255,2902,30620,69,148331
9811,0.000601,172.31.40.0-255,66,30686,69,148331
9812,0.000607,74.125.24.0-255,4320,35006,69,148331
9813,0.000609,172.31.40.0-255,66,35072,69,148331
9814,0.000629,74.125.24.0-255,3132,38204,69,148331
9815,0.000632,172.31.40.0-255,66,38270,69,148331
9816,0.000897,74.125.24.0-255,1484,39754,69,148331
9817,0.000902,74.125.24.0-255,1484,41238,69,148331
9818,0.000905,172.31.40.0-255,66,41304,69,148331
9819,0.000918,74.125.24.0-255,1484,42788,69,148331
9820,0.000946,74.125.24.0-255,5738,48526,69,148331
9821,0.000949,172.31.40.0-255,66,48592,69,148331
9822,0.000977,172.31.40.0-255,66,48658,69,148331
9823,0.000994,74.125.24.0-255,2902,51560,69,148331
9824,0.000996,172.31.40.0-255,66,51626,69,148331
9825,0.00101,74.125.24.0-255,2902,54528,69,148331
9826,0.001013,172.31.40.0-255,66,54594,69,148331
9827,0.00104,172.31.40.0-255,66,54660,69,148331
9828,0.001075,172.31.40.0-255,66,54726,69,148331
9829,0.001081,74.125.24.0-255,5738,60464,69,148331
9830,0.001084,172.31.40.0-255,66,60530,69,148331
9831,0.001121,74.125.24.0-255,5738,66268,69,148331
9832,0.001124,172.31.40.0-255,66,66334,69,148331
9833,0.001155,172.31.40.0-255,66,66400,69,148331
9834,0.001162,74.125.24.0-255,7156,73556,69,148331
9835,0.001165,172.31.40.0-255,66,73622,69,148331
9836,0.001203,172.31.40.0-255,66,73688,69,148331
9837,0.001208,74.125.24.0-255,5738,79426,69,148331
9838,0.00121,172.31.40.0-255,66,79492,69,148331
9839,0.001231,172.31.40.0-255,66,79558,69,148331
9840,0.001276,172.31.40.0-255,66,79624,69,148331
9841,0.001295,172.31.40.0-255,66,79690,69,148331
9842,0.0013,74.125.24.0-255,3602,83292,69,148331
9843,0.001302,172.31.40.0-255,66,83358,69,148331
9844,0.001329,172.31.40.0-255,66,83424,69,148331
9845,0.00136,172.31.40.0-255,66,83490,69,148331
9846,0.001372,172.31.40.0-255,66,83556,69,148331
9847,0.001394,74.125.24.0-255,3602,87158,69,148331
9848,0.001396,172.31.40.0-255,66,87224,69,148331
9849,0.001402,74.125.24.0-255,4320,91544,69,148331
9850,0.001404,172.31.40.0-255,66,91610,69,148331
9851,0.001454,172.31.40.0-255,66,91676,69,148331
9852,0.001464,172.31.40.0-255,66,91742,69,148331
9853,0.001476,172.31.40.0-255,66,91808,69,148331
9854,0.001557,172.31.40.0-255,66,91874,69,148331
9855,0.001577,172.31.40.0-255,66,91940,69,148331
9856,0.001583,74.125.24.0-255,6438,98378,69,148331
9857,0.001585,172.31.40.0-255,66,98444,69,148331
9858,0.001721,74.125.24.0-255,1484,99928,69,148331
9859,0.001725,74.125.24.0-255,1484,101412,69,148331
9860,0.001728,172.31.40.0-255,66,101478,69,148331
9861,0.00175,74.125.24.0-255,1484,102962,69,148331
9862,0.001758,74.125.24.0-255,5738,108700,69,148331
9863,0.001761,172.31.40.0-255,66,108766,69,148331
9864,0.001787,172.31.40.0-255,66,108832,69,148331
9865,0.001815,74.125.24.0-255,4320,113152,69,148331
9866,0.001817,172.31.40.0-255,66,113218,69,148331
9867,0.001824,74.125.24.0-255,7156,120374,69,148331
9868,0.001827,172.31.40.0-255,66,120440,69,148331
9869,0.001845,74.125.24.0-255,3602,124042,69,148331
9870,0.001848,172.31.40.0-255,66,124108,69,148331
9871,0.00189,74.125.24.0-255,4320,128428,69,148331
9872,0.001893,172.31.40.0-255,66,128494,69,148331
9873,0.0019,74.125.24.0-255,7156,135650,69,148331
9874,0.001903,172.31.40.0-255,66,135716,69,148331
9875,0.001934,172.31.40.0-255,66,135782,69,148331
9876,0.001954,74.125.24.0-255,2902,138684,69,148331
9877,0.001956,172.31.40.0-255,66,138750,69,148331
9878,0.001968,172.31.40.0-255,66,138816,69,148331
9879,0.002021,172.31.40.0-255,66,138882,69,148331
9880,0.002039,74.125.24.0-255,105,138987,69,148331
9881,0.008731,172.31.40.0-255,66,139053,69,148331
9882,0.008771,172.31.40.0-255,105,139158,69,148331
9883,0.010782,74.125.24.0-255,66,139224,69,148331
9884,0.034169,172.31.40.0-255,172,139396,69,148331
9885,0.034201,172.31.40.0-255,1116,140512,69,148331
9886,0.034266,172.31.40.0-255,1514,142026,69,148331
9887,0.034268,172.31.40.0-255,1514,143540,69,148331
9888,0.034274,172.31.40.0-255,1514,145054,69,148331
9889,0.034275,172.31.40.0-255,1514,146568,69,148331
9890,0.034306,172.31.40.0-255,1499,148067,69,148331
9891,0.035729,104.244.42.0-255,66,148133,69,148331
9892,0.03578,104.244.42.0-255,66,148199,69,148331
9893,0.035816,104.244.42.0-255,66,148265,69,148331
9894,0.035903,104.244.42.0-255,66,148331,69,148331
9895,0.0,74.125.200.0-255,146,146,69,401774
9896,2e-05,172.31.40.0-255,66,212,69,401774
9897,5.2e-05,74.125.200.0-255,1484,1696,69,401774
9898,5.6e-05,172.31.40.0-255,66,1762,69,401774
9899,6.1e-05,74.125.200.0-255,2902,4664,69,401774
9900,6.4e-05,172.31.40.0-255,66,4730,69,401774
9901,6.6e-05,74.125.200.0-255,1484,6214,69,401774
9902,6.8e-05,172.31.40.0-255,66,6280,69,401774
9903,0.000104,74.125.200.0-255,2902,9182,69,401774
9904,0.000106,172.31.40.0-255,66,9248,69,401774
9905,0.000112,74.125.200.0-255,4938,14186,69,401774
9906,0.000114,172.31.40.0-255,66,14252,69,401774
9907,0.00015,74.125.200.0-255,4320,18572,69,401774
9908,0.000152,172.31.40.0-255,66,18638,69,401774
9909,0.000176,74.125.200.0-255,5738,24376,69,401774
9910,0.000178,172.31.40.0-255,66,24442,69,401774
9911,0.000181,74.125.200.0-255,1484,25926,69,401774
9912,0.000183,172.31.40.0-255,66,25992,69,401774
9913,0.000204,74.125.200.0-255,2902,28894,69,401774
9914,0.000211,172.31.40.0-255,66,28960,69,401774
9915,0.000234,74.125.200.0-255,2543,31503,69,401774
9916,0.000236,172.31.40.0-255,66,31569,69,401774
9917,0.000368,74.125.200.0-255,1484,33053,69,401774
9918,0.000372,172.31.40.0-255,66,33119,69,401774
9919,0.000375,74.125.200.0-255,1484,34603,69,401774
9920,0.000377,172.31.40.0-255,66,34669,69,401774
9921,0.000417,74.125.200.0-255,2902,37571,69,401774
9922,0.000421,172.31.40.0-255,66,37637,69,401774
9923,0.000427,74.125.200.0-255,5738,43375,69,401774
9924,0.000429,172.31.40.0-255,66,43441,69,401774
9925,0.000431,74.125.200.0-255,1484,44925,69,401774
9926,0.000437,172.31.40.0-255,66,44991,69,401774
9927,0.000441,74.125.200.0-255,1484,46475,69,401774
9928,0.000462,74.125.200.0-255,1484,47959,69,401774
9929,0.000464,172.31.40.0-255,66,48025,69,401774
9930,0.000471,74.125.200.0-255,1125,49150,69,401774
9931,0.000769,74.125.200.0-255,1484,50634,69,401774
9932,0.000773,172.31.40.0-255,66,50700,69,401774
9933,0.000791,74.125.200.0-255,2902,53602,69,401774
9934,0.000794,172.31.40.0-255,66,53668,69,401774
9935,0.000815,74.125.200.0-255,1484,55152,69,401774
9936,0.000825,74.125.200.0-255,1484,56636,69,401774
9937,0.000827,172.31.40.0-255,66,56702,69,401774
9938,0.00083,74.125.200.0-255,1484,58186,69,401774
9939,0.000858,74.125.200.0-255,2902,61088,69,401774
9940,0.00086,172.31.40.0-255,66,61154,69,401774
9941,0.000866,74.125.200.0-255,5379,66533,69,401774
9942,0.000867,172.31.40.0-255,66,66599,69,401774
9943,0.000995,74.125.200.0-255,1484,68083,69,401774
9944,0.001036,74.125.200.0-255,1484,69567,69,401774
9945,0.001039,172.31.40.0-255,66,69633,69,401774
9946,0.001065,74.125.200.0-255,1484,71117,69,401774
9947,0.001068,74.125.200.0-255,1484,72601,69,401774
9948,0.00107,172.31.40.0-255,66,72667,69,401774
9949,0.001074,74.125.200.0-255,2902,75569,69,401774
9950,0.001076,172.31.40.0-255,66,75635,69,401774
9951,0.001082,74.125.200.0-255,5738,81373,69,401774
9952,0.001087,172.31.40.0-255,66,81439,69,401774
9953,0.001091,74.125.200.0-255,2543,83982,69,401774
9954,0.001093,172.31.40.0-255,66,84048,69,401774
9955,0.001125,74.125.200.0-255,2902,86950,69,401774
9956,0.001128,172.31.40.0-255,66,87016,69,401774
9957,0.001154,74.125.200.0-255,7156,94172,69,401774
9958,0.001157,172.31.40.0-255,66,94238,69,401774
9959,0.001203,172.31.40.0-255,66,94304,69,401774
9960,0.001209,74.125.200.0-255,5738,100042,69,401774
9961,0.001212,172.31.40.0-255,66,100108,69,401774
9962,0.001245,74.125.200.0-255,7156,107264,69,401774
9963,0.001248,172.31.40.0-255,66,107330,69,401774
9964,0.001252,74.125.200.0-255,2170,109500,69,401774
9965,0.001254,172.31.40.0-255,66,109566,69,401774
9966,0.001339,74.125.200.0-255,1484,111050,69,401774
9967,0.001354,74.125.200.0-255,2902,113952,69,401774
9968,0.001358,172.31.40.0-255,66,114018,69,401774
9969,0.001387,74.125.200.0-255,5738,119756,69,401774
9970,0.001391,172.31.40.0-255,66,119822,69,401774
9971,0.001397,74.125.200.0-255,2902,122724,69,401774
9972,0.001398,172.31.40.0-255,66,122790,69,401774
9973,0.001422,74.125.200.0-255,2902,125692,69,401774
9974,0.001429,172.31.40.0-255,66,125758,69,401774
9975,0.001461,74.125.200.0-255,4320,130078,69,401774
9976,0.001465,172.31.40.0-255,66,130144,69,401774
9977,0.001491,74.125.200.0-255,2902,133046,69,401774
9978,0.001496,74.125.200.0-255,4320,137366,69,401774
9979,0.0015,172.31.40.0-255,66,137432,69,401774
9980,0.001503,172.31.40.0-255,66,137498,69,401774
9981,0.001519,74.125.200.0-255,4320,141818,69,401774
9982,0.001522,172.31.40.0-255,66,141884,69,401774
9983,0.001526,74.125.200.0-255,2184,144068,69,401774
9984,0.001528,172.31.40.0-255,66,144134,69,401774
9985,0.001623,74.125.200.0-255,1484,145618,69,401774
9986,0.001627,74.125.200.0-255,1484,147102,69,401774
9987,0.00163,172.31.40.0-255,66,147168,69,401774
9988,0.001658,74.125.200.0-255,1484,148652,69,401774
9989,0.001662,74.125.200.0-255,1484,150136,69,401774
9990,0.001664,172.31.40.0-255,66,150202,69,401774
9991,0.001669,74.125.200.0-255,2902,153104,69,401774
9992,0.001671,172.31.40.0-255,66,153170,69,401774
9993,0.001705,74.125.200.0-255,5738,158908,69,401774
9994,0.001709,172.31.40.0-255,66,158974,69,401774
9995,0.001713,74.125.200.0-255,2902,161876,69,401774
9996,0.001715,172.31.40.0-255,66,161942,69,401774
9997,0.001719,74.125.200.0-255,2902,164844,69,401774
9998,0.001721,172.31.40.0-255,66,164910,69,401774
9999,0.001748,74.125.200.0-255,1484,166394,69,401774
10000,0.001751,74.125.200.0-255,1484,167878,69,401774
10001,0.001753,172.31.40.0-255,66,167944,69,401774
10002,0.001773,74.125.200.0-255,7156,175100,69,401774
10003,0.001776,172.31.40.0-255,66,175166,69,401774
10004,0.001818,74.125.200.0-255,3602,178768,69,401774
10005,0.001821,172.31.40.0-255,66,178834,69,401774
10006,0.001846,74.125.200.0-255,4320,183154,69,401774
10007,0.001849,172.31.40.0-255,66,183220,69,401774
10008,0.001853,74.125.200.0-255,2902,186122,69,401774
10009,0.001855,172.31.40.0-255,66,186188,69,401774
10010,0.001885,74.125.200.0-255,4320,190508,69,401774
10011,0.001889,172.31.40.0-255,66,190574,69,401774
10012,0.001922,74.125.200.0-255,7156,197730,69,401774
10013,0.001926,172.31.40.0-255,66,197796,69,401774
10014,0.001975,74.125.200.0-255,2902,200698,69,401774
10015,0.001977,172.31.40.0-255,66,200764,69,401774
10016,0.001983,74.125.200.0-255,4320,205084,69,401774
10017,0.001985,172.31.40.0-255,66,205150,69,401774
10018,0.002021,172.31.40.0-255,66,205216,69,401774
10019,0.002071,74.125.200.0-255,1484,206700,69,401774
10020,0.002086,74.125.200.0-255,2902,209602,69,401774
10021,0.002092,172.31.40.0-255,66,209668,69,401774
10022,0.002127,74.125.200.0-255,4320,213988,69,401774
10023,0.002132,74.125.200.0-255,2902,216890,69,401774
10024,0.002135,172.31.40.0-255,66,216956,69,401774
10025,0.002138,172.31.40.0-255,66,217022,69,401774
10026,0.002159,74.125.200.0-255,2902,219924,69,401774
10027,0.002161,172.31.40.0-255,66,219990,69,401774
10028,0.002165,74.125.200.0-255,2902,222892,69,401774
10029,0.002168,172.31.40.0-255,66,222958,69,401774
10030,0.002204,172.31.40.0-255,66,223024,69,401774
10031,0.002214,74.125.200.0-255,4320,227344,69,401774
10032,0.002217,172.31.40.0-255,66,227410,69,401774
10033,0.002222,74.125.200.0-255,3602,231012,69,401774
10034,0.002224,172.31.40.0-255,66,231078,69,401774
10035,0.004505,74.125.200.0-255,1484,232562,69,401774
10036,0.004532,74.125.200.0-255,4320,236882,69,401774
10037,0.004538,172.31.40.0-255,66,236948,69,401774
10038,0.006848,74.125.200.0-255,4320,241268,69,401774
10039,0.006852,172.31.40.0-255,66,241334,69,401774
10040,0.006878,74.125.200.0-255,1484,242818,69,401774
10041,0.009147,74.125.200.0-255,4320,247138,69,401774
10042,0.009154,172.31.40.0-255,66,247204,69,401774
10043,0.011458,74.125.200.0-255,5738,252942,69,401774
10044,0.011466,172.31.40.0-255,66,253008,69,401774
10045,0.0138,74.125.200.0-255,2902,255910,69,401774
10046,0.013811,172.31.40.0-255,66,255976,69,401774
10047,0.01385,74.125.200.0-255,2902,258878,69,401774
10048,0.013852,172.31.40.0-255,66,258944,69,401774
10049,0.016117,74.125.200.0-255,2902,261846,69,401774
10050,0.016126,172.31.40.0-255,66,261912,69,401774
10051,0.016151,74.125.200.0-255,2902,264814,69,401774
10052,0.016154,172.31.40.0-255,66,264880,69,401774
10053,0.018435,74.125.200.0-255,2902,267782,69,401774
10054,0.018443,172.31.40.0-255,66,267848,69,401774
10055,0.018473,74.125.200.0-255,2902,270750,69,401774
10056,0.018476,172.31.40.0-255,66,270816,69,401774
10057,0.020739,74.125.200.0-255,2902,273718,69,401774
10058,0.020745,172.31.40.0-255,66,273784,69,401774
10059,0.020774,74.125.200.0-255,2902,276686,69,401774
10060,0.020777,172.31.40.0-255,66,276752,69,401774
10061,0.02306,74.125.200.0-255,5738,282490,69,401774
10062,0.023067,172.31.40.0-255,66,282556,69,401774
10063,0.025373,74.125.200.0-255,5738,288294,69,401774
10064,0.025379,172.31.40.0-255,66,288360,69,401774
10065,0.02771,74.125.200.0-255,5738,294098,69,401774
10066,0.027718,172.31.40.0-255,66,294164,69,401774
10067,0.030017,74.125.200.0-255,2902,297066,69,401774
10068,0.030026,172.31.40.0-255,66,297132,69,401774
10069,0.030071,74.125.200.0-255,2902,300034,69,401774
10070,0.030075,172.31.40.0-255,66,300100,69,401774
10071,0.032328,74.125.200.0-255,2902,303002,69,401774
10072,0.032336,172.31.40.0-255,66,303068,69,401774
10073,0.03236,74.125.200.0-255,2902,305970,69,401774
10074,0.032363,172.31.40.0-255,66,306036,69,401774
10075,0.034319,172.31.40.0-255,172,306208,69,401774
10076,0.034351,172.31.40.0-255,1114,307322,69,401774
10077,0.034406,172.31.40.0-255,563,307885,69,401774
10078,0.034648,74.125.200.0-255,4320,312205,69,401774
10079,0.034655,172.31.40.0-255,66,312271,69,401774
10080,0.034683,74.125.200.0-255,1484,313755,69,401774
10081,0.035853,104.244.42.0-255,66,313821,69,401774
10082,0.035899,104.244.42.0-255,66,313887,69,401774
10083,0.035949,104.244.42.0-255,66,313953,69,401774
10084,0.03696,74.125.200.0-255,4320,318273,69,401774
10085,0.036967,172.31.40.0-255,66,318339,69,401774
10086,0.03928,74.125.200.0-255,5738,324077,69,401774
10087,0.039286,172.31.40.0-255,66,324143,69,401774
10088,0.041593,74.125.200.0-255,5738,329881,69,401774
10089,0.0416,172.31.40.0-255,66,329947,69,401774
10090,0.043907,74.125.200.0-255,5738,335685,69,401774
10091,0.043914,172.31.40.0-255,66,335751,69,401774
10092,0.046238,74.125.200.0-255,5738,341489,69,401774
10093,0.046243,172.31.40.0-255,66,341555,69,401774
10094,0.048551,74.125.200.0-255,5738,347293,69,401774
10095,0.048558,172.31.40.0-255,66,347359,69,401774
10096,0.050874,74.125.200.0-255,5738,353097,69,401774
10097,0.050881,172.31.40.0-255,66,353163,69,401774
10098,0.053186,74.125.200.0-255,5738,358901,69,401774
10099,0.053192,172.31.40.0-255,66,358967,69,401774
10100,0.055535,74.125.200.0-255,5738,364705,69,401774
10101,0.055542,172.31.40.0-255,66,364771,69,401774
10102,0.05784,74.125.200.0-255,5738,370509,69,401774
10103,0.057847,172.31.40.0-255,66,370575,69,401774
10104,0.060159,74.125.200.0-255,5738,376313,69,401774
10105,0.060166,172.31.40.0-255,66,376379,69,401774
10106,0.062471,74.125.200.0-255,5738,382117,69,401774
10107,0.062478,172.31.40.0-255,66,382183,69,401774
10108,0.064798,74.125.200.0-255,5738,387921,69,401774
10109,0.064804,172.31.40.0-255,66,387987,69,401774
10110,0.067109,74.125.200.0-255,5738,393725,69,401774
10111,0.067116,172.31.40.0-255,66,393791,69,401774
10112,0.069428,74.125.200.0-255,5738,399529,69,401774
10113,0.069435,172.31.40.0-255,66,399595,69,401774
10114,0.071741,74.125.200.0-255,1942,401537,69,401774
10115,0.071747,172.31.40.0-255,66,401603,69,401774
10116,0.071886,172.31.40.0-255,105,401708,69,401774
10117,0.074166,74.125.200.0-255,66,401774,69,401774
10118,0.0,74.125.24.0-255,153,153,69,134991
10119,2.3e-05,172.31.40.0-255,66,219,69,134991
10120,3e-05,74.125.24.0-255,1484,1703,69,134991
10121,3.5e-05,172.31.40.0-255,66,1769,69,134991
10122,4.1e-05,74.125.24.0-255,2902,4671,69,134991
10123,5.2e-05,172.31.40.0-255,66,4737,69,134991
10124,6e-05,74.125.24.0-255,7156,11893,69,134991
10125,6.3e-05,172.31.40.0-255,66,11959,69,134991
10126,0.000111,172.31.40.0-255,66,12025,69,134991
10127,0.000124,172.31.40.0-255,66,12091,69,134991
10128,0.000149,74.125.24.0-255,4320,16411,69,134991
10129,0.000151,172.31.40.0-255,66,16477,69,134991
10130,0.000189,172.31.40.0-255,66,16543,69,134991
10131,0.000218,172.31.40.0-255,66,16609,69,134991
10132,0.000318,74.125.24.0-255,1484,18093,69,134991
10133,0.000322,172.31.40.0-255,66,18159,69,134991
10134,0.000328,74.125.24.0-255,2902,21061,69,134991
10135,0.00033,172.31.40.0-255,66,21127,69,134991
10136,0.000358,74.125.24.0-255,5738,26865,69,134991
10137,0.000362,172.31.40.0-255,66,26931,69,134991
10138,0.000395,172.31.40.0-255,66,26997,69,134991
10139,0.000425,74.125.24.0-255,2902,29899,69,134991
10140,0.000428,172.31.40.0-255,66,29965,69,134991
10141,0.000441,172.31.40.0-255,66,30031,69,134991
10142,0.000551,74.125.24.0-255,1484,31515,69,134991
10143,0.000556,172.31.40.0-255,66,31581,69,134991
10144,0.000561,74.125.24.0-255,2902,34483,69,134991
10145,0.000564,172.31.40.0-255,66,34549,69,134991
10146,0.00057,74.125.24.0-255,5738,40287,69,134991
10147,0.000577,172.31.40.0-255,66,40353,69,134991
10148,0.00058,74.125.24.0-255,1484,41837,69,134991
10149,0.000627,172.31.40.0-255,66,41903,69,134991
10150,0.000639,172.31.40.0-255,66,41969,69,134991
10151,0.000723,74.125.24.0-255,1484,43453,69,134991
10152,0.000728,74.125.24.0-255,2902,46355,69,134991
10153,0.000733,172.31.40.0-255,66,46421,69,134991
10154,0.000754,74.125.24.0-255,5738,52159,69,134991
10155,0.000757,172.31.40.0-255,66,52225,69,134991
10156,0.000769,172.31.40.0-255,66,52291,69,134991
10157,0.000805,172.31.40.0-255,66,52357,69,134991
10158,0.00084,172.31.40.0-255,66,52423,69,134991
10159,0.000863,172.31.40.0-255,66,52489,69,134991
10160,0.000893,172.31.40.0-255,66,52555,69,134991
10161,0.000997,74.125.24.0-255,1484,54039,69,134991
10162,0.001002,74.125.24.0-255,2902,56941,69,134991
10163,0.001012,172.31.40.0-255,66,57007,69,134991
10164,0.001032,74.125.24.0-255,5738,62745,69,134991
10165,0.00104,74.125.24.0-255,5738,68483,69,134991
10166,0.001046,172.31.40.0-255,66,68549,69,134991
10167,0.001075,74.125.24.0-255,7156,75705,69,134991
10168,0.001104,172.31.40.0-255,66,75771,69,134991
10169,0.001145,74.125.24.0-255,1484,77255,69,134991
10170,0.001169,74.125.24.0-255,2902,80157,69,134991
10171,0.001173,74.125.24.0-255,2902,83059,69,134991
10172,0.001179,172.31.40.0-255,66,83125,69,134991
10173,0.001204,74.125.24.0-255,2902,86027,69,134991
10174,0.001283,74.125.24.0-255,1484,87511,69,134991
10175,0.001398,74.125.24.0-255,4320,91831,69,134991
10176,0.00147,74.125.24.0-255,5020,96851,69,134991
10177,0.001472,74.125.24.0-255,1484,98335,69,134991
10178,0.001477,74.125.24.0-255,2902,101237,69,134991
10179,0.001497,74.125.24.0-255,5738,106975,69,134991
10180,0.001504,74.125.24.0-255,5738,112713,69,134991
10181,0.001536,74.125.24.0-255,7156,119869,69,134991
10182,0.001589,74.125.24.0-255,5738,125607,69,134991
10183,0.001627,74.125.24.0-255,105,125712,69,134991
10184,0.001876,172.31.40.0-255,66,125778,69,134991
10185,0.004843,172.31.40.0-255,105,125883,69,134991
10186,0.007122,74.125.24.0-255,66,125949,69,134991
10187,0.033511,172.31.40.0-255,172,126121,69,134991
10188,0.033554,172.31.40.0-255,1114,127235,69,134991
10189,0.033642,172.31.40.0-255,1514,128749,69,134991
10190,0.033644,172.31.40.0-255,1514,130263,69,134991
10191,0.033645,172.31.40.0-255,1514,131777,69,134991
10192,0.033649,172.31.40.0-255,1514,133291,69,134991
10193,0.033651,172.31.40.0-255,1502,134793,69,134991
10194,0.035066,104.244.42.0-255,66,134859,69,134991
10195,0.035154,104.244.42.0-255,66,134925,69,134991
10196,0.035251,104.244.42.0-255,66,134991,69,134991
10197,0.0,172.217.26.0-255,151,151,69,384950
10198,1.9e-05,172.31.40.0-255,66,217,69,384950
10199,2.5e-05,172.217.26.0-255,1484,1701,69,384950
10200,3e-05,172.31.40.0-255,66,1767,69,384950
10201,3.3e-05,172.217.26.0-255,1484,3251,69,384950
10202,3.6e-05,172.31.40.0-255,66,3317,69,384950
10203,3.9e-05,172.217.26.0-255,1484,4801,69,384950
10204,4.2e-05,172.31.40.0-255,66,4867,69,384950
10205,7e-05,172.217.26.0-255,1484,6351,69,384950
10206,7.2e-05,172.31.40.0-255,66,6417,69,384950
10207,7.9e-05,172.217.26.0-255,5738,12155,69,384950
10208,8.2e-05,172.31.40.0-255,66,12221,69,384950
10209,8.7e-05,172.217.26.0-255,3482,15703,69,384950
10210,8.9e-05,172.31.40.0-255,66,15769,69,384950
10211,9.3e-05,172.217.26.0-255,4320,20089,69,384950
10212,9.6e-05,172.31.40.0-255,66,20155,69,384950
10213,0.000102,172.217.26.0-255,5738,25893,69,384950
10214,0.000104,172.31.40.0-255,66,25959,69,384950
10215,0.000128,172.217.26.0-255,4320,30279,69,384950
10216,0.00013,172.31.40.0-255,66,30345,69,384950
10217,0.000133,172.217.26.0-255,1125,31470,69,384950
10218,0.000134,172.31.40.0-255,66,31536,69,384950
10219,0.000204,172.217.26.0-255,1484,33020,69,384950
10220,0.000208,172.31.40.0-255,66,33086,69,384950
10221,0.000212,172.217.26.0-255,2902,35988,69,384950
10222,0.000214,172.31.40.0-255,66,36054,69,384950
10223,0.000219,172.217.26.0-255,4320,40374,69,384950
10224,0.000221,172.31.40.0-255,66,40440,69,384950
10225,0.000243,172.217.26.0-255,1484,41924,69,384950
10226,0.000245,172.31.40.0-255,66,41990,69,384950
10227,0.000252,172.217.26.0-255,6797,48787,69,384950
10228,0.000254,172.31.40.0-255,66,48853,69,384950
10229,0.000284,172.31.40.0-255,66,48919,69,384950
10230,0.000287,172.217.26.0-255,2543,51462,69,384950
10231,0.000289,172.31.40.0-255,66,51528,69,384950
10232,0.000361,172.217.26.0-255,395,51923,69,384950
10233,0.000841,172.31.40.0-255,66,51989,69,384950
10234,0.001032,172.217.26.0-255,113,52102,69,384950
10235,0.00114,172.217.26.0-255,1484,53586,69,384950
10236,0.001145,172.31.40.0-255,66,53652,69,384950
10237,0.00115,172.217.26.0-255,2902,56554,69,384950
10238,0.001152,172.31.40.0-255,66,56620,69,384950
10239,0.001171,172.217.26.0-255,5738,62358,69,384950
10240,0.001172,172.31.40.0-255,66,62424,69,384950
10241,0.001197,172.217.26.0-255,6797,69221,69,384950
10242,0.001199,172.31.40.0-255,66,69287,69,384950
10243,0.001233,172.217.26.0-255,2902,72189,69,384950
10244,0.001235,172.31.40.0-255,66,72255,69,384950
10245,0.00125,172.217.26.0-255,4320,76575,69,384950
10246,0.001252,172.31.40.0-255,66,76641,69,384950
10247,0.001262,172.31.40.0-255,66,76707,69,384950
10248,0.001264,172.217.26.0-255,1125,77832,69,384950
10249,0.001379,172.217.26.0-255,1484,79316,69,384950
10250,0.001384,172.31.40.0-255,66,79382,69,384950
10251,0.001401,172.217.26.0-255,2902,82284,69,384950
10252,0.001403,172.31.40.0-255,66,82350,69,384950
10253,0.001406,172.217.26.0-255,1484,83834,69,384950
10254,0.001427,172.217.26.0-255,4320,88154,69,384950
10255,0.001429,172.31.40.0-255,66,88220,69,384950
10256,0.001456,172.31.40.0-255,66,88286,69,384950
10257,0.001463,172.217.26.0-255,5738,94024,69,384950
10258,0.001465,172.31.40.0-255,66,94090,69,384950
10259,0.001498,172.217.26.0-255,4320,98410,69,384950
10260,0.001501,172.31.40.0-255,66,98476,69,384950
10261,0.001507,172.217.26.0-255,5020,103496,69,384950
10262,0.001509,172.31.40.0-255,66,103562,69,384950
10263,0.00154,172.217.26.0-255,1484,105046,69,384950
10264,0.00157,172.217.26.0-255,1484,106530,69,384950
10265,0.001573,172.31.40.0-255,66,106596,69,384950
10266,0.00158,172.217.26.0-255,4320,110916,69,384950
10267,0.001582,172.31.40.0-255,66,110982,69,384950
10268,0.001593,172.31.40.0-255,66,111048,69,384950
10269,0.001595,172.217.26.0-255,1484,112532,69,384950
10270,0.001616,172.217.26.0-255,5738,118270,69,384950
10271,0.001619,172.31.40.0-255,66,118336,69,384950
10272,0.001629,172.31.40.0-255,66,118402,69,384950
10273,0.00165,172.217.26.0-255,2184,120586,69,384950
10274,0.001653,172.31.40.0-255,66,120652,69,384950
10275,0.003556,172.217.26.0-255,2902,123554,69,384950
10276,0.003561,172.31.40.0-255,66,123620,69,384950
10277,0.00358,172.217.26.0-255,2902,126522,69,384950
10278,0.003582,172.31.40.0-255,66,126588,69,384950
10279,0.005512,172.217.26.0-255,2902,129490,69,384950
10280,0.005515,172.31.40.0-255,66,129556,69,384950
10281,0.005534,172.217.26.0-255,2902,132458,69,384950
10282,0.005536,172.31.40.0-255,66,132524,69,384950
10283,0.007594,172.217.26.0-255,5738,138262,69,384950
10284,0.007601,172.31.40.0-255,66,138328,69,384950
10285,0.009544,172.217.26.0-255,5738,144066,69,384950
10286,0.009552,172.31.40.0-255,66,144132,69,384950
10287,0.011491,172.217.26.0-255,5738,149870,69,384950
10288,0.011498,172.31.40.0-255,66,149936,69,384950
10289,0.013438,172.217.26.0-255,5738,155674,69,384950
10290,0.013445,172.31.40.0-255,66,155740,69,384950
10291,0.015386,172.217.26.0-255,5738,161478,69,384950
10292,0.015393,172.31.40.0-255,66,161544,69,384950
10293,0.017335,172.217.26.0-255,5738,167282,69,384950
10294,0.017344,172.31.40.0-255,66,167348,69,384950
10295,0.019293,172.217.26.0-255,5738,173086,69,384950
10296,0.019301,172.31.40.0-255,66,173152,69,384950
10297,0.021257,172.217.26.0-255,5738,178890,69,384950
10298,0.021264,172.31.40.0-255,66,178956,69,384950
10299,0.023206,172.217.26.0-255,5738,184694,69,384950
10300,0.023213,172.31.40.0-255,66,184760,69,384950
10301,0.025157,172.217.26.0-255,5738,190498,69,384950
10302,0.025163,172.31.40.0-255,66,190564,69,384950
10303,0.027105,172.217.26.0-255,5738,196302,69,384950
10304,0.027114,172.31.40.0-255,66,196368,69,384950
10305,0.029064,172.217.26.0-255,5738,202106,69,384950
10306,0.029071,172.31.40.0-255,66,202172,69,384950
10307,0.031034,172.217.26.0-255,5738,207910,69,384950
10308,0.031042,172.31.40.0-255,66,207976,69,384950
10309,0.033005,172.217.26.0-255,5738,213714,69,384950
10310,0.033013,172.31.40.0-255,66,213780,69,384950
10311,0.034136,172.31.40.0-255,172,213952,69,384950
10312,0.034167,172.31.40.0-255,1114,215066,69,384950
10313,0.034231,172.31.40.0-255,1514,216580,69,384950
10314,0.034233,172.31.40.0-255,1514,218094,69,384950
10315,0.034234,172.31.40.0-255,1514,219608,69,384950
10316,0.034239,172.31.40.0-255,1514,221122,69,384950
10317,0.03424,172.31.40.0-255,1502,222624,69,384950
10318,0.034971,172.217.26.0-255,5738,228362,69,384950
10319,0.034978,172.31.40.0-255,66,228428,69,384950
10320,0.035709,104.244.42.0-255,66,228494,69,384950
10321,0.035829,104.244.42.0-255,66,228560,69,384950
10322,0.035835,104.244.42.0-255,66,228626,69,384950
10323,0.036924,172.217.26.0-255,5738,234364,69,384950
10324,0.036932,172.31.40.0-255,66,234430,69,384950
10325,0.038869,172.217.26.0-255,5738,240168,69,384950
10326,0.038879,172.31.40.0-255,66,240234,69,384950
10327,0.040814,172.217.26.0-255,5738,245972,69,384950
10328,0.040821,172.31.40.0-255,66,246038,69,384950
10329,0.04276,172.217.26.0-255,5738,251776,69,384950
10330,0.042767,172.31.40.0-255,66,251842,69,384950
10331,0.044723,172.217.26.0-255,5738,257580,69,384950
10332,0.044734,172.31.40.0-255,66,257646,69,384950
10333,0.04668,172.217.26.0-255,5738,263384,69,384950
10334,0.046686,172.31.40.0-255,66,263450,69,384950
10335,0.048643,172.217.26.0-255,5738,269188,69,384950
10336,0.04865,172.31.40.0-255,66,269254,69,384950
10337,0.050601,172.217.26.0-255,5738,274992,69,384950
10338,0.050608,172.31.40.0-255,66,275058,69,384950
10339,0.052566,172.217.26.0-255,5738,280796,69,384950
10340,0.052572,172.31.40.0-255,66,280862,69,384950
10341,0.054522,172.217.26.0-255,5738,286600,69,384950
10342,0.054528,172.31.40.0-255,66,286666,69,384950
10343,0.056471,172.217.26.0-255,5738,292404,69,384950
10344,0.056477,172.31.40.0-255,66,292470,69,384950
10345,0.058413,172.217.26.0-255,5738,298208,69,384950
10346,0.058419,172.31.40.0-255,66,298274,69,384950
10347,0.060365,172.217.26.0-255,5738,304012,69,384950
10348,0.060372,172.31.40.0-255,66,304078,69,384950
10349,0.06234,172.217.26.0-255,5738,309816,69,384950
10350,0.062346,172.31.40.0-255,66,309882,69,384950
10351,0.064302,172.217.26.0-255,5738,315620,69,384950
10352,0.06431,172.31.40.0-255,66,315686,69,384950
10353,0.06629,172.217.26.0-255,5738,321424,69,384950
10354,0.066296,172.31.40.0-255,66,321490,69,384950
10355,0.068282,172.217.26.0-255,5738,327228,69,384950
10356,0.068288,172.31.40.0-255,66,327294,69,384950
10357,0.070241,172.217.26.0-255,5738,333032,69,384950
10358,0.070248,172.31.40.0-255,66,333098,69,384950
10359,0.072204,172.217.26.0-255,5738,338836,69,384950
10360,0.07221,172.31.40.0-255,66,338902,69,384950
10361,0.07416,172.217.26.0-255,5738,344640,69,384950
10362,0.074167,172.31.40.0-255,66,344706,69,384950
10363,0.076109,172.217.26.0-255,5738,350444,69,384950
10364,0.076116,172.31.40.0-255,66,350510,69,384950
10365,0.078059,172.217.26.0-255,5738,356248,69,384950
10366,0.078065,172.31.40.0-255,66,356314,69,384950
10367,0.080021,172.217.26.0-255,5738,362052,69,384950
10368,0.080026,172.31.40.0-255,66,362118,69,384950
10369,0.081994,172.217.26.0-255,5738,367856,69,384950
10370,0.082,172.31.40.0-255,66,367922,69,384950
10371,0.083947,172.217.26.0-255,5738,373660,69,384950
10372,0.083954,172.31.40.0-255,66,373726,69,384950
10373,0.085904,172.217.26.0-255,5738,379464,69,384950
10374,0.085911,172.31.40.0-255,66,379530,69,384950
10375,0.087862,172.217.26.0-255,5183,384713,69,384950
10376,0.08787,172.31.40.0-255,66,384779,69,384950
10377,0.088069,172.31.40.0-255,105,384884,69,384950
10378,0.089976,172.217.26.0-255,66,384950,69,384950
10379,0.0,142.250.4.0-255,146,146,69,174687
10380,1.6e-05,172.31.40.0-255,66,212,69,174687
10381,2.2e-05,142.250.4.0-255,1484,1696,69,174687
10382,2.6e-05,172.31.40.0-255,66,1762,69,174687
10383,3.1e-05,142.250.4.0-255,2902,4664,69,174687
10384,4e-05,172.31.40.0-255,66,4730,69,174687
10385,4.3e-05,142.250.4.0-255,1484,6214,69,174687
10386,4.6e-05,172.31.40.0-255,66,6280,69,174687
10387,6.4e-05,142.250.4.0-255,5738,12018,69,174687
10388,6.6e-05,172.31.40.0-255,66,12084,69,174687
10389,7.3e-05,142.250.4.0-255,2095,14179,69,174687
10390,7.5e-05,172.31.40.0-255,66,14245,69,174687
10391,0.000109,172.31.40.0-255,66,14311,69,174687
10392,0.000114,142.250.4.0-255,5379,19690,69,174687
10393,0.000117,172.31.40.0-255,66,19756,69,174687
10394,0.000215,142.250.4.0-255,1484,21240,69,174687
10395,0.000218,172.31.40.0-255,66,21306,69,174687
10396,0.000222,142.250.4.0-255,2902,24208,69,174687
10397,0.000225,172.31.40.0-255,66,24274,69,174687
10398,0.000229,142.250.4.0-255,2902,27176,69,174687
10399,0.00023,172.31.40.0-255,66,27242,69,174687
10400,0.000258,142.250.4.0-255,2902,30144,69,174687
10401,0.000261,172.31.40.0-255,66,30210,69,174687
10402,0.000277,172.31.40.0-255,66,30276,69,174687
10403,0.000286,172.31.40.0-255,66,30342,69,174687
10404,0.000316,142.250.4.0-255,2482,32824,69,174687
10405,0.000322,172.31.40.0-255,66,32890,69,174687
10406,0.000362,142.250.4.0-255,380,33270,69,174687
10407,0.000364,172.31.40.0-255,66,33336,69,174687
10408,0.000701,142.250.4.0-255,1484,34820,69,174687
10409,0.000706,172.31.40.0-255,66,34886,69,174687
10410,0.000712,142.250.4.0-255,2902,37788,69,174687
10411,0.000714,172.31.40.0-255,66,37854,69,174687
10412,0.000764,142.250.4.0-255,4320,42174,69,174687
10413,0.000767,172.31.40.0-255,66,42240,69,174687
10414,0.000774,142.250.4.0-255,5738,47978,69,174687
10415,0.000776,172.31.40.0-255,66,48044,69,174687
10416,0.000793,172.31.40.0-255,66,48110,69,174687
10417,0.0008,142.250.4.0-255,5738,53848,69,174687
10418,0.000803,172.31.40.0-255,66,53914,69,174687
10419,0.000828,142.250.4.0-255,2184,56098,69,174687
10420,0.000831,172.31.40.0-255,66,56164,69,174687
10421,0.000962,142.250.4.0-255,1484,57648,69,174687
10422,0.00097,172.31.40.0-255,66,57714,69,174687
10423,0.000975,142.250.4.0-255,2902,60616,69,174687
10424,0.000978,172.31.40.0-255,66,60682,69,174687
10425,0.000981,142.250.4.0-255,1484,62166,69,174687
10426,0.000983,172.31.40.0-255,66,62232,69,174687
10427,0.001005,142.250.4.0-255,4320,66552,69,174687
10428,0.00101,172.31.40.0-255,66,66618,69,174687
10429,0.001045,172.31.40.0-255,66,66684,69,174687
10430,0.001081,142.250.4.0-255,4320,71004,69,174687
10431,0.001115,142.250.4.0-255,1484,72488,69,174687
10432,0.001132,142.250.4.0-255,2902,75390,69,174687
10433,0.001151,142.250.4.0-255,5020,80410,69,174687
10434,0.001161,172.31.40.0-255,66,80476,69,174687
10435,0.001279,142.250.4.0-255,1484,81960,69,174687
10436,0.001293,142.250.4.0-255,2902,84862,69,174687
10437,0.001295,142.250.4.0-255,1484,86346,69,174687
10438,0.001312,142.250.4.0-255,4320,90666,69,174687
10439,0.001321,172.31.40.0-255,66,90732,69,174687
10440,0.001351,172.31.40.0-255,66,90798,69,174687
10441,0.001359,142.250.4.0-255,2902,93700,69,174687
10442,0.001363,142.250.4.0-255,4320,98020,69,174687
10443,0.001384,142.250.4.0-255,4320,102340,69,174687
10444,0.001389,142.250.4.0-255,2184,104524,69,174687
10445,0.001404,172.31.40.0-255,66,104590,69,174687
10446,0.001563,142.250.4.0-255,1484,106074,69,174687
10447,0.001569,142.250.4.0-255,2902,108976,69,174687
10448,0.001571,172.31.40.0-255,66,109042,69,174687
10449,0.001575,142.250.4.0-255,1484,110526,69,174687
10450,0.001603,142.250.4.0-255,4320,114846,69,174687
10451,0.001608,142.250.4.0-255,4320,119166,69,174687
10452,0.001611,142.250.4.0-255,2902,122068,69,174687
10453,0.00162,172.31.40.0-255,66,122134,69,174687
10454,0.001656,142.250.4.0-255,4320,126454,69,174687
10455,0.00166,172.31.40.0-255,66,126520,69,174687
10456,0.001689,142.250.4.0-255,4320,130840,69,174687
10457,0.001692,172.31.40.0-255,66,130906,69,174687
10458,0.001705,172.31.40.0-255,66,130972,69,174687
10459,0.001741,142.250.4.0-255,7156,138128,69,174687
10460,0.001789,172.31.40.0-255,66,138194,69,174687
10461,0.001814,142.250.4.0-255,4320,142514,69,174687
10462,0.00182,172.31.40.0-255,66,142580,69,174687
10463,0.001865,142.250.4.0-255,5738,148318,69,174687
10464,0.001872,172.31.40.0-255,66,148384,69,174687
10465,0.001884,142.250.4.0-255,7156,155540,69,174687
10466,0.001918,172.31.40.0-255,66,155606,69,174687
10467,0.001929,142.250.4.0-255,5738,161344,69,174687
10468,0.001961,172.31.40.0-255,66,161410,69,174687
10469,0.00204,172.31.40.0-255,66,161476,69,174687
10470,0.002046,172.31.40.0-255,66,161542,69,174687
10471,0.002064,142.250.4.0-255,2902,164444,69,174687
10472,0.002073,172.31.40.0-255,66,164510,69,174687
10473,0.002111,172.31.40.0-255,66,164576,69,174687
10474,0.002126,142.250.4.0-255,1484,166060,69,174687
10475,0.002146,142.250.4.0-255,6172,172232,69,174687
10476,0.002158,172.31.40.0-255,66,172298,69,174687
10477,0.004184,142.250.4.0-255,105,172403,69,174687
10478,0.005229,172.31.40.0-255,66,172469,69,174687
10479,0.005269,172.31.40.0-255,105,172574,69,174687
10480,0.007283,142.250.4.0-255,66,172640,69,174687
10481,0.033358,172.31.40.0-255,172,172812,69,174687
10482,0.033387,172.31.40.0-255,1112,173924,69,174687
10483,0.033452,172.31.40.0-255,565,174489,69,174687
10484,0.035005,104.244.42.0-255,66,174555,69,174687
10485,0.035055,104.244.42.0-255,66,174621,69,174687
10486,0.035065,104.244.42.0-255,66,174687,69,174687
10487,0.0,172.217.194.0-255,152,152,69,336626
10488,2.1e-05,172.31.40.0-255,66,218,69,336626
10489,2.8e-05,172.217.194.0-255,1484,1702,69,336626
10490,3.3e-05,172.31.40.0-255,66,1768,69,336626
10491,3.9e-05,172.217.194.0-255,2902,4670,69,336626
10492,4.4e-05,172.31.40.0-255,66,4736,69,336626
10493,5.9e-05,172.217.194.0-255,7156,11892,69,336626
10494,6.2e-05,172.31.40.0-255,66,11958,69,336626
10495,6.7e-05,172.217.194.0-255,2902,14860,69,336626
10496,6.9e-05,172.31.40.0-255,66,14926,69,336626
10497,0.000108,172.31.40.0-255,66,14992,69,336626
10498,0.000134,172.217.194.0-255,3449,18441,69,336626
10499,0.000137,172.31.40.0-255,66,18507,69,336626
10500,0.000158,172.31.40.0-255,66,18573,69,336626
10501,0.000163,172.217.194.0-255,2902,21475,69,336626
10502,0.000165,172.31.40.0-255,66,21541,69,336626
10503,0.000188,172.217.194.0-255,1125,22666,69,336626
10504,0.00019,172.31.40.0-255,66,22732,69,336626
10505,0.000548,172.217.194.0-255,1484,24216,69,336626
10506,0.000553,172.31.40.0-255,66,24282,69,336626
10507,0.000559,172.217.194.0-255,2902,27184,69,336626
10508,0.000562,172.31.40.0-255,66,27250,69,336626
10509,0.000569,172.217.194.0-255,5738,32988,69,336626
10510,0.000576,172.31.40.0-255,66,33054,69,336626
10511,0.000583,172.217.194.0-255,5738,38792,69,336626
10512,0.000586,172.31.40.0-255,66,38858,69,336626
10513,0.000633,172.217.194.0-255,1125,39983,69,336626
10514,0.000637,172.31.40.0-255,66,40049,69,336626
10515,0.00066,172.217.194.0-255,1484,41533,69,336626
10516,0.000663,172.31.40.0-255,66,41599,69,336626
10517,0.00069,172.217.194.0-255,2902,44501,69,336626
10518,0.000693,172.31.40.0-255,66,44567,69,336626
10519,0.000698,172.217.194.0-255,4320,48887,69,336626
10520,0.000701,172.31.40.0-255,66,48953,69,336626
10521,0.000713,172.31.40.0-255,66,49019,69,336626
10522,0.000739,172.217.194.0-255,1484,50503,69,336626
10523,0.000766,172.217.194.0-255,2902,53405,69,336626
10524,0.000769,172.31.40.0-255,66,53471,69,336626
10525,0.000776,172.217.194.0-255,5738,59209,69,336626
10526,0.000778,172.31.40.0-255,66,59275,69,336626
10527,0.00079,172.217.194.0-255,6797,66072,69,336626
10528,0.000792,172.31.40.0-255,66,66138,69,336626
10529,0.001538,172.217.194.0-255,1484,67622,69,336626
10530,0.001547,172.217.194.0-255,2902,70524,69,336626
10531,0.001551,172.31.40.0-255,66,70590,69,336626
10532,0.001557,172.217.194.0-255,1484,72074,69,336626
10533,0.001592,172.217.194.0-255,4320,76394,69,336626
10534,0.001594,172.31.40.0-255,66,76460,69,336626
10535,0.001599,172.217.194.0-255,2902,79362,69,336626
10536,0.001601,172.31.40.0-255,66,79428,69,336626
10537,0.001624,172.217.194.0-255,3399,82827,69,336626
10538,0.001631,172.31.40.0-255,66,82893,69,336626
10539,0.001717,172.217.194.0-255,1484,84377,69,336626
10540,0.001723,172.217.194.0-255,2902,87279,69,336626
10541,0.001726,172.31.40.0-255,66,87345,69,336626
10542,0.001732,172.217.194.0-255,4320,91665,69,336626
10543,0.001734,172.31.40.0-255,66,91731,69,336626
10544,0.001768,172.217.194.0-255,1484,93215,69,336626
10545,0.00178,172.217.194.0-255,7156,100371,69,336626
10546,0.001783,172.31.40.0-255,66,100437,69,336626
10547,0.001797,172.31.40.0-255,66,100503,69,336626
10548,0.001801,172.217.194.0-255,2184,102687,69,336626
10549,0.001803,172.31.40.0-255,66,102753,69,336626
10550,0.002304,172.217.194.0-255,1484,104237,69,336626
10551,0.002313,172.217.194.0-255,2902,107139,69,336626
10552,0.002317,172.31.40.0-255,66,107205,69,336626
10553,0.002326,172.217.194.0-255,4320,111525,69,336626
10554,0.002327,172.31.40.0-255,66,111591,69,336626
10555,0.002352,172.217.194.0-255,1484,113075,69,336626
10556,0.00237,172.31.40.0-255,66,113141,69,336626
10557,0.002382,172.31.40.0-255,66,113207,69,336626
10558,0.002438,172.217.194.0-255,1484,114691,69,336626
10559,0.002449,172.217.194.0-255,1484,116175,69,336626
10560,0.002452,172.31.40.0-255,66,116241,69,336626
10561,0.00248,172.217.194.0-255,1484,117725,69,336626
10562,0.002487,172.217.194.0-255,5738,123463,69,336626
10563,0.002489,172.31.40.0-255,66,123529,69,336626
10564,0.002494,172.217.194.0-255,2902,126431,69,336626
10565,0.002496,172.31.40.0-255,66,126497,69,336626
10566,0.00253,172.31.40.0-255,66,126563,69,336626
10567,0.002543,172.31.40.0-255,66,126629,69,336626
10568,0.002583,172.217.194.0-255,1484,128113,69,336626
10569,0.002588,172.217.194.0-255,2902,131015,69,336626
10570,0.00259,172.31.40.0-255,66,131081,69,336626
10571,0.002595,172.217.194.0-255,2902,133983,69,336626
10572,0.002597,172.31.40.0-255,66,134049,69,336626
10573,0.005097,172.217.194.0-255,5738,139787,69,336626
10574,0.005104,172.31.40.0-255,66,139853,69,336626
10575,0.007642,172.217.194.0-255,5738,145591,69,336626
10576,0.007648,172.31.40.0-255,66,145657,69,336626
10577,0.010196,172.217.194.0-255,5738,151395,69,336626
10578,0.010204,172.31.40.0-255,66,151461,69,336626
10579,0.012752,172.217.194.0-255,4320,155781,69,336626
10580,0.012758,172.31.40.0-255,66,155847,69,336626
10581,0.012776,172.217.194.0-255,1484,157331,69,336626
10582,0.015338,172.217.194.0-255,4320,161651,69,336626
10583,0.015344,172.31.40.0-255,66,161717,69,336626
10584,0.017864,172.217.194.0-255,5738,167455,69,336626
10585,0.017872,172.31.40.0-255,66,167521,69,336626
10586,0.020448,172.217.194.0-255,5738,173259,69,336626
10587,0.020455,172.31.40.0-255,66,173325,69,336626
10588,0.023009,172.217.194.0-255,5738,179063,69,336626
10589,0.023015,172.31.40.0-255,66,179129,69,336626
10590,0.025539,172.217.194.0-255,5738,184867,69,336626
10591,0.025546,172.31.40.0-255,66,184933,69,336626
10592,0.028077,172.217.194.0-255,5738,190671,69,336626
10593,0.028085,172.31.40.0-255,66,190737,69,336626
10594,0.02961,172.31.40.0-255,167,190904,69,336626
10595,0.029643,172.31.40.0-255,1116,192020,69,336626
10596,0.029707,172.31.40.0-255,1514,193534,69,336626
10597,0.029709,172.31.40.0-255,1514,195048,69,336626
10598,0.02971,172.31.40.0-255,1514,196562,69,336626
10599,0.029712,172.31.40.0-255,1514,198076,69,336626
10600,0.029712,172.31.40.0-255,540,198616,69,336626
10601,0.030604,172.217.194.0-255,5738,204354,69,336626
10602,0.030612,172.31.40.0-255,66,204420,69,336626
10603,0.031803,104.244.42.0-255,66,204486,69,336626
10604,0.033138,172.217.194.0-255,5738,210224,69,336626
10605,0.033142,172.31.40.0-255,66,210290,69,336626
10606,0.035653,172.217.194.0-255,5738,216028,69,336626
10607,0.035659,172.31.40.0-255,66,216094,69,336626
10608,0.038187,172.217.194.0-255,5738,221832,69,336626
10609,0.038194,172.31.40.0-255,66,221898,69,336626
10610,0.040736,172.217.194.0-255,5738,227636,69,336626
10611,0.040742,172.31.40.0-255,66,227702,69,336626
10612,0.043299,172.217.194.0-255,5738,233440,69,336626
10613,0.043305,172.31.40.0-255,66,233506,69,336626
10614,0.045844,172.217.194.0-255,5738,239244,69,336626
10615,0.045851,172.31.40.0-255,66,239310,69,336626
10616,0.048407,172.217.194.0-255,5738,245048,69,336626
10617,0.048413,172.31.40.0-255,66,245114,69,336626
10618,0.050951,172.217.194.0-255,5738,250852,69,336626
10619,0.050957,172.31.40.0-255,66,250918,69,336626
10620,0.053493,172.217.194.0-255,5738,256656,69,336626
10621,0.053501,172.31.40.0-255,66,256722,69,336626
10622,0.056044,172.217.194.0-255,5738,262460,69,336626
10623,0.056051,172.31.40.0-255,66,262526,69,336626
10624,0.058589,172.217.194.0-255,5738,268264,69,336626
10625,0.058596,172.31.40.0-255,66,268330,69,336626
10626,0.061135,172.217.194.0-255,4320,272650,69,336626
10627,0.061141,172.31.40.0-255,66,272716,69,336626
10628,0.061168,172.217.194.0-255,1484,274200,69,336626
10629,0.063656,172.217.194.0-255,4320,278520,69,336626
10630,0.063662,172.31.40.0-255,66,278586,69,336626
10631,0.066189,172.217.194.0-255,5738,284324,69,336626
10632,0.066195,172.31.40.0-255,66,284390,69,336626
10633,0.068762,172.217.194.0-255,5738,290128,69,336626
10634,0.068768,172.31.40.0-255,66,290194,69,336626
10635,0.071309,172.217.194.0-255,5738,295932,69,336626
10636,0.071314,172.31.40.0-255,66,295998,69,336626
10637,0.073841,172.217.194.0-255,5738,301736,69,336626
10638,0.073847,172.31.40.0-255,66,301802,69,336626
10639,0.076377,172.217.194.0-255,5738,307540,69,336626
10640,0.076383,172.31.40.0-255,66,307606,69,336626
10641,0.07893,172.217.194.0-255,5738,313344,69,336626
10642,0.078936,172.31.40.0-255,66,313410,69,336626
10643,0.081473,172.217.194.0-255,5738,319148,69,336626
10644,0.081479,172.31.40.0-255,66,319214,69,336626
10645,0.084002,172.217.194.0-255,5738,324952,69,336626
10646,0.084009,172.31.40.0-255,66,325018,69,336626
10647,0.086561,172.217.194.0-255,5738,330756,69,336626
10648,0.086568,172.31.40.0-255,66,330822,69,336626
10649,0.089135,172.217.194.0-255,5738,336560,69,336626
10650,0.089141,172.31.40.0-255,66,336626,69,336626
10651,0.0,172.217.194.0-255,150,150,69,236142
10652,2.3e-05,172.31.40.0-255,66,216,69,236142
10653,3e-05,172.217.194.0-255,1484,1700,69,236142
10654,3.5e-05,172.31.40.0-255,66,1766,69,236142
10655,4e-05,172.217.194.0-255,2902,4668,69,236142
10656,5.1e-05,172.31.40.0-255,66,4734,69,236142
10657,5.7e-05,172.217.194.0-255,4320,9054,69,236142
10658,6.1e-05,172.31.40.0-255,66,9120,69,236142
10659,9.7e-05,172.217.194.0-255,4892,14012,69,236142
10660,0.000101,172.31.40.0-255,66,14078,69,236142
10661,0.000188,172.217.194.0-255,1484,15562,69,236142
10662,0.000191,172.31.40.0-255,66,15628,69,236142
10663,0.000195,172.217.194.0-255,1484,17112,69,236142
10664,0.000197,172.31.40.0-255,66,17178,69,236142
10665,0.00023,172.217.194.0-255,1484,18662,69,236142
10666,0.000232,172.31.40.0-255,66,18728,69,236142
10667,0.000239,172.217.194.0-255,5738,24466,69,236142
10668,0.000242,172.31.40.0-255,66,24532,69,236142
10669,0.000246,172.217.194.0-255,2902,27434,69,236142
10670,0.000248,172.31.40.0-255,66,27500,69,236142
10671,0.000281,172.217.194.0-255,3961,31461,69,236142
10672,0.000284,172.31.40.0-255,66,31527,69,236142
10673,0.000693,172.217.194.0-255,1484,33011,69,236142
10674,0.000699,172.31.40.0-255,66,33077,69,236142
10675,0.000727,172.217.194.0-255,2902,35979,69,236142
10676,0.000729,172.31.40.0-255,66,36045,69,236142
10677,0.000736,172.217.194.0-255,5738,41783,69,236142
10678,0.000738,172.31.40.0-255,66,41849,69,236142
10679,0.000776,172.217.194.0-255,6797,48646,69,236142
10680,0.000779,172.31.40.0-255,66,48712,69,236142
10681,0.001183,172.217.194.0-255,1484,50196,69,236142
10682,0.001188,172.31.40.0-255,66,50262,69,236142
10683,0.001196,172.217.194.0-255,2902,53164,69,236142
10684,0.001198,172.31.40.0-255,66,53230,69,236142
10685,0.001209,172.217.194.0-255,5738,58968,69,236142
10686,0.001211,172.31.40.0-255,66,59034,69,236142
10687,0.001253,172.31.40.0-255,66,59100,69,236142
10688,0.001275,172.217.194.0-255,1484,60584,69,236142
10689,0.001287,172.217.194.0-255,1484,62068,69,236142
10690,0.00129,172.31.40.0-255,66,62134,69,236142
10691,0.001319,172.217.194.0-255,1484,63618,69,236142
10692,0.001324,172.217.194.0-255,5738,69356,69,236142
10693,0.001326,172.31.40.0-255,66,69422,69,236142
10694,0.001333,172.217.194.0-255,6797,76219,69,236142
10695,0.001336,172.31.40.0-255,66,76285,69,236142
10696,0.001381,172.217.194.0-255,5738,82023,69,236142
10697,0.001383,172.31.40.0-255,66,82089,69,236142
10698,0.001413,172.31.40.0-255,66,82155,69,236142
10699,0.002052,172.217.194.0-255,1484,83639,69,236142
10700,0.002059,172.217.194.0-255,1484,85123,69,236142
10701,0.002063,172.31.40.0-255,66,85189,69,236142
10702,0.002087,172.217.194.0-255,1484,86673,69,236142
10703,0.002093,172.217.194.0-255,5738,92411,69,236142
10704,0.002095,172.31.40.0-255,66,92477,69,236142
10705,0.002098,172.217.194.0-255,1484,93961,69,236142
10706,0.002124,172.217.194.0-255,5738,99699,69,236142
10707,0.002126,172.31.40.0-255,66,99765,69,236142
10708,0.002143,172.217.194.0-255,2902,102667,69,236142
10709,0.002145,172.31.40.0-255,66,102733,69,236142
10710,0.002162,172.31.40.0-255,66,102799,69,236142
10711,0.002375,172.217.194.0-255,1484,104283,69,236142
10712,0.002394,172.217.194.0-255,2902,107185,69,236142
10713,0.002396,172.31.40.0-255,66,107251,69,236142
10714,0.002401,172.217.194.0-255,2902,110153,69,236142
10715,0.002403,172.31.40.0-255,66,110219,69,236142
10716,0.002422,172.217.194.0-255,2902,113121,69,236142
10717,0.002424,172.31.40.0-255,66,113187,69,236142
10718,0.002449,172.31.40.0-255,66,113253,69,236142
10719,0.002474,172.217.194.0-255,4320,117573,69,236142
10720,0.002476,172.31.40.0-255,66,117639,69,236142
10721,0.002479,172.217.194.0-255,2902,120541,69,236142
10722,0.002481,172.31.40.0-255,66,120607,69,236142
10723,0.002506,172.217.194.0-255,2902,123509,69,236142
10724,0.002508,172.31.40.0-255,66,123575,69,236142
10725,0.002533,172.217.194.0-255,5020,128595,69,236142
10726,0.002536,172.31.40.0-255,66,128661,69,236142
10727,0.002551,172.217.194.0-255,1484,130145,69,236142
10728,0.002555,172.217.194.0-255,2902,133047,69,236142
10729,0.002557,172.31.40.0-255,66,133113,69,236142
10730,0.002585,172.217.194.0-255,5738,138851,69,236142
10731,0.002587,172.31.40.0-255,66,138917,69,236142
10732,0.002599,172.31.40.0-255,66,138983,69,236142
10733,0.002613,172.31.40.0-255,66,139049,69,236142
10734,0.002639,172.217.194.0-255,2184,141233,69,236142
10735,0.002641,172.31.40.0-255,66,141299,69,236142
10736,0.003199,172.217.194.0-255,1484,142783,69,236142
10737,0.003211,172.217.194.0-255,2902,145685,69,236142
10738,0.003213,172.31.40.0-255,66,145751,69,236142
10739,0.003217,172.217.194.0-255,2902,148653,69,236142
10740,0.003219,172.31.40.0-255,66,148719,69,236142
10741,0.003252,172.217.194.0-255,2902,151621,69,236142
10742,0.003254,172.31.40.0-255,66,151687,69,236142
10743,0.003265,172.31.40.0-255,66,151753,69,236142
10744,0.003295,172.217.194.0-255,2902,154655,69,236142
10745,0.003296,172.31.40.0-255,66,154721,69,236142
10746,0.003307,172.31.40.0-255,66,154787,69,236142
10747,0.003332,172.217.194.0-255,1484,156271,69,236142
10748,0.003335,172.217.194.0-255,2902,159173,69,236142
10749,0.003337,172.31.40.0-255,66,159239,69,236142
10750,0.003393,172.217.194.0-255,5738,164977,69,236142
10751,0.003396,172.31.40.0-255,66,165043,69,236142
10752,0.003404,172.217.194.0-255,5738,170781,69,236142
10753,0.003406,172.31.40.0-255,66,170847,69,236142
10754,0.003411,172.217.194.0-255,4320,175167,69,236142
10755,0.003413,172.31.40.0-255,66,175233,69,236142
10756,0.003416,172.217.194.0-255,1484,176717,69,236142
10757,0.003458,172.31.40.0-255,66,176783,69,236142
10758,0.003568,172.217.194.0-255,1484,178267,69,236142
10759,0.003587,172.217.194.0-255,2902,181169,69,236142
10760,0.00359,172.31.40.0-255,66,181235,69,236142
10761,0.003596,172.217.194.0-255,5738,186973,69,236142
10762,0.003598,172.31.40.0-255,66,187039,69,236142
10763,0.003629,172.217.194.0-255,4320,191359,69,236142
10764,0.003632,172.31.40.0-255,66,191425,69,236142
10765,0.00366,172.217.194.0-255,5738,197163,69,236142
10766,0.003662,172.31.40.0-255,66,197229,69,236142
10767,0.003673,172.31.40.0-255,66,197295,69,236142
10768,0.003676,172.217.194.0-255,2184,199479,69,236142
10769,0.003679,172.31.40.0-255,66,199545,69,236142
10770,0.00373,172.217.194.0-255,7156,206701,69,236142
10771,0.003733,172.31.40.0-255,66,206767,69,236142
10772,0.003739,172.217.194.0-255,5738,212505,69,236142
10773,0.003741,172.31.40.0-255,66,212571,69,236142
10774,0.003759,172.217.194.0-255,2902,215473,69,236142
10775,0.003762,172.31.40.0-255,66,215539,69,236142
10776,0.003767,172.217.194.0-255,4320,219859,69,236142
10777,0.003769,172.31.40.0-255,66,219925,69,236142
10778,0.003813,172.31.40.0-255,66,219991,69,236142
10779,0.003822,172.31.40.0-255,66,220057,69,236142
10780,0.003832,172.31.40.0-255,66,220123,69,236142
10781,0.003864,172.31.40.0-255,66,220189,69,236142
10782,0.003892,172.217.194.0-255,5020,225209,69,236142
10783,0.003894,172.31.40.0-255,66,225275,69,236142
10784,0.003925,172.217.194.0-255,1484,226759,69,236142
10785,0.003989,172.217.194.0-255,105,226864,69,236142
10786,0.004537,172.31.40.0-255,66,226930,69,236142
10787,0.007093,172.31.40.0-255,105,227035,69,236142
10788,0.009692,172.217.194.0-255,66,227101,69,236142
10789,0.038024,172.31.40.0-255,172,227273,69,236142
10790,0.038059,172.31.40.0-255,1112,228385,69,236142
10791,0.038128,172.31.40.0-255,1514,229899,69,236142
10792,0.03813,172.31.40.0-255,1514,231413,69,236142
10793,0.038131,172.31.40.0-255,1514,232927,69,236142
10794,0.038136,172.31.40.0-255,1514,234441,69,236142
10795,0.038159,172.31.40.0-255,1503,235944,69,236142
10796,0.039712,104.244.42.0-255,66,236010,69,236142
10797,0.039722,104.244.42.0-255,66,236076,69,236142
10798,0.039816,104.244.42.0-255,66,236142,69,236142
10799,0.0,172.31.40.0-255,105,105,69,276
10800,0.081149,31.13.82.0-255,105,210,69,276
10801,0.081171,172.31.40.0-255,66,276,69,276
10802,0.0,172.31.40.0-255,105,105,69,276
10803,0.001887,157.240.7.0-255,105,210,69,276
10804,0.001902,172.31.40.0-255,66,276,69,276
10805,0.0,172.31.40.0-255,105,105,69,276
10806,0.002169,157.240.7.0-255,105,210,69,276
10807,0.002178,172.31.40.0-255,66,276,69,276
10808,0.0,74.125.68.0-255,431,431,69,126315
10809,1.2e-05,74.125.68.0-255,1484,1915,69,126315
10810,1.9e-05,172.31.40.0-255,66,1981,69,126315
10811,2.9e-05,74.125.68.0-255,4320,6301,69,126315
10812,3.2e-05,172.31.40.0-255,66,6367,69,126315
10813,0.000188,74.125.68.0-255,4320,10687,69,126315
10814,0.000194,172.31.40.0-255,66,10753,69,126315
10815,0.000378,74.125.68.0-255,4875,15628,69,126315
10816,0.000382,172.31.40.0-255,66,15694,69,126315
10817,0.000605,172.31.40.0-255,66,15760,69,126315
10818,0.000625,74.125.68.0-255,2902,18662,69,126315
10819,0.000628,172.31.40.0-255,66,18728,69,126315
10820,0.001103,74.125.68.0-255,2902,21630,69,126315
10821,0.001109,172.31.40.0-255,66,21696,69,126315
10822,0.002306,74.125.68.0-255,5738,27434,69,126315
10823,0.00269,172.31.40.0-255,66,27500,69,126315
10824,0.002988,74.125.68.0-255,4320,31820,69,126315
10825,0.002993,172.31.40.0-255,66,31886,69,126315
10826,0.003051,172.31.40.0-255,66,31952,69,126315
10827,0.003736,74.125.68.0-255,4320,36272,69,126315
10828,0.00374,172.31.40.0-255,66,36338,69,126315
10829,0.00439,172.31.40.0-255,66,36404,69,126315
10830,0.004415,74.125.68.0-255,7156,43560,69,126315
10831,0.004437,172.31.40.0-255,66,43626,69,126315
10832,0.004999,74.125.68.0-255,7156,50782,69,126315
10833,0.005004,172.31.40.0-255,66,50848,69,126315
10834,0.005024,74.125.68.0-255,4320,55168,69,126315
10835,0.00509,74.125.68.0-255,5738,60906,69,126315
10836,0.005152,172.31.40.0-255,66,60972,69,126315
10837,0.005516,74.125.68.0-255,4320,65292,69,126315
10838,0.005522,172.31.40.0-255,66,65358,69,126315
10839,0.005555,172.31.40.0-255,66,65424,69,126315
10840,0.005577,74.125.68.0-255,7156,72580,69,126315
10841,0.00558,172.31.40.0-255,66,72646,69,126315
10842,0.006695,74.125.68.0-255,4320,76966,69,126315
10843,0.006703,172.31.40.0-255,66,77032,69,126315
10844,0.006757,172.31.40.0-255,66,77098,69,126315
10845,0.007299,74.125.68.0-255,1514,78612,69,126315
10846,0.007307,172.31.40.0-255,66,78678,69,126315
10847,0.007498,172.31.40.0-255,66,78744,69,126315
10848,0.007546,172.31.40.0-255,66,78810,69,126315
10849,0.007563,74.125.68.0-255,4320,83130,69,126315
10850,0.007566,172.31.40.0-255,66,83196,69,126315
10851,0.007581,74.125.68.0-255,2902,86098,69,126315
10852,0.007583,172.31.40.0-255,66,86164,69,126315
10853,0.007899,74.125.68.0-255,7156,93320,69,126315
10854,0.007904,172.31.40.0-255,66,93386,69,126315
10855,0.007944,172.31.40.0-255,66,93452,69,126315
10856,0.008032,172.31.40.0-255,66,93518,69,126315
10857,0.008522,172.31.40.0-255,66,93584,69,126315
10858,0.008561,172.31.40.0-255,66,93650,69,126315
10859,0.009058,74.125.68.0-255,5738,99388,69,126315
10860,0.009063,172.31.40.0-255,66,99454,69,126315
10861,0.009102,172.31.40.0-255,66,99520,69,126315
10862,0.009112,74.125.68.0-255,1590,101110,69,126315
10863,0.009128,172.31.40.0-255,66,101176,69,126315
10864,0.009611,74.125.68.0-255,2902,104078,69,126315
10865,0.009616,172.31.40.0-255,66,104144,69,126315
10866,0.009664,172.31.40.0-255,66,104210,69,126315
10867,0.009724,172.31.40.0-255,66,104276,69,126315
10868,0.009839,74.125.68.0-255,5738,110014,69,126315
10869,0.00985,172.31.40.0-255,66,110080,69,126315
10870,0.00987,74.125.68.0-255,6891,116971,69,126315
10871,0.009905,172.31.40.0-255,66,117037,69,126315
10872,0.013318,172.31.40.0-255,105,117142,69,126315
10873,0.015601,74.125.68.0-255,66,117208,69,126315
10874,0.031134,172.31.40.0-255,172,117380,69,126315
10875,0.031167,172.31.40.0-255,1116,118496,69,126315
10876,0.031249,172.31.40.0-255,1514,120010,69,126315
10877,0.031251,172.31.40.0-255,1514,121524,69,126315
10878,0.031257,172.31.40.0-255,1514,123038,69,126315
10879,0.031258,172.31.40.0-255,1514,124552,69,126315
10880,0.031288,172.31.40.0-255,1499,126051,69,126315
10881,0.032731,104.244.42.0-255,66,126117,69,126315
10882,0.032764,104.244.42.0-255,66,126183,69,126315
10883,0.032827,104.244.42.0-255,66,126249,69,126315
10884,0.032886,104.244.42.0-255,66,126315,69,126315
10885,0.0,172.31.40.0-255,105,105,69,459
10886,0.000185,172.31.40.0-255,90,195,69,459
10887,0.000195,172.31.40.0-255,66,261,69,459
10888,0.002185,74.125.130.0-255,66,327,69,459
10889,0.002217,74.125.130.0-255,66,393,69,459
10890,0.002239,172.31.40.0-255,66,459,69,459
10891,0.0,172.217.24.0-255,153,153,69,360059
10892,2.4e-05,172.31.40.0-255,66,219,69,360059
10893,3.1e-05,172.217.24.0-255,1484,1703,69,360059
10894,3.6e-05,172.31.40.0-255,66,1769,69,360059
10895,3.9e-05,172.217.24.0-255,1484,3253,69,360059
10896,4.9e-05,172.31.40.0-255,66,3319,69,360059
10897,5.5e-05,172.217.24.0-255,2902,6221,69,360059
10898,5.9e-05,172.31.40.0-255,66,6287,69,360059
10899,6.8e-05,172.217.24.0-255,5738,12025,69,360059
10900,7.2e-05,172.31.40.0-255,66,12091,69,360059
10901,7.6e-05,172.217.24.0-255,2092,14183,69,360059
10902,7.9e-05,172.31.40.0-255,66,14249,69,360059
10903,0.000111,172.217.24.0-255,2902,17151,69,360059
10904,0.000114,172.31.40.0-255,66,17217,69,360059
10905,0.000125,172.217.24.0-255,1484,18701,69,360059
10906,0.000127,172.31.40.0-255,66,18767,69,360059
10907,0.000158,172.217.24.0-255,2902,21669,69,360059
10908,0.000161,172.31.40.0-255,66,21735,69,360059
10909,0.000168,172.217.24.0-255,5738,27473,69,360059
10910,0.00017,172.31.40.0-255,66,27539,69,360059
10911,0.00018,172.217.24.0-255,3961,31500,69,360059
10912,0.000182,172.31.40.0-255,66,31566,69,360059
10913,0.000283,172.217.24.0-255,1484,33050,69,360059
10914,0.000286,172.31.40.0-255,66,33116,69,360059
10915,0.00029,172.217.24.0-255,1484,34600,69,360059
10916,0.000292,172.31.40.0-255,66,34666,69,360059
10917,0.000312,172.217.24.0-255,1484,36150,69,360059
10918,0.000314,172.31.40.0-255,66,36216,69,360059
10919,0.000321,172.217.24.0-255,5738,41954,69,360059
10920,0.000328,172.31.40.0-255,66,42020,69,360059
10921,0.000336,172.217.24.0-255,6797,48817,69,360059
10922,0.000339,172.31.40.0-255,66,48883,69,360059
10923,0.000387,172.217.24.0-255,1484,50367,69,360059
10924,0.000393,172.217.24.0-255,2902,53269,69,360059
10925,0.000395,172.31.40.0-255,66,53335,69,360059
10926,0.000422,172.217.24.0-255,5738,59073,69,360059
10927,0.000424,172.31.40.0-255,66,59139,69,360059
10928,0.000432,172.217.24.0-255,5738,64877,69,360059
10929,0.000434,172.31.40.0-255,66,64943,69,360059
10930,0.000449,172.217.24.0-255,1125,66068,69,360059
10931,0.00094,172.217.24.0-255,356,66424,69,360059
10932,0.001102,172.31.40.0-255,66,66490,69,360059
10933,0.001274,172.217.24.0-255,386,66876,69,360059
10934,0.00138,172.217.24.0-255,1484,68360,69,360059
10935,0.001385,172.31.40.0-255,66,68426,69,360059
10936,0.001393,172.217.24.0-255,2902,71328,69,360059
10937,0.001395,172.31.40.0-255,66,71394,69,360059
10938,0.001425,172.217.24.0-255,5738,77132,69,360059
10939,0.001427,172.31.40.0-255,66,77198,69,360059
10940,0.001453,172.217.24.0-255,5738,82936,69,360059
10941,0.001455,172.31.40.0-255,66,83002,69,360059
10942,0.001478,172.217.24.0-255,1125,84127,69,360059
10943,0.001498,172.217.24.0-255,1484,85611,69,360059
10944,0.001501,172.31.40.0-255,66,85677,69,360059
10945,0.001505,172.217.24.0-255,2902,88579,69,360059
10946,0.001507,172.31.40.0-255,66,88645,69,360059
10947,0.001534,172.217.24.0-255,1484,90129,69,360059
10948,0.00154,172.217.24.0-255,5738,95867,69,360059
10949,0.001542,172.31.40.0-255,66,95933,69,360059
10950,0.001564,172.217.24.0-255,1484,97417,69,360059
10951,0.001575,172.217.24.0-255,1484,98901,69,360059
10952,0.001577,172.31.40.0-255,66,98967,69,360059
10953,0.001605,172.217.24.0-255,2543,101510,69,360059
10954,0.001607,172.31.40.0-255,66,101576,69,360059
10955,0.003614,172.217.24.0-255,2902,104478,69,360059
10956,0.003621,172.31.40.0-255,66,104544,69,360059
10957,0.00365,172.217.24.0-255,2902,107446,69,360059
10958,0.003653,172.31.40.0-255,66,107512,69,360059
10959,0.005663,172.217.24.0-255,2902,110414,69,360059
10960,0.005671,172.31.40.0-255,66,110480,69,360059
10961,0.005705,172.217.24.0-255,2902,113382,69,360059
10962,0.005708,172.31.40.0-255,66,113448,69,360059
10963,0.007712,172.217.24.0-255,2902,116350,69,360059
10964,0.007718,172.31.40.0-255,66,116416,69,360059
10965,0.007751,172.217.24.0-255,2902,119318,69,360059
10966,0.007754,172.31.40.0-255,66,119384,69,360059
10967,0.009764,172.217.24.0-255,2902,122286,69,360059
10968,0.00977,172.31.40.0-255,66,122352,69,360059
10969,0.009794,172.217.24.0-255,2902,125254,69,360059
10970,0.009796,172.31.40.0-255,66,125320,69,360059
10971,0.011808,172.217.24.0-255,2902,128222,69,360059
10972,0.011813,172.31.40.0-255,66,128288,69,360059
10973,0.011843,172.217.24.0-255,2902,131190,69,360059
10974,0.011846,172.31.40.0-255,66,131256,69,360059
10975,0.013869,172.217.24.0-255,2902,134158,69,360059
10976,0.013876,172.31.40.0-255,66,134224,69,360059
10977,0.013904,172.217.24.0-255,2902,137126,69,360059
10978,0.013906,172.31.40.0-255,66,137192,69,360059
10979,0.015946,172.217.24.0-255,2902,140094,69,360059
10980,0.015952,172.31.40.0-255,66,140160,69,360059
10981,0.01598,172.217.24.0-255,2902,143062,69,360059
10982,0.015982,172.31.40.0-255,66,143128,69,360059
10983,0.017994,172.217.24.0-255,2902,146030,69,360059
10984,0.018002,172.31.40.0-255,66,146096,69,360059
10985,0.018034,172.217.24.0-255,2902,148998,69,360059
10986,0.018038,172.31.40.0-255,66,149064,69,360059
10987,0.020057,172.217.24.0-255,2902,151966,69,360059
10988,0.020066,172.31.40.0-255,66,152032,69,360059
10989,0.020104,172.217.24.0-255,2902,154934,69,360059
10990,0.020106,172.31.40.0-255,66,155000,69,360059
10991,0.022117,172.217.24.0-255,2902,157902,69,360059
10992,0.022123,172.31.40.0-255,66,157968,69,360059
10993,0.02215,172.217.24.0-255,2902,160870,69,360059
10994,0.022153,172.31.40.0-255,66,160936,69,360059
10995,0.024165,172.217.24.0-255,2902,163838,69,360059
10996,0.024173,172.31.40.0-255,66,163904,69,360059
10997,0.02421,172.217.24.0-255,2902,166806,69,360059
10998,0.024213,172.31.40.0-255,66,166872,69,360059
10999,0.026214,172.217.24.0-255,2902,169774,69,360059
11000,0.026221,172.31.40.0-255,66,169840,69,360059
11001,0.026246,172.217.24.0-255,2902,172742,69,360059
11002,0.026249,172.31.40.0-255,66,172808,69,360059
11003,0.028265,172.217.24.0-255,2902,175710,69,360059
11004,0.028272,172.31.40.0-255,66,175776,69,360059
11005,0.028305,172.217.24.0-255,2902,178678,69,360059
11006,0.028308,172.31.40.0-255,66,178744,69,360059
11007,0.030313,172.217.24.0-255,2902,181646,69,360059
11008,0.03032,172.31.40.0-255,66,181712,69,360059
11009,0.03035,172.217.24.0-255,2902,184614,69,360059
11010,0.030353,172.31.40.0-255,66,184680,69,360059
11011,0.032399,172.217.24.0-255,5738,190418,69,360059
11012,0.032405,172.31.40.0-255,66,190484,69,360059
11013,0.034452,172.217.24.0-255,5738,196222,69,360059
11014,0.034459,172.31.40.0-255,66,196288,69,360059
11015,0.035136,172.31.40.0-255,172,196460,69,360059
11016,0.035165,172.31.40.0-255,1116,197576,69,360059
11017,0.035231,172.31.40.0-255,1514,199090,69,360059
11018,0.035234,172.31.40.0-255,1514,200604,69,360059
11019,0.03524,172.31.40.0-255,1514,202118,69,360059
11020,0.035241,172.31.40.0-255,1514,203632,69,360059
11021,0.03526,172.31.40.0-255,1499,205131,69,360059
11022,0.03652,172.217.24.0-255,5738,210869,69,360059
11023,0.036527,172.31.40.0-255,66,210935,69,360059
11024,0.036807,104.244.42.0-255,66,211001,69,360059
11025,0.036815,104.244.42.0-255,66,211067,69,360059
11026,0.036913,104.244.42.0-255,66,211133,69,360059
11027,0.038568,172.217.24.0-255,5738,216871,69,360059
11028,0.038574,172.31.40.0-255,66,216937,69,360059
11029,0.040616,172.217.24.0-255,5738,222675,69,360059
11030,0.040627,172.31.40.0-255,66,222741,69,360059
11031,0.042687,172.217.24.0-255,5738,228479,69,360059
11032,0.042695,172.31.40.0-255,66,228545,69,360059
11033,0.044744,172.217.24.0-255,5738,234283,69,360059
11034,0.04475,172.31.40.0-255,66,234349,69,360059
11035,0.046786,172.217.24.0-255,4320,238669,69,360059
11036,0.04679,172.31.40.0-255,66,238735,69,360059
11037,0.046814,172.217.24.0-255,1484,240219,69,360059
11038,0.048831,172.217.24.0-255,4320,244539,69,360059
11039,0.048836,172.31.40.0-255,66,244605,69,360059
11040,0.050909,172.217.24.0-255,5738,250343,69,360059
11041,0.050916,172.31.40.0-255,66,250409,69,360059
11042,0.052961,172.217.24.0-255,5738,256147,69,360059
11043,0.052966,172.31.40.0-255,66,256213,69,360059
11044,0.055011,172.217.24.0-255,5738,261951,69,360059
11045,0.055018,172.31.40.0-255,66,262017,69,360059
11046,0.057067,172.217.24.0-255,5738,267755,69,360059
11047,0.057073,172.31.40.0-255,66,267821,69,360059
11048,0.059119,172.217.24.0-255,5738,273559,69,360059
11049,0.059125,172.31.40.0-255,66,273625,69,360059
11050,0.061163,172.217.24.0-255,5738,279363,69,360059
11051,0.061169,172.31.40.0-255,66,279429,69,360059
11052,0.063208,172.217.24.0-255,5738,285167,69,360059
11053,0.063213,172.31.40.0-255,66,285233,69,360059
11054,0.065268,172.217.24.0-255,5738,290971,69,360059
11055,0.065273,172.31.40.0-255,66,291037,69,360059
11056,0.067312,172.217.24.0-255,5738,296775,69,360059
11057,0.067317,172.31.40.0-255,66,296841,69,360059
11058,0.069356,172.217.24.0-255,5738,302579,69,360059
11059,0.069361,172.31.40.0-255,66,302645,69,360059
11060,0.071401,172.217.24.0-255,4320,306965,69,360059
11061,0.071407,172.31.40.0-255,66,307031,69,360059
11062,0.07144,172.217.24.0-255,1484,308515,69,360059
11063,0.073453,172.217.24.0-255,4320,312835,69,360059
11064,0.073459,172.31.40.0-255,66,312901,69,360059
11065,0.075497,172.217.24.0-255,2902,315803,69,360059
11066,0.075502,172.31.40.0-255,66,315869,69,360059
11067,0.075527,172.217.24.0-255,2902,318771,69,360059
11068,0.075529,172.31.40.0-255,66,318837,69,360059
11069,0.077543,172.217.24.0-255,2902,321739,69,360059
11070,0.077548,172.31.40.0-255,66,321805,69,360059
11071,0.077574,172.217.24.0-255,2902,324707,69,360059
11072,0.077576,172.31.40.0-255,66,324773,69,360059
11073,0.079595,172.217.24.0-255,1484,326257,69,360059
11074,0.079667,172.217.24.0-255,4320,330577,69,360059
11075,0.079673,172.31.40.0-255,66,330643,69,360059
11076,0.081726,172.217.24.0-255,5738,336381,69,360059
11077,0.081732,172.31.40.0-255,66,336447,69,360059
11078,0.083772,172.217.24.0-255,5738,342185,69,360059
11079,0.083777,172.31.40.0-255,66,342251,69,360059
11080,0.085827,172.217.24.0-255,2902,345153,69,360059
11081,0.085833,172.31.40.0-255,66,345219,69,360059
11082,0.085866,172.217.24.0-255,2902,348121,69,360059
11083,0.085869,172.31.40.0-255,66,348187,69,360059
11084,0.087874,172.217.24.0-255,2902,351089,69,360059
11085,0.08788,172.31.40.0-255,66,351155,69,360059
11086,0.087914,172.217.24.0-255,2902,354057,69,360059
11087,0.087917,172.31.40.0-255,66,354123,69,360059
11088,0.089923,172.217.24.0-255,2902,357025,69,360059
11089,0.089931,172.31.40.0-255,66,357091,69,360059
11090,0.089964,172.217.24.0-255,2902,359993,69,360059
11091,0.089968,172.31.40.0-255,66,360059,69,360059
11092,0.0,172.31.40.0-255,105,105,69,459
11093,0.000213,172.31.40.0-255,90,195,69,459
11094,0.000223,172.31.40.0-255,66,261,69,459
11095,0.002294,74.125.24.0-255,66,327,69,459
11096,0.002325,74.125.24.0-255,66,393,69,459
11097,0.002346,172.31.40.0-255,66,459,69,459
11098,0.0,74.125.24.0-255,143,143,69,316556
11099,2.2e-05,172.31.40.0-255,66,209,69,316556
11100,2.9e-05,74.125.24.0-255,1484,1693,69,316556
11101,3.4e-05,172.31.40.0-255,66,1759,69,316556
11102,3.9e-05,74.125.24.0-255,2902,4661,69,316556
11103,4.2e-05,172.31.40.0-255,66,4727,69,316556
11104,5.1e-05,74.125.24.0-255,7156,11883,69,316556
11105,5.5e-05,172.31.40.0-255,66,11949,69,316556
11106,5.9e-05,74.125.24.0-255,2103,14052,69,316556
11107,6.1e-05,172.31.40.0-255,66,14118,69,316556
11108,0.000181,74.125.24.0-255,1484,15602,69,316556
11109,0.000186,172.31.40.0-255,66,15668,69,316556
11110,0.000192,74.125.24.0-255,2902,18570,69,316556
11111,0.000194,172.31.40.0-255,66,18636,69,316556
11112,0.000217,74.125.24.0-255,5738,24374,69,316556
11113,0.00022,172.31.40.0-255,66,24440,69,316556
11114,0.000223,74.125.24.0-255,1484,25924,69,316556
11115,0.000225,172.31.40.0-255,66,25990,69,316556
11116,0.000249,74.125.24.0-255,5379,31369,69,316556
11117,0.000251,172.31.40.0-255,66,31435,69,316556
11118,0.000369,74.125.24.0-255,1484,32919,69,316556
11119,0.000373,172.31.40.0-255,66,32985,69,316556
11120,0.000378,74.125.24.0-255,2902,35887,69,316556
11121,0.00038,172.31.40.0-255,66,35953,69,316556
11122,0.000385,74.125.24.0-255,2902,38855,69,316556
11123,0.000387,172.31.40.0-255,66,38921,69,316556
11124,0.000408,74.125.24.0-255,2902,41823,69,316556
11125,0.000411,172.31.40.0-255,66,41889,69,316556
11126,0.000432,74.125.24.0-255,4320,46209,69,316556
11127,0.000434,172.31.40.0-255,66,46275,69,316556
11128,0.000457,74.125.24.0-255,2543,48818,69,316556
11129,0.000459,172.31.40.0-255,66,48884,69,316556
11130,0.000964,74.125.24.0-255,1484,50368,69,316556
11131,0.000974,74.125.24.0-255,2902,53270,69,316556
11132,0.000979,172.31.40.0-255,66,53336,69,316556
11133,0.000999,74.125.24.0-255,1484,54820,69,316556
11134,0.001014,74.125.24.0-255,4320,59140,69,316556
11135,0.001016,172.31.40.0-255,66,59206,69,316556
11136,0.001055,74.125.24.0-255,6797,66003,69,316556
11137,0.001058,172.31.40.0-255,66,66069,69,316556
11138,0.001078,74.125.24.0-255,1484,67553,69,316556
11139,0.001083,74.125.24.0-255,2902,70455,69,316556
11140,0.001086,172.31.40.0-255,66,70521,69,316556
11141,0.00111,74.125.24.0-255,5738,76259,69,316556
11142,0.001113,172.31.40.0-255,66,76325,69,316556
11143,0.001126,74.125.24.0-255,2902,79227,69,316556
11144,0.001129,172.31.40.0-255,66,79293,69,316556
11145,0.001147,74.125.24.0-255,4541,83834,69,316556
11146,0.00115,172.31.40.0-255,66,83900,69,316556
11147,0.001222,74.125.24.0-255,1484,85384,69,316556
11148,0.001226,74.125.24.0-255,1484,86868,69,316556
11149,0.001229,172.31.40.0-255,66,86934,69,316556
11150,0.001255,74.125.24.0-255,1484,88418,69,316556
11151,0.001262,74.125.24.0-255,5738,94156,69,316556
11152,0.001265,172.31.40.0-255,66,94222,69,316556
11153,0.001285,74.125.24.0-255,4320,98542,69,316556
11154,0.001288,172.31.40.0-255,66,98608,69,316556
11155,0.001302,74.125.24.0-255,2543,101151,69,316556
11156,0.001304,172.31.40.0-255,66,101217,69,316556
11157,0.00151,74.125.24.0-255,1484,102701,69,316556
11158,0.001518,74.125.24.0-255,2902,105603,69,316556
11159,0.001523,172.31.40.0-255,66,105669,69,316556
11160,0.001528,74.125.24.0-255,2902,108571,69,316556
11161,0.001531,172.31.40.0-255,66,108637,69,316556
11162,0.001547,74.125.24.0-255,2902,111539,69,316556
11163,0.001549,172.31.40.0-255,66,111605,69,316556
11164,0.001553,74.125.24.0-255,1484,113089,69,316556
11165,0.001557,74.125.24.0-255,2902,115991,69,316556
11166,0.001559,172.31.40.0-255,66,116057,69,316556
11167,0.001605,172.31.40.0-255,66,116123,69,316556
11168,0.001616,172.31.40.0-255,66,116189,69,316556
11169,0.002374,74.125.24.0-255,1484,117673,69,316556
11170,0.002381,74.125.24.0-255,2902,120575,69,316556
11171,0.002385,172.31.40.0-255,66,120641,69,316556
11172,0.002391,74.125.24.0-255,2902,123543,69,316556
11173,0.002394,172.31.40.0-255,66,123609,69,316556
11174,0.002412,74.125.24.0-255,2902,126511,69,316556
11175,0.002414,172.31.40.0-255,66,126577,69,316556
11176,0.002419,74.125.24.0-255,2902,129479,69,316556
11177,0.00242,172.31.40.0-255,66,129545,69,316556
11178,0.002425,74.125.24.0-255,2902,132447,69,316556
11179,0.002427,172.31.40.0-255,66,132513,69,316556
11180,0.002452,74.125.24.0-255,7156,139669,69,316556
11181,0.002454,172.31.40.0-255,66,139735,69,316556
11182,0.002461,74.125.24.0-255,5738,145473,69,316556
11183,0.002463,172.31.40.0-255,66,145539,69,316556
11184,0.002482,74.125.24.0-255,5020,150559,69,316556
11185,0.002485,172.31.40.0-255,66,150625,69,316556
11186,0.0025,74.125.24.0-255,2902,153527,69,316556
11187,0.002503,172.31.40.0-255,66,153593,69,316556
11188,0.002527,172.31.40.0-255,66,153659,69,316556
11189,0.002532,74.125.24.0-255,4320,157979,69,316556
11190,0.002534,172.31.40.0-255,66,158045,69,316556
11191,0.00256,172.31.40.0-255,66,158111,69,316556
11192,0.002571,172.31.40.0-255,66,158177,69,316556
11193,0.002795,74.125.24.0-255,1484,159661,69,316556
11194,0.002812,74.125.24.0-255,2902,162563,69,316556
11195,0.002814,172.31.40.0-255,66,162629,69,316556
11196,0.00282,74.125.24.0-255,4320,166949,69,316556
11197,0.002823,172.31.40.0-255,66,167015,69,316556
11198,0.002835,74.125.24.0-255,1484,168499,69,316556
11199,0.00284,74.125.24.0-255,4320,172819,69,316556
11200,0.002842,172.31.40.0-255,66,172885,69,316556
11201,0.002865,74.125.24.0-255,7156,180041,69,316556
11202,0.002867,172.31.40.0-255,66,180107,69,316556
11203,0.002883,74.125.24.0-255,4320,184427,69,316556
11204,0.002885,172.31.40.0-255,66,184493,69,316556
11205,0.00293,74.125.24.0-255,4320,188813,69,316556
11206,0.002932,172.31.40.0-255,66,188879,69,316556
11207,0.002956,74.125.24.0-255,5020,193899,69,316556
11208,0.002958,172.31.40.0-255,66,193965,69,316556
11209,0.002969,172.31.40.0-255,66,194031,69,316556
11210,0.002981,74.125.24.0-255,5738,199769,69,316556
11211,0.002983,172.31.40.0-255,66,199835,69,316556
11212,0.003052,172.31.40.0-255,66,199901,69,316556
11213,0.003059,74.125.24.0-255,7156,207057,69,316556
11214,0.003061,172.31.40.0-255,66,207123,69,316556
11215,0.003064,74.125.24.0-255,1484,208607,69,316556
11216,0.003109,172.31.40.0-255,66,208673,69,316556
11217,0.003135,74.125.24.0-255,4320,212993,69,316556
11218,0.003138,172.31.40.0-255,66,213059,69,316556
11219,0.003141,74.125.24.0-255,1484,214543,69,316556
11220,0.003148,74.125.24.0-255,7156,221699,69,316556
11221,0.003151,172.31.40.0-255,66,221765,69,316556
11222,0.003156,74.125.24.0-255,3602,225367,69,316556
11223,0.003159,172.31.40.0-255,66,225433,69,316556
11224,0.003189,74.125.24.0-255,4320,229753,69,316556
11225,0.003193,172.31.40.0-255,66,229819,69,316556
11226,0.0032,74.125.24.0-255,5738,235557,69,316556
11227,0.003202,172.31.40.0-255,66,235623,69,316556
11228,0.003217,74.125.24.0-255,4320,239943,69,316556
11229,0.00322,172.31.40.0-255,66,240009,69,316556
11230,0.003234,74.125.24.0-255,5738,245747,69,316556
11231,0.003237,172.31.40.0-255,66,245813,69,316556
11232,0.003267,74.125.24.0-255,1484,247297,69,316556
11233,0.00328,172.31.40.0-255,66,247363,69,316556
11234,0.003285,74.125.24.0-255,3602,250965,69,316556
11235,0.003287,172.31.40.0-255,66,251031,69,316556
11236,0.00331,74.125.24.0-255,4320,255351,69,316556
11237,0.003313,172.31.40.0-255,66,255417,69,316556
11238,0.003349,172.31.40.0-255,66,255483,69,316556
11239,0.003356,74.125.24.0-255,7156,262639,69,316556
11240,0.003359,172.31.40.0-255,66,262705,69,316556
11241,0.003376,74.125.24.0-255,7156,269861,69,316556
11242,0.003379,172.31.40.0-255,66,269927,69,316556
11243,0.003385,74.125.24.0-255,6438,276365,69,316556
11244,0.003388,172.31.40.0-255,66,276431,69,316556
11245,0.003432,74.125.24.0-255,1484,277915,69,316556
11246,0.003435,74.125.24.0-255,1484,279399,69,316556
11247,0.003438,172.31.40.0-255,66,279465,69,316556
11248,0.003465,74.125.24.0-255,1484,280949,69,316556
11249,0.003472,74.125.24.0-255,5738,286687,69,316556
11250,0.003475,172.31.40.0-255,66,286753,69,316556
11251,0.003479,74.125.24.0-255,2902,289655,69,316556
11252,0.003481,172.31.40.0-255,66,289721,69,316556
11253,0.003505,74.125.24.0-255,7156,296877,69,316556
11254,0.003508,172.31.40.0-255,66,296943,69,316556
11255,0.003552,172.31.40.0-255,66,297009,69,316556
11256,0.003575,74.125.24.0-255,5020,302029,69,316556
11257,0.003579,172.31.40.0-255,66,302095,69,316556
11258,0.00359,172.31.40.0-255,66,302161,69,316556
11259,0.003608,74.125.24.0-255,4746,306907,69,316556
11260,0.003611,172.31.40.0-255,66,306973,69,316556
11261,0.003614,74.125.24.0-255,105,307078,69,316556
11262,0.00662,172.31.40.0-255,66,307144,69,316556
11263,0.006661,172.31.40.0-255,105,307249,69,316556
11264,0.009252,74.125.24.0-255,66,307315,69,316556
11265,0.03502,172.31.40.0-255,240,307555,69,316556
11266,0.035053,172.31.40.0-255,1114,308669,69,316556
11267,0.035134,172.31.40.0-255,1514,310183,69,316556
11268,0.035135,172.31.40.0-255,1514,311697,69,316556
11269,0.035141,172.31.40.0-255,1514,313211,69,316556
11270,0.035142,172.31.40.0-255,1514,314725,69,316556
11271,0.035172,172.31.40.0-255,1501,316226,69,316556
11272,0.036523,104.244.42.0-255,66,316292,69,316556
11273,0.036618,104.244.42.0-255,66,316358,69,316556
11274,0.036678,104.244.42.0-255,66,316424,69,316556
11275,0.036763,104.244.42.0-255,66,316490,69,316556
11276,0.03678,104.244.42.0-255,66,316556,69,316556
11277,0.0,74.125.24.0-255,297,297,69,255880
11278,2.3e-05,172.31.40.0-255,66,363,69,255880
11279,2.8e-05,74.125.24.0-255,1484,1847,69,255880
11280,3.3e-05,172.31.40.0-255,66,1913,69,255880
11281,4e-05,74.125.24.0-255,4320,6233,69,255880
11282,4.4e-05,172.31.40.0-255,66,6299,69,255880
11283,5.6e-05,172.31.40.0-255,66,6365,69,255880
11284,6e-05,74.125.24.0-255,2902,9267,69,255880
11285,6.3e-05,172.31.40.0-255,66,9333,69,255880
11286,0.0001,172.31.40.0-255,66,9399,69,255880
11287,0.000104,74.125.24.0-255,2543,11942,69,255880
11288,0.000106,172.31.40.0-255,66,12008,69,255880
11289,0.000153,74.125.24.0-255,1484,13492,69,255880
11290,0.000156,172.31.40.0-255,66,13558,69,255880
11291,0.000169,74.125.24.0-255,2902,16460,69,255880
11292,0.000172,172.31.40.0-255,66,16526,69,255880
11293,0.000198,74.125.24.0-255,5738,22264,69,255880
11294,0.000201,172.31.40.0-255,66,22330,69,255880
11295,0.000204,74.125.24.0-255,1484,23814,69,255880
11296,0.000206,172.31.40.0-255,66,23880,69,255880
11297,0.000234,172.31.40.0-255,66,23946,69,255880
11298,0.000288,172.31.40.0-255,66,24012,69,255880
11299,0.000301,74.125.24.0-255,135,24147,69,255880
11300,0.000303,172.31.40.0-255,66,24213,69,255880
11301,0.000395,74.125.24.0-255,1484,25697,69,255880
11302,0.000399,172.31.40.0-255,66,25763,69,255880
11303,0.000404,74.125.24.0-255,2902,28665,69,255880
11304,0.000406,172.31.40.0-255,66,28731,69,255880
11305,0.000411,74.125.24.0-255,2902,31633,69,255880
11306,0.000413,172.31.40.0-255,66,31699,69,255880
11307,0.000433,74.125.24.0-255,2902,34601,69,255880
11308,0.000435,172.31.40.0-255,66,34667,69,255880
11309,0.00046,74.125.24.0-255,4320,38987,69,255880
11310,0.000462,172.31.40.0-255,66,39053,69,255880
11311,0.000474,74.125.24.0-255,2543,41596,69,255880
11312,0.000476,172.31.40.0-255,66,41662,69,255880
11313,0.000495,74.125.24.0-255,7156,48818,69,255880
11314,0.000498,172.31.40.0-255,66,48884,69,255880
11315,0.000534,172.31.40.0-255,66,48950,69,255880
11316,0.001254,74.125.24.0-255,1484,50434,69,255880
11317,0.001274,74.125.24.0-255,2902,53336,69,255880
11318,0.001278,172.31.40.0-255,66,53402,69,255880
11319,0.001286,74.125.24.0-255,5738,59140,69,255880
11320,0.001288,172.31.40.0-255,66,59206,69,255880
11321,0.001318,74.125.24.0-255,4320,63526,69,255880
11322,0.00132,172.31.40.0-255,66,63592,69,255880
11323,0.001345,172.31.40.0-255,66,63658,69,255880
11324,0.001355,172.31.40.0-255,66,63724,69,255880
11325,0.001371,74.125.24.0-255,2184,65908,69,255880
11326,0.001373,172.31.40.0-255,66,65974,69,255880
11327,0.001467,74.125.24.0-255,1484,67458,69,255880
11328,0.001473,74.125.24.0-255,2902,70360,69,255880
11329,0.001477,172.31.40.0-255,66,70426,69,255880
11330,0.001483,74.125.24.0-255,4320,74746,69,255880
11331,0.001484,172.31.40.0-255,66,74812,69,255880
11332,0.001497,74.125.24.0-255,1484,76296,69,255880
11333,0.001503,74.125.24.0-255,2902,79198,69,255880
11334,0.001505,172.31.40.0-255,66,79264,69,255880
11335,0.001535,172.31.40.0-255,66,79330,69,255880
11336,0.001546,172.31.40.0-255,66,79396,69,255880
11337,0.001566,74.125.24.0-255,766,80162,69,255880
11338,0.001595,74.125.24.0-255,1484,81646,69,255880
11339,0.001598,172.31.40.0-255,66,81712,69,255880
11340,0.001605,74.125.24.0-255,4320,86032,69,255880
11341,0.001607,172.31.40.0-255,66,86098,69,255880
11342,0.001627,74.125.24.0-255,2902,89000,69,255880
11343,0.00163,172.31.40.0-255,66,89066,69,255880
11344,0.001646,74.125.24.0-255,7156,96222,69,255880
11345,0.001649,172.31.40.0-255,66,96288,69,255880
11346,0.001652,74.125.24.0-255,1484,97772,69,255880
11347,0.001682,172.31.40.0-255,66,97838,69,255880
11348,0.001689,74.125.24.0-255,6438,104276,69,255880
11349,0.001692,172.31.40.0-255,66,104342,69,255880
11350,0.001757,74.125.24.0-255,1484,105826,69,255880
11351,0.001763,74.125.24.0-255,2902,108728,69,255880
11352,0.001766,172.31.40.0-255,66,108794,69,255880
11353,0.001769,74.125.24.0-255,1484,110278,69,255880
11354,0.001789,74.125.24.0-255,4320,114598,69,255880
11355,0.001791,172.31.40.0-255,66,114664,69,255880
11356,0.001795,74.125.24.0-255,2902,117566,69,255880
11357,0.001798,172.31.40.0-255,66,117632,69,255880
11358,0.00182,172.31.40.0-255,66,117698,69,255880
11359,0.001849,172.31.40.0-255,66,117764,69,255880
11360,0.001995,74.125.24.0-255,1484,119248,69,255880
11361,0.002001,74.125.24.0-255,2902,122150,69,255880
11362,0.002005,172.31.40.0-255,66,122216,69,255880
11363,0.002011,74.125.24.0-255,4320,126536,69,255880
11364,0.002013,172.31.40.0-255,66,126602,69,255880
11365,0.002026,74.125.24.0-255,1484,128086,69,255880
11366,0.002061,172.31.40.0-255,66,128152,69,255880
11367,0.002068,74.125.24.0-255,5738,133890,69,255880
11368,0.00207,172.31.40.0-255,66,133956,69,255880
11369,0.002093,172.31.40.0-255,66,134022,69,255880
11370,0.002106,172.31.40.0-255,66,134088,69,255880
11371,0.002138,74.125.24.0-255,2902,136990,69,255880
11372,0.00214,172.31.40.0-255,66,137056,69,255880
11373,0.002174,172.31.40.0-255,66,137122,69,255880
11374,0.004473,74.125.24.0-255,5738,142860,69,255880
11375,0.00448,172.31.40.0-255,66,142926,69,255880
11376,0.006815,74.125.24.0-255,5738,148664,69,255880
11377,0.006822,172.31.40.0-255,66,148730,69,255880
11378,0.009094,74.125.24.0-255,5738,154468,69,255880
11379,0.0091,172.31.40.0-255,66,154534,69,255880
11380,0.011401,74.125.24.0-255,5738,160272,69,255880
11381,0.011408,172.31.40.0-255,66,160338,69,255880
11382,0.013693,74.125.24.0-255,5738,166076,69,255880
11383,0.0137,172.31.40.0-255,66,166142,69,255880
11384,0.015995,74.125.24.0-255,5738,171880,69,255880
11385,0.016003,172.31.40.0-255,66,171946,69,255880
11386,0.018322,74.125.24.0-255,5738,177684,69,255880
11387,0.018331,172.31.40.0-255,66,177750,69,255880
11388,0.02062,74.125.24.0-255,5738,183488,69,255880
11389,0.020628,172.31.40.0-255,66,183554,69,255880
11390,0.022902,74.125.24.0-255,5738,189292,69,255880
11391,0.022909,172.31.40.0-255,66,189358,69,255880
11392,0.025189,74.125.24.0-255,5738,195096,69,255880
11393,0.025199,172.31.40.0-255,66,195162,69,255880
11394,0.027502,74.125.24.0-255,5738,200900,69,255880
11395,0.02751,172.31.40.0-255,66,200966,69,255880
11396,0.029801,74.125.24.0-255,5738,206704,69,255880
11397,0.02981,172.31.40.0-255,66,206770,69,255880
11398,0.032109,74.125.24.0-255,5738,212508,69,255880
11399,0.032118,172.31.40.0-255,66,212574,69,255880
11400,0.03443,74.125.24.0-255,5738,218312,69,255880
11401,0.034438,172.31.40.0-255,66,218378,69,255880
11402,0.036743,74.125.24.0-255,5738,224116,69,255880
11403,0.036751,172.31.40.0-255,66,224182,69,255880
11404,0.03722,172.31.40.0-255,172,224354,69,255880
11405,0.037251,172.31.40.0-255,1114,225468,69,255880
11406,0.03731,172.31.40.0-255,562,226030,69,255880
11407,0.038775,104.244.42.0-255,66,226096,69,255880
11408,0.038818,104.244.42.0-255,66,226162,69,255880
11409,0.038859,104.244.42.0-255,66,226228,69,255880
11410,0.039052,74.125.24.0-255,5738,231966,69,255880
11411,0.039059,172.31.40.0-255,66,232032,69,255880
11412,0.041364,74.125.24.0-255,5738,237770,69,255880
11413,0.041373,172.31.40.0-255,66,237836,69,255880
11414,0.043668,74.125.24.0-255,5738,243574,69,255880
11415,0.043675,172.31.40.0-255,66,243640,69,255880
11416,0.046035,74.125.24.0-255,5738,249378,69,255880
11417,0.046042,172.31.40.0-255,66,249444,69,255880
11418,0.048336,74.125.24.0-255,5738,255182,69,255880
11419,0.048343,172.31.40.0-255,66,255248,69,255880
11420,0.050595,74.125.24.0-255,395,255643,69,255880
11421,0.050721,172.31.40.0-255,66,255709,69,255880
11422,0.050756,172.31.40.0-255,105,255814,69,255880
11423,0.053004,74.125.24.0-255,66,255880,69,255880
11424,0.0,74.125.24.0-255,153,153,69,305710
11425,2.4e-05,172.31.40.0-255,66,219,69,305710
11426,3.1e-05,74.125.24.0-255,1484,1703,69,305710
11427,3.7e-05,172.31.40.0-255,66,1769,69,305710
11428,4.3e-05,74.125.24.0-255,2902,4671,69,305710
11429,5.3e-05,172.31.40.0-255,66,4737,69,305710
11430,6.2e-05,74.125.24.0-255,7156,11893,69,305710
11431,6.5e-05,172.31.40.0-255,66,11959,69,305710
11432,6.9e-05,74.125.24.0-255,2063,14022,69,305710
11433,7.1e-05,172.31.40.0-255,66,14088,69,305710
11434,7.6e-05,74.125.24.0-255,2902,16990,69,305710
11435,7.9e-05,172.31.40.0-255,66,17056,69,305710
11436,0.000109,172.31.40.0-255,66,17122,69,305710
11437,0.000115,74.125.24.0-255,5379,22501,69,305710
11438,0.000118,172.31.40.0-255,66,22567,69,305710
11439,0.000238,74.125.24.0-255,1484,24051,69,305710
11440,0.000242,172.31.40.0-255,66,24117,69,305710
11441,0.000246,74.125.24.0-255,1484,25601,69,305710
11442,0.000248,172.31.40.0-255,66,25667,69,305710
11443,0.000281,74.125.24.0-255,1484,27151,69,305710
11444,0.000283,172.31.40.0-255,66,27217,69,305710
11445,0.00029,74.125.24.0-255,5738,32955,69,305710
11446,0.000292,172.31.40.0-255,66,33021,69,305710
11447,0.000309,172.31.40.0-255,66,33087,69,305710
11448,0.000337,74.125.24.0-255,3961,37048,69,305710
11449,0.000344,172.31.40.0-255,66,37114,69,305710
11450,0.000355,172.31.40.0-255,66,37180,69,305710
11451,0.000358,74.125.24.0-255,1438,38618,69,305710
11452,0.00036,172.31.40.0-255,66,38684,69,305710
11453,0.000465,74.125.24.0-255,111,38795,69,305710
11454,0.000641,74.125.24.0-255,1484,40279,69,305710
11455,0.000657,74.125.24.0-255,2902,43181,69,305710
11456,0.000664,74.125.24.0-255,5738,48919,69,305710
11457,0.000683,172.31.40.0-255,66,48985,69,305710
11458,0.000699,74.125.24.0-255,5738,54723,69,305710
11459,0.000718,74.125.24.0-255,5379,60102,69,305710
11460,0.000739,74.125.24.0-255,1484,61586,69,305710
11461,0.000748,172.31.40.0-255,66,61652,69,305710
11462,0.000777,74.125.24.0-255,1125,62777,69,305710
11463,0.000826,74.125.24.0-255,328,63105,69,305710
11464,0.000905,74.125.24.0-255,1484,64589,69,305710
11465,0.000911,74.125.24.0-255,2902,67491,69,305710
11466,0.000928,172.31.40.0-255,66,67557,69,305710
11467,0.000947,74.125.24.0-255,5738,73295,69,305710
11468,0.00099,172.31.40.0-255,66,73361,69,305710
11469,0.001322,74.125.24.0-255,1484,74845,69,305710
11470,0.001329,74.125.24.0-255,2902,77747,69,305710
11471,0.001332,172.31.40.0-255,66,77813,69,305710
11472,0.001336,74.125.24.0-255,1484,79297,69,305710
11473,0.001362,74.125.24.0-255,4320,83617,69,305710
11474,0.001368,74.125.24.0-255,5738,89355,69,305710
11475,0.001378,172.31.40.0-255,66,89421,69,305710
11476,0.00142,74.125.24.0-255,5020,94441,69,305710
11477,0.001458,172.31.40.0-255,66,94507,69,305710
11478,0.002117,74.125.24.0-255,1484,95991,69,305710
11479,0.002125,74.125.24.0-255,2902,98893,69,305710
11480,0.002129,172.31.40.0-255,66,98959,69,305710
11481,0.002133,74.125.24.0-255,1484,100443,69,305710
11482,0.002167,74.125.24.0-255,4320,104763,69,305710
11483,0.002184,172.31.40.0-255,66,104829,69,305710
11484,0.002233,172.31.40.0-255,66,104895,69,305710
11485,0.004766,74.125.24.0-255,5738,110633,69,305710
11486,0.004776,172.31.40.0-255,66,110699,69,305710
11487,0.007304,74.125.24.0-255,5738,116437,69,305710
11488,0.008866,172.31.40.0-255,66,116503,69,305710
11489,0.011432,74.125.24.0-255,5738,122241,69,305710
11490,0.011443,172.31.40.0-255,66,122307,69,305710
11491,0.013962,74.125.24.0-255,5738,128045,69,305710
11492,0.014482,172.31.40.0-255,66,128111,69,305710
11493,0.017003,74.125.24.0-255,5738,133849,69,305710
11494,0.017019,172.31.40.0-255,66,133915,69,305710
11495,0.019571,74.125.24.0-255,5738,139653,69,305710
11496,0.019578,172.31.40.0-255,66,139719,69,305710
11497,0.022151,74.125.24.0-255,5738,145457,69,305710
11498,0.022163,172.31.40.0-255,66,145523,69,305710
11499,0.024716,74.125.24.0-255,5738,151261,69,305710
11500,0.024728,172.31.40.0-255,66,151327,69,305710
11501,0.027253,74.125.24.0-255,5738,157065,69,305710
11502,0.027264,172.31.40.0-255,66,157131,69,305710
11503,0.029838,74.125.24.0-255,5738,162869,69,305710
11504,0.029854,172.31.40.0-255,66,162935,69,305710
11505,0.0324,74.125.24.0-255,5738,168673,69,305710
11506,0.032413,172.31.40.0-255,66,168739,69,305710
11507,0.034977,74.125.24.0-255,5738,174477,69,305710
11508,0.03499,172.31.40.0-255,66,174543,69,305710
11509,0.037532,172.31.40.0-255,172,174715,69,305710
11510,0.037566,172.31.40.0-255,1114,175829,69,305710
11511,0.037608,74.125.24.0-255,5738,181567,69,305710
11512,0.037613,172.31.40.0-255,66,181633,69,305710
11513,0.037727,172.31.40.0-255,1514,183147,69,305710
11514,0.037729,172.31.40.0-255,1514,184661,69,305710
11515,0.037735,172.31.40.0-255,1514,186175,69,305710
11516,0.037736,172.31.40.0-255,1514,187689,69,305710
11517,0.037754,172.31.40.0-255,1503,189192,69,305710
11518,0.039086,104.244.42.0-255,66,189258,69,305710
11519,0.039096,104.244.42.0-255,66,189324,69,305710
11520,0.039296,104.244.42.0-255,66,189390,69,305710
11521,0.039304,104.244.42.0-255,66,189456,69,305710
11522,0.039729,104.244.42.0-255,108,189564,69,305710
11523,0.039739,172.31.40.0-255,66,189630,69,305710
11524,0.040161,74.125.24.0-255,5738,195368,69,305710
11525,0.040168,172.31.40.0-255,66,195434,69,305710
11526,0.042735,74.125.24.0-255,5738,201172,69,305710
11527,0.042742,172.31.40.0-255,66,201238,69,305710
11528,0.045264,74.125.24.0-255,5738,206976,69,305710
11529,0.045271,172.31.40.0-255,66,207042,69,305710
11530,0.047782,74.125.24.0-255,5738,212780,69,305710
11531,0.047788,172.31.40.0-255,66,212846,69,305710
11532,0.050353,74.125.24.0-255,5738,218584,69,305710
11533,0.050361,172.31.40.0-255,66,218650,69,305710
11534,0.052912,74.125.24.0-255,5738,224388,69,305710
11535,0.052922,172.31.40.0-255,66,224454,69,305710
11536,0.055482,74.125.24.0-255,5738,230192,69,305710
11537,0.055489,172.31.40.0-255,66,230258,69,305710
11538,0.058036,74.125.24.0-255,5738,235996,69,305710
11539,0.058043,172.31.40.0-255,66,236062,69,305710
11540,0.060598,74.125.24.0-255,5738,241800,69,305710
11541,0.060605,172.31.40.0-255,66,241866,69,305710
11542,0.063117,74.125.24.0-255,5738,247604,69,305710
11543,0.063125,172.31.40.0-255,66,247670,69,305710
11544,0.065697,74.125.24.0-255,5738,253408,69,305710
11545,0.065705,172.31.40.0-255,66,253474,69,305710
11546,0.068305,74.125.24.0-255,5738,259212,69,305710
11547,0.068313,172.31.40.0-255,66,259278,69,305710
11548,0.07086,74.125.24.0-255,5738,265016,69,305710
11549,0.070868,172.31.40.0-255,66,265082,69,305710
11550,0.073397,74.125.24.0-255,5738,270820,69,305710
11551,0.073404,172.31.40.0-255,66,270886,69,305710
11552,0.075912,74.125.24.0-255,5738,276624,69,305710
11553,0.075919,172.31.40.0-255,66,276690,69,305710
11554,0.078455,74.125.24.0-255,5738,282428,69,305710
11555,0.07846,172.31.40.0-255,66,282494,69,305710
11556,0.081007,74.125.24.0-255,5738,288232,69,305710
11557,0.081014,172.31.40.0-255,66,288298,69,305710
11558,0.08357,74.125.24.0-255,5738,294036,69,305710
11559,0.083578,172.31.40.0-255,66,294102,69,305710
11560,0.086135,74.125.24.0-255,5738,299840,69,305710
11561,0.086142,172.31.40.0-255,66,299906,69,305710
11562,0.088668,74.125.24.0-255,5738,305644,69,305710
11563,0.088678,172.31.40.0-255,66,305710,69,305710
11564,0.0,74.125.200.0-255,153,153,69,424587
11565,2.3e-05,172.31.40.0-255,66,219,69,424587
11566,3e-05,74.125.200.0-255,1484,1703,69,424587
11567,3.5e-05,172.31.40.0-255,66,1769,69,424587
11568,4.8e-05,74.125.200.0-255,2902,4671,69,424587
11569,5.3e-05,172.31.40.0-255,66,4737,69,424587
11570,6e-05,74.125.200.0-255,7156,11893,69,424587
11571,6.4e-05,172.31.40.0-255,66,11959,69,424587
11572,6.7e-05,74.125.200.0-255,2038,13997,69,424587
11573,6.9e-05,172.31.40.0-255,66,14063,69,424587
11574,0.000615,74.125.200.0-255,1484,15547,69,424587
11575,0.000621,172.31.40.0-255,66,15613,69,424587
11576,0.000674,74.125.200.0-255,1484,17097,69,424587
11577,0.000677,172.31.40.0-255,66,17163,69,424587
11578,0.000702,74.125.200.0-255,2902,20065,69,424587
11579,0.000704,172.31.40.0-255,66,20131,69,424587
11580,0.000722,74.125.200.0-255,2902,23033,69,424587
11581,0.000724,172.31.40.0-255,66,23099,69,424587
11582,0.000728,74.125.200.0-255,1484,24583,69,424587
11583,0.000729,172.31.40.0-255,66,24649,69,424587
11584,0.000754,74.125.200.0-255,2902,27551,69,424587
11585,0.00076,172.31.40.0-255,66,27617,69,424587
11586,0.00079,74.125.200.0-255,3961,31578,69,424587
11587,0.000793,172.31.40.0-255,66,31644,69,424587
11588,0.000934,74.125.200.0-255,1484,33128,69,424587
11589,0.000938,172.31.40.0-255,66,33194,69,424587
11590,0.000944,74.125.200.0-255,2902,36096,69,424587
11591,0.000946,172.31.40.0-255,66,36162,69,424587
11592,0.000949,74.125.200.0-255,1484,37646,69,424587
11593,0.000951,172.31.40.0-255,66,37712,69,424587
11594,0.00098,74.125.200.0-255,4320,42032,69,424587
11595,0.000983,172.31.40.0-255,66,42098,69,424587
11596,0.000987,74.125.200.0-255,4320,46418,69,424587
11597,0.000989,172.31.40.0-255,66,46484,69,424587
11598,0.001033,74.125.200.0-255,2902,49386,69,424587
11599,0.001036,172.31.40.0-255,66,49452,69,424587
11600,0.001065,74.125.200.0-255,2543,51995,69,424587
11601,0.001068,172.31.40.0-255,66,52061,69,424587
11602,0.001075,74.125.200.0-255,5738,57799,69,424587
11603,0.001077,172.31.40.0-255,66,57865,69,424587
11604,0.001084,74.125.200.0-255,2902,60767,69,424587
11605,0.001085,172.31.40.0-255,66,60833,69,424587
11606,0.001113,74.125.200.0-255,5686,66519,69,424587
11607,0.001115,172.31.40.0-255,66,66585,69,424587
11608,0.001138,74.125.200.0-255,115,66700,69,424587
11609,0.001178,74.125.200.0-255,329,67029,69,424587
11610,0.001452,74.125.200.0-255,1484,68513,69,424587
11611,0.001457,172.31.40.0-255,66,68579,69,424587
11612,0.001461,74.125.200.0-255,2902,71481,69,424587
11613,0.001463,172.31.40.0-255,66,71547,69,424587
11614,0.001481,74.125.200.0-255,4320,75867,69,424587
11615,0.001483,172.31.40.0-255,66,75933,69,424587
11616,0.0015,74.125.200.0-255,1484,77417,69,424587
11617,0.001503,74.125.200.0-255,1484,78901,69,424587
11618,0.001505,172.31.40.0-255,66,78967,69,424587
11619,0.001509,74.125.200.0-255,2902,81869,69,424587
11620,0.001511,172.31.40.0-255,66,81935,69,424587
11621,0.001513,74.125.200.0-255,1484,83419,69,424587
11622,0.001544,74.125.200.0-255,4320,87739,69,424587
11623,0.001546,172.31.40.0-255,66,87805,69,424587
11624,0.001549,74.125.200.0-255,1484,89289,69,424587
11625,0.001573,74.125.200.0-255,4320,93609,69,424587
11626,0.001575,172.31.40.0-255,66,93675,69,424587
11627,0.001581,74.125.200.0-255,5738,99413,69,424587
11628,0.001583,172.31.40.0-255,66,99479,69,424587
11629,0.001609,74.125.200.0-255,1484,100963,69,424587
11630,0.001612,74.125.200.0-255,766,101729,69,424587
11631,0.001614,172.31.40.0-255,66,101795,69,424587
11632,0.001816,74.125.200.0-255,1484,103279,69,424587
11633,0.001836,74.125.200.0-255,1484,104763,69,424587
11634,0.001838,172.31.40.0-255,66,104829,69,424587
11635,0.001887,74.125.200.0-255,1484,106313,69,424587
11636,0.001899,74.125.200.0-255,1484,107797,69,424587
11637,0.001901,172.31.40.0-255,66,107863,69,424587
11638,0.001904,74.125.200.0-255,1484,109347,69,424587
11639,0.001931,74.125.200.0-255,2902,112249,69,424587
11640,0.001933,172.31.40.0-255,66,112315,69,424587
11641,0.001966,74.125.200.0-255,5738,118053,69,424587
11642,0.001969,172.31.40.0-255,66,118119,69,424587
11643,0.001993,74.125.200.0-255,2902,121021,69,424587
11644,0.001995,172.31.40.0-255,66,121087,69,424587
11645,0.002,74.125.200.0-255,4320,125407,69,424587
11646,0.002002,172.31.40.0-255,66,125473,69,424587
11647,0.002011,74.125.200.0-255,5738,131211,69,424587
11648,0.002013,172.31.40.0-255,66,131277,69,424587
11649,0.002016,74.125.200.0-255,1484,132761,69,424587
11650,0.00202,74.125.200.0-255,2902,135663,69,424587
11651,0.002022,172.31.40.0-255,66,135729,69,424587
11652,0.002059,74.125.200.0-255,766,136495,69,424587
11653,0.002154,74.125.200.0-255,1484,137979,69,424587
11654,0.002156,172.31.40.0-255,66,138045,69,424587
11655,0.002159,74.125.200.0-255,1484,139529,69,424587
11656,0.00218,74.125.200.0-255,1484,141013,69,424587
11657,0.002182,172.31.40.0-255,66,141079,69,424587
11658,0.002188,74.125.200.0-255,5738,146817,69,424587
11659,0.002191,172.31.40.0-255,66,146883,69,424587
11660,0.002194,74.125.200.0-255,2902,149785,69,424587
11661,0.0022,172.31.40.0-255,66,149851,69,424587
11662,0.002219,74.125.200.0-255,1484,151335,69,424587
11663,0.002228,74.125.200.0-255,5738,157073,69,424587
11664,0.002231,172.31.40.0-255,66,157139,69,424587
11665,0.002243,74.125.200.0-255,1484,158623,69,424587
11666,0.002269,172.31.40.0-255,66,158689,69,424587
11667,0.002303,74.125.200.0-255,2184,160873,69,424587
11668,0.002305,172.31.40.0-255,66,160939,69,424587
11669,0.00233,74.125.200.0-255,2902,163841,69,424587
11670,0.002332,172.31.40.0-255,66,163907,69,424587
11671,0.002356,74.125.200.0-255,7156,171063,69,424587
11672,0.002359,172.31.40.0-255,66,171129,69,424587
11673,0.002393,74.125.200.0-255,1484,172613,69,424587
11674,0.002408,74.125.200.0-255,1484,174097,69,424587
11675,0.00241,172.31.40.0-255,66,174163,69,424587
11676,0.002436,74.125.200.0-255,1484,175647,69,424587
11677,0.002442,74.125.200.0-255,5738,181385,69,424587
11678,0.002444,172.31.40.0-255,66,181451,69,424587
11679,0.002446,74.125.200.0-255,1484,182935,69,424587
11680,0.002474,74.125.200.0-255,7156,190091,69,424587
11681,0.002477,172.31.40.0-255,66,190157,69,424587
11682,0.002499,74.125.200.0-255,5020,195177,69,424587
11683,0.002501,172.31.40.0-255,66,195243,69,424587
11684,0.002525,74.125.200.0-255,1484,196727,69,424587
11685,0.002539,74.125.200.0-255,4320,201047,69,424587
11686,0.002542,172.31.40.0-255,66,201113,69,424587
11687,0.002546,74.125.200.0-255,1484,202597,69,424587
11688,0.002572,74.125.200.0-255,4320,206917,69,424587
11689,0.002575,172.31.40.0-255,66,206983,69,424587
11690,0.00258,74.125.200.0-255,4320,211303,69,424587
11691,0.002583,172.31.40.0-255,66,211369,69,424587
11692,0.002605,74.125.200.0-255,2902,214271,69,424587
11693,0.002612,172.31.40.0-255,66,214337,69,424587
11694,0.002618,74.125.200.0-255,5738,220075,69,424587
11695,0.00262,172.31.40.0-255,66,220141,69,424587
11696,0.002661,74.125.200.0-255,4320,224461,69,424587
11697,0.002663,172.31.40.0-255,66,224527,69,424587
11698,0.002689,74.125.200.0-255,2902,227429,69,424587
11699,0.002692,172.31.40.0-255,66,227495,69,424587
11700,0.005328,74.125.200.0-255,5738,233233,69,424587
11701,0.005338,172.31.40.0-255,66,233299,69,424587
11702,0.007991,74.125.200.0-255,5738,239037,69,424587
11703,0.007999,172.31.40.0-255,66,239103,69,424587
11704,0.010655,74.125.200.0-255,5738,244841,69,424587
11705,0.010664,172.31.40.0-255,66,244907,69,424587
11706,0.013318,74.125.200.0-255,5738,250645,69,424587
11707,0.013327,172.31.40.0-255,66,250711,69,424587
11708,0.015968,74.125.200.0-255,4320,255031,69,424587
11709,0.015975,172.31.40.0-255,66,255097,69,424587
11710,0.016006,74.125.200.0-255,1484,256581,69,424587
11711,0.018634,74.125.200.0-255,4320,260901,69,424587
11712,0.018644,172.31.40.0-255,66,260967,69,424587
11713,0.021287,74.125.200.0-255,5738,266705,69,424587
11714,0.021294,172.31.40.0-255,66,266771,69,424587
11715,0.023949,74.125.200.0-255,5738,272509,69,424587
11716,0.023959,172.31.40.0-255,66,272575,69,424587
11717,0.026617,74.125.200.0-255,5738,278313,69,424587
11718,0.026625,172.31.40.0-255,66,278379,69,424587
11719,0.029266,74.125.200.0-255,5738,284117,69,424587
11720,0.029273,172.31.40.0-255,66,284183,69,424587
11721,0.031919,74.125.200.0-255,5738,289921,69,424587
11722,0.031925,172.31.40.0-255,66,289987,69,424587
11723,0.034605,74.125.200.0-255,5738,295725,69,424587
11724,0.034613,172.31.40.0-255,66,295791,69,424587
11725,0.035113,172.31.40.0-255,171,295962,69,424587
11726,0.035145,172.31.40.0-255,1140,297102,69,424587
11727,0.035209,172.31.40.0-255,1514,298616,69,424587
11728,0.035211,172.31.40.0-255,1514,300130,69,424587
11729,0.035216,172.31.40.0-255,1514,301644,69,424587
11730,0.035217,172.31.40.0-255,1514,303158,69,424587
11731,0.035238,172.31.40.0-255,1514,304672,69,424587
11732,0.035239,172.31.40.0-255,1514,306186,69,424587
11733,0.03526,172.31.40.0-255,101,306287,69,424587
11734,0.03676,104.244.42.0-255,66,306353,69,424587
11735,0.036851,104.244.42.0-255,66,306419,69,424587
11736,0.036919,104.244.42.0-255,66,306485,69,424587
11737,0.036924,104.244.42.0-255,66,306551,69,424587
11738,0.037268,74.125.200.0-255,5738,312289,69,424587
11739,0.037273,172.31.40.0-255,66,312355,69,424587
11740,0.039915,74.125.200.0-255,2902,315257,69,424587
11741,0.039922,172.31.40.0-255,66,315323,69,424587
11742,0.039951,74.125.200.0-255,2902,318225,69,424587
11743,0.039953,172.31.40.0-255,66,318291,69,424587
11744,0.042563,74.125.200.0-255,2902,321193,69,424587
11745,0.04257,172.31.40.0-255,66,321259,69,424587
11746,0.042602,74.125.200.0-255,2902,324161,69,424587
11747,0.042605,172.31.40.0-255,66,324227,69,424587
11748,0.042781,172.31.40.0-255,108,324335,69,424587
11749,0.044431,104.244.42.0-255,66,324401,69,424587
11750,0.045216,74.125.200.0-255,2902,327303,69,424587
11751,0.045224,172.31.40.0-255,66,327369,69,424587
11752,0.045259,74.125.200.0-255,2902,330271,69,424587
11753,0.045262,172.31.40.0-255,66,330337,69,424587
11754,0.047866,74.125.200.0-255,2902,333239,69,424587
11755,0.047877,172.31.40.0-255,66,333305,69,424587
11756,0.047909,74.125.200.0-255,2902,336207,69,424587
11757,0.047912,172.31.40.0-255,66,336273,69,424587
11758,0.050528,74.125.200.0-255,2902,339175,69,424587
11759,0.050537,172.31.40.0-255,66,339241,69,424587
11760,0.050571,74.125.200.0-255,2902,342143,69,424587
11761,0.050575,172.31.40.0-255,66,342209,69,424587
11762,0.053174,74.125.200.0-255,2902,345111,69,424587
11763,0.053181,172.31.40.0-255,66,345177,69,424587
11764,0.053209,74.125.200.0-255,2902,348079,69,424587
11765,0.053211,172.31.40.0-255,66,348145,69,424587
11766,0.055831,74.125.200.0-255,2902,351047,69,424587
11767,0.055841,172.31.40.0-255,66,351113,69,424587
11768,0.055876,74.125.200.0-255,2902,354015,69,424587
11769,0.055879,172.31.40.0-255,66,354081,69,424587
11770,0.058482,74.125.200.0-255,2902,356983,69,424587
11771,0.058489,172.31.40.0-255,66,357049,69,424587
11772,0.058525,74.125.200.0-255,2902,359951,69,424587
11773,0.058528,172.31.40.0-255,66,360017,69,424587
11774,0.061124,74.125.200.0-255,2902,362919,69,424587
11775,0.061132,172.31.40.0-255,66,362985,69,424587
11776,0.061163,74.125.200.0-255,2902,365887,69,424587
11777,0.061166,172.31.40.0-255,66,365953,69,424587
11778,0.063771,74.125.200.0-255,1484,367437,69,424587
11779,0.063791,74.125.200.0-255,4320,371757,69,424587
11780,0.063796,172.31.40.0-255,66,371823,69,424587
11781,0.06658,74.125.200.0-255,5738,377561,69,424587
11782,0.066587,172.31.40.0-255,66,377627,69,424587
11783,0.069233,74.125.200.0-255,5738,383365,69,424587
11784,0.069241,172.31.40.0-255,66,383431,69,424587
11785,0.071887,74.125.200.0-255,5738,389169,69,424587
11786,0.071895,172.31.40.0-255,66,389235,69,424587
11787,0.074539,74.125.200.0-255,5738,394973,69,424587
11788,0.074547,172.31.40.0-255,66,395039,69,424587
11789,0.077218,74.125.200.0-255,5738,400777,69,424587
11790,0.077224,172.31.40.0-255,66,400843,69,424587
11791,0.079895,74.125.200.0-255,2902,403745,69,424587
11792,0.079904,172.31.40.0-255,66,403811,69,424587
11793,0.079936,74.125.200.0-255,2902,406713,69,424587
11794,0.079939,172.31.40.0-255,66,406779,69,424587
11795,0.082555,74.125.200.0-255,2902,409681,69,424587
11796,0.082563,172.31.40.0-255,66,409747,69,424587
11797,0.082595,74.125.200.0-255,2902,412649,69,424587
11798,0.082598,172.31.40.0-255,66,412715,69,424587
11799,0.085216,74.125.200.0-255,2902,415617,69,424587
11800,0.085224,172.31.40.0-255,66,415683,69,424587
11801,0.08525,74.125.200.0-255,2902,418585,69,424587
11802,0.085253,172.31.40.0-255,66,418651,69,424587
11803,0.087874,74.125.200.0-255,2902,421553,69,424587
11804,0.087883,172.31.40.0-255,66,421619,69,424587
11805,0.087914,74.125.200.0-255,2902,424521,69,424587
11806,0.087918,172.31.40.0-255,66,424587,69,424587
11807,0.0,74.125.24.0-255,153,153,69,261475
11808,2.1e-05,172.31.40.0-255,66,219,69,261475
11809,2.8e-05,74.125.24.0-255,1484,1703,69,261475
11810,3.2e-05,172.31.40.0-255,66,1769,69,261475
11811,3.7e-05,74.125.24.0-255,2902,4671,69,261475
11812,4e-05,172.31.40.0-255,66,4737,69,261475
11813,4.7e-05,74.125.24.0-255,7156,11893,69,261475
11814,5e-05,172.31.40.0-255,66,11959,69,261475
11815,5.7e-05,74.125.24.0-255,5738,17697,69,261475
11816,6e-05,172.31.40.0-255,66,17763,69,261475
11817,8.7e-05,74.125.24.0-255,4900,22663,69,261475
11818,9e-05,172.31.40.0-255,66,22729,69,261475
11819,0.000122,172.31.40.0-255,66,22795,69,261475
11820,0.000278,74.125.24.0-255,1484,24279,69,261475
11821,0.000281,172.31.40.0-255,66,24345,69,261475
11822,0.000299,74.125.24.0-255,2902,27247,69,261475
11823,0.000301,172.31.40.0-255,66,27313,69,261475
11824,0.000307,74.125.24.0-255,5738,33051,69,261475
11825,0.000309,172.31.40.0-255,66,33117,69,261475
11826,0.000354,74.125.24.0-255,5738,38855,69,261475
11827,0.000357,172.31.40.0-255,66,38921,69,261475
11828,0.000372,74.125.24.0-255,1125,40046,69,261475
11829,0.000374,172.31.40.0-255,66,40112,69,261475
11830,0.000431,74.125.24.0-255,1484,41596,69,261475
11831,0.000433,172.31.40.0-255,66,41662,69,261475
11832,0.000437,74.125.24.0-255,2902,44564,69,261475
11833,0.00044,172.31.40.0-255,66,44630,69,261475
11834,0.000463,74.125.24.0-255,5738,50368,69,261475
11835,0.000466,172.31.40.0-255,66,50434,69,261475
11836,0.000506,74.125.24.0-255,5738,56172,69,261475
11837,0.000509,172.31.40.0-255,66,56238,69,261475
11838,0.00053,74.125.24.0-255,1504,57742,69,261475
11839,0.000532,172.31.40.0-255,66,57808,69,261475
11840,0.000535,74.125.24.0-255,329,58137,69,261475
11841,0.000773,74.125.24.0-255,1484,59621,69,261475
11842,0.000777,172.31.40.0-255,66,59687,69,261475
11843,0.000782,74.125.24.0-255,2902,62589,69,261475
11844,0.000801,74.125.24.0-255,5738,68327,69,261475
11845,0.000803,74.125.24.0-255,1484,69811,69,261475
11846,0.000823,74.125.24.0-255,5738,75549,69,261475
11847,0.000863,74.125.24.0-255,1484,77033,69,261475
11848,0.000866,74.125.24.0-255,2184,79217,69,261475
11849,0.000977,172.31.40.0-255,66,79283,69,261475
11850,0.00102,74.125.24.0-255,1484,80767,69,261475
11851,0.001025,74.125.24.0-255,1484,82251,69,261475
11852,0.001035,74.125.24.0-255,1484,83735,69,261475
11853,0.001038,74.125.24.0-255,1484,85219,69,261475
11854,0.001054,172.31.40.0-255,66,85285,69,261475
11855,0.00106,74.125.24.0-255,4320,89605,69,261475
11856,0.001086,74.125.24.0-255,1484,91089,69,261475
11857,0.001091,172.31.40.0-255,66,91155,69,261475
11858,0.001113,74.125.24.0-255,1484,92639,69,261475
11859,0.001143,172.31.40.0-255,66,92705,69,261475
11860,0.001175,74.125.24.0-255,1484,94189,69,261475
11861,0.001181,74.125.24.0-255,2902,97091,69,261475
11862,0.001189,172.31.40.0-255,66,97157,69,261475
11863,0.001199,74.125.24.0-255,5738,102895,69,261475
11864,0.001208,172.31.40.0-255,66,102961,69,261475
11865,0.001221,74.125.24.0-255,2902,105863,69,261475
11866,0.001246,172.31.40.0-255,66,105929,69,261475
11867,0.001273,74.125.24.0-255,5738,111667,69,261475
11868,0.001277,172.31.40.0-255,66,111733,69,261475
11869,0.001294,74.125.24.0-255,6438,118171,69,261475
11870,0.001301,172.31.40.0-255,66,118237,69,261475
11871,0.001419,74.125.24.0-255,1484,119721,69,261475
11872,0.001424,74.125.24.0-255,2902,122623,69,261475
11873,0.00143,172.31.40.0-255,66,122689,69,261475
11874,0.001448,74.125.24.0-255,5738,128427,69,261475
11875,0.001463,74.125.24.0-255,5738,134165,69,261475
11876,0.001465,172.31.40.0-255,66,134231,69,261475
11877,0.001469,172.31.40.0-255,66,134297,69,261475
11878,0.001484,74.125.24.0-255,2902,137199,69,261475
11879,0.001491,172.31.40.0-255,66,137265,69,261475
11880,0.001555,74.125.24.0-255,1484,138749,69,261475
11881,0.001559,74.125.24.0-255,2902,141651,69,261475
11882,0.001564,172.31.40.0-255,66,141717,69,261475
11883,0.001573,74.125.24.0-255,4320,146037,69,261475
11884,0.001577,172.31.40.0-255,66,146103,69,261475
11885,0.001584,74.125.24.0-255,1484,147587,69,261475
11886,0.001597,74.125.24.0-255,1484,149071,69,261475
11887,0.001604,172.31.40.0-255,66,149137,69,261475
11888,0.001652,172.31.40.0-255,66,149203,69,261475
11889,0.001666,74.125.24.0-255,2184,151387,69,261475
11890,0.001676,172.31.40.0-255,66,151453,69,261475
11891,0.001793,74.125.24.0-255,1484,152937,69,261475
11892,0.001805,74.125.24.0-255,2902,155839,69,261475
11893,0.001807,74.125.24.0-255,1484,157323,69,261475
11894,0.001823,172.31.40.0-255,66,157389,69,261475
11895,0.001828,74.125.24.0-255,4320,161709,69,261475
11896,0.00183,74.125.24.0-255,1484,163193,69,261475
11897,0.001834,172.31.40.0-255,66,163259,69,261475
11898,0.001869,172.31.40.0-255,66,163325,69,261475
11899,0.001913,172.31.40.0-255,66,163391,69,261475
11900,0.002068,74.125.24.0-255,1484,164875,69,261475
11901,0.00209,74.125.24.0-255,2902,167777,69,261475
11902,0.002096,74.125.24.0-255,5738,173515,69,261475
11903,0.002103,172.31.40.0-255,66,173581,69,261475
11904,0.00211,74.125.24.0-255,1484,175065,69,261475
11905,0.002134,172.31.40.0-255,66,175131,69,261475
11906,0.002158,74.125.24.0-255,1484,176615,69,261475
11907,0.002166,74.125.24.0-255,7156,183771,69,261475
11908,0.002205,74.125.24.0-255,3602,187373,69,261475
11909,0.002212,172.31.40.0-255,66,187439,69,261475
11910,0.00227,74.125.24.0-255,1484,188923,69,261475
11911,0.002276,74.125.24.0-255,2902,191825,69,261475
11912,0.00228,172.31.40.0-255,66,191891,69,261475
11913,0.002293,74.125.24.0-255,5738,197629,69,261475
11914,0.00232,74.125.24.0-255,5738,203367,69,261475
11915,0.002322,172.31.40.0-255,66,203433,69,261475
11916,0.002328,172.31.40.0-255,66,203499,69,261475
11917,0.00235,74.125.24.0-255,7156,210655,69,261475
11918,0.002378,74.125.24.0-255,3602,214257,69,261475
11919,0.00238,172.31.40.0-255,66,214323,69,261475
11920,0.002385,172.31.40.0-255,66,214389,69,261475
11921,0.002404,74.125.24.0-255,4320,218709,69,261475
11922,0.002412,74.125.24.0-255,7156,225865,69,261475
11923,0.002418,172.31.40.0-255,66,225931,69,261475
11924,0.002432,74.125.24.0-255,2902,228833,69,261475
11925,0.002449,74.125.24.0-255,5738,234571,69,261475
11926,0.002454,172.31.40.0-255,66,234637,69,261475
11927,0.002503,172.31.40.0-255,66,234703,69,261475
11928,0.002536,172.31.40.0-255,66,234769,69,261475
11929,0.002561,74.125.24.0-255,2184,236953,69,261475
11930,0.002585,74.125.24.0-255,7156,244109,69,261475
11931,0.002591,172.31.40.0-255,66,244175,69,261475
11932,0.002609,74.125.24.0-255,5738,249913,69,261475
11933,0.002614,74.125.24.0-255,1671,251584,69,261475
11934,0.002617,74.125.24.0-255,97,251681,69,261475
11935,0.002648,172.31.40.0-255,66,251747,69,261475
11936,0.00521,74.125.24.0-255,105,251852,69,261475
11937,0.009546,172.31.40.0-255,66,251918,69,261475
11938,0.009592,172.31.40.0-255,105,252023,69,261475
11939,0.012157,74.125.24.0-255,66,252089,69,261475
11940,0.036264,172.31.40.0-255,172,252261,69,261475
11941,0.0363,172.31.40.0-255,1114,253375,69,261475
11942,0.036366,172.31.40.0-255,1514,254889,69,261475
11943,0.036368,172.31.40.0-255,1514,256403,69,261475
11944,0.036369,172.31.40.0-255,1514,257917,69,261475
11945,0.03637,172.31.40.0-255,1514,259431,69,261475
11946,0.0364,172.31.40.0-255,1504,260935,69,261475
11947,0.037747,104.244.42.0-255,66,261001,69,261475
11948,0.037783,104.244.42.0-255,66,261067,69,261475
11949,0.037901,104.244.42.0-255,66,261133,69,261475
11950,0.037927,104.244.42.0-255,66,261199,69,261475
11951,0.061292,172.31.40.0-255,105,261304,69,261475
11952,0.063044,157.240.7.0-255,105,261409,69,261475
11953,0.063059,172.31.40.0-255,66,261475,69,261475
11954,0.0,172.217.194.0-255,153,153,69,362576
11955,3.9e-05,172.31.40.0-255,66,219,69,362576
11956,5e-05,172.217.194.0-255,1484,1703,69,362576
11957,5.7e-05,172.31.40.0-255,66,1769,69,362576
11958,6.4e-05,172.217.194.0-255,2902,4671,69,362576
11959,6.8e-05,172.31.40.0-255,66,4737,69,362576
11960,7.8e-05,172.217.194.0-255,7156,11893,69,362576
11961,8.2e-05,172.31.40.0-255,66,11959,69,362576
11962,8.8e-05,172.217.194.0-255,2136,14095,69,362576
11963,9.1e-05,172.31.40.0-255,66,14161,69,362576
11964,9.7e-05,172.217.194.0-255,2902,17063,69,362576
11965,0.0001,172.31.40.0-255,66,17129,69,362576
11966,0.000108,172.217.194.0-255,5738,22867,69,362576
11967,0.000111,172.31.40.0-255,66,22933,69,362576
11968,0.000171,172.31.40.0-255,66,22999,69,362576
11969,0.000251,172.217.194.0-255,1484,24483,69,362576
11970,0.000254,172.31.40.0-255,66,24549,69,362576
11971,0.000258,172.217.194.0-255,1484,26033,69,362576
11972,0.00026,172.31.40.0-255,66,26099,69,362576
11973,0.000273,172.217.194.0-255,1484,27583,69,362576
11974,0.000275,172.31.40.0-255,66,27649,69,362576
11975,0.000286,172.217.194.0-255,5738,33387,69,362576
11976,0.000289,172.31.40.0-255,66,33453,69,362576
11977,0.000293,172.217.194.0-255,1484,34937,69,362576
11978,0.000294,172.31.40.0-255,66,35003,69,362576
11979,0.000337,172.31.40.0-255,66,35069,69,362576
11980,0.000356,172.31.40.0-255,66,35135,69,362576
11981,0.000471,172.217.194.0-255,647,35782,69,362576
11982,0.000474,172.31.40.0-255,66,35848,69,362576
11983,0.000567,172.217.194.0-255,1484,37332,69,362576
11984,0.000587,172.217.194.0-255,2902,40234,69,362576
11985,0.000591,172.217.194.0-255,1484,41718,69,362576
11986,0.000614,172.217.194.0-255,4320,46038,69,362576
11987,0.000634,172.217.194.0-255,5738,51776,69,362576
11988,0.000652,172.217.194.0-255,4320,56096,69,362576
11989,0.000686,172.217.194.0-255,2902,58998,69,362576
11990,0.000691,172.217.194.0-255,2184,61182,69,362576
11991,0.000798,172.31.40.0-255,66,61248,69,362576
11992,0.001023,172.217.194.0-255,1484,62732,69,362576
11993,0.00103,172.217.194.0-255,1484,64216,69,362576
11994,0.001043,172.31.40.0-255,66,64282,69,362576
11995,0.001048,172.217.194.0-255,1484,65766,69,362576
11996,0.001056,172.217.194.0-255,5738,71504,69,362576
11997,0.001063,172.31.40.0-255,66,71570,69,362576
11998,0.001078,172.217.194.0-255,5738,77308,69,362576
11999,0.001109,172.217.194.0-255,7156,84464,69,362576
12000,0.001121,172.217.194.0-255,766,85230,69,362576
12001,0.001124,172.31.40.0-255,66,85296,69,362576
12002,0.00114,172.31.40.0-255,66,85362,69,362576
12003,0.00128,172.217.194.0-255,1484,86846,69,362576
12004,0.001288,172.217.194.0-255,2902,89748,69,362576
12005,0.001307,172.217.194.0-255,5738,95486,69,362576
12006,0.001325,172.217.194.0-255,1484,96970,69,362576
12007,0.00134,172.217.194.0-255,5738,102708,69,362576
12008,0.001357,172.217.194.0-255,5738,108446,69,362576
12009,0.001367,172.217.194.0-255,5738,114184,69,362576
12010,0.001378,172.31.40.0-255,66,114250,69,362576
12011,0.001408,172.217.194.0-255,5020,119270,69,362576
12012,0.001416,172.31.40.0-255,66,119336,69,362576
12013,0.00342,172.217.194.0-255,5738,125074,69,362576
12014,0.003432,172.31.40.0-255,66,125140,69,362576
12015,0.005427,172.217.194.0-255,4320,129460,69,362576
12016,0.005446,172.217.194.0-255,1484,130944,69,362576
12017,0.008213,172.31.40.0-255,66,131010,69,362576
12018,0.010182,172.217.194.0-255,5738,136748,69,362576
12019,0.010195,172.31.40.0-255,66,136814,69,362576
12020,0.012203,172.217.194.0-255,5738,142552,69,362576
12021,0.013633,172.31.40.0-255,66,142618,69,362576
12022,0.01563,172.217.194.0-255,2902,145520,69,362576
12023,0.015642,172.31.40.0-255,66,145586,69,362576
12024,0.015665,172.217.194.0-255,2902,148488,69,362576
12025,0.015707,172.31.40.0-255,66,148554,69,362576
12026,0.017603,172.217.194.0-255,2902,151456,69,362576
12027,0.017616,172.31.40.0-255,66,151522,69,362576
12028,0.017676,172.217.194.0-255,2902,154424,69,362576
12029,0.018203,172.31.40.0-255,66,154490,69,362576
12030,0.019639,172.217.194.0-255,2902,157392,69,362576
12031,0.019648,172.31.40.0-255,66,157458,69,362576
12032,0.020189,172.217.194.0-255,2902,160360,69,362576
12033,0.020196,172.31.40.0-255,66,160426,69,362576
12034,0.02163,172.217.194.0-255,2902,163328,69,362576
12035,0.021637,172.31.40.0-255,66,163394,69,362576
12036,0.022213,172.217.194.0-255,2902,166296,69,362576
12037,0.02222,172.31.40.0-255,66,166362,69,362576
12038,0.023599,172.217.194.0-255,2902,169264,69,362576
12039,0.023607,172.31.40.0-255,66,169330,69,362576
12040,0.024211,172.217.194.0-255,2902,172232,69,362576
12041,0.024217,172.31.40.0-255,66,172298,69,362576
12042,0.025561,172.31.40.0-255,167,172465,69,362576
12043,0.025595,172.217.194.0-255,2902,175367,69,362576
12044,0.025601,172.31.40.0-255,66,175433,69,362576
12045,0.025633,172.31.40.0-255,1111,176544,69,362576
12046,0.025703,172.31.40.0-255,1514,178058,69,362576
12047,0.025705,172.31.40.0-255,1514,179572,69,362576
12048,0.025706,172.31.40.0-255,1514,181086,69,362576
12049,0.025707,172.31.40.0-255,1514,182600,69,362576
12050,0.025708,172.31.40.0-255,546,183146,69,362576
12051,0.026229,172.217.194.0-255,2902,186048,69,362576
12052,0.026237,172.31.40.0-255,66,186114,69,362576
12053,0.027131,104.244.42.0-255,66,186180,69,362576
12054,0.027216,104.244.42.0-255,66,186246,69,362576
12055,0.027309,104.244.42.0-255,66,186312,69,362576
12056,0.027324,104.244.42.0-255,66,186378,69,362576
12057,0.027613,172.217.194.0-255,2902,189280,69,362576
12058,0.027631,172.31.40.0-255,66,189346,69,362576
12059,0.02823,172.217.194.0-255,2902,192248,69,362576
12060,0.028238,172.31.40.0-255,66,192314,69,362576
12061,0.029646,172.217.194.0-255,2902,195216,69,362576
12062,0.029656,172.31.40.0-255,66,195282,69,362576
12063,0.030236,172.217.194.0-255,2902,198184,69,362576
12064,0.030494,172.31.40.0-255,66,198250,69,362576
12065,0.031635,172.217.194.0-255,2902,201152,69,362576
12066,0.031644,172.31.40.0-255,66,201218,69,362576
12067,0.032501,172.217.194.0-255,2902,204120,69,362576
12068,0.032507,172.31.40.0-255,66,204186,69,362576
12069,0.033632,172.217.194.0-255,2902,207088,69,362576
12070,0.033643,172.31.40.0-255,66,207154,69,362576
12071,0.034488,172.217.194.0-255,2902,210056,69,362576
12072,0.035633,172.217.194.0-255,2902,212958,69,362576
12073,0.037278,172.31.40.0-255,66,213024,69,362576
12074,0.039289,172.217.194.0-255,5738,218762,69,362576
12075,0.039307,172.31.40.0-255,66,218828,69,362576
12076,0.041331,172.217.194.0-255,5738,224566,69,362576
12077,0.041349,172.31.40.0-255,66,224632,69,362576
12078,0.043361,172.217.194.0-255,5738,230370,69,362576
12079,0.043375,172.31.40.0-255,66,230436,69,362576
12080,0.04537,172.217.194.0-255,5738,236174,69,362576
12081,0.045377,172.31.40.0-255,66,236240,69,362576
12082,0.047358,172.217.194.0-255,5738,241978,69,362576
12083,0.047366,172.31.40.0-255,66,242044,69,362576
12084,0.049389,172.217.194.0-255,5738,247782,69,362576
12085,0.049395,172.31.40.0-255,66,247848,69,362576
12086,0.05142,172.217.194.0-255,5738,253586,69,362576
12087,0.051427,172.31.40.0-255,66,253652,69,362576
12088,0.053443,172.217.194.0-255,5738,259390,69,362576
12089,0.05345,172.31.40.0-255,66,259456,69,362576
12090,0.055446,172.217.194.0-255,5738,265194,69,362576
12091,0.055453,172.31.40.0-255,66,265260,69,362576
12092,0.057461,172.217.194.0-255,5738,270998,69,362576
12093,0.057467,172.31.40.0-255,66,271064,69,362576
12094,0.059461,172.217.194.0-255,5738,276802,69,362576
12095,0.059467,172.31.40.0-255,66,276868,69,362576
12096,0.061454,172.217.194.0-255,5738,282606,69,362576
12097,0.061462,172.31.40.0-255,66,282672,69,362576
12098,0.063456,172.217.194.0-255,5738,288410,69,362576
12099,0.063465,172.31.40.0-255,66,288476,69,362576
12100,0.065467,172.217.194.0-255,5738,294214,69,362576
12101,0.065473,172.31.40.0-255,66,294280,69,362576
12102,0.067535,172.217.194.0-255,5738,300018,69,362576
12103,0.067541,172.31.40.0-255,66,300084,69,362576
12104,0.06955,172.217.194.0-255,5738,305822,69,362576
12105,0.069556,172.31.40.0-255,66,305888,69,362576
12106,0.071555,172.217.194.0-255,5738,311626,69,362576
12107,0.071562,172.31.40.0-255,66,311692,69,362576
12108,0.073561,172.217.194.0-255,5738,317430,69,362576
12109,0.073568,172.31.40.0-255,66,317496,69,362576
12110,0.075567,172.217.194.0-255,5738,323234,69,362576
12111,0.075574,172.31.40.0-255,66,323300,69,362576
12112,0.077589,172.217.194.0-255,5738,329038,69,362576
12113,0.077596,172.31.40.0-255,66,329104,69,362576
12114,0.079588,172.217.194.0-255,5738,334842,69,362576
12115,0.079596,172.31.40.0-255,66,334908,69,362576
12116,0.08161,172.217.194.0-255,5738,340646,69,362576
12117,0.081617,172.31.40.0-255,66,340712,69,362576
12118,0.083666,172.217.194.0-255,5738,346450,69,362576
12119,0.083674,172.31.40.0-255,66,346516,69,362576
12120,0.085655,172.217.194.0-255,4320,350836,69,362576
12121,0.085662,172.31.40.0-255,66,350902,69,362576
12122,0.085683,172.217.194.0-255,1484,352386,69,362576
12123,0.087658,172.217.194.0-255,4320,356706,69,362576
12124,0.087665,172.31.40.0-255,66,356772,69,362576
12125,0.089675,172.217.194.0-255,5738,362510,69,362576
12126,0.089727,172.31.40.0-255,66,362576,69,362576
12127,0.0,74.125.68.0-255,148,148,69,400029
12128,1.4e-05,172.31.40.0-255,66,214,69,400029
12129,2e-05,74.125.68.0-255,1484,1698,69,400029
12130,2.4e-05,172.31.40.0-255,66,1764,69,400029
12131,2.9e-05,74.125.68.0-255,2902,4666,69,400029
12132,3.7e-05,172.31.40.0-255,66,4732,69,400029
12133,4.3e-05,74.125.68.0-255,4320,9052,69,400029
12134,4.6e-05,172.31.40.0-255,66,9118,69,400029
12135,7.9e-05,74.125.68.0-255,2902,12020,69,400029
12136,8.1e-05,172.31.40.0-255,66,12086,69,400029
12137,9.3e-05,74.125.68.0-255,2074,14160,69,400029
12138,9.9e-05,172.31.40.0-255,66,14226,69,400029
12139,0.000122,74.125.68.0-255,2902,17128,69,400029
12140,0.000124,172.31.40.0-255,66,17194,69,400029
12141,0.00016,74.125.68.0-255,7156,24350,69,400029
12142,0.000162,172.31.40.0-255,66,24416,69,400029
12143,0.000167,74.125.68.0-255,2902,27318,69,400029
12144,0.000172,172.31.40.0-255,66,27384,69,400029
12145,0.00021,74.125.68.0-255,3961,31345,69,400029
12146,0.000212,172.31.40.0-255,66,31411,69,400029
12147,0.000257,74.125.68.0-255,1484,32895,69,400029
12148,0.00026,172.31.40.0-255,66,32961,69,400029
12149,0.000263,74.125.68.0-255,1484,34445,69,400029
12150,0.000264,172.31.40.0-255,66,34511,69,400029
12151,0.000288,74.125.68.0-255,1484,35995,69,400029
12152,0.00029,172.31.40.0-255,66,36061,69,400029
12153,0.0003,74.125.68.0-255,5738,41799,69,400029
12154,0.000302,172.31.40.0-255,66,41865,69,400029
12155,0.000307,74.125.68.0-255,4320,46185,69,400029
12156,0.000309,172.31.40.0-255,66,46251,69,400029
12157,0.00034,74.125.68.0-255,5379,51630,69,400029
12158,0.000343,172.31.40.0-255,66,51696,69,400029
12159,0.000356,74.125.68.0-255,2902,54598,69,400029
12160,0.000374,74.125.68.0-255,7156,61754,69,400029
12161,0.000404,74.125.68.0-255,2902,64656,69,400029
12162,0.000414,74.125.68.0-255,1400,66056,69,400029
12163,0.000512,172.31.40.0-255,66,66122,69,400029
12164,0.000668,74.125.68.0-255,132,66254,69,400029
12165,0.000788,74.125.68.0-255,1484,67738,69,400029
12166,0.000791,172.31.40.0-255,66,67804,69,400029
12167,0.000797,74.125.68.0-255,2902,70706,69,400029
12168,0.000814,172.31.40.0-255,66,70772,69,400029
12169,0.000833,74.125.68.0-255,4320,75092,69,400029
12170,0.000843,172.31.40.0-255,66,75158,69,400029
12171,0.000859,74.125.68.0-255,1484,76642,69,400029
12172,0.000892,74.125.68.0-255,4320,80962,69,400029
12173,0.000895,172.31.40.0-255,66,81028,69,400029
12174,0.000924,74.125.68.0-255,2902,83930,69,400029
12175,0.00093,172.31.40.0-255,66,83996,69,400029
12176,0.000962,172.31.40.0-255,66,84062,69,400029
12177,0.000964,74.125.68.0-255,345,84407,69,400029
12178,0.001299,172.31.40.0-255,66,84473,69,400029
12179,0.001406,74.125.68.0-255,1484,85957,69,400029
12180,0.001421,74.125.68.0-255,2902,88859,69,400029
12181,0.001435,74.125.68.0-255,4320,93179,69,400029
12182,0.00145,74.125.68.0-255,1484,94663,69,400029
12183,0.001468,74.125.68.0-255,7156,101819,69,400029
12184,0.001473,74.125.68.0-255,5738,107557,69,400029
12185,0.001497,74.125.68.0-255,4320,111877,69,400029
12186,0.001517,74.125.68.0-255,2902,114779,69,400029
12187,0.001533,74.125.68.0-255,3602,118381,69,400029
12188,0.001594,74.125.68.0-255,1484,119865,69,400029
12189,0.001599,74.125.68.0-255,2902,122767,69,400029
12190,0.001606,74.125.68.0-255,5738,128505,69,400029
12191,0.001654,74.125.68.0-255,2902,131407,69,400029
12192,0.00167,74.125.68.0-255,7156,138563,69,400029
12193,0.001674,74.125.68.0-255,2902,141465,69,400029
12194,0.00169,74.125.68.0-255,2184,143649,69,400029
12195,0.001736,74.125.68.0-255,1484,145133,69,400029
12196,0.001749,74.125.68.0-255,2902,148035,69,400029
12197,0.001769,74.125.68.0-255,4320,152355,69,400029
12198,0.001781,74.125.68.0-255,1484,153839,69,400029
12199,0.001786,74.125.68.0-255,2902,156741,69,400029
12200,0.001789,74.125.68.0-255,1484,158225,69,400029
12201,0.001801,74.125.68.0-255,4320,162545,69,400029
12202,0.001816,74.125.68.0-255,4320,166865,69,400029
12203,0.001831,74.125.68.0-255,4320,171185,69,400029
12204,0.001846,74.125.68.0-255,6438,177623,69,400029
12205,0.00656,172.31.40.0-255,66,177689,69,400029
12206,0.008636,74.125.68.0-255,5738,183427,69,400029
12207,0.008644,172.31.40.0-255,66,183493,69,400029
12208,0.010664,74.125.68.0-255,5738,189231,69,400029
12209,0.010672,172.31.40.0-255,66,189297,69,400029
12210,0.012707,74.125.68.0-255,5738,195035,69,400029
12211,0.012714,172.31.40.0-255,66,195101,69,400029
12212,0.014726,74.125.68.0-255,5738,200839,69,400029
12213,0.014732,172.31.40.0-255,66,200905,69,400029
12214,0.01677,74.125.68.0-255,5738,206643,69,400029
12215,0.016776,172.31.40.0-255,66,206709,69,400029
12216,0.018797,74.125.68.0-255,5738,212447,69,400029
12217,0.018803,172.31.40.0-255,66,212513,69,400029
12218,0.020822,74.125.68.0-255,4320,216833,69,400029
12219,0.02083,172.31.40.0-255,66,216899,69,400029
12220,0.020859,74.125.68.0-255,1484,218383,69,400029
12221,0.022842,74.125.68.0-255,4320,222703,69,400029
12222,0.02285,172.31.40.0-255,66,222769,69,400029
12223,0.024911,74.125.68.0-255,5738,228507,69,400029
12224,0.025241,172.31.40.0-255,66,228573,69,400029
12225,0.027293,74.125.68.0-255,5738,234311,69,400029
12226,0.027301,172.31.40.0-255,66,234377,69,400029
12227,0.029347,74.125.68.0-255,5738,240115,69,400029
12228,0.029354,172.31.40.0-255,66,240181,69,400029
12229,0.03137,74.125.68.0-255,5738,245919,69,400029
12230,0.031377,172.31.40.0-255,66,245985,69,400029
12231,0.032768,172.31.40.0-255,172,246157,69,400029
12232,0.032796,172.31.40.0-255,1116,247273,69,400029
12233,0.032857,172.31.40.0-255,1514,248787,69,400029
12234,0.032859,172.31.40.0-255,1514,250301,69,400029
12235,0.03286,172.31.40.0-255,1514,251815,69,400029
12236,0.032864,172.31.40.0-255,1514,253329,69,400029
12237,0.032865,172.31.40.0-255,1499,254828,69,400029
12238,0.033381,74.125.68.0-255,1484,256312,69,400029
12239,0.033404,74.125.68.0-255,4320,260632,69,400029
12240,0.033408,172.31.40.0-255,66,260698,69,400029
12241,0.034343,104.244.42.0-255,66,260764,69,400029
12242,0.034424,104.244.42.0-255,66,260830,69,400029
12243,0.034471,104.244.42.0-255,66,260896,69,400029
12244,0.035429,74.125.68.0-255,5738,266634,69,400029
12245,0.035436,172.31.40.0-255,66,266700,69,400029
12246,0.037465,74.125.68.0-255,5738,272438,69,400029
12247,0.037472,172.31.40.0-255,66,272504,69,400029
12248,0.03951,74.125.68.0-255,5738,278242,69,400029
12249,0.039517,172.31.40.0-255,66,278308,69,400029
12250,0.041609,74.125.68.0-255,5738,284046,69,400029
12251,0.041617,172.31.40.0-255,66,284112,69,400029
12252,0.043652,74.125.68.0-255,5738,289850,69,400029
12253,0.04366,172.31.40.0-255,66,289916,69,400029
12254,0.045679,74.125.68.0-255,2902,292818,69,400029
12255,0.045685,172.31.40.0-255,66,292884,69,400029
12256,0.045714,74.125.68.0-255,2902,295786,69,400029
12257,0.046128,172.31.40.0-255,66,295852,69,400029
12258,0.047705,74.125.68.0-255,2902,298754,69,400029
12259,0.047712,172.31.40.0-255,66,298820,69,400029
12260,0.048163,74.125.68.0-255,2902,301722,69,400029
12261,0.04817,172.31.40.0-255,66,301788,69,400029
12262,0.04973,74.125.68.0-255,2902,304690,69,400029
12263,0.049736,172.31.40.0-255,66,304756,69,400029
12264,0.050201,74.125.68.0-255,2902,307658,69,400029
12265,0.050207,172.31.40.0-255,66,307724,69,400029
12266,0.051745,74.125.68.0-255,2902,310626,69,400029
12267,0.051753,172.31.40.0-255,66,310692,69,400029
12268,0.052227,74.125.68.0-255,2902,313594,69,400029
12269,0.052234,172.31.40.0-255,66,313660,69,400029
12270,0.053771,74.125.68.0-255,1484,315144,69,400029
12271,0.05426,74.125.68.0-255,4320,319464,69,400029
12272,0.054291,172.31.40.0-255,66,319530,69,400029
12273,0.056321,74.125.68.0-255,5738,325268,69,400029
12274,0.056367,172.31.40.0-255,66,325334,69,400029
12275,0.058404,74.125.68.0-255,5738,331072,69,400029
12276,0.05841,172.31.40.0-255,66,331138,69,400029
12277,0.060431,74.125.68.0-255,5738,336876,69,400029
12278,0.060439,172.31.40.0-255,66,336942,69,400029
12279,0.062469,74.125.68.0-255,5738,342680,69,400029
12280,0.062477,172.31.40.0-255,66,342746,69,400029
12281,0.064493,74.125.68.0-255,5738,348484,69,400029
12282,0.064498,172.31.40.0-255,66,348550,69,400029
12283,0.066544,74.125.68.0-255,5738,354288,69,400029
12284,0.06655,172.31.40.0-255,66,354354,69,400029
12285,0.068577,74.125.68.0-255,5738,360092,69,400029
12286,0.068585,172.31.40.0-255,66,360158,69,400029
12287,0.070622,74.125.68.0-255,5738,365896,69,400029
12288,0.070628,172.31.40.0-255,66,365962,69,400029
12289,0.072644,74.125.68.0-255,5738,371700,69,400029
12290,0.072651,172.31.40.0-255,66,371766,69,400029
12291,0.074711,74.125.68.0-255,5738,377504,69,400029
12292,0.074717,172.31.40.0-255,66,377570,69,400029
12293,0.076724,74.125.68.0-255,4320,381890,69,400029
12294,0.076729,172.31.40.0-255,66,381956,69,400029
12295,0.076752,74.125.68.0-255,1484,383440,69,400029
12296,0.078751,74.125.68.0-255,4320,387760,69,400029
12297,0.078757,172.31.40.0-255,66,387826,69,400029
12298,0.080792,74.125.68.0-255,5738,393564,69,400029
12299,0.080836,172.31.40.0-255,66,393630,69,400029
12300,0.082861,74.125.68.0-255,5738,399368,69,400029
12301,0.082868,172.31.40.0-255,66,399434,69,400029
12302,0.084866,74.125.68.0-255,358,399792,69,400029
12303,0.084978,172.31.40.0-255,66,399858,69,400029
12304,0.08501,172.31.40.0-255,105,399963,69,400029
12305,0.08701,74.125.68.0-255,66,400029,69,400029
12306,0.0,172.217.194.0-255,153,153,69,247725
12307,2.5e-05,172.31.40.0-255,66,219,69,247725
12308,3.3e-05,172.217.194.0-255,1484,1703,69,247725
12309,3.7e-05,172.31.40.0-255,66,1769,69,247725
12310,4.3e-05,172.217.194.0-255,2902,4671,69,247725
12311,4.7e-05,172.31.40.0-255,66,4737,69,247725
12312,5.5e-05,172.217.194.0-255,7156,11893,69,247725
12313,5.8e-05,172.31.40.0-255,66,11959,69,247725
12314,6.2e-05,172.217.194.0-255,2030,13989,69,247725
12315,6.5e-05,172.31.40.0-255,66,14055,69,247725
12316,6.9e-05,172.217.194.0-255,2902,16957,69,247725
12317,7.2e-05,172.31.40.0-255,66,17023,69,247725
12318,8e-05,172.217.194.0-255,7156,24179,69,247725
12319,8.3e-05,172.31.40.0-255,66,24245,69,247725
12320,0.000131,172.217.194.0-255,2902,27147,69,247725
12321,0.000135,172.31.40.0-255,66,27213,69,247725
12322,0.000166,172.31.40.0-255,66,27279,69,247725
12323,0.000177,172.31.40.0-255,66,27345,69,247725
12324,0.000209,172.217.194.0-255,1484,28829,69,247725
12325,0.000212,172.31.40.0-255,66,28895,69,247725
12326,0.000217,172.217.194.0-255,2902,31797,69,247725
12327,0.000219,172.31.40.0-255,66,31863,69,247725
12328,0.000241,172.217.194.0-255,1484,33347,69,247725
12329,0.000244,172.31.40.0-255,66,33413,69,247725
12330,0.000269,172.217.194.0-255,4320,37733,69,247725
12331,0.000272,172.31.40.0-255,66,37799,69,247725
12332,0.00028,172.217.194.0-255,6797,44596,69,247725
12333,0.000282,172.31.40.0-255,66,44662,69,247725
12334,0.000314,172.217.194.0-255,1484,46146,69,247725
12335,0.000317,172.31.40.0-255,66,46212,69,247725
12336,0.000331,172.217.194.0-255,1484,47696,69,247725
12337,0.000352,172.217.194.0-255,1484,49180,69,247725
12338,0.000355,172.31.40.0-255,66,49246,69,247725
12339,0.000362,172.217.194.0-255,5738,54984,69,247725
12340,0.000364,172.31.40.0-255,66,55050,69,247725
12341,0.00037,172.217.194.0-255,4320,59370,69,247725
12342,0.000372,172.31.40.0-255,66,59436,69,247725
12343,0.000377,172.217.194.0-255,4320,63756,69,247725
12344,0.00038,172.31.40.0-255,66,63822,69,247725
12345,0.000405,172.217.194.0-255,7156,70978,69,247725
12346,0.000408,172.31.40.0-255,66,71044,69,247725
12347,0.000442,172.217.194.0-255,1484,72528,69,247725
12348,0.000468,172.217.194.0-255,6438,78966,69,247725
12349,0.000471,172.31.40.0-255,66,79032,69,247725
12350,0.000533,172.217.194.0-255,1484,80516,69,247725
12351,0.000553,172.217.194.0-255,2902,83418,69,247725
12352,0.000555,172.217.194.0-255,1484,84902,69,247725
12353,0.000573,172.217.194.0-255,2902,87804,69,247725
12354,0.00058,172.217.194.0-255,5738,93542,69,247725
12355,0.000658,172.31.40.0-255,66,93608,69,247725
12356,0.00067,172.217.194.0-255,2902,96510,69,247725
12357,0.000675,172.31.40.0-255,66,96576,69,247725
12358,0.000705,172.217.194.0-255,1125,97701,69,247725
12359,0.000708,172.217.194.0-255,1484,99185,69,247725
12360,0.000729,172.31.40.0-255,66,99251,69,247725
12361,0.000742,172.217.194.0-255,5738,104989,69,247725
12362,0.000761,172.31.40.0-255,66,105055,69,247725
12363,0.000777,172.217.194.0-255,4320,109375,69,247725
12364,0.000804,172.31.40.0-255,66,109441,69,247725
12365,0.000812,172.217.194.0-255,1484,110925,69,247725
12366,0.000815,172.217.194.0-255,766,111691,69,247725
12367,0.00082,172.31.40.0-255,66,111757,69,247725
12368,0.000874,172.217.194.0-255,1484,113241,69,247725
12369,0.00088,172.217.194.0-255,2902,116143,69,247725
12370,0.000885,172.31.40.0-255,66,116209,69,247725
12371,0.000909,172.217.194.0-255,5738,121947,69,247725
12372,0.000914,172.217.194.0-255,2902,124849,69,247725
12373,0.00093,172.217.194.0-255,3961,128810,69,247725
12374,0.000933,172.217.194.0-255,1484,130294,69,247725
12375,0.000936,172.31.40.0-255,66,130360,69,247725
12376,0.000942,172.31.40.0-255,66,130426,69,247725
12377,0.000962,172.217.194.0-255,2543,132969,69,247725
12378,0.000982,172.31.40.0-255,66,133035,69,247725
12379,0.001057,172.217.194.0-255,1484,134519,69,247725
12380,0.001071,172.217.194.0-255,2902,137421,69,247725
12381,0.001076,172.217.194.0-255,2902,140323,69,247725
12382,0.001095,172.217.194.0-255,2902,143225,69,247725
12383,0.001107,172.31.40.0-255,66,143291,69,247725
12384,0.001113,172.217.194.0-255,4320,147611,69,247725
12385,0.001119,172.31.40.0-255,66,147677,69,247725
12386,0.001201,172.217.194.0-255,1484,149161,69,247725
12387,0.001209,172.217.194.0-255,1484,150645,69,247725
12388,0.001214,172.31.40.0-255,66,150711,69,247725
12389,0.001235,172.217.194.0-255,1484,152195,69,247725
12390,0.001241,172.217.194.0-255,5738,157933,69,247725
12391,0.001255,172.217.194.0-255,4320,162253,69,247725
12392,0.001259,172.31.40.0-255,66,162319,69,247725
12393,0.001264,172.31.40.0-255,66,162385,69,247725
12394,0.001274,172.217.194.0-255,7156,169541,69,247725
12395,0.001294,172.217.194.0-255,2543,172084,69,247725
12396,0.001326,172.31.40.0-255,66,172150,69,247725
12397,0.001334,172.217.194.0-255,7156,179306,69,247725
12398,0.001341,172.31.40.0-255,66,179372,69,247725
12399,0.001377,172.217.194.0-255,2902,182274,69,247725
12400,0.001395,172.217.194.0-255,7156,189430,69,247725
12401,0.0014,172.31.40.0-255,66,189496,69,247725
12402,0.00141,172.217.194.0-255,5738,195234,69,247725
12403,0.001425,172.217.194.0-255,2902,198136,69,247725
12404,0.001441,172.217.194.0-255,4320,202456,69,247725
12405,0.001449,172.31.40.0-255,66,202522,69,247725
12406,0.001472,172.31.40.0-255,66,202588,69,247725
12407,0.001476,172.217.194.0-255,1484,204072,69,247725
12408,0.001493,172.217.194.0-255,2902,206974,69,247725
12409,0.001496,172.217.194.0-255,1484,208458,69,247725
12410,0.001511,172.217.194.0-255,4320,212778,69,247725
12411,0.001521,172.31.40.0-255,66,212844,69,247725
12412,0.001545,172.31.40.0-255,66,212910,69,247725
12413,0.00158,172.217.194.0-255,1484,214394,69,247725
12414,0.001639,172.217.194.0-255,1484,215878,69,247725
12415,0.001644,172.217.194.0-255,2902,218780,69,247725
12416,0.001647,172.31.40.0-255,66,218846,69,247725
12417,0.001653,172.31.40.0-255,66,218912,69,247725
12418,0.001674,172.217.194.0-255,5738,224650,69,247725
12419,0.001677,172.217.194.0-255,1484,226134,69,247725
12420,0.001685,172.31.40.0-255,66,226200,69,247725
12421,0.001719,172.217.194.0-255,1484,227684,69,247725
12422,0.00173,172.31.40.0-255,66,227750,69,247725
12423,0.001738,172.217.194.0-255,7156,234906,69,247725
12424,0.001743,172.31.40.0-255,66,234972,69,247725
12425,0.001767,172.217.194.0-255,4101,239073,69,247725
12426,0.00177,172.217.194.0-255,105,239178,69,247725
12427,0.0018,172.31.40.0-255,66,239244,69,247725
12428,0.003636,172.31.40.0-255,101,239345,69,247725
12429,0.004673,172.31.40.0-255,105,239450,69,247725
12430,0.005626,172.217.194.0-255,66,239516,69,247725
12431,0.006602,172.217.194.0-255,66,239582,69,247725
12432,0.032223,172.31.40.0-255,167,239749,69,247725
12433,0.032258,172.31.40.0-255,1116,240865,69,247725
12434,0.032322,172.31.40.0-255,1514,242379,69,247725
12435,0.032324,172.31.40.0-255,1514,243893,69,247725
12436,0.032325,172.31.40.0-255,1514,245407,69,247725
12437,0.032326,172.31.40.0-255,1514,246921,69,247725
12438,0.032327,172.31.40.0-255,540,247461,69,247725
12439,0.033794,104.244.42.0-255,66,247527,69,247725
12440,0.033852,104.244.42.0-255,66,247593,69,247725
12441,0.033911,104.244.42.0-255,66,247659,69,247725
12442,0.033915,104.244.42.0-255,66,247725,69,247725
12443,0.0,74.125.130.0-255,153,153,69,396592
12444,2e-05,172.31.40.0-255,66,219,69,396592
12445,2.7e-05,74.125.130.0-255,1484,1703,69,396592
12446,3.3e-05,172.31.40.0-255,66,1769,69,396592
12447,3.9e-05,74.125.130.0-255,2902,4671,69,396592
12448,4.3e-05,172.31.40.0-255,66,4737,69,396592
12449,4.8e-05,74.125.130.0-255,2902,7639,69,396592
12450,5.1e-05,172.31.40.0-255,66,7705,69,396592
12451,7.9e-05,74.125.130.0-255,4320,12025,69,396592
12452,8.2e-05,172.31.40.0-255,66,12091,69,396592
12453,8.6e-05,74.125.130.0-255,2064,14155,69,396592
12454,8.9e-05,172.31.40.0-255,66,14221,69,396592
12455,0.000111,74.125.130.0-255,1484,15705,69,396592
12456,0.000113,172.31.40.0-255,66,15771,69,396592
12457,0.000133,74.125.130.0-255,2902,18673,69,396592
12458,0.000136,172.31.40.0-255,66,18739,69,396592
12459,0.000142,74.125.130.0-255,5738,24477,69,396592
12460,0.000145,172.31.40.0-255,66,24543,69,396592
12461,0.00016,74.125.130.0-255,2902,27445,69,396592
12462,0.000162,172.31.40.0-255,66,27511,69,396592
12463,0.000179,74.125.130.0-255,3961,31472,69,396592
12464,0.000182,172.31.40.0-255,66,31538,69,396592
12465,0.000277,74.125.130.0-255,1484,33022,69,396592
12466,0.00028,172.31.40.0-255,66,33088,69,396592
12467,0.000285,74.125.130.0-255,2902,35990,69,396592
12468,0.000287,172.31.40.0-255,66,36056,69,396592
12469,0.000319,74.125.130.0-255,5738,41794,69,396592
12470,0.000322,172.31.40.0-255,66,41860,69,396592
12471,0.000328,74.125.130.0-255,5738,47598,69,396592
12472,0.00033,172.31.40.0-255,66,47664,69,396592
12473,0.000338,74.125.130.0-255,6797,54461,69,396592
12474,0.000341,172.31.40.0-255,66,54527,69,396592
12475,0.000384,172.31.40.0-255,66,54593,69,396592
12476,0.000398,74.125.130.0-255,2543,57136,69,396592
12477,0.0004,172.31.40.0-255,66,57202,69,396592
12478,0.000608,74.125.130.0-255,645,57847,69,396592
12479,0.000792,74.125.130.0-255,1484,59331,69,396592
12480,0.000798,172.31.40.0-255,66,59397,69,396592
12481,0.000804,74.125.130.0-255,2902,62299,69,396592
12482,0.000806,172.31.40.0-255,66,62365,69,396592
12483,0.000813,74.125.130.0-255,5738,68103,69,396592
12484,0.000816,172.31.40.0-255,66,68169,69,396592
12485,0.000821,74.125.130.0-255,4320,72489,69,396592
12486,0.000823,172.31.40.0-255,66,72555,69,396592
12487,0.00084,74.125.130.0-255,4320,76875,69,396592
12488,0.000843,172.31.40.0-255,66,76941,69,396592
12489,0.000873,74.125.130.0-255,7156,84097,69,396592
12490,0.000876,172.31.40.0-255,66,84163,69,396592
12491,0.000881,74.125.130.0-255,4320,88483,69,396592
12492,0.000883,172.31.40.0-255,66,88549,69,396592
12493,0.000901,74.125.130.0-255,3054,91603,69,396592
12494,0.000904,172.31.40.0-255,66,91669,69,396592
12495,0.001126,74.125.130.0-255,1484,93153,69,396592
12496,0.001132,74.125.130.0-255,2902,96055,69,396592
12497,0.001136,172.31.40.0-255,66,96121,69,396592
12498,0.001142,74.125.130.0-255,2902,99023,69,396592
12499,0.001144,172.31.40.0-255,66,99089,69,396592
12500,0.001159,74.125.130.0-255,2902,101991,69,396592
12501,0.001161,172.31.40.0-255,66,102057,69,396592
12502,0.001168,74.125.130.0-255,5738,107795,69,396592
12503,0.001171,172.31.40.0-255,66,107861,69,396592
12504,0.0012,74.125.130.0-255,7156,115017,69,396592
12505,0.001202,172.31.40.0-255,66,115083,69,396592
12506,0.001209,74.125.130.0-255,7156,122239,69,396592
12507,0.001211,172.31.40.0-255,66,122305,69,396592
12508,0.00124,74.125.130.0-255,3602,125907,69,396592
12509,0.001243,172.31.40.0-255,66,125973,69,396592
12510,0.001827,74.125.130.0-255,1484,127457,69,396592
12511,0.001834,74.125.130.0-255,2902,130359,69,396592
12512,0.001838,172.31.40.0-255,66,130425,69,396592
12513,0.001844,74.125.130.0-255,4320,134745,69,396592
12514,0.001847,172.31.40.0-255,66,134811,69,396592
12515,0.001862,74.125.130.0-255,5738,140549,69,396592
12516,0.001864,172.31.40.0-255,66,140615,69,396592
12517,0.001879,74.125.130.0-255,2902,143517,69,396592
12518,0.001881,172.31.40.0-255,66,143583,69,396592
12519,0.001903,74.125.130.0-255,7156,150739,69,396592
12520,0.001905,172.31.40.0-255,66,150805,69,396592
12521,0.001932,172.31.40.0-255,66,150871,69,396592
12522,0.004027,74.125.130.0-255,5738,156609,69,396592
12523,0.004035,172.31.40.0-255,66,156675,69,396592
12524,0.006126,74.125.130.0-255,5738,162413,69,396592
12525,0.00613,172.31.40.0-255,66,162479,69,396592
12526,0.00823,74.125.130.0-255,4320,166799,69,396592
12527,0.008233,172.31.40.0-255,66,166865,69,396592
12528,0.008252,74.125.130.0-255,1484,168349,69,396592
12529,0.010331,74.125.130.0-255,4320,172669,69,396592
12530,0.010338,172.31.40.0-255,66,172735,69,396592
12531,0.012491,74.125.130.0-255,5738,178473,69,396592
12532,0.012499,172.31.40.0-255,66,178539,69,396592
12533,0.014589,74.125.130.0-255,5738,184277,69,396592
12534,0.014597,172.31.40.0-255,66,184343,69,396592
12535,0.016707,74.125.130.0-255,5738,190081,69,396592
12536,0.016715,172.31.40.0-255,66,190147,69,396592
12537,0.018816,74.125.130.0-255,5738,195885,69,396592
12538,0.018825,172.31.40.0-255,66,195951,69,396592
12539,0.021009,74.125.130.0-255,5738,201689,69,396592
12540,0.021015,172.31.40.0-255,66,201755,69,396592
12541,0.023105,74.125.130.0-255,5738,207493,69,396592
12542,0.023113,172.31.40.0-255,66,207559,69,396592
12543,0.025214,74.125.130.0-255,5738,213297,69,396592
12544,0.025221,172.31.40.0-255,66,213363,69,396592
12545,0.027326,74.125.130.0-255,5738,219101,69,396592
12546,0.027335,172.31.40.0-255,66,219167,69,396592
12547,0.02943,74.125.130.0-255,5738,224905,69,396592
12548,0.029439,172.31.40.0-255,66,224971,69,396592
12549,0.031545,74.125.130.0-255,5738,230709,69,396592
12550,0.031552,172.31.40.0-255,66,230775,69,396592
12551,0.033517,172.31.40.0-255,172,230947,69,396592
12552,0.033548,172.31.40.0-255,1114,232061,69,396592
12553,0.033647,74.125.130.0-255,5738,237799,69,396592
12554,0.033654,172.31.40.0-255,66,237865,69,396592
12555,0.033703,172.31.40.0-255,1514,239379,69,396592
12556,0.033705,172.31.40.0-255,1514,240893,69,396592
12557,0.033706,172.31.40.0-255,1514,242407,69,396592
12558,0.033711,172.31.40.0-255,1514,243921,69,396592
12559,0.033712,172.31.40.0-255,1503,245424,69,396592
12560,0.035086,104.244.42.0-255,66,245490,69,396592
12561,0.035095,104.244.42.0-255,66,245556,69,396592
12562,0.035279,104.244.42.0-255,66,245622,69,396592
12563,0.035748,74.125.130.0-255,5738,251360,69,396592
12564,0.035756,172.31.40.0-255,66,251426,69,396592
12565,0.037857,74.125.130.0-255,5738,257164,69,396592
12566,0.037864,172.31.40.0-255,66,257230,69,396592
12567,0.039966,74.125.130.0-255,5738,262968,69,396592
12568,0.039973,172.31.40.0-255,66,263034,69,396592
12569,0.042071,74.125.130.0-255,5738,268772,69,396592
12570,0.042078,172.31.40.0-255,66,268838,69,396592
12571,0.044188,74.125.130.0-255,5738,274576,69,396592
12572,0.044195,172.31.40.0-255,66,274642,69,396592
12573,0.046294,74.125.130.0-255,5738,280380,69,396592
12574,0.046303,172.31.40.0-255,66,280446,69,396592
12575,0.048409,74.125.130.0-255,5738,286184,69,396592
12576,0.048415,172.31.40.0-255,66,286250,69,396592
12577,0.050507,74.125.130.0-255,5738,291988,69,396592
12578,0.050514,172.31.40.0-255,66,292054,69,396592
12579,0.052611,74.125.130.0-255,5738,297792,69,396592
12580,0.052618,172.31.40.0-255,66,297858,69,396592
12581,0.054717,74.125.130.0-255,5738,303596,69,396592
12582,0.054724,172.31.40.0-255,66,303662,69,396592
12583,0.056828,74.125.130.0-255,5738,309400,69,396592
12584,0.056834,172.31.40.0-255,66,309466,69,396592
12585,0.05894,74.125.130.0-255,5738,315204,69,396592
12586,0.058947,172.31.40.0-255,66,315270,69,396592
12587,0.06105,74.125.130.0-255,5738,321008,69,396592
12588,0.061057,172.31.40.0-255,66,321074,69,396592
12589,0.063176,74.125.130.0-255,5738,326812,69,396592
12590,0.063182,172.31.40.0-255,66,326878,69,396592
12591,0.065275,74.125.130.0-255,5738,332616,69,396592
12592,0.065282,172.31.40.0-255,66,332682,69,396592
12593,0.067396,74.125.130.0-255,5738,338420,69,396592
12594,0.067403,172.31.40.0-255,66,338486,69,396592
12595,0.069517,74.125.130.0-255,5738,344224,69,396592
12596,0.069524,172.31.40.0-255,66,344290,69,396592
12597,0.071632,74.125.130.0-255,5738,350028,69,396592
12598,0.071639,172.31.40.0-255,66,350094,69,396592
12599,0.073743,74.125.130.0-255,5738,355832,69,396592
12600,0.07375,172.31.40.0-255,66,355898,69,396592
12601,0.075857,74.125.130.0-255,5738,361636,69,396592
12602,0.075863,172.31.40.0-255,66,361702,69,396592
12603,0.077964,74.125.130.0-255,5738,367440,69,396592
12604,0.077971,172.31.40.0-255,66,367506,69,396592
12605,0.08008,74.125.130.0-255,5738,373244,69,396592
12606,0.080086,172.31.40.0-255,66,373310,69,396592
12607,0.082229,74.125.130.0-255,5738,379048,69,396592
12608,0.082236,172.31.40.0-255,66,379114,69,396592
12609,0.084325,74.125.130.0-255,1484,380598,69,396592
12610,0.084351,74.125.130.0-255,4320,384918,69,396592
12611,0.084356,172.31.40.0-255,66,384984,69,396592
12612,0.086481,74.125.130.0-255,5738,390722,69,396592
12613,0.086488,172.31.40.0-255,66,390788,69,396592
12614,0.088605,74.125.130.0-255,5738,396526,69,396592
12615,0.088611,172.31.40.0-255,66,396592,69,396592
12616,0.0,172.31.40.0-255,105,105,69,276
12617,0.002328,157.240.7.0-255,105,210,69,276
12618,0.00234,172.31.40.0-255,66,276,69,276
12619,0.0,74.125.24.0-255,153,153,69,362868
12620,2.2e-05,172.31.40.0-255,66,219,69,362868
12621,2.8e-05,74.125.24.0-255,1484,1703,69,362868
12622,3.3e-05,172.31.40.0-255,66,1769,69,362868
12623,3.9e-05,74.125.24.0-255,2902,4671,69,362868
12624,4.2e-05,172.31.40.0-255,66,4737,69,362868
12625,4.8e-05,74.125.24.0-255,5738,10475,69,362868
12626,5.1e-05,172.31.40.0-255,66,10541,69,362868
12627,7.2e-05,74.125.24.0-255,1484,12025,69,362868
12628,7.4e-05,172.31.40.0-255,66,12091,69,362868
12629,7.8e-05,74.125.24.0-255,1484,13575,69,362868
12630,8e-05,172.31.40.0-255,66,13641,69,362868
12631,9.8e-05,74.125.24.0-255,3507,17148,69,362868
12632,0.000101,172.31.40.0-255,66,17214,69,362868
12633,0.000107,74.125.24.0-255,5738,22952,69,362868
12634,0.000109,172.31.40.0-255,66,23018,69,362868
12635,0.000126,74.125.24.0-255,7156,30174,69,362868
12636,0.000128,172.31.40.0-255,66,30240,69,362868
12637,0.000146,74.125.24.0-255,5738,35978,69,362868
12638,0.000148,172.31.40.0-255,66,36044,69,362868
12639,0.000155,74.125.24.0-255,7156,43200,69,362868
12640,0.000157,172.31.40.0-255,66,43266,69,362868
12641,0.000174,74.125.24.0-255,2902,46168,69,362868
12642,0.000176,172.31.40.0-255,66,46234,69,362868
12643,0.000195,74.125.24.0-255,2184,48418,69,362868
12644,0.000196,172.31.40.0-255,66,48484,69,362868
12645,0.000365,74.125.24.0-255,1484,49968,69,362868
12646,0.00037,172.31.40.0-255,66,50034,69,362868
12647,0.000375,74.125.24.0-255,2902,52936,69,362868
12648,0.000377,172.31.40.0-255,66,53002,69,362868
12649,0.000392,74.125.24.0-255,4320,57322,69,362868
12650,0.000394,172.31.40.0-255,66,57388,69,362868
12651,0.0004,74.125.24.0-255,5738,63126,69,362868
12652,0.000402,172.31.40.0-255,66,63192,69,362868
12653,0.000447,74.125.24.0-255,2883,66075,69,362868
12654,0.00045,172.31.40.0-255,66,66141,69,362868
12655,0.000947,74.125.24.0-255,1484,67625,69,362868
12656,0.000955,74.125.24.0-255,2902,70527,69,362868
12657,0.000959,172.31.40.0-255,66,70593,69,362868
12658,0.000984,74.125.24.0-255,5738,76331,69,362868
12659,0.000988,74.125.24.0-255,2902,79233,69,362868
12660,0.000991,172.31.40.0-255,66,79299,69,362868
12661,0.000994,172.31.40.0-255,66,79365,69,362868
12662,0.001011,172.31.40.0-255,66,79431,69,362868
12663,0.001056,74.125.24.0-255,1484,80915,69,362868
12664,0.001077,74.125.24.0-255,7156,88071,69,362868
12665,0.00108,172.31.40.0-255,66,88137,69,362868
12666,0.001102,74.125.24.0-255,2184,90321,69,362868
12667,0.001105,172.31.40.0-255,66,90387,69,362868
12668,0.001388,74.125.24.0-255,1484,91871,69,362868
12669,0.001404,74.125.24.0-255,2902,94773,69,362868
12670,0.001408,172.31.40.0-255,66,94839,69,362868
12671,0.001414,74.125.24.0-255,4320,99159,69,362868
12672,0.001416,172.31.40.0-255,66,99225,69,362868
12673,0.001427,74.125.24.0-255,1484,100709,69,362868
12674,0.001455,172.31.40.0-255,66,100775,69,362868
12675,0.001497,74.125.24.0-255,4320,105095,69,362868
12676,0.0015,172.31.40.0-255,66,105161,69,362868
12677,0.001513,172.31.40.0-255,66,105227,69,362868
12678,0.001555,172.31.40.0-255,66,105293,69,362868
12679,0.001583,74.125.24.0-255,5738,111031,69,362868
12680,0.001586,172.31.40.0-255,66,111097,69,362868
12681,0.0016,172.31.40.0-255,66,111163,69,362868
12682,0.002131,74.125.24.0-255,1484,112647,69,362868
12683,0.002153,74.125.24.0-255,2902,115549,69,362868
12684,0.002157,172.31.40.0-255,66,115615,69,362868
12685,0.002186,74.125.24.0-255,4320,119935,69,362868
12686,0.002188,172.31.40.0-255,66,120001,69,362868
12687,0.002218,74.125.24.0-255,5738,125739,69,362868
12688,0.002221,172.31.40.0-255,66,125805,69,362868
12689,0.002236,74.125.24.0-255,2902,128707,69,362868
12690,0.002238,172.31.40.0-255,66,128773,69,362868
12691,0.002258,74.125.24.0-255,4320,133093,69,362868
12692,0.00226,172.31.40.0-255,66,133159,69,362868
12693,0.002292,74.125.24.0-255,4320,137479,69,362868
12694,0.002295,172.31.40.0-255,66,137545,69,362868
12695,0.002314,74.125.24.0-255,2902,140447,69,362868
12696,0.002316,172.31.40.0-255,66,140513,69,362868
12697,0.002329,74.125.24.0-255,2902,143415,69,362868
12698,0.002331,172.31.40.0-255,66,143481,69,362868
12699,0.002335,74.125.24.0-255,2184,145665,69,362868
12700,0.002337,172.31.40.0-255,66,145731,69,362868
12701,0.004751,74.125.24.0-255,5738,151469,69,362868
12702,0.004758,172.31.40.0-255,66,151535,69,362868
12703,0.007152,74.125.24.0-255,5738,157273,69,362868
12704,0.007155,172.31.40.0-255,66,157339,69,362868
12705,0.00958,74.125.24.0-255,5738,163077,69,362868
12706,0.009587,172.31.40.0-255,66,163143,69,362868
12707,0.011961,74.125.24.0-255,5738,168881,69,362868
12708,0.011969,172.31.40.0-255,66,168947,69,362868
12709,0.014353,74.125.24.0-255,5738,174685,69,362868
12710,0.014361,172.31.40.0-255,66,174751,69,362868
12711,0.01676,74.125.24.0-255,5738,180489,69,362868
12712,0.01677,172.31.40.0-255,66,180555,69,362868
12713,0.019165,74.125.24.0-255,5738,186293,69,362868
12714,0.019175,172.31.40.0-255,66,186359,69,362868
12715,0.021529,74.125.24.0-255,2902,189261,69,362868
12716,0.021536,172.31.40.0-255,66,189327,69,362868
12717,0.021558,74.125.24.0-255,2902,192229,69,362868
12718,0.021561,172.31.40.0-255,66,192295,69,362868
12719,0.0239,74.125.24.0-255,2902,195197,69,362868
12720,0.023908,172.31.40.0-255,66,195263,69,362868
12721,0.02394,74.125.24.0-255,2902,198165,69,362868
12722,0.023944,172.31.40.0-255,66,198231,69,362868
12723,0.026311,74.125.24.0-255,5738,203969,69,362868
12724,0.026318,172.31.40.0-255,66,204035,69,362868
12725,0.02871,74.125.24.0-255,5738,209773,69,362868
12726,0.028718,172.31.40.0-255,66,209839,69,362868
12727,0.031085,74.125.24.0-255,5738,215577,69,362868
12728,0.031094,172.31.40.0-255,66,215643,69,362868
12729,0.033727,74.125.24.0-255,4320,219963,69,362868
12730,0.033734,172.31.40.0-255,66,220029,69,362868
12731,0.033751,74.125.24.0-255,1484,221513,69,362868
12732,0.034164,172.31.40.0-255,172,221685,69,362868
12733,0.034192,172.31.40.0-255,1116,222801,69,362868
12734,0.034259,172.31.40.0-255,1514,224315,69,362868
12735,0.03426,172.31.40.0-255,1514,225829,69,362868
12736,0.034267,172.31.40.0-255,1514,227343,69,362868
12737,0.034268,172.31.40.0-255,1514,228857,69,362868
12738,0.034298,172.31.40.0-255,1499,230356,69,362868
12739,0.035833,104.244.42.0-255,66,230422,69,362868
12740,0.035887,104.244.42.0-255,66,230488,69,362868
12741,0.03592,104.244.42.0-255,66,230554,69,362868
12742,0.035991,104.244.42.0-255,66,230620,69,362868
12743,0.036093,74.125.24.0-255,4320,234940,69,362868
12744,0.036099,172.31.40.0-255,66,235006,69,362868
12745,0.038508,74.125.24.0-255,5738,240744,69,362868
12746,0.038514,172.31.40.0-255,66,240810,69,362868
12747,0.038895,104.244.42.0-255,108,240918,69,362868
12748,0.038901,172.31.40.0-255,66,240984,69,362868
12749,0.040876,74.125.24.0-255,5738,246722,69,362868
12750,0.040882,172.31.40.0-255,66,246788,69,362868
12751,0.04327,74.125.24.0-255,5738,252526,69,362868
12752,0.043276,172.31.40.0-255,66,252592,69,362868
12753,0.045746,74.125.24.0-255,5738,258330,69,362868
12754,0.045754,172.31.40.0-255,66,258396,69,362868
12755,0.048144,74.125.24.0-255,5738,264134,69,362868
12756,0.048149,172.31.40.0-255,66,264200,69,362868
12757,0.05055,74.125.24.0-255,5738,269938,69,362868
12758,0.050555,172.31.40.0-255,66,270004,69,362868
12759,0.05299,74.125.24.0-255,5738,275742,69,362868
12760,0.052995,172.31.40.0-255,66,275808,69,362868
12761,0.055427,74.125.24.0-255,5738,281546,69,362868
12762,0.055434,172.31.40.0-255,66,281612,69,362868
12763,0.057837,74.125.24.0-255,5738,287350,69,362868
12764,0.057844,172.31.40.0-255,66,287416,69,362868
12765,0.060243,74.125.24.0-255,5738,293154,69,362868
12766,0.060249,172.31.40.0-255,66,293220,69,362868
12767,0.062652,74.125.24.0-255,5738,298958,69,362868
12768,0.062658,172.31.40.0-255,66,299024,69,362868
12769,0.065078,74.125.24.0-255,5738,304762,69,362868
12770,0.065085,172.31.40.0-255,66,304828,69,362868
12771,0.067461,74.125.24.0-255,5738,310566,69,362868
12772,0.067468,172.31.40.0-255,66,310632,69,362868
12773,0.069858,74.125.24.0-255,5738,316370,69,362868
12774,0.069867,172.31.40.0-255,66,316436,69,362868
12775,0.072276,74.125.24.0-255,5738,322174,69,362868
12776,0.072283,172.31.40.0-255,66,322240,69,362868
12777,0.074682,74.125.24.0-255,5738,327978,69,362868
12778,0.074692,172.31.40.0-255,66,328044,69,362868
12779,0.077061,74.125.24.0-255,5738,333782,69,362868
12780,0.077068,172.31.40.0-255,66,333848,69,362868
12781,0.079467,74.125.24.0-255,5738,339586,69,362868
12782,0.079474,172.31.40.0-255,66,339652,69,362868
12783,0.081877,74.125.24.0-255,5738,345390,69,362868
12784,0.081883,172.31.40.0-255,66,345456,69,362868
12785,0.084285,74.125.24.0-255,5738,351194,69,362868
12786,0.084292,172.31.40.0-255,66,351260,69,362868
12787,0.086688,74.125.24.0-255,5738,356998,69,362868
12788,0.086695,172.31.40.0-255,66,357064,69,362868
12789,0.089098,74.125.24.0-255,5738,362802,69,362868
12790,0.089105,172.31.40.0-255,66,362868,69,362868
12791,0.0,172.217.194.0-255,153,153,69,269718
12792,2.4e-05,172.31.40.0-255,66,219,69,269718
12793,3.1e-05,172.217.194.0-255,1484,1703,69,269718
12794,3.6e-05,172.31.40.0-255,66,1769,69,269718
12795,4.3e-05,172.217.194.0-255,2902,4671,69,269718
12796,4.6e-05,172.31.40.0-255,66,4737,69,269718
12797,5.2e-05,172.217.194.0-255,5738,10475,69,269718
12798,5.7e-05,172.31.40.0-255,66,10541,69,269718
12799,9.6e-05,172.31.40.0-255,66,10607,69,269718
12800,0.000117,172.217.194.0-255,2080,12687,69,269718
12801,0.00012,172.31.40.0-255,66,12753,69,269718
12802,0.000128,172.217.194.0-255,6797,19550,69,269718
12803,0.000131,172.31.40.0-255,66,19616,69,269718
12804,0.000178,172.217.194.0-255,1484,21100,69,269718
12805,0.00018,172.31.40.0-255,66,21166,69,269718
12806,0.000185,172.217.194.0-255,2902,24068,69,269718
12807,0.000187,172.31.40.0-255,66,24134,69,269718
12808,0.000191,172.217.194.0-255,2902,27036,69,269718
12809,0.000194,172.31.40.0-255,66,27102,69,269718
12810,0.000225,172.217.194.0-255,7156,34258,69,269718
12811,0.000228,172.31.40.0-255,66,34324,69,269718
12812,0.000273,172.31.40.0-255,66,34390,69,269718
12813,0.000292,172.217.194.0-255,3961,38351,69,269718
12814,0.000294,172.31.40.0-255,66,38417,69,269718
12815,0.0003,172.217.194.0-255,5738,44155,69,269718
12816,0.000303,172.31.40.0-255,66,44221,69,269718
12817,0.000319,172.217.194.0-255,1714,45935,69,269718
12818,0.000322,172.31.40.0-255,66,46001,69,269718
12819,0.000551,172.217.194.0-255,1484,47485,69,269718
12820,0.000557,172.31.40.0-255,66,47551,69,269718
12821,0.000563,172.217.194.0-255,2902,50453,69,269718
12822,0.000566,172.31.40.0-255,66,50519,69,269718
12823,0.000571,172.217.194.0-255,5738,56257,69,269718
12824,0.000574,172.31.40.0-255,66,56323,69,269718
12825,0.000602,172.31.40.0-255,66,56389,69,269718
12826,0.000627,172.217.194.0-255,2902,59291,69,269718
12827,0.00063,172.31.40.0-255,66,59357,69,269718
12828,0.00064,172.31.40.0-255,66,59423,69,269718
12829,0.000661,172.217.194.0-255,2184,61607,69,269718
12830,0.000663,172.31.40.0-255,66,61673,69,269718
12831,0.001158,172.217.194.0-255,1484,63157,69,269718
12832,0.001166,172.217.194.0-255,2902,66059,69,269718
12833,0.00117,172.31.40.0-255,66,66125,69,269718
12834,0.001175,172.217.194.0-255,2902,69027,69,269718
12835,0.001177,172.31.40.0-255,66,69093,69,269718
12836,0.001193,172.217.194.0-255,2902,71995,69,269718
12837,0.001195,172.31.40.0-255,66,72061,69,269718
12838,0.001198,172.217.194.0-255,1484,73545,69,269718
12839,0.001231,172.31.40.0-255,66,73611,69,269718
12840,0.001237,172.217.194.0-255,5738,79349,69,269718
12841,0.001239,172.31.40.0-255,66,79415,69,269718
12842,0.001256,172.217.194.0-255,4320,83735,69,269718
12843,0.001258,172.31.40.0-255,66,83801,69,269718
12844,0.001261,172.217.194.0-255,766,84567,69,269718
12845,0.001275,172.217.194.0-255,1484,86051,69,269718
12846,0.001277,172.31.40.0-255,66,86117,69,269718
12847,0.001302,172.217.194.0-255,4320,90437,69,269718
12848,0.001305,172.31.40.0-255,66,90503,69,269718
12849,0.001315,172.31.40.0-255,66,90569,69,269718
12850,0.001339,172.217.194.0-255,1484,92053,69,269718
12851,0.00135,172.31.40.0-255,66,92119,69,269718
12852,0.001371,172.217.194.0-255,5738,97857,69,269718
12853,0.001373,172.31.40.0-255,66,97923,69,269718
12854,0.001396,172.217.194.0-255,3602,101525,69,269718
12855,0.001398,172.31.40.0-255,66,101591,69,269718
12856,0.001436,172.217.194.0-255,1484,103075,69,269718
12857,0.00144,172.217.194.0-255,2902,105977,69,269718
12858,0.001451,172.31.40.0-255,66,106043,69,269718
12859,0.001464,172.217.194.0-255,4320,110363,69,269718
12860,0.001467,172.31.40.0-255,66,110429,69,269718
12861,0.001491,172.217.194.0-255,1484,111913,69,269718
12862,0.001498,172.217.194.0-255,5738,117651,69,269718
12863,0.001501,172.31.40.0-255,66,117717,69,269718
12864,0.001507,172.217.194.0-255,5738,123455,69,269718
12865,0.00151,172.31.40.0-255,66,123521,69,269718
12866,0.001546,172.217.194.0-255,7156,130677,69,269718
12867,0.001549,172.31.40.0-255,66,130743,69,269718
12868,0.001555,172.217.194.0-255,5020,135763,69,269718
12869,0.001557,172.31.40.0-255,66,135829,69,269718
12870,0.00158,172.217.194.0-255,5738,141567,69,269718
12871,0.001583,172.31.40.0-255,66,141633,69,269718
12872,0.001597,172.31.40.0-255,66,141699,69,269718
12873,0.001625,172.217.194.0-255,1484,143183,69,269718
12874,0.001653,172.31.40.0-255,66,143249,69,269718
12875,0.001709,172.217.194.0-255,7156,150405,69,269718
12876,0.001711,172.31.40.0-255,66,150471,69,269718
12877,0.001723,172.31.40.0-255,66,150537,69,269718
12878,0.001743,172.31.40.0-255,66,150603,69,269718
12879,0.001766,172.217.194.0-255,4320,154923,69,269718
12880,0.001768,172.31.40.0-255,66,154989,69,269718
12881,0.001771,172.217.194.0-255,766,155755,69,269718
12882,0.001792,172.217.194.0-255,5738,161493,69,269718
12883,0.001794,172.31.40.0-255,66,161559,69,269718
12884,0.001827,172.31.40.0-255,66,161625,69,269718
12885,0.001843,172.31.40.0-255,66,161691,69,269718
12886,0.001848,172.217.194.0-255,3602,165293,69,269718
12887,0.00185,172.31.40.0-255,66,165359,69,269718
12888,0.001906,172.217.194.0-255,1484,166843,69,269718
12889,0.001922,172.217.194.0-255,2902,169745,69,269718
12890,0.001925,172.31.40.0-255,66,169811,69,269718
12891,0.00193,172.217.194.0-255,2902,172713,69,269718
12892,0.001932,172.31.40.0-255,66,172779,69,269718
12893,0.001948,172.217.194.0-255,2902,175681,69,269718
12894,0.00195,172.31.40.0-255,66,175747,69,269718
12895,0.001955,172.217.194.0-255,2902,178649,69,269718
12896,0.001956,172.31.40.0-255,66,178715,69,269718
12897,0.001994,172.31.40.0-255,66,178781,69,269718
12898,0.002006,172.31.40.0-255,66,178847,69,269718
12899,0.002044,172.217.194.0-255,1484,180331,69,269718
12900,0.002059,172.217.194.0-255,2902,183233,69,269718
12901,0.002062,172.31.40.0-255,66,183299,69,269718
12902,0.002066,172.217.194.0-255,1484,184783,69,269718
12903,0.002087,172.217.194.0-255,4320,189103,69,269718
12904,0.00209,172.31.40.0-255,66,189169,69,269718
12905,0.002096,172.217.194.0-255,5738,194907,69,269718
12906,0.002098,172.31.40.0-255,66,194973,69,269718
12907,0.002117,172.217.194.0-255,7156,202129,69,269718
12908,0.002142,172.217.194.0-255,4320,206449,69,269718
12909,0.002166,172.217.194.0-255,6438,212887,69,269718
12910,0.00218,172.217.194.0-255,1484,214371,69,269718
12911,0.005975,172.31.40.0-255,66,214437,69,269718
12912,0.008167,172.217.194.0-255,5738,220175,69,269718
12913,0.008178,172.31.40.0-255,66,220241,69,269718
12914,0.010317,172.217.194.0-255,5738,225979,69,269718
12915,0.010325,172.31.40.0-255,66,226045,69,269718
12916,0.012487,172.217.194.0-255,5738,231783,69,269718
12917,0.012496,172.31.40.0-255,66,231849,69,269718
12918,0.014705,172.217.194.0-255,5738,237587,69,269718
12919,0.014716,172.31.40.0-255,66,237653,69,269718
12920,0.016869,172.217.194.0-255,5738,243391,69,269718
12921,0.016883,172.31.40.0-255,66,243457,69,269718
12922,0.019072,172.217.194.0-255,5738,249195,69,269718
12923,0.019083,172.31.40.0-255,66,249261,69,269718
12924,0.021305,172.217.194.0-255,5738,254999,69,269718
12925,0.021317,172.31.40.0-255,66,255065,69,269718
12926,0.023466,172.217.194.0-255,5571,260636,69,269718
12927,0.023474,172.31.40.0-255,66,260702,69,269718
12928,0.023725,172.31.40.0-255,105,260807,69,269718
12929,0.025842,172.217.194.0-255,66,260873,69,269718
12930,0.043274,172.31.40.0-255,172,261045,69,269718
12931,0.043302,172.31.40.0-255,1112,262157,69,269718
12932,0.043377,172.31.40.0-255,1514,263671,69,269718
12933,0.043379,172.31.40.0-255,1514,265185,69,269718
12934,0.043385,172.31.40.0-255,1514,266699,69,269718
12935,0.043386,172.31.40.0-255,1514,268213,69,269718
12936,0.043404,172.31.40.0-255,1505,269718,69,269718
12937,0.0,172.31.40.0-255,105,105,69,276
12938,0.001893,157.240.7.0-255,105,210,69,276
12939,0.001906,172.31.40.0-255,66,276,69,276
12940,0.0,74.125.68.0-255,153,153,69,357303
12941,1.5e-05,172.31.40.0-255,66,219,69,357303
12942,2.1e-05,74.125.68.0-255,1484,1703,69,357303
12943,2.5e-05,172.31.40.0-255,66,1769,69,357303
12944,4.5e-05,74.125.68.0-255,2902,4671,69,357303
12945,4.8e-05,172.31.40.0-255,66,4737,69,357303
12946,5.2e-05,74.125.68.0-255,1484,6221,69,357303
12947,5.4e-05,172.31.40.0-255,66,6287,69,357303
12948,0.000116,74.125.68.0-255,2902,9189,69,357303
12949,0.00012,172.31.40.0-255,66,9255,69,357303
12950,0.000126,74.125.68.0-255,4874,14129,69,357303
12951,0.000129,172.31.40.0-255,66,14195,69,357303
12952,0.00043,74.125.68.0-255,1484,15679,69,357303
12953,0.000436,172.31.40.0-255,66,15745,69,357303
12954,0.000442,74.125.68.0-255,2902,18647,69,357303
12955,0.000444,172.31.40.0-255,66,18713,69,357303
12956,0.000447,74.125.68.0-255,1484,20197,69,357303
12957,0.00045,172.31.40.0-255,66,20263,69,357303
12958,0.000479,74.125.68.0-255,2902,23165,69,357303
12959,0.000482,172.31.40.0-255,66,23231,69,357303
12960,0.000489,74.125.68.0-255,5738,28969,69,357303
12961,0.000492,172.31.40.0-255,66,29035,69,357303
12962,0.000497,74.125.68.0-255,2543,31578,69,357303
12963,0.000499,172.31.40.0-255,66,31644,69,357303
12964,0.000519,74.125.68.0-255,2902,34546,69,357303
12965,0.000522,172.31.40.0-255,66,34612,69,357303
12966,0.000526,74.125.68.0-255,2902,37514,69,357303
12967,0.000528,172.31.40.0-255,66,37580,69,357303
12968,0.000549,74.125.68.0-255,4320,41900,69,357303
12969,0.000552,172.31.40.0-255,66,41966,69,357303
12970,0.000558,74.125.68.0-255,5738,47704,69,357303
12971,0.00056,172.31.40.0-255,66,47770,69,357303
12972,0.000581,74.125.68.0-255,1125,48895,69,357303
12973,0.000615,74.125.68.0-255,1484,50379,69,357303
12974,0.000618,172.31.40.0-255,66,50445,69,357303
12975,0.000646,74.125.68.0-255,1484,51929,69,357303
12976,0.000651,74.125.68.0-255,2902,54831,69,357303
12977,0.000653,172.31.40.0-255,66,54897,69,357303
12978,0.000676,74.125.68.0-255,5738,60635,69,357303
12979,0.000679,172.31.40.0-255,66,60701,69,357303
12980,0.000701,74.125.68.0-255,5704,66405,69,357303
12981,0.000705,172.31.40.0-255,66,66471,69,357303
12982,0.000775,74.125.68.0-255,1484,67955,69,357303
12983,0.000781,74.125.68.0-255,2902,70857,69,357303
12984,0.000784,172.31.40.0-255,66,70923,69,357303
12985,0.000811,74.125.68.0-255,4320,75243,69,357303
12986,0.000813,172.31.40.0-255,66,75309,69,357303
12987,0.00082,74.125.68.0-255,5738,81047,69,357303
12988,0.000823,172.31.40.0-255,66,81113,69,357303
12989,0.000854,74.125.68.0-255,4320,85433,69,357303
12990,0.000857,172.31.40.0-255,66,85499,69,357303
12991,0.000875,74.125.68.0-255,6797,92296,69,357303
12992,0.000878,172.31.40.0-255,66,92362,69,357303
12993,0.000904,74.125.68.0-255,5738,98100,69,357303
12994,0.000907,172.31.40.0-255,66,98166,69,357303
12995,0.000923,74.125.68.0-255,2227,100393,69,357303
12996,0.000951,172.31.40.0-255,66,100459,69,357303
12997,0.00096,74.125.68.0-255,1484,101943,69,357303
12998,0.000975,74.125.68.0-255,2902,104845,69,357303
12999,0.000977,172.31.40.0-255,66,104911,69,357303
13000,0.001001,74.125.68.0-255,5738,110649,69,357303
13001,0.001004,172.31.40.0-255,66,110715,69,357303
13002,0.001008,74.125.68.0-255,2902,113617,69,357303
13003,0.001011,172.31.40.0-255,66,113683,69,357303
13004,0.001014,74.125.68.0-255,1484,115167,69,357303
13005,0.001031,74.125.68.0-255,2902,118069,69,357303
13006,0.001033,172.31.40.0-255,66,118135,69,357303
13007,0.001048,74.125.68.0-255,5738,123873,69,357303
13008,0.001051,172.31.40.0-255,66,123939,69,357303
13009,0.001067,74.125.68.0-255,2902,126841,69,357303
13010,0.00107,172.31.40.0-255,66,126907,69,357303
13011,0.001074,74.125.68.0-255,2902,129809,69,357303
13012,0.001077,172.31.40.0-255,66,129875,69,357303
13013,0.00112,74.125.68.0-255,5020,134895,69,357303
13014,0.001123,172.31.40.0-255,66,134961,69,357303
13015,0.001271,74.125.68.0-255,1484,136445,69,357303
13016,0.001303,74.125.68.0-255,2902,139347,69,357303
13017,0.001308,74.125.68.0-255,2902,142249,69,357303
13018,0.001312,172.31.40.0-255,66,142315,69,357303
13019,0.001316,172.31.40.0-255,66,142381,69,357303
13020,0.001337,74.125.68.0-255,4320,146701,69,357303
13021,0.001339,172.31.40.0-255,66,146767,69,357303
13022,0.00135,172.31.40.0-255,66,146833,69,357303
13023,0.001383,74.125.68.0-255,7156,153989,69,357303
13024,0.001385,172.31.40.0-255,66,154055,69,357303
13025,0.001418,74.125.68.0-255,2902,156957,69,357303
13026,0.001421,172.31.40.0-255,66,157023,69,357303
13027,0.001441,74.125.68.0-255,3602,160625,69,357303
13028,0.001445,172.31.40.0-255,66,160691,69,357303
13029,0.001465,74.125.68.0-255,1484,162175,69,357303
13030,0.00148,74.125.68.0-255,1484,163659,69,357303
13031,0.001483,172.31.40.0-255,66,163725,69,357303
13032,0.001503,74.125.68.0-255,1484,165209,69,357303
13033,0.00151,74.125.68.0-255,5738,170947,69,357303
13034,0.001512,172.31.40.0-255,66,171013,69,357303
13035,0.001516,74.125.68.0-255,2902,173915,69,357303
13036,0.001519,172.31.40.0-255,66,173981,69,357303
13037,0.00153,74.125.68.0-255,1484,175465,69,357303
13038,0.001537,74.125.68.0-255,5738,181203,69,357303
13039,0.001539,172.31.40.0-255,66,181269,69,357303
13040,0.001568,172.31.40.0-255,66,181335,69,357303
13041,0.001571,74.125.68.0-255,2184,183519,69,357303
13042,0.001573,172.31.40.0-255,66,183585,69,357303
13043,0.001665,74.125.68.0-255,1484,185069,69,357303
13044,0.001679,74.125.68.0-255,2902,187971,69,357303
13045,0.001683,172.31.40.0-255,66,188037,69,357303
13046,0.001693,74.125.68.0-255,1484,189521,69,357303
13047,0.001709,74.125.68.0-255,4320,193841,69,357303
13048,0.001711,172.31.40.0-255,66,193907,69,357303
13049,0.001714,74.125.68.0-255,1484,195391,69,357303
13050,0.001736,74.125.68.0-255,7156,202547,69,357303
13051,0.001738,172.31.40.0-255,66,202613,69,357303
13052,0.001764,74.125.68.0-255,1484,204097,69,357303
13053,0.001785,172.31.40.0-255,66,204163,69,357303
13054,0.001791,74.125.68.0-255,5020,209183,69,357303
13055,0.001793,172.31.40.0-255,66,209249,69,357303
13056,0.001986,74.125.68.0-255,1484,210733,69,357303
13057,0.002005,74.125.68.0-255,2902,213635,69,357303
13058,0.002008,172.31.40.0-255,66,213701,69,357303
13059,0.002022,74.125.68.0-255,5738,219439,69,357303
13060,0.002024,172.31.40.0-255,66,219505,69,357303
13061,0.002037,74.125.68.0-255,2902,222407,69,357303
13062,0.002043,172.31.40.0-255,66,222473,69,357303
13063,0.00206,74.125.68.0-255,4320,226793,69,357303
13064,0.002062,172.31.40.0-255,66,226859,69,357303
13065,0.002098,172.31.40.0-255,66,226925,69,357303
13066,0.002144,172.31.40.0-255,66,226991,69,357303
13067,0.002152,74.125.68.0-255,3602,230593,69,357303
13068,0.002154,172.31.40.0-255,66,230659,69,357303
13069,0.002166,74.125.68.0-255,1484,232143,69,357303
13070,0.002198,172.31.40.0-255,66,232209,69,357303
13071,0.002203,74.125.68.0-255,4320,236529,69,357303
13072,0.002204,172.31.40.0-255,66,236595,69,357303
13073,0.002271,172.31.40.0-255,66,236661,69,357303
13074,0.002278,74.125.68.0-255,7156,243817,69,357303
13075,0.00228,172.31.40.0-255,66,243883,69,357303
13076,0.002295,74.125.68.0-255,5738,249621,69,357303
13077,0.002297,172.31.40.0-255,66,249687,69,357303
13078,0.002313,74.125.68.0-255,4320,254007,69,357303
13079,0.002316,172.31.40.0-255,66,254073,69,357303
13080,0.00458,74.125.68.0-255,1484,255557,69,357303
13081,0.004601,74.125.68.0-255,4320,259877,69,357303
13082,0.004605,172.31.40.0-255,66,259943,69,357303
13083,0.006892,74.125.68.0-255,5738,265681,69,357303
13084,0.006895,172.31.40.0-255,66,265747,69,357303
13085,0.009201,74.125.68.0-255,5738,271485,69,357303
13086,0.009208,172.31.40.0-255,66,271551,69,357303
13087,0.011505,74.125.68.0-255,5738,277289,69,357303
13088,0.011514,172.31.40.0-255,66,277355,69,357303
13089,0.013814,74.125.68.0-255,5738,283093,69,357303
13090,0.013821,172.31.40.0-255,66,283159,69,357303
13091,0.016127,74.125.68.0-255,5738,288897,69,357303
13092,0.016135,172.31.40.0-255,66,288963,69,357303
13093,0.018435,74.125.68.0-255,5738,294701,69,357303
13094,0.018441,172.31.40.0-255,66,294767,69,357303
13095,0.020737,74.125.68.0-255,5738,300505,69,357303
13096,0.020744,172.31.40.0-255,66,300571,69,357303
13097,0.023045,74.125.68.0-255,5738,306309,69,357303
13098,0.023055,172.31.40.0-255,66,306375,69,357303
13099,0.025352,74.125.68.0-255,5738,312113,69,357303
13100,0.02536,172.31.40.0-255,66,312179,69,357303
13101,0.027661,74.125.68.0-255,5738,317917,69,357303
13102,0.027668,172.31.40.0-255,66,317983,69,357303
13103,0.02996,74.125.68.0-255,5738,323721,69,357303
13104,0.029968,172.31.40.0-255,66,323787,69,357303
13105,0.032293,74.125.68.0-255,5738,329525,69,357303
13106,0.032302,172.31.40.0-255,66,329591,69,357303
13107,0.034603,74.125.68.0-255,5738,335329,69,357303
13108,0.03461,172.31.40.0-255,66,335395,69,357303
13109,0.03692,74.125.68.0-255,5738,341133,69,357303
13110,0.036928,172.31.40.0-255,66,341199,69,357303
13111,0.038871,172.31.40.0-255,192,341391,69,357303
13112,0.038905,172.31.40.0-255,1116,342507,69,357303
13113,0.038971,172.31.40.0-255,1514,344021,69,357303
13114,0.038973,172.31.40.0-255,1514,345535,69,357303
13115,0.038974,172.31.40.0-255,1514,347049,69,357303
13116,0.038978,172.31.40.0-255,1514,348563,69,357303
13117,0.038979,172.31.40.0-255,1501,350064,69,357303
13118,0.039219,74.125.68.0-255,5738,355802,69,357303
13119,0.039226,172.31.40.0-255,66,355868,69,357303
13120,0.040375,104.244.42.0-255,66,355934,69,357303
13121,0.040404,104.244.42.0-255,66,356000,69,357303
13122,0.040507,104.244.42.0-255,66,356066,69,357303
13123,0.041529,74.125.68.0-255,1000,357066,69,357303
13124,0.04167,172.31.40.0-255,66,357132,69,357303
13125,0.041701,172.31.40.0-255,105,357237,69,357303
13126,0.043961,74.125.68.0-255,66,357303,69,357303
13127,0.0,74.125.200.0-255,147,147,69,346743
13128,1.4e-05,172.31.40.0-255,66,213,69,346743
13129,4.3e-05,74.125.200.0-255,1484,1697,69,346743
13130,4.9e-05,172.31.40.0-255,66,1763,69,346743
13131,5.5e-05,74.125.200.0-255,2902,4665,69,346743
13132,5.9e-05,172.31.40.0-255,66,4731,69,346743
13133,8.9e-05,74.125.200.0-255,5738,10469,69,346743
13134,9.7e-05,172.31.40.0-255,66,10535,69,346743
13135,0.000101,74.125.200.0-255,2902,13437,69,346743
13136,0.000103,172.31.40.0-255,66,13503,69,346743
13137,0.000109,74.125.200.0-255,3543,17046,69,346743
13138,0.000111,172.31.40.0-255,66,17112,69,346743
13139,0.000143,172.31.40.0-255,66,17178,69,346743
13140,0.000148,74.125.200.0-255,4320,21498,69,346743
13141,0.000151,172.31.40.0-255,66,21564,69,346743
13142,0.000187,74.125.200.0-255,1125,22689,69,346743
13143,0.00019,172.31.40.0-255,66,22755,69,346743
13144,0.000463,74.125.200.0-255,1484,24239,69,346743
13145,0.000469,172.31.40.0-255,66,24305,69,346743
13146,0.000476,74.125.200.0-255,2902,27207,69,346743
13147,0.000479,172.31.40.0-255,66,27273,69,346743
13148,0.00049,74.125.200.0-255,5738,33011,69,346743
13149,0.000492,172.31.40.0-255,66,33077,69,346743
13150,0.00052,74.125.200.0-255,6797,39874,69,346743
13151,0.000527,172.31.40.0-255,66,39940,69,346743
13152,0.000556,172.31.40.0-255,66,40006,69,346743
13153,0.000581,74.125.200.0-255,2902,42908,69,346743
13154,0.000584,172.31.40.0-255,66,42974,69,346743
13155,0.000591,74.125.200.0-255,5691,48665,69,346743
13156,0.000593,172.31.40.0-255,66,48731,69,346743
13157,0.00069,74.125.200.0-255,112,48843,69,346743
13158,0.000772,74.125.200.0-255,1484,50327,69,346743
13159,0.000787,172.31.40.0-255,66,50393,69,346743
13160,0.000793,74.125.200.0-255,2902,53295,69,346743
13161,0.000797,74.125.200.0-255,2902,56197,69,346743
13162,0.000812,172.31.40.0-255,66,56263,69,346743
13163,0.000814,74.125.200.0-255,1484,57747,69,346743
13164,0.000841,74.125.200.0-255,4320,62067,69,346743
13165,0.00086,172.31.40.0-255,66,62133,69,346743
13166,0.000924,74.125.200.0-255,3602,65735,69,346743
13167,0.000936,172.31.40.0-255,66,65801,69,346743
13168,0.001172,74.125.200.0-255,1484,67285,69,346743
13169,0.001199,74.125.200.0-255,1484,68769,69,346743
13170,0.001202,172.31.40.0-255,66,68835,69,346743
13171,0.001236,74.125.200.0-255,2902,71737,69,346743
13172,0.001254,74.125.200.0-255,4320,76057,69,346743
13173,0.001266,172.31.40.0-255,66,76123,69,346743
13174,0.001279,74.125.200.0-255,1484,77607,69,346743
13175,0.001305,74.125.200.0-255,7156,84763,69,346743
13176,0.00131,74.125.200.0-255,5738,90501,69,346743
13177,0.001318,74.125.200.0-255,7156,97657,69,346743
13178,0.001333,172.31.40.0-255,66,97723,69,346743
13179,0.001337,74.125.200.0-255,2184,99907,69,346743
13180,0.001355,172.31.40.0-255,66,99973,69,346743
13181,0.001379,74.125.200.0-255,2902,102875,69,346743
13182,0.001395,74.125.200.0-255,1484,104359,69,346743
13183,0.0014,74.125.200.0-255,2902,107261,69,346743
13184,0.001415,172.31.40.0-255,66,107327,69,346743
13185,0.001423,74.125.200.0-255,5738,113065,69,346743
13186,0.001443,172.31.40.0-255,66,113131,69,346743
13187,0.001529,172.31.40.0-255,66,113197,69,346743
13188,0.001534,74.125.200.0-255,2902,116099,69,346743
13189,0.001539,172.31.40.0-255,66,116165,69,346743
13190,0.001595,172.31.40.0-255,66,116231,69,346743
13191,0.00183,74.125.200.0-255,1484,117715,69,346743
13192,0.001846,74.125.200.0-255,2902,120617,69,346743
13193,0.00185,172.31.40.0-255,66,120683,69,346743
13194,0.001862,74.125.200.0-255,4320,125003,69,346743
13195,0.001875,74.125.200.0-255,2902,127905,69,346743
13196,0.001891,74.125.200.0-255,5738,133643,69,346743
13197,0.001894,74.125.200.0-255,1484,135127,69,346743
13198,0.001898,172.31.40.0-255,66,135193,69,346743
13199,0.001907,74.125.200.0-255,4320,139513,69,346743
13200,0.001911,172.31.40.0-255,66,139579,69,346743
13201,0.001932,74.125.200.0-255,1484,141063,69,346743
13202,0.001946,74.125.200.0-255,766,141829,69,346743
13203,0.001952,172.31.40.0-255,66,141895,69,346743
13204,0.002083,74.125.200.0-255,1484,143379,69,346743
13205,0.002096,74.125.200.0-255,1484,144863,69,346743
13206,0.002099,172.31.40.0-255,66,144929,69,346743
13207,0.002103,74.125.200.0-255,1484,146413,69,346743
13208,0.002123,74.125.200.0-255,1484,147897,69,346743
13209,0.002156,74.125.200.0-255,4320,152217,69,346743
13210,0.002171,74.125.200.0-255,1484,153701,69,346743
13211,0.002184,172.31.40.0-255,66,153767,69,346743
13212,0.002189,172.31.40.0-255,66,153833,69,346743
13213,0.002199,74.125.200.0-255,1484,155317,69,346743
13214,0.002231,172.31.40.0-255,66,155383,69,346743
13215,0.00227,74.125.200.0-255,1484,156867,69,346743
13216,0.002291,74.125.200.0-255,2902,159769,69,346743
13217,0.002295,172.31.40.0-255,66,159835,69,346743
13218,0.002326,74.125.200.0-255,4320,164155,69,346743
13219,0.002339,172.31.40.0-255,66,164221,69,346743
13220,0.002343,74.125.200.0-255,2902,167123,69,346743
13221,0.002347,172.31.40.0-255,66,167189,69,346743
13222,0.004662,74.125.200.0-255,5738,172927,69,346743
13223,0.004669,172.31.40.0-255,66,172993,69,346743
13224,0.006985,74.125.200.0-255,5738,178731,69,346743
13225,0.012377,172.31.40.0-255,66,178797,69,346743
13226,0.013982,74.125.200.0-255,1484,180281,69,346743
13227,0.014713,74.125.200.0-255,4320,184601,69,346743
13228,0.01472,172.31.40.0-255,66,184667,69,346743
13229,0.017044,74.125.200.0-255,5738,190405,69,346743
13230,0.017094,172.31.40.0-255,66,190471,69,346743
13231,0.019425,74.125.200.0-255,5738,196209,69,346743
13232,0.019437,172.31.40.0-255,66,196275,69,346743
13233,0.021769,74.125.200.0-255,5738,202013,69,346743
13234,0.024031,172.31.40.0-255,66,202079,69,346743
13235,0.02637,74.125.200.0-255,5738,207817,69,346743
13236,0.026381,172.31.40.0-255,66,207883,69,346743
13237,0.028716,74.125.200.0-255,5738,213621,69,346743
13238,0.028724,172.31.40.0-255,66,213687,69,346743
13239,0.031048,74.125.200.0-255,5738,219425,69,346743
13240,0.031055,172.31.40.0-255,66,219491,69,346743
13241,0.033372,74.125.200.0-255,5738,225229,69,346743
13242,0.03338,172.31.40.0-255,66,225295,69,346743
13243,0.035696,74.125.200.0-255,5738,231033,69,346743
13244,0.035704,172.31.40.0-255,66,231099,69,346743
13245,0.03696,172.31.40.0-255,172,231271,69,346743
13246,0.03699,172.31.40.0-255,1111,232382,69,346743
13247,0.037046,172.31.40.0-255,1514,233896,69,346743
13248,0.037048,172.31.40.0-255,1514,235410,69,346743
13249,0.037049,172.31.40.0-255,1514,236924,69,346743
13250,0.03705,172.31.40.0-255,1514,238438,69,346743
13251,0.037051,172.31.40.0-255,546,238984,69,346743
13252,0.03804,74.125.200.0-255,5738,244722,69,346743
13253,0.038046,172.31.40.0-255,66,244788,69,346743
13254,0.03851,104.244.42.0-255,66,244854,69,346743
13255,0.038537,104.244.42.0-255,66,244920,69,346743
13256,0.038666,104.244.42.0-255,66,244986,69,346743
13257,0.038679,104.244.42.0-255,66,245052,69,346743
13258,0.040369,74.125.200.0-255,5738,250790,69,346743
13259,0.040375,172.31.40.0-255,66,250856,69,346743
13260,0.042708,74.125.200.0-255,5738,256594,69,346743
13261,0.042715,172.31.40.0-255,66,256660,69,346743
13262,0.045032,74.125.200.0-255,5738,262398,69,346743
13263,0.045038,172.31.40.0-255,66,262464,69,346743
13264,0.047412,74.125.200.0-255,5738,268202,69,346743
13265,0.047418,172.31.40.0-255,66,268268,69,346743
13266,0.049748,74.125.200.0-255,5738,274006,69,346743
13267,0.049756,172.31.40.0-255,66,274072,69,346743
13268,0.052101,74.125.200.0-255,5738,279810,69,346743
13269,0.052115,172.31.40.0-255,66,279876,69,346743
13270,0.054469,74.125.200.0-255,5738,285614,69,346743
13271,0.054485,172.31.40.0-255,66,285680,69,346743
13272,0.056826,74.125.200.0-255,5738,291418,69,346743
13273,0.056836,172.31.40.0-255,66,291484,69,346743
13274,0.059163,74.125.200.0-255,5738,297222,69,346743
13275,0.05917,172.31.40.0-255,66,297288,69,346743
13276,0.061491,74.125.200.0-255,5738,303026,69,346743
13277,0.061501,172.31.40.0-255,66,303092,69,346743
13278,0.063826,74.125.200.0-255,5738,308830,69,346743
13279,0.063833,172.31.40.0-255,66,308896,69,346743
13280,0.066158,74.125.200.0-255,5738,314634,69,346743
13281,0.066164,172.31.40.0-255,66,314700,69,346743
13282,0.068518,74.125.200.0-255,5738,320438,69,346743
13283,0.068525,172.31.40.0-255,66,320504,69,346743
13284,0.070848,74.125.200.0-255,5738,326242,69,346743
13285,0.070855,172.31.40.0-255,66,326308,69,346743
13286,0.073178,74.125.200.0-255,5738,332046,69,346743
13287,0.073185,172.31.40.0-255,66,332112,69,346743
13288,0.07552,74.125.200.0-255,5738,337850,69,346743
13289,0.075527,172.31.40.0-255,66,337916,69,346743
13290,0.07785,74.125.200.0-255,5738,343654,69,346743
13291,0.077856,172.31.40.0-255,66,343720,69,346743
13292,0.080177,74.125.200.0-255,2786,346506,69,346743
13293,0.080184,172.31.40.0-255,66,346572,69,346743
13294,0.080368,172.31.40.0-255,105,346677,69,346743
13295,0.082652,74.125.200.0-255,66,346743,69,346743
13296,0.0,74.125.24.0-255,153,153,69,299709
13297,3.1e-05,172.31.40.0-255,66,219,69,299709
13298,3.8e-05,74.125.24.0-255,1484,1703,69,299709
13299,4.2e-05,172.31.40.0-255,66,1769,69,299709
13300,4.7e-05,74.125.24.0-255,2902,4671,69,299709
13301,5.1e-05,172.31.40.0-255,66,4737,69,299709
13302,5.8e-05,74.125.24.0-255,7156,11893,69,299709
13303,6.1e-05,172.31.40.0-255,66,11959,69,299709
13304,9.5e-05,74.125.24.0-255,2100,14059,69,299709
13305,9.8e-05,172.31.40.0-255,66,14125,69,299709
13306,0.000197,74.125.24.0-255,1484,15609,69,299709
13307,0.000202,172.31.40.0-255,66,15675,69,299709
13308,0.000207,74.125.24.0-255,2902,18577,69,299709
13309,0.000211,172.31.40.0-255,66,18643,69,299709
13310,0.000217,74.125.24.0-255,5738,24381,69,299709
13311,0.000219,172.31.40.0-255,66,24447,69,299709
13312,0.000265,74.125.24.0-255,6797,31244,69,299709
13313,0.00027,172.31.40.0-255,66,31310,69,299709
13314,0.00038,74.125.24.0-255,1484,32794,69,299709
13315,0.000385,172.31.40.0-255,66,32860,69,299709
13316,0.000391,74.125.24.0-255,2902,35762,69,299709
13317,0.000396,172.31.40.0-255,66,35828,69,299709
13318,0.000408,74.125.24.0-255,5738,41566,69,299709
13319,0.000412,172.31.40.0-255,66,41632,69,299709
13320,0.000438,74.125.24.0-255,7156,48788,69,299709
13321,0.000442,172.31.40.0-255,66,48854,69,299709
13322,0.000469,74.125.24.0-255,6797,55651,69,299709
13323,0.000473,172.31.40.0-255,66,55717,69,299709
13324,0.000478,74.125.24.0-255,4320,60037,69,299709
13325,0.000482,172.31.40.0-255,66,60103,69,299709
13326,0.000504,74.125.24.0-255,4320,64423,69,299709
13327,0.000508,172.31.40.0-255,66,64489,69,299709
13328,0.000526,74.125.24.0-255,1458,65947,69,299709
13329,0.000528,74.125.24.0-255,376,66323,69,299709
13330,0.000531,172.31.40.0-255,66,66389,69,299709
13331,0.00079,74.125.24.0-255,1484,67873,69,299709
13332,0.000797,74.125.24.0-255,2902,70775,69,299709
13333,0.000801,172.31.40.0-255,66,70841,69,299709
13334,0.000808,74.125.24.0-255,4320,75161,69,299709
13335,0.00081,172.31.40.0-255,66,75227,69,299709
13336,0.000825,74.125.24.0-255,1484,76711,69,299709
13337,0.000838,172.31.40.0-255,66,76777,69,299709
13338,0.000852,74.125.24.0-255,2902,79679,69,299709
13339,0.000855,172.31.40.0-255,66,79745,69,299709
13340,0.000859,74.125.24.0-255,2902,82647,69,299709
13341,0.000863,172.31.40.0-255,66,82713,69,299709
13342,0.000895,172.31.40.0-255,66,82779,69,299709
13343,0.002,74.125.24.0-255,1484,84263,69,299709
13344,0.002009,74.125.24.0-255,1484,85747,69,299709
13345,0.002014,172.31.40.0-255,66,85813,69,299709
13346,0.002037,74.125.24.0-255,1484,87297,69,299709
13347,0.002043,74.125.24.0-255,4320,91617,69,299709
13348,0.002045,172.31.40.0-255,66,91683,69,299709
13349,0.002056,172.31.40.0-255,66,91749,69,299709
13350,0.002084,74.125.24.0-255,2902,94651,69,299709
13351,0.002086,172.31.40.0-255,66,94717,69,299709
13352,0.002117,172.31.40.0-255,66,94783,69,299709
13353,0.002121,74.125.24.0-255,2902,97685,69,299709
13354,0.002123,172.31.40.0-255,66,97751,69,299709
13355,0.002145,74.125.24.0-255,1484,99235,69,299709
13356,0.002152,74.125.24.0-255,5738,104973,69,299709
13357,0.002154,172.31.40.0-255,66,105039,69,299709
13358,0.002173,74.125.24.0-255,7156,112195,69,299709
13359,0.002176,172.31.40.0-255,66,112261,69,299709
13360,0.002194,74.125.24.0-255,4320,116581,69,299709
13361,0.002196,172.31.40.0-255,66,116647,69,299709
13362,0.002203,74.125.24.0-255,7156,123803,69,299709
13363,0.002206,172.31.40.0-255,66,123869,69,299709
13364,0.002255,172.31.40.0-255,66,123935,69,299709
13365,0.002267,172.31.40.0-255,66,124001,69,299709
13366,0.002286,74.125.24.0-255,4320,128321,69,299709
13367,0.002288,172.31.40.0-255,66,128387,69,299709
13368,0.002341,172.31.40.0-255,66,128453,69,299709
13369,0.002389,172.31.40.0-255,66,128519,69,299709
13370,0.00242,172.31.40.0-255,66,128585,69,299709
13371,0.002439,172.31.40.0-255,66,128651,69,299709
13372,0.004792,74.125.24.0-255,5738,134389,69,299709
13373,0.00481,172.31.40.0-255,66,134455,69,299709
13374,0.007185,74.125.24.0-255,5738,140193,69,299709
13375,0.007205,172.31.40.0-255,66,140259,69,299709
13376,0.009549,74.125.24.0-255,5738,145997,69,299709
13377,0.009569,172.31.40.0-255,66,146063,69,299709
13378,0.0119,74.125.24.0-255,5738,151801,69,299709
13379,0.011908,172.31.40.0-255,66,151867,69,299709
13380,0.014213,74.125.24.0-255,5738,157605,69,299709
13381,0.01422,172.31.40.0-255,66,157671,69,299709
13382,0.016561,74.125.24.0-255,5738,163409,69,299709
13383,0.016568,172.31.40.0-255,66,163475,69,299709
13384,0.018922,74.125.24.0-255,5738,169213,69,299709
13385,0.018931,172.31.40.0-255,66,169279,69,299709
13386,0.021286,74.125.24.0-255,5738,175017,69,299709
13387,0.021296,172.31.40.0-255,66,175083,69,299709
13388,0.02362,74.125.24.0-255,5738,180821,69,299709
13389,0.023627,172.31.40.0-255,66,180887,69,299709
13390,0.025958,74.125.24.0-255,5738,186625,69,299709
13391,0.025972,172.31.40.0-255,66,186691,69,299709
13392,0.028321,74.125.24.0-255,5738,192429,69,299709
13393,0.028331,172.31.40.0-255,66,192495,69,299709
13394,0.030643,74.125.24.0-255,5738,198233,69,299709
13395,0.03065,172.31.40.0-255,66,198299,69,299709
13396,0.033002,74.125.24.0-255,5738,204037,69,299709
13397,0.03301,172.31.40.0-255,66,204103,69,299709
13398,0.035331,74.125.24.0-255,5738,209841,69,299709
13399,0.035338,172.31.40.0-255,66,209907,69,299709
13400,0.036192,172.31.40.0-255,167,210074,69,299709
13401,0.036227,172.31.40.0-255,1111,211185,69,299709
13402,0.036341,172.31.40.0-255,1514,212699,69,299709
13403,0.036343,172.31.40.0-255,1514,214213,69,299709
13404,0.036344,172.31.40.0-255,1514,215727,69,299709
13405,0.036345,172.31.40.0-255,1514,217241,69,299709
13406,0.036346,172.31.40.0-255,546,217787,69,299709
13407,0.037709,74.125.24.0-255,5738,223525,69,299709
13408,0.037716,172.31.40.0-255,66,223591,69,299709
13409,0.037753,104.244.42.0-255,66,223657,69,299709
13410,0.037808,104.244.42.0-255,66,223723,69,299709
13411,0.037903,104.244.42.0-255,66,223789,69,299709
13412,0.037908,104.244.42.0-255,66,223855,69,299709
13413,0.040034,74.125.24.0-255,5738,229593,69,299709
13414,0.040041,172.31.40.0-255,66,229659,69,299709
13415,0.042422,74.125.24.0-255,5738,235397,69,299709
13416,0.04243,172.31.40.0-255,66,235463,69,299709
13417,0.044795,74.125.24.0-255,5738,241201,69,299709
13418,0.044801,172.31.40.0-255,66,241267,69,299709
13419,0.047181,74.125.24.0-255,5738,247005,69,299709
13420,0.047188,172.31.40.0-255,66,247071,69,299709
13421,0.049526,74.125.24.0-255,5738,252809,69,299709
13422,0.049533,172.31.40.0-255,66,252875,69,299709
13423,0.051875,74.125.24.0-255,5738,258613,69,299709
13424,0.051887,172.31.40.0-255,66,258679,69,299709
13425,0.054229,74.125.24.0-255,5738,264417,69,299709
13426,0.054235,172.31.40.0-255,66,264483,69,299709
13427,0.056564,74.125.24.0-255,5738,270221,69,299709
13428,0.056571,172.31.40.0-255,66,270287,69,299709
13429,0.058902,74.125.24.0-255,5738,276025,69,299709
13430,0.058908,172.31.40.0-255,66,276091,69,299709
13431,0.061244,74.125.24.0-255,5738,281829,69,299709
13432,0.061251,172.31.40.0-255,66,281895,69,299709
13433,0.063611,74.125.24.0-255,5738,287633,69,299709
13434,0.063618,172.31.40.0-255,66,287699,69,299709
13435,0.066011,74.125.24.0-255,5738,293437,69,299709
13436,0.066018,172.31.40.0-255,66,293503,69,299709
13437,0.068351,74.125.24.0-255,5738,299241,69,299709
13438,0.068357,172.31.40.0-255,66,299307,69,299709
13439,0.070668,74.125.24.0-255,165,299472,69,299709
13440,0.070809,172.31.40.0-255,66,299538,69,299709
13441,0.070846,172.31.40.0-255,105,299643,69,299709
13442,0.073153,74.125.24.0-255,66,299709,69,299709
13443,0.0,172.31.40.0-255,105,105,69,459
13444,0.000151,172.31.40.0-255,90,195,69,459
13445,0.00016,172.31.40.0-255,66,261,69,459
13446,0.002567,74.125.24.0-255,66,327,69,459
13447,0.002597,74.125.24.0-255,66,393,69,459
13448,0.002619,172.31.40.0-255,66,459,69,459
13449,0.0,172.217.194.0-255,149,149,69,172771
13450,2.2e-05,172.31.40.0-255,66,215,69,172771
13451,2.9e-05,172.217.194.0-255,1484,1699,69,172771
13452,3.3e-05,172.31.40.0-255,66,1765,69,172771
13453,3.9e-05,172.217.194.0-255,2902,4667,69,172771
13454,5.1e-05,172.31.40.0-255,66,4733,69,172771
13455,5.8e-05,172.217.194.0-255,7156,11889,69,172771
13456,6.2e-05,172.31.40.0-255,66,11955,69,172771
13457,9.5e-05,172.217.194.0-255,2099,14054,69,172771
13458,9.7e-05,172.31.40.0-255,66,14120,69,172771
13459,0.000504,172.217.194.0-255,1484,15604,69,172771
13460,0.00051,172.31.40.0-255,66,15670,69,172771
13461,0.000516,172.217.194.0-255,2902,18572,69,172771
13462,0.000519,172.31.40.0-255,66,18638,69,172771
13463,0.000531,172.217.194.0-255,5738,24376,69,172771
13464,0.000534,172.31.40.0-255,66,24442,69,172771
13465,0.00058,172.31.40.0-255,66,24508,69,172771
13466,0.000592,172.31.40.0-255,66,24574,69,172771
13467,0.000639,172.217.194.0-255,5738,30312,69,172771
13468,0.000642,172.31.40.0-255,66,30378,69,172771
13469,0.000683,172.31.40.0-255,66,30444,69,172771
13470,0.00098,172.217.194.0-255,646,31090,69,172771
13471,0.000987,172.31.40.0-255,66,31156,69,172771
13472,0.001105,172.217.194.0-255,1484,32640,69,172771
13473,0.001109,172.31.40.0-255,66,32706,69,172771
13474,0.001114,172.217.194.0-255,2902,35608,69,172771
13475,0.001117,172.31.40.0-255,66,35674,69,172771
13476,0.00112,172.217.194.0-255,1484,37158,69,172771
13477,0.001122,172.31.40.0-255,66,37224,69,172771
13478,0.001158,172.217.194.0-255,4320,41544,69,172771
13479,0.001166,172.217.194.0-255,7156,48700,69,172771
13480,0.001182,172.31.40.0-255,66,48766,69,172771
13481,0.001189,172.217.194.0-255,5738,54504,69,172771
13482,0.001195,172.217.194.0-255,5738,60242,69,172771
13483,0.001215,172.217.194.0-255,2902,63144,69,172771
13484,0.001219,172.217.194.0-255,2184,65328,69,172771
13485,0.001222,172.31.40.0-255,66,65394,69,172771
13486,0.001249,172.31.40.0-255,66,65460,69,172771
13487,0.001526,172.217.194.0-255,1484,66944,69,172771
13488,0.001533,172.217.194.0-255,2902,69846,69,172771
13489,0.001537,172.31.40.0-255,66,69912,69,172771
13490,0.001542,172.217.194.0-255,2902,72814,69,172771
13491,0.001548,172.31.40.0-255,66,72880,69,172771
13492,0.001567,172.217.194.0-255,2902,75782,69,172771
13493,0.001591,172.217.194.0-255,7156,82938,69,172771
13494,0.001596,172.31.40.0-255,66,83004,69,172771
13495,0.001607,172.217.194.0-255,1484,84488,69,172771
13496,0.001649,172.217.194.0-255,2184,86672,69,172771
13497,0.001665,172.31.40.0-255,66,86738,69,172771
13498,0.001891,172.217.194.0-255,1484,88222,69,172771
13499,0.00191,172.217.194.0-255,2902,91124,69,172771
13500,0.001914,172.31.40.0-255,66,91190,69,172771
13501,0.001921,172.217.194.0-255,5738,96928,69,172771
13502,0.001944,172.217.194.0-255,5738,102666,69,172771
13503,0.001956,172.31.40.0-255,66,102732,69,172771
13504,0.001964,172.217.194.0-255,7156,109888,69,172771
13505,0.001966,172.217.194.0-255,1484,111372,69,172771
13506,0.001978,172.217.194.0-255,5738,117110,69,172771
13507,0.001984,172.31.40.0-255,66,117176,69,172771
13508,0.00204,172.217.194.0-255,1484,118660,69,172771
13509,0.002045,172.31.40.0-255,66,118726,69,172771
13510,0.002057,172.217.194.0-255,5738,124464,69,172771
13511,0.002064,172.31.40.0-255,66,124530,69,172771
13512,0.002101,172.217.194.0-255,6438,130968,69,172771
13513,0.00211,172.217.194.0-255,7156,138124,69,172771
13514,0.002112,172.217.194.0-255,1484,139608,69,172771
13515,0.002116,172.31.40.0-255,78,139686,69,172771
13516,0.002176,172.217.194.0-255,4320,144006,69,172771
13517,0.002183,172.31.40.0-255,66,144072,69,172771
13518,0.002298,172.217.194.0-255,7156,151228,69,172771
13519,0.002334,172.217.194.0-255,1484,152712,69,172771
13520,0.002376,172.217.194.0-255,7156,159868,69,172771
13521,0.002415,172.217.194.0-255,4320,164188,69,172771
13522,0.002448,172.217.194.0-255,97,164285,69,172771
13523,0.002497,172.217.194.0-255,105,164390,69,172771
13524,0.012103,172.31.40.0-255,66,164456,69,172771
13525,0.014469,172.31.40.0-255,105,164561,69,172771
13526,0.016437,172.217.194.0-255,66,164627,69,172771
13527,0.056292,172.31.40.0-255,167,164794,69,172771
13528,0.056342,172.31.40.0-255,1111,165905,69,172771
13529,0.056461,172.31.40.0-255,1514,167419,69,172771
13530,0.056463,172.31.40.0-255,1514,168933,69,172771
13531,0.056464,172.31.40.0-255,1514,170447,69,172771
13532,0.056465,172.31.40.0-255,1514,171961,69,172771
13533,0.056466,172.31.40.0-255,546,172507,69,172771
13534,0.05788,104.244.42.0-255,66,172573,69,172771
13535,0.057969,104.244.42.0-255,66,172639,69,172771
13536,0.05806,104.244.42.0-255,66,172705,69,172771
13537,0.058065,104.244.42.0-255,66,172771,69,172771
13538,0.0,74.125.24.0-255,298,298,69,330698
13539,1.6e-05,172.31.40.0-255,66,364,69,330698
13540,2.2e-05,74.125.24.0-255,1484,1848,69,330698
13541,2.7e-05,172.31.40.0-255,66,1914,69,330698
13542,3.4e-05,74.125.24.0-255,4320,6234,69,330698
13543,3.7e-05,172.31.40.0-255,66,6300,69,330698
13544,6.2e-05,74.125.24.0-255,4320,10620,69,330698
13545,6.5e-05,172.31.40.0-255,66,10686,69,330698
13546,8.6e-05,74.125.24.0-255,3257,13943,69,330698
13547,8.9e-05,172.31.40.0-255,66,14009,69,330698
13548,0.0001,74.125.24.0-255,1484,15493,69,330698
13549,0.000103,172.31.40.0-255,66,15559,69,330698
13550,0.000127,74.125.24.0-255,2902,18461,69,330698
13551,0.00013,172.31.40.0-255,66,18527,69,330698
13552,0.000136,74.125.24.0-255,5738,24265,69,330698
13553,0.000139,172.31.40.0-255,66,24331,69,330698
13554,0.000161,74.125.24.0-255,2902,27233,69,330698
13555,0.000164,172.31.40.0-255,66,27299,69,330698
13556,0.000176,74.125.24.0-255,3961,31260,69,330698
13557,0.000179,172.31.40.0-255,66,31326,69,330698
13558,0.00083,74.125.24.0-255,1484,32810,69,330698
13559,0.000837,172.31.40.0-255,66,32876,69,330698
13560,0.000845,74.125.24.0-255,2902,35778,69,330698
13561,0.000848,172.31.40.0-255,66,35844,69,330698
13562,0.000855,74.125.24.0-255,5738,41582,69,330698
13563,0.000857,172.31.40.0-255,66,41648,69,330698
13564,0.00089,74.125.24.0-255,6797,48445,69,330698
13565,0.000893,172.31.40.0-255,66,48511,69,330698
13566,0.000901,74.125.24.0-255,7156,55667,69,330698
13567,0.000903,172.31.40.0-255,66,55733,69,330698
13568,0.000946,172.31.40.0-255,66,55799,69,330698
13569,0.000978,74.125.24.0-255,342,56141,69,330698
13570,0.001066,74.125.24.0-255,1484,57625,69,330698
13571,0.001072,172.31.40.0-255,66,57691,69,330698
13572,0.001078,74.125.24.0-255,2902,60593,69,330698
13573,0.001081,172.31.40.0-255,66,60659,69,330698
13574,0.001086,74.125.24.0-255,4320,64979,69,330698
13575,0.001088,172.31.40.0-255,66,65045,69,330698
13576,0.001106,74.125.24.0-255,1484,66529,69,330698
13577,0.001122,74.125.24.0-255,2902,69431,69,330698
13578,0.001125,172.31.40.0-255,66,69497,69,330698
13579,0.001146,74.125.24.0-255,3961,73458,69,330698
13580,0.001149,172.31.40.0-255,66,73524,69,330698
13581,0.00119,74.125.24.0-255,1484,75008,69,330698
13582,0.001231,74.125.24.0-255,2902,77910,69,330698
13583,0.001235,172.31.40.0-255,66,77976,69,330698
13584,0.001238,74.125.24.0-255,1484,79460,69,330698
13585,0.001263,74.125.24.0-255,1484,80944,69,330698
13586,0.001265,172.31.40.0-255,66,81010,69,330698
13587,0.001274,74.125.24.0-255,7156,88166,69,330698
13588,0.001277,172.31.40.0-255,66,88232,69,330698
13589,0.001281,74.125.24.0-255,2543,90775,69,330698
13590,0.001284,172.31.40.0-255,66,90841,69,330698
13591,0.001417,74.125.24.0-255,1484,92325,69,330698
13592,0.001424,74.125.24.0-255,2902,95227,69,330698
13593,0.001428,172.31.40.0-255,66,95293,69,330698
13594,0.001451,74.125.24.0-255,5738,101031,69,330698
13595,0.001454,172.31.40.0-255,66,101097,69,330698
13596,0.001478,74.125.24.0-255,4320,105417,69,330698
13597,0.001481,172.31.40.0-255,66,105483,69,330698
13598,0.001508,172.31.40.0-255,66,105549,69,330698
13599,0.00153,74.125.24.0-255,4320,109869,69,330698
13600,0.001532,172.31.40.0-255,66,109935,69,330698
13601,0.001553,74.125.24.0-255,6438,116373,69,330698
13602,0.001557,172.31.40.0-255,66,116439,69,330698
13603,0.003949,74.125.24.0-255,5738,122177,69,330698
13604,0.003958,172.31.40.0-255,66,122243,69,330698
13605,0.006339,74.125.24.0-255,5738,127981,69,330698
13606,0.006348,172.31.40.0-255,66,128047,69,330698
13607,0.008763,74.125.24.0-255,5738,133785,69,330698
13608,0.008771,172.31.40.0-255,66,133851,69,330698
13609,0.01119,74.125.24.0-255,5738,139589,69,330698
13610,0.011198,172.31.40.0-255,66,139655,69,330698
13611,0.01362,74.125.24.0-255,5738,145393,69,330698
13612,0.013629,172.31.40.0-255,66,145459,69,330698
13613,0.016062,74.125.24.0-255,2902,148361,69,330698
13614,0.016073,172.31.40.0-255,66,148427,69,330698
13615,0.016096,74.125.24.0-255,2902,151329,69,330698
13616,0.016099,172.31.40.0-255,66,151395,69,330698
13617,0.018511,74.125.24.0-255,5738,157133,69,330698
13618,0.018519,172.31.40.0-255,66,157199,69,330698
13619,0.020916,74.125.24.0-255,5738,162937,69,330698
13620,0.020924,172.31.40.0-255,66,163003,69,330698
13621,0.023317,74.125.24.0-255,5738,168741,69,330698
13622,0.023324,172.31.40.0-255,66,168807,69,330698
13623,0.025733,74.125.24.0-255,5738,174545,69,330698
13624,0.025741,172.31.40.0-255,66,174611,69,330698
13625,0.028143,74.125.24.0-255,5738,180349,69,330698
13626,0.028151,172.31.40.0-255,66,180415,69,330698
13627,0.029551,172.31.40.0-255,172,180587,69,330698
13628,0.029584,172.31.40.0-255,1116,181703,69,330698
13629,0.029658,172.31.40.0-255,1514,183217,69,330698
13630,0.02966,172.31.40.0-255,1514,184731,69,330698
13631,0.029666,172.31.40.0-255,1514,186245,69,330698
13632,0.029667,172.31.40.0-255,1514,187759,69,330698
13633,0.029697,172.31.40.0-255,1499,189258,69,330698
13634,0.030613,74.125.24.0-255,5738,194996,69,330698
13635,0.03062,172.31.40.0-255,66,195062,69,330698
13636,0.031243,104.244.42.0-255,66,195128,69,330698
13637,0.031285,104.244.42.0-255,66,195194,69,330698
13638,0.031354,104.244.42.0-255,66,195260,69,330698
13639,0.031393,104.244.42.0-255,66,195326,69,330698
13640,0.033054,74.125.24.0-255,4320,199646,69,330698
13641,0.033061,172.31.40.0-255,66,199712,69,330698
13642,0.03308,74.125.24.0-255,1484,201196,69,330698
13643,0.035469,74.125.24.0-255,4320,205516,69,330698
13644,0.035476,172.31.40.0-255,66,205582,69,330698
13645,0.037886,74.125.24.0-255,5738,211320,69,330698
13646,0.037893,172.31.40.0-255,66,211386,69,330698
13647,0.040295,74.125.24.0-255,5738,217124,69,330698
13648,0.040302,172.31.40.0-255,66,217190,69,330698
13649,0.042726,74.125.24.0-255,5738,222928,69,330698
13650,0.042733,172.31.40.0-255,66,222994,69,330698
13651,0.04516,74.125.24.0-255,5738,228732,69,330698
13652,0.045166,172.31.40.0-255,66,228798,69,330698
13653,0.047584,74.125.24.0-255,5738,234536,69,330698
13654,0.047591,172.31.40.0-255,66,234602,69,330698
13655,0.050005,74.125.24.0-255,5738,240340,69,330698
13656,0.050012,172.31.40.0-255,66,240406,69,330698
13657,0.052412,74.125.24.0-255,5738,246144,69,330698
13658,0.052418,172.31.40.0-255,66,246210,69,330698
13659,0.054828,74.125.24.0-255,5738,251948,69,330698
13660,0.054834,172.31.40.0-255,66,252014,69,330698
13661,0.057251,74.125.24.0-255,5738,257752,69,330698
13662,0.057259,172.31.40.0-255,66,257818,69,330698
13663,0.059658,74.125.24.0-255,5738,263556,69,330698
13664,0.059665,172.31.40.0-255,66,263622,69,330698
13665,0.062083,74.125.24.0-255,2902,266524,69,330698
13666,0.06209,172.31.40.0-255,66,266590,69,330698
13667,0.062111,74.125.24.0-255,2902,269492,69,330698
13668,0.062114,172.31.40.0-255,66,269558,69,330698
13669,0.064506,74.125.24.0-255,4320,273878,69,330698
13670,0.064511,172.31.40.0-255,66,273944,69,330698
13671,0.064527,74.125.24.0-255,1484,275428,69,330698
13672,0.066943,74.125.24.0-255,4320,279748,69,330698
13673,0.066949,172.31.40.0-255,66,279814,69,330698
13674,0.069362,74.125.24.0-255,5738,285552,69,330698
13675,0.069368,172.31.40.0-255,66,285618,69,330698
13676,0.071777,74.125.24.0-255,5738,291356,69,330698
13677,0.071783,172.31.40.0-255,66,291422,69,330698
13678,0.074194,74.125.24.0-255,5738,297160,69,330698
13679,0.074201,172.31.40.0-255,66,297226,69,330698
13680,0.076705,74.125.24.0-255,5738,302964,69,330698
13681,0.076712,172.31.40.0-255,66,303030,69,330698
13682,0.079124,74.125.24.0-255,4320,307350,69,330698
13683,0.079131,172.31.40.0-255,66,307416,69,330698
13684,0.079148,74.125.24.0-255,1484,308900,69,330698
13685,0.081544,74.125.24.0-255,4320,313220,69,330698
13686,0.081551,172.31.40.0-255,66,313286,69,330698
13687,0.083955,74.125.24.0-255,5738,319024,69,330698
13688,0.083961,172.31.40.0-255,66,319090,69,330698
13689,0.086367,74.125.24.0-255,5738,324828,69,330698
13690,0.086373,172.31.40.0-255,66,324894,69,330698
13691,0.088782,74.125.24.0-255,5738,330632,69,330698
13692,0.088788,172.31.40.0-255,66,330698,69,330698
13693,0.0,172.217.194.0-255,153,153,69,300959
13694,1.3e-05,172.31.40.0-255,66,219,69,300959
13695,2.1e-05,172.217.194.0-255,1484,1703,69,300959
13696,2.6e-05,172.31.40.0-255,66,1769,69,300959
13697,3.2e-05,172.217.194.0-255,2902,4671,69,300959
13698,3.6e-05,172.31.40.0-255,66,4737,69,300959
13699,4.2e-05,172.217.194.0-255,4320,9057,69,300959
13700,4.4e-05,172.31.40.0-255,66,9123,69,300959
13701,6.3e-05,172.217.194.0-255,2902,12025,69,300959
13702,6.6e-05,172.31.40.0-255,66,12091,69,300959
13703,0.000104,172.217.194.0-255,3507,15598,69,300959
13704,0.000107,172.31.40.0-255,66,15664,69,300959
13705,0.000111,172.217.194.0-255,2902,18566,69,300959
13706,0.000113,172.31.40.0-255,66,18632,69,300959
13707,0.000126,172.217.194.0-255,1484,20116,69,300959
13708,0.000128,172.31.40.0-255,66,20182,69,300959
13709,0.00015,172.217.194.0-255,7156,27338,69,300959
13710,0.000152,172.31.40.0-255,66,27404,69,300959
13711,0.000173,172.217.194.0-255,2902,30306,69,300959
13712,0.000176,172.31.40.0-255,66,30372,69,300959
13713,0.000179,172.217.194.0-255,1125,31497,69,300959
13714,0.000181,172.31.40.0-255,66,31563,69,300959
13715,0.000195,172.217.194.0-255,1484,33047,69,300959
13716,0.000197,172.31.40.0-255,66,33113,69,300959
13717,0.000215,172.217.194.0-255,2902,36015,69,300959
13718,0.000218,172.31.40.0-255,66,36081,69,300959
13719,0.000224,172.217.194.0-255,4320,40401,69,300959
13720,0.000226,172.31.40.0-255,66,40467,69,300959
13721,0.00024,172.217.194.0-255,1484,41951,69,300959
13722,0.000243,172.31.40.0-255,66,42017,69,300959
13723,0.00028,172.31.40.0-255,66,42083,69,300959
13724,0.000292,172.31.40.0-255,66,42149,69,300959
13725,0.000297,172.217.194.0-255,3961,46110,69,300959
13726,0.0003,172.31.40.0-255,66,46176,69,300959
13727,0.00034,172.217.194.0-255,346,46522,69,300959
13728,0.000393,172.217.194.0-255,119,46641,69,300959
13729,0.000436,172.217.194.0-255,376,47017,69,300959
13730,0.000639,172.217.194.0-255,1484,48501,69,300959
13731,0.000644,172.31.40.0-255,66,48567,69,300959
13732,0.00065,172.217.194.0-255,2902,51469,69,300959
13733,0.000653,172.31.40.0-255,66,51535,69,300959
13734,0.000657,172.217.194.0-255,2902,54437,69,300959
13735,0.000659,172.31.40.0-255,66,54503,69,300959
13736,0.000694,172.217.194.0-255,2902,57405,69,300959
13737,0.000697,172.31.40.0-255,66,57471,69,300959
13738,0.000712,172.31.40.0-255,66,57537,69,300959
13739,0.000717,172.217.194.0-255,2902,60439,69,300959
13740,0.000719,172.31.40.0-255,66,60505,69,300959
13741,0.000758,172.31.40.0-255,66,60571,69,300959
13742,0.000991,172.217.194.0-255,1484,62055,69,300959
13743,0.000998,172.217.194.0-255,2902,64957,69,300959
13744,0.001001,172.31.40.0-255,66,65023,69,300959
13745,0.001008,172.217.194.0-255,5738,70761,69,300959
13746,0.001011,172.31.40.0-255,66,70827,69,300959
13747,0.001038,172.217.194.0-255,5738,76565,69,300959
13748,0.001041,172.31.40.0-255,66,76631,69,300959
13749,0.001066,172.217.194.0-255,7156,83787,69,300959
13750,0.001069,172.31.40.0-255,66,83853,69,300959
13751,0.001081,172.31.40.0-255,66,83919,69,300959
13752,0.001137,172.217.194.0-255,1484,85403,69,300959
13753,0.001143,172.217.194.0-255,2902,88305,69,300959
13754,0.001153,172.31.40.0-255,66,88371,69,300959
13755,0.001167,172.217.194.0-255,4320,92691,69,300959
13756,0.001177,172.217.194.0-255,1484,94175,69,300959
13757,0.001183,172.217.194.0-255,5738,99913,69,300959
13758,0.001195,172.31.40.0-255,66,99979,69,300959
13759,0.001207,172.217.194.0-255,7156,107135,69,300959
13760,0.001222,172.31.40.0-255,66,107201,69,300959
13761,0.001254,172.217.194.0-255,4320,111521,69,300959
13762,0.001269,172.31.40.0-255,66,111587,69,300959
13763,0.001281,172.217.194.0-255,7156,118743,69,300959
13764,0.001288,172.217.194.0-255,5738,124481,69,300959
13765,0.001297,172.31.40.0-255,66,124547,69,300959
13766,0.00135,172.217.194.0-255,6438,130985,69,300959
13767,0.001353,172.31.40.0-255,66,131051,69,300959
13768,0.001398,172.217.194.0-255,5738,136789,69,300959
13769,0.001403,172.31.40.0-255,66,136855,69,300959
13770,0.001428,172.217.194.0-255,5738,142593,69,300959
13771,0.001435,172.217.194.0-255,5738,148331,69,300959
13772,0.001451,172.217.194.0-255,5020,153351,69,300959
13773,0.001465,172.31.40.0-255,66,153417,69,300959
13774,0.001623,172.217.194.0-255,1484,154901,69,300959
13775,0.001628,172.217.194.0-255,2902,157803,69,300959
13776,0.00166,172.217.194.0-255,5738,163541,69,300959
13777,0.001675,172.217.194.0-255,2902,166443,69,300959
13778,0.001679,172.31.40.0-255,66,166509,69,300959
13779,0.001689,172.31.40.0-255,66,166575,69,300959
13780,0.001733,172.217.194.0-255,2902,169477,69,300959
13781,0.001738,172.31.40.0-255,66,169543,69,300959
13782,0.001765,172.31.40.0-255,66,169609,69,300959
13783,0.002471,172.217.194.0-255,1484,171093,69,300959
13784,0.002489,172.217.194.0-255,2902,173995,69,300959
13785,0.002493,172.31.40.0-255,66,174061,69,300959
13786,0.0025,172.217.194.0-255,5738,179799,69,300959
13787,0.002511,172.217.194.0-255,1484,181283,69,300959
13788,0.002535,172.31.40.0-255,66,181349,69,300959
13789,0.002572,172.217.194.0-255,1484,182833,69,300959
13790,0.002618,172.31.40.0-255,66,182899,69,300959
13791,0.005243,172.217.194.0-255,5738,188637,69,300959
13792,0.00525,172.31.40.0-255,66,188703,69,300959
13793,0.007877,172.217.194.0-255,5738,194441,69,300959
13794,0.007884,172.31.40.0-255,66,194507,69,300959
13795,0.010511,172.217.194.0-255,5738,200245,69,300959
13796,0.010517,172.31.40.0-255,66,200311,69,300959
13797,0.013139,172.217.194.0-255,5738,206049,69,300959
13798,0.013147,172.31.40.0-255,66,206115,69,300959
13799,0.015825,172.217.194.0-255,5738,211853,69,300959
13800,0.015834,172.31.40.0-255,66,211919,69,300959
13801,0.018451,172.217.194.0-255,5738,217657,69,300959
13802,0.01846,172.31.40.0-255,66,217723,69,300959
13803,0.021112,172.217.194.0-255,5738,223461,69,300959
13804,0.02112,172.31.40.0-255,66,223527,69,300959
13805,0.023758,172.217.194.0-255,5738,229265,69,300959
13806,0.023765,172.31.40.0-255,66,229331,69,300959
13807,0.0264,172.217.194.0-255,5738,235069,69,300959
13808,0.02641,172.31.40.0-255,66,235135,69,300959
13809,0.029038,172.217.194.0-255,4320,239455,69,300959
13810,0.029046,172.31.40.0-255,66,239521,69,300959
13811,0.029066,172.217.194.0-255,1484,241005,69,300959
13812,0.031703,172.217.194.0-255,4320,245325,69,300959
13813,0.03171,172.31.40.0-255,66,245391,69,300959
13814,0.0341,172.31.40.0-255,172,245563,69,300959
13815,0.034133,172.31.40.0-255,1116,246679,69,300959
13816,0.034191,172.31.40.0-255,560,247239,69,300959
13817,0.034373,172.217.194.0-255,5738,252977,69,300959
13818,0.034379,172.31.40.0-255,66,253043,69,300959
13819,0.03569,104.244.42.0-255,66,253109,69,300959
13820,0.035723,104.244.42.0-255,66,253175,69,300959
13821,0.035775,104.244.42.0-255,66,253241,69,300959
13822,0.037011,172.217.194.0-255,5738,258979,69,300959
13823,0.037018,172.31.40.0-255,66,259045,69,300959
13824,0.039655,172.217.194.0-255,5738,264783,69,300959
13825,0.039662,172.31.40.0-255,66,264849,69,300959
13826,0.042298,172.217.194.0-255,5738,270587,69,300959
13827,0.042304,172.31.40.0-255,66,270653,69,300959
13828,0.044977,172.217.194.0-255,5738,276391,69,300959
13829,0.044986,172.31.40.0-255,66,276457,69,300959
13830,0.04763,172.217.194.0-255,5738,282195,69,300959
13831,0.047636,172.31.40.0-255,66,282261,69,300959
13832,0.05027,172.217.194.0-255,5738,287999,69,300959
13833,0.050277,172.31.40.0-255,66,288065,69,300959
13834,0.052928,172.217.194.0-255,5738,293803,69,300959
13835,0.052936,172.31.40.0-255,66,293869,69,300959
13836,0.05556,172.217.194.0-255,5738,299607,69,300959
13837,0.055566,172.31.40.0-255,66,299673,69,300959
13838,0.058196,172.217.194.0-255,1049,300722,69,300959
13839,0.058338,172.31.40.0-255,66,300788,69,300959
13840,0.058379,172.31.40.0-255,105,300893,69,300959
13841,0.060975,172.217.194.0-255,66,300959,69,300959
13842,0.0,74.125.24.0-255,154,154,69,191545
13843,2.2e-05,172.31.40.0-255,66,220,69,191545
13844,2.9e-05,74.125.24.0-255,1484,1704,69,191545
13845,3.4e-05,172.31.40.0-255,66,1770,69,191545
13846,4e-05,74.125.24.0-255,2902,4672,69,191545
13847,4.4e-05,172.31.40.0-255,66,4738,69,191545
13848,5.1e-05,74.125.24.0-255,7156,11894,69,191545
13849,5.5e-05,172.31.40.0-255,66,11960,69,191545
13850,5.8e-05,74.125.24.0-255,1484,13444,69,191545
13851,6e-05,172.31.40.0-255,66,13510,69,191545
13852,0.000108,172.31.40.0-255,66,13576,69,191545
13853,0.000113,74.125.24.0-255,2543,16119,69,191545
13854,0.000114,172.31.40.0-255,66,16185,69,191545
13855,0.000259,74.125.24.0-255,1484,17669,69,191545
13856,0.000263,172.31.40.0-255,66,17735,69,191545
13857,0.000269,74.125.24.0-255,2902,20637,69,191545
13858,0.000271,172.31.40.0-255,66,20703,69,191545
13859,0.000274,74.125.24.0-255,1484,22187,69,191545
13860,0.000276,172.31.40.0-255,66,22253,69,191545
13861,0.000298,74.125.24.0-255,4320,26573,69,191545
13862,0.0003,172.31.40.0-255,66,26639,69,191545
13863,0.000304,74.125.24.0-255,2902,29541,69,191545
13864,0.000307,172.31.40.0-255,66,29607,69,191545
13865,0.000324,74.125.24.0-255,3961,33568,69,191545
13866,0.000326,172.31.40.0-255,66,33634,69,191545
13867,0.000343,74.125.24.0-255,1484,35118,69,191545
13868,0.000345,172.31.40.0-255,66,35184,69,191545
13869,0.000369,74.125.24.0-255,5738,40922,69,191545
13870,0.000371,172.31.40.0-255,66,40988,69,191545
13871,0.000376,74.125.24.0-255,2902,43890,69,191545
13872,0.000377,172.31.40.0-255,66,43956,69,191545
13873,0.000402,74.125.24.0-255,1484,45440,69,191545
13874,0.000417,74.125.24.0-255,5675,51115,69,191545
13875,0.00042,172.31.40.0-255,66,51181,69,191545
13876,0.000436,74.125.24.0-255,414,51595,69,191545
13877,0.000779,74.125.24.0-255,1484,53079,69,191545
13878,0.000784,172.31.40.0-255,66,53145,69,191545
13879,0.00079,74.125.24.0-255,2902,56047,69,191545
13880,0.000792,172.31.40.0-255,66,56113,69,191545
13881,0.000797,74.125.24.0-255,2902,59015,69,191545
13882,0.000799,172.31.40.0-255,66,59081,69,191545
13883,0.000821,74.125.24.0-255,2902,61983,69,191545
13884,0.000823,172.31.40.0-255,66,62049,69,191545
13885,0.000839,172.31.40.0-255,66,62115,69,191545
13886,0.00088,172.31.40.0-255,66,62181,69,191545
13887,0.000899,74.125.24.0-255,4320,66501,69,191545
13888,0.000901,172.31.40.0-255,66,66567,69,191545
13889,0.000909,74.125.24.0-255,5738,72305,69,191545
13890,0.000911,172.31.40.0-255,66,72371,69,191545
13891,0.000954,172.31.40.0-255,66,72437,69,191545
13892,0.000966,172.31.40.0-255,66,72503,69,191545
13893,0.000978,74.125.24.0-255,766,73269,69,191545
13894,0.000985,74.125.24.0-255,4320,77589,69,191545
13895,0.000987,172.31.40.0-255,66,77655,69,191545
13896,0.001023,172.31.40.0-255,66,77721,69,191545
13897,0.00104,172.31.40.0-255,66,77787,69,191545
13898,0.001076,74.125.24.0-255,5020,82807,69,191545
13899,0.00108,172.31.40.0-255,66,82873,69,191545
13900,0.001083,74.125.24.0-255,1484,84357,69,191545
13901,0.001087,74.125.24.0-255,2902,87259,69,191545
13902,0.001089,172.31.40.0-255,66,87325,69,191545
13903,0.001095,74.125.24.0-255,5738,93063,69,191545
13904,0.001098,172.31.40.0-255,66,93129,69,191545
13905,0.001174,172.31.40.0-255,66,93195,69,191545
13906,0.001191,74.125.24.0-255,1484,94679,69,191545
13907,0.001195,74.125.24.0-255,2902,97581,69,191545
13908,0.001201,74.125.24.0-255,5738,103319,69,191545
13909,0.00124,74.125.24.0-255,766,104085,69,191545
13910,0.001247,172.31.40.0-255,66,104151,69,191545
13911,0.001502,74.125.24.0-255,1484,105635,69,191545
13912,0.001508,74.125.24.0-255,2902,108537,69,191545
13913,0.001512,172.31.40.0-255,66,108603,69,191545
13914,0.001517,74.125.24.0-255,4320,112923,69,191545
13915,0.001527,172.31.40.0-255,66,112989,69,191545
13916,0.001537,74.125.24.0-255,1484,114473,69,191545
13917,0.001556,172.31.40.0-255,66,114539,69,191545
13918,0.001578,74.125.24.0-255,2902,117441,69,191545
13919,0.001597,172.31.40.0-255,66,117507,69,191545
13920,0.001903,74.125.24.0-255,1484,118991,69,191545
13921,0.001908,74.125.24.0-255,1484,120475,69,191545
13922,0.001911,172.31.40.0-255,66,120541,69,191545
13923,0.001934,74.125.24.0-255,1484,122025,69,191545
13924,0.001941,74.125.24.0-255,5738,127763,69,191545
13925,0.001945,74.125.24.0-255,2902,130665,69,191545
13926,0.001951,172.31.40.0-255,66,130731,69,191545
13927,0.002013,74.125.24.0-255,2184,132915,69,191545
13928,0.002028,172.31.40.0-255,66,132981,69,191545
13929,0.002207,74.125.24.0-255,1484,134465,69,191545
13930,0.002212,74.125.24.0-255,2902,137367,69,191545
13931,0.002215,172.31.40.0-255,66,137433,69,191545
13932,0.002219,74.125.24.0-255,1484,138917,69,191545
13933,0.00225,74.125.24.0-255,4320,143237,69,191545
13934,0.002265,74.125.24.0-255,1484,144721,69,191545
13935,0.002273,172.31.40.0-255,66,144787,69,191545
13936,0.002298,74.125.24.0-255,5738,150525,69,191545
13937,0.00232,74.125.24.0-255,5738,156263,69,191545
13938,0.002337,172.31.40.0-255,66,156329,69,191545
13939,0.002349,74.125.24.0-255,4320,160649,69,191545
13940,0.002363,74.125.24.0-255,4320,164969,69,191545
13941,0.002374,172.31.40.0-255,66,165035,69,191545
13942,0.002443,74.125.24.0-255,4320,169355,69,191545
13943,0.002471,172.31.40.0-255,66,169421,69,191545
13944,0.004873,74.125.24.0-255,5738,175159,69,191545
13945,0.004888,172.31.40.0-255,66,175225,69,191545
13946,0.007291,74.125.24.0-255,5738,180963,69,191545
13947,0.012333,172.31.40.0-255,66,181029,69,191545
13948,0.014715,74.125.24.0-255,1960,182989,69,191545
13949,0.014723,172.31.40.0-255,66,183055,69,191545
13950,0.01718,172.31.40.0-255,105,183160,69,191545
13951,0.019517,74.125.24.0-255,66,183226,69,191545
13952,0.037796,172.31.40.0-255,167,183393,69,191545
13953,0.037829,172.31.40.0-255,1111,184504,69,191545
13954,0.037881,172.31.40.0-255,1514,186018,69,191545
13955,0.037883,172.31.40.0-255,1514,187532,69,191545
13956,0.037884,172.31.40.0-255,1514,189046,69,191545
13957,0.037885,172.31.40.0-255,1514,190560,69,191545
13958,0.037886,172.31.40.0-255,547,191107,69,191545
13959,0.039321,104.244.42.0-255,66,191173,69,191545
13960,0.039474,104.244.42.0-255,66,191239,69,191545
13961,0.039477,104.244.42.0-255,66,191305,69,191545
13962,0.039481,104.244.42.0-255,66,191371,69,191545
13963,0.040198,104.244.42.0-255,108,191479,69,191545
13964,0.040208,172.31.40.0-255,66,191545,69,191545
13965,0.0,74.125.24.0-255,156,156,69,169536
13966,3.6e-05,172.31.40.0-255,66,222,69,169536
13967,4.3e-05,74.125.24.0-255,1484,1706,69,169536
13968,4.8e-05,172.31.40.0-255,66,1772,69,169536
13969,5.3e-05,74.125.24.0-255,2902,4674,69,169536
13970,6.3e-05,172.31.40.0-255,66,4740,69,169536
13971,7.1e-05,74.125.24.0-255,7156,11896,69,169536
13972,7.4e-05,172.31.40.0-255,66,11962,69,169536
13973,8e-05,74.125.24.0-255,4320,16282,69,169536
13974,8.3e-05,172.31.40.0-255,66,16348,69,169536
13975,0.000133,172.31.40.0-255,66,16414,69,169536
13976,0.000138,74.125.24.0-255,3961,20375,69,169536
13977,0.000141,172.31.40.0-255,66,20441,69,169536
13978,0.000176,74.125.24.0-255,1484,21925,69,169536
13979,0.000179,172.31.40.0-255,66,21991,69,169536
13980,0.000186,74.125.24.0-255,2902,24893,69,169536
13981,0.000188,172.31.40.0-255,66,24959,69,169536
13982,0.000222,74.125.24.0-255,5738,30697,69,169536
13983,0.000226,172.31.40.0-255,66,30763,69,169536
13984,0.000229,74.125.24.0-255,1484,32247,69,169536
13985,0.000232,172.31.40.0-255,66,32313,69,169536
13986,0.000269,172.31.40.0-255,66,32379,69,169536
13987,0.000283,172.31.40.0-255,66,32445,69,169536
13988,0.000313,74.125.24.0-255,1736,34181,69,169536
13989,0.000316,172.31.40.0-255,66,34247,69,169536
13990,0.000396,74.125.24.0-255,1484,35731,69,169536
13991,0.000399,172.31.40.0-255,66,35797,69,169536
13992,0.000405,74.125.24.0-255,2902,38699,69,169536
13993,0.000408,172.31.40.0-255,66,38765,69,169536
13994,0.000411,74.125.24.0-255,1484,40249,69,169536
13995,0.000431,74.125.24.0-255,4320,44569,69,169536
13996,0.000438,172.31.40.0-255,66,44635,69,169536
13997,0.000443,74.125.24.0-255,2902,47537,69,169536
13998,0.000446,172.31.40.0-255,66,47603,69,169536
13999,0.000494,172.31.40.0-255,66,47669,69,169536
14000,0.000506,172.31.40.0-255,66,47735,69,169536
14001,0.000975,74.125.24.0-255,1484,49219,69,169536
14002,0.000981,74.125.24.0-255,2902,52121,69,169536
14003,0.000985,172.31.40.0-255,66,52187,69,169536
14004,0.000991,74.125.24.0-255,4320,56507,69,169536
14005,0.000993,172.31.40.0-255,66,56573,69,169536
14006,0.001022,74.125.24.0-255,1484,58057,69,169536
14007,0.001035,172.31.40.0-255,66,58123,69,169536
14008,0.001052,74.125.24.0-255,2902,61025,69,169536
14009,0.001054,172.31.40.0-255,66,61091,69,169536
14010,0.001072,172.31.40.0-255,66,61157,69,169536
14011,0.001101,74.125.24.0-255,1484,62641,69,169536
14012,0.001105,74.125.24.0-255,2902,65543,69,169536
14013,0.001108,172.31.40.0-255,66,65609,69,169536
14014,0.001116,74.125.24.0-255,5738,71347,69,169536
14015,0.001118,172.31.40.0-255,66,71413,69,169536
14016,0.001146,74.125.24.0-255,5738,77151,69,169536
14017,0.001149,172.31.40.0-255,66,77217,69,169536
14018,0.001186,74.125.24.0-255,7156,84373,69,169536
14019,0.001189,172.31.40.0-255,66,84439,69,169536
14020,0.001196,74.125.24.0-255,5738,90177,69,169536
14021,0.001198,172.31.40.0-255,66,90243,69,169536
14022,0.001209,74.125.24.0-255,5020,95263,69,169536
14023,0.001212,172.31.40.0-255,66,95329,69,169536
14024,0.001258,74.125.24.0-255,1484,96813,69,169536
14025,0.001305,74.125.24.0-255,2902,99715,69,169536
14026,0.001308,172.31.40.0-255,66,99781,69,169536
14027,0.001314,74.125.24.0-255,4320,104101,69,169536
14028,0.001316,172.31.40.0-255,66,104167,69,169536
14029,0.00134,74.125.24.0-255,4320,108487,69,169536
14030,0.001343,172.31.40.0-255,66,108553,69,169536
14031,0.001369,74.125.24.0-255,4320,112873,69,169536
14032,0.001372,172.31.40.0-255,66,112939,69,169536
14033,0.001383,172.31.40.0-255,66,113005,69,169536
14034,0.001418,172.31.40.0-255,66,113071,69,169536
14035,0.00155,74.125.24.0-255,1484,114555,69,169536
14036,0.001557,74.125.24.0-255,2902,117457,69,169536
14037,0.001561,172.31.40.0-255,66,117523,69,169536
14038,0.001564,74.125.24.0-255,1484,119007,69,169536
14039,0.001592,74.125.24.0-255,4320,123327,69,169536
14040,0.001596,172.31.40.0-255,66,123393,69,169536
14041,0.001609,172.31.40.0-255,66,123459,69,169536
14042,0.001645,74.125.24.0-255,1484,124943,69,169536
14043,0.001657,172.31.40.0-255,66,125009,69,169536
14044,0.001661,74.125.24.0-255,2184,127193,69,169536
14045,0.001665,172.31.40.0-255,66,127259,69,169536
14046,0.001723,74.125.24.0-255,1484,128743,69,169536
14047,0.001745,74.125.24.0-255,2902,131645,69,169536
14048,0.001749,172.31.40.0-255,66,131711,69,169536
14049,0.001755,74.125.24.0-255,4320,136031,69,169536
14050,0.001757,172.31.40.0-255,66,136097,69,169536
14051,0.001782,74.125.24.0-255,1484,137581,69,169536
14052,0.001795,74.125.24.0-255,7156,144737,69,169536
14053,0.001799,172.31.40.0-255,66,144803,69,169536
14054,0.001848,172.31.40.0-255,66,144869,69,169536
14055,0.001854,74.125.24.0-255,4320,149189,69,169536
14056,0.001858,172.31.40.0-255,66,149255,69,169536
14057,0.001909,172.31.40.0-255,66,149321,69,169536
14058,0.001922,172.31.40.0-255,66,149387,69,169536
14059,0.001958,74.125.24.0-255,1484,150871,69,169536
14060,0.002001,172.31.40.0-255,66,150937,69,169536
14061,0.002024,172.31.40.0-255,66,151003,69,169536
14062,0.002036,172.31.40.0-255,66,151069,69,169536
14063,0.002079,172.31.40.0-255,66,151135,69,169536
14064,0.002084,74.125.24.0-255,2184,153319,69,169536
14065,0.002087,172.31.40.0-255,66,153385,69,169536
14066,0.002104,172.31.40.0-255,66,153451,69,169536
14067,0.002143,172.31.40.0-255,66,153517,69,169536
14068,0.002151,74.125.24.0-255,6438,159955,69,169536
14069,0.002153,172.31.40.0-255,66,160021,69,169536
14070,0.002166,172.31.40.0-255,66,160087,69,169536
14071,0.002168,74.125.24.0-255,105,160192,69,169536
14072,0.003656,172.31.40.0-255,66,160258,69,169536
14073,0.003683,172.31.40.0-255,105,160363,69,169536
14074,0.006117,74.125.24.0-255,66,160429,69,169536
14075,0.038006,172.31.40.0-255,172,160601,69,169536
14076,0.038035,172.31.40.0-255,1116,161717,69,169536
14077,0.038088,172.31.40.0-255,1514,163231,69,169536
14078,0.03809,172.31.40.0-255,1514,164745,69,169536
14079,0.038113,172.31.40.0-255,1514,166259,69,169536
14080,0.038114,172.31.40.0-255,1514,167773,69,169536
14081,0.038117,172.31.40.0-255,1499,169272,69,169536
14082,0.039657,104.244.42.0-255,66,169338,69,169536
14083,0.039668,104.244.42.0-255,66,169404,69,169536
14084,0.039735,104.244.42.0-255,66,169470,69,169536
14085,0.03978,104.244.42.0-255,66,169536,69,169536
14086,0.0,74.125.130.0-255,156,156,69,272993
14087,2e-05,172.31.40.0-255,66,222,69,272993
14088,3.8e-05,74.125.130.0-255,1484,1706,69,272993
14089,4.3e-05,172.31.40.0-255,66,1772,69,272993
14090,4.9e-05,74.125.130.0-255,2902,4674,69,272993
14091,5.2e-05,172.31.40.0-255,66,4740,69,272993
14092,5.5e-05,74.125.130.0-255,1484,6224,69,272993
14093,5.8e-05,172.31.40.0-255,66,6290,69,272993
14094,7.9e-05,74.125.130.0-255,4320,10610,69,272993
14095,8.2e-05,172.31.40.0-255,66,10676,69,272993
14096,8.7e-05,74.125.130.0-255,3482,14158,69,272993
14097,9e-05,172.31.40.0-255,66,14224,69,272993
14098,0.000123,172.31.40.0-255,66,14290,69,272993
14099,0.000142,74.125.130.0-255,5379,19669,69,272993
14100,0.000144,172.31.40.0-255,66,19735,69,272993
14101,0.000276,74.125.130.0-255,1484,21219,69,272993
14102,0.000281,172.31.40.0-255,66,21285,69,272993
14103,0.000304,74.125.130.0-255,2902,24187,69,272993
14104,0.000307,172.31.40.0-255,66,24253,69,272993
14105,0.000313,74.125.130.0-255,5738,29991,69,272993
14106,0.000315,172.31.40.0-255,66,30057,69,272993
14107,0.000345,74.125.130.0-255,6797,36854,69,272993
14108,0.000348,172.31.40.0-255,66,36920,69,272993
14109,0.000376,74.125.130.0-255,5738,42658,69,272993
14110,0.000379,172.31.40.0-255,66,42724,69,272993
14111,0.000396,74.125.130.0-255,1484,44208,69,272993
14112,0.000399,172.31.40.0-255,66,44274,69,272993
14113,0.000405,74.125.130.0-255,4320,48594,69,272993
14114,0.000407,172.31.40.0-255,66,48660,69,272993
14115,0.00043,74.125.130.0-255,4320,52980,69,272993
14116,0.000433,172.31.40.0-255,66,53046,69,272993
14117,0.000435,74.125.130.0-255,1415,54461,69,272993
14118,0.000518,74.125.130.0-255,365,54826,69,272993
14119,0.000522,172.31.40.0-255,66,54892,69,272993
14120,0.000774,74.125.130.0-255,1484,56376,69,272993
14121,0.000778,74.125.130.0-255,1484,57860,69,272993
14122,0.000781,172.31.40.0-255,66,57926,69,272993
14123,0.000803,74.125.130.0-255,1484,59410,69,272993
14124,0.000809,74.125.130.0-255,5738,65148,69,272993
14125,0.000811,172.31.40.0-255,66,65214,69,272993
14126,0.000844,172.31.40.0-255,66,65280,69,272993
14127,0.000864,74.125.130.0-255,1484,66764,69,272993
14128,0.000877,172.31.40.0-255,66,66830,69,272993
14129,0.000896,74.125.130.0-255,766,67596,69,272993
14130,0.001054,74.125.130.0-255,1484,69080,69,272993
14131,0.001058,172.31.40.0-255,66,69146,69,272993
14132,0.001065,74.125.130.0-255,2902,72048,69,272993
14133,0.001067,172.31.40.0-255,66,72114,69,272993
14134,0.00109,74.125.130.0-255,5738,77852,69,272993
14135,0.001092,172.31.40.0-255,66,77918,69,272993
14136,0.001108,74.125.130.0-255,1484,79402,69,272993
14137,0.00113,74.125.130.0-255,2902,82304,69,272993
14138,0.001133,172.31.40.0-255,66,82370,69,272993
14139,0.00115,74.125.130.0-255,5738,88108,69,272993
14140,0.001152,172.31.40.0-255,66,88174,69,272993
14141,0.00116,74.125.130.0-255,7156,95330,69,272993
14142,0.001162,172.31.40.0-255,66,95396,69,272993
14143,0.001216,172.31.40.0-255,66,95462,69,272993
14144,0.001272,74.125.130.0-255,2902,98364,69,272993
14145,0.001275,172.31.40.0-255,66,98430,69,272993
14146,0.001299,74.125.130.0-255,1484,99914,69,272993
14147,0.001306,74.125.130.0-255,5738,105652,69,272993
14148,0.001308,172.31.40.0-255,66,105718,69,272993
14149,0.001311,74.125.130.0-255,1484,107202,69,272993
14150,0.001316,74.125.130.0-255,2902,110104,69,272993
14151,0.001318,172.31.40.0-255,66,110170,69,272993
14152,0.001321,74.125.130.0-255,1484,111654,69,272993
14153,0.001338,74.125.130.0-255,4320,115974,69,272993
14154,0.001343,172.31.40.0-255,66,116040,69,272993
14155,0.001355,74.125.130.0-255,7156,123196,69,272993
14156,0.001357,172.31.40.0-255,66,123262,69,272993
14157,0.001376,74.125.130.0-255,4320,127582,69,272993
14158,0.001379,172.31.40.0-255,66,127648,69,272993
14159,0.001381,74.125.130.0-255,766,128414,69,272993
14160,0.001543,74.125.130.0-255,1484,129898,69,272993
14161,0.001554,172.31.40.0-255,66,129964,69,272993
14162,0.00156,74.125.130.0-255,2902,132866,69,272993
14163,0.001562,172.31.40.0-255,66,132932,69,272993
14164,0.001569,74.125.130.0-255,5738,138670,69,272993
14165,0.001572,172.31.40.0-255,66,138736,69,272993
14166,0.001585,74.125.130.0-255,1484,140220,69,272993
14167,0.001611,172.31.40.0-255,66,140286,69,272993
14168,0.001617,74.125.130.0-255,4320,144606,69,272993
14169,0.001619,172.31.40.0-255,66,144672,69,272993
14170,0.001634,74.125.130.0-255,4320,148992,69,272993
14171,0.001638,172.31.40.0-255,66,149058,69,272993
14172,0.001654,74.125.130.0-255,2184,151242,69,272993
14173,0.001657,172.31.40.0-255,66,151308,69,272993
14174,0.001987,74.125.130.0-255,1484,152792,69,272993
14175,0.001994,74.125.130.0-255,2902,155694,69,272993
14176,0.001997,172.31.40.0-255,66,155760,69,272993
14177,0.002003,74.125.130.0-255,2902,158662,69,272993
14178,0.002005,172.31.40.0-255,66,158728,69,272993
14179,0.002021,74.125.130.0-255,2902,161630,69,272993
14180,0.002024,172.31.40.0-255,66,161696,69,272993
14181,0.002026,74.125.130.0-255,1484,163180,69,272993
14182,0.002031,74.125.130.0-255,2902,166082,69,272993
14183,0.002032,172.31.40.0-255,66,166148,69,272993
14184,0.002053,74.125.130.0-255,5738,171886,69,272993
14185,0.002059,172.31.40.0-255,66,171952,69,272993
14186,0.002083,172.31.40.0-255,66,172018,69,272993
14187,0.002087,74.125.130.0-255,2902,174920,69,272993
14188,0.002089,172.31.40.0-255,66,174986,69,272993
14189,0.002108,74.125.130.0-255,6438,181424,69,272993
14190,0.00211,172.31.40.0-255,66,181490,69,272993
14191,0.002117,74.125.130.0-255,5738,187228,69,272993
14192,0.002119,172.31.40.0-255,66,187294,69,272993
14193,0.002151,74.125.130.0-255,5738,193032,69,272993
14194,0.002154,172.31.40.0-255,66,193098,69,272993
14195,0.002167,172.31.40.0-255,66,193164,69,272993
14196,0.002173,74.125.130.0-255,5020,198184,69,272993
14197,0.002176,172.31.40.0-255,66,198250,69,272993
14198,0.002182,74.125.130.0-255,4320,202570,69,272993
14199,0.002184,172.31.40.0-255,66,202636,69,272993
14200,0.00221,74.125.130.0-255,1484,204120,69,272993
14201,0.002225,172.31.40.0-255,66,204186,69,272993
14202,0.002231,74.125.130.0-255,5738,209924,69,272993
14203,0.002234,172.31.40.0-255,66,209990,69,272993
14204,0.002247,74.125.130.0-255,2902,212892,69,272993
14205,0.00225,172.31.40.0-255,66,212958,69,272993
14206,0.00228,74.125.130.0-255,1484,214442,69,272993
14207,0.002311,172.31.40.0-255,66,214508,69,272993
14208,0.002381,172.31.40.0-255,66,214574,69,272993
14209,0.002407,172.31.40.0-255,66,214640,69,272993
14210,0.002423,172.31.40.0-255,66,214706,69,272993
14211,0.002436,172.31.40.0-255,66,214772,69,272993
14212,0.00478,74.125.130.0-255,5738,220510,69,272993
14213,0.004787,172.31.40.0-255,66,220576,69,272993
14214,0.007133,74.125.130.0-255,4320,224896,69,272993
14215,0.007138,172.31.40.0-255,66,224962,69,272993
14216,0.007154,74.125.130.0-255,1484,226446,69,272993
14217,0.00947,74.125.130.0-255,4320,230766,69,272993
14218,0.009476,172.31.40.0-255,66,230832,69,272993
14219,0.011825,74.125.130.0-255,4320,235152,69,272993
14220,0.011832,172.31.40.0-255,66,235218,69,272993
14221,0.011853,74.125.130.0-255,1484,236702,69,272993
14222,0.014186,74.125.130.0-255,4320,241022,69,272993
14223,0.014196,172.31.40.0-255,66,241088,69,272993
14224,0.016548,74.125.130.0-255,5738,246826,69,272993
14225,0.016555,172.31.40.0-255,66,246892,69,272993
14226,0.018907,74.125.130.0-255,5738,252630,69,272993
14227,0.018916,172.31.40.0-255,66,252696,69,272993
14228,0.021252,74.125.130.0-255,5738,258434,69,272993
14229,0.021261,172.31.40.0-255,66,258500,69,272993
14230,0.023611,74.125.130.0-255,5147,263647,69,272993
14231,0.023618,172.31.40.0-255,66,263713,69,272993
14232,0.023814,172.31.40.0-255,105,263818,69,272993
14233,0.026121,74.125.130.0-255,66,263884,69,272993
14234,0.037049,172.31.40.0-255,172,264056,69,272993
14235,0.03708,172.31.40.0-255,1114,265170,69,272993
14236,0.037148,172.31.40.0-255,1514,266684,69,272993
14237,0.03715,172.31.40.0-255,1514,268198,69,272993
14238,0.037151,172.31.40.0-255,1514,269712,69,272993
14239,0.037152,172.31.40.0-255,1514,271226,69,272993
14240,0.03718,172.31.40.0-255,1503,272729,69,272993
14241,0.038567,104.244.42.0-255,66,272795,69,272993
14242,0.038676,104.244.42.0-255,66,272861,69,272993
14243,0.03868,104.244.42.0-255,66,272927,69,272993
14244,0.038768,104.244.42.0-255,66,272993,69,272993
14245,0.0,172.31.40.0-255,105,105,69,459
14246,0.000236,172.31.40.0-255,90,195,69,459
14247,0.000245,172.31.40.0-255,66,261,69,459
14248,0.002536,74.125.200.0-255,66,327,69,459
14249,0.002573,74.125.200.0-255,66,393,69,459
14250,0.002583,172.31.40.0-255,66,459,69,459
14251,0.0,74.125.130.0-255,146,146,69,407094
14252,2.2e-05,172.31.40.0-255,66,212,69,407094
14253,3e-05,74.125.130.0-255,1484,1696,69,407094
14254,3.4e-05,172.31.40.0-255,66,1762,69,407094
14255,4e-05,74.125.130.0-255,2902,4664,69,407094
14256,4.2e-05,172.31.40.0-255,66,4730,69,407094
14257,5.7e-05,74.125.130.0-255,5738,10468,69,407094
14258,5.9e-05,172.31.40.0-255,66,10534,69,407094
14259,8.3e-05,74.125.130.0-255,1484,12018,69,407094
14260,8.5e-05,172.31.40.0-255,66,12084,69,407094
14261,0.000108,74.125.130.0-255,3457,15541,69,407094
14262,0.00011,172.31.40.0-255,66,15607,69,407094
14263,0.000118,74.125.130.0-255,5738,21345,69,407094
14264,0.00012,172.31.40.0-255,66,21411,69,407094
14265,0.000123,74.125.130.0-255,1484,22895,69,407094
14266,0.000125,172.31.40.0-255,66,22961,69,407094
14267,0.000166,172.31.40.0-255,66,23027,69,407094
14268,0.000261,74.125.130.0-255,1484,24511,69,407094
14269,0.000264,172.31.40.0-255,66,24577,69,407094
14270,0.000268,74.125.130.0-255,1484,26061,69,407094
14271,0.000269,172.31.40.0-255,66,26127,69,407094
14272,0.000332,74.125.130.0-255,2902,29029,69,407094
14273,0.000335,172.31.40.0-255,66,29095,69,407094
14274,0.000342,74.125.130.0-255,5738,34833,69,407094
14275,0.000345,172.31.40.0-255,66,34899,69,407094
14276,0.000355,74.125.130.0-255,5379,40278,69,407094
14277,0.000357,172.31.40.0-255,66,40344,69,407094
14278,0.000364,74.125.130.0-255,5738,46082,69,407094
14279,0.000366,172.31.40.0-255,66,46148,69,407094
14280,0.000401,74.125.130.0-255,5738,51886,69,407094
14281,0.000404,172.31.40.0-255,66,51952,69,407094
14282,0.000435,74.125.130.0-255,5668,57620,69,407094
14283,0.000437,172.31.40.0-255,66,57686,69,407094
14284,0.000465,74.125.130.0-255,98,57784,69,407094
14285,0.000609,74.125.130.0-255,1484,59268,69,407094
14286,0.000615,172.31.40.0-255,66,59334,69,407094
14287,0.00062,74.125.130.0-255,2902,62236,69,407094
14288,0.000623,172.31.40.0-255,66,62302,69,407094
14289,0.000648,74.125.130.0-255,4320,66622,69,407094
14290,0.00065,172.31.40.0-255,66,66688,69,407094
14291,0.000661,74.125.130.0-255,5738,72426,69,407094
14292,0.000664,172.31.40.0-255,66,72492,69,407094
14293,0.000688,74.125.130.0-255,2902,75394,69,407094
14294,0.00069,172.31.40.0-255,66,75460,69,407094
14295,0.000697,74.125.130.0-255,5738,81198,69,407094
14296,0.000699,172.31.40.0-255,66,81264,69,407094
14297,0.000729,74.125.130.0-255,7156,88420,69,407094
14298,0.000732,172.31.40.0-255,66,88486,69,407094
14299,0.00077,74.125.130.0-255,3321,91807,69,407094
14300,0.000773,172.31.40.0-255,66,91873,69,407094
14301,0.000796,74.125.130.0-255,1484,93357,69,407094
14302,0.000809,74.125.130.0-255,2902,96259,69,407094
14303,0.000811,172.31.40.0-255,66,96325,69,407094
14304,0.00084,74.125.130.0-255,2902,99227,69,407094
14305,0.000843,172.31.40.0-255,66,99293,69,407094
14306,0.000848,74.125.130.0-255,4320,103613,69,407094
14307,0.000851,172.31.40.0-255,66,103679,69,407094
14308,0.000855,74.125.130.0-255,2902,106581,69,407094
14309,0.000857,172.31.40.0-255,66,106647,69,407094
14310,0.000889,74.125.130.0-255,5738,112385,69,407094
14311,0.000896,172.31.40.0-255,66,112451,69,407094
14312,0.000899,74.125.130.0-255,1484,113935,69,407094
14313,0.000923,74.125.130.0-255,4320,118255,69,407094
14314,0.000926,172.31.40.0-255,66,118321,69,407094
14315,0.00093,74.125.130.0-255,2902,121223,69,407094
14316,0.000933,172.31.40.0-255,66,121289,69,407094
14317,0.000955,74.125.130.0-255,4320,125609,69,407094
14318,0.000958,172.31.40.0-255,66,125675,69,407094
14319,0.000964,74.125.130.0-255,766,126441,69,407094
14320,0.001176,74.125.130.0-255,1484,127925,69,407094
14321,0.001181,172.31.40.0-255,66,127991,69,407094
14322,0.001195,74.125.130.0-255,2902,130893,69,407094
14323,0.001202,172.31.40.0-255,66,130959,69,407094
14324,0.001221,74.125.130.0-255,5738,136697,69,407094
14325,0.001228,172.31.40.0-255,66,136763,69,407094
14326,0.001235,74.125.130.0-255,7156,143919,69,407094
14327,0.001237,172.31.40.0-255,66,143985,69,407094
14328,0.00127,74.125.130.0-255,7156,151141,69,407094
14329,0.001273,172.31.40.0-255,66,151207,69,407094
14330,0.001298,74.125.130.0-255,1484,152691,69,407094
14331,0.001314,74.125.130.0-255,5738,158429,69,407094
14332,0.001316,172.31.40.0-255,66,158495,69,407094
14333,0.001341,74.125.130.0-255,2184,160679,69,407094
14334,0.001344,172.31.40.0-255,66,160745,69,407094
14335,0.001511,74.125.130.0-255,1484,162229,69,407094
14336,0.001518,74.125.130.0-255,2902,165131,69,407094
14337,0.001521,172.31.40.0-255,66,165197,69,407094
14338,0.001552,74.125.130.0-255,2902,168099,69,407094
14339,0.001555,172.31.40.0-255,66,168165,69,407094
14340,0.001561,74.125.130.0-255,4320,172485,69,407094
14341,0.001564,172.31.40.0-255,66,172551,69,407094
14342,0.001578,172.31.40.0-255,66,172617,69,407094
14343,0.001607,74.125.130.0-255,4320,176937,69,407094
14344,0.00161,172.31.40.0-255,66,177003,69,407094
14345,0.001635,74.125.130.0-255,1484,178487,69,407094
14346,0.001644,74.125.130.0-255,7156,185643,69,407094
14347,0.001647,172.31.40.0-255,66,185709,69,407094
14348,0.0017,74.125.130.0-255,766,186475,69,407094
14349,0.001866,74.125.130.0-255,1484,187959,69,407094
14350,0.001869,74.125.130.0-255,1484,189443,69,407094
14351,0.001873,172.31.40.0-255,66,189509,69,407094
14352,0.001883,74.125.130.0-255,1484,190993,69,407094
14353,0.001885,172.31.40.0-255,66,191059,69,407094
14354,0.001889,74.125.130.0-255,1484,192543,69,407094
14355,0.001908,74.125.130.0-255,2902,195445,69,407094
14356,0.00191,172.31.40.0-255,66,195511,69,407094
14357,0.001926,172.31.40.0-255,66,195577,69,407094
14358,0.001979,74.125.130.0-255,4320,199897,69,407094
14359,0.001982,172.31.40.0-255,66,199963,69,407094
14360,0.001989,74.125.130.0-255,5738,205701,69,407094
14361,0.001992,172.31.40.0-255,66,205767,69,407094
14362,0.002021,74.125.130.0-255,6438,212205,69,407094
14363,0.002024,172.31.40.0-255,66,212271,69,407094
14364,0.0041,74.125.130.0-255,5738,218009,69,407094
14365,0.004108,172.31.40.0-255,66,218075,69,407094
14366,0.006176,74.125.130.0-255,4320,222395,69,407094
14367,0.006181,172.31.40.0-255,66,222461,69,407094
14368,0.0062,74.125.130.0-255,1484,223945,69,407094
14369,0.008268,74.125.130.0-255,4320,228265,69,407094
14370,0.008276,172.31.40.0-255,66,228331,69,407094
14371,0.010359,74.125.130.0-255,5738,234069,69,407094
14372,0.010367,172.31.40.0-255,66,234135,69,407094
14373,0.012454,74.125.130.0-255,5738,239873,69,407094
14374,0.012468,172.31.40.0-255,66,239939,69,407094
14375,0.014559,74.125.130.0-255,5738,245677,69,407094
14376,0.014574,172.31.40.0-255,66,245743,69,407094
14377,0.01666,74.125.130.0-255,5738,251481,69,407094
14378,0.01667,172.31.40.0-255,66,251547,69,407094
14379,0.018767,74.125.130.0-255,5738,257285,69,407094
14380,0.018778,172.31.40.0-255,66,257351,69,407094
14381,0.020859,74.125.130.0-255,5738,263089,69,407094
14382,0.020866,172.31.40.0-255,66,263155,69,407094
14383,0.022949,74.125.130.0-255,5738,268893,69,407094
14384,0.022961,172.31.40.0-255,66,268959,69,407094
14385,0.025039,74.125.130.0-255,5738,274697,69,407094
14386,0.025048,172.31.40.0-255,66,274763,69,407094
14387,0.027116,74.125.130.0-255,5738,280501,69,407094
14388,0.027124,172.31.40.0-255,66,280567,69,407094
14389,0.029205,74.125.130.0-255,5738,286305,69,407094
14390,0.029213,172.31.40.0-255,66,286371,69,407094
14391,0.031284,74.125.130.0-255,5738,292109,69,407094
14392,0.031292,172.31.40.0-255,66,292175,69,407094
14393,0.033395,74.125.130.0-255,5738,297913,69,407094
14394,0.033405,172.31.40.0-255,66,297979,69,407094
14395,0.035492,74.125.130.0-255,5738,303717,69,407094
14396,0.035501,172.31.40.0-255,66,303783,69,407094
14397,0.03758,74.125.130.0-255,5738,309521,69,407094
14398,0.037591,172.31.40.0-255,66,309587,69,407094
14399,0.039684,74.125.130.0-255,5738,315325,69,407094
14400,0.039711,172.31.40.0-255,66,315391,69,407094
14401,0.041606,172.31.40.0-255,172,315563,69,407094
14402,0.041637,172.31.40.0-255,1116,316679,69,407094
14403,0.041691,172.31.40.0-255,1514,318193,69,407094
14404,0.041693,172.31.40.0-255,1514,319707,69,407094
14405,0.041694,172.31.40.0-255,1514,321221,69,407094
14406,0.041695,172.31.40.0-255,1514,322735,69,407094
14407,0.041723,172.31.40.0-255,1501,324236,69,407094
14408,0.041785,74.125.130.0-255,2902,327138,69,407094
14409,0.041791,172.31.40.0-255,66,327204,69,407094
14410,0.041817,74.125.130.0-255,2902,330106,69,407094
14411,0.041819,172.31.40.0-255,66,330172,69,407094
14412,0.043145,104.244.42.0-255,66,330238,69,407094
14413,0.043167,104.244.42.0-255,66,330304,69,407094
14414,0.043277,104.244.42.0-255,66,330370,69,407094
14415,0.043282,104.244.42.0-255,66,330436,69,407094
14416,0.043868,74.125.130.0-255,2902,333338,69,407094
14417,0.043875,172.31.40.0-255,66,333404,69,407094
14418,0.043904,104.244.42.0-255,108,333512,69,407094
14419,0.043907,172.31.40.0-255,66,333578,69,407094
14420,0.043913,74.125.130.0-255,2902,336480,69,407094
14421,0.043915,172.31.40.0-255,66,336546,69,407094
14422,0.04595,74.125.130.0-255,2902,339448,69,407094
14423,0.045957,172.31.40.0-255,66,339514,69,407094
14424,0.045986,74.125.130.0-255,2902,342416,69,407094
14425,0.04599,172.31.40.0-255,66,342482,69,407094
14426,0.048046,74.125.130.0-255,5738,348220,69,407094
14427,0.048052,172.31.40.0-255,66,348286,69,407094
14428,0.050141,74.125.130.0-255,5738,354024,69,407094
14429,0.050148,172.31.40.0-255,66,354090,69,407094
14430,0.052228,74.125.130.0-255,5738,359828,69,407094
14431,0.052234,172.31.40.0-255,66,359894,69,407094
14432,0.054307,74.125.130.0-255,5738,365632,69,407094
14433,0.054318,172.31.40.0-255,66,365698,69,407094
14434,0.056429,74.125.130.0-255,5738,371436,69,407094
14435,0.056438,172.31.40.0-255,66,371502,69,407094
14436,0.058517,74.125.130.0-255,5738,377240,69,407094
14437,0.058524,172.31.40.0-255,66,377306,69,407094
14438,0.060599,74.125.130.0-255,5738,383044,69,407094
14439,0.060607,172.31.40.0-255,66,383110,69,407094
14440,0.062722,74.125.130.0-255,5738,388848,69,407094
14441,0.062732,172.31.40.0-255,66,388914,69,407094
14442,0.064825,74.125.130.0-255,5738,394652,69,407094
14443,0.064831,172.31.40.0-255,66,394718,69,407094
14444,0.066923,74.125.130.0-255,5738,400456,69,407094
14445,0.06693,172.31.40.0-255,66,400522,69,407094
14446,0.069025,74.125.130.0-255,5738,406260,69,407094
14447,0.069032,172.31.40.0-255,66,406326,69,407094
14448,0.071095,74.125.130.0-255,531,406857,69,407094
14449,0.071235,172.31.40.0-255,66,406923,69,407094
14450,0.071272,172.31.40.0-255,105,407028,69,407094
14451,0.073317,74.125.130.0-255,66,407094,69,407094
14452,0.0,74.125.68.0-255,153,153,69,328245
14453,2.2e-05,172.31.40.0-255,66,219,69,328245
14454,2.9e-05,74.125.68.0-255,1484,1703,69,328245
14455,3.5e-05,172.31.40.0-255,66,1769,69,328245
14456,4.7e-05,74.125.68.0-255,2902,4671,69,328245
14457,5.1e-05,172.31.40.0-255,66,4737,69,328245
14458,5.8e-05,74.125.68.0-255,5738,10475,69,328245
14459,6.2e-05,172.31.40.0-255,66,10541,69,328245
14460,7.8e-05,74.125.68.0-255,1484,12025,69,328245
14461,8.1e-05,172.31.40.0-255,66,12091,69,328245
14462,9e-05,74.125.68.0-255,2066,14157,69,328245
14463,9.3e-05,172.31.40.0-255,66,14223,69,328245
14464,0.000127,74.125.68.0-255,1484,15707,69,328245
14465,0.000129,172.31.40.0-255,66,15773,69,328245
14466,0.000171,74.125.68.0-255,2902,18675,69,328245
14467,0.000173,172.31.40.0-255,66,18741,69,328245
14468,0.00018,74.125.68.0-255,5738,24479,69,328245
14469,0.000183,172.31.40.0-255,66,24545,69,328245
14470,0.000187,74.125.68.0-255,2902,27447,69,328245
14471,0.000189,172.31.40.0-255,66,27513,69,328245
14472,0.000199,74.125.68.0-255,3961,31474,69,328245
14473,0.000202,172.31.40.0-255,66,31540,69,328245
14474,0.000435,74.125.68.0-255,1484,33024,69,328245
14475,0.000442,172.31.40.0-255,66,33090,69,328245
14476,0.000459,74.125.68.0-255,2902,35992,69,328245
14477,0.000466,172.31.40.0-255,66,36058,69,328245
14478,0.000472,74.125.68.0-255,4320,40378,69,328245
14479,0.000474,172.31.40.0-255,66,40444,69,328245
14480,0.000498,74.125.68.0-255,1484,41928,69,328245
14481,0.000505,172.31.40.0-255,66,41994,69,328245
14482,0.000509,74.125.68.0-255,1484,43478,69,328245
14483,0.000511,172.31.40.0-255,66,43544,69,328245
14484,0.000516,74.125.68.0-255,2902,46446,69,328245
14485,0.000524,74.125.68.0-255,6797,53243,69,328245
14486,0.000532,74.125.68.0-255,5738,58981,69,328245
14487,0.000538,172.31.40.0-255,66,59047,69,328245
14488,0.00054,172.31.40.0-255,66,59113,69,328245
14489,0.000541,172.31.40.0-255,66,59179,69,328245
14490,0.000571,74.125.68.0-255,6797,65976,69,328245
14491,0.000578,172.31.40.0-255,66,66042,69,328245
14492,0.000879,74.125.68.0-255,412,66454,69,328245
14493,0.0009,74.125.68.0-255,330,66784,69,328245
14494,0.001152,172.31.40.0-255,66,66850,69,328245
14495,0.001736,74.125.68.0-255,1484,68334,69,328245
14496,0.001747,74.125.68.0-255,2902,71236,69,328245
14497,0.001752,172.31.40.0-255,66,71302,69,328245
14498,0.001758,74.125.68.0-255,1484,72786,69,328245
14499,0.001806,74.125.68.0-255,2902,75688,69,328245
14500,0.001809,172.31.40.0-255,66,75754,69,328245
14501,0.001816,74.125.68.0-255,5738,81492,69,328245
14502,0.001818,172.31.40.0-255,66,81558,69,328245
14503,0.001825,74.125.68.0-255,5738,87296,69,328245
14504,0.001827,172.31.40.0-255,66,87362,69,328245
14505,0.001839,74.125.68.0-255,7156,94518,69,328245
14506,0.001841,172.31.40.0-255,66,94584,69,328245
14507,0.001873,74.125.68.0-255,2902,97486,69,328245
14508,0.001875,172.31.40.0-255,66,97552,69,328245
14509,0.001894,74.125.68.0-255,3602,101154,69,328245
14510,0.001897,172.31.40.0-255,66,101220,69,328245
14511,0.004168,74.125.68.0-255,1484,102704,69,328245
14512,0.004185,74.125.68.0-255,4320,107024,69,328245
14513,0.004188,172.31.40.0-255,66,107090,69,328245
14514,0.006472,74.125.68.0-255,5738,112828,69,328245
14515,0.006475,172.31.40.0-255,66,112894,69,328245
14516,0.008763,74.125.68.0-255,5738,118632,69,328245
14517,0.008769,172.31.40.0-255,66,118698,69,328245
14518,0.011066,74.125.68.0-255,5738,124436,69,328245
14519,0.011075,172.31.40.0-255,66,124502,69,328245
14520,0.013364,74.125.68.0-255,5738,130240,69,328245
14521,0.013372,172.31.40.0-255,66,130306,69,328245
14522,0.015691,74.125.68.0-255,5738,136044,69,328245
14523,0.015703,172.31.40.0-255,66,136110,69,328245
14524,0.017994,74.125.68.0-255,5738,141848,69,328245
14525,0.018002,172.31.40.0-255,66,141914,69,328245
14526,0.020326,74.125.68.0-255,5738,147652,69,328245
14527,0.020334,172.31.40.0-255,66,147718,69,328245
14528,0.022627,74.125.68.0-255,5738,153456,69,328245
14529,0.022634,172.31.40.0-255,66,153522,69,328245
14530,0.024928,74.125.68.0-255,4320,157842,69,328245
14531,0.024936,172.31.40.0-255,66,157908,69,328245
14532,0.024977,74.125.68.0-255,1484,159392,69,328245
14533,0.02724,74.125.68.0-255,4320,163712,69,328245
14534,0.027248,172.31.40.0-255,66,163778,69,328245
14535,0.02953,74.125.68.0-255,4320,168098,69,328245
14536,0.029536,172.31.40.0-255,66,168164,69,328245
14537,0.029565,74.125.68.0-255,1484,169648,69,328245
14538,0.031833,74.125.68.0-255,4320,173968,69,328245
14539,0.03184,172.31.40.0-255,66,174034,69,328245
14540,0.032707,172.31.40.0-255,176,174210,69,328245
14541,0.032739,172.31.40.0-255,1114,175324,69,328245
14542,0.032809,172.31.40.0-255,1514,176838,69,328245
14543,0.032811,172.31.40.0-255,1514,178352,69,328245
14544,0.032817,172.31.40.0-255,1514,179866,69,328245
14545,0.032819,172.31.40.0-255,1514,181380,69,328245
14546,0.032854,172.31.40.0-255,1501,182881,69,328245
14547,0.034133,74.125.68.0-255,5738,188619,69,328245
14548,0.03414,172.31.40.0-255,66,188685,69,328245
14549,0.034266,104.244.42.0-255,66,188751,69,328245
14550,0.034273,104.244.42.0-255,66,188817,69,328245
14551,0.03437,104.244.42.0-255,66,188883,69,328245
14552,0.034519,104.244.42.0-255,66,188949,69,328245
14553,0.03643,74.125.68.0-255,5738,194687,69,328245
14554,0.036437,172.31.40.0-255,66,194753,69,328245
14555,0.038733,74.125.68.0-255,5738,200491,69,328245
14556,0.038741,172.31.40.0-255,66,200557,69,328245
14557,0.041031,74.125.68.0-255,5738,206295,69,328245
14558,0.041039,172.31.40.0-255,66,206361,69,328245
14559,0.043336,74.125.68.0-255,5738,212099,69,328245
14560,0.043344,172.31.40.0-255,66,212165,69,328245
14561,0.045644,74.125.68.0-255,5738,217903,69,328245
14562,0.045651,172.31.40.0-255,66,217969,69,328245
14563,0.047968,74.125.68.0-255,5738,223707,69,328245
14564,0.047974,172.31.40.0-255,66,223773,69,328245
14565,0.050267,74.125.68.0-255,5738,229511,69,328245
14566,0.050274,172.31.40.0-255,66,229577,69,328245
14567,0.052565,74.125.68.0-255,5738,235315,69,328245
14568,0.052572,172.31.40.0-255,66,235381,69,328245
14569,0.054862,74.125.68.0-255,5738,241119,69,328245
14570,0.054869,172.31.40.0-255,66,241185,69,328245
14571,0.057174,74.125.68.0-255,5738,246923,69,328245
14572,0.057181,172.31.40.0-255,66,246989,69,328245
14573,0.059481,74.125.68.0-255,5738,252727,69,328245
14574,0.059488,172.31.40.0-255,66,252793,69,328245
14575,0.06178,74.125.68.0-255,5738,258531,69,328245
14576,0.061786,172.31.40.0-255,66,258597,69,328245
14577,0.064125,74.125.68.0-255,5738,264335,69,328245
14578,0.064131,172.31.40.0-255,66,264401,69,328245
14579,0.066431,74.125.68.0-255,5738,270139,69,328245
14580,0.066438,172.31.40.0-255,66,270205,69,328245
14581,0.068734,74.125.68.0-255,5738,275943,69,328245
14582,0.068741,172.31.40.0-255,66,276009,69,328245
14583,0.071046,74.125.68.0-255,5738,281747,69,328245
14584,0.071052,172.31.40.0-255,66,281813,69,328245
14585,0.073345,74.125.68.0-255,5738,287551,69,328245
14586,0.073352,172.31.40.0-255,66,287617,69,328245
14587,0.075649,74.125.68.0-255,5738,293355,69,328245
14588,0.075656,172.31.40.0-255,66,293421,69,328245
14589,0.077939,74.125.68.0-255,5738,299159,69,328245
14590,0.077946,172.31.40.0-255,66,299225,69,328245
14591,0.080226,74.125.68.0-255,5738,304963,69,328245
14592,0.080232,172.31.40.0-255,66,305029,69,328245
14593,0.082523,74.125.68.0-255,5738,310767,69,328245
14594,0.082529,172.31.40.0-255,66,310833,69,328245
14595,0.08482,74.125.68.0-255,5738,316571,69,328245
14596,0.084841,172.31.40.0-255,66,316637,69,328245
14597,0.087134,74.125.68.0-255,5738,322375,69,328245
14598,0.08714,172.31.40.0-255,66,322441,69,328245
14599,0.089429,74.125.68.0-255,5738,328179,69,328245
14600,0.089435,172.31.40.0-255,66,328245,69,328245
14601,0.0,74.125.68.0-255,153,153,69,414303
14602,1.2e-05,172.31.40.0-255,66,219,69,414303
14603,1.7e-05,74.125.68.0-255,1484,1703,69,414303
14604,2.1e-05,172.31.40.0-255,66,1769,69,414303
14605,2.6e-05,74.125.68.0-255,2902,4671,69,414303
14606,2.9e-05,172.31.40.0-255,66,4737,69,414303
14607,6e-05,74.125.68.0-255,5738,10475,69,414303
14608,6.3e-05,172.31.40.0-255,66,10541,69,414303
14609,8.4e-05,74.125.68.0-255,3520,14061,69,414303
14610,8.6e-05,172.31.40.0-255,66,14127,69,414303
14611,0.000223,74.125.68.0-255,1484,15611,69,414303
14612,0.000227,172.31.40.0-255,66,15677,69,414303
14613,0.000241,74.125.68.0-255,2902,18579,69,414303
14614,0.000243,172.31.40.0-255,66,18645,69,414303
14615,0.000246,74.125.68.0-255,1484,20129,69,414303
14616,0.000247,172.31.40.0-255,66,20195,69,414303
14617,0.000261,74.125.68.0-255,4320,24515,69,414303
14618,0.000264,172.31.40.0-255,66,24581,69,414303
14619,0.000294,74.125.68.0-255,2902,27483,69,414303
14620,0.000296,172.31.40.0-255,66,27549,69,414303
14621,0.000308,74.125.68.0-255,3961,31510,69,414303
14622,0.00031,172.31.40.0-255,66,31576,69,414303
14623,0.000317,74.125.68.0-255,7156,38732,69,414303
14624,0.000319,172.31.40.0-255,66,38798,69,414303
14625,0.000323,74.125.68.0-255,2902,41700,69,414303
14626,0.000324,172.31.40.0-255,66,41766,69,414303
14627,0.000355,74.125.68.0-255,7156,48922,69,414303
14628,0.000357,172.31.40.0-255,66,48988,69,414303
14629,0.000361,74.125.68.0-255,4320,53308,69,414303
14630,0.000363,172.31.40.0-255,66,53374,69,414303
14631,0.00038,74.125.68.0-255,7156,60530,69,414303
14632,0.000382,172.31.40.0-255,66,60596,69,414303
14633,0.000388,74.125.68.0-255,5020,65616,69,414303
14634,0.000389,172.31.40.0-255,66,65682,69,414303
14635,0.000428,74.125.68.0-255,359,66041,69,414303
14636,0.000893,74.125.68.0-255,384,66425,69,414303
14637,0.000922,172.31.40.0-255,66,66491,69,414303
14638,0.001085,74.125.68.0-255,1484,67975,69,414303
14639,0.001093,74.125.68.0-255,2902,70877,69,414303
14640,0.001096,172.31.40.0-255,66,70943,69,414303
14641,0.001116,74.125.68.0-255,5738,76681,69,414303
14642,0.001119,172.31.40.0-255,66,76747,69,414303
14643,0.001142,74.125.68.0-255,2902,79649,69,414303
14644,0.001145,172.31.40.0-255,66,79715,69,414303
14645,0.001166,74.125.68.0-255,4320,84035,69,414303
14646,0.001168,172.31.40.0-255,66,84101,69,414303
14647,0.001177,172.31.40.0-255,66,84167,69,414303
14648,0.00119,74.125.68.0-255,2902,87069,69,414303
14649,0.001192,172.31.40.0-255,66,87135,69,414303
14650,0.001232,74.125.68.0-255,4320,91455,69,414303
14651,0.001235,172.31.40.0-255,66,91521,69,414303
14652,0.001246,74.125.68.0-255,766,92287,69,414303
14653,0.001573,74.125.68.0-255,1484,93771,69,414303
14654,0.001578,172.31.40.0-255,66,93837,69,414303
14655,0.001584,74.125.68.0-255,2902,96739,69,414303
14656,0.001586,172.31.40.0-255,66,96805,69,414303
14657,0.001589,74.125.68.0-255,1484,98289,69,414303
14658,0.00161,74.125.68.0-255,4320,102609,69,414303
14659,0.001612,172.31.40.0-255,66,102675,69,414303
14660,0.001624,74.125.68.0-255,2902,105577,69,414303
14661,0.001626,172.31.40.0-255,66,105643,69,414303
14662,0.001644,74.125.68.0-255,4320,109963,69,414303
14663,0.001646,172.31.40.0-255,66,110029,69,414303
14664,0.001651,74.125.68.0-255,4320,114349,69,414303
14665,0.001653,172.31.40.0-255,66,114415,69,414303
14666,0.001679,74.125.68.0-255,4320,118735,69,414303
14667,0.001681,172.31.40.0-255,66,118801,69,414303
14668,0.001688,74.125.68.0-255,5738,124539,69,414303
14669,0.001689,172.31.40.0-255,66,124605,69,414303
14670,0.001705,74.125.68.0-255,2184,126789,69,414303
14671,0.001707,172.31.40.0-255,66,126855,69,414303
14672,0.001773,74.125.68.0-255,1484,128339,69,414303
14673,0.001785,74.125.68.0-255,1484,129823,69,414303
14674,0.001788,172.31.40.0-255,66,129889,69,414303
14675,0.001802,74.125.68.0-255,1484,131373,69,414303
14676,0.001834,74.125.68.0-255,5738,137111,69,414303
14677,0.001836,172.31.40.0-255,66,137177,69,414303
14678,0.001841,74.125.68.0-255,2902,140079,69,414303
14679,0.001843,172.31.40.0-255,66,140145,69,414303
14680,0.001848,74.125.68.0-255,4320,144465,69,414303
14681,0.001851,172.31.40.0-255,66,144531,69,414303
14682,0.001857,74.125.68.0-255,5738,150269,69,414303
14683,0.00186,172.31.40.0-255,66,150335,69,414303
14684,0.001887,74.125.68.0-255,2902,153237,69,414303
14685,0.00189,172.31.40.0-255,66,153303,69,414303
14686,0.001895,74.125.68.0-255,5738,159041,69,414303
14687,0.001898,172.31.40.0-255,66,159107,69,414303
14688,0.001931,74.125.68.0-255,2184,161291,69,414303
14689,0.001933,172.31.40.0-255,66,161357,69,414303
14690,0.00204,74.125.68.0-255,1484,162841,69,414303
14691,0.002043,74.125.68.0-255,1484,164325,69,414303
14692,0.002045,172.31.40.0-255,66,164391,69,414303
14693,0.002058,74.125.68.0-255,1484,165875,69,414303
14694,0.002096,74.125.68.0-255,5738,171613,69,414303
14695,0.002099,172.31.40.0-255,66,171679,69,414303
14696,0.002103,74.125.68.0-255,2902,174581,69,414303
14697,0.002106,172.31.40.0-255,66,174647,69,414303
14698,0.002119,74.125.68.0-255,2902,177549,69,414303
14699,0.002121,172.31.40.0-255,66,177615,69,414303
14700,0.002137,74.125.68.0-255,5738,183353,69,414303
14701,0.002139,172.31.40.0-255,66,183419,69,414303
14702,0.002164,74.125.68.0-255,1484,184903,69,414303
14703,0.002175,172.31.40.0-255,66,184969,69,414303
14704,0.002178,74.125.68.0-255,766,185735,69,414303
14705,0.002315,74.125.68.0-255,1484,187219,69,414303
14706,0.002318,172.31.40.0-255,66,187285,69,414303
14707,0.002331,74.125.68.0-255,2902,190187,69,414303
14708,0.002334,172.31.40.0-255,66,190253,69,414303
14709,0.002354,74.125.68.0-255,1484,191737,69,414303
14710,0.002358,74.125.68.0-255,2902,194639,69,414303
14711,0.002361,172.31.40.0-255,66,194705,69,414303
14712,0.002377,74.125.68.0-255,5738,200443,69,414303
14713,0.00238,172.31.40.0-255,66,200509,69,414303
14714,0.002401,74.125.68.0-255,4320,204829,69,414303
14715,0.002403,172.31.40.0-255,66,204895,69,414303
14716,0.002427,74.125.68.0-255,7156,212051,69,414303
14717,0.00243,172.31.40.0-255,66,212117,69,414303
14718,0.002435,74.125.68.0-255,5738,217855,69,414303
14719,0.002437,172.31.40.0-255,66,217921,69,414303
14720,0.002469,74.125.68.0-255,6438,224359,69,414303
14721,0.002471,172.31.40.0-255,66,224425,69,414303
14722,0.002474,74.125.68.0-255,1484,225909,69,414303
14723,0.004886,74.125.68.0-255,1484,227393,69,414303
14724,0.004889,172.31.40.0-255,66,227459,69,414303
14725,0.004932,74.125.68.0-255,2902,230361,69,414303
14726,0.004946,172.31.40.0-255,66,230427,69,414303
14727,0.007319,74.125.68.0-255,2902,233329,69,414303
14728,0.007325,172.31.40.0-255,66,233395,69,414303
14729,0.007358,74.125.68.0-255,2902,236297,69,414303
14730,0.007362,172.31.40.0-255,66,236363,69,414303
14731,0.009754,74.125.68.0-255,2902,239265,69,414303
14732,0.00976,172.31.40.0-255,66,239331,69,414303
14733,0.00979,74.125.68.0-255,2902,242233,69,414303
14734,0.009793,172.31.40.0-255,66,242299,69,414303
14735,0.012177,74.125.68.0-255,2902,245201,69,414303
14736,0.012185,172.31.40.0-255,66,245267,69,414303
14737,0.012208,74.125.68.0-255,2902,248169,69,414303
14738,0.01221,172.31.40.0-255,66,248235,69,414303
14739,0.014617,74.125.68.0-255,5738,253973,69,414303
14740,0.014624,172.31.40.0-255,66,254039,69,414303
14741,0.017055,74.125.68.0-255,5738,259777,69,414303
14742,0.017065,172.31.40.0-255,66,259843,69,414303
14743,0.019496,74.125.68.0-255,5738,265581,69,414303
14744,0.019504,172.31.40.0-255,66,265647,69,414303
14745,0.021935,74.125.68.0-255,5738,271385,69,414303
14746,0.021943,172.31.40.0-255,66,271451,69,414303
14747,0.024375,74.125.68.0-255,5738,277189,69,414303
14748,0.024382,172.31.40.0-255,66,277255,69,414303
14749,0.026806,74.125.68.0-255,5738,282993,69,414303
14750,0.026814,172.31.40.0-255,66,283059,69,414303
14751,0.029233,74.125.68.0-255,5738,288797,69,414303
14752,0.02924,172.31.40.0-255,66,288863,69,414303
14753,0.031661,74.125.68.0-255,5738,294601,69,414303
14754,0.031669,172.31.40.0-255,66,294667,69,414303
14755,0.034098,74.125.68.0-255,5738,300405,69,414303
14756,0.034106,172.31.40.0-255,66,300471,69,414303
14757,0.036542,74.125.68.0-255,5738,306209,69,414303
14758,0.03655,172.31.40.0-255,66,306275,69,414303
14759,0.038982,74.125.68.0-255,5738,312013,69,414303
14760,0.038989,172.31.40.0-255,66,312079,69,414303
14761,0.03996,172.31.40.0-255,172,312251,69,414303
14762,0.040006,172.31.40.0-255,1114,313365,69,414303
14763,0.040072,172.31.40.0-255,1514,314879,69,414303
14764,0.040074,172.31.40.0-255,1514,316393,69,414303
14765,0.040075,172.31.40.0-255,1514,317907,69,414303
14766,0.040076,172.31.40.0-255,1514,319421,69,414303
14767,0.040105,172.31.40.0-255,1501,320922,69,414303
14768,0.041428,74.125.68.0-255,5738,326660,69,414303
14769,0.04144,172.31.40.0-255,66,326726,69,414303
14770,0.041603,104.244.42.0-255,66,326792,69,414303
14771,0.04165,104.244.42.0-255,66,326858,69,414303
14772,0.041802,104.244.42.0-255,66,326924,69,414303
14773,0.043869,74.125.68.0-255,5738,332662,69,414303
14774,0.043876,172.31.40.0-255,66,332728,69,414303
14775,0.046303,74.125.68.0-255,4320,337048,69,414303
14776,0.046311,172.31.40.0-255,66,337114,69,414303
14777,0.046333,74.125.68.0-255,1484,338598,69,414303
14778,0.048785,74.125.68.0-255,4320,342918,69,414303
14779,0.048791,172.31.40.0-255,66,342984,69,414303
14780,0.051234,74.125.68.0-255,5738,348722,69,414303
14781,0.05124,172.31.40.0-255,66,348788,69,414303
14782,0.053656,74.125.68.0-255,5738,354526,69,414303
14783,0.053662,172.31.40.0-255,66,354592,69,414303
14784,0.056097,74.125.68.0-255,5738,360330,69,414303
14785,0.056104,172.31.40.0-255,66,360396,69,414303
14786,0.058546,74.125.68.0-255,4320,364716,69,414303
14787,0.058552,172.31.40.0-255,66,364782,69,414303
14788,0.058572,74.125.68.0-255,1484,366266,69,414303
14789,0.060965,74.125.68.0-255,4320,370586,69,414303
14790,0.060972,172.31.40.0-255,66,370652,69,414303
14791,0.063396,74.125.68.0-255,5738,376390,69,414303
14792,0.063404,172.31.40.0-255,66,376456,69,414303
14793,0.065831,74.125.68.0-255,4320,380776,69,414303
14794,0.065838,172.31.40.0-255,66,380842,69,414303
14795,0.065853,74.125.68.0-255,1484,382326,69,414303
14796,0.068263,74.125.68.0-255,4320,386646,69,414303
14797,0.068271,172.31.40.0-255,66,386712,69,414303
14798,0.070693,74.125.68.0-255,5738,392450,69,414303
14799,0.070699,172.31.40.0-255,66,392516,69,414303
14800,0.073116,74.125.68.0-255,5738,398254,69,414303
14801,0.073123,172.31.40.0-255,66,398320,69,414303
14802,0.075561,74.125.68.0-255,5738,404058,69,414303
14803,0.075567,172.31.40.0-255,66,404124,69,414303
14804,0.07801,74.125.68.0-255,5738,409862,69,414303
14805,0.078017,172.31.40.0-255,66,409928,69,414303
14806,0.080443,74.125.68.0-255,4138,414066,69,414303
14807,0.08045,172.31.40.0-255,66,414132,69,414303
14808,0.080627,172.31.40.0-255,105,414237,69,414303
14809,0.083007,74.125.68.0-255,66,414303,69,414303
14810,0.0,172.253.118.0-255,153,153,69,332296
14811,1.7e-05,172.31.40.0-255,66,219,69,332296
14812,2.4e-05,172.253.118.0-255,1484,1703,69,332296
14813,2.8e-05,172.31.40.0-255,66,1769,69,332296
14814,4.7e-05,172.253.118.0-255,2902,4671,69,332296
14815,5.1e-05,172.31.40.0-255,66,4737,69,332296
14816,5.4e-05,172.253.118.0-255,1484,6221,69,332296
14817,5.6e-05,172.31.40.0-255,66,6287,69,332296
14818,8.1e-05,172.253.118.0-255,4320,10607,69,332296
14819,8.3e-05,172.31.40.0-255,66,10673,69,332296
14820,0.000113,172.253.118.0-255,2902,13575,69,332296
14821,0.000115,172.31.40.0-255,66,13641,69,332296
14822,0.000131,172.253.118.0-255,675,14316,69,332296
14823,0.000133,172.31.40.0-255,66,14382,69,332296
14824,0.000278,172.253.118.0-255,1484,15866,69,332296
14825,0.000282,172.31.40.0-255,66,15932,69,332296
14826,0.000301,172.253.118.0-255,2902,18834,69,332296
14827,0.000303,172.31.40.0-255,66,18900,69,332296
14828,0.000308,172.253.118.0-255,4320,23220,69,332296
14829,0.000311,172.31.40.0-255,66,23286,69,332296
14830,0.000331,172.253.118.0-255,1484,24770,69,332296
14831,0.000334,172.31.40.0-255,66,24836,69,332296
14832,0.000372,172.31.40.0-255,66,24902,69,332296
14833,0.000391,172.253.118.0-255,1125,26027,69,332296
14834,0.000394,172.31.40.0-255,66,26093,69,332296
14835,0.000405,172.31.40.0-255,66,26159,69,332296
14836,0.00044,172.31.40.0-255,66,26225,69,332296
14837,0.00047,172.253.118.0-255,2902,29127,69,332296
14838,0.000473,172.31.40.0-255,66,29193,69,332296
14839,0.000502,172.31.40.0-255,66,29259,69,332296
14840,0.000504,172.253.118.0-255,646,29905,69,332296
14841,0.000638,172.253.118.0-255,1484,31389,69,332296
14842,0.000642,172.31.40.0-255,66,31455,69,332296
14843,0.000672,172.253.118.0-255,2902,34357,69,332296
14844,0.000675,172.31.40.0-255,66,34423,69,332296
14845,0.000678,172.253.118.0-255,1484,35907,69,332296
14846,0.000696,172.253.118.0-255,4320,40227,69,332296
14847,0.000698,172.31.40.0-255,66,40293,69,332296
14848,0.000719,172.253.118.0-255,5738,46031,69,332296
14849,0.000721,172.31.40.0-255,66,46097,69,332296
14850,0.00074,172.253.118.0-255,2902,48999,69,332296
14851,0.000742,172.31.40.0-255,66,49065,69,332296
14852,0.000767,172.253.118.0-255,4320,53385,69,332296
14853,0.00077,172.31.40.0-255,66,53451,69,332296
14854,0.000778,172.253.118.0-255,7156,60607,69,332296
14855,0.00078,172.31.40.0-255,66,60673,69,332296
14856,0.000797,172.253.118.0-255,2902,63575,69,332296
14857,0.000799,172.31.40.0-255,66,63641,69,332296
14858,0.000802,172.253.118.0-255,766,64407,69,332296
14859,0.000965,172.253.118.0-255,1484,65891,69,332296
14860,0.000969,172.31.40.0-255,66,65957,69,332296
14861,0.000975,172.253.118.0-255,2902,68859,69,332296
14862,0.000977,172.31.40.0-255,66,68925,69,332296
14863,0.001001,172.253.118.0-255,5738,74663,69,332296
14864,0.001003,172.31.40.0-255,66,74729,69,332296
14865,0.00102,172.253.118.0-255,1484,76213,69,332296
14866,0.001045,172.31.40.0-255,66,76279,69,332296
14867,0.001112,172.31.40.0-255,66,76345,69,332296
14868,0.001772,172.253.118.0-255,1484,77829,69,332296
14869,0.001781,172.253.118.0-255,2902,80731,69,332296
14870,0.001785,172.31.40.0-255,66,80797,69,332296
14871,0.00181,172.253.118.0-255,5738,86535,69,332296
14872,0.001812,172.31.40.0-255,66,86601,69,332296
14873,0.001826,172.253.118.0-255,2902,89503,69,332296
14874,0.001828,172.31.40.0-255,66,89569,69,332296
14875,0.001862,172.31.40.0-255,66,89635,69,332296
14876,0.00187,172.253.118.0-255,7156,96791,69,332296
14877,0.001872,172.31.40.0-255,66,96857,69,332296
14878,0.001888,172.253.118.0-255,5020,101877,69,332296
14879,0.00189,172.31.40.0-255,66,101943,69,332296
14880,0.001975,172.253.118.0-255,1484,103427,69,332296
14881,0.001981,172.253.118.0-255,2902,106329,69,332296
14882,0.001984,172.31.40.0-255,66,106395,69,332296
14883,0.002005,172.253.118.0-255,5738,112133,69,332296
14884,0.002007,172.31.40.0-255,66,112199,69,332296
14885,0.002037,172.253.118.0-255,2902,115101,69,332296
14886,0.00204,172.31.40.0-255,66,115167,69,332296
14887,0.002067,172.31.40.0-255,66,115233,69,332296
14888,0.002087,172.253.118.0-255,5738,120971,69,332296
14889,0.002089,172.31.40.0-255,66,121037,69,332296
14890,0.002109,172.253.118.0-255,5020,126057,69,332296
14891,0.002111,172.31.40.0-255,66,126123,69,332296
14892,0.002198,172.253.118.0-255,1484,127607,69,332296
14893,0.002229,172.253.118.0-255,2902,130509,69,332296
14894,0.002232,172.31.40.0-255,66,130575,69,332296
14895,0.002241,172.253.118.0-255,5738,136313,69,332296
14896,0.002243,172.31.40.0-255,66,136379,69,332296
14897,0.002275,172.31.40.0-255,66,136445,69,332296
14898,0.002307,172.31.40.0-255,66,136511,69,332296
14899,0.002329,172.253.118.0-255,1484,137995,69,332296
14900,0.002346,172.253.118.0-255,766,138761,69,332296
14901,0.002349,172.31.40.0-255,66,138827,69,332296
14902,0.004807,172.253.118.0-255,2902,141729,69,332296
14903,0.004816,172.31.40.0-255,66,141795,69,332296
14904,0.004845,172.253.118.0-255,2902,144697,69,332296
14905,0.004847,172.31.40.0-255,66,144763,69,332296
14906,0.007312,172.253.118.0-255,5738,150501,69,332296
14907,0.007318,172.31.40.0-255,66,150567,69,332296
14908,0.009823,172.253.118.0-255,5738,156305,69,332296
14909,0.00983,172.31.40.0-255,66,156371,69,332296
14910,0.012307,172.253.118.0-255,5738,162109,69,332296
14911,0.012318,172.31.40.0-255,66,162175,69,332296
14912,0.014812,172.253.118.0-255,5738,167913,69,332296
14913,0.01482,172.31.40.0-255,66,167979,69,332296
14914,0.017315,172.253.118.0-255,5738,173717,69,332296
14915,0.017324,172.31.40.0-255,66,173783,69,332296
14916,0.019816,172.253.118.0-255,5738,179521,69,332296
14917,0.019826,172.31.40.0-255,66,179587,69,332296
14918,0.022316,172.253.118.0-255,5738,185325,69,332296
14919,0.022324,172.31.40.0-255,66,185391,69,332296
14920,0.024821,172.253.118.0-255,5738,191129,69,332296
14921,0.024828,172.31.40.0-255,66,191195,69,332296
14922,0.02733,172.253.118.0-255,5738,196933,69,332296
14923,0.027337,172.31.40.0-255,66,196999,69,332296
14924,0.029831,172.253.118.0-255,5738,202737,69,332296
14925,0.029838,172.31.40.0-255,66,202803,69,332296
14926,0.032342,172.253.118.0-255,5738,208541,69,332296
14927,0.03235,172.31.40.0-255,66,208607,69,332296
14928,0.034337,172.31.40.0-255,172,208779,69,332296
14929,0.034366,172.31.40.0-255,1112,209891,69,332296
14930,0.034432,172.31.40.0-255,1514,211405,69,332296
14931,0.034434,172.31.40.0-255,1514,212919,69,332296
14932,0.034435,172.31.40.0-255,1514,214433,69,332296
14933,0.034437,172.31.40.0-255,1514,215947,69,332296
14934,0.034465,172.31.40.0-255,1505,217452,69,332296
14935,0.034853,172.253.118.0-255,5738,223190,69,332296
14936,0.034859,172.31.40.0-255,66,223256,69,332296
14937,0.035997,104.244.42.0-255,66,223322,69,332296
14938,0.03605,104.244.42.0-255,66,223388,69,332296
14939,0.036209,104.244.42.0-255,66,223454,69,332296
14940,0.037384,172.253.118.0-255,5738,229192,69,332296
14941,0.03739,172.31.40.0-255,66,229258,69,332296
14942,0.039893,172.253.118.0-255,5738,234996,69,332296
14943,0.039901,172.31.40.0-255,66,235062,69,332296
14944,0.042404,172.253.118.0-255,5738,240800,69,332296
14945,0.042414,172.31.40.0-255,66,240866,69,332296
14946,0.044917,172.253.118.0-255,5738,246604,69,332296
14947,0.044922,172.31.40.0-255,66,246670,69,332296
14948,0.047446,172.253.118.0-255,5738,252408,69,332296
14949,0.047451,172.31.40.0-255,66,252474,69,332296
14950,0.049965,172.253.118.0-255,5738,258212,69,332296
14951,0.049971,172.31.40.0-255,66,258278,69,332296
14952,0.052475,172.253.118.0-255,5738,264016,69,332296
14953,0.052481,172.31.40.0-255,66,264082,69,332296
14954,0.054971,172.253.118.0-255,5738,269820,69,332296
14955,0.054977,172.31.40.0-255,66,269886,69,332296
14956,0.05748,172.253.118.0-255,5738,275624,69,332296
14957,0.057485,172.31.40.0-255,66,275690,69,332296
14958,0.059989,172.253.118.0-255,5738,281428,69,332296
14959,0.059996,172.31.40.0-255,66,281494,69,332296
14960,0.0625,172.253.118.0-255,5738,287232,69,332296
14961,0.062505,172.31.40.0-255,66,287298,69,332296
14962,0.065003,172.253.118.0-255,5738,293036,69,332296
14963,0.065008,172.31.40.0-255,66,293102,69,332296
14964,0.067498,172.253.118.0-255,5738,298840,69,332296
14965,0.067504,172.31.40.0-255,66,298906,69,332296
14966,0.070002,172.253.118.0-255,5738,304644,69,332296
14967,0.070008,172.31.40.0-255,66,304710,69,332296
14968,0.072515,172.253.118.0-255,5738,310448,69,332296
14969,0.072522,172.31.40.0-255,66,310514,69,332296
14970,0.075027,172.253.118.0-255,5738,316252,69,332296
14971,0.075034,172.31.40.0-255,66,316318,69,332296
14972,0.077525,172.253.118.0-255,5738,322056,69,332296
14973,0.07753,172.31.40.0-255,66,322122,69,332296
14974,0.080028,172.253.118.0-255,5738,327860,69,332296
14975,0.080034,172.31.40.0-255,66,327926,69,332296
14976,0.082537,172.253.118.0-255,4133,332059,69,332296
14977,0.082545,172.31.40.0-255,66,332125,69,332296
14978,0.082737,172.31.40.0-255,105,332230,69,332296
14979,0.085317,172.253.118.0-255,66,332296,69,332296
14980,0.0,74.125.130.0-255,296,296,69,363304
14981,2.1e-05,172.31.40.0-255,66,362,69,363304
14982,2.8e-05,74.125.130.0-255,1484,1846,69,363304
14983,3.2e-05,172.31.40.0-255,66,1912,69,363304
14984,3.9e-05,74.125.130.0-255,2902,4814,69,363304
14985,4.3e-05,172.31.40.0-255,66,4880,69,363304
14986,5e-05,74.125.130.0-255,5738,10618,69,363304
14987,5.4e-05,172.31.40.0-255,66,10684,69,363304
14988,6e-05,74.125.130.0-255,4704,15388,69,363304
14989,6.3e-05,172.31.40.0-255,66,15454,69,363304
14990,8.8e-05,74.125.130.0-255,4320,19774,69,363304
14991,9.1e-05,172.31.40.0-255,66,19840,69,363304
14992,0.000115,74.125.130.0-255,1484,21324,69,363304
14993,0.000118,172.31.40.0-255,66,21390,69,363304
14994,0.000143,172.31.40.0-255,66,21456,69,363304
14995,0.000229,74.125.130.0-255,1484,22940,69,363304
14996,0.000233,172.31.40.0-255,66,23006,69,363304
14997,0.000237,74.125.130.0-255,1484,24490,69,363304
14998,0.00024,172.31.40.0-255,66,24556,69,363304
14999,0.000251,74.125.130.0-255,1484,26040,69,363304
15000,0.000254,172.31.40.0-255,66,26106,69,363304
15001,0.000257,74.125.130.0-255,1484,27590,69,363304
15002,0.000259,172.31.40.0-255,66,27656,69,363304
15003,0.000264,74.125.130.0-255,2902,30558,69,363304
15004,0.000267,172.31.40.0-255,66,30624,69,363304
15005,0.000294,74.125.130.0-255,5738,36362,69,363304
15006,0.000296,172.31.40.0-255,66,36428,69,363304
15007,0.000324,172.31.40.0-255,66,36494,69,363304
15008,0.00035,172.31.40.0-255,66,36560,69,363304
15009,0.000372,74.125.130.0-255,2833,39393,69,363304
15010,0.000375,172.31.40.0-255,66,39459,69,363304
15011,0.000378,74.125.130.0-255,98,39557,69,363304
15012,0.000527,74.125.130.0-255,1484,41041,69,363304
15013,0.000532,172.31.40.0-255,66,41107,69,363304
15014,0.000538,74.125.130.0-255,2902,44009,69,363304
15015,0.00054,172.31.40.0-255,66,44075,69,363304
15016,0.000552,74.125.130.0-255,1484,45559,69,363304
15017,0.000567,74.125.130.0-255,4320,49879,69,363304
15018,0.00057,172.31.40.0-255,66,49945,69,363304
15019,0.000573,74.125.130.0-255,1484,51429,69,363304
15020,0.000587,74.125.130.0-255,2902,54331,69,363304
15021,0.00059,172.31.40.0-255,66,54397,69,363304
15022,0.00061,74.125.130.0-255,2543,56940,69,363304
15023,0.000612,172.31.40.0-255,66,57006,69,363304
15024,0.000624,172.31.40.0-255,66,57072,69,363304
15025,0.00066,74.125.130.0-255,2902,59974,69,363304
15026,0.000664,172.31.40.0-255,66,60040,69,363304
15027,0.000681,74.125.130.0-255,5379,65419,69,363304
15028,0.000684,172.31.40.0-255,66,65485,69,363304
15029,0.000732,74.125.130.0-255,1484,66969,69,363304
15030,0.00075,74.125.130.0-255,1484,68453,69,363304
15031,0.000755,172.31.40.0-255,66,68519,69,363304
15032,0.000763,74.125.130.0-255,1484,70003,69,363304
15033,0.000777,74.125.130.0-255,1484,71487,69,363304
15034,0.00078,172.31.40.0-255,66,71553,69,363304
15035,0.000808,74.125.130.0-255,4320,75873,69,363304
15036,0.000811,172.31.40.0-255,66,75939,69,363304
15037,0.000815,74.125.130.0-255,2902,78841,69,363304
15038,0.000817,172.31.40.0-255,66,78907,69,363304
15039,0.000825,74.125.130.0-255,7156,86063,69,363304
15040,0.000827,172.31.40.0-255,66,86129,69,363304
15041,0.000852,74.125.130.0-255,2902,89031,69,363304
15042,0.000856,172.31.40.0-255,66,89097,69,363304
15043,0.000867,172.31.40.0-255,66,89163,69,363304
15044,0.000893,74.125.130.0-255,2481,91644,69,363304
15045,0.000896,172.31.40.0-255,66,91710,69,363304
15046,0.000977,74.125.130.0-255,1484,93194,69,363304
15047,0.000996,74.125.130.0-255,2902,96096,69,363304
15048,0.001007,172.31.40.0-255,66,96162,69,363304
15049,0.001013,74.125.130.0-255,4320,100482,69,363304
15050,0.001016,172.31.40.0-255,66,100548,69,363304
15051,0.001038,74.125.130.0-255,1484,102032,69,363304
15052,0.001048,74.125.130.0-255,7156,109188,69,363304
15053,0.001051,172.31.40.0-255,66,109254,69,363304
15054,0.001069,74.125.130.0-255,5738,114992,69,363304
15055,0.001072,172.31.40.0-255,66,115058,69,363304
15056,0.0011,74.125.130.0-255,5738,120796,69,363304
15057,0.001104,172.31.40.0-255,66,120862,69,363304
15058,0.001118,74.125.130.0-255,5020,125882,69,363304
15059,0.001121,172.31.40.0-255,66,125948,69,363304
15060,0.001238,74.125.130.0-255,1484,127432,69,363304
15061,0.001256,74.125.130.0-255,2902,130334,69,363304
15062,0.001259,172.31.40.0-255,66,130400,69,363304
15063,0.001283,74.125.130.0-255,4320,134720,69,363304
15064,0.001286,172.31.40.0-255,66,134786,69,363304
15065,0.001291,74.125.130.0-255,4320,139106,69,363304
15066,0.001294,172.31.40.0-255,66,139172,69,363304
15067,0.001315,74.125.130.0-255,4320,143492,69,363304
15068,0.001318,172.31.40.0-255,66,143558,69,363304
15069,0.001325,74.125.130.0-255,5738,149296,69,363304
15070,0.001328,172.31.40.0-255,66,149362,69,363304
15071,0.001334,74.125.130.0-255,5738,155100,69,363304
15072,0.001337,172.31.40.0-255,66,155166,69,363304
15073,0.001359,74.125.130.0-255,1484,156650,69,363304
15074,0.001365,74.125.130.0-255,3602,160252,69,363304
15075,0.001367,172.31.40.0-255,66,160318,69,363304
15076,0.001418,74.125.130.0-255,1484,161802,69,363304
15077,0.001439,74.125.130.0-255,2902,164704,69,363304
15078,0.001442,172.31.40.0-255,66,164770,69,363304
15079,0.001445,74.125.130.0-255,1484,166254,69,363304
15080,0.00146,74.125.130.0-255,2902,169156,69,363304
15081,0.001463,172.31.40.0-255,66,169222,69,363304
15082,0.00148,74.125.130.0-255,1484,170706,69,363304
15083,0.001485,74.125.130.0-255,2902,173608,69,363304
15084,0.001488,172.31.40.0-255,66,173674,69,363304
15085,0.001493,74.125.130.0-255,4320,177994,69,363304
15086,0.001495,172.31.40.0-255,66,178060,69,363304
15087,0.001498,74.125.130.0-255,1484,179544,69,363304
15088,0.001532,74.125.130.0-255,7156,186700,69,363304
15089,0.001536,172.31.40.0-255,66,186766,69,363304
15090,0.001542,74.125.130.0-255,5738,192504,69,363304
15091,0.001544,172.31.40.0-255,66,192570,69,363304
15092,0.001566,74.125.130.0-255,2184,194754,69,363304
15093,0.001568,172.31.40.0-255,66,194820,69,363304
15094,0.001671,74.125.130.0-255,1484,196304,69,363304
15095,0.001696,74.125.130.0-255,2902,199206,69,363304
15096,0.0017,172.31.40.0-255,66,199272,69,363304
15097,0.001707,74.125.130.0-255,5738,205010,69,363304
15098,0.001709,172.31.40.0-255,66,205076,69,363304
15099,0.001711,74.125.130.0-255,1484,206560,69,363304
15100,0.001745,74.125.130.0-255,5738,212298,69,363304
15101,0.001749,172.31.40.0-255,66,212364,69,363304
15102,0.00176,172.31.40.0-255,66,212430,69,363304
15103,0.0018,172.31.40.0-255,66,212496,69,363304
15104,0.001963,74.125.130.0-255,1484,213980,69,363304
15105,0.001969,74.125.130.0-255,2902,216882,69,363304
15106,0.001972,172.31.40.0-255,66,216948,69,363304
15107,0.001995,74.125.130.0-255,4320,221268,69,363304
15108,0.001998,172.31.40.0-255,66,221334,69,363304
15109,0.002002,74.125.130.0-255,2902,224236,69,363304
15110,0.002004,172.31.40.0-255,66,224302,69,363304
15111,0.002019,74.125.130.0-255,2902,227204,69,363304
15112,0.002023,172.31.40.0-255,66,227270,69,363304
15113,0.002033,74.125.130.0-255,2902,230172,69,363304
15114,0.002035,172.31.40.0-255,66,230238,69,363304
15115,0.00204,74.125.130.0-255,2902,233140,69,363304
15116,0.002042,172.31.40.0-255,66,233206,69,363304
15117,0.002077,172.31.40.0-255,66,233272,69,363304
15118,0.00209,74.125.130.0-255,1484,234756,69,363304
15119,0.002093,74.125.130.0-255,766,235522,69,363304
15120,0.002096,172.31.40.0-255,66,235588,69,363304
15121,0.00415,74.125.130.0-255,5738,241326,69,363304
15122,0.004157,172.31.40.0-255,66,241392,69,363304
15123,0.006219,74.125.130.0-255,5738,247130,69,363304
15124,0.006227,172.31.40.0-255,66,247196,69,363304
15125,0.008292,74.125.130.0-255,4320,251516,69,363304
15126,0.008297,172.31.40.0-255,66,251582,69,363304
15127,0.008315,74.125.130.0-255,1484,253066,69,363304
15128,0.010346,74.125.130.0-255,4320,257386,69,363304
15129,0.010352,172.31.40.0-255,66,257452,69,363304
15130,0.012407,74.125.130.0-255,5738,263190,69,363304
15131,0.012413,172.31.40.0-255,66,263256,69,363304
15132,0.014476,74.125.130.0-255,5738,268994,69,363304
15133,0.014488,172.31.40.0-255,66,269060,69,363304
15134,0.016545,74.125.130.0-255,5738,274798,69,363304
15135,0.016558,172.31.40.0-255,66,274864,69,363304
15136,0.018619,74.125.130.0-255,4320,279184,69,363304
15137,0.018626,172.31.40.0-255,66,279250,69,363304
15138,0.018641,74.125.130.0-255,1484,280734,69,363304
15139,0.020689,74.125.130.0-255,4320,285054,69,363304
15140,0.020696,172.31.40.0-255,66,285120,69,363304
15141,0.022771,74.125.130.0-255,5738,290858,69,363304
15142,0.022777,172.31.40.0-255,66,290924,69,363304
15143,0.024843,74.125.130.0-255,5738,296662,69,363304
15144,0.024855,172.31.40.0-255,66,296728,69,363304
15145,0.026912,74.125.130.0-255,5738,302466,69,363304
15146,0.02692,172.31.40.0-255,66,302532,69,363304
15147,0.028987,74.125.130.0-255,5738,308270,69,363304
15148,0.028997,172.31.40.0-255,66,308336,69,363304
15149,0.031057,74.125.130.0-255,5738,314074,69,363304
15150,0.031064,172.31.40.0-255,66,314140,69,363304
15151,0.033168,74.125.130.0-255,5738,319878,69,363304
15152,0.033176,172.31.40.0-255,66,319944,69,363304
15153,0.035244,74.125.130.0-255,5738,325682,69,363304
15154,0.035253,172.31.40.0-255,66,325748,69,363304
15155,0.037318,74.125.130.0-255,5738,331486,69,363304
15156,0.03733,172.31.40.0-255,66,331552,69,363304
15157,0.039393,74.125.130.0-255,4320,335872,69,363304
15158,0.039399,172.31.40.0-255,66,335938,69,363304
15159,0.039427,74.125.130.0-255,1484,337422,69,363304
15160,0.041484,74.125.130.0-255,4320,341742,69,363304
15161,0.041503,172.31.40.0-255,66,341808,69,363304
15162,0.043568,74.125.130.0-255,5738,347546,69,363304
15163,0.043583,172.31.40.0-255,66,347612,69,363304
15164,0.044594,172.31.40.0-255,172,347784,69,363304
15165,0.044621,172.31.40.0-255,1114,348898,69,363304
15166,0.044685,172.31.40.0-255,1514,350412,69,363304
15167,0.044687,172.31.40.0-255,1514,351926,69,363304
15168,0.044688,172.31.40.0-255,1514,353440,69,363304
15169,0.044689,172.31.40.0-255,1514,354954,69,363304
15170,0.044716,172.31.40.0-255,1501,356455,69,363304
15171,0.045639,74.125.130.0-255,4320,360775,69,363304
15172,0.045645,172.31.40.0-255,66,360841,69,363304
15173,0.045661,74.125.130.0-255,1484,362325,69,363304
15174,0.046123,104.244.42.0-255,66,362391,69,363304
15175,0.046176,104.244.42.0-255,66,362457,69,363304
15176,0.046269,104.244.42.0-255,66,362523,69,363304
15177,0.047666,74.125.130.0-255,544,363067,69,363304
15178,0.047673,172.31.40.0-255,66,363133,69,363304
15179,0.047844,172.31.40.0-255,105,363238,69,363304
15180,0.049868,74.125.130.0-255,66,363304,69,363304
15181,0.0,74.125.24.0-255,156,156,69,284013
15182,1.4e-05,172.31.40.0-255,66,222,69,284013
15183,4.3e-05,74.125.24.0-255,1484,1706,69,284013
15184,4.7e-05,172.31.40.0-255,66,1772,69,284013
15185,5.2e-05,74.125.24.0-255,2902,4674,69,284013
15186,5.4e-05,172.31.40.0-255,66,4740,69,284013
15187,6.4e-05,74.125.24.0-255,7156,11896,69,284013
15188,6.7e-05,172.31.40.0-255,66,11962,69,284013
15189,7e-05,74.125.24.0-255,2103,14065,69,284013
15190,7.3e-05,172.31.40.0-255,66,14131,69,284013
15191,0.000104,74.125.24.0-255,5738,19869,69,284013
15192,0.000107,172.31.40.0-255,66,19935,69,284013
15193,0.000126,74.125.24.0-255,5738,25673,69,284013
15194,0.000128,172.31.40.0-255,66,25739,69,284013
15195,0.000131,74.125.24.0-255,1484,27223,69,284013
15196,0.000132,172.31.40.0-255,66,27289,69,284013
15197,0.000152,74.125.24.0-255,3961,31250,69,284013
15198,0.000156,172.31.40.0-255,66,31316,69,284013
15199,0.000325,74.125.24.0-255,1484,32800,69,284013
15200,0.00033,172.31.40.0-255,66,32866,69,284013
15201,0.000335,74.125.24.0-255,2902,35768,69,284013
15202,0.000337,172.31.40.0-255,66,35834,69,284013
15203,0.00034,74.125.24.0-255,1484,37318,69,284013
15204,0.000342,172.31.40.0-255,66,37384,69,284013
15205,0.000359,74.125.24.0-255,4320,41704,69,284013
15206,0.000361,172.31.40.0-255,66,41770,69,284013
15207,0.000386,74.125.24.0-255,5738,47508,69,284013
15208,0.000389,172.31.40.0-255,66,47574,69,284013
15209,0.000413,74.125.24.0-255,6797,54371,69,284013
15210,0.000416,172.31.40.0-255,66,54437,69,284013
15211,0.000433,74.125.24.0-255,1484,55921,69,284013
15212,0.000436,172.31.40.0-255,66,55987,69,284013
15213,0.000462,172.31.40.0-255,66,56053,69,284013
15214,0.001136,74.125.24.0-255,646,56699,69,284013
15215,0.001332,74.125.24.0-255,1484,58183,69,284013
15216,0.001338,172.31.40.0-255,66,58249,69,284013
15217,0.001356,74.125.24.0-255,1484,59733,69,284013
15218,0.001371,74.125.24.0-255,1484,61217,69,284013
15219,0.001373,172.31.40.0-255,66,61283,69,284013
15220,0.00138,74.125.24.0-255,5738,67021,69,284013
15221,0.001381,172.31.40.0-255,66,67087,69,284013
15222,0.001388,74.125.24.0-255,7156,74243,69,284013
15223,0.00139,172.31.40.0-255,66,74309,69,284013
15224,0.001406,74.125.24.0-255,5738,80047,69,284013
15225,0.001408,172.31.40.0-255,66,80113,69,284013
15226,0.001413,74.125.24.0-255,4320,84433,69,284013
15227,0.001415,172.31.40.0-255,66,84499,69,284013
15228,0.00144,74.125.24.0-255,4320,88819,69,284013
15229,0.001442,172.31.40.0-255,66,88885,69,284013
15230,0.001446,74.125.24.0-255,2184,91069,69,284013
15231,0.001448,172.31.40.0-255,66,91135,69,284013
15232,0.002559,74.125.24.0-255,1484,92619,69,284013
15233,0.002565,74.125.24.0-255,2902,95521,69,284013
15234,0.002568,172.31.40.0-255,66,95587,69,284013
15235,0.002572,74.125.24.0-255,1484,97071,69,284013
15236,0.002587,74.125.24.0-255,2902,99973,69,284013
15237,0.002589,172.31.40.0-255,66,100039,69,284013
15238,0.002612,74.125.24.0-255,1484,101523,69,284013
15239,0.002619,74.125.24.0-255,7156,108679,69,284013
15240,0.002621,172.31.40.0-255,66,108745,69,284013
15241,0.002624,74.125.24.0-255,1484,110229,69,284013
15242,0.002638,74.125.24.0-255,4320,114549,69,284013
15243,0.00264,172.31.40.0-255,66,114615,69,284013
15244,0.002656,74.125.24.0-255,5738,120353,69,284013
15245,0.002658,172.31.40.0-255,66,120419,69,284013
15246,0.002662,74.125.24.0-255,1484,121903,69,284013
15247,0.002685,74.125.24.0-255,3602,125505,69,284013
15248,0.002686,172.31.40.0-255,66,125571,69,284013
15249,0.0027,74.125.24.0-255,1484,127055,69,284013
15250,0.002703,74.125.24.0-255,1484,128539,69,284013
15251,0.002706,172.31.40.0-255,66,128605,69,284013
15252,0.002734,74.125.24.0-255,1484,130089,69,284013
15253,0.002741,74.125.24.0-255,5738,135827,69,284013
15254,0.002743,172.31.40.0-255,66,135893,69,284013
15255,0.002747,74.125.24.0-255,2902,138795,69,284013
15256,0.002749,172.31.40.0-255,66,138861,69,284013
15257,0.002785,172.31.40.0-255,66,138927,69,284013
15258,0.002796,172.31.40.0-255,66,138993,69,284013
15259,0.002819,74.125.24.0-255,766,139759,69,284013
15260,0.002841,74.125.24.0-255,1484,141243,69,284013
15261,0.002843,172.31.40.0-255,66,141309,69,284013
15262,0.002848,74.125.24.0-255,2902,144211,69,284013
15263,0.002851,172.31.40.0-255,66,144277,69,284013
15264,0.002868,74.125.24.0-255,1484,145761,69,284013
15265,0.002876,74.125.24.0-255,7156,152917,69,284013
15266,0.002879,172.31.40.0-255,66,152983,69,284013
15267,0.002884,74.125.24.0-255,4320,157303,69,284013
15268,0.002886,172.31.40.0-255,66,157369,69,284013
15269,0.002918,172.31.40.0-255,66,157435,69,284013
15270,0.00292,74.125.24.0-255,1484,158919,69,284013
15271,0.002945,74.125.24.0-255,6438,165357,69,284013
15272,0.002947,172.31.40.0-255,66,165423,69,284013
15273,0.003003,74.125.24.0-255,1484,166907,69,284013
15274,0.003018,74.125.24.0-255,2902,169809,69,284013
15275,0.00302,172.31.40.0-255,66,169875,69,284013
15276,0.003046,74.125.24.0-255,1484,171359,69,284013
15277,0.003062,74.125.24.0-255,4320,175679,69,284013
15278,0.003064,172.31.40.0-255,66,175745,69,284013
15279,0.003067,74.125.24.0-255,1484,177229,69,284013
15280,0.003086,74.125.24.0-255,4320,181549,69,284013
15281,0.003088,172.31.40.0-255,66,181615,69,284013
15282,0.003108,74.125.24.0-255,2902,184517,69,284013
15283,0.00311,172.31.40.0-255,66,184583,69,284013
15284,0.003142,172.31.40.0-255,66,184649,69,284013
15285,0.003165,74.125.24.0-255,6438,191087,69,284013
15286,0.003168,172.31.40.0-255,66,191153,69,284013
15287,0.003225,74.125.24.0-255,1484,192637,69,284013
15288,0.003245,74.125.24.0-255,2902,195539,69,284013
15289,0.003247,172.31.40.0-255,66,195605,69,284013
15290,0.003254,74.125.24.0-255,5738,201343,69,284013
15291,0.003257,172.31.40.0-255,66,201409,69,284013
15292,0.003259,74.125.24.0-255,1484,202893,69,284013
15293,0.003281,74.125.24.0-255,4320,207213,69,284013
15294,0.003284,172.31.40.0-255,66,207279,69,284013
15295,0.00334,74.125.24.0-255,2902,210181,69,284013
15296,0.003343,172.31.40.0-255,66,210247,69,284013
15297,0.003378,172.31.40.0-255,66,210313,69,284013
15298,0.003391,172.31.40.0-255,66,210379,69,284013
15299,0.003405,172.31.40.0-255,66,210445,69,284013
15300,0.00342,172.31.40.0-255,66,210511,69,284013
15301,0.003437,74.125.24.0-255,1484,211995,69,284013
15302,0.003441,74.125.24.0-255,1484,213479,69,284013
15303,0.003443,172.31.40.0-255,66,213545,69,284013
15304,0.00346,74.125.24.0-255,1484,215029,69,284013
15305,0.003466,74.125.24.0-255,4320,219349,69,284013
15306,0.003468,172.31.40.0-255,66,219415,69,284013
15307,0.003471,74.125.24.0-255,1484,220899,69,284013
15308,0.003488,74.125.24.0-255,4320,225219,69,284013
15309,0.003491,172.31.40.0-255,66,225285,69,284013
15310,0.00351,74.125.24.0-255,2902,228187,69,284013
15311,0.003513,172.31.40.0-255,66,228253,69,284013
15312,0.003515,74.125.24.0-255,1484,229737,69,284013
15313,0.003545,172.31.40.0-255,66,229803,69,284013
15314,0.003548,74.125.24.0-255,1484,231287,69,284013
15315,0.003553,74.125.24.0-255,3602,234889,69,284013
15316,0.003556,172.31.40.0-255,66,234955,69,284013
15317,0.003606,74.125.24.0-255,1484,236439,69,284013
15318,0.00361,74.125.24.0-255,1484,237923,69,284013
15319,0.003612,172.31.40.0-255,66,237989,69,284013
15320,0.00363,74.125.24.0-255,1484,239473,69,284013
15321,0.003635,74.125.24.0-255,2902,242375,69,284013
15322,0.003637,172.31.40.0-255,66,242441,69,284013
15323,0.003654,74.125.24.0-255,2902,245343,69,284013
15324,0.003656,172.31.40.0-255,66,245409,69,284013
15325,0.003663,74.125.24.0-255,4320,249729,69,284013
15326,0.003665,172.31.40.0-255,66,249795,69,284013
15327,0.003692,172.31.40.0-255,66,249861,69,284013
15328,0.003697,74.125.24.0-255,2902,252763,69,284013
15329,0.003699,172.31.40.0-255,66,252829,69,284013
15330,0.003722,74.125.24.0-255,4320,257149,69,284013
15331,0.003726,172.31.40.0-255,66,257215,69,284013
15332,0.003733,74.125.24.0-255,7156,264371,69,284013
15333,0.003735,172.31.40.0-255,66,264437,69,284013
15334,0.003771,172.31.40.0-255,66,264503,69,284013
15335,0.003782,172.31.40.0-255,66,264569,69,284013
15336,0.003821,172.31.40.0-255,66,264635,69,284013
15337,0.003839,74.125.24.0-255,2184,266819,69,284013
15338,0.003842,172.31.40.0-255,66,266885,69,284013
15339,0.003847,74.125.24.0-255,2902,269787,69,284013
15340,0.003849,172.31.40.0-255,66,269853,69,284013
15341,0.003876,74.125.24.0-255,4711,274564,69,284013
15342,0.003879,172.31.40.0-255,66,274630,69,284013
15343,0.003896,74.125.24.0-255,105,274735,69,284013
15344,0.006519,172.31.40.0-255,66,274801,69,284013
15345,0.006552,172.31.40.0-255,105,274906,69,284013
15346,0.008619,74.125.24.0-255,66,274972,69,284013
15347,0.038394,172.31.40.0-255,172,275144,69,284013
15348,0.038445,172.31.40.0-255,1114,276258,69,284013
15349,0.038511,172.31.40.0-255,1514,277772,69,284013
15350,0.038512,172.31.40.0-255,1514,279286,69,284013
15351,0.038514,172.31.40.0-255,1514,280800,69,284013
15352,0.038519,172.31.40.0-255,1514,282314,69,284013
15353,0.03852,172.31.40.0-255,1501,283815,69,284013
15354,0.040055,104.244.42.0-255,66,283881,69,284013
15355,0.040122,104.244.42.0-255,66,283947,69,284013
15356,0.040265,104.244.42.0-255,66,284013,69,284013
15357,0.0,172.217.194.0-255,150,150,69,243809
15358,1.7e-05,172.31.40.0-255,66,216,69,243809
15359,2.3e-05,172.217.194.0-255,1484,1700,69,243809
15360,2.8e-05,172.31.40.0-255,66,1766,69,243809
15361,5.7e-05,172.217.194.0-255,2902,4668,69,243809
15362,6.1e-05,172.31.40.0-255,66,4734,69,243809
15363,6.7e-05,172.217.194.0-255,4320,9054,69,243809
15364,7e-05,172.31.40.0-255,66,9120,69,243809
15365,9.7e-05,172.31.40.0-255,66,9186,69,243809
15366,0.000105,172.217.194.0-255,7156,16342,69,243809
15367,0.000108,172.31.40.0-255,66,16408,69,243809
15368,0.000152,172.217.194.0-255,4320,20728,69,243809
15369,0.000155,172.31.40.0-255,66,20794,69,243809
15370,0.000172,172.217.194.0-255,1125,21919,69,243809
15371,0.000175,172.31.40.0-255,66,21985,69,243809
15372,0.000204,172.217.194.0-255,1484,23469,69,243809
15373,0.000207,172.31.40.0-255,66,23535,69,243809
15374,0.000212,172.217.194.0-255,2902,26437,69,243809
15375,0.000214,172.31.40.0-255,66,26503,69,243809
15376,0.00022,172.217.194.0-255,4320,30823,69,243809
15377,0.000222,172.31.40.0-255,66,30889,69,243809
15378,0.000246,172.217.194.0-255,1484,32373,69,243809
15379,0.000248,172.31.40.0-255,66,32439,69,243809
15380,0.000262,172.31.40.0-255,66,32505,69,243809
15381,0.000268,172.217.194.0-255,5738,38243,69,243809
15382,0.000271,172.31.40.0-255,66,38309,69,243809
15383,0.000293,172.217.194.0-255,5738,44047,69,243809
15384,0.000296,172.31.40.0-255,66,44113,69,243809
15385,0.000299,172.217.194.0-255,1429,45542,69,243809
15386,0.000301,172.31.40.0-255,66,45608,69,243809
15387,0.000384,172.217.194.0-255,1484,47092,69,243809
15388,0.000389,172.217.194.0-255,2902,49994,69,243809
15389,0.000393,172.31.40.0-255,66,50060,69,243809
15390,0.000397,172.217.194.0-255,2902,52962,69,243809
15391,0.000399,172.31.40.0-255,66,53028,69,243809
15392,0.000417,172.217.194.0-255,2902,55930,69,243809
15393,0.00042,172.31.40.0-255,66,55996,69,243809
15394,0.000437,172.217.194.0-255,7156,63152,69,243809
15395,0.00044,172.31.40.0-255,66,63218,69,243809
15396,0.000461,172.217.194.0-255,6533,69751,69,243809
15397,0.000464,172.31.40.0-255,66,69817,69,243809
15398,0.000476,172.31.40.0-255,66,69883,69,243809
15399,0.00067,172.217.194.0-255,1484,71367,69,243809
15400,0.000677,172.217.194.0-255,2902,74269,69,243809
15401,0.000681,172.31.40.0-255,66,74335,69,243809
15402,0.000686,172.217.194.0-255,2902,77237,69,243809
15403,0.000689,172.31.40.0-255,66,77303,69,243809
15404,0.000705,172.217.194.0-255,2902,80205,69,243809
15405,0.000713,172.217.194.0-255,7156,87361,69,243809
15406,0.000732,172.217.194.0-255,5738,93099,69,243809
15407,0.000741,172.31.40.0-255,66,93165,69,243809
15408,0.000754,172.217.194.0-255,5738,98903,69,243809
15409,0.00077,172.217.194.0-255,5020,103923,69,243809
15410,0.000784,172.31.40.0-255,66,103989,69,243809
15411,0.000983,172.217.194.0-255,1484,105473,69,243809
15412,0.000989,172.217.194.0-255,2902,108375,69,243809
15413,0.000992,172.31.40.0-255,66,108441,69,243809
15414,0.000996,172.217.194.0-255,1484,109925,69,243809
15415,0.001018,172.217.194.0-255,4320,114245,69,243809
15416,0.001042,172.217.194.0-255,2902,117147,69,243809
15417,0.001045,172.31.40.0-255,66,117213,69,243809
15418,0.0011,172.31.40.0-255,66,117279,69,243809
15419,0.001119,172.217.194.0-255,1484,118763,69,243809
15420,0.001137,172.217.194.0-255,2902,121665,69,243809
15421,0.001142,172.217.194.0-255,2902,124567,69,243809
15422,0.001158,172.217.194.0-255,2902,127469,69,243809
15423,0.001161,172.217.194.0-255,1484,128953,69,243809
15424,0.001166,172.217.194.0-255,2902,131855,69,243809
15425,0.00118,172.217.194.0-255,5738,137593,69,243809
15426,0.001213,172.217.194.0-255,1484,139077,69,243809
15427,0.001232,172.217.194.0-255,7156,146233,69,243809
15428,0.001254,172.217.194.0-255,5020,151253,69,243809
15429,0.001269,172.217.194.0-255,5738,156991,69,243809
15430,0.001271,172.217.194.0-255,1484,158475,69,243809
15431,0.001285,172.217.194.0-255,5738,164213,69,243809
15432,0.001288,172.217.194.0-255,1484,165697,69,243809
15433,0.001332,172.217.194.0-255,6438,172135,69,243809
15434,0.001366,172.217.194.0-255,1484,173619,69,243809
15435,0.00137,172.217.194.0-255,1484,175103,69,243809
15436,0.001384,172.217.194.0-255,1484,176587,69,243809
15437,0.001391,172.217.194.0-255,5738,182325,69,243809
15438,0.001518,172.217.194.0-255,2902,185227,69,243809
15439,0.00154,172.217.194.0-255,1484,186711,69,243809
15440,0.001566,172.217.194.0-255,1484,188195,69,243809
15441,0.001602,172.217.194.0-255,1484,189679,69,243809
15442,0.001653,172.217.194.0-255,1484,191163,69,243809
15443,0.001692,172.217.194.0-255,1484,192647,69,243809
15444,0.001696,172.217.194.0-255,1484,194131,69,243809
15445,0.001708,172.217.194.0-255,1484,195615,69,243809
15446,0.001715,172.217.194.0-255,5738,201353,69,243809
15447,0.001722,172.217.194.0-255,5738,207091,69,243809
15448,0.001735,172.217.194.0-255,2902,209993,69,243809
15449,0.001796,172.217.194.0-255,6438,216431,69,243809
15450,0.001809,172.217.194.0-255,1484,217915,69,243809
15451,0.001846,172.217.194.0-255,7156,225071,69,243809
15452,0.001863,172.217.194.0-255,1484,226555,69,243809
15453,0.001885,172.217.194.0-255,2902,229457,69,243809
15454,0.001936,172.217.194.0-255,4734,234191,69,243809
15455,0.001939,172.217.194.0-255,105,234296,69,243809
15456,0.006337,172.31.40.0-255,66,234362,69,243809
15457,0.006723,172.31.40.0-255,101,234463,69,243809
15458,0.00902,172.217.194.0-255,66,234529,69,243809
15459,0.009301,172.31.40.0-255,105,234634,69,243809
15460,0.011612,172.217.194.0-255,66,234700,69,243809
15461,0.039781,172.31.40.0-255,172,234872,69,243809
15462,0.039816,172.31.40.0-255,1114,235986,69,243809
15463,0.039881,172.31.40.0-255,1514,237500,69,243809
15464,0.039883,172.31.40.0-255,1514,239014,69,243809
15465,0.039884,172.31.40.0-255,1514,240528,69,243809
15466,0.039886,172.31.40.0-255,1514,242042,69,243809
15467,0.039914,172.31.40.0-255,1503,243545,69,243809
15468,0.041325,104.244.42.0-255,66,243611,69,243809
15469,0.041335,104.244.42.0-255,66,243677,69,243809
15470,0.041459,104.244.42.0-255,66,243743,69,243809
15471,0.041464,104.244.42.0-255,66,243809,69,243809
15472,0.0,172.217.24.0-255,150,150,69,316476
15473,2e-05,172.31.40.0-255,66,216,69,316476
15474,2.6e-05,172.217.24.0-255,1484,1700,69,316476
15475,3.1e-05,172.31.40.0-255,66,1766,69,316476
15476,3.6e-05,172.217.24.0-255,2902,4668,69,316476
15477,4e-05,172.31.40.0-255,66,4734,69,316476
15478,6.6e-05,172.217.24.0-255,1484,6218,69,316476
15479,6.9e-05,172.31.40.0-255,66,6284,69,316476
15480,8.9e-05,172.217.24.0-255,2902,9186,69,316476
15481,9.2e-05,172.31.40.0-255,66,9252,69,316476
15482,9.5e-05,172.217.24.0-255,1484,10736,69,316476
15483,9.7e-05,172.31.40.0-255,66,10802,69,316476
15484,0.000125,172.31.40.0-255,66,10868,69,316476
15485,0.000149,172.217.24.0-255,2902,13770,69,316476
15486,0.000152,172.31.40.0-255,66,13836,69,316476
15487,0.000168,172.217.24.0-255,4320,18156,69,316476
15488,0.00017,172.31.40.0-255,66,18222,69,316476
15489,0.000188,172.217.24.0-255,2902,21124,69,316476
15490,0.00019,172.31.40.0-255,66,21190,69,316476
15491,0.000205,172.217.24.0-255,2543,23733,69,316476
15492,0.000207,172.31.40.0-255,66,23799,69,316476
15493,0.000301,172.217.24.0-255,1484,25283,69,316476
15494,0.000304,172.31.40.0-255,66,25349,69,316476
15495,0.000326,172.217.24.0-255,2902,28251,69,316476
15496,0.000328,172.31.40.0-255,66,28317,69,316476
15497,0.000334,172.217.24.0-255,5738,34055,69,316476
15498,0.000336,172.31.40.0-255,66,34121,69,316476
15499,0.000339,172.217.24.0-255,1484,35605,69,316476
15500,0.000341,172.31.40.0-255,66,35671,69,316476
15501,0.000365,172.217.24.0-255,4320,39991,69,316476
15502,0.000368,172.31.40.0-255,66,40057,69,316476
15503,0.000375,172.217.24.0-255,6797,46854,69,316476
15504,0.000577,172.31.40.0-255,66,46920,69,316476
15505,0.001275,172.217.24.0-255,118,47038,69,316476
15506,0.001376,172.217.24.0-255,1484,48522,69,316476
15507,0.001381,172.31.40.0-255,66,48588,69,316476
15508,0.001387,172.217.24.0-255,2902,51490,69,316476
15509,0.001391,172.217.24.0-255,2902,54392,69,316476
15510,0.001409,172.217.24.0-255,2902,57294,69,316476
15511,0.001414,172.217.24.0-255,4320,61614,69,316476
15512,0.001453,172.217.24.0-255,5379,66993,69,316476
15513,0.001478,172.217.24.0-255,5738,72731,69,316476
15514,0.001506,172.217.24.0-255,2902,75633,69,316476
15515,0.00152,172.217.24.0-255,5379,81012,69,316476
15516,0.008764,172.31.40.0-255,66,81078,69,316476
15517,0.010801,172.217.24.0-255,5738,86816,69,316476
15518,0.010809,172.31.40.0-255,66,86882,69,316476
15519,0.012864,172.217.24.0-255,5738,92620,69,316476
15520,0.012875,172.31.40.0-255,66,92686,69,316476
15521,0.014911,172.217.24.0-255,5738,98424,69,316476
15522,0.014919,172.31.40.0-255,66,98490,69,316476
15523,0.016957,172.217.24.0-255,5738,104228,69,316476
15524,0.016975,172.31.40.0-255,66,104294,69,316476
15525,0.019018,172.217.24.0-255,5738,110032,69,316476
15526,0.019034,172.31.40.0-255,66,110098,69,316476
15527,0.021072,172.217.24.0-255,5738,115836,69,316476
15528,0.021081,172.31.40.0-255,66,115902,69,316476
15529,0.02311,172.217.24.0-255,5738,121640,69,316476
15530,0.023118,172.31.40.0-255,66,121706,69,316476
15531,0.025146,172.217.24.0-255,5738,127444,69,316476
15532,0.025153,172.31.40.0-255,66,127510,69,316476
15533,0.027183,172.217.24.0-255,5738,133248,69,316476
15534,0.027189,172.31.40.0-255,66,133314,69,316476
15535,0.029232,172.217.24.0-255,5738,139052,69,316476
15536,0.029246,172.31.40.0-255,66,139118,69,316476
15537,0.031284,172.217.24.0-255,5738,144856,69,316476
15538,0.031293,172.31.40.0-255,66,144922,69,316476
15539,0.033342,172.217.24.0-255,5738,150660,69,316476
15540,0.033351,172.31.40.0-255,66,150726,69,316476
15541,0.035383,172.217.24.0-255,5738,156464,69,316476
15542,0.035392,172.31.40.0-255,66,156530,69,316476
15543,0.036288,172.31.40.0-255,172,156702,69,316476
15544,0.036318,172.31.40.0-255,1116,157818,69,316476
15545,0.0364,172.31.40.0-255,1514,159332,69,316476
15546,0.036402,172.31.40.0-255,1514,160846,69,316476
15547,0.036403,172.31.40.0-255,1514,162360,69,316476
15548,0.036408,172.31.40.0-255,1514,163874,69,316476
15549,0.036409,172.31.40.0-255,1500,165374,69,316476
15550,0.037424,172.217.24.0-255,5738,171112,69,316476
15551,0.037431,172.31.40.0-255,66,171178,69,316476
15552,0.037939,104.244.42.0-255,66,171244,69,316476
15553,0.037948,104.244.42.0-255,66,171310,69,316476
15554,0.038124,104.244.42.0-255,66,171376,69,316476
15555,0.039462,172.217.24.0-255,5738,177114,69,316476
15556,0.039469,172.31.40.0-255,66,177180,69,316476
15557,0.041503,172.217.24.0-255,5738,182918,69,316476
15558,0.041514,172.31.40.0-255,66,182984,69,316476
15559,0.043535,172.217.24.0-255,5738,188722,69,316476
15560,0.043542,172.31.40.0-255,66,188788,69,316476
15561,0.045575,172.217.24.0-255,5738,194526,69,316476
15562,0.045582,172.31.40.0-255,66,194592,69,316476
15563,0.047622,172.217.24.0-255,5738,200330,69,316476
15564,0.04763,172.31.40.0-255,66,200396,69,316476
15565,0.049662,172.217.24.0-255,5738,206134,69,316476
15566,0.049668,172.31.40.0-255,66,206200,69,316476
15567,0.051707,172.217.24.0-255,5738,211938,69,316476
15568,0.051716,172.31.40.0-255,66,212004,69,316476
15569,0.053744,172.217.24.0-255,5738,217742,69,316476
15570,0.053751,172.31.40.0-255,66,217808,69,316476
15571,0.055792,172.217.24.0-255,5738,223546,69,316476
15572,0.055799,172.31.40.0-255,66,223612,69,316476
15573,0.057835,172.217.24.0-255,5738,229350,69,316476
15574,0.057843,172.31.40.0-255,66,229416,69,316476
15575,0.059873,172.217.24.0-255,5738,235154,69,316476
15576,0.059879,172.31.40.0-255,66,235220,69,316476
15577,0.061906,172.217.24.0-255,5738,240958,69,316476
15578,0.061913,172.31.40.0-255,66,241024,69,316476
15579,0.06395,172.217.24.0-255,5738,246762,69,316476
15580,0.063962,172.31.40.0-255,66,246828,69,316476
15581,0.065997,172.217.24.0-255,5738,252566,69,316476
15582,0.066003,172.31.40.0-255,66,252632,69,316476
15583,0.068085,172.217.24.0-255,5738,258370,69,316476
15584,0.068091,172.31.40.0-255,66,258436,69,316476
15585,0.070118,172.217.24.0-255,5738,264174,69,316476
15586,0.070124,172.31.40.0-255,66,264240,69,316476
15587,0.072163,172.217.24.0-255,5738,269978,69,316476
15588,0.072169,172.31.40.0-255,66,270044,69,316476
15589,0.074196,172.217.24.0-255,5738,275782,69,316476
15590,0.074202,172.31.40.0-255,66,275848,69,316476
15591,0.076252,172.217.24.0-255,5738,281586,69,316476
15592,0.076258,172.31.40.0-255,66,281652,69,316476
15593,0.078329,172.217.24.0-255,5738,287390,69,316476
15594,0.078337,172.31.40.0-255,66,287456,69,316476
15595,0.080378,172.217.24.0-255,5738,293194,69,316476
15596,0.080384,172.31.40.0-255,66,293260,69,316476
15597,0.08242,172.217.24.0-255,5738,298998,69,316476
15598,0.082427,172.31.40.0-255,66,299064,69,316476
15599,0.084459,172.217.24.0-255,5738,304802,69,316476
15600,0.084465,172.31.40.0-255,66,304868,69,316476
15601,0.0865,172.217.24.0-255,5738,310606,69,316476
15602,0.086507,172.31.40.0-255,66,310672,69,316476
15603,0.088544,172.217.24.0-255,5738,316410,69,316476
15604,0.08855,172.31.40.0-255,66,316476,69,316476
15605,0.0,74.125.24.0-255,152,152,69,316429
15606,2.4e-05,172.31.40.0-255,66,218,69,316429
15607,3.1e-05,74.125.24.0-255,1484,1702,69,316429
15608,3.6e-05,172.31.40.0-255,66,1768,69,316429
15609,4.9e-05,74.125.24.0-255,2902,4670,69,316429
15610,5.2e-05,172.31.40.0-255,66,4736,69,316429
15611,6e-05,74.125.24.0-255,7156,11892,69,316429
15612,6.3e-05,172.31.40.0-255,66,11958,69,316429
15613,6.7e-05,74.125.24.0-255,2134,14092,69,316429
15614,7e-05,172.31.40.0-255,66,14158,69,316429
15615,0.00012,74.125.24.0-255,1484,15642,69,316429
15616,0.000122,172.31.40.0-255,66,15708,69,316429
15617,0.000127,74.125.24.0-255,2902,18610,69,316429
15618,0.00013,172.31.40.0-255,66,18676,69,316429
15619,0.000134,74.125.24.0-255,2902,21578,69,316429
15620,0.000136,172.31.40.0-255,66,21644,69,316429
15621,0.000154,74.125.24.0-255,2902,24546,69,316429
15622,0.000156,172.31.40.0-255,66,24612,69,316429
15623,0.000164,74.125.24.0-255,6797,31409,69,316429
15624,0.00017,172.31.40.0-255,66,31475,69,316429
15625,0.000259,74.125.24.0-255,1484,32959,69,316429
15626,0.000263,172.31.40.0-255,66,33025,69,316429
15627,0.00027,74.125.24.0-255,2902,35927,69,316429
15628,0.000272,172.31.40.0-255,66,35993,69,316429
15629,0.000278,74.125.24.0-255,5738,41731,69,316429
15630,0.000285,172.31.40.0-255,66,41797,69,316429
15631,0.00032,172.31.40.0-255,66,41863,69,316429
15632,0.000366,74.125.24.0-255,5379,47242,69,316429
15633,0.000369,172.31.40.0-255,66,47308,69,316429
15634,0.000386,172.31.40.0-255,66,47374,69,316429
15635,0.000492,74.125.24.0-255,647,48021,69,316429
15636,0.000811,74.125.24.0-255,1484,49505,69,316429
15637,0.000816,172.31.40.0-255,66,49571,69,316429
15638,0.000822,74.125.24.0-255,2902,52473,69,316429
15639,0.000824,172.31.40.0-255,66,52539,69,316429
15640,0.000847,74.125.24.0-255,5738,58277,69,316429
15641,0.000854,172.31.40.0-255,66,58343,69,316429
15642,0.000859,74.125.24.0-255,2902,61245,69,316429
15643,0.000861,172.31.40.0-255,66,61311,69,316429
15644,0.000873,172.31.40.0-255,66,61377,69,316429
15645,0.000898,74.125.24.0-255,1484,62861,69,316429
15646,0.000961,172.31.40.0-255,66,62927,69,316429
15647,0.00114,74.125.24.0-255,1484,64411,69,316429
15648,0.001147,74.125.24.0-255,2902,67313,69,316429
15649,0.00115,172.31.40.0-255,66,67379,69,316429
15650,0.001182,74.125.24.0-255,5738,73117,69,316429
15651,0.001185,172.31.40.0-255,66,73183,69,316429
15652,0.001198,172.31.40.0-255,66,73249,69,316429
15653,0.001229,74.125.24.0-255,1484,74733,69,316429
15654,0.001232,74.125.24.0-255,766,75499,69,316429
15655,0.001248,172.31.40.0-255,66,75565,69,316429
15656,0.001292,74.125.24.0-255,1484,77049,69,316429
15657,0.001304,74.125.24.0-255,2902,79951,69,316429
15658,0.001322,172.31.40.0-255,66,80017,69,316429
15659,0.001329,74.125.24.0-255,5738,85755,69,316429
15660,0.001335,172.31.40.0-255,66,85821,69,316429
15661,0.001396,172.31.40.0-255,66,85887,69,316429
15662,0.001424,74.125.24.0-255,2184,88071,69,316429
15663,0.001429,172.31.40.0-255,66,88137,69,316429
15664,0.001478,74.125.24.0-255,1484,89621,69,316429
15665,0.001482,74.125.24.0-255,1484,91105,69,316429
15666,0.001494,172.31.40.0-255,66,91171,69,316429
15667,0.001498,74.125.24.0-255,1484,92655,69,316429
15668,0.001504,74.125.24.0-255,5738,98393,69,316429
15669,0.001519,172.31.40.0-255,66,98459,69,316429
15670,0.001546,74.125.24.0-255,4320,102779,69,316429
15671,0.001561,172.31.40.0-255,66,102845,69,316429
15672,0.001584,74.125.24.0-255,7156,110001,69,316429
15673,0.001597,172.31.40.0-255,66,110067,69,316429
15674,0.001606,74.125.24.0-255,3602,113669,69,316429
15675,0.00164,74.125.24.0-255,4320,117989,69,316429
15676,0.001643,74.125.24.0-255,1484,119473,69,316429
15677,0.001654,172.31.40.0-255,66,119539,69,316429
15678,0.001683,74.125.24.0-255,5738,125277,69,316429
15679,0.001704,172.31.40.0-255,66,125343,69,316429
15680,0.001757,172.31.40.0-255,66,125409,69,316429
15681,0.00405,74.125.24.0-255,5738,131147,69,316429
15682,0.004057,172.31.40.0-255,66,131213,69,316429
15683,0.006351,74.125.24.0-255,5738,136951,69,316429
15684,0.006358,172.31.40.0-255,66,137017,69,316429
15685,0.008671,74.125.24.0-255,5738,142755,69,316429
15686,0.008677,172.31.40.0-255,66,142821,69,316429
15687,0.010075,172.31.40.0-255,101,142922,69,316429
15688,0.010992,74.125.24.0-255,5738,148660,69,316429
15689,0.010999,172.31.40.0-255,66,148726,69,316429
15690,0.012334,74.125.24.0-255,66,148792,69,316429
15691,0.01331,74.125.24.0-255,5738,154530,69,316429
15692,0.013321,172.31.40.0-255,66,154596,69,316429
15693,0.015664,74.125.24.0-255,5738,160334,69,316429
15694,0.01568,172.31.40.0-255,66,160400,69,316429
15695,0.018005,74.125.24.0-255,5738,166138,69,316429
15696,0.018022,172.31.40.0-255,66,166204,69,316429
15697,0.020374,74.125.24.0-255,5738,171942,69,316429
15698,0.020382,172.31.40.0-255,66,172008,69,316429
15699,0.02269,74.125.24.0-255,5738,177746,69,316429
15700,0.022698,172.31.40.0-255,66,177812,69,316429
15701,0.025033,74.125.24.0-255,5738,183550,69,316429
15702,0.02504,172.31.40.0-255,66,183616,69,316429
15703,0.027356,74.125.24.0-255,5738,189354,69,316429
15704,0.027364,172.31.40.0-255,66,189420,69,316429
15705,0.029664,74.125.24.0-255,5738,195158,69,316429
15706,0.029671,172.31.40.0-255,66,195224,69,316429
15707,0.031987,74.125.24.0-255,5738,200962,69,316429
15708,0.031995,172.31.40.0-255,66,201028,69,316429
15709,0.034293,74.125.24.0-255,5738,206766,69,316429
15710,0.034301,172.31.40.0-255,66,206832,69,316429
15711,0.036033,172.31.40.0-255,172,207004,69,316429
15712,0.036063,172.31.40.0-255,1111,208115,69,316429
15713,0.036129,172.31.40.0-255,1514,209629,69,316429
15714,0.036131,172.31.40.0-255,1514,211143,69,316429
15715,0.036133,172.31.40.0-255,1514,212657,69,316429
15716,0.036134,172.31.40.0-255,1514,214171,69,316429
15717,0.036135,172.31.40.0-255,548,214719,69,316429
15718,0.036606,74.125.24.0-255,5738,220457,69,316429
15719,0.036613,172.31.40.0-255,66,220523,69,316429
15720,0.037578,104.244.42.0-255,66,220589,69,316429
15721,0.037626,104.244.42.0-255,66,220655,69,316429
15722,0.037728,104.244.42.0-255,66,220721,69,316429
15723,0.037733,104.244.42.0-255,66,220787,69,316429
15724,0.03891,74.125.24.0-255,5738,226525,69,316429
15725,0.038917,172.31.40.0-255,66,226591,69,316429
15726,0.038944,104.244.42.0-255,108,226699,69,316429
15727,0.038948,172.31.40.0-255,66,226765,69,316429
15728,0.041239,74.125.24.0-255,5738,232503,69,316429
15729,0.041248,172.31.40.0-255,66,232569,69,316429
15730,0.043565,74.125.24.0-255,5738,238307,69,316429
15731,0.043572,172.31.40.0-255,66,238373,69,316429
15732,0.045884,74.125.24.0-255,5738,244111,69,316429
15733,0.04589,172.31.40.0-255,66,244177,69,316429
15734,0.048176,74.125.24.0-255,5738,249915,69,316429
15735,0.048183,172.31.40.0-255,66,249981,69,316429
15736,0.050502,74.125.24.0-255,5738,255719,69,316429
15737,0.050509,172.31.40.0-255,66,255785,69,316429
15738,0.052836,74.125.24.0-255,5738,261523,69,316429
15739,0.052843,172.31.40.0-255,66,261589,69,316429
15740,0.055199,74.125.24.0-255,5738,267327,69,316429
15741,0.055207,172.31.40.0-255,66,267393,69,316429
15742,0.05753,74.125.24.0-255,5738,273131,69,316429
15743,0.057538,172.31.40.0-255,66,273197,69,316429
15744,0.05986,74.125.24.0-255,5738,278935,69,316429
15745,0.059866,172.31.40.0-255,66,279001,69,316429
15746,0.062176,74.125.24.0-255,5738,284739,69,316429
15747,0.062184,172.31.40.0-255,66,284805,69,316429
15748,0.064503,74.125.24.0-255,5738,290543,69,316429
15749,0.06451,172.31.40.0-255,66,290609,69,316429
15750,0.066818,74.125.24.0-255,5738,296347,69,316429
15751,0.066825,172.31.40.0-255,66,296413,69,316429
15752,0.069133,74.125.24.0-255,5738,302151,69,316429
15753,0.069139,172.31.40.0-255,66,302217,69,316429
15754,0.071429,74.125.24.0-255,5738,307955,69,316429
15755,0.071437,172.31.40.0-255,66,308021,69,316429
15756,0.073767,74.125.24.0-255,5738,313759,69,316429
15757,0.073776,172.31.40.0-255,66,313825,69,316429
15758,0.07611,74.125.24.0-255,2367,316192,69,316429
15759,0.076118,172.31.40.0-255,66,316258,69,316429
15760,0.076307,172.31.40.0-255,105,316363,69,316429
15761,0.082657,74.125.24.0-255,66,316429,69,316429
15762,0.0,74.125.24.0-255,152,152,69,302523
15763,2.8e-05,172.31.40.0-255,66,218,69,302523
15764,3.6e-05,74.125.24.0-255,1484,1702,69,302523
15765,4.1e-05,172.31.40.0-255,66,1768,69,302523
15766,4.6e-05,74.125.24.0-255,2902,4670,69,302523
15767,4.8e-05,172.31.40.0-255,66,4736,69,302523
15768,5.1e-05,74.125.24.0-255,1484,6220,69,302523
15769,5.4e-05,172.31.40.0-255,66,6286,69,302523
15770,7.2e-05,74.125.24.0-255,1484,7770,69,302523
15771,7.5e-05,172.31.40.0-255,66,7836,69,302523
15772,0.000105,74.125.24.0-255,6317,14153,69,302523
15773,0.000109,172.31.40.0-255,66,14219,69,302523
15774,0.000751,74.125.24.0-255,1484,15703,69,302523
15775,0.000757,172.31.40.0-255,66,15769,69,302523
15776,0.000767,74.125.24.0-255,2902,18671,69,302523
15777,0.00077,172.31.40.0-255,66,18737,69,302523
15778,0.000774,74.125.24.0-255,1484,20221,69,302523
15779,0.000775,172.31.40.0-255,66,20287,69,302523
15780,0.000778,74.125.24.0-255,1484,21771,69,302523
15781,0.00078,172.31.40.0-255,66,21837,69,302523
15782,0.000801,74.125.24.0-255,1484,23321,69,302523
15783,0.000803,172.31.40.0-255,66,23387,69,302523
15784,0.00081,74.125.24.0-255,5738,29125,69,302523
15785,0.000812,172.31.40.0-255,66,29191,69,302523
15786,0.000827,74.125.24.0-255,2543,31734,69,302523
15787,0.000831,172.31.40.0-255,66,31800,69,302523
15788,0.000861,74.125.24.0-255,2902,34702,69,302523
15789,0.000863,172.31.40.0-255,66,34768,69,302523
15790,0.000866,74.125.24.0-255,1484,36252,69,302523
15791,0.000869,172.31.40.0-255,66,36318,69,302523
15792,0.000883,74.125.24.0-255,1484,37802,69,302523
15793,0.000885,172.31.40.0-255,66,37868,69,302523
15794,0.000919,74.125.24.0-255,7156,45024,69,302523
15795,0.000922,172.31.40.0-255,66,45090,69,302523
15796,0.000938,74.125.24.0-255,3961,49051,69,302523
15797,0.000941,172.31.40.0-255,66,49117,69,302523
15798,0.002972,74.125.24.0-255,4320,53437,69,302523
15799,0.00298,172.31.40.0-255,66,53503,69,302523
15800,0.002999,74.125.24.0-255,1484,54987,69,302523
15801,0.005037,74.125.24.0-255,4320,59307,69,302523
15802,0.005044,172.31.40.0-255,66,59373,69,302523
15803,0.007124,74.125.24.0-255,5738,65111,69,302523
15804,0.007131,172.31.40.0-255,66,65177,69,302523
15805,0.009192,74.125.24.0-255,5738,70915,69,302523
15806,0.0092,172.31.40.0-255,66,70981,69,302523
15807,0.011235,74.125.24.0-255,5738,76719,69,302523
15808,0.011242,172.31.40.0-255,66,76785,69,302523
15809,0.013311,74.125.24.0-255,5738,82523,69,302523
15810,0.013319,172.31.40.0-255,66,82589,69,302523
15811,0.015372,74.125.24.0-255,5738,88327,69,302523
15812,0.015383,172.31.40.0-255,66,88393,69,302523
15813,0.017453,74.125.24.0-255,5738,94131,69,302523
15814,0.017459,172.31.40.0-255,66,94197,69,302523
15815,0.019525,74.125.24.0-255,5738,99935,69,302523
15816,0.019532,172.31.40.0-255,66,100001,69,302523
15817,0.021572,74.125.24.0-255,4320,104321,69,302523
15818,0.02158,172.31.40.0-255,66,104387,69,302523
15819,0.021601,74.125.24.0-255,1484,105871,69,302523
15820,0.023632,74.125.24.0-255,4320,110191,69,302523
15821,0.023637,172.31.40.0-255,66,110257,69,302523
15822,0.025719,74.125.24.0-255,5738,115995,69,302523
15823,0.025726,172.31.40.0-255,66,116061,69,302523
15824,0.027803,74.125.24.0-255,5738,121799,69,302523
15825,0.02781,172.31.40.0-255,66,121865,69,302523
15826,0.02855,172.31.40.0-255,172,122037,69,302523
15827,0.028579,172.31.40.0-255,1114,123151,69,302523
15828,0.028644,172.31.40.0-255,1514,124665,69,302523
15829,0.028645,172.31.40.0-255,1514,126179,69,302523
15830,0.028646,172.31.40.0-255,1514,127693,69,302523
15831,0.028651,172.31.40.0-255,1514,129207,69,302523
15832,0.028652,172.31.40.0-255,1504,130711,69,302523
15833,0.029875,74.125.24.0-255,5738,136449,69,302523
15834,0.029882,172.31.40.0-255,66,136515,69,302523
15835,0.030188,104.244.42.0-255,66,136581,69,302523
15836,0.030196,104.244.42.0-255,66,136647,69,302523
15837,0.030336,104.244.42.0-255,66,136713,69,302523
15838,0.030343,104.244.42.0-255,66,136779,69,302523
15839,0.031933,74.125.24.0-255,5738,142517,69,302523
15840,0.03194,172.31.40.0-255,66,142583,69,302523
15841,0.03399,74.125.24.0-255,5738,148321,69,302523
15842,0.033996,172.31.40.0-255,66,148387,69,302523
15843,0.036072,74.125.24.0-255,5738,154125,69,302523
15844,0.03608,172.31.40.0-255,66,154191,69,302523
15845,0.038129,74.125.24.0-255,5738,159929,69,302523
15846,0.038136,172.31.40.0-255,66,159995,69,302523
15847,0.040202,74.125.24.0-255,5738,165733,69,302523
15848,0.040213,172.31.40.0-255,66,165799,69,302523
15849,0.042259,74.125.24.0-255,5738,171537,69,302523
15850,0.042265,172.31.40.0-255,66,171603,69,302523
15851,0.044344,74.125.24.0-255,5738,177341,69,302523
15852,0.044351,172.31.40.0-255,66,177407,69,302523
15853,0.046398,74.125.24.0-255,4320,181727,69,302523
15854,0.046404,172.31.40.0-255,66,181793,69,302523
15855,0.046419,74.125.24.0-255,1484,183277,69,302523
15856,0.048459,74.125.24.0-255,4320,187597,69,302523
15857,0.048466,172.31.40.0-255,66,187663,69,302523
15858,0.050512,74.125.24.0-255,5738,193401,69,302523
15859,0.050518,172.31.40.0-255,66,193467,69,302523
15860,0.052577,74.125.24.0-255,5738,199205,69,302523
15861,0.052584,172.31.40.0-255,66,199271,69,302523
15862,0.054652,74.125.24.0-255,5738,205009,69,302523
15863,0.054658,172.31.40.0-255,66,205075,69,302523
15864,0.056714,74.125.24.0-255,5738,210813,69,302523
15865,0.056719,172.31.40.0-255,66,210879,69,302523
15866,0.05877,74.125.24.0-255,5738,216617,69,302523
15867,0.058777,172.31.40.0-255,66,216683,69,302523
15868,0.060834,74.125.24.0-255,5738,222421,69,302523
15869,0.060841,172.31.40.0-255,66,222487,69,302523
15870,0.062902,74.125.24.0-255,5738,228225,69,302523
15871,0.062909,172.31.40.0-255,66,228291,69,302523
15872,0.064959,74.125.24.0-255,5738,234029,69,302523
15873,0.064965,172.31.40.0-255,66,234095,69,302523
15874,0.067009,74.125.24.0-255,5738,239833,69,302523
15875,0.067015,172.31.40.0-255,66,239899,69,302523
15876,0.069045,74.125.24.0-255,5738,245637,69,302523
15877,0.06905,172.31.40.0-255,66,245703,69,302523
15878,0.071121,74.125.24.0-255,4320,250023,69,302523
15879,0.071127,172.31.40.0-255,66,250089,69,302523
15880,0.071146,74.125.24.0-255,1484,251573,69,302523
15881,0.073182,74.125.24.0-255,4320,255893,69,302523
15882,0.073189,172.31.40.0-255,66,255959,69,302523
15883,0.075261,74.125.24.0-255,5738,261697,69,302523
15884,0.075269,172.31.40.0-255,66,261763,69,302523
15885,0.07732,74.125.24.0-255,5738,267501,69,302523
15886,0.077327,172.31.40.0-255,66,267567,69,302523
15887,0.079409,74.125.24.0-255,5738,273305,69,302523
15888,0.079416,172.31.40.0-255,66,273371,69,302523
15889,0.08148,74.125.24.0-255,5738,279109,69,302523
15890,0.081487,172.31.40.0-255,66,279175,69,302523
15891,0.083542,74.125.24.0-255,5738,284913,69,302523
15892,0.083549,172.31.40.0-255,66,284979,69,302523
15893,0.085596,74.125.24.0-255,5738,290717,69,302523
15894,0.085602,172.31.40.0-255,66,290783,69,302523
15895,0.087654,74.125.24.0-255,2902,293685,69,302523
15896,0.08766,172.31.40.0-255,66,293751,69,302523
15897,0.08768,74.125.24.0-255,2902,296653,69,302523
15898,0.087683,172.31.40.0-255,66,296719,69,302523
15899,0.089715,74.125.24.0-255,5738,302457,69,302523
15900,0.089721,172.31.40.0-255,66,302523,69,302523
15901,0.0,74.125.200.0-255,146,146,69,313326
15902,1.8e-05,172.31.40.0-255,66,212,69,313326
15903,2.5e-05,74.125.200.0-255,1484,1696,69,313326
15904,2.9e-05,172.31.40.0-255,66,1762,69,313326
15905,3.4e-05,74.125.200.0-255,2902,4664,69,313326
15906,3.7e-05,172.31.40.0-255,66,4730,69,313326
15907,4e-05,74.125.200.0-255,1484,6214,69,313326
15908,4.3e-05,172.31.40.0-255,66,6280,69,313326
15909,7e-05,74.125.200.0-255,5738,12018,69,313326
15910,7.3e-05,172.31.40.0-255,66,12084,69,313326
15911,7.7e-05,74.125.200.0-255,2056,14140,69,313326
15912,7.9e-05,172.31.40.0-255,66,14206,69,313326
15913,8.3e-05,74.125.200.0-255,2902,17108,69,313326
15914,8.5e-05,172.31.40.0-255,66,17174,69,313326
15915,0.000106,74.125.200.0-255,1484,18658,69,313326
15916,0.000108,172.31.40.0-255,66,18724,69,313326
15917,0.000123,74.125.200.0-255,5738,24462,69,313326
15918,0.000126,172.31.40.0-255,66,24528,69,313326
15919,0.000164,74.125.200.0-255,6797,31325,69,313326
15920,0.000166,172.31.40.0-255,66,31391,69,313326
15921,0.001523,74.125.200.0-255,1484,32875,69,313326
15922,0.001531,172.31.40.0-255,66,32941,69,313326
15923,0.00154,74.125.200.0-255,2902,35843,69,313326
15924,0.001542,172.31.40.0-255,66,35909,69,313326
15925,0.001548,74.125.200.0-255,4320,40229,69,313326
15926,0.001551,172.31.40.0-255,66,40295,69,313326
15927,0.001568,74.125.200.0-255,1484,41779,69,313326
15928,0.00157,172.31.40.0-255,66,41845,69,313326
15929,0.001578,74.125.200.0-255,6797,48642,69,313326
15930,0.00158,172.31.40.0-255,66,48708,69,313326
15931,0.001611,74.125.200.0-255,5738,54446,69,313326
15932,0.001613,172.31.40.0-255,66,54512,69,313326
15933,0.001634,74.125.200.0-255,1484,55996,69,313326
15934,0.001637,172.31.40.0-255,66,56062,69,313326
15935,0.001643,74.125.200.0-255,5738,61800,69,313326
15936,0.001645,172.31.40.0-255,66,61866,69,313326
15937,0.001689,74.125.200.0-255,2902,64768,69,313326
15938,0.001691,172.31.40.0-255,66,64834,69,313326
15939,0.001707,74.125.200.0-255,1432,66266,69,313326
15940,0.001709,172.31.40.0-255,66,66332,69,313326
15941,0.001712,74.125.200.0-255,113,66445,69,313326
15942,0.001714,172.31.40.0-255,66,66511,69,313326
15943,0.001971,74.125.200.0-255,1484,67995,69,313326
15944,0.001975,172.31.40.0-255,66,68061,69,313326
15945,0.001996,74.125.200.0-255,2902,70963,69,313326
15946,0.001999,172.31.40.0-255,66,71029,69,313326
15947,0.002002,74.125.200.0-255,1484,72513,69,313326
15948,0.002004,172.31.40.0-255,66,72579,69,313326
15949,0.002025,74.125.200.0-255,4320,76899,69,313326
15950,0.002028,172.31.40.0-255,66,76965,69,313326
15951,0.002031,74.125.200.0-255,1484,78449,69,313326
15952,0.002033,172.31.40.0-255,66,78515,69,313326
15953,0.002038,74.125.200.0-255,2902,81417,69,313326
15954,0.00204,172.31.40.0-255,66,81483,69,313326
15955,0.002062,74.125.200.0-255,2902,84385,69,313326
15956,0.002079,74.125.200.0-255,3961,88346,69,313326
15957,0.002086,74.125.200.0-255,5738,94084,69,313326
15958,0.002089,74.125.200.0-255,1484,95568,69,313326
15959,0.002103,74.125.200.0-255,5379,100947,69,313326
15960,0.005284,172.31.40.0-255,66,101013,69,313326
15961,0.007629,74.125.200.0-255,2902,103915,69,313326
15962,0.007635,172.31.40.0-255,66,103981,69,313326
15963,0.007653,74.125.200.0-255,2902,106883,69,313326
15964,0.007655,172.31.40.0-255,66,106949,69,313326
15965,0.009989,74.125.200.0-255,5738,112687,69,313326
15966,0.009997,172.31.40.0-255,66,112753,69,313326
15967,0.012339,74.125.200.0-255,5738,118491,69,313326
15968,0.012348,172.31.40.0-255,66,118557,69,313326
15969,0.014701,74.125.200.0-255,5738,124295,69,313326
15970,0.014711,172.31.40.0-255,66,124361,69,313326
15971,0.017053,74.125.200.0-255,5738,130099,69,313326
15972,0.01706,172.31.40.0-255,66,130165,69,313326
15973,0.019413,74.125.200.0-255,5738,135903,69,313326
15974,0.019421,172.31.40.0-255,66,135969,69,313326
15975,0.021757,74.125.200.0-255,5738,141707,69,313326
15976,0.021764,172.31.40.0-255,66,141773,69,313326
15977,0.02411,74.125.200.0-255,5738,147511,69,313326
15978,0.024119,172.31.40.0-255,66,147577,69,313326
15979,0.026461,74.125.200.0-255,5738,153315,69,313326
15980,0.02647,172.31.40.0-255,66,153381,69,313326
15981,0.028825,74.125.200.0-255,5738,159119,69,313326
15982,0.028836,172.31.40.0-255,66,159185,69,313326
15983,0.030077,172.31.40.0-255,172,159357,69,313326
15984,0.030132,172.31.40.0-255,1116,160473,69,313326
15985,0.030205,172.31.40.0-255,1514,161987,69,313326
15986,0.030207,172.31.40.0-255,1514,163501,69,313326
15987,0.030208,172.31.40.0-255,1514,165015,69,313326
15988,0.030214,172.31.40.0-255,1514,166529,69,313326
15989,0.030215,172.31.40.0-255,1499,168028,69,313326
15990,0.03121,74.125.200.0-255,5738,173766,69,313326
15991,0.031217,172.31.40.0-255,66,173832,69,313326
15992,0.031742,104.244.42.0-255,66,173898,69,313326
15993,0.031791,104.244.42.0-255,66,173964,69,313326
15994,0.031889,104.244.42.0-255,66,174030,69,313326
15995,0.033576,74.125.200.0-255,5738,179768,69,313326
15996,0.033585,172.31.40.0-255,66,179834,69,313326
15997,0.035949,74.125.200.0-255,5738,185572,69,313326
15998,0.035955,172.31.40.0-255,66,185638,69,313326
15999,0.038306,74.125.200.0-255,5738,191376,69,313326
16000,0.038313,172.31.40.0-255,66,191442,69,313326
16001,0.040678,74.125.200.0-255,5738,197180,69,313326
16002,0.040685,172.31.40.0-255,66,197246,69,313326
16003,0.043048,74.125.200.0-255,5738,202984,69,313326
16004,0.043059,172.31.40.0-255,66,203050,69,313326
16005,0.045436,74.125.200.0-255,5738,208788,69,313326
16006,0.045442,172.31.40.0-255,66,208854,69,313326
16007,0.047802,74.125.200.0-255,5738,214592,69,313326
16008,0.047808,172.31.40.0-255,66,214658,69,313326
16009,0.050153,74.125.200.0-255,5738,220396,69,313326
16010,0.05016,172.31.40.0-255,66,220462,69,313326
16011,0.052506,74.125.200.0-255,5738,226200,69,313326
16012,0.052512,172.31.40.0-255,66,226266,69,313326
16013,0.054859,74.125.200.0-255,5738,232004,69,313326
16014,0.054866,172.31.40.0-255,66,232070,69,313326
16015,0.057209,74.125.200.0-255,5738,237808,69,313326
16016,0.057216,172.31.40.0-255,66,237874,69,313326
16017,0.059562,74.125.200.0-255,5738,243612,69,313326
16018,0.059568,172.31.40.0-255,66,243678,69,313326
16019,0.061943,74.125.200.0-255,5738,249416,69,313326
16020,0.061951,172.31.40.0-255,66,249482,69,313326
16021,0.064311,74.125.200.0-255,5738,255220,69,313326
16022,0.064317,172.31.40.0-255,66,255286,69,313326
16023,0.066671,74.125.200.0-255,5738,261024,69,313326
16024,0.066676,172.31.40.0-255,66,261090,69,313326
16025,0.069031,74.125.200.0-255,5738,266828,69,313326
16026,0.069038,172.31.40.0-255,66,266894,69,313326
16027,0.071384,74.125.200.0-255,5738,272632,69,313326
16028,0.07139,172.31.40.0-255,66,272698,69,313326
16029,0.073743,74.125.200.0-255,5738,278436,69,313326
16030,0.073749,172.31.40.0-255,66,278502,69,313326
16031,0.076094,74.125.200.0-255,5738,284240,69,313326
16032,0.076101,172.31.40.0-255,66,284306,69,313326
16033,0.078449,74.125.200.0-255,5738,290044,69,313326
16034,0.078456,172.31.40.0-255,66,290110,69,313326
16035,0.080819,74.125.200.0-255,5738,295848,69,313326
16036,0.080825,172.31.40.0-255,66,295914,69,313326
16037,0.083173,74.125.200.0-255,5738,301652,69,313326
16038,0.083179,172.31.40.0-255,66,301718,69,313326
16039,0.085535,74.125.200.0-255,5738,307456,69,313326
16040,0.085541,172.31.40.0-255,66,307522,69,313326
16041,0.087893,74.125.200.0-255,5738,313260,69,313326
16042,0.087898,172.31.40.0-255,66,313326,69,313326
16043,0.0,172.31.40.0-255,105,105,69,276
16044,0.001919,157.240.7.0-255,105,210,69,276
16045,0.001933,172.31.40.0-255,66,276,69,276
16046,0.0,74.125.24.0-255,146,146,69,320839
16047,2.3e-05,172.31.40.0-255,66,212,69,320839
16048,3.1e-05,74.125.24.0-255,1484,1696,69,320839
16049,3.5e-05,172.31.40.0-255,66,1762,69,320839
16050,4e-05,74.125.24.0-255,2902,4664,69,320839
16051,4.3e-05,172.31.40.0-255,66,4730,69,320839
16052,5e-05,74.125.24.0-255,7156,11886,69,320839
16053,5.4e-05,172.31.40.0-255,66,11952,69,320839
16054,8.9e-05,74.125.24.0-255,2064,14016,69,320839
16055,9.2e-05,172.31.40.0-255,66,14082,69,320839
16056,0.000122,74.125.24.0-255,2902,16984,69,320839
16057,0.000124,172.31.40.0-255,66,17050,69,320839
16058,0.000127,74.125.24.0-255,1484,18534,69,320839
16059,0.000129,172.31.40.0-255,66,18600,69,320839
16060,0.000147,74.125.24.0-255,5738,24338,69,320839
16061,0.00015,172.31.40.0-255,66,24404,69,320839
16062,0.000186,74.125.24.0-255,4320,28724,69,320839
16063,0.000188,172.31.40.0-255,66,28790,69,320839
16064,0.000216,74.125.24.0-255,2543,31333,69,320839
16065,0.000218,172.31.40.0-255,66,31399,69,320839
16066,0.0004,74.125.24.0-255,1484,32883,69,320839
16067,0.000404,172.31.40.0-255,66,32949,69,320839
16068,0.000423,74.125.24.0-255,2902,35851,69,320839
16069,0.000427,172.31.40.0-255,66,35917,69,320839
16070,0.00045,74.125.24.0-255,5738,41655,69,320839
16071,0.000452,172.31.40.0-255,66,41721,69,320839
16072,0.000473,74.125.24.0-255,5738,47459,69,320839
16073,0.000475,172.31.40.0-255,66,47525,69,320839
16074,0.000494,74.125.24.0-255,1125,48650,69,320839
16075,0.000496,172.31.40.0-255,66,48716,69,320839
16076,0.000504,74.125.24.0-255,7156,55872,69,320839
16077,0.000506,172.31.40.0-255,66,55938,69,320839
16078,0.000545,172.31.40.0-255,66,56004,69,320839
16079,0.000587,74.125.24.0-255,344,56348,69,320839
16080,0.001061,172.31.40.0-255,66,56414,69,320839
16081,0.001302,74.125.24.0-255,1484,57898,69,320839
16082,0.001312,74.125.24.0-255,2902,60800,69,320839
16083,0.001316,172.31.40.0-255,66,60866,69,320839
16084,0.001323,74.125.24.0-255,5738,66604,69,320839
16085,0.001325,172.31.40.0-255,66,66670,69,320839
16086,0.001355,74.125.24.0-255,5738,72408,69,320839
16087,0.001358,172.31.40.0-255,66,72474,69,320839
16088,0.001374,74.125.24.0-255,7156,79630,69,320839
16089,0.001377,172.31.40.0-255,66,79696,69,320839
16090,0.001389,172.31.40.0-255,66,79762,69,320839
16091,0.001408,74.125.24.0-255,766,80528,69,320839
16092,0.003572,74.125.24.0-255,4320,84848,69,320839
16093,0.003579,172.31.40.0-255,66,84914,69,320839
16094,0.005785,74.125.24.0-255,5738,90652,69,320839
16095,0.005791,172.31.40.0-255,66,90718,69,320839
16096,0.007973,74.125.24.0-255,5738,96456,69,320839
16097,0.00798,172.31.40.0-255,66,96522,69,320839
16098,0.010169,74.125.24.0-255,5738,102260,69,320839
16099,0.010176,172.31.40.0-255,66,102326,69,320839
16100,0.012362,74.125.24.0-255,5738,108064,69,320839
16101,0.01237,172.31.40.0-255,66,108130,69,320839
16102,0.01455,74.125.24.0-255,1484,109614,69,320839
16103,0.014577,74.125.24.0-255,4320,113934,69,320839
16104,0.014584,172.31.40.0-255,66,114000,69,320839
16105,0.01678,74.125.24.0-255,5738,119738,69,320839
16106,0.016789,172.31.40.0-255,66,119804,69,320839
16107,0.018979,74.125.24.0-255,5738,125542,69,320839
16108,0.018986,172.31.40.0-255,66,125608,69,320839
16109,0.021196,74.125.24.0-255,5738,131346,69,320839
16110,0.021203,172.31.40.0-255,66,131412,69,320839
16111,0.023379,74.125.24.0-255,5738,137150,69,320839
16112,0.023385,172.31.40.0-255,66,137216,69,320839
16113,0.025585,74.125.24.0-255,5738,142954,69,320839
16114,0.025592,172.31.40.0-255,66,143020,69,320839
16115,0.027783,74.125.24.0-255,2902,145922,69,320839
16116,0.027791,172.31.40.0-255,66,145988,69,320839
16117,0.027817,74.125.24.0-255,2902,148890,69,320839
16118,0.02782,172.31.40.0-255,66,148956,69,320839
16119,0.029982,74.125.24.0-255,5738,154694,69,320839
16120,0.029987,172.31.40.0-255,66,154760,69,320839
16121,0.03074,172.31.40.0-255,172,154932,69,320839
16122,0.030773,172.31.40.0-255,1114,156046,69,320839
16123,0.030839,172.31.40.0-255,1514,157560,69,320839
16124,0.030841,172.31.40.0-255,1514,159074,69,320839
16125,0.030843,172.31.40.0-255,1514,160588,69,320839
16126,0.030844,172.31.40.0-255,1514,162102,69,320839
16127,0.030874,172.31.40.0-255,1501,163603,69,320839
16128,0.032198,74.125.24.0-255,5738,169341,69,320839
16129,0.032205,172.31.40.0-255,66,169407,69,320839
16130,0.032561,104.244.42.0-255,66,169473,69,320839
16131,0.032596,104.244.42.0-255,66,169539,69,320839
16132,0.032617,104.244.42.0-255,66,169605,69,320839
16133,0.03263,104.244.42.0-255,66,169671,69,320839
16134,0.034414,74.125.24.0-255,5738,175409,69,320839
16135,0.034425,172.31.40.0-255,66,175475,69,320839
16136,0.036605,74.125.24.0-255,5738,181213,69,320839
16137,0.036611,172.31.40.0-255,66,181279,69,320839
16138,0.038783,74.125.24.0-255,5738,187017,69,320839
16139,0.038788,172.31.40.0-255,66,187083,69,320839
16140,0.040988,74.125.24.0-255,5738,192821,69,320839
16141,0.040994,172.31.40.0-255,66,192887,69,320839
16142,0.043198,74.125.24.0-255,5738,198625,69,320839
16143,0.043204,172.31.40.0-255,66,198691,69,320839
16144,0.045468,74.125.24.0-255,5738,204429,69,320839
16145,0.045474,172.31.40.0-255,66,204495,69,320839
16146,0.047674,74.125.24.0-255,5738,210233,69,320839
16147,0.047681,172.31.40.0-255,66,210299,69,320839
16148,0.049884,74.125.24.0-255,2902,213201,69,320839
16149,0.04989,172.31.40.0-255,66,213267,69,320839
16150,0.049911,74.125.24.0-255,2902,216169,69,320839
16151,0.049914,172.31.40.0-255,66,216235,69,320839
16152,0.052087,74.125.24.0-255,5738,221973,69,320839
16153,0.052093,172.31.40.0-255,66,222039,69,320839
16154,0.054283,74.125.24.0-255,5738,227777,69,320839
16155,0.054289,172.31.40.0-255,66,227843,69,320839
16156,0.056473,74.125.24.0-255,5738,233581,69,320839
16157,0.056482,172.31.40.0-255,66,233647,69,320839
16158,0.058686,74.125.24.0-255,5738,239385,69,320839
16159,0.058693,172.31.40.0-255,66,239451,69,320839
16160,0.060894,74.125.24.0-255,5738,245189,69,320839
16161,0.0609,172.31.40.0-255,66,245255,69,320839
16162,0.063081,74.125.24.0-255,5738,250993,69,320839
16163,0.063088,172.31.40.0-255,66,251059,69,320839
16164,0.06527,74.125.24.0-255,5738,256797,69,320839
16165,0.065277,172.31.40.0-255,66,256863,69,320839
16166,0.067488,74.125.24.0-255,5738,262601,69,320839
16167,0.067494,172.31.40.0-255,66,262667,69,320839
16168,0.06968,74.125.24.0-255,5738,268405,69,320839
16169,0.069687,172.31.40.0-255,66,268471,69,320839
16170,0.071865,74.125.24.0-255,5738,274209,69,320839
16171,0.071872,172.31.40.0-255,66,274275,69,320839
16172,0.074076,74.125.24.0-255,5738,280013,69,320839
16173,0.074084,172.31.40.0-255,66,280079,69,320839
16174,0.076258,74.125.24.0-255,5738,285817,69,320839
16175,0.076265,172.31.40.0-255,66,285883,69,320839
16176,0.07843,74.125.24.0-255,2902,288785,69,320839
16177,0.078436,172.31.40.0-255,66,288851,69,320839
16178,0.078457,74.125.24.0-255,2902,291753,69,320839
16179,0.078461,172.31.40.0-255,66,291819,69,320839
16180,0.080653,74.125.24.0-255,5738,297557,69,320839
16181,0.080661,172.31.40.0-255,66,297623,69,320839
16182,0.082854,74.125.24.0-255,5738,303361,69,320839
16183,0.082861,172.31.40.0-255,66,303427,69,320839
16184,0.08505,74.125.24.0-255,5738,309165,69,320839
16185,0.085056,172.31.40.0-255,66,309231,69,320839
16186,0.087258,74.125.24.0-255,5738,314969,69,320839
16187,0.087264,172.31.40.0-255,66,315035,69,320839
16188,0.08946,74.125.24.0-255,5738,320773,69,320839
16189,0.089465,172.31.40.0-255,66,320839,69,320839
16190,0.0,74.125.200.0-255,153,153,69,379793
16191,1e-05,172.31.40.0-255,66,219,69,379793
16192,3.8e-05,74.125.200.0-255,1484,1703,69,379793
16193,4.2e-05,172.31.40.0-255,66,1769,69,379793
16194,4.7e-05,74.125.200.0-255,2902,4671,69,379793
16195,4.9e-05,172.31.40.0-255,66,4737,69,379793
16196,6.9e-05,74.125.200.0-255,1484,6221,69,379793
16197,7e-05,172.31.40.0-255,66,6287,69,379793
16198,8.4e-05,74.125.200.0-255,2902,9189,69,379793
16199,8.6e-05,172.31.40.0-255,66,9255,69,379793
16200,9.8e-05,74.125.200.0-255,1484,10739,69,379793
16201,0.0001,172.31.40.0-255,66,10805,69,379793
16202,0.000105,74.125.200.0-255,3493,14298,69,379793
16203,0.000108,172.31.40.0-255,66,14364,69,379793
16204,0.000132,74.125.200.0-255,4320,18684,69,379793
16205,0.000134,172.31.40.0-255,66,18750,69,379793
16206,0.000139,74.125.200.0-255,4320,23070,69,379793
16207,0.000141,172.31.40.0-255,66,23136,69,379793
16208,0.000156,74.125.200.0-255,5738,28874,69,379793
16209,0.000158,172.31.40.0-255,66,28940,69,379793
16210,0.000162,74.125.200.0-255,2543,31483,69,379793
16211,0.000164,172.31.40.0-255,66,31549,69,379793
16212,0.000324,74.125.200.0-255,1484,33033,69,379793
16213,0.000328,172.31.40.0-255,66,33099,69,379793
16214,0.000332,74.125.200.0-255,1484,34583,69,379793
16215,0.000334,172.31.40.0-255,66,34649,69,379793
16216,0.000348,74.125.200.0-255,2902,37551,69,379793
16217,0.00035,172.31.40.0-255,66,37617,69,379793
16218,0.000373,74.125.200.0-255,5738,43355,69,379793
16219,0.000375,172.31.40.0-255,66,43421,69,379793
16220,0.000402,74.125.200.0-255,4320,47741,69,379793
16221,0.000404,172.31.40.0-255,66,47807,69,379793
16222,0.000426,74.125.200.0-255,3961,51768,69,379793
16223,0.000428,172.31.40.0-255,66,51834,69,379793
16224,0.000434,74.125.200.0-255,5738,57572,69,379793
16225,0.000437,172.31.40.0-255,66,57638,69,379793
16226,0.000451,74.125.200.0-255,2902,60540,69,379793
16227,0.000453,172.31.40.0-255,66,60606,69,379793
16228,0.000459,74.125.200.0-255,5379,65985,69,379793
16229,0.000461,172.31.40.0-255,66,66051,69,379793
16230,0.000463,74.125.200.0-255,645,66696,69,379793
16231,0.000621,74.125.200.0-255,1484,68180,69,379793
16232,0.000624,172.31.40.0-255,66,68246,69,379793
16233,0.000646,74.125.200.0-255,2902,71148,69,379793
16234,0.000649,172.31.40.0-255,66,71214,69,379793
16235,0.000658,74.125.200.0-255,1484,72698,69,379793
16236,0.00067,74.125.200.0-255,2902,75600,69,379793
16237,0.000672,172.31.40.0-255,66,75666,69,379793
16238,0.000689,74.125.200.0-255,1484,77150,69,379793
16239,0.000691,74.125.200.0-255,1484,78634,69,379793
16240,0.000695,172.31.40.0-255,66,78700,69,379793
16241,0.000729,74.125.200.0-255,4320,83020,69,379793
16242,0.000732,172.31.40.0-255,66,83086,69,379793
16243,0.000744,74.125.200.0-255,1125,84211,69,379793
16244,0.000857,74.125.200.0-255,1484,85695,69,379793
16245,0.000861,172.31.40.0-255,66,85761,69,379793
16246,0.000878,74.125.200.0-255,2902,88663,69,379793
16247,0.00088,172.31.40.0-255,66,88729,69,379793
16248,0.000904,74.125.200.0-255,4320,93049,69,379793
16249,0.000906,172.31.40.0-255,66,93115,69,379793
16250,0.000952,74.125.200.0-255,2902,96017,69,379793
16251,0.000955,172.31.40.0-255,66,96083,69,379793
16252,0.000971,74.125.200.0-255,5379,101462,69,379793
16253,0.000974,172.31.40.0-255,66,101528,69,379793
16254,0.001591,74.125.200.0-255,1484,103012,69,379793
16255,0.0016,74.125.200.0-255,2902,105914,69,379793
16256,0.001604,172.31.40.0-255,66,105980,69,379793
16257,0.00164,74.125.200.0-255,5738,111718,69,379793
16258,0.001642,172.31.40.0-255,66,111784,69,379793
16259,0.001662,74.125.200.0-255,1484,113268,69,379793
16260,0.001679,74.125.200.0-255,5738,119006,69,379793
16261,0.001681,172.31.40.0-255,66,119072,69,379793
16262,0.001685,74.125.200.0-255,2902,121974,69,379793
16263,0.001687,172.31.40.0-255,66,122040,69,379793
16264,0.001705,74.125.200.0-255,5738,127778,69,379793
16265,0.001706,172.31.40.0-255,66,127844,69,379793
16266,0.001737,74.125.200.0-255,4320,132164,69,379793
16267,0.001739,172.31.40.0-255,66,132230,69,379793
16268,0.001759,74.125.200.0-255,3602,135832,69,379793
16269,0.001761,172.31.40.0-255,66,135898,69,379793
16270,0.00326,74.125.200.0-255,1484,137382,69,379793
16271,0.003284,74.125.200.0-255,2902,140284,69,379793
16272,0.003288,172.31.40.0-255,66,140350,69,379793
16273,0.003302,74.125.200.0-255,1484,141834,69,379793
16274,0.003305,74.125.200.0-255,1484,143318,69,379793
16275,0.003307,172.31.40.0-255,66,143384,69,379793
16276,0.003331,74.125.200.0-255,4320,147704,69,379793
16277,0.003334,172.31.40.0-255,66,147770,69,379793
16278,0.003366,74.125.200.0-255,1484,149254,69,379793
16279,0.003371,74.125.200.0-255,2902,152156,69,379793
16280,0.003373,172.31.40.0-255,66,152222,69,379793
16281,0.003401,74.125.200.0-255,5738,157960,69,379793
16282,0.003403,172.31.40.0-255,66,158026,69,379793
16283,0.003406,74.125.200.0-255,1484,159510,69,379793
16284,0.003422,74.125.200.0-255,1484,160994,69,379793
16285,0.003424,172.31.40.0-255,66,161060,69,379793
16286,0.00343,74.125.200.0-255,4320,165380,69,379793
16287,0.003432,172.31.40.0-255,66,165446,69,379793
16288,0.003435,74.125.200.0-255,1484,166930,69,379793
16289,0.003451,74.125.200.0-255,1484,168414,69,379793
16290,0.003453,172.31.40.0-255,66,168480,69,379793
16291,0.003472,74.125.200.0-255,1484,169964,69,379793
16292,0.003475,74.125.200.0-255,766,170730,69,379793
16293,0.003477,172.31.40.0-255,66,170796,69,379793
16294,0.003726,74.125.200.0-255,1484,172280,69,379793
16295,0.003741,74.125.200.0-255,2902,175182,69,379793
16296,0.003744,172.31.40.0-255,66,175248,69,379793
16297,0.003758,74.125.200.0-255,4320,179568,69,379793
16298,0.00376,172.31.40.0-255,66,179634,69,379793
16299,0.003771,74.125.200.0-255,1484,181118,69,379793
16300,0.003776,74.125.200.0-255,2902,184020,69,379793
16301,0.003778,172.31.40.0-255,66,184086,69,379793
16302,0.003801,74.125.200.0-255,4320,188406,69,379793
16303,0.003804,172.31.40.0-255,66,188472,69,379793
16304,0.003818,74.125.200.0-255,5738,194210,69,379793
16305,0.003821,172.31.40.0-255,66,194276,69,379793
16306,0.003849,172.31.40.0-255,66,194342,69,379793
16307,0.003852,74.125.200.0-255,1484,195826,69,379793
16308,0.003855,74.125.200.0-255,766,196592,69,379793
16309,0.003857,172.31.40.0-255,66,196658,69,379793
16310,0.003891,74.125.200.0-255,1484,198142,69,379793
16311,0.003906,74.125.200.0-255,4320,202462,69,379793
16312,0.003908,172.31.40.0-255,66,202528,69,379793
16313,0.003934,74.125.200.0-255,5738,208266,69,379793
16314,0.003937,172.31.40.0-255,66,208332,69,379793
16315,0.003965,74.125.200.0-255,2902,211234,69,379793
16316,0.003968,172.31.40.0-255,66,211300,69,379793
16317,0.003982,74.125.200.0-255,4320,215620,69,379793
16318,0.003984,172.31.40.0-255,66,215686,69,379793
16319,0.003987,74.125.200.0-255,1484,217170,69,379793
16320,0.004015,74.125.200.0-255,2902,220072,69,379793
16321,0.004017,172.31.40.0-255,66,220138,69,379793
16322,0.004024,74.125.200.0-255,5738,225876,69,379793
16323,0.004026,172.31.40.0-255,66,225942,69,379793
16324,0.00403,74.125.200.0-255,2902,228844,69,379793
16325,0.004033,172.31.40.0-255,66,228910,69,379793
16326,0.004036,74.125.200.0-255,2184,231094,69,379793
16327,0.004039,172.31.40.0-255,66,231160,69,379793
16328,0.004166,74.125.200.0-255,1484,232644,69,379793
16329,0.004183,74.125.200.0-255,1484,234128,69,379793
16330,0.004186,172.31.40.0-255,66,234194,69,379793
16331,0.004201,74.125.200.0-255,2902,237096,69,379793
16332,0.004204,172.31.40.0-255,66,237162,69,379793
16333,0.004223,74.125.200.0-255,1484,238646,69,379793
16334,0.004246,74.125.200.0-255,2902,241548,69,379793
16335,0.004249,172.31.40.0-255,66,241614,69,379793
16336,0.004252,74.125.200.0-255,1484,243098,69,379793
16337,0.00427,74.125.200.0-255,4320,247418,69,379793
16338,0.004273,172.31.40.0-255,66,247484,69,379793
16339,0.004276,74.125.200.0-255,1484,248968,69,379793
16340,0.00429,74.125.200.0-255,1484,250452,69,379793
16341,0.004292,172.31.40.0-255,66,250518,69,379793
16342,0.004298,74.125.200.0-255,4320,254838,69,379793
16343,0.0043,172.31.40.0-255,66,254904,69,379793
16344,0.004322,74.125.200.0-255,1484,256388,69,379793
16345,0.004338,74.125.200.0-255,4320,260708,69,379793
16346,0.00434,172.31.40.0-255,66,260774,69,379793
16347,0.004383,74.125.200.0-255,1484,262258,69,379793
16348,0.004398,74.125.200.0-255,1484,263742,69,379793
16349,0.004401,172.31.40.0-255,66,263808,69,379793
16350,0.004412,74.125.200.0-255,2184,265992,69,379793
16351,0.004415,172.31.40.0-255,66,266058,69,379793
16352,0.004441,74.125.200.0-255,1484,267542,69,379793
16353,0.004445,74.125.200.0-255,1484,269026,69,379793
16354,0.004447,172.31.40.0-255,66,269092,69,379793
16355,0.004463,74.125.200.0-255,1484,270576,69,379793
16356,0.00447,74.125.200.0-255,5738,276314,69,379793
16357,0.004473,172.31.40.0-255,66,276380,69,379793
16358,0.004509,74.125.200.0-255,2902,279282,69,379793
16359,0.004512,172.31.40.0-255,66,279348,69,379793
16360,0.004534,74.125.200.0-255,1484,280832,69,379793
16361,0.004541,74.125.200.0-255,5738,286570,69,379793
16362,0.004544,172.31.40.0-255,66,286636,69,379793
16363,0.004555,172.31.40.0-255,66,286702,69,379793
16364,0.004571,74.125.200.0-255,1484,288186,69,379793
16365,0.004607,172.31.40.0-255,66,288252,69,379793
16366,0.004612,74.125.200.0-255,2902,291154,69,379793
16367,0.004613,172.31.40.0-255,66,291220,69,379793
16368,0.004633,74.125.200.0-255,1484,292704,69,379793
16369,0.004672,172.31.40.0-255,66,292770,69,379793
16370,0.004678,74.125.200.0-255,5738,298508,69,379793
16371,0.004681,172.31.40.0-255,66,298574,69,379793
16372,0.0047,74.125.200.0-255,2184,300758,69,379793
16373,0.004703,172.31.40.0-255,66,300824,69,379793
16374,0.004737,74.125.200.0-255,1484,302308,69,379793
16375,0.004754,74.125.200.0-255,1484,303792,69,379793
16376,0.004757,172.31.40.0-255,66,303858,69,379793
16377,0.004759,74.125.200.0-255,1484,305342,69,379793
16378,0.004764,74.125.200.0-255,2902,308244,69,379793
16379,0.004767,172.31.40.0-255,66,308310,69,379793
16380,0.004791,74.125.200.0-255,5738,314048,69,379793
16381,0.004795,172.31.40.0-255,66,314114,69,379793
16382,0.004817,74.125.200.0-255,5738,319852,69,379793
16383,0.00482,172.31.40.0-255,66,319918,69,379793
16384,0.004827,74.125.200.0-255,7156,327074,69,379793
16385,0.004829,172.31.40.0-255,66,327140,69,379793
16386,0.004848,74.125.200.0-255,1484,328624,69,379793
16387,0.004865,74.125.200.0-255,6438,335062,69,379793
16388,0.004868,172.31.40.0-255,66,335128,69,379793
16389,0.004886,74.125.200.0-255,1484,336612,69,379793
16390,0.004908,74.125.200.0-255,7156,343768,69,379793
16391,0.004911,172.31.40.0-255,66,343834,69,379793
16392,0.004915,74.125.200.0-255,2902,346736,69,379793
16393,0.004918,172.31.40.0-255,66,346802,69,379793
16394,0.004958,172.31.40.0-255,66,346868,69,379793
16395,0.004965,74.125.200.0-255,7156,354024,69,379793
16396,0.004968,172.31.40.0-255,66,354090,69,379793
16397,0.004989,74.125.200.0-255,4320,358410,69,379793
16398,0.004992,172.31.40.0-255,66,358476,69,379793
16399,0.005016,74.125.200.0-255,3602,362078,69,379793
16400,0.00502,172.31.40.0-255,66,362144,69,379793
16401,0.005025,74.125.200.0-255,4320,366464,69,379793
16402,0.005027,172.31.40.0-255,66,366530,69,379793
16403,0.005061,74.125.200.0-255,3713,370243,69,379793
16404,0.005064,172.31.40.0-255,66,370309,69,379793
16405,0.005089,74.125.200.0-255,105,370414,69,379793
16406,0.006427,172.31.40.0-255,101,370515,69,379793
16407,0.007942,172.31.40.0-255,105,370620,69,379793
16408,0.008788,74.125.200.0-255,66,370686,69,379793
16409,0.010305,74.125.200.0-255,66,370752,69,379793
16410,0.036332,172.31.40.0-255,172,370924,69,379793
16411,0.036367,172.31.40.0-255,1112,372036,69,379793
16412,0.036433,172.31.40.0-255,1514,373550,69,379793
16413,0.036435,172.31.40.0-255,1514,375064,69,379793
16414,0.036436,172.31.40.0-255,1514,376578,69,379793
16415,0.03644,172.31.40.0-255,1514,378092,69,379793
16416,0.036441,172.31.40.0-255,1503,379595,69,379793
16417,0.038001,104.244.42.0-255,66,379661,69,379793
16418,0.038061,104.244.42.0-255,66,379727,69,379793
16419,0.038159,104.244.42.0-255,66,379793,69,379793
16420,0.0,172.217.194.0-255,151,151,69,289091
16421,2.3e-05,172.31.40.0-255,66,217,69,289091
16422,3e-05,172.217.194.0-255,1484,1701,69,289091
16423,3.5e-05,172.31.40.0-255,66,1767,69,289091
16424,3.8e-05,172.217.194.0-255,1484,3251,69,289091
16425,4.2e-05,172.31.40.0-255,66,3317,69,289091
16426,6.9e-05,172.217.194.0-255,1484,4801,69,289091
16427,7.2e-05,172.31.40.0-255,66,4867,69,289091
16428,8e-05,172.217.194.0-255,5738,10605,69,289091
16429,8.3e-05,172.31.40.0-255,66,10671,69,289091
16430,0.000116,172.217.194.0-255,3580,14251,69,289091
16431,0.000119,172.31.40.0-255,66,14317,69,289091
16432,0.000457,172.217.194.0-255,1484,15801,69,289091
16433,0.000464,172.31.40.0-255,66,15867,69,289091
16434,0.000469,172.217.194.0-255,2902,18769,69,289091
16435,0.000472,172.31.40.0-255,66,18835,69,289091
16436,0.000478,172.217.194.0-255,4320,23155,69,289091
16437,0.00048,172.31.40.0-255,66,23221,69,289091
16438,0.000503,172.217.194.0-255,1484,24705,69,289091
16439,0.000505,172.31.40.0-255,66,24771,69,289091
16440,0.000534,172.31.40.0-255,66,24837,69,289091
16441,0.000564,172.217.194.0-255,3961,28798,69,289091
16442,0.000567,172.31.40.0-255,66,28864,69,289091
16443,0.00058,172.31.40.0-255,66,28930,69,289091
16444,0.000584,172.217.194.0-255,1484,30414,69,289091
16445,0.000586,172.31.40.0-255,66,30480,69,289091
16446,0.000626,172.31.40.0-255,66,30546,69,289091
16447,0.000653,172.217.194.0-255,3602,34148,69,289091
16448,0.000656,172.31.40.0-255,66,34214,69,289091
16449,0.000659,172.217.194.0-255,676,34890,69,289091
16450,0.000693,172.217.194.0-255,1484,36374,69,289091
16451,0.000696,172.31.40.0-255,66,36440,69,289091
16452,0.0007,172.217.194.0-255,1484,37924,69,289091
16453,0.000733,172.217.194.0-255,1484,39408,69,289091
16454,0.000736,172.31.40.0-255,66,39474,69,289091
16455,0.000744,172.217.194.0-255,5738,45212,69,289091
16456,0.000747,172.31.40.0-255,66,45278,69,289091
16457,0.000759,172.31.40.0-255,66,45344,69,289091
16458,0.000834,172.31.40.0-255,66,45410,69,289091
16459,0.001549,172.217.194.0-255,1484,46894,69,289091
16460,0.001559,172.217.194.0-255,2902,49796,69,289091
16461,0.001563,172.31.40.0-255,66,49862,69,289091
16462,0.001582,172.217.194.0-255,2902,52764,69,289091
16463,0.001584,172.31.40.0-255,66,52830,69,289091
16464,0.001613,172.217.194.0-255,2902,55732,69,289091
16465,0.001617,172.31.40.0-255,66,55798,69,289091
16466,0.001625,172.217.194.0-255,7156,62954,69,289091
16467,0.001627,172.31.40.0-255,66,63020,69,289091
16468,0.001639,172.31.40.0-255,66,63086,69,289091
16469,0.001656,172.217.194.0-255,2902,65988,69,289091
16470,0.001659,172.31.40.0-255,66,66054,69,289091
16471,0.001663,172.217.194.0-255,2184,68238,69,289091
16472,0.001664,172.31.40.0-255,66,68304,69,289091
16473,0.001735,172.217.194.0-255,1484,69788,69,289091
16474,0.001741,172.217.194.0-255,2902,72690,69,289091
16475,0.001744,172.31.40.0-255,66,72756,69,289091
16476,0.001749,172.217.194.0-255,2902,75658,69,289091
16477,0.001751,172.31.40.0-255,66,75724,69,289091
16478,0.001767,172.217.194.0-255,2902,78626,69,289091
16479,0.001769,172.31.40.0-255,66,78692,69,289091
16480,0.001774,172.217.194.0-255,4320,83012,69,289091
16481,0.001776,172.31.40.0-255,66,83078,69,289091
16482,0.001806,172.217.194.0-255,5738,88816,69,289091
16483,0.001808,172.31.40.0-255,66,88882,69,289091
16484,0.001823,172.217.194.0-255,2902,91784,69,289091
16485,0.001825,172.31.40.0-255,66,91850,69,289091
16486,0.001851,172.31.40.0-255,66,91916,69,289091
16487,0.004438,172.217.194.0-255,4320,96236,69,289091
16488,0.004445,172.31.40.0-255,66,96302,69,289091
16489,0.004464,172.217.194.0-255,1484,97786,69,289091
16490,0.007013,172.217.194.0-255,4320,102106,69,289091
16491,0.007019,172.31.40.0-255,66,102172,69,289091
16492,0.009629,172.217.194.0-255,5738,107910,69,289091
16493,0.009636,172.31.40.0-255,66,107976,69,289091
16494,0.012258,172.217.194.0-255,5738,113714,69,289091
16495,0.012266,172.31.40.0-255,66,113780,69,289091
16496,0.014891,172.217.194.0-255,5738,119518,69,289091
16497,0.014899,172.31.40.0-255,66,119584,69,289091
16498,0.017463,172.217.194.0-255,5738,125322,69,289091
16499,0.017473,172.31.40.0-255,66,125388,69,289091
16500,0.020034,172.217.194.0-255,5738,131126,69,289091
16501,0.020041,172.31.40.0-255,66,131192,69,289091
16502,0.022603,172.217.194.0-255,1484,132676,69,289091
16503,0.022625,172.217.194.0-255,4320,136996,69,289091
16504,0.022629,172.31.40.0-255,66,137062,69,289091
16505,0.025261,172.217.194.0-255,5738,142800,69,289091
16506,0.025267,172.31.40.0-255,66,142866,69,289091
16507,0.02563,172.31.40.0-255,172,143038,69,289091
16508,0.02567,172.31.40.0-255,1111,144149,69,289091
16509,0.025742,172.31.40.0-255,1514,145663,69,289091
16510,0.025744,172.31.40.0-255,1514,147177,69,289091
16511,0.025746,172.31.40.0-255,1514,148691,69,289091
16512,0.025747,172.31.40.0-255,1514,150205,69,289091
16513,0.025748,172.31.40.0-255,546,150751,69,289091
16514,0.027176,104.244.42.0-255,66,150817,69,289091
16515,0.027229,104.244.42.0-255,66,150883,69,289091
16516,0.027317,104.244.42.0-255,66,150949,69,289091
16517,0.027321,104.244.42.0-255,66,151015,69,289091
16518,0.027889,172.217.194.0-255,4320,155335,69,289091
16519,0.027894,172.31.40.0-255,66,155401,69,289091
16520,0.027913,172.217.194.0-255,1484,156885,69,289091
16521,0.030515,172.217.194.0-255,4320,161205,69,289091
16522,0.030521,172.31.40.0-255,66,161271,69,289091
16523,0.033147,172.217.194.0-255,5738,167009,69,289091
16524,0.033159,172.31.40.0-255,66,167075,69,289091
16525,0.035797,172.217.194.0-255,5738,172813,69,289091
16526,0.035805,172.31.40.0-255,66,172879,69,289091
16527,0.038382,172.217.194.0-255,5738,178617,69,289091
16528,0.038389,172.31.40.0-255,66,178683,69,289091
16529,0.041053,172.217.194.0-255,5738,184421,69,289091
16530,0.041074,172.31.40.0-255,66,184487,69,289091
16531,0.043675,172.217.194.0-255,5738,190225,69,289091
16532,0.04369,172.31.40.0-255,66,190291,69,289091
16533,0.046352,172.217.194.0-255,5738,196029,69,289091
16534,0.046371,172.31.40.0-255,66,196095,69,289091
16535,0.048943,172.217.194.0-255,5738,201833,69,289091
16536,0.04895,172.31.40.0-255,66,201899,69,289091
16537,0.051534,172.217.194.0-255,5738,207637,69,289091
16538,0.051541,172.31.40.0-255,66,207703,69,289091
16539,0.054132,172.217.194.0-255,2902,210605,69,289091
16540,0.054137,172.31.40.0-255,66,210671,69,289091
16541,0.054157,172.217.194.0-255,2902,213573,69,289091
16542,0.05416,172.31.40.0-255,66,213639,69,289091
16543,0.056762,172.217.194.0-255,5738,219377,69,289091
16544,0.056768,172.31.40.0-255,66,219443,69,289091
16545,0.059349,172.217.194.0-255,5738,225181,69,289091
16546,0.059356,172.31.40.0-255,66,225247,69,289091
16547,0.061995,172.217.194.0-255,5738,230985,69,289091
16548,0.062001,172.31.40.0-255,66,231051,69,289091
16549,0.06464,172.217.194.0-255,5738,236789,69,289091
16550,0.064646,172.31.40.0-255,66,236855,69,289091
16551,0.067214,172.217.194.0-255,5738,242593,69,289091
16552,0.067224,172.31.40.0-255,66,242659,69,289091
16553,0.069791,172.217.194.0-255,5738,248397,69,289091
16554,0.069798,172.31.40.0-255,66,248463,69,289091
16555,0.072387,172.217.194.0-255,5738,254201,69,289091
16556,0.072391,172.31.40.0-255,66,254267,69,289091
16557,0.074989,172.217.194.0-255,5738,260005,69,289091
16558,0.074995,172.31.40.0-255,66,260071,69,289091
16559,0.077619,172.217.194.0-255,5738,265809,69,289091
16560,0.077626,172.31.40.0-255,66,265875,69,289091
16561,0.080243,172.217.194.0-255,5738,271613,69,289091
16562,0.080249,172.31.40.0-255,66,271679,69,289091
16563,0.082867,172.217.194.0-255,5738,277417,69,289091
16564,0.082874,172.31.40.0-255,66,277483,69,289091
16565,0.085495,172.217.194.0-255,5738,283221,69,289091
16566,0.085501,172.31.40.0-255,66,283287,69,289091
16567,0.088052,172.217.194.0-255,5738,289025,69,289091
16568,0.088058,172.31.40.0-255,66,289091,69,289091
16569,0.0,172.217.194.0-255,297,297,69,265104
16570,2.1e-05,172.31.40.0-255,66,363,69,265104
16571,2.8e-05,172.217.194.0-255,1484,1847,69,265104
16572,3.1e-05,172.31.40.0-255,66,1913,69,265104
16573,3.8e-05,172.217.194.0-255,4320,6233,69,265104
16574,4.1e-05,172.31.40.0-255,66,6299,69,265104
16575,4.8e-05,172.217.194.0-255,7156,13455,69,265104
16576,5.2e-05,172.31.40.0-255,66,13521,69,265104
16577,5.4e-05,172.217.194.0-255,407,13928,69,265104
16578,5.7e-05,172.31.40.0-255,66,13994,69,265104
16579,0.000127,172.217.194.0-255,1484,15478,69,265104
16580,0.00013,172.31.40.0-255,66,15544,69,265104
16581,0.000148,172.217.194.0-255,4320,19864,69,265104
16582,0.000151,172.31.40.0-255,66,19930,69,265104
16583,0.000157,172.217.194.0-255,5738,25668,69,265104
16584,0.000159,172.31.40.0-255,66,25734,69,265104
16585,0.000181,172.217.194.0-255,1484,27218,69,265104
16586,0.000183,172.31.40.0-255,66,27284,69,265104
16587,0.000191,172.217.194.0-255,6797,34081,69,265104
16588,0.000193,172.31.40.0-255,66,34147,69,265104
16589,0.000208,172.217.194.0-255,2902,37049,69,265104
16590,0.00021,172.31.40.0-255,66,37115,69,265104
16591,0.000227,172.217.194.0-255,4320,41435,69,265104
16592,0.00023,172.31.40.0-255,66,41501,69,265104
16593,0.000232,172.217.194.0-255,1484,42985,69,265104
16594,0.000234,172.31.40.0-255,66,43051,69,265104
16595,0.000256,172.217.194.0-255,5379,48430,69,265104
16596,0.000259,172.31.40.0-255,66,48496,69,265104
16597,0.00028,172.217.194.0-255,2902,51398,69,265104
16598,0.000282,172.31.40.0-255,66,51464,69,265104
16599,0.000304,172.217.194.0-255,4320,55784,69,265104
16600,0.000307,172.31.40.0-255,66,55850,69,265104
16601,0.000313,172.217.194.0-255,5738,61588,69,265104
16602,0.000315,172.31.40.0-255,66,61654,69,265104
16603,0.000341,172.217.194.0-255,2902,64556,69,265104
16604,0.000344,172.31.40.0-255,66,64622,69,265104
16605,0.000355,172.217.194.0-255,1451,66073,69,265104
16606,0.000373,172.217.194.0-255,381,66454,69,265104
16607,0.000375,172.31.40.0-255,66,66520,69,265104
16608,0.000724,172.217.194.0-255,1484,68004,69,265104
16609,0.00073,172.217.194.0-255,2902,70906,69,265104
16610,0.000734,172.31.40.0-255,66,70972,69,265104
16611,0.00074,172.217.194.0-255,4320,75292,69,265104
16612,0.000742,172.31.40.0-255,66,75358,69,265104
16613,0.000754,172.217.194.0-255,1484,76842,69,265104
16614,0.00076,172.217.194.0-255,2902,79744,69,265104
16615,0.000762,172.31.40.0-255,66,79810,69,265104
16616,0.000787,172.217.194.0-255,7156,86966,69,265104
16617,0.000789,172.31.40.0-255,66,87032,69,265104
16618,0.000802,172.217.194.0-255,4320,91352,69,265104
16619,0.000804,172.31.40.0-255,66,91418,69,265104
16620,0.000843,172.31.40.0-255,66,91484,69,265104
16621,0.001068,172.217.194.0-255,1484,92968,69,265104
16622,0.001074,172.217.194.0-255,2902,95870,69,265104
16623,0.001078,172.31.40.0-255,66,95936,69,265104
16624,0.001084,172.217.194.0-255,4320,100256,69,265104
16625,0.001086,172.31.40.0-255,66,100322,69,265104
16626,0.001097,172.217.194.0-255,1484,101806,69,265104
16627,0.001104,172.217.194.0-255,5738,107544,69,265104
16628,0.001106,172.31.40.0-255,66,107610,69,265104
16629,0.001128,172.217.194.0-255,2902,110512,69,265104
16630,0.001131,172.31.40.0-255,66,110578,69,265104
16631,0.001164,172.217.194.0-255,1484,112062,69,265104
16632,0.001201,172.31.40.0-255,66,112128,69,265104
16633,0.001207,172.217.194.0-255,1484,113612,69,265104
16634,0.001209,172.217.194.0-255,1484,115096,69,265104
16635,0.001214,172.31.40.0-255,66,115162,69,265104
16636,0.001221,172.217.194.0-255,1484,116646,69,265104
16637,0.001227,172.217.194.0-255,4320,120966,69,265104
16638,0.00124,172.217.194.0-255,1484,122450,69,265104
16639,0.001242,172.217.194.0-255,1484,123934,69,265104
16640,0.001252,172.217.194.0-255,2902,126836,69,265104
16641,0.001271,172.31.40.0-255,66,126902,69,265104
16642,0.001275,172.31.40.0-255,66,126968,69,265104
16643,0.001288,172.217.194.0-255,2902,129870,69,265104
16644,0.001301,172.217.194.0-255,4320,134190,69,265104
16645,0.001305,172.31.40.0-255,66,134256,69,265104
16646,0.001329,172.217.194.0-255,4320,138576,69,265104
16647,0.001339,172.31.40.0-255,66,138642,69,265104
16648,0.001364,172.217.194.0-255,4320,142962,69,265104
16649,0.001376,172.31.40.0-255,66,143028,69,265104
16650,0.00141,172.217.194.0-255,1484,144512,69,265104
16651,0.001417,172.31.40.0-255,66,144578,69,265104
16652,0.001425,172.217.194.0-255,2902,147480,69,265104
16653,0.001429,172.31.40.0-255,66,147546,69,265104
16654,0.001451,172.217.194.0-255,1484,149030,69,265104
16655,0.001458,172.31.40.0-255,66,149096,69,265104
16656,0.001488,172.31.40.0-255,66,149162,69,265104
16657,0.001495,172.217.194.0-255,5738,154900,69,265104
16658,0.001499,172.217.194.0-255,3602,158502,69,265104
16659,0.001504,172.31.40.0-255,66,158568,69,265104
16660,0.001527,172.217.194.0-255,1484,160052,69,265104
16661,0.001531,172.217.194.0-255,2902,162954,69,265104
16662,0.001536,172.217.194.0-255,5738,168692,69,265104
16663,0.001549,172.31.40.0-255,66,168758,69,265104
16664,0.001552,172.217.194.0-255,1484,170242,69,265104
16665,0.001583,172.217.194.0-255,2902,173144,69,265104
16666,0.001588,172.31.40.0-255,66,173210,69,265104
16667,0.001619,172.217.194.0-255,2902,176112,69,265104
16668,0.001625,172.31.40.0-255,66,176178,69,265104
16669,0.001649,172.217.194.0-255,5020,181198,69,265104
16670,0.001654,172.31.40.0-255,66,181264,69,265104
16671,0.001791,172.217.194.0-255,1484,182748,69,265104
16672,0.001805,172.217.194.0-255,2902,185650,69,265104
16673,0.001822,172.217.194.0-255,5738,191388,69,265104
16674,0.00183,172.31.40.0-255,66,191454,69,265104
16675,0.001955,172.31.40.0-255,66,191520,69,265104
16676,0.001999,172.31.40.0-255,66,191586,69,265104
16677,0.002062,172.217.194.0-255,1484,193070,69,265104
16678,0.002066,172.217.194.0-255,1484,194554,69,265104
16679,0.002071,172.31.40.0-255,66,194620,69,265104
16680,0.002088,172.217.194.0-255,1484,196104,69,265104
16681,0.002095,172.217.194.0-255,5738,201842,69,265104
16682,0.002101,172.31.40.0-255,66,201908,69,265104
16683,0.00212,172.31.40.0-255,66,201974,69,265104
16684,0.002129,172.217.194.0-255,4320,206294,69,265104
16685,0.002137,172.217.194.0-255,7156,213450,69,265104
16686,0.002151,172.217.194.0-255,3602,217052,69,265104
16687,0.002167,172.31.40.0-255,66,217118,69,265104
16688,0.002244,172.217.194.0-255,1484,218602,69,265104
16689,0.002259,172.217.194.0-255,2902,221504,69,265104
16690,0.002262,172.217.194.0-255,1484,222988,69,265104
16691,0.002275,172.217.194.0-255,2902,225890,69,265104
16692,0.002284,172.31.40.0-255,66,225956,69,265104
16693,0.002297,172.217.194.0-255,1484,227440,69,265104
16694,0.002303,172.217.194.0-255,5738,233178,69,265104
16695,0.002327,172.217.194.0-255,2902,236080,69,265104
16696,0.002341,172.217.194.0-255,5020,241100,69,265104
16697,0.002345,172.31.40.0-255,66,241166,69,265104
16698,0.004619,172.217.194.0-255,5738,246904,69,265104
16699,0.004623,172.31.40.0-255,66,246970,69,265104
16700,0.00692,172.217.194.0-255,5738,252708,69,265104
16701,0.006927,172.31.40.0-255,66,252774,69,265104
16702,0.009221,172.217.194.0-255,4142,256916,69,265104
16703,0.009226,172.31.40.0-255,66,256982,69,265104
16704,0.011954,172.31.40.0-255,105,257087,69,265104
16705,0.014183,172.217.194.0-255,66,257153,69,265104
16706,0.032428,172.31.40.0-255,172,257325,69,265104
16707,0.032462,172.31.40.0-255,1116,258441,69,265104
16708,0.032535,172.31.40.0-255,1514,259955,69,265104
16709,0.032537,172.31.40.0-255,1514,261469,69,265104
16710,0.032538,172.31.40.0-255,1514,262983,69,265104
16711,0.032539,172.31.40.0-255,1514,264497,69,265104
16712,0.03254,172.31.40.0-255,541,265038,69,265104
16713,0.034118,104.244.42.0-255,66,265104,69,265104
16714,0.0,74.125.68.0-255,153,153,69,358953
16715,1.8e-05,172.31.40.0-255,66,219,69,358953
16716,2.6e-05,74.125.68.0-255,1484,1703,69,358953
16717,3.1e-05,172.31.40.0-255,66,1769,69,358953
16718,3.5e-05,74.125.68.0-255,1484,3253,69,358953
16719,4.6e-05,172.31.40.0-255,66,3319,69,358953
16720,5.3e-05,74.125.68.0-255,2902,6221,69,358953
16721,5.6e-05,172.31.40.0-255,66,6287,69,358953
16722,5.9e-05,74.125.68.0-255,1484,7771,69,358953
16723,6.1e-05,172.31.40.0-255,66,7837,69,358953
16724,8.5e-05,74.125.68.0-255,4320,12157,69,358953
16725,8.8e-05,172.31.40.0-255,66,12223,69,358953
16726,9.8e-05,74.125.68.0-255,2055,14278,69,358953
16727,0.0001,172.31.40.0-255,66,14344,69,358953
16728,0.000104,74.125.68.0-255,2902,17246,69,358953
16729,0.000106,172.31.40.0-255,66,17312,69,358953
16730,0.000111,74.125.68.0-255,2902,20214,69,358953
16731,0.000114,172.31.40.0-255,66,20280,69,358953
16732,0.000148,74.125.68.0-255,4320,24600,69,358953
16733,0.000151,172.31.40.0-255,66,24666,69,358953
16734,0.000158,74.125.68.0-255,6797,31463,69,358953
16735,0.00016,172.31.40.0-255,66,31529,69,358953
16736,0.000216,74.125.68.0-255,1484,33013,69,358953
16737,0.000219,172.31.40.0-255,66,33079,69,358953
16738,0.000224,74.125.68.0-255,2902,35981,69,358953
16739,0.000226,172.31.40.0-255,66,36047,69,358953
16740,0.000242,74.125.68.0-255,1484,37531,69,358953
16741,0.000245,172.31.40.0-255,66,37597,69,358953
16742,0.000268,74.125.68.0-255,4320,41917,69,358953
16743,0.00027,172.31.40.0-255,66,41983,69,358953
16744,0.00028,74.125.68.0-255,4320,46303,69,358953
16745,0.000283,172.31.40.0-255,66,46369,69,358953
16746,0.000303,74.125.68.0-255,1484,47853,69,358953
16747,0.000305,74.125.68.0-255,1125,48978,69,358953
16748,0.000324,172.31.40.0-255,66,49044,69,358953
16749,0.000349,74.125.68.0-255,1484,50528,69,358953
16750,0.000355,74.125.68.0-255,2902,53430,69,358953
16751,0.000371,74.125.68.0-255,5738,59168,69,358953
16752,0.000394,74.125.68.0-255,6797,65965,69,358953
16753,0.000428,74.125.68.0-255,646,66611,69,358953
16754,0.000571,172.31.40.0-255,66,66677,69,358953
16755,0.00064,74.125.68.0-255,1484,68161,69,358953
16756,0.000645,74.125.68.0-255,1484,69645,69,358953
16757,0.00065,172.31.40.0-255,66,69711,69,358953
16758,0.000658,74.125.68.0-255,1484,71195,69,358953
16759,0.000669,74.125.68.0-255,2902,74097,69,358953
16760,0.000674,172.31.40.0-255,66,74163,69,358953
16761,0.000693,74.125.68.0-255,2902,77065,69,358953
16762,0.000697,74.125.68.0-255,1484,78549,69,358953
16763,0.000713,74.125.68.0-255,5738,84287,69,358953
16764,0.000735,172.31.40.0-255,66,84353,69,358953
16765,0.000745,74.125.68.0-255,4320,88673,69,358953
16766,0.000749,172.31.40.0-255,66,88739,69,358953
16767,0.000792,74.125.68.0-255,3602,92341,69,358953
16768,0.000805,172.31.40.0-255,66,92407,69,358953
16769,0.000836,74.125.68.0-255,4320,96727,69,358953
16770,0.000841,74.125.68.0-255,2902,99629,69,358953
16771,0.000861,172.31.40.0-255,66,99695,69,358953
16772,0.000904,74.125.68.0-255,5738,105433,69,358953
16773,0.000914,172.31.40.0-255,66,105499,69,358953
16774,0.000942,74.125.68.0-255,5738,111237,69,358953
16775,0.000961,74.125.68.0-255,4320,115557,69,358953
16776,0.000976,74.125.68.0-255,5738,121295,69,358953
16777,0.000993,172.31.40.0-255,66,121361,69,358953
16778,0.001034,74.125.68.0-255,7156,128517,69,358953
16779,0.001048,74.125.68.0-255,2184,130701,69,358953
16780,0.001055,172.31.40.0-255,66,130767,69,358953
16781,0.00117,74.125.68.0-255,1484,132251,69,358953
16782,0.001174,74.125.68.0-255,1484,133735,69,358953
16783,0.001187,74.125.68.0-255,1484,135219,69,358953
16784,0.001197,172.31.40.0-255,66,135285,69,358953
16785,0.001204,74.125.68.0-255,5738,141023,69,358953
16786,0.001209,172.31.40.0-255,66,141089,69,358953
16787,0.001251,74.125.68.0-255,7156,148245,69,358953
16788,0.001256,74.125.68.0-255,2902,151147,69,358953
16789,0.001289,172.31.40.0-255,66,151213,69,358953
16790,0.001297,74.125.68.0-255,1484,152697,69,358953
16791,0.001317,74.125.68.0-255,2184,154881,69,358953
16792,0.001319,172.31.40.0-255,66,154947,69,358953
16793,0.001355,172.31.40.0-255,66,155013,69,358953
16794,0.001406,74.125.68.0-255,1484,156497,69,358953
16795,0.001423,74.125.68.0-255,2902,159399,69,358953
16796,0.001439,172.31.40.0-255,66,159465,69,358953
16797,0.001467,74.125.68.0-255,5738,165203,69,358953
16798,0.001472,74.125.68.0-255,2902,168105,69,358953
16799,0.001479,172.31.40.0-255,66,168171,69,358953
16800,0.00149,74.125.68.0-255,5738,173909,69,358953
16801,0.001495,74.125.68.0-255,4320,178229,69,358953
16802,0.001514,74.125.68.0-255,4320,182549,69,358953
16803,0.001516,172.31.40.0-255,66,182615,69,358953
16804,0.001541,74.125.68.0-255,1484,184099,69,358953
16805,0.001544,74.125.68.0-255,1484,185583,69,358953
16806,0.001552,172.31.40.0-255,66,185649,69,358953
16807,0.001565,74.125.68.0-255,3602,189251,69,358953
16808,0.001575,172.31.40.0-255,66,189317,69,358953
16809,0.00161,74.125.68.0-255,1484,190801,69,358953
16810,0.001615,74.125.68.0-255,2902,193703,69,358953
16811,0.001627,172.31.40.0-255,66,193769,69,358953
16812,0.001664,74.125.68.0-255,1484,195253,69,358953
16813,0.001679,74.125.68.0-255,1484,196737,69,358953
16814,0.00169,172.31.40.0-255,66,196803,69,358953
16815,0.0017,74.125.68.0-255,2902,199705,69,358953
16816,0.00171,172.31.40.0-255,66,199771,69,358953
16817,0.001717,74.125.68.0-255,1484,201255,69,358953
16818,0.001804,74.125.68.0-255,7156,208411,69,358953
16819,0.00182,74.125.68.0-255,6438,214849,69,358953
16820,0.001824,74.125.68.0-255,2902,217751,69,358953
16821,0.001844,74.125.68.0-255,4320,222071,69,358953
16822,0.001856,74.125.68.0-255,1484,223555,69,358953
16823,0.00186,172.31.40.0-255,66,223621,69,358953
16824,0.001888,74.125.68.0-255,2902,226523,69,358953
16825,0.001896,74.125.68.0-255,5738,232261,69,358953
16826,0.001903,74.125.68.0-255,7156,239417,69,358953
16827,0.001906,74.125.68.0-255,2902,242319,69,358953
16828,0.001912,74.125.68.0-255,4320,246639,69,358953
16829,0.001915,74.125.68.0-255,2184,248823,69,358953
16830,0.001925,172.31.40.0-255,66,248889,69,358953
16831,0.001969,74.125.68.0-255,1484,250373,69,358953
16832,0.001987,74.125.68.0-255,2902,253275,69,358953
16833,0.001992,172.31.40.0-255,66,253341,69,358953
16834,0.002022,74.125.68.0-255,5738,259079,69,358953
16835,0.00203,74.125.68.0-255,7156,266235,69,358953
16836,0.002037,172.31.40.0-255,66,266301,69,358953
16837,0.002076,74.125.68.0-255,5738,272039,69,358953
16838,0.00209,172.31.40.0-255,66,272105,69,358953
16839,0.002095,74.125.68.0-255,2902,275007,69,358953
16840,0.002113,172.31.40.0-255,66,275073,69,358953
16841,0.002118,74.125.68.0-255,4320,279393,69,358953
16842,0.002123,74.125.68.0-255,3602,282995,69,358953
16843,0.002152,172.31.40.0-255,66,283061,69,358953
16844,0.002165,74.125.68.0-255,1484,284545,69,358953
16845,0.002185,74.125.68.0-255,1484,286029,69,358953
16846,0.002191,74.125.68.0-255,4320,290349,69,358953
16847,0.002194,74.125.68.0-255,1484,291833,69,358953
16848,0.002198,172.31.40.0-255,66,291899,69,358953
16849,0.002246,74.125.68.0-255,7156,299055,69,358953
16850,0.002253,74.125.68.0-255,5738,304793,69,358953
16851,0.00226,74.125.68.0-255,7156,311949,69,358953
16852,0.002265,74.125.68.0-255,4320,316269,69,358953
16853,0.002283,74.125.68.0-255,3602,319871,69,358953
16854,0.00229,74.125.68.0-255,7156,327027,69,358953
16855,0.002295,172.31.40.0-255,66,327093,69,358953
16856,0.002302,74.125.68.0-255,1484,328577,69,358953
16857,0.00233,74.125.68.0-255,2902,331479,69,358953
16858,0.002343,172.31.40.0-255,66,331545,69,358953
16859,0.00235,74.125.68.0-255,7156,338701,69,358953
16860,0.002355,172.31.40.0-255,66,338767,69,358953
16861,0.002379,74.125.68.0-255,1484,340251,69,358953
16862,0.002398,74.125.68.0-255,2184,342435,69,358953
16863,0.00242,74.125.68.0-255,5738,348173,69,358953
16864,0.002445,74.125.68.0-255,5738,353911,69,358953
16865,0.002449,74.125.68.0-255,2587,356498,69,358953
16866,0.002456,172.31.40.0-255,66,356564,69,358953
16867,0.002489,74.125.68.0-255,105,356669,69,358953
16868,0.011117,172.31.40.0-255,66,356735,69,358953
16869,0.011158,172.31.40.0-255,105,356840,69,358953
16870,0.013847,74.125.68.0-255,66,356906,69,358953
16871,0.035157,172.31.40.0-255,172,357078,69,358953
16872,0.035194,172.31.40.0-255,1116,358194,69,358953
16873,0.035252,172.31.40.0-255,561,358755,69,358953
16874,0.036807,104.244.42.0-255,66,358821,69,358953
16875,0.036915,104.244.42.0-255,66,358887,69,358953
16876,0.036929,104.244.42.0-255,66,358953,69,358953
