,TIME,SRC,PACKET_SIZE,CUMULATIVE_PACKET_SIZE,PAGE_NUMBER,TOTAL_PACKET_SIZE
0,0.0,74.125.68.0-255,150,150,65,222162
1,2.9e-05,172.31.40.0-255,66,216,65,222162
2,3.6e-05,74.125.68.0-255,1484,1700,65,222162
3,4.1e-05,172.31.40.0-255,66,1766,65,222162
4,4.4e-05,74.125.68.0-255,1484,3250,65,222162
5,5.7e-05,172.31.40.0-255,66,3316,65,222162
6,6.4e-05,74.125.68.0-255,2902,6218,65,222162
7,6.7e-05,172.31.40.0-255,66,6284,65,222162
8,7.3e-05,74.125.68.0-255,5738,12022,65,222162
9,7.6e-05,172.31.40.0-255,66,12088,65,222162
10,8e-05,74.125.68.0-255,2139,14227,65,222162
11,8.3e-05,172.31.40.0-255,66,14293,65,222162
12,0.000202,74.125.68.0-255,1484,15777,65,222162
13,0.000206,172.31.40.0-255,66,15843,65,222162
14,0.000211,74.125.68.0-255,2902,18745,65,222162
15,0.000214,172.31.40.0-255,66,18811,65,222162
16,0.000259,74.125.68.0-255,4320,23131,65,222162
17,0.000262,172.31.40.0-255,66,23197,65,222162
18,0.000292,74.125.68.0-255,2902,26099,65,222162
19,0.000294,172.31.40.0-255,66,26165,65,222162
20,0.000323,74.125.68.0-255,4320,30485,65,222162
21,0.000325,172.31.40.0-255,66,30551,65,222162
22,0.000345,74.125.68.0-255,3961,34512,65,222162
23,0.000348,172.31.40.0-255,66,34578,65,222162
24,0.000353,74.125.68.0-255,4320,38898,65,222162
25,0.000355,172.31.40.0-255,66,38964,65,222162
26,0.00039,172.31.40.0-255,66,39030,65,222162
27,0.000396,74.125.68.0-255,4320,43350,65,222162
28,0.000398,172.31.40.0-255,66,43416,65,222162
29,0.000442,74.125.68.0-255,2902,46318,65,222162
30,0.000445,172.31.40.0-255,66,46384,65,222162
31,0.000478,172.31.40.0-255,66,46450,65,222162
32,0.000482,74.125.68.0-255,395,46845,65,222162
33,0.00058,74.125.68.0-255,1484,48329,65,222162
34,0.000585,172.31.40.0-255,66,48395,65,222162
35,0.000592,74.125.68.0-255,2902,51297,65,222162
36,0.000595,172.31.40.0-255,66,51363,65,222162
37,0.000605,74.125.68.0-255,2902,54265,65,222162
38,0.000608,172.31.40.0-255,66,54331,65,222162
39,0.000613,74.125.68.0-255,4320,58651,65,222162
40,0.000615,172.31.40.0-255,66,58717,65,222162
41,0.000618,74.125.68.0-255,1484,60201,65,222162
42,0.000661,74.125.68.0-255,7156,67357,65,222162
43,0.000664,172.31.40.0-255,66,67423,65,222162
44,0.000671,74.125.68.0-255,5738,73161,65,222162
45,0.000673,172.31.40.0-255,66,73227,65,222162
46,0.00068,74.125.68.0-255,7156,80383,65,222162
47,0.000683,172.31.40.0-255,66,80449,65,222162
48,0.000685,74.125.68.0-255,1049,81498,65,222162
49,0.001271,74.125.68.0-255,1484,82982,65,222162
50,0.001277,172.31.40.0-255,66,83048,65,222162
51,0.001283,74.125.68.0-255,2902,85950,65,222162
52,0.001285,172.31.40.0-255,66,86016,65,222162
53,0.001313,74.125.68.0-255,5738,91754,65,222162
54,0.001315,172.31.40.0-255,66,91820,65,222162
55,0.001323,74.125.68.0-255,7156,98976,65,222162
56,0.001325,172.31.40.0-255,66,99042,65,222162
57,0.001355,74.125.68.0-255,5738,104780,65,222162
58,0.00136,172.31.40.0-255,66,104846,65,222162
59,0.00137,74.125.68.0-255,4320,109166,65,222162
60,0.001373,172.31.40.0-255,66,109232,65,222162
61,0.001409,74.125.68.0-255,6438,115670,65,222162
62,0.001412,172.31.40.0-255,66,115736,65,222162
63,0.001484,74.125.68.0-255,1484,117220,65,222162
64,0.001496,74.125.68.0-255,1484,118704,65,222162
65,0.001499,172.31.40.0-255,66,118770,65,222162
66,0.001518,74.125.68.0-255,2902,121672,65,222162
67,0.001521,172.31.40.0-255,66,121738,65,222162
68,0.001525,74.125.68.0-255,2902,124640,65,222162
69,0.001527,172.31.40.0-255,66,124706,65,222162
70,0.001557,74.125.68.0-255,2902,127608,65,222162
71,0.001559,172.31.40.0-255,66,127674,65,222162
72,0.00157,172.31.40.0-255,66,127740,65,222162
73,0.001574,74.125.68.0-255,1484,129224,65,222162
74,0.001612,172.31.40.0-255,66,129290,65,222162
75,0.001617,74.125.68.0-255,3602,132892,65,222162
76,0.001619,172.31.40.0-255,66,132958,65,222162
77,0.001742,74.125.68.0-255,1484,134442,65,222162
78,0.001747,74.125.68.0-255,1484,135926,65,222162
79,0.00175,172.31.40.0-255,66,135992,65,222162
80,0.001777,74.125.68.0-255,1484,137476,65,222162
81,0.001784,74.125.68.0-255,5738,143214,65,222162
82,0.001786,172.31.40.0-255,66,143280,65,222162
83,0.001821,172.31.40.0-255,66,143346,65,222162
84,0.001857,172.31.40.0-255,66,143412,65,222162
85,0.00189,74.125.68.0-255,1484,144896,65,222162
86,0.00191,74.125.68.0-255,1484,146380,65,222162
87,0.001913,172.31.40.0-255,66,146446,65,222162
88,0.001917,74.125.68.0-255,1484,147930,65,222162
89,0.001937,74.125.68.0-255,1484,149414,65,222162
90,0.001939,172.31.40.0-255,66,149480,65,222162
91,0.001945,74.125.68.0-255,4320,153800,65,222162
92,0.001948,172.31.40.0-255,66,153866,65,222162
93,0.001972,74.125.68.0-255,1484,155350,65,222162
94,0.001978,74.125.68.0-255,2902,158252,65,222162
95,0.00198,172.31.40.0-255,66,158318,65,222162
96,0.001985,74.125.68.0-255,4320,162638,65,222162
97,0.001988,172.31.40.0-255,66,162704,65,222162
98,0.002019,74.125.68.0-255,5738,168442,65,222162
99,0.002025,172.31.40.0-255,66,168508,65,222162
100,0.002054,74.125.68.0-255,7156,175664,65,222162
101,0.002059,172.31.40.0-255,66,175730,65,222162
102,0.004076,74.125.68.0-255,5738,181468,65,222162
103,0.004082,172.31.40.0-255,66,181534,65,222162
104,0.00609,74.125.68.0-255,5738,187272,65,222162
105,0.006095,172.31.40.0-255,66,187338,65,222162
106,0.008119,74.125.68.0-255,5738,193076,65,222162
107,0.008125,172.31.40.0-255,66,193142,65,222162
108,0.010153,74.125.68.0-255,5738,198880,65,222162
109,0.01017,172.31.40.0-255,66,198946,65,222162
110,0.0122,74.125.68.0-255,5738,204684,65,222162
111,0.012214,172.31.40.0-255,66,204750,65,222162
112,0.014242,74.125.68.0-255,5738,210488,65,222162
113,0.014255,172.31.40.0-255,66,210554,65,222162
114,0.016281,74.125.68.0-255,5738,216292,65,222162
115,0.016295,172.31.40.0-255,66,216358,65,222162
116,0.018311,74.125.68.0-255,5738,222096,65,222162
117,0.018319,172.31.40.0-255,66,222162,65,222162
118,0.0,172.217.194.0-255,149,149,65,190089
119,1.3e-05,172.31.40.0-255,66,215,65,190089
120,2e-05,172.217.194.0-255,1484,1699,65,190089
121,2.4e-05,172.31.40.0-255,66,1765,65,190089
122,2.9e-05,172.217.194.0-255,2902,4667,65,190089
123,3.3e-05,172.31.40.0-255,66,4733,65,190089
124,3.6e-05,172.217.194.0-255,1484,6217,65,190089
125,3.9e-05,172.31.40.0-255,66,6283,65,190089
126,7.5e-05,172.217.194.0-255,5738,12021,65,190089
127,7.8e-05,172.31.40.0-255,66,12087,65,190089
128,9.7e-05,172.217.194.0-255,2030,14117,65,190089
129,0.0001,172.31.40.0-255,66,14183,65,190089
130,0.000113,172.217.194.0-255,2902,17085,65,190089
131,0.000116,172.31.40.0-255,66,17151,65,190089
132,0.00015,172.217.194.0-255,7156,24307,65,190089
133,0.000153,172.31.40.0-255,66,24373,65,190089
134,0.000156,172.217.194.0-255,1484,25857,65,190089
135,0.000158,172.31.40.0-255,66,25923,65,190089
136,0.000189,172.217.194.0-255,5379,31302,65,190089
137,0.000191,172.31.40.0-255,66,31368,65,190089
138,0.00023,172.217.194.0-255,5738,37106,65,190089
139,0.000233,172.31.40.0-255,66,37172,65,190089
140,0.000256,172.217.194.0-255,7156,44328,65,190089
141,0.000259,172.31.40.0-255,66,44394,65,190089
142,0.00029,172.217.194.0-255,5738,50132,65,190089
143,0.000292,172.31.40.0-255,66,50198,65,190089
144,0.000319,172.31.40.0-255,66,50264,65,190089
145,0.000348,172.217.194.0-255,5959,56223,65,190089
146,0.000351,172.31.40.0-255,66,56289,65,190089
147,0.000616,172.217.194.0-255,1484,57773,65,190089
148,0.000621,172.31.40.0-255,66,57839,65,190089
149,0.000628,172.217.194.0-255,2902,60741,65,190089
150,0.00063,172.31.40.0-255,66,60807,65,190089
151,0.000636,172.217.194.0-255,4320,65127,65,190089
152,0.000639,172.31.40.0-255,66,65193,65,190089
153,0.000655,172.217.194.0-255,1484,66677,65,190089
154,0.000681,172.31.40.0-255,66,66743,65,190089
155,0.000739,172.217.194.0-255,2902,69645,65,190089
156,0.000744,172.31.40.0-255,66,69711,65,190089
157,0.000757,172.31.40.0-255,66,69777,65,190089
158,0.000823,172.217.194.0-255,1484,71261,65,190089
159,0.000829,172.217.194.0-255,2902,74163,65,190089
160,0.000832,172.31.40.0-255,66,74229,65,190089
161,0.000838,172.217.194.0-255,4320,78549,65,190089
162,0.00084,172.31.40.0-255,66,78615,65,190089
163,0.000851,172.217.194.0-255,1484,80099,65,190089
164,0.000859,172.217.194.0-255,7156,87255,65,190089
165,0.000862,172.31.40.0-255,66,87321,65,190089
166,0.000885,172.217.194.0-255,5738,93059,65,190089
167,0.000888,172.31.40.0-255,66,93125,65,190089
168,0.000896,172.217.194.0-255,7156,100281,65,190089
169,0.000899,172.31.40.0-255,66,100347,65,190089
170,0.000915,172.217.194.0-255,3602,103949,65,190089
171,0.000917,172.31.40.0-255,66,104015,65,190089
172,0.001007,172.217.194.0-255,1484,105499,65,190089
173,0.001013,172.217.194.0-255,2902,108401,65,190089
174,0.001017,172.31.40.0-255,66,108467,65,190089
175,0.001023,172.217.194.0-255,4320,112787,65,190089
176,0.001026,172.31.40.0-255,66,112853,65,190089
177,0.001057,172.217.194.0-255,1484,114337,65,190089
178,0.00107,172.31.40.0-255,66,114403,65,190089
179,0.001111,172.31.40.0-255,66,114469,65,190089
180,0.001328,172.217.194.0-255,1484,115953,65,190089
181,0.001334,172.217.194.0-255,2902,118855,65,190089
182,0.001337,172.31.40.0-255,66,118921,65,190089
183,0.001343,172.217.194.0-255,2902,121823,65,190089
184,0.001345,172.31.40.0-255,66,121889,65,190089
185,0.00136,172.217.194.0-255,2902,124791,65,190089
186,0.001362,172.31.40.0-255,66,124857,65,190089
187,0.001366,172.217.194.0-255,1484,126341,65,190089
188,0.001413,172.31.40.0-255,66,126407,65,190089
189,0.001421,172.217.194.0-255,5738,132145,65,190089
190,0.001423,172.31.40.0-255,66,132211,65,190089
191,0.001446,172.217.194.0-255,5020,137231,65,190089
192,0.001449,172.31.40.0-255,66,137297,65,190089
193,0.00154,172.217.194.0-255,1484,138781,65,190089
194,0.001545,172.217.194.0-255,2902,141683,65,190089
195,0.001548,172.31.40.0-255,66,141749,65,190089
196,0.001565,172.217.194.0-255,5738,147487,65,190089
197,0.001568,172.31.40.0-255,66,147553,65,190089
198,0.001607,172.31.40.0-255,66,147619,65,190089
199,0.001619,172.31.40.0-255,66,147685,65,190089
200,0.001647,172.217.194.0-255,1484,149169,65,190089
201,0.00166,172.217.194.0-255,2902,152071,65,190089
202,0.001663,172.31.40.0-255,66,152137,65,190089
203,0.001667,172.217.194.0-255,2902,155039,65,190089
204,0.001669,172.31.40.0-255,66,155105,65,190089
205,0.001684,172.217.194.0-255,2902,158007,65,190089
206,0.001687,172.31.40.0-255,66,158073,65,190089
207,0.001691,172.217.194.0-255,2902,160975,65,190089
208,0.001693,172.31.40.0-255,66,161041,65,190089
209,0.001746,172.217.194.0-255,766,161807,65,190089
210,0.00175,172.31.40.0-255,66,161873,65,190089
211,0.001758,172.31.40.0-255,66,161939,65,190089
212,0.001844,172.217.194.0-255,1484,163423,65,190089
213,0.001849,172.217.194.0-255,2902,166325,65,190089
214,0.001853,172.31.40.0-255,66,166391,65,190089
215,0.001856,172.31.40.0-255,66,166457,65,190089
216,0.001867,172.217.194.0-255,5738,172195,65,190089
217,0.00187,172.31.40.0-255,66,172261,65,190089
218,0.001911,172.217.194.0-255,2902,175163,65,190089
219,0.001915,172.31.40.0-255,66,175229,65,190089
220,0.00195,172.31.40.0-255,66,175295,65,190089
221,0.001963,172.31.40.0-255,66,175361,65,190089
222,0.001966,172.217.194.0-255,1484,176845,65,190089
223,0.00197,172.217.194.0-255,2902,179747,65,190089
224,0.001972,172.31.40.0-255,66,179813,65,190089
225,0.00198,172.217.194.0-255,5738,185551,65,190089
226,0.001982,172.31.40.0-255,66,185617,65,190089
227,0.002025,172.31.40.0-255,66,185683,65,190089
228,0.002036,172.31.40.0-255,66,185749,65,190089
229,0.002085,172.31.40.0-255,66,185815,65,190089
230,0.002119,172.31.40.0-255,66,185881,65,190089
231,0.002137,172.31.40.0-255,66,185947,65,190089
232,0.002165,172.217.194.0-255,3602,189549,65,190089
233,0.002168,172.31.40.0-255,66,189615,65,190089
234,0.002184,172.31.40.0-255,66,189681,65,190089
235,0.002195,172.31.40.0-255,66,189747,65,190089
236,0.002198,172.217.194.0-255,105,189852,65,190089
237,0.004311,172.31.40.0-255,66,189918,65,190089
238,0.004348,172.31.40.0-255,105,190023,65,190089
239,0.00652,172.217.194.0-255,66,190089,65,190089
240,0.0,172.217.194.0-255,150,150,65,232224
241,2.2e-05,172.31.40.0-255,66,216,65,232224
242,2.8e-05,172.217.194.0-255,1484,1700,65,232224
243,3.2e-05,172.31.40.0-255,66,1766,65,232224
244,3.8e-05,172.217.194.0-255,2902,4668,65,232224
245,4.3e-05,172.31.40.0-255,66,4734,65,232224
246,5e-05,172.217.194.0-255,7156,11890,65,232224
247,5.3e-05,172.31.40.0-255,66,11956,65,232224
248,6.4e-05,172.31.40.0-255,66,12022,65,232224
249,8.1e-05,172.217.194.0-255,611,12633,65,232224
250,8.4e-05,172.31.40.0-255,66,12699,65,232224
251,0.000108,172.217.194.0-255,5738,18437,65,232224
252,0.000111,172.31.40.0-255,66,18503,65,232224
253,0.000131,172.217.194.0-255,3961,22464,65,232224
254,0.000133,172.31.40.0-255,66,22530,65,232224
255,0.000138,172.217.194.0-255,4320,26850,65,232224
256,0.000141,172.31.40.0-255,66,26916,65,232224
257,0.00016,172.217.194.0-255,5738,32654,65,232224
258,0.000163,172.31.40.0-255,66,32720,65,232224
259,0.000174,172.31.40.0-255,66,32786,65,232224
260,0.00019,172.217.194.0-255,1484,34270,65,232224
261,0.000192,172.31.40.0-255,66,34336,65,232224
262,0.000239,172.217.194.0-255,5738,40074,65,232224
263,0.000242,172.31.40.0-255,66,40140,65,232224
264,0.000257,172.217.194.0-255,5738,45878,65,232224
265,0.000259,172.31.40.0-255,66,45944,65,232224
266,0.00028,172.217.194.0-255,1109,47053,65,232224
267,0.000283,172.31.40.0-255,66,47119,65,232224
268,0.000307,172.31.40.0-255,66,47185,65,232224
269,0.000323,172.217.194.0-255,4320,51505,65,232224
270,0.000326,172.31.40.0-255,66,51571,65,232224
271,0.000331,172.217.194.0-255,4320,55891,65,232224
272,0.000335,172.31.40.0-255,66,55957,65,232224
273,0.000377,172.31.40.0-255,66,56023,65,232224
274,0.000409,172.31.40.0-255,66,56089,65,232224
275,0.000427,172.217.194.0-255,1484,57573,65,232224
276,0.000434,172.217.194.0-255,2902,60475,65,232224
277,0.000436,172.31.40.0-255,66,60541,65,232224
278,0.000458,172.217.194.0-255,5738,66279,65,232224
279,0.000461,172.31.40.0-255,66,66345,65,232224
280,0.000467,172.217.194.0-255,5738,72083,65,232224
281,0.000471,172.31.40.0-255,66,72149,65,232224
282,0.000542,172.31.40.0-255,66,72215,65,232224
283,0.000547,172.217.194.0-255,5020,77235,65,232224
284,0.00055,172.31.40.0-255,66,77301,65,232224
285,0.0012,172.217.194.0-255,1484,78785,65,232224
286,0.001208,172.217.194.0-255,2902,81687,65,232224
287,0.001212,172.31.40.0-255,66,81753,65,232224
288,0.001218,172.217.194.0-255,4320,86073,65,232224
289,0.00122,172.31.40.0-255,66,86139,65,232224
290,0.001233,172.217.194.0-255,1484,87623,65,232224
291,0.001239,172.217.194.0-255,5738,93361,65,232224
292,0.001241,172.31.40.0-255,66,93427,65,232224
293,0.001264,172.31.40.0-255,66,93493,65,232224
294,0.001291,172.217.194.0-255,1484,94977,65,232224
295,0.001298,172.217.194.0-255,5020,99997,65,232224
296,0.001301,172.31.40.0-255,66,100063,65,232224
297,0.001334,172.217.194.0-255,5738,105801,65,232224
298,0.001337,172.31.40.0-255,66,105867,65,232224
299,0.001345,172.217.194.0-255,7156,113023,65,232224
300,0.001348,172.31.40.0-255,66,113089,65,232224
301,0.001386,172.31.40.0-255,66,113155,65,232224
302,0.001393,172.217.194.0-255,6438,119593,65,232224
303,0.001395,172.31.40.0-255,66,119659,65,232224
304,0.001634,172.217.194.0-255,1484,121143,65,232224
305,0.001641,172.217.194.0-255,2902,124045,65,232224
306,0.001644,172.31.40.0-255,66,124111,65,232224
307,0.001666,172.217.194.0-255,4320,128431,65,232224
308,0.001669,172.31.40.0-255,66,128497,65,232224
309,0.001686,172.217.194.0-255,1484,129981,65,232224
310,0.001691,172.217.194.0-255,2902,132883,65,232224
311,0.001693,172.31.40.0-255,66,132949,65,232224
312,0.001735,172.31.40.0-255,66,133015,65,232224
313,0.001746,172.31.40.0-255,66,133081,65,232224
314,0.00175,172.217.194.0-255,2184,135265,65,232224
315,0.001752,172.31.40.0-255,66,135331,65,232224
316,0.001774,172.217.194.0-255,2902,138233,65,232224
317,0.001777,172.31.40.0-255,66,138299,65,232224
318,0.001781,172.217.194.0-255,2902,141201,65,232224
319,0.001783,172.31.40.0-255,66,141267,65,232224
320,0.001805,172.217.194.0-255,4320,145587,65,232224
321,0.001808,172.31.40.0-255,66,145653,65,232224
322,0.001824,172.31.40.0-255,66,145719,65,232224
323,0.001862,172.217.194.0-255,4320,150039,65,232224
324,0.001864,172.31.40.0-255,66,150105,65,232224
325,0.001891,172.31.40.0-255,66,150171,65,232224
326,0.001896,172.217.194.0-255,5738,155909,65,232224
327,0.001898,172.31.40.0-255,66,155975,65,232224
328,0.001919,172.217.194.0-255,7156,163131,65,232224
329,0.001922,172.31.40.0-255,66,163197,65,232224
330,0.001929,172.217.194.0-255,7156,170353,65,232224
331,0.001931,172.31.40.0-255,66,170419,65,232224
332,0.00196,172.217.194.0-255,7156,177575,65,232224
333,0.001963,172.31.40.0-255,66,177641,65,232224
334,0.001969,172.217.194.0-255,6438,184079,65,232224
335,0.001971,172.31.40.0-255,66,184145,65,232224
336,0.002011,172.217.194.0-255,1484,185629,65,232224
337,0.002016,172.217.194.0-255,2902,188531,65,232224
338,0.002018,172.31.40.0-255,66,188597,65,232224
339,0.002023,172.217.194.0-255,5738,194335,65,232224
340,0.002025,172.31.40.0-255,66,194401,65,232224
341,0.002035,172.217.194.0-255,1484,195885,65,232224
342,0.002058,172.217.194.0-255,7156,203041,65,232224
343,0.002061,172.31.40.0-255,66,203107,65,232224
344,0.002066,172.217.194.0-255,5738,208845,65,232224
345,0.002068,172.31.40.0-255,66,208911,65,232224
346,0.002081,172.217.194.0-255,4320,213231,65,232224
347,0.002083,172.31.40.0-255,66,213297,65,232224
348,0.002107,172.217.194.0-255,7156,220453,65,232224
349,0.00211,172.31.40.0-255,66,220519,65,232224
350,0.002138,172.31.40.0-255,66,220585,65,232224
351,0.002155,172.217.194.0-255,2184,222769,65,232224
352,0.002159,172.217.194.0-255,2902,225671,65,232224
353,0.002162,172.31.40.0-255,66,225737,65,232224
354,0.002164,172.31.40.0-255,66,225803,65,232224
355,0.002193,172.31.40.0-255,66,225869,65,232224
356,0.002231,172.217.194.0-255,5020,230889,65,232224
357,0.002233,172.31.40.0-255,66,230955,65,232224
358,0.002245,172.31.40.0-255,66,231021,65,232224
359,0.002261,172.31.40.0-255,66,231087,65,232224
360,0.002263,172.217.194.0-255,105,231192,65,232224
361,0.002266,172.217.194.0-255,129,231321,65,232224
362,0.011335,172.217.194.0-255,129,231450,65,232224
363,0.011354,172.31.40.0-255,78,231528,65,232224
364,0.012264,172.31.40.0-255,105,231633,65,232224
365,0.0123,172.31.40.0-255,105,231738,65,232224
366,0.012531,172.31.40.0-255,90,231828,65,232224
367,0.012541,172.31.40.0-255,66,231894,65,232224
368,0.014546,172.217.194.0-255,66,231960,65,232224
369,0.014561,172.217.194.0-255,66,232026,65,232224
370,0.014814,172.217.194.0-255,66,232092,65,232224
371,0.014852,172.217.194.0-255,66,232158,65,232224
372,0.014863,172.31.40.0-255,66,232224,65,232224
373,0.0,74.125.68.0-255,153,153,65,203699
374,2.4e-05,172.31.40.0-255,66,219,65,203699
375,3.1e-05,74.125.68.0-255,1484,1703,65,203699
376,3.6e-05,172.31.40.0-255,66,1769,65,203699
377,5.3e-05,74.125.68.0-255,2902,4671,65,203699
378,5.6e-05,172.31.40.0-255,66,4737,65,203699
379,6.5e-05,74.125.68.0-255,5738,10475,65,203699
380,6.8e-05,172.31.40.0-255,66,10541,65,203699
381,7.4e-05,74.125.68.0-255,3517,14058,65,203699
382,7.7e-05,172.31.40.0-255,66,14124,65,203699
383,0.000137,74.125.68.0-255,1484,15608,65,203699
384,0.000141,172.31.40.0-255,66,15674,65,203699
385,0.000175,74.125.68.0-255,1484,17158,65,203699
386,0.000177,172.31.40.0-255,66,17224,65,203699
387,0.000181,74.125.68.0-255,1484,18708,65,203699
388,0.000183,172.31.40.0-255,66,18774,65,203699
389,0.000204,74.125.68.0-255,1484,20258,65,203699
390,0.000207,172.31.40.0-255,66,20324,65,203699
391,0.000215,74.125.68.0-255,5738,26062,65,203699
392,0.000217,172.31.40.0-255,66,26128,65,203699
393,0.00022,74.125.68.0-255,1484,27612,65,203699
394,0.000222,172.31.40.0-255,66,27678,65,203699
395,0.000252,74.125.68.0-255,1484,29162,65,203699
396,0.000255,172.31.40.0-255,66,29228,65,203699
397,0.000259,74.125.68.0-255,2543,31771,65,203699
398,0.000261,172.31.40.0-255,66,31837,65,203699
399,0.000345,74.125.68.0-255,1484,33321,65,203699
400,0.000348,172.31.40.0-255,66,33387,65,203699
401,0.000375,74.125.68.0-255,2902,36289,65,203699
402,0.000378,172.31.40.0-255,66,36355,65,203699
403,0.000381,74.125.68.0-255,1484,37839,65,203699
404,0.000384,172.31.40.0-255,66,37905,65,203699
405,0.000416,74.125.68.0-255,2902,40807,65,203699
406,0.000423,74.125.68.0-255,2902,43709,65,203699
407,0.00044,74.125.68.0-255,2902,46611,65,203699
408,0.000444,74.125.68.0-255,2902,49513,65,203699
409,0.000463,74.125.68.0-255,3961,53474,65,203699
410,0.000479,74.125.68.0-255,5738,59212,65,203699
411,0.000496,74.125.68.0-255,1484,60696,65,203699
412,0.000523,74.125.68.0-255,1484,62180,65,203699
413,0.00054,74.125.68.0-255,3961,66141,65,203699
414,0.000556,74.125.68.0-255,646,66787,65,203699
415,0.000635,172.31.40.0-255,66,66853,65,203699
416,0.000762,74.125.68.0-255,1484,68337,65,203699
417,0.000816,74.125.68.0-255,1484,69821,65,203699
418,0.000821,74.125.68.0-255,2902,72723,65,203699
419,0.000828,74.125.68.0-255,5738,78461,65,203699
420,0.000833,74.125.68.0-255,5738,84199,65,203699
421,0.000855,172.31.40.0-255,66,84265,65,203699
422,0.000863,74.125.68.0-255,7156,91421,65,203699
423,0.000868,172.31.40.0-255,66,91487,65,203699
424,0.000923,172.31.40.0-255,66,91553,65,203699
425,0.001196,74.125.68.0-255,1484,93037,65,203699
426,0.001201,74.125.68.0-255,1484,94521,65,203699
427,0.001204,172.31.40.0-255,66,94587,65,203699
428,0.001231,74.125.68.0-255,1484,96071,65,203699
429,0.001239,74.125.68.0-255,5738,101809,65,203699
430,0.001243,74.125.68.0-255,2902,104711,65,203699
431,0.001259,172.31.40.0-255,66,104777,65,203699
432,0.001265,74.125.68.0-255,4320,109097,65,203699
433,0.00127,172.31.40.0-255,66,109163,65,203699
434,0.001317,74.125.68.0-255,4320,113483,65,203699
435,0.001342,74.125.68.0-255,3602,117085,65,203699
436,0.001345,172.31.40.0-255,66,117151,65,203699
437,0.00135,172.31.40.0-255,66,117217,65,203699
438,0.001518,74.125.68.0-255,1484,118701,65,203699
439,0.001522,74.125.68.0-255,1484,120185,65,203699
440,0.001527,172.31.40.0-255,66,120251,65,203699
441,0.001553,74.125.68.0-255,1484,121735,65,203699
442,0.001556,74.125.68.0-255,1484,123219,65,203699
443,0.001561,74.125.68.0-255,2902,126121,65,203699
444,0.001567,74.125.68.0-255,5738,131859,65,203699
445,0.001575,172.31.40.0-255,66,131925,65,203699
446,0.001625,172.31.40.0-255,66,131991,65,203699
447,0.001671,74.125.68.0-255,766,132757,65,203699
448,0.001679,172.31.40.0-255,66,132823,65,203699
449,0.002073,74.125.68.0-255,1484,134307,65,203699
450,0.002079,74.125.68.0-255,2902,137209,65,203699
451,0.002083,172.31.40.0-255,66,137275,65,203699
452,0.002104,74.125.68.0-255,4320,141595,65,203699
453,0.002107,74.125.68.0-255,1484,143079,65,203699
454,0.002116,172.31.40.0-255,66,143145,65,203699
455,0.002126,74.125.68.0-255,4320,147465,65,203699
456,0.002136,172.31.40.0-255,66,147531,65,203699
457,0.002151,74.125.68.0-255,4320,151851,65,203699
458,0.002176,74.125.68.0-255,7156,159007,65,203699
459,0.002183,172.31.40.0-255,66,159073,65,203699
460,0.002225,172.31.40.0-255,66,159139,65,203699
461,0.002262,74.125.68.0-255,1484,160623,65,203699
462,0.002265,74.125.68.0-255,1484,162107,65,203699
463,0.002272,172.31.40.0-255,66,162173,65,203699
464,0.00228,74.125.68.0-255,1484,163657,65,203699
465,0.002295,74.125.68.0-255,2902,166559,65,203699
466,0.002313,74.125.68.0-255,2902,169461,65,203699
467,0.002316,74.125.68.0-255,1484,170945,65,203699
468,0.002335,172.31.40.0-255,66,171011,65,203699
469,0.002343,74.125.68.0-255,5738,176749,65,203699
470,0.002362,172.31.40.0-255,66,176815,65,203699
471,0.002384,74.125.68.0-255,3602,180417,65,203699
472,0.002408,172.31.40.0-255,66,180483,65,203699
473,0.004758,74.125.68.0-255,5738,186221,65,203699
474,0.004765,172.31.40.0-255,66,186287,65,203699
475,0.007114,74.125.68.0-255,5738,192025,65,203699
476,0.009304,172.31.40.0-255,66,192091,65,203699
477,0.011686,74.125.68.0-255,5738,197829,65,203699
478,0.011694,172.31.40.0-255,66,197895,65,203699
479,0.014046,74.125.68.0-255,5738,203633,65,203699
480,0.018954,172.31.40.0-255,66,203699,65,203699
481,0.0,74.125.200.0-255,156,156,65,233859
482,1e-05,172.31.40.0-255,66,222,65,233859
483,3.2e-05,74.125.200.0-255,1484,1706,65,233859
484,3.6e-05,172.31.40.0-255,66,1772,65,233859
485,3.9e-05,74.125.200.0-255,1484,3256,65,233859
486,4.2e-05,172.31.40.0-255,66,3322,65,233859
487,5.6e-05,74.125.200.0-255,1484,4806,65,233859
488,5.8e-05,172.31.40.0-255,66,4872,65,233859
489,6.5e-05,74.125.200.0-255,4320,9192,65,233859
490,6.7e-05,172.31.40.0-255,66,9258,65,233859
491,7.1e-05,74.125.200.0-255,1484,10742,65,233859
492,7.3e-05,172.31.40.0-255,66,10808,65,233859
493,0.000101,74.125.200.0-255,3401,14209,65,233859
494,0.000103,172.31.40.0-255,66,14275,65,233859
495,0.000203,74.125.200.0-255,1484,15759,65,233859
496,0.000207,172.31.40.0-255,66,15825,65,233859
497,0.000213,74.125.200.0-255,2902,18727,65,233859
498,0.000215,172.31.40.0-255,66,18793,65,233859
499,0.000242,74.125.200.0-255,5738,24531,65,233859
500,0.000245,172.31.40.0-255,66,24597,65,233859
501,0.000269,74.125.200.0-255,6797,31394,65,233859
502,0.000272,172.31.40.0-255,66,31460,65,233859
503,0.000534,74.125.200.0-255,1484,32944,65,233859
504,0.000539,172.31.40.0-255,66,33010,65,233859
505,0.000546,74.125.200.0-255,2902,35912,65,233859
506,0.000548,172.31.40.0-255,66,35978,65,233859
507,0.000563,74.125.200.0-255,1484,37462,65,233859
508,0.000565,172.31.40.0-255,66,37528,65,233859
509,0.000569,74.125.200.0-255,1484,39012,65,233859
510,0.000571,172.31.40.0-255,66,39078,65,233859
511,0.000589,74.125.200.0-255,1484,40562,65,233859
512,0.000594,74.125.200.0-255,4320,44882,65,233859
513,0.000598,172.31.40.0-255,66,44948,65,233859
514,0.000601,172.31.40.0-255,66,45014,65,233859
515,0.00062,74.125.200.0-255,1484,46498,65,233859
516,0.000627,74.125.200.0-255,2543,49041,65,233859
517,0.000629,172.31.40.0-255,66,49107,65,233859
518,0.000634,74.125.200.0-255,2902,52009,65,233859
519,0.000637,172.31.40.0-255,66,52075,65,233859
520,0.000676,74.125.200.0-255,7156,59231,65,233859
521,0.000679,172.31.40.0-255,66,59297,65,233859
522,0.000684,74.125.200.0-255,2902,62199,65,233859
523,0.000686,172.31.40.0-255,66,62265,65,233859
524,0.000691,74.125.200.0-255,3961,66226,65,233859
525,0.000693,172.31.40.0-255,66,66292,65,233859
526,0.000732,74.125.200.0-255,645,66937,65,233859
527,0.001051,172.31.40.0-255,66,67003,65,233859
528,0.001073,74.125.200.0-255,1484,68487,65,233859
529,0.001084,74.125.200.0-255,1484,69971,65,233859
530,0.001087,172.31.40.0-255,66,70037,65,233859
531,0.001105,74.125.200.0-255,1484,71521,65,233859
532,0.001122,74.125.200.0-255,5738,77259,65,233859
533,0.001125,172.31.40.0-255,66,77325,65,233859
534,0.001159,74.125.200.0-255,7156,84481,65,233859
535,0.001161,172.31.40.0-255,66,84547,65,233859
536,0.001182,74.125.200.0-255,2902,87449,65,233859
537,0.001184,172.31.40.0-255,66,87515,65,233859
538,0.00121,74.125.200.0-255,4320,91835,65,233859
539,0.001213,172.31.40.0-255,66,91901,65,233859
540,0.00123,74.125.200.0-255,4320,96221,65,233859
541,0.001232,172.31.40.0-255,66,96287,65,233859
542,0.001251,74.125.200.0-255,1484,97771,65,233859
543,0.00127,74.125.200.0-255,3602,101373,65,233859
544,0.001272,172.31.40.0-255,66,101439,65,233859
545,0.001329,74.125.200.0-255,1484,102923,65,233859
546,0.001348,74.125.200.0-255,2902,105825,65,233859
547,0.001351,172.31.40.0-255,66,105891,65,233859
548,0.001358,74.125.200.0-255,5738,111629,65,233859
549,0.00136,172.31.40.0-255,66,111695,65,233859
550,0.001363,74.125.200.0-255,1484,113179,65,233859
551,0.001388,74.125.200.0-255,2902,116081,65,233859
552,0.00139,172.31.40.0-255,66,116147,65,233859
553,0.001404,74.125.200.0-255,2902,119049,65,233859
554,0.001407,172.31.40.0-255,66,119115,65,233859
555,0.001432,74.125.200.0-255,2902,122017,65,233859
556,0.001434,172.31.40.0-255,66,122083,65,233859
557,0.001438,74.125.200.0-255,2902,124985,65,233859
558,0.00144,172.31.40.0-255,66,125051,65,233859
559,0.001446,74.125.200.0-255,4320,129371,65,233859
560,0.001448,172.31.40.0-255,66,129437,65,233859
561,0.001471,74.125.200.0-255,5738,135175,65,233859
562,0.001473,172.31.40.0-255,66,135241,65,233859
563,0.001476,74.125.200.0-255,766,136007,65,233859
564,0.001785,172.31.40.0-255,66,136073,65,233859
565,0.001988,74.125.200.0-255,1484,137557,65,233859
566,0.001995,74.125.200.0-255,1484,139041,65,233859
567,0.001999,172.31.40.0-255,66,139107,65,233859
568,0.002016,74.125.200.0-255,1484,140591,65,233859
569,0.002022,74.125.200.0-255,4320,144911,65,233859
570,0.002024,172.31.40.0-255,66,144977,65,233859
571,0.002058,74.125.200.0-255,2902,147879,65,233859
572,0.002061,172.31.40.0-255,66,147945,65,233859
573,0.002083,74.125.200.0-255,4320,152265,65,233859
574,0.002085,172.31.40.0-255,66,152331,65,233859
575,0.002123,74.125.200.0-255,4320,156651,65,233859
576,0.002126,172.31.40.0-255,66,156717,65,233859
577,0.00214,74.125.200.0-255,2902,159619,65,233859
578,0.002142,172.31.40.0-255,66,159685,65,233859
579,0.002161,74.125.200.0-255,2902,162587,65,233859
580,0.002163,172.31.40.0-255,66,162653,65,233859
581,0.002166,74.125.200.0-255,1484,164137,65,233859
582,0.002181,74.125.200.0-255,2902,167039,65,233859
583,0.002184,172.31.40.0-255,66,167105,65,233859
584,0.002197,74.125.200.0-255,1484,168589,65,233859
585,0.002224,74.125.200.0-255,2184,170773,65,233859
586,0.002227,172.31.40.0-255,66,170839,65,233859
587,0.002362,74.125.200.0-255,1484,172323,65,233859
588,0.002367,74.125.200.0-255,1484,173807,65,233859
589,0.00237,172.31.40.0-255,66,173873,65,233859
590,0.002383,74.125.200.0-255,1484,175357,65,233859
591,0.002398,74.125.200.0-255,5738,181095,65,233859
592,0.0024,172.31.40.0-255,66,181161,65,233859
593,0.002411,74.125.200.0-255,1484,182645,65,233859
594,0.002423,74.125.200.0-255,1484,184129,65,233859
595,0.002426,172.31.40.0-255,66,184195,65,233859
596,0.002441,74.125.200.0-255,1484,185679,65,233859
597,0.002457,74.125.200.0-255,5738,191417,65,233859
598,0.00246,172.31.40.0-255,66,191483,65,233859
599,0.002463,74.125.200.0-255,1484,192967,65,233859
600,0.002483,74.125.200.0-255,2902,195869,65,233859
601,0.002485,172.31.40.0-255,66,195935,65,233859
602,0.002549,74.125.200.0-255,4320,200255,65,233859
603,0.002553,172.31.40.0-255,66,200321,65,233859
604,0.005023,74.125.200.0-255,1484,201805,65,233859
605,0.005091,74.125.200.0-255,4320,206125,65,233859
606,0.005095,172.31.40.0-255,66,206191,65,233859
607,0.007627,74.125.200.0-255,5738,211929,65,233859
608,0.007633,172.31.40.0-255,66,211995,65,233859
609,0.01019,74.125.200.0-255,5738,217733,65,233859
610,0.010199,172.31.40.0-255,66,217799,65,233859
611,0.012731,74.125.200.0-255,4320,222119,65,233859
612,0.012739,172.31.40.0-255,66,222185,65,233859
613,0.012759,74.125.200.0-255,1484,223669,65,233859
614,0.015313,74.125.200.0-255,4320,227989,65,233859
615,0.015321,172.31.40.0-255,66,228055,65,233859
616,0.017857,74.125.200.0-255,5738,233793,65,233859
617,0.017865,172.31.40.0-255,66,233859,65,233859
618,0.0,172.217.194.0-255,150,150,65,110436
619,1.8e-05,172.31.40.0-255,66,216,65,110436
620,2.5e-05,172.217.194.0-255,1484,1700,65,110436
621,3e-05,172.31.40.0-255,66,1766,65,110436
622,4.2e-05,172.217.194.0-255,2902,4668,65,110436
623,4.6e-05,172.31.40.0-255,66,4734,65,110436
624,5.2e-05,172.217.194.0-255,5738,10472,65,110436
625,5.5e-05,172.31.40.0-255,66,10538,65,110436
626,8.4e-05,172.217.194.0-255,3409,13947,65,110436
627,8.9e-05,172.31.40.0-255,66,14013,65,110436
628,0.000121,172.217.194.0-255,4320,18333,65,110436
629,0.000123,172.31.40.0-255,66,18399,65,110436
630,0.000134,172.31.40.0-255,66,18465,65,110436
631,0.000138,172.217.194.0-255,2543,21008,65,110436
632,0.00014,172.31.40.0-255,66,21074,65,110436
633,0.000276,172.217.194.0-255,1484,22558,65,110436
634,0.000281,172.31.40.0-255,66,22624,65,110436
635,0.000285,172.217.194.0-255,2902,25526,65,110436
636,0.000287,172.31.40.0-255,66,25592,65,110436
637,0.000328,172.217.194.0-255,5738,31330,65,110436
638,0.00033,172.31.40.0-255,66,31396,65,110436
639,0.000379,172.31.40.0-255,66,31462,65,110436
640,0.000403,172.217.194.0-255,7156,38618,65,110436
641,0.000405,172.31.40.0-255,66,38684,65,110436
642,0.00043,172.217.194.0-255,2854,41538,65,110436
643,0.000432,172.31.40.0-255,66,41604,65,110436
644,0.000435,172.217.194.0-255,98,41702,65,110436
645,0.000436,172.31.40.0-255,66,41768,65,110436
646,0.000439,172.217.194.0-255,364,42132,65,110436
647,0.00044,172.31.40.0-255,66,42198,65,110436
648,0.000772,172.217.194.0-255,1484,43682,65,110436
649,0.000788,172.217.194.0-255,2902,46584,65,110436
650,0.000792,172.31.40.0-255,66,46650,65,110436
651,0.00081,172.217.194.0-255,5738,52388,65,110436
652,0.000817,172.31.40.0-255,66,52454,65,110436
653,0.000827,172.217.194.0-255,4320,56774,65,110436
654,0.000829,172.31.40.0-255,66,56840,65,110436
655,0.00086,172.217.194.0-255,2902,59742,65,110436
656,0.000863,172.31.40.0-255,66,59808,65,110436
657,0.00088,172.31.40.0-255,66,59874,65,110436
658,0.000883,172.217.194.0-255,2184,62058,65,110436
659,0.000885,172.31.40.0-255,66,62124,65,110436
660,0.001786,172.217.194.0-255,1484,63608,65,110436
661,0.001796,172.217.194.0-255,2902,66510,65,110436
662,0.0018,172.31.40.0-255,66,66576,65,110436
663,0.001806,172.217.194.0-255,2902,69478,65,110436
664,0.001807,172.31.40.0-255,66,69544,65,110436
665,0.001829,172.217.194.0-255,2902,72446,65,110436
666,0.001835,172.31.40.0-255,66,72512,65,110436
667,0.001846,172.217.194.0-255,2902,75414,65,110436
668,0.001848,172.31.40.0-255,66,75480,65,110436
669,0.001895,172.31.40.0-255,66,75546,65,110436
670,0.001906,172.31.40.0-255,66,75612,65,110436
671,0.004517,172.217.194.0-255,5738,81350,65,110436
672,0.004522,172.31.40.0-255,66,81416,65,110436
673,0.007164,172.217.194.0-255,5738,87154,65,110436
674,0.007171,172.31.40.0-255,66,87220,65,110436
675,0.009791,172.217.194.0-255,5738,92958,65,110436
676,0.0098,172.31.40.0-255,66,93024,65,110436
677,0.012412,172.217.194.0-255,5738,98762,65,110436
678,0.012419,172.31.40.0-255,66,98828,65,110436
679,0.015033,172.217.194.0-255,5738,104566,65,110436
680,0.015042,172.31.40.0-255,66,104632,65,110436
681,0.017659,172.217.194.0-255,5738,110370,65,110436
682,0.017668,172.31.40.0-255,66,110436,65,110436
683,0.0,74.125.200.0-255,152,152,65,162294
684,1.8e-05,172.31.40.0-255,66,218,65,162294
685,2.5e-05,74.125.200.0-255,1484,1702,65,162294
686,3e-05,172.31.40.0-255,66,1768,65,162294
687,3.6e-05,74.125.200.0-255,2902,4670,65,162294
688,4e-05,172.31.40.0-255,66,4736,65,162294
689,4.3e-05,74.125.200.0-255,1484,6220,65,162294
690,4.6e-05,172.31.40.0-255,66,6286,65,162294
691,5.2e-05,74.125.200.0-255,2902,9188,65,162294
692,5.5e-05,172.31.40.0-255,66,9254,65,162294
693,8e-05,74.125.200.0-255,4864,14118,65,162294
694,8.3e-05,172.31.40.0-255,66,14184,65,162294
695,0.000174,74.125.200.0-255,1484,15668,65,162294
696,0.000176,172.31.40.0-255,66,15734,65,162294
697,0.000181,74.125.200.0-255,1484,17218,65,162294
698,0.000183,172.31.40.0-255,66,17284,65,162294
699,0.000194,74.125.200.0-255,1484,18768,65,162294
700,0.000196,172.31.40.0-255,66,18834,65,162294
701,0.000226,74.125.200.0-255,5738,24572,65,162294
702,0.000229,172.31.40.0-255,66,24638,65,162294
703,0.000235,74.125.200.0-255,4320,28958,65,162294
704,0.000238,172.31.40.0-255,66,29024,65,162294
705,0.000251,74.125.200.0-255,2543,31567,65,162294
706,0.000253,172.31.40.0-255,66,31633,65,162294
707,0.000459,74.125.200.0-255,1484,33117,65,162294
708,0.000465,172.31.40.0-255,66,33183,65,162294
709,0.00047,74.125.200.0-255,2902,36085,65,162294
710,0.000473,172.31.40.0-255,66,36151,65,162294
711,0.000477,74.125.200.0-255,2902,39053,65,162294
712,0.000479,172.31.40.0-255,66,39119,65,162294
713,0.000508,74.125.200.0-255,4320,43439,65,162294
714,0.000512,172.31.40.0-255,66,43505,65,162294
715,0.000529,74.125.200.0-255,1484,44989,65,162294
716,0.000563,172.31.40.0-255,66,45055,65,162294
717,0.000574,172.31.40.0-255,66,45121,65,162294
718,0.000599,74.125.200.0-255,1484,46605,65,162294
719,0.000604,74.125.200.0-255,2543,49148,65,162294
720,0.000607,172.31.40.0-255,66,49214,65,162294
721,0.00061,74.125.200.0-255,414,49628,65,162294
722,0.000657,74.125.200.0-255,330,49958,65,162294
723,0.001037,172.31.40.0-255,66,50024,65,162294
724,0.001053,74.125.200.0-255,1484,51508,65,162294
725,0.001059,74.125.200.0-255,2902,54410,65,162294
726,0.001061,172.31.40.0-255,66,54476,65,162294
727,0.001073,74.125.200.0-255,1484,55960,65,162294
728,0.00109,74.125.200.0-255,4320,60280,65,162294
729,0.001092,172.31.40.0-255,66,60346,65,162294
730,0.001099,74.125.200.0-255,7156,67502,65,162294
731,0.001101,172.31.40.0-255,66,67568,65,162294
732,0.001135,74.125.200.0-255,7156,74724,65,162294
733,0.001138,172.31.40.0-255,66,74790,65,162294
734,0.001159,74.125.200.0-255,7156,81946,65,162294
735,0.001161,172.31.40.0-255,66,82012,65,162294
736,0.001164,74.125.200.0-255,2184,84196,65,162294
737,0.001166,172.31.40.0-255,66,84262,65,162294
738,0.001792,74.125.200.0-255,1484,85746,65,162294
739,0.0018,74.125.200.0-255,1484,87230,65,162294
740,0.001804,172.31.40.0-255,66,87296,65,162294
741,0.001818,74.125.200.0-255,1484,88780,65,162294
742,0.001824,74.125.200.0-255,5738,94518,65,162294
743,0.001826,172.31.40.0-255,66,94584,65,162294
744,0.001851,74.125.200.0-255,5738,100322,65,162294
745,0.001853,172.31.40.0-255,66,100388,65,162294
746,0.001869,74.125.200.0-255,4320,104708,65,162294
747,0.001871,172.31.40.0-255,66,104774,65,162294
748,0.001875,74.125.200.0-255,2902,107676,65,162294
749,0.001877,172.31.40.0-255,66,107742,65,162294
750,0.001909,172.31.40.0-255,66,107808,65,162294
751,0.001913,74.125.200.0-255,2184,109992,65,162294
752,0.001914,172.31.40.0-255,66,110058,65,162294
753,0.003866,74.125.200.0-255,5738,115796,65,162294
754,0.003873,172.31.40.0-255,66,115862,65,162294
755,0.005834,74.125.200.0-255,5738,121600,65,162294
756,0.005838,172.31.40.0-255,66,121666,65,162294
757,0.007798,74.125.200.0-255,5738,127404,65,162294
758,0.007804,172.31.40.0-255,66,127470,65,162294
759,0.00977,74.125.200.0-255,5738,133208,65,162294
760,0.009777,172.31.40.0-255,66,133274,65,162294
761,0.011734,74.125.200.0-255,5738,139012,65,162294
762,0.011741,172.31.40.0-255,66,139078,65,162294
763,0.013707,74.125.200.0-255,5738,144816,65,162294
764,0.013716,172.31.40.0-255,66,144882,65,162294
765,0.01568,74.125.200.0-255,5738,150620,65,162294
766,0.015688,172.31.40.0-255,66,150686,65,162294
767,0.017649,74.125.200.0-255,5738,156424,65,162294
768,0.017657,172.31.40.0-255,66,156490,65,162294
769,0.019621,74.125.200.0-255,5738,162228,65,162294
770,0.01963,172.31.40.0-255,66,162294,65,162294
771,0.0,172.217.194.0-255,146,146,65,79391
772,2.2e-05,172.31.40.0-255,66,212,65,79391
773,3e-05,172.217.194.0-255,1484,1696,65,79391
774,3.4e-05,172.31.40.0-255,66,1762,65,79391
775,4.8e-05,172.217.194.0-255,2902,4664,65,79391
776,5.2e-05,172.31.40.0-255,66,4730,65,79391
777,6e-05,172.217.194.0-255,7156,11886,65,79391
778,6.3e-05,172.31.40.0-255,66,11952,65,79391
779,6.6e-05,172.217.194.0-255,1949,13901,65,79391
780,6.9e-05,172.31.40.0-255,66,13967,65,79391
781,0.000952,172.217.194.0-255,1484,15451,65,79391
782,0.000959,172.31.40.0-255,66,15517,65,79391
783,0.000989,172.217.194.0-255,2902,18419,65,79391
784,0.000992,172.31.40.0-255,66,18485,65,79391
785,0.001024,172.217.194.0-255,4320,22805,65,79391
786,0.001026,172.31.40.0-255,66,22871,65,79391
787,0.00103,172.217.194.0-255,1484,24355,65,79391
788,0.001032,172.31.40.0-255,66,24421,65,79391
789,0.001036,172.217.194.0-255,2902,27323,65,79391
790,0.001042,172.31.40.0-255,66,27389,65,79391
791,0.001084,172.217.194.0-255,5379,32768,65,79391
792,0.001088,172.31.40.0-255,66,32834,65,79391
793,0.001119,172.217.194.0-255,5738,38572,65,79391
794,0.001122,172.31.40.0-255,66,38638,65,79391
795,0.001126,172.217.194.0-255,1484,40122,65,79391
796,0.001128,172.31.40.0-255,66,40188,65,79391
797,0.001169,172.31.40.0-255,66,40254,65,79391
798,0.001181,172.31.40.0-255,66,40320,65,79391
799,0.001191,172.217.194.0-255,5020,45340,65,79391
800,0.001194,172.31.40.0-255,66,45406,65,79391
801,0.004431,172.217.194.0-255,381,45787,65,79391
802,0.004992,172.31.40.0-255,66,45853,65,79391
803,0.008565,172.217.194.0-255,1484,47337,65,79391
804,0.00858,172.217.194.0-255,2902,50239,65,79391
805,0.008586,172.31.40.0-255,66,50305,65,79391
806,0.008593,172.217.194.0-255,1484,51789,65,79391
807,0.010674,172.217.194.0-255,4320,56109,65,79391
808,0.010682,172.31.40.0-255,66,56175,65,79391
809,0.012763,172.217.194.0-255,5738,61913,65,79391
810,0.012783,172.31.40.0-255,66,61979,65,79391
811,0.014863,172.217.194.0-255,5738,67717,65,79391
812,0.014873,172.31.40.0-255,66,67783,65,79391
813,0.016949,172.217.194.0-255,5738,73521,65,79391
814,0.016958,172.31.40.0-255,66,73587,65,79391
815,0.019027,172.217.194.0-255,5738,79325,65,79391
816,0.019034,172.31.40.0-255,66,79391,65,79391
817,0.0,74.125.24.0-255,152,152,65,220260
818,2.1e-05,172.31.40.0-255,66,218,65,220260
819,2.7e-05,74.125.24.0-255,1484,1702,65,220260
820,3.2e-05,172.31.40.0-255,66,1768,65,220260
821,3.7e-05,74.125.24.0-255,2902,4670,65,220260
822,4e-05,172.31.40.0-255,66,4736,65,220260
823,4.3e-05,74.125.24.0-255,1484,6220,65,220260
824,4.5e-05,172.31.40.0-255,66,6286,65,220260
825,8.1e-05,172.31.40.0-255,66,6352,65,220260
826,8.8e-05,74.125.24.0-255,7156,13508,65,220260
827,9e-05,172.31.40.0-255,66,13574,65,220260
828,0.000105,74.125.24.0-255,1484,15058,65,220260
829,0.000107,172.31.40.0-255,66,15124,65,220260
830,0.000118,74.125.24.0-255,1484,16608,65,220260
831,0.00012,172.31.40.0-255,66,16674,65,220260
832,0.000138,74.125.24.0-255,6797,23471,65,220260
833,0.00014,172.31.40.0-255,66,23537,65,220260
834,0.000224,74.125.24.0-255,1484,25021,65,220260
835,0.000228,172.31.40.0-255,66,25087,65,220260
836,0.000233,74.125.24.0-255,2902,27989,65,220260
837,0.000235,172.31.40.0-255,66,28055,65,220260
838,0.00024,74.125.24.0-255,4320,32375,65,220260
839,0.000243,172.31.40.0-255,66,32441,65,220260
840,0.000265,74.125.24.0-255,1484,33925,65,220260
841,0.000267,172.31.40.0-255,66,33991,65,220260
842,0.000275,74.125.24.0-255,7156,41147,65,220260
843,0.000278,172.31.40.0-255,66,41213,65,220260
844,0.000299,74.125.24.0-255,6797,48010,65,220260
845,0.000302,172.31.40.0-255,66,48076,65,220260
846,0.000314,172.31.40.0-255,66,48142,65,220260
847,0.000316,74.125.24.0-255,444,48586,65,220260
848,0.000403,74.125.24.0-255,331,48917,65,220260
849,0.000813,74.125.24.0-255,1484,50401,65,220260
850,0.000819,172.31.40.0-255,66,50467,65,220260
851,0.000825,74.125.24.0-255,2902,53369,65,220260
852,0.000828,172.31.40.0-255,66,53435,65,220260
853,0.000831,74.125.24.0-255,1484,54919,65,220260
854,0.000847,74.125.24.0-255,4320,59239,65,220260
855,0.00085,172.31.40.0-255,66,59305,65,220260
856,0.000855,74.125.24.0-255,4320,63625,65,220260
857,0.000857,172.31.40.0-255,66,63691,65,220260
858,0.000882,74.125.24.0-255,1484,65175,65,220260
859,0.000911,172.31.40.0-255,66,65241,65,220260
860,0.000922,172.31.40.0-255,66,65307,65,220260
861,0.001558,74.125.24.0-255,1484,66791,65,220260
862,0.001567,74.125.24.0-255,2902,69693,65,220260
863,0.001572,172.31.40.0-255,66,69759,65,220260
864,0.00158,74.125.24.0-255,5738,75497,65,220260
865,0.001582,172.31.40.0-255,66,75563,65,220260
866,0.001587,74.125.24.0-255,2902,78465,65,220260
867,0.001589,172.31.40.0-255,66,78531,65,220260
868,0.001609,74.125.24.0-255,2902,81433,65,220260
869,0.001611,172.31.40.0-255,66,81499,65,220260
870,0.001616,74.125.24.0-255,2902,84401,65,220260
871,0.001618,172.31.40.0-255,66,84467,65,220260
872,0.001638,172.31.40.0-255,66,84533,65,220260
873,0.001644,74.125.24.0-255,4320,88853,65,220260
874,0.001647,172.31.40.0-255,66,88919,65,220260
875,0.001665,74.125.24.0-255,766,89685,65,220260
876,0.001696,74.125.24.0-255,2902,92587,65,220260
877,0.0017,172.31.40.0-255,66,92653,65,220260
878,0.001714,74.125.24.0-255,5738,98391,65,220260
879,0.001716,172.31.40.0-255,66,98457,65,220260
880,0.001728,172.31.40.0-255,66,98523,65,220260
881,0.00175,74.125.24.0-255,2902,101425,65,220260
882,0.001753,172.31.40.0-255,66,101491,65,220260
883,0.001795,172.31.40.0-255,66,101557,65,220260
884,0.001803,74.125.24.0-255,7156,108713,65,220260
885,0.001805,172.31.40.0-255,66,108779,65,220260
886,0.001842,172.31.40.0-255,66,108845,65,220260
887,0.001854,172.31.40.0-255,66,108911,65,220260
888,0.001857,74.125.24.0-255,1484,110395,65,220260
889,0.001862,74.125.24.0-255,2902,113297,65,220260
890,0.001864,172.31.40.0-255,66,113363,65,220260
891,0.001867,74.125.24.0-255,1484,114847,65,220260
892,0.001906,74.125.24.0-255,4320,119167,65,220260
893,0.00191,172.31.40.0-255,66,119233,65,220260
894,0.001924,172.31.40.0-255,66,119299,65,220260
895,0.001935,172.31.40.0-255,66,119365,65,220260
896,0.001958,74.125.24.0-255,1484,120849,65,220260
897,0.001972,74.125.24.0-255,766,121615,65,220260
898,0.001975,172.31.40.0-255,66,121681,65,220260
899,0.00198,74.125.24.0-255,2902,124583,65,220260
900,0.001983,172.31.40.0-255,66,124649,65,220260
901,0.001986,74.125.24.0-255,1484,126133,65,220260
902,0.002002,74.125.24.0-255,4320,130453,65,220260
903,0.002004,172.31.40.0-255,66,130519,65,220260
904,0.002016,74.125.24.0-255,1484,132003,65,220260
905,0.002023,74.125.24.0-255,5738,137741,65,220260
906,0.002025,172.31.40.0-255,66,137807,65,220260
907,0.002041,172.31.40.0-255,66,137873,65,220260
908,0.00207,74.125.24.0-255,5738,143611,65,220260
909,0.002074,172.31.40.0-255,66,143677,65,220260
910,0.002079,74.125.24.0-255,3602,147279,65,220260
911,0.002081,172.31.40.0-255,66,147345,65,220260
912,0.00213,74.125.24.0-255,1484,148829,65,220260
913,0.002155,74.125.24.0-255,2902,151731,65,220260
914,0.002159,172.31.40.0-255,66,151797,65,220260
915,0.002166,74.125.24.0-255,5738,157535,65,220260
916,0.002169,172.31.40.0-255,66,157601,65,220260
917,0.002176,74.125.24.0-255,7156,164757,65,220260
918,0.002178,172.31.40.0-255,66,164823,65,220260
919,0.002196,74.125.24.0-255,5738,170561,65,220260
920,0.002198,172.31.40.0-255,66,170627,65,220260
921,0.002222,172.31.40.0-255,66,170693,65,220260
922,0.002235,172.31.40.0-255,66,170759,65,220260
923,0.002243,74.125.24.0-255,7156,177915,65,220260
924,0.002245,172.31.40.0-255,66,177981,65,220260
925,0.002267,74.125.24.0-255,5738,183719,65,220260
926,0.00227,172.31.40.0-255,66,183785,65,220260
927,0.002287,74.125.24.0-255,5738,189523,65,220260
928,0.0023,74.125.24.0-255,1484,191007,65,220260
929,0.006292,172.31.40.0-255,66,191073,65,220260
930,0.00648,172.31.40.0-255,101,191174,65,220260
931,0.008588,74.125.24.0-255,5738,196912,65,220260
932,0.008596,172.31.40.0-255,66,196978,65,220260
933,0.008712,74.125.24.0-255,66,197044,65,220260
934,0.010877,74.125.24.0-255,5738,202782,65,220260
935,0.010884,172.31.40.0-255,66,202848,65,220260
936,0.013159,74.125.24.0-255,5738,208586,65,220260
937,0.013167,172.31.40.0-255,66,208652,65,220260
938,0.015428,74.125.24.0-255,5738,214390,65,220260
939,0.015436,172.31.40.0-255,66,214456,65,220260
940,0.017717,74.125.24.0-255,5738,220194,65,220260
941,0.017727,172.31.40.0-255,66,220260,65,220260
942,0.0,74.125.24.0-255,147,147,65,143336
943,2.3e-05,172.31.40.0-255,66,213,65,143336
944,3.1e-05,74.125.24.0-255,1484,1697,65,143336
945,3.5e-05,172.31.40.0-255,66,1763,65,143336
946,4.1e-05,74.125.24.0-255,2902,4665,65,143336
947,6.9e-05,172.31.40.0-255,66,4731,65,143336
948,7.8e-05,74.125.24.0-255,7156,11887,65,143336
949,8.1e-05,172.31.40.0-255,66,11953,65,143336
950,8.6e-05,74.125.24.0-255,1942,13895,65,143336
951,8.8e-05,172.31.40.0-255,66,13961,65,143336
952,0.000133,74.125.24.0-255,1484,15445,65,143336
953,0.000136,172.31.40.0-255,66,15511,65,143336
954,0.000141,74.125.24.0-255,2902,18413,65,143336
955,0.000144,172.31.40.0-255,66,18479,65,143336
956,0.00015,74.125.24.0-255,5738,24217,65,143336
957,0.000157,172.31.40.0-255,66,24283,65,143336
958,0.000191,74.125.24.0-255,6797,31080,65,143336
959,0.0002,172.31.40.0-255,66,31146,65,143336
960,0.000348,74.125.24.0-255,1484,32630,65,143336
961,0.000352,172.31.40.0-255,66,32696,65,143336
962,0.000358,74.125.24.0-255,2902,35598,65,143336
963,0.000361,172.31.40.0-255,66,35664,65,143336
964,0.000394,74.125.24.0-255,5738,41402,65,143336
965,0.000397,172.31.40.0-255,66,41468,65,143336
966,0.000402,74.125.24.0-255,4320,45788,65,143336
967,0.000405,172.31.40.0-255,66,45854,65,143336
968,0.000442,172.31.40.0-255,66,45920,65,143336
969,0.000473,172.31.40.0-255,66,45986,65,143336
970,0.000476,74.125.24.0-255,360,46346,65,143336
971,0.000478,172.31.40.0-255,66,46412,65,143336
972,0.000591,74.125.24.0-255,384,46796,65,143336
973,0.001103,74.125.24.0-255,1484,48280,65,143336
974,0.001111,172.31.40.0-255,66,48346,65,143336
975,0.001118,74.125.24.0-255,2902,51248,65,143336
976,0.001121,172.31.40.0-255,66,51314,65,143336
977,0.001132,74.125.24.0-255,5738,57052,65,143336
978,0.001134,172.31.40.0-255,66,57118,65,143336
979,0.00114,74.125.24.0-255,4320,61438,65,143336
980,0.001142,172.31.40.0-255,66,61504,65,143336
981,0.001183,172.31.40.0-255,66,61570,65,143336
982,0.001197,74.125.24.0-255,2543,64113,65,143336
983,0.001199,172.31.40.0-255,66,64179,65,143336
984,0.001205,74.125.24.0-255,6797,70976,65,143336
985,0.001208,172.31.40.0-255,66,71042,65,143336
986,0.001994,74.125.24.0-255,1484,72526,65,143336
987,0.002001,74.125.24.0-255,2902,75428,65,143336
988,0.002006,172.31.40.0-255,66,75494,65,143336
989,0.002013,74.125.24.0-255,2902,78396,65,143336
990,0.002014,172.31.40.0-255,66,78462,65,143336
991,0.002041,74.125.24.0-255,2902,81364,65,143336
992,0.002043,172.31.40.0-255,66,81430,65,143336
993,0.002062,172.31.40.0-255,66,81496,65,143336
994,0.002069,74.125.24.0-255,7156,88652,65,143336
995,0.002073,172.31.40.0-255,66,88718,65,143336
996,0.002127,74.125.24.0-255,3602,92320,65,143336
997,0.002129,172.31.40.0-255,66,92386,65,143336
998,0.002294,74.125.24.0-255,1484,93870,65,143336
999,0.002309,74.125.24.0-255,2902,96772,65,143336
1000,0.002313,172.31.40.0-255,66,96838,65,143336
1001,0.00232,74.125.24.0-255,5738,102576,65,143336
1002,0.002322,172.31.40.0-255,66,102642,65,143336
1003,0.002362,172.31.40.0-255,66,102708,65,143336
1004,0.004633,74.125.24.0-255,5738,108446,65,143336
1005,0.00464,172.31.40.0-255,66,108512,65,143336
1006,0.006942,74.125.24.0-255,5738,114250,65,143336
1007,0.006946,172.31.40.0-255,66,114316,65,143336
1008,0.009283,74.125.24.0-255,5738,120054,65,143336
1009,0.00929,172.31.40.0-255,66,120120,65,143336
1010,0.0116,74.125.24.0-255,5738,125858,65,143336
1011,0.011608,172.31.40.0-255,66,125924,65,143336
1012,0.013886,74.125.24.0-255,5738,131662,65,143336
1013,0.013894,172.31.40.0-255,66,131728,65,143336
1014,0.016257,74.125.24.0-255,5738,137466,65,143336
1015,0.016267,172.31.40.0-255,66,137532,65,143336
1016,0.0186,74.125.24.0-255,5738,143270,65,143336
1017,0.018609,172.31.40.0-255,66,143336,65,143336
1018,0.0,74.125.24.0-255,153,153,65,193443
1019,1.7e-05,172.31.40.0-255,66,219,65,193443
1020,2.5e-05,74.125.24.0-255,1484,1703,65,193443
1021,2.9e-05,172.31.40.0-255,66,1769,65,193443
1022,3.5e-05,74.125.24.0-255,2902,4671,65,193443
1023,3.8e-05,172.31.40.0-255,66,4737,65,193443
1024,4.6e-05,74.125.24.0-255,7156,11893,65,193443
1025,4.9e-05,172.31.40.0-255,66,11959,65,193443
1026,7.6e-05,74.125.24.0-255,3420,15379,65,193443
1027,7.9e-05,172.31.40.0-255,66,15445,65,193443
1028,9.9e-05,74.125.24.0-255,7156,22601,65,193443
1029,0.000101,172.31.40.0-255,66,22667,65,193443
1030,0.000126,74.125.24.0-255,5738,28405,65,193443
1031,0.000129,172.31.40.0-255,66,28471,65,193443
1032,0.000133,74.125.24.0-255,2543,31014,65,193443
1033,0.000135,172.31.40.0-255,66,31080,65,193443
1034,0.00035,74.125.24.0-255,1484,32564,65,193443
1035,0.000357,172.31.40.0-255,66,32630,65,193443
1036,0.000363,74.125.24.0-255,2902,35532,65,193443
1037,0.000366,172.31.40.0-255,66,35598,65,193443
1038,0.000369,74.125.24.0-255,1484,37082,65,193443
1039,0.000371,172.31.40.0-255,66,37148,65,193443
1040,0.000399,74.125.24.0-255,4320,41468,65,193443
1041,0.000402,172.31.40.0-255,66,41534,65,193443
1042,0.000409,74.125.24.0-255,6797,48331,65,193443
1043,0.000411,172.31.40.0-255,66,48397,65,193443
1044,0.000416,74.125.24.0-255,4320,52717,65,193443
1045,0.000418,172.31.40.0-255,66,52783,65,193443
1046,0.000439,74.125.24.0-255,2902,55685,65,193443
1047,0.000442,172.31.40.0-255,66,55751,65,193443
1048,0.000463,172.31.40.0-255,66,55817,65,193443
1049,0.000485,74.125.24.0-255,1125,56942,65,193443
1050,0.000489,74.125.24.0-255,677,57619,65,193443
1051,0.000491,172.31.40.0-255,66,57685,65,193443
1052,0.000806,74.125.24.0-255,1484,59169,65,193443
1053,0.000811,74.125.24.0-255,2902,62071,65,193443
1054,0.000822,172.31.40.0-255,66,62137,65,193443
1055,0.000829,74.125.24.0-255,5738,67875,65,193443
1056,0.000831,172.31.40.0-255,66,67941,65,193443
1057,0.000855,74.125.24.0-255,5738,73679,65,193443
1058,0.000857,172.31.40.0-255,66,73745,65,193443
1059,0.000888,172.31.40.0-255,66,73811,65,193443
1060,0.000891,74.125.24.0-255,1484,75295,65,193443
1061,0.000946,172.31.40.0-255,66,75361,65,193443
1062,0.000966,74.125.24.0-255,1484,76845,65,193443
1063,0.000972,74.125.24.0-255,2902,79747,65,193443
1064,0.000974,172.31.40.0-255,66,79813,65,193443
1065,0.001004,74.125.24.0-255,5738,85551,65,193443
1066,0.001008,172.31.40.0-255,66,85617,65,193443
1067,0.001012,74.125.24.0-255,2902,88519,65,193443
1068,0.001014,172.31.40.0-255,66,88585,65,193443
1069,0.001069,172.31.40.0-255,66,88651,65,193443
1070,0.001076,74.125.24.0-255,5738,94389,65,193443
1071,0.001078,172.31.40.0-255,66,94455,65,193443
1072,0.001094,74.125.24.0-255,5020,99475,65,193443
1073,0.001096,172.31.40.0-255,66,99541,65,193443
1074,0.001144,74.125.24.0-255,1484,101025,65,193443
1075,0.00115,74.125.24.0-255,2902,103927,65,193443
1076,0.001152,172.31.40.0-255,66,103993,65,193443
1077,0.001159,74.125.24.0-255,5738,109731,65,193443
1078,0.001161,172.31.40.0-255,66,109797,65,193443
1079,0.0012,172.31.40.0-255,66,109863,65,193443
1080,0.001212,172.31.40.0-255,66,109929,65,193443
1081,0.001229,74.125.24.0-255,6438,116367,65,193443
1082,0.001231,172.31.40.0-255,66,116433,65,193443
1083,0.001246,172.31.40.0-255,66,116499,65,193443
1084,0.001269,74.125.24.0-255,2902,119401,65,193443
1085,0.001272,172.31.40.0-255,66,119467,65,193443
1086,0.001305,172.31.40.0-255,66,119533,65,193443
1087,0.001338,172.31.40.0-255,66,119599,65,193443
1088,0.001341,74.125.24.0-255,1484,121083,65,193443
1089,0.001387,172.31.40.0-255,66,121149,65,193443
1090,0.0014,74.125.24.0-255,1484,122633,65,193443
1091,0.001421,74.125.24.0-255,2902,125535,65,193443
1092,0.001426,74.125.24.0-255,2902,128437,65,193443
1093,0.00143,172.31.40.0-255,66,128503,65,193443
1094,0.001438,172.31.40.0-255,66,128569,65,193443
1095,0.001442,74.125.24.0-255,2902,131471,65,193443
1096,0.001445,172.31.40.0-255,66,131537,65,193443
1097,0.001451,74.125.24.0-255,5738,137275,65,193443
1098,0.001454,172.31.40.0-255,66,137341,65,193443
1099,0.001486,74.125.24.0-255,7156,144497,65,193443
1100,0.00149,172.31.40.0-255,66,144563,65,193443
1101,0.001501,172.31.40.0-255,66,144629,65,193443
1102,0.00152,74.125.24.0-255,2184,146813,65,193443
1103,0.001522,172.31.40.0-255,66,146879,65,193443
1104,0.003562,74.125.24.0-255,2902,149781,65,193443
1105,0.00357,172.31.40.0-255,66,149847,65,193443
1106,0.003609,74.125.24.0-255,2902,152749,65,193443
1107,0.003611,172.31.40.0-255,66,152815,65,193443
1108,0.005663,74.125.24.0-255,5738,158553,65,193443
1109,0.005669,172.31.40.0-255,66,158619,65,193443
1110,0.00776,74.125.24.0-255,5738,164357,65,193443
1111,0.007764,172.31.40.0-255,66,164423,65,193443
1112,0.009833,74.125.24.0-255,5738,170161,65,193443
1113,0.00984,172.31.40.0-255,66,170227,65,193443
1114,0.011947,74.125.24.0-255,5738,175965,65,193443
1115,0.011955,172.31.40.0-255,66,176031,65,193443
1116,0.01408,74.125.24.0-255,5738,181769,65,193443
1117,0.014089,172.31.40.0-255,66,181835,65,193443
1118,0.016168,74.125.24.0-255,5738,187573,65,193443
1119,0.016175,172.31.40.0-255,66,187639,65,193443
1120,0.018212,74.125.24.0-255,5738,193377,65,193443
1121,0.01822,172.31.40.0-255,66,193443,65,193443
1122,0.0,216.58.203.0-255,303,303,65,218862
1123,2.3e-05,172.31.40.0-255,66,369,65,218862
1124,2.9e-05,216.58.203.0-255,1484,1853,65,218862
1125,3.3e-05,172.31.40.0-255,66,1919,65,218862
1126,4e-05,216.58.203.0-255,4320,6239,65,218862
1127,4.3e-05,172.31.40.0-255,66,6305,65,218862
1128,5.5e-05,172.31.40.0-255,66,6371,65,218862
1129,6e-05,216.58.203.0-255,5738,12109,65,218862
1130,6.3e-05,172.31.40.0-255,66,12175,65,218862
1131,6.7e-05,216.58.203.0-255,4320,16495,65,218862
1132,7.1e-05,172.31.40.0-255,66,16561,65,218862
1133,9.1e-05,216.58.203.0-255,2902,19463,65,218862
1134,9.4e-05,172.31.40.0-255,66,19529,65,218862
1135,9.7e-05,216.58.203.0-255,2543,22072,65,218862
1136,9.9e-05,172.31.40.0-255,66,22138,65,218862
1137,0.000189,216.58.203.0-255,1484,23622,65,218862
1138,0.000193,172.31.40.0-255,66,23688,65,218862
1139,0.000213,216.58.203.0-255,2902,26590,65,218862
1140,0.000216,172.31.40.0-255,66,26656,65,218862
1141,0.000218,216.58.203.0-255,1484,28140,65,218862
1142,0.00022,172.31.40.0-255,66,28206,65,218862
1143,0.000243,216.58.203.0-255,4320,32526,65,218862
1144,0.000245,172.31.40.0-255,66,32592,65,218862
1145,0.000261,216.58.203.0-255,7156,39748,65,218862
1146,0.000264,172.31.40.0-255,66,39814,65,218862
1147,0.000283,216.58.203.0-255,1125,40939,65,218862
1148,0.000285,172.31.40.0-255,66,41005,65,218862
1149,0.000295,172.31.40.0-255,66,41071,65,218862
1150,0.000326,216.58.203.0-255,6797,47868,65,218862
1151,0.000328,172.31.40.0-255,66,47934,65,218862
1152,0.00033,216.58.203.0-255,362,48296,65,218862
1153,0.000607,216.58.203.0-255,383,48679,65,218862
1154,0.000742,216.58.203.0-255,1484,50163,65,218862
1155,0.000746,172.31.40.0-255,66,50229,65,218862
1156,0.000751,216.58.203.0-255,2902,53131,65,218862
1157,0.000753,172.31.40.0-255,66,53197,65,218862
1158,0.000775,216.58.203.0-255,5738,58935,65,218862
1159,0.000777,172.31.40.0-255,66,59001,65,218862
1160,0.000808,172.31.40.0-255,66,59067,65,218862
1161,0.000827,216.58.203.0-255,3961,63028,65,218862
1162,0.000829,172.31.40.0-255,66,63094,65,218862
1163,0.000852,216.58.203.0-255,1484,64578,65,218862
1164,0.000875,172.31.40.0-255,66,64644,65,218862
1165,0.001038,216.58.203.0-255,1484,66128,65,218862
1166,0.001043,216.58.203.0-255,2902,69030,65,218862
1167,0.001045,172.31.40.0-255,66,69096,65,218862
1168,0.001049,216.58.203.0-255,2902,71998,65,218862
1169,0.001051,172.31.40.0-255,66,72064,65,218862
1170,0.001054,216.58.203.0-255,1484,73548,65,218862
1171,0.001068,216.58.203.0-255,2902,76450,65,218862
1172,0.00107,172.31.40.0-255,66,76516,65,218862
1173,0.001093,216.58.203.0-255,2902,79418,65,218862
1174,0.001095,172.31.40.0-255,66,79484,65,218862
1175,0.001121,216.58.203.0-255,5738,85222,65,218862
1176,0.001123,172.31.40.0-255,66,85288,65,218862
1177,0.001135,172.31.40.0-255,66,85354,65,218862
1178,0.001163,216.58.203.0-255,1484,86838,65,218862
1179,0.001169,216.58.203.0-255,2902,89740,65,218862
1180,0.001171,172.31.40.0-255,66,89806,65,218862
1181,0.001193,216.58.203.0-255,5738,95544,65,218862
1182,0.001195,172.31.40.0-255,66,95610,65,218862
1183,0.001223,172.31.40.0-255,66,95676,65,218862
1184,0.001235,216.58.203.0-255,2902,98578,65,218862
1185,0.001237,172.31.40.0-255,66,98644,65,218862
1186,0.001249,172.31.40.0-255,66,98710,65,218862
1187,0.001282,172.31.40.0-255,66,98776,65,218862
1188,0.001288,216.58.203.0-255,5738,104514,65,218862
1189,0.00129,172.31.40.0-255,66,104580,65,218862
1190,0.00131,172.31.40.0-255,66,104646,65,218862
1191,0.001318,216.58.203.0-255,6438,111084,65,218862
1192,0.00132,172.31.40.0-255,66,111150,65,218862
1193,0.001358,216.58.203.0-255,1484,112634,65,218862
1194,0.001363,216.58.203.0-255,2902,115536,65,218862
1195,0.001367,172.31.40.0-255,66,115602,65,218862
1196,0.001392,216.58.203.0-255,5738,121340,65,218862
1197,0.001394,172.31.40.0-255,66,121406,65,218862
1198,0.001398,216.58.203.0-255,1484,122890,65,218862
1199,0.001426,172.31.40.0-255,66,122956,65,218862
1200,0.001452,172.31.40.0-255,66,123022,65,218862
1201,0.001474,216.58.203.0-255,2184,125206,65,218862
1202,0.001476,172.31.40.0-255,66,125272,65,218862
1203,0.001505,216.58.203.0-255,2902,128174,65,218862
1204,0.001509,172.31.40.0-255,66,128240,65,218862
1205,0.001513,216.58.203.0-255,2902,131142,65,218862
1206,0.001515,172.31.40.0-255,66,131208,65,218862
1207,0.001541,216.58.203.0-255,4320,135528,65,218862
1208,0.001544,172.31.40.0-255,66,135594,65,218862
1209,0.001548,216.58.203.0-255,2902,138496,65,218862
1210,0.00155,172.31.40.0-255,66,138562,65,218862
1211,0.001591,216.58.203.0-255,5738,144300,65,218862
1212,0.001595,172.31.40.0-255,66,144366,65,218862
1213,0.001612,172.31.40.0-255,66,144432,65,218862
1214,0.001626,216.58.203.0-255,1484,145916,65,218862
1215,0.001645,216.58.203.0-255,2902,148818,65,218862
1216,0.001648,172.31.40.0-255,66,148884,65,218862
1217,0.001652,216.58.203.0-255,2902,151786,65,218862
1218,0.001655,172.31.40.0-255,66,151852,65,218862
1219,0.001673,216.58.203.0-255,2902,154754,65,218862
1220,0.001675,172.31.40.0-255,66,154820,65,218862
1221,0.003271,216.58.203.0-255,2902,157722,65,218862
1222,0.003276,172.31.40.0-255,66,157788,65,218862
1223,0.003299,216.58.203.0-255,2902,160690,65,218862
1224,0.003301,172.31.40.0-255,66,160756,65,218862
1225,0.004921,216.58.203.0-255,5738,166494,65,218862
1226,0.004935,172.31.40.0-255,66,166560,65,218862
1227,0.006601,216.58.203.0-255,5738,172298,65,218862
1228,0.006612,172.31.40.0-255,66,172364,65,218862
1229,0.00824,216.58.203.0-255,5738,178102,65,218862
1230,0.008246,172.31.40.0-255,66,178168,65,218862
1231,0.009863,216.58.203.0-255,1484,179652,65,218862
1232,0.009882,216.58.203.0-255,4320,183972,65,218862
1233,0.009884,172.31.40.0-255,66,184038,65,218862
1234,0.011514,216.58.203.0-255,5738,189776,65,218862
1235,0.011521,172.31.40.0-255,66,189842,65,218862
1236,0.013151,216.58.203.0-255,5738,195580,65,218862
1237,0.01316,172.31.40.0-255,66,195646,65,218862
1238,0.01483,216.58.203.0-255,5738,201384,65,218862
1239,0.01484,172.31.40.0-255,66,201450,65,218862
1240,0.016463,216.58.203.0-255,5738,207188,65,218862
1241,0.016469,172.31.40.0-255,66,207254,65,218862
1242,0.018101,216.58.203.0-255,5738,212992,65,218862
1243,0.018107,172.31.40.0-255,66,213058,65,218862
1244,0.019733,216.58.203.0-255,5738,218796,65,218862
1245,0.01974,172.31.40.0-255,66,218862,65,218862
1246,0.0,74.125.68.0-255,151,151,65,141860
1247,2e-05,172.31.40.0-255,66,217,65,141860
1248,2.8e-05,74.125.68.0-255,1484,1701,65,141860
1249,3.2e-05,172.31.40.0-255,66,1767,65,141860
1250,4.6e-05,74.125.68.0-255,2902,4669,65,141860
1251,4.9e-05,172.31.40.0-255,66,4735,65,141860
1252,5.6e-05,74.125.68.0-255,4320,9055,65,141860
1253,5.9e-05,172.31.40.0-255,66,9121,65,141860
1254,9.1e-05,74.125.68.0-255,2902,12023,65,141860
1255,9.4e-05,172.31.40.0-255,66,12089,65,141860
1256,9.9e-05,74.125.68.0-255,2136,14225,65,141860
1257,0.000102,172.31.40.0-255,66,14291,65,141860
1258,0.00047,74.125.68.0-255,1484,15775,65,141860
1259,0.000477,172.31.40.0-255,66,15841,65,141860
1260,0.000482,74.125.68.0-255,1484,17325,65,141860
1261,0.000483,172.31.40.0-255,66,17391,65,141860
1262,0.000487,74.125.68.0-255,1484,18875,65,141860
1263,0.000491,172.31.40.0-255,66,18941,65,141860
1264,0.000522,74.125.68.0-255,1484,20425,65,141860
1265,0.000525,172.31.40.0-255,66,20491,65,141860
1266,0.000533,74.125.68.0-255,5738,26229,65,141860
1267,0.000535,172.31.40.0-255,66,26295,65,141860
1268,0.000542,74.125.68.0-255,5379,31674,65,141860
1269,0.000545,172.31.40.0-255,66,31740,65,141860
1270,0.0016,74.125.68.0-255,1484,33224,65,141860
1271,0.001608,172.31.40.0-255,66,33290,65,141860
1272,0.001618,74.125.68.0-255,2902,36192,65,141860
1273,0.00162,172.31.40.0-255,66,36258,65,141860
1274,0.001633,74.125.68.0-255,5738,41996,65,141860
1275,0.001636,172.31.40.0-255,66,42062,65,141860
1276,0.001672,74.125.68.0-255,6797,48859,65,141860
1277,0.001674,172.31.40.0-255,66,48925,65,141860
1278,0.001682,74.125.68.0-255,7156,56081,65,141860
1279,0.001714,74.125.68.0-255,7156,63237,65,141860
1280,0.001729,74.125.68.0-255,1484,64721,65,141860
1281,0.001747,74.125.68.0-255,1125,65846,65,141860
1282,0.001806,74.125.68.0-255,646,66492,65,141860
1283,0.001966,74.125.68.0-255,1484,67976,65,141860
1284,0.001988,74.125.68.0-255,2902,70878,65,141860
1285,0.001994,74.125.68.0-255,2902,73780,65,141860
1286,0.002008,74.125.68.0-255,2902,76682,65,141860
1287,0.002011,74.125.68.0-255,1484,78166,65,141860
1288,0.002031,74.125.68.0-255,5738,83904,65,141860
1289,0.002053,74.125.68.0-255,5738,89642,65,141860
1290,0.002072,74.125.68.0-255,7156,96798,65,141860
1291,0.002106,74.125.68.0-255,3602,100400,65,141860
1292,0.002185,74.125.68.0-255,1484,101884,65,141860
1293,0.0022,74.125.68.0-255,2902,104786,65,141860
1294,0.002255,74.125.68.0-255,2902,107688,65,141860
1295,0.00228,74.125.68.0-255,2902,110590,65,141860
1296,0.002304,74.125.68.0-255,2184,112774,65,141860
1297,0.005955,172.31.40.0-255,66,112840,65,141860
1298,0.008475,74.125.68.0-255,5738,118578,65,141860
1299,0.008483,172.31.40.0-255,66,118644,65,141860
1300,0.011005,74.125.68.0-255,5738,124382,65,141860
1301,0.011014,172.31.40.0-255,66,124448,65,141860
1302,0.013517,74.125.68.0-255,5738,130186,65,141860
1303,0.013526,172.31.40.0-255,66,130252,65,141860
1304,0.016032,74.125.68.0-255,5738,135990,65,141860
1305,0.01604,172.31.40.0-255,66,136056,65,141860
1306,0.018539,74.125.68.0-255,5738,141794,65,141860
1307,0.018549,172.31.40.0-255,66,141860,65,141860
1308,0.0,172.217.194.0-255,298,298,65,206955
1309,2.2e-05,172.31.40.0-255,66,364,65,206955
1310,2.9e-05,172.217.194.0-255,1484,1848,65,206955
1311,3.5e-05,172.31.40.0-255,66,1914,65,206955
1312,4.2e-05,172.217.194.0-255,4320,6234,65,206955
1313,4.6e-05,172.31.40.0-255,66,6300,65,206955
1314,6.4e-05,172.217.194.0-255,5738,12038,65,206955
1315,6.7e-05,172.31.40.0-255,66,12104,65,206955
1316,8.4e-05,172.217.194.0-255,3384,15488,65,206955
1317,8.7e-05,172.31.40.0-255,66,15554,65,206955
1318,9.9e-05,172.31.40.0-255,66,15620,65,206955
1319,0.000127,172.217.194.0-255,5379,20999,65,206955
1320,0.00013,172.31.40.0-255,66,21065,65,206955
1321,0.000154,172.217.194.0-255,2902,23967,65,206955
1322,0.000157,172.31.40.0-255,66,24033,65,206955
1323,0.000175,172.217.194.0-255,2902,26935,65,206955
1324,0.000178,172.31.40.0-255,66,27001,65,206955
1325,0.000184,172.217.194.0-255,4320,31321,65,206955
1326,0.000186,172.31.40.0-255,66,31387,65,206955
1327,0.000199,172.217.194.0-255,2902,34289,65,206955
1328,0.000202,172.31.40.0-255,66,34355,65,206955
1329,0.000213,172.217.194.0-255,1484,35839,65,206955
1330,0.000216,172.31.40.0-255,66,35905,65,206955
1331,0.000252,172.31.40.0-255,66,35971,65,206955
1332,0.000258,172.217.194.0-255,5634,41605,65,206955
1333,0.000261,172.31.40.0-255,66,41671,65,206955
1334,0.000264,172.217.194.0-255,118,41789,65,206955
1335,0.000266,172.31.40.0-255,66,41855,65,206955
1336,0.000456,172.217.194.0-255,380,42235,65,206955
1337,0.000461,172.31.40.0-255,66,42301,65,206955
1338,0.000829,172.217.194.0-255,1484,43785,65,206955
1339,0.000836,172.217.194.0-255,2902,46687,65,206955
1340,0.00084,172.31.40.0-255,66,46753,65,206955
1341,0.000844,172.217.194.0-255,1484,48237,65,206955
1342,0.000866,172.217.194.0-255,4320,52557,65,206955
1343,0.000869,172.31.40.0-255,66,52623,65,206955
1344,0.000883,172.31.40.0-255,66,52689,65,206955
1345,0.000898,172.217.194.0-255,2902,55591,65,206955
1346,0.0009,172.31.40.0-255,66,55657,65,206955
1347,0.000924,172.217.194.0-255,4320,59977,65,206955
1348,0.000928,172.31.40.0-255,66,60043,65,206955
1349,0.000932,172.217.194.0-255,2902,62945,65,206955
1350,0.000934,172.31.40.0-255,66,63011,65,206955
1351,0.000952,172.217.194.0-255,766,63777,65,206955
1352,0.001179,172.217.194.0-255,1484,65261,65,206955
1353,0.001184,172.31.40.0-255,66,65327,65,206955
1354,0.001189,172.217.194.0-255,2902,68229,65,206955
1355,0.001192,172.31.40.0-255,66,68295,65,206955
1356,0.001195,172.217.194.0-255,1484,69779,65,206955
1357,0.001217,172.217.194.0-255,4320,74099,65,206955
1358,0.001219,172.31.40.0-255,66,74165,65,206955
1359,0.001231,172.31.40.0-255,66,74231,65,206955
1360,0.001248,172.217.194.0-255,4320,78551,65,206955
1361,0.00125,172.31.40.0-255,66,78617,65,206955
1362,0.001264,172.31.40.0-255,66,78683,65,206955
1363,0.001374,172.217.194.0-255,1484,80167,65,206955
1364,0.00138,172.217.194.0-255,2902,83069,65,206955
1365,0.001384,172.31.40.0-255,66,83135,65,206955
1366,0.001389,172.217.194.0-255,2902,86037,65,206955
1367,0.00139,172.31.40.0-255,66,86103,65,206955
1368,0.001404,172.217.194.0-255,2902,89005,65,206955
1369,0.001406,172.31.40.0-255,66,89071,65,206955
1370,0.001409,172.217.194.0-255,1484,90555,65,206955
1371,0.001437,172.31.40.0-255,66,90621,65,206955
1372,0.001459,172.217.194.0-255,5738,96359,65,206955
1373,0.001462,172.31.40.0-255,66,96425,65,206955
1374,0.001481,172.217.194.0-255,5020,101445,65,206955
1375,0.001484,172.31.40.0-255,66,101511,65,206955
1376,0.001559,172.217.194.0-255,1484,102995,65,206955
1377,0.001564,172.217.194.0-255,2902,105897,65,206955
1378,0.001569,172.31.40.0-255,66,105963,65,206955
1379,0.001581,172.217.194.0-255,5738,111701,65,206955
1380,0.001583,172.31.40.0-255,66,111767,65,206955
1381,0.001586,172.217.194.0-255,1484,113251,65,206955
1382,0.001614,172.217.194.0-255,5738,118989,65,206955
1383,0.001617,172.31.40.0-255,66,119055,65,206955
1384,0.001622,172.217.194.0-255,4320,123375,65,206955
1385,0.001625,172.31.40.0-255,66,123441,65,206955
1386,0.00165,172.217.194.0-255,2184,125625,65,206955
1387,0.0017,172.31.40.0-255,66,125691,65,206955
1388,0.001732,172.217.194.0-255,1484,127175,65,206955
1389,0.001751,172.217.194.0-255,2902,130077,65,206955
1390,0.001756,172.217.194.0-255,5738,135815,65,206955
1391,0.001761,172.31.40.0-255,66,135881,65,206955
1392,0.001769,172.31.40.0-255,66,135947,65,206955
1393,0.001772,172.217.194.0-255,1484,137431,65,206955
1394,0.001818,172.31.40.0-255,66,137497,65,206955
1395,0.001879,172.217.194.0-255,1484,138981,65,206955
1396,0.001883,172.217.194.0-255,1484,140465,65,206955
1397,0.001897,172.217.194.0-255,1484,141949,65,206955
1398,0.001904,172.31.40.0-255,66,142015,65,206955
1399,0.001923,172.217.194.0-255,2902,144917,65,206955
1400,0.001937,172.31.40.0-255,66,144983,65,206955
1401,0.001941,172.217.194.0-255,2902,147885,65,206955
1402,0.001944,172.217.194.0-255,1484,149369,65,206955
1403,0.001949,172.31.40.0-255,66,149435,65,206955
1404,0.001977,172.217.194.0-255,1484,150919,65,206955
1405,0.001996,172.31.40.0-255,66,150985,65,206955
1406,0.002031,172.217.194.0-255,2902,153887,65,206955
1407,0.002038,172.31.40.0-255,66,153953,65,206955
1408,0.00205,172.217.194.0-255,6438,160391,65,206955
1409,0.002061,172.31.40.0-255,66,160457,65,206955
1410,0.004122,172.217.194.0-255,5738,166195,65,206955
1411,0.00413,172.31.40.0-255,66,166261,65,206955
1412,0.006168,172.217.194.0-255,5738,171999,65,206955
1413,0.006177,172.31.40.0-255,66,172065,65,206955
1414,0.008221,172.217.194.0-255,5738,177803,65,206955
1415,0.008228,172.31.40.0-255,66,177869,65,206955
1416,0.010246,172.217.194.0-255,1484,179353,65,206955
1417,0.01027,172.217.194.0-255,4320,183673,65,206955
1418,0.010273,172.31.40.0-255,66,183739,65,206955
1419,0.012319,172.217.194.0-255,5738,189477,65,206955
1420,0.012327,172.31.40.0-255,66,189543,65,206955
1421,0.01438,172.217.194.0-255,5738,195281,65,206955
1422,0.014389,172.31.40.0-255,66,195347,65,206955
1423,0.016436,172.217.194.0-255,5738,201085,65,206955
1424,0.016444,172.31.40.0-255,66,201151,65,206955
1425,0.018493,172.217.194.0-255,5738,206889,65,206955
1426,0.018501,172.31.40.0-255,66,206955,65,206955
1427,0.0,74.125.24.0-255,153,153,65,139328
1428,2.1e-05,172.31.40.0-255,66,219,65,139328
1429,2.8e-05,74.125.24.0-255,1484,1703,65,139328
1430,3.2e-05,172.31.40.0-255,66,1769,65,139328
1431,3.7e-05,74.125.24.0-255,2902,4671,65,139328
1432,4.6e-05,172.31.40.0-255,66,4737,65,139328
1433,8.5e-05,74.125.24.0-255,4320,9057,65,139328
1434,8.8e-05,172.31.40.0-255,66,9123,65,139328
1435,9.3e-05,74.125.24.0-255,4820,13943,65,139328
1436,9.5e-05,172.31.40.0-255,66,14009,65,139328
1437,0.000127,74.125.24.0-255,1484,15493,65,139328
1438,0.000129,172.31.40.0-255,66,15559,65,139328
1439,0.000132,74.125.24.0-255,1484,17043,65,139328
1440,0.000134,172.31.40.0-255,66,17109,65,139328
1441,0.000156,74.125.24.0-255,1484,18593,65,139328
1442,0.000158,172.31.40.0-255,66,18659,65,139328
1443,0.000166,74.125.24.0-255,5738,24397,65,139328
1444,0.000168,172.31.40.0-255,66,24463,65,139328
1445,0.000171,74.125.24.0-255,1484,25947,65,139328
1446,0.000172,172.31.40.0-255,66,26013,65,139328
1447,0.000199,74.125.24.0-255,5379,31392,65,139328
1448,0.000204,172.31.40.0-255,66,31458,65,139328
1449,0.000277,74.125.24.0-255,1484,32942,65,139328
1450,0.00028,172.31.40.0-255,66,33008,65,139328
1451,0.000285,74.125.24.0-255,2902,35910,65,139328
1452,0.000287,172.31.40.0-255,66,35976,65,139328
1453,0.000316,74.125.24.0-255,5738,41714,65,139328
1454,0.000318,172.31.40.0-255,66,41780,65,139328
1455,0.000323,74.125.24.0-255,4320,46100,65,139328
1456,0.000325,172.31.40.0-255,66,46166,65,139328
1457,0.000365,74.125.24.0-255,2543,48709,65,139328
1458,0.000368,172.31.40.0-255,66,48775,65,139328
1459,0.000416,74.125.24.0-255,2902,51677,65,139328
1460,0.000419,172.31.40.0-255,66,51743,65,139328
1461,0.000422,74.125.24.0-255,1484,53227,65,139328
1462,0.000443,74.125.24.0-255,2902,56129,65,139328
1463,0.000445,172.31.40.0-255,66,56195,65,139328
1464,0.000449,74.125.24.0-255,2902,59097,65,139328
1465,0.000451,172.31.40.0-255,66,59163,65,139328
1466,0.000482,74.125.24.0-255,5738,64901,65,139328
1467,0.000484,172.31.40.0-255,66,64967,65,139328
1468,0.000487,74.125.24.0-255,1474,66441,65,139328
1469,0.000508,74.125.24.0-255,329,66770,65,139328
1470,0.000511,172.31.40.0-255,66,66836,65,139328
1471,0.000857,74.125.24.0-255,1484,68320,65,139328
1472,0.000864,74.125.24.0-255,2902,71222,65,139328
1473,0.000867,172.31.40.0-255,66,71288,65,139328
1474,0.000895,74.125.24.0-255,5738,77026,65,139328
1475,0.000898,172.31.40.0-255,66,77092,65,139328
1476,0.000902,74.125.24.0-255,2902,79994,65,139328
1477,0.000904,172.31.40.0-255,66,80060,65,139328
1478,0.000941,172.31.40.0-255,66,80126,65,139328
1479,0.000953,172.31.40.0-255,66,80192,65,139328
1480,0.000983,74.125.24.0-255,2184,82376,65,139328
1481,0.000986,172.31.40.0-255,66,82442,65,139328
1482,0.002141,74.125.24.0-255,1484,83926,65,139328
1483,0.002153,74.125.24.0-255,2902,86828,65,139328
1484,0.002157,172.31.40.0-255,66,86894,65,139328
1485,0.002165,74.125.24.0-255,5738,92632,65,139328
1486,0.002167,172.31.40.0-255,66,92698,65,139328
1487,0.002204,172.31.40.0-255,66,92764,65,139328
1488,0.002238,74.125.24.0-255,5738,98502,65,139328
1489,0.00224,172.31.40.0-255,66,98568,65,139328
1490,0.002271,172.31.40.0-255,66,98634,65,139328
1491,0.002306,74.125.24.0-255,1484,100118,65,139328
1492,0.00457,74.125.24.0-255,4320,104438,65,139328
1493,0.004574,172.31.40.0-255,66,104504,65,139328
1494,0.006851,74.125.24.0-255,5738,110242,65,139328
1495,0.006856,172.31.40.0-255,66,110308,65,139328
1496,0.009154,74.125.24.0-255,5738,116046,65,139328
1497,0.00916,172.31.40.0-255,66,116112,65,139328
1498,0.011455,74.125.24.0-255,5738,121850,65,139328
1499,0.011462,172.31.40.0-255,66,121916,65,139328
1500,0.013794,74.125.24.0-255,5738,127654,65,139328
1501,0.013801,172.31.40.0-255,66,127720,65,139328
1502,0.016088,74.125.24.0-255,5738,133458,65,139328
1503,0.016095,172.31.40.0-255,66,133524,65,139328
1504,0.01838,74.125.24.0-255,5738,139262,65,139328
1505,0.018387,172.31.40.0-255,66,139328,65,139328
1506,0.0,74.125.24.0-255,153,153,65,92056
1507,2.2e-05,172.31.40.0-255,66,219,65,92056
1508,3e-05,74.125.24.0-255,1484,1703,65,92056
1509,3.4e-05,172.31.40.0-255,66,1769,65,92056
1510,4e-05,74.125.24.0-255,2902,4671,65,92056
1511,4.2e-05,172.31.40.0-255,66,4737,65,92056
1512,5.1e-05,74.125.24.0-255,7156,11893,65,92056
1513,5.4e-05,172.31.40.0-255,66,11959,65,92056
1514,5.9e-05,74.125.24.0-255,1984,13943,65,92056
1515,6.1e-05,172.31.40.0-255,66,14009,65,92056
1516,0.000226,74.125.24.0-255,1484,15493,65,92056
1517,0.00023,172.31.40.0-255,66,15559,65,92056
1518,0.000235,74.125.24.0-255,2902,18461,65,92056
1519,0.000237,172.31.40.0-255,66,18527,65,92056
1520,0.000243,74.125.24.0-255,5738,24265,65,92056
1521,0.000245,172.31.40.0-255,66,24331,65,92056
1522,0.000298,74.125.24.0-255,5738,30069,65,92056
1523,0.0003,172.31.40.0-255,66,30135,65,92056
1524,0.000311,74.125.24.0-255,1125,31260,65,92056
1525,0.000313,172.31.40.0-255,66,31326,65,92056
1526,0.000479,74.125.24.0-255,1484,32810,65,92056
1527,0.000482,172.31.40.0-255,66,32876,65,92056
1528,0.000503,74.125.24.0-255,2902,35778,65,92056
1529,0.000505,172.31.40.0-255,66,35844,65,92056
1530,0.000524,74.125.24.0-255,2902,38746,65,92056
1531,0.000525,172.31.40.0-255,66,38812,65,92056
1532,0.000551,74.125.24.0-255,2902,41714,65,92056
1533,0.000554,172.31.40.0-255,66,41780,65,92056
1534,0.000567,172.31.40.0-255,66,41846,65,92056
1535,0.000577,172.31.40.0-255,66,41912,65,92056
1536,0.00141,74.125.24.0-255,413,42325,65,92056
1537,0.001495,74.125.24.0-255,331,42656,65,92056
1538,0.002557,74.125.24.0-255,2902,45558,65,92056
1539,0.002563,172.31.40.0-255,66,45624,65,92056
1540,0.004565,74.125.24.0-255,5738,51362,65,92056
1541,0.004569,172.31.40.0-255,66,51428,65,92056
1542,0.006573,74.125.24.0-255,5738,57166,65,92056
1543,0.006581,172.31.40.0-255,66,57232,65,92056
1544,0.00857,74.125.24.0-255,5738,62970,65,92056
1545,0.008577,172.31.40.0-255,66,63036,65,92056
1546,0.010572,74.125.24.0-255,5738,68774,65,92056
1547,0.010581,172.31.40.0-255,66,68840,65,92056
1548,0.012598,74.125.24.0-255,5738,74578,65,92056
1549,0.012607,172.31.40.0-255,66,74644,65,92056
1550,0.014645,74.125.24.0-255,5738,80382,65,92056
1551,0.014654,172.31.40.0-255,66,80448,65,92056
1552,0.016629,74.125.24.0-255,5738,86186,65,92056
1553,0.016634,172.31.40.0-255,66,86252,65,92056
1554,0.018633,74.125.24.0-255,5738,91990,65,92056
1555,0.018639,172.31.40.0-255,66,92056,65,92056
1556,0.0,74.125.200.0-255,148,148,65,217853
1557,1.4e-05,172.31.40.0-255,66,214,65,217853
1558,3.9e-05,74.125.200.0-255,1484,1698,65,217853
1559,4.3e-05,172.31.40.0-255,66,1764,65,217853
1560,4.6e-05,74.125.200.0-255,1484,3248,65,217853
1561,4.9e-05,172.31.40.0-255,66,3314,65,217853
1562,6e-05,74.125.200.0-255,1484,4798,65,217853
1563,6.3e-05,172.31.40.0-255,66,4864,65,217853
1564,7.6e-05,74.125.200.0-255,1484,6348,65,217853
1565,7.8e-05,172.31.40.0-255,66,6414,65,217853
1566,9.6e-05,74.125.200.0-255,4320,10734,65,217853
1567,9.9e-05,172.31.40.0-255,66,10800,65,217853
1568,0.000103,74.125.200.0-255,2902,13702,65,217853
1569,0.000105,172.31.40.0-255,66,13768,65,217853
1570,0.000147,74.125.200.0-255,4320,18088,65,217853
1571,0.00015,172.31.40.0-255,66,18154,65,217853
1572,0.000172,74.125.200.0-255,4962,23116,65,217853
1573,0.000174,172.31.40.0-255,66,23182,65,217853
1574,0.000204,74.125.200.0-255,2902,26084,65,217853
1575,0.000206,172.31.40.0-255,66,26150,65,217853
1576,0.000227,74.125.200.0-255,5379,31529,65,217853
1577,0.000244,172.31.40.0-255,66,31595,65,217853
1578,0.00026,74.125.200.0-255,1484,33079,65,217853
1579,0.000263,172.31.40.0-255,66,33145,65,217853
1580,0.000286,74.125.200.0-255,2902,36047,65,217853
1581,0.000288,172.31.40.0-255,66,36113,65,217853
1582,0.000304,74.125.200.0-255,1484,37597,65,217853
1583,0.000307,172.31.40.0-255,66,37663,65,217853
1584,0.000328,74.125.200.0-255,2902,40565,65,217853
1585,0.000331,172.31.40.0-255,66,40631,65,217853
1586,0.000346,74.125.200.0-255,4320,44951,65,217853
1587,0.000348,172.31.40.0-255,66,45017,65,217853
1588,0.00037,74.125.200.0-255,5379,50396,65,217853
1589,0.000433,74.125.200.0-255,5738,56134,65,217853
1590,0.000451,74.125.200.0-255,2902,59036,65,217853
1591,0.000489,172.31.40.0-255,66,59102,65,217853
1592,0.000503,74.125.200.0-255,7155,66257,65,217853
1593,0.000514,172.31.40.0-255,66,66323,65,217853
1594,0.000529,74.125.200.0-255,329,66652,65,217853
1595,0.000552,74.125.200.0-255,1484,68136,65,217853
1596,0.000563,172.31.40.0-255,66,68202,65,217853
1597,0.000574,74.125.200.0-255,4320,72522,65,217853
1598,0.000579,172.31.40.0-255,66,72588,65,217853
1599,0.000608,74.125.200.0-255,4320,76908,65,217853
1600,0.000622,74.125.200.0-255,4320,81228,65,217853
1601,0.000625,172.31.40.0-255,66,81294,65,217853
1602,0.000629,172.31.40.0-255,66,81360,65,217853
1603,0.000678,74.125.200.0-255,2543,83903,65,217853
1604,0.0007,74.125.200.0-255,2902,86805,65,217853
1605,0.000706,172.31.40.0-255,66,86871,65,217853
1606,0.000712,74.125.200.0-255,1484,88355,65,217853
1607,0.00073,74.125.200.0-255,5738,94093,65,217853
1608,0.000736,172.31.40.0-255,66,94159,65,217853
1609,0.000786,74.125.200.0-255,5738,99897,65,217853
1610,0.0008,172.31.40.0-255,66,99963,65,217853
1611,0.000803,74.125.200.0-255,1125,101088,65,217853
1612,0.001141,74.125.200.0-255,1484,102572,65,217853
1613,0.001145,172.31.40.0-255,66,102638,65,217853
1614,0.001164,74.125.200.0-255,2902,105540,65,217853
1615,0.001167,172.31.40.0-255,66,105606,65,217853
1616,0.001188,74.125.200.0-255,5738,111344,65,217853
1617,0.001193,172.31.40.0-255,66,111410,65,217853
1618,0.001266,172.31.40.0-255,66,111476,65,217853
1619,0.001344,74.125.200.0-255,2184,113660,65,217853
1620,0.00135,172.31.40.0-255,66,113726,65,217853
1621,0.001405,74.125.200.0-255,1484,115210,65,217853
1622,0.001442,172.31.40.0-255,66,115276,65,217853
1623,0.001496,74.125.200.0-255,2902,118178,65,217853
1624,0.001501,172.31.40.0-255,66,118244,65,217853
1625,0.001518,74.125.200.0-255,1484,119728,65,217853
1626,0.001557,172.31.40.0-255,66,119794,65,217853
1627,0.001663,74.125.200.0-255,3602,123396,65,217853
1628,0.001667,172.31.40.0-255,66,123462,65,217853
1629,0.001698,74.125.200.0-255,5738,129200,65,217853
1630,0.001709,172.31.40.0-255,66,129266,65,217853
1631,0.001749,172.31.40.0-255,66,129332,65,217853
1632,0.00191,74.125.200.0-255,4320,133652,65,217853
1633,0.001915,172.31.40.0-255,66,133718,65,217853
1634,0.001935,74.125.200.0-255,5020,138738,65,217853
1635,0.001946,172.31.40.0-255,66,138804,65,217853
1636,0.002,172.31.40.0-255,66,138870,65,217853
1637,0.002064,74.125.200.0-255,5738,144608,65,217853
1638,0.002068,172.31.40.0-255,66,144674,65,217853
1639,0.002103,172.31.40.0-255,66,144740,65,217853
1640,0.002267,172.31.40.0-255,66,144806,65,217853
1641,0.002321,74.125.200.0-255,7138,151944,65,217853
1642,0.002607,74.125.200.0-255,5738,157682,65,217853
1643,0.002622,74.125.200.0-255,5738,163420,65,217853
1644,0.002641,74.125.200.0-255,4320,167740,65,217853
1645,0.002733,74.125.200.0-255,2902,170642,65,217853
1646,0.002751,74.125.200.0-255,5020,175662,65,217853
1647,0.002863,74.125.200.0-255,7156,182818,65,217853
1648,0.002939,74.125.200.0-255,7156,189974,65,217853
1649,0.003412,74.125.200.0-255,7156,197130,65,217853
1650,0.006868,172.31.40.0-255,66,197196,65,217853
1651,0.009206,74.125.200.0-255,5738,202934,65,217853
1652,0.009213,172.31.40.0-255,66,203000,65,217853
1653,0.011587,74.125.200.0-255,5738,208738,65,217853
1654,0.011594,172.31.40.0-255,66,208804,65,217853
1655,0.013938,74.125.200.0-255,5738,214542,65,217853
1656,0.013946,172.31.40.0-255,66,214608,65,217853
1657,0.01627,74.125.200.0-255,3008,217616,65,217853
1658,0.016278,172.31.40.0-255,66,217682,65,217853
1659,0.016545,172.31.40.0-255,105,217787,65,217853
1660,0.018849,74.125.200.0-255,66,217853,65,217853
1661,0.0,74.125.24.0-255,150,150,65,188056
1662,2.3e-05,172.31.40.0-255,66,216,65,188056
1663,3e-05,74.125.24.0-255,1484,1700,65,188056
1664,3.4e-05,172.31.40.0-255,66,1766,65,188056
1665,4e-05,74.125.24.0-255,2902,4668,65,188056
1666,4.2e-05,172.31.40.0-255,66,4734,65,188056
1667,5.1e-05,74.125.24.0-255,7156,11890,65,188056
1668,5.4e-05,172.31.40.0-255,66,11956,65,188056
1669,9.7e-05,172.31.40.0-255,66,12022,65,188056
1670,0.000104,74.125.24.0-255,5379,17401,65,188056
1671,0.000107,172.31.40.0-255,66,17467,65,188056
1672,0.000211,74.125.24.0-255,1484,18951,65,188056
1673,0.000215,172.31.40.0-255,66,19017,65,188056
1674,0.000221,74.125.24.0-255,2902,21919,65,188056
1675,0.000223,172.31.40.0-255,66,21985,65,188056
1676,0.000226,74.125.24.0-255,1484,23469,65,188056
1677,0.000228,172.31.40.0-255,66,23535,65,188056
1678,0.000255,74.125.24.0-255,4320,27855,65,188056
1679,0.000258,172.31.40.0-255,66,27921,65,188056
1680,0.000272,172.31.40.0-255,66,27987,65,188056
1681,0.000299,74.125.24.0-255,3961,31948,65,188056
1682,0.000301,172.31.40.0-255,66,32014,65,188056
1683,0.00031,74.125.24.0-255,7156,39170,65,188056
1684,0.000312,172.31.40.0-255,66,39236,65,188056
1685,0.000315,74.125.24.0-255,1484,40720,65,188056
1686,0.000317,172.31.40.0-255,66,40786,65,188056
1687,0.000337,74.125.24.0-255,1483,42269,65,188056
1688,0.000339,172.31.40.0-255,66,42335,65,188056
1689,0.000372,74.125.24.0-255,1484,43819,65,188056
1690,0.000375,172.31.40.0-255,66,43885,65,188056
1691,0.000391,74.125.24.0-255,2902,46787,65,188056
1692,0.000394,172.31.40.0-255,66,46853,65,188056
1693,0.000417,74.125.24.0-255,5738,52591,65,188056
1694,0.00042,172.31.40.0-255,66,52657,65,188056
1695,0.000445,74.125.24.0-255,6797,59454,65,188056
1696,0.000448,172.31.40.0-255,66,59520,65,188056
1697,0.000486,74.125.24.0-255,4320,63840,65,188056
1698,0.000488,172.31.40.0-255,66,63906,65,188056
1699,0.000505,74.125.24.0-255,2902,66808,65,188056
1700,0.000508,172.31.40.0-255,66,66874,65,188056
1701,0.000521,172.31.40.0-255,66,66940,65,188056
1702,0.001169,74.125.24.0-255,1484,68424,65,188056
1703,0.001178,74.125.24.0-255,2902,71326,65,188056
1704,0.001182,172.31.40.0-255,66,71392,65,188056
1705,0.001188,74.125.24.0-255,2902,74294,65,188056
1706,0.001192,172.31.40.0-255,66,74360,65,188056
1707,0.001206,74.125.24.0-255,2902,77262,65,188056
1708,0.001209,172.31.40.0-255,66,77328,65,188056
1709,0.001221,172.31.40.0-255,66,77394,65,188056
1710,0.001237,74.125.24.0-255,4320,81714,65,188056
1711,0.001239,172.31.40.0-255,66,81780,65,188056
1712,0.001247,74.125.24.0-255,7156,88936,65,188056
1713,0.00125,172.31.40.0-255,66,89002,65,188056
1714,0.00128,74.125.24.0-255,3602,92604,65,188056
1715,0.001283,172.31.40.0-255,66,92670,65,188056
1716,0.001669,74.125.24.0-255,1484,94154,65,188056
1717,0.001683,74.125.24.0-255,1484,95638,65,188056
1718,0.001688,172.31.40.0-255,66,95704,65,188056
1719,0.001694,74.125.24.0-255,2902,98606,65,188056
1720,0.001697,172.31.40.0-255,66,98672,65,188056
1721,0.001703,74.125.24.0-255,4320,102992,65,188056
1722,0.001705,172.31.40.0-255,66,103058,65,188056
1723,0.001726,74.125.24.0-255,1484,104542,65,188056
1724,0.001729,74.125.24.0-255,1484,106026,65,188056
1725,0.001731,172.31.40.0-255,66,106092,65,188056
1726,0.001759,172.31.40.0-255,66,106158,65,188056
1727,0.001778,74.125.24.0-255,1484,107642,65,188056
1728,0.00179,172.31.40.0-255,66,107708,65,188056
1729,0.001793,74.125.24.0-255,766,108474,65,188056
1730,0.001943,74.125.24.0-255,1484,109958,65,188056
1731,0.001947,172.31.40.0-255,66,110024,65,188056
1732,0.001953,74.125.24.0-255,2902,112926,65,188056
1733,0.001956,172.31.40.0-255,66,112992,65,188056
1734,0.001962,74.125.24.0-255,5738,118730,65,188056
1735,0.001965,172.31.40.0-255,66,118796,65,188056
1736,0.002004,172.31.40.0-255,66,118862,65,188056
1737,0.002012,74.125.24.0-255,7156,126018,65,188056
1738,0.002014,172.31.40.0-255,66,126084,65,188056
1739,0.00203,74.125.24.0-255,1484,127568,65,188056
1740,0.002046,74.125.24.0-255,2184,129752,65,188056
1741,0.002049,172.31.40.0-255,66,129818,65,188056
1742,0.002054,74.125.24.0-255,2902,132720,65,188056
1743,0.002056,172.31.40.0-255,66,132786,65,188056
1744,0.002084,74.125.24.0-255,7156,139942,65,188056
1745,0.002087,172.31.40.0-255,66,140008,65,188056
1746,0.00209,74.125.24.0-255,1484,141492,65,188056
1747,0.002121,172.31.40.0-255,66,141558,65,188056
1748,0.002132,172.31.40.0-255,66,141624,65,188056
1749,0.004161,74.125.24.0-255,5738,147362,65,188056
1750,0.004168,172.31.40.0-255,66,147428,65,188056
1751,0.006185,74.125.24.0-255,5738,153166,65,188056
1752,0.006192,172.31.40.0-255,66,153232,65,188056
1753,0.008242,74.125.24.0-255,5738,158970,65,188056
1754,0.00825,172.31.40.0-255,66,159036,65,188056
1755,0.010266,74.125.24.0-255,5738,164774,65,188056
1756,0.01028,172.31.40.0-255,66,164840,65,188056
1757,0.012325,74.125.24.0-255,5738,170578,65,188056
1758,0.012337,172.31.40.0-255,66,170644,65,188056
1759,0.014366,74.125.24.0-255,5738,176382,65,188056
1760,0.014379,172.31.40.0-255,66,176448,65,188056
1761,0.016388,74.125.24.0-255,5738,182186,65,188056
1762,0.016398,172.31.40.0-255,66,182252,65,188056
1763,0.018438,74.125.24.0-255,5738,187990,65,188056
1764,0.018445,172.31.40.0-255,66,188056,65,188056
1765,0.0,172.217.194.0-255,150,150,65,112757
1766,2.4e-05,172.31.40.0-255,66,216,65,112757
1767,3.2e-05,172.217.194.0-255,1484,1700,65,112757
1768,3.6e-05,172.31.40.0-255,66,1766,65,112757
1769,4.2e-05,172.217.194.0-255,2902,4668,65,112757
1770,4.6e-05,172.31.40.0-255,66,4734,65,112757
1771,6.1e-05,172.217.194.0-255,7156,11890,65,112757
1772,6.4e-05,172.31.40.0-255,66,11956,65,112757
1773,6.9e-05,172.217.194.0-255,1999,13955,65,112757
1774,7.1e-05,172.31.40.0-255,66,14021,65,112757
1775,7.6e-05,172.217.194.0-255,2902,16923,65,112757
1776,7.8e-05,172.31.40.0-255,66,16989,65,112757
1777,8.6e-05,172.217.194.0-255,7156,24145,65,112757
1778,8.9e-05,172.31.40.0-255,66,24211,65,112757
1779,9.5e-05,172.217.194.0-255,6797,31008,65,112757
1780,9.8e-05,172.31.40.0-255,66,31074,65,112757
1781,0.00028,172.217.194.0-255,1484,32558,65,112757
1782,0.000285,172.31.40.0-255,66,32624,65,112757
1783,0.000317,172.217.194.0-255,2902,35526,65,112757
1784,0.00032,172.31.40.0-255,66,35592,65,112757
1785,0.000327,172.217.194.0-255,5738,41330,65,112757
1786,0.00033,172.31.40.0-255,66,41396,65,112757
1787,0.00034,172.217.194.0-255,4320,45716,65,112757
1788,0.000342,172.31.40.0-255,66,45782,65,112757
1789,0.000387,172.31.40.0-255,66,45848,65,112757
1790,0.000417,172.217.194.0-255,5738,51586,65,112757
1791,0.00042,172.31.40.0-255,66,51652,65,112757
1792,0.00045,172.217.194.0-255,3961,55613,65,112757
1793,0.000454,172.31.40.0-255,66,55679,65,112757
1794,0.000798,172.217.194.0-255,646,56325,65,112757
1795,0.000803,172.31.40.0-255,66,56391,65,112757
1796,0.000904,172.217.194.0-255,1484,57875,65,112757
1797,0.000909,172.217.194.0-255,1484,59359,65,112757
1798,0.000912,172.31.40.0-255,66,59425,65,112757
1799,0.000947,172.217.194.0-255,1484,60909,65,112757
1800,0.000954,172.217.194.0-255,5738,66647,65,112757
1801,0.000957,172.31.40.0-255,66,66713,65,112757
1802,0.000985,172.31.40.0-255,66,66779,65,112757
1803,0.000995,172.31.40.0-255,66,66845,65,112757
1804,0.00102,172.217.194.0-255,766,67611,65,112757
1805,0.001377,172.31.40.0-255,66,67677,65,112757
1806,0.003283,172.217.194.0-255,4320,71997,65,112757
1807,0.003289,172.31.40.0-255,66,72063,65,112757
1808,0.003656,172.217.194.0-255,1484,73547,65,112757
1809,0.005578,172.217.194.0-255,4320,77867,65,112757
1810,0.005582,172.31.40.0-255,66,77933,65,112757
1811,0.007873,172.217.194.0-255,5738,83671,65,112757
1812,0.00788,172.31.40.0-255,66,83737,65,112757
1813,0.010184,172.217.194.0-255,5738,89475,65,112757
1814,0.010192,172.31.40.0-255,66,89541,65,112757
1815,0.012478,172.217.194.0-255,5738,95279,65,112757
1816,0.012487,172.31.40.0-255,66,95345,65,112757
1817,0.014786,172.217.194.0-255,5738,101083,65,112757
1818,0.014798,172.31.40.0-255,66,101149,65,112757
1819,0.017081,172.217.194.0-255,5738,106887,65,112757
1820,0.017088,172.31.40.0-255,66,106953,65,112757
1821,0.019371,172.217.194.0-255,5738,112691,65,112757
1822,0.019379,172.31.40.0-255,66,112757,65,112757
1823,0.0,74.125.68.0-255,153,153,65,206326
1824,1.5e-05,172.31.40.0-255,66,219,65,206326
1825,4e-05,74.125.68.0-255,1484,1703,65,206326
1826,4.4e-05,172.31.40.0-255,66,1769,65,206326
1827,5e-05,74.125.68.0-255,2902,4671,65,206326
1828,5.3e-05,172.31.40.0-255,66,4737,65,206326
1829,5.6e-05,74.125.68.0-255,1484,6221,65,206326
1830,5.9e-05,172.31.40.0-255,66,6287,65,206326
1831,6.5e-05,74.125.68.0-255,2902,9189,65,206326
1832,6.8e-05,172.31.40.0-255,66,9255,65,206326
1833,0.0001,74.125.68.0-255,4320,13575,65,206326
1834,0.000103,172.31.40.0-255,66,13641,65,206326
1835,0.000122,74.125.68.0-255,2100,15741,65,206326
1836,0.000124,172.31.40.0-255,66,15807,65,206326
1837,0.000131,74.125.68.0-255,7156,22963,65,206326
1838,0.000134,172.31.40.0-255,66,23029,65,206326
1839,0.000155,74.125.68.0-255,4320,27349,65,206326
1840,0.000157,172.31.40.0-255,66,27415,65,206326
1841,0.000179,74.125.68.0-255,3961,31376,65,206326
1842,0.000182,172.31.40.0-255,66,31442,65,206326
1843,0.000292,74.125.68.0-255,1484,32926,65,206326
1844,0.000297,172.31.40.0-255,66,32992,65,206326
1845,0.000302,74.125.68.0-255,2902,35894,65,206326
1846,0.000304,172.31.40.0-255,66,35960,65,206326
1847,0.000311,74.125.68.0-255,5738,41698,65,206326
1848,0.000313,172.31.40.0-255,66,41764,65,206326
1849,0.000323,172.31.40.0-255,66,41830,65,206326
1850,0.000352,172.31.40.0-255,66,41896,65,206326
1851,0.000357,74.125.68.0-255,4320,46216,65,206326
1852,0.00036,172.31.40.0-255,66,46282,65,206326
1853,0.000384,74.125.68.0-255,2543,48825,65,206326
1854,0.000387,74.125.68.0-255,416,49241,65,206326
1855,0.000434,74.125.68.0-255,329,49570,65,206326
1856,0.000459,172.31.40.0-255,66,49636,65,206326
1857,0.00051,74.125.68.0-255,1484,51120,65,206326
1858,0.000525,74.125.68.0-255,2902,54022,65,206326
1859,0.000542,172.31.40.0-255,66,54088,65,206326
1860,0.000549,74.125.68.0-255,5738,59826,65,206326
1861,0.000552,74.125.68.0-255,1484,61310,65,206326
1862,0.000558,172.31.40.0-255,66,61376,65,206326
1863,0.000571,74.125.68.0-255,4320,65696,65,206326
1864,0.000595,74.125.68.0-255,1125,66821,65,206326
1865,0.000599,172.31.40.0-255,66,66887,65,206326
1866,0.000826,74.125.68.0-255,1484,68371,65,206326
1867,0.000832,74.125.68.0-255,2902,71273,65,206326
1868,0.000857,74.125.68.0-255,5738,77011,65,206326
1869,0.000862,74.125.68.0-255,2902,79913,65,206326
1870,0.000869,172.31.40.0-255,66,79979,65,206326
1871,0.000927,74.125.68.0-255,3961,83940,65,206326
1872,0.000947,172.31.40.0-255,66,84006,65,206326
1873,0.00149,74.125.68.0-255,1484,85490,65,206326
1874,0.001499,74.125.68.0-255,2902,88392,65,206326
1875,0.001503,172.31.40.0-255,66,88458,65,206326
1876,0.001508,74.125.68.0-255,1484,89942,65,206326
1877,0.001512,74.125.68.0-255,2902,92844,65,206326
1878,0.001529,74.125.68.0-255,5738,98582,65,206326
1879,0.001556,74.125.68.0-255,5738,104320,65,206326
1880,0.001576,74.125.68.0-255,4320,108640,65,206326
1881,0.001717,74.125.68.0-255,1484,110124,65,206326
1882,0.001723,74.125.68.0-255,2902,113026,65,206326
1883,0.001746,74.125.68.0-255,5738,118764,65,206326
1884,0.001769,74.125.68.0-255,4320,123084,65,206326
1885,0.001776,74.125.68.0-255,5738,128822,65,206326
1886,0.001799,74.125.68.0-255,5738,134560,65,206326
1887,0.001824,74.125.68.0-255,5738,140298,65,206326
1888,0.00183,74.125.68.0-255,2184,142482,65,206326
1889,0.001898,74.125.68.0-255,1484,143966,65,206326
1890,0.001915,74.125.68.0-255,2902,146868,65,206326
1891,0.001933,74.125.68.0-255,5738,152606,65,206326
1892,0.00196,74.125.68.0-255,2902,155508,65,206326
1893,0.001996,74.125.68.0-255,4320,159828,65,206326
1894,0.003382,172.31.40.0-255,66,159894,65,206326
1895,0.005372,74.125.68.0-255,5738,165632,65,206326
1896,0.005378,172.31.40.0-255,66,165698,65,206326
1897,0.007374,74.125.68.0-255,5738,171436,65,206326
1898,0.00738,172.31.40.0-255,66,171502,65,206326
1899,0.009354,74.125.68.0-255,5738,177240,65,206326
1900,0.00936,172.31.40.0-255,66,177306,65,206326
1901,0.011323,74.125.68.0-255,5738,183044,65,206326
1902,0.01133,172.31.40.0-255,66,183110,65,206326
1903,0.013316,74.125.68.0-255,5738,188848,65,206326
1904,0.013325,172.31.40.0-255,66,188914,65,206326
1905,0.015299,74.125.68.0-255,5738,194652,65,206326
1906,0.015307,172.31.40.0-255,66,194718,65,206326
1907,0.017285,74.125.68.0-255,5738,200456,65,206326
1908,0.017294,172.31.40.0-255,66,200522,65,206326
1909,0.019258,74.125.68.0-255,5738,206260,65,206326
1910,0.019266,172.31.40.0-255,66,206326,65,206326
1911,0.0,74.125.24.0-255,147,147,65,124807
1912,2.2e-05,172.31.40.0-255,66,213,65,124807
1913,3e-05,74.125.24.0-255,1484,1697,65,124807
1914,3.3e-05,172.31.40.0-255,66,1763,65,124807
1915,3.9e-05,74.125.24.0-255,2902,4665,65,124807
1916,4.9e-05,172.31.40.0-255,66,4731,65,124807
1917,5.6e-05,74.125.24.0-255,7156,11887,65,124807
1918,5.9e-05,172.31.40.0-255,66,11953,65,124807
1919,7.1e-05,172.31.40.0-255,66,12019,65,124807
1920,0.000116,172.31.40.0-255,66,12085,65,124807
1921,0.000213,74.125.24.0-255,1484,13569,65,124807
1922,0.000216,172.31.40.0-255,66,13635,65,124807
1923,0.000244,74.125.24.0-255,2902,16537,65,124807
1924,0.000247,172.31.40.0-255,66,16603,65,124807
1925,0.000253,74.125.24.0-255,5738,22341,65,124807
1926,0.000256,172.31.40.0-255,66,22407,65,124807
1927,0.000288,74.125.24.0-255,6797,29204,65,124807
1928,0.000291,172.31.40.0-255,66,29270,65,124807
1929,0.000364,74.125.24.0-255,1484,30754,65,124807
1930,0.000367,172.31.40.0-255,66,30820,65,124807
1931,0.000372,74.125.24.0-255,2902,33722,65,124807
1932,0.000375,172.31.40.0-255,66,33788,65,124807
1933,0.000401,74.125.24.0-255,5738,39526,65,124807
1934,0.000405,172.31.40.0-255,66,39592,65,124807
1935,0.000447,74.125.24.0-255,7090,46682,65,124807
1936,0.00045,172.31.40.0-255,66,46748,65,124807
1937,0.000724,74.125.24.0-255,131,46879,65,124807
1938,0.000728,172.31.40.0-255,66,46945,65,124807
1939,0.000732,74.125.24.0-255,350,47295,65,124807
1940,0.000734,172.31.40.0-255,66,47361,65,124807
1941,0.001117,74.125.24.0-255,1484,48845,65,124807
1942,0.001124,74.125.24.0-255,2902,51747,65,124807
1943,0.001127,172.31.40.0-255,66,51813,65,124807
1944,0.001171,74.125.24.0-255,5738,57551,65,124807
1945,0.001174,172.31.40.0-255,66,57617,65,124807
1946,0.001181,74.125.24.0-255,7156,64773,65,124807
1947,0.001182,172.31.40.0-255,66,64839,65,124807
1948,0.0012,172.31.40.0-255,66,64905,65,124807
1949,0.001204,74.125.24.0-255,2184,67089,65,124807
1950,0.001206,172.31.40.0-255,66,67155,65,124807
1951,0.002053,74.125.24.0-255,1484,68639,65,124807
1952,0.002064,74.125.24.0-255,2902,71541,65,124807
1953,0.002068,172.31.40.0-255,66,71607,65,124807
1954,0.002076,74.125.24.0-255,5738,77345,65,124807
1955,0.002078,172.31.40.0-255,66,77411,65,124807
1956,0.002087,74.125.24.0-255,1484,78895,65,124807
1957,0.00212,172.31.40.0-255,66,78961,65,124807
1958,0.002126,74.125.24.0-255,5738,84699,65,124807
1959,0.002128,172.31.40.0-255,66,84765,65,124807
1960,0.002147,74.125.24.0-255,1484,86249,65,124807
1961,0.002171,74.125.24.0-255,3602,89851,65,124807
1962,0.002174,172.31.40.0-255,66,89917,65,124807
1963,0.004757,74.125.24.0-255,1484,91401,65,124807
1964,0.004778,74.125.24.0-255,4320,95721,65,124807
1965,0.004783,172.31.40.0-255,66,95787,65,124807
1966,0.00738,74.125.24.0-255,5738,101525,65,124807
1967,0.007386,172.31.40.0-255,66,101591,65,124807
1968,0.009993,74.125.24.0-255,5738,107329,65,124807
1969,0.010004,172.31.40.0-255,66,107395,65,124807
1970,0.012628,74.125.24.0-255,5738,113133,65,124807
1971,0.012642,172.31.40.0-255,66,113199,65,124807
1972,0.015258,74.125.24.0-255,5738,118937,65,124807
1973,0.015269,172.31.40.0-255,66,119003,65,124807
1974,0.017978,74.125.24.0-255,5738,124741,65,124807
1975,0.017988,172.31.40.0-255,66,124807,65,124807
1976,0.0,74.125.130.0-255,153,153,65,203721
1977,2e-05,172.31.40.0-255,66,219,65,203721
1978,2.7e-05,74.125.130.0-255,1484,1703,65,203721
1979,3.1e-05,172.31.40.0-255,66,1769,65,203721
1980,4.5e-05,74.125.130.0-255,2902,4671,65,203721
1981,4.8e-05,172.31.40.0-255,66,4737,65,203721
1982,5.6e-05,74.125.130.0-255,7156,11893,65,203721
1983,5.9e-05,172.31.40.0-255,66,11959,65,203721
1984,6.4e-05,74.125.130.0-255,2067,14026,65,203721
1985,6.7e-05,172.31.40.0-255,66,14092,65,203721
1986,7.2e-05,74.125.130.0-255,2902,16994,65,203721
1987,7.5e-05,172.31.40.0-255,66,17060,65,203721
1988,0.000113,74.125.130.0-255,7156,24216,65,203721
1989,0.000117,172.31.40.0-255,66,24282,65,203721
1990,0.000125,74.125.130.0-255,5738,30020,65,203721
1991,0.000127,172.31.40.0-255,66,30086,65,203721
1992,0.00016,74.125.130.0-255,1125,31211,65,203721
1993,0.000163,172.31.40.0-255,66,31277,65,203721
1994,0.000257,74.125.130.0-255,1484,32761,65,203721
1995,0.00026,172.31.40.0-255,66,32827,65,203721
1996,0.000264,74.125.130.0-255,1484,34311,65,203721
1997,0.000266,172.31.40.0-255,66,34377,65,203721
1998,0.000295,74.125.130.0-255,2902,37279,65,203721
1999,0.000298,172.31.40.0-255,66,37345,65,203721
2000,0.000304,74.125.130.0-255,5738,43083,65,203721
2001,0.000306,172.31.40.0-255,66,43149,65,203721
2002,0.000346,74.125.130.0-255,5379,48528,65,203721
2003,0.000349,172.31.40.0-255,66,48594,65,203721
2004,0.000575,74.125.130.0-255,1484,50078,65,203721
2005,0.000578,74.125.130.0-255,1484,51562,65,203721
2006,0.000582,74.125.130.0-255,2902,54464,65,203721
2007,0.000587,172.31.40.0-255,66,54530,65,203721
2008,0.000591,172.31.40.0-255,66,54596,65,203721
2009,0.000598,172.31.40.0-255,66,54662,65,203721
2010,0.00061,74.125.130.0-255,5738,60400,65,203721
2011,0.000612,172.31.40.0-255,66,60466,65,203721
2012,0.000686,74.125.130.0-255,5960,66426,65,203721
2013,0.000691,172.31.40.0-255,66,66492,65,203721
2014,0.000824,74.125.130.0-255,1484,67976,65,203721
2015,0.000831,74.125.130.0-255,2902,70878,65,203721
2016,0.000834,172.31.40.0-255,66,70944,65,203721
2017,0.000841,74.125.130.0-255,5738,76682,65,203721
2018,0.000843,172.31.40.0-255,66,76748,65,203721
2019,0.000856,74.125.130.0-255,6797,83545,65,203721
2020,0.000858,172.31.40.0-255,66,83611,65,203721
2021,0.000883,74.125.130.0-255,4320,87931,65,203721
2022,0.000885,172.31.40.0-255,66,87997,65,203721
2023,0.000919,74.125.130.0-255,7156,95153,65,203721
2024,0.000923,172.31.40.0-255,66,95219,65,203721
2025,0.000976,74.125.130.0-255,4829,100048,65,203721
2026,0.00098,172.31.40.0-255,66,100114,65,203721
2027,0.001088,74.125.130.0-255,1484,101598,65,203721
2028,0.001095,74.125.130.0-255,2902,104500,65,203721
2029,0.001098,172.31.40.0-255,66,104566,65,203721
2030,0.001103,74.125.130.0-255,2902,107468,65,203721
2031,0.001105,172.31.40.0-255,66,107534,65,203721
2032,0.001129,74.125.130.0-255,2902,110436,65,203721
2033,0.001132,172.31.40.0-255,66,110502,65,203721
2034,0.001137,74.125.130.0-255,4320,114822,65,203721
2035,0.00114,172.31.40.0-255,66,114888,65,203721
2036,0.001177,74.125.130.0-255,4320,119208,65,203721
2037,0.001181,172.31.40.0-255,66,119274,65,203721
2038,0.001192,172.31.40.0-255,66,119340,65,203721
2039,0.001199,74.125.130.0-255,5020,124360,65,203721
2040,0.0012,172.31.40.0-255,66,124426,65,203721
2041,0.001384,74.125.130.0-255,1484,125910,65,203721
2042,0.00139,74.125.130.0-255,2902,128812,65,203721
2043,0.001393,172.31.40.0-255,66,128878,65,203721
2044,0.001397,74.125.130.0-255,1484,130362,65,203721
2045,0.001425,74.125.130.0-255,4320,134682,65,203721
2046,0.001428,74.125.130.0-255,1484,136166,65,203721
2047,0.001431,172.31.40.0-255,66,136232,65,203721
2048,0.00146,172.31.40.0-255,66,136298,65,203721
2049,0.001472,172.31.40.0-255,66,136364,65,203721
2050,0.001505,74.125.130.0-255,2184,138548,65,203721
2051,0.001512,172.31.40.0-255,66,138614,65,203721
2052,0.001869,172.31.40.0-255,101,138715,65,203721
2053,0.002168,74.125.130.0-255,1484,140199,65,203721
2054,0.00219,74.125.130.0-255,2902,143101,65,203721
2055,0.002194,172.31.40.0-255,66,143167,65,203721
2056,0.002199,74.125.130.0-255,1484,144651,65,203721
2057,0.002229,74.125.130.0-255,4320,148971,65,203721
2058,0.002232,172.31.40.0-255,66,149037,65,203721
2059,0.002239,74.125.130.0-255,7156,156193,65,203721
2060,0.002241,172.31.40.0-255,66,156259,65,203721
2061,0.002252,74.125.130.0-255,5738,161997,65,203721
2062,0.002254,172.31.40.0-255,66,162063,65,203721
2063,0.002286,172.31.40.0-255,66,162129,65,203721
2064,0.00229,74.125.130.0-255,2184,164313,65,203721
2065,0.002292,172.31.40.0-255,66,164379,65,203721
2066,0.004111,74.125.130.0-255,66,164445,65,203721
2067,0.004541,74.125.130.0-255,4320,168765,65,203721
2068,0.004548,172.31.40.0-255,66,168831,65,203721
2069,0.004578,74.125.130.0-255,1484,170315,65,203721
2070,0.006826,74.125.130.0-255,4320,174635,65,203721
2071,0.006831,172.31.40.0-255,66,174701,65,203721
2072,0.009103,74.125.130.0-255,5738,180439,65,203721
2073,0.009115,172.31.40.0-255,66,180505,65,203721
2074,0.011405,74.125.130.0-255,5738,186243,65,203721
2075,0.011419,172.31.40.0-255,66,186309,65,203721
2076,0.013718,74.125.130.0-255,5738,192047,65,203721
2077,0.013738,172.31.40.0-255,66,192113,65,203721
2078,0.01602,74.125.130.0-255,5738,197851,65,203721
2079,0.016037,172.31.40.0-255,66,197917,65,203721
2080,0.018331,74.125.130.0-255,5738,203655,65,203721
2081,0.01835,172.31.40.0-255,66,203721,65,203721
2082,0.0,172.31.40.0-255,105,105,65,276
2083,0.001804,157.240.24.0-255,105,210,65,276
2084,0.001819,172.31.40.0-255,66,276,65,276
2085,0.0,74.125.24.0-255,153,153,65,192369
2086,2.2e-05,172.31.40.0-255,66,219,65,192369
2087,2.9e-05,74.125.24.0-255,1484,1703,65,192369
2088,3.3e-05,172.31.40.0-255,66,1769,65,192369
2089,3.9e-05,74.125.24.0-255,2902,4671,65,192369
2090,5.2e-05,172.31.40.0-255,66,4737,65,192369
2091,6e-05,74.125.24.0-255,7156,11893,65,192369
2092,6.3e-05,172.31.40.0-255,66,11959,65,192369
2093,6.7e-05,74.125.24.0-255,2029,13988,65,192369
2094,7e-05,172.31.40.0-255,66,14054,65,192369
2095,0.000151,74.125.24.0-255,1484,15538,65,192369
2096,0.000154,172.31.40.0-255,66,15604,65,192369
2097,0.00016,74.125.24.0-255,2902,18506,65,192369
2098,0.000163,172.31.40.0-255,66,18572,65,192369
2099,0.000175,74.125.24.0-255,5738,24310,65,192369
2100,0.000177,172.31.40.0-255,66,24376,65,192369
2101,0.000214,74.125.24.0-255,6797,31173,65,192369
2102,0.000217,172.31.40.0-255,66,31239,65,192369
2103,0.00034,74.125.24.0-255,1484,32723,65,192369
2104,0.000344,172.31.40.0-255,66,32789,65,192369
2105,0.00035,74.125.24.0-255,2902,35691,65,192369
2106,0.000352,172.31.40.0-255,66,35757,65,192369
2107,0.000363,74.125.24.0-255,5738,41495,65,192369
2108,0.000366,172.31.40.0-255,66,41561,65,192369
2109,0.000411,172.31.40.0-255,66,41627,65,192369
2110,0.000422,172.31.40.0-255,66,41693,65,192369
2111,0.000429,74.125.24.0-255,129,41822,65,192369
2112,0.000432,172.31.40.0-255,66,41888,65,192369
2113,0.000444,74.125.24.0-255,348,42236,65,192369
2114,0.000446,172.31.40.0-255,66,42302,65,192369
2115,0.000731,74.125.24.0-255,1484,43786,65,192369
2116,0.000739,74.125.24.0-255,2902,46688,65,192369
2117,0.000743,172.31.40.0-255,66,46754,65,192369
2118,0.000749,74.125.24.0-255,4320,51074,65,192369
2119,0.000751,172.31.40.0-255,66,51140,65,192369
2120,0.000773,74.125.24.0-255,1484,52624,65,192369
2121,0.00078,74.125.24.0-255,5738,58362,65,192369
2122,0.000782,172.31.40.0-255,66,58428,65,192369
2123,0.000794,172.31.40.0-255,66,58494,65,192369
2124,0.000822,74.125.24.0-255,1484,59978,65,192369
2125,0.000829,74.125.24.0-255,5020,64998,65,192369
2126,0.000831,172.31.40.0-255,66,65064,65,192369
2127,0.001106,74.125.24.0-255,1484,66548,65,192369
2128,0.001112,74.125.24.0-255,2902,69450,65,192369
2129,0.001115,172.31.40.0-255,66,69516,65,192369
2130,0.001122,74.125.24.0-255,5738,75254,65,192369
2131,0.001124,172.31.40.0-255,66,75320,65,192369
2132,0.001151,74.125.24.0-255,7156,82476,65,192369
2133,0.001154,172.31.40.0-255,66,82542,65,192369
2134,0.00118,74.125.24.0-255,5738,88280,65,192369
2135,0.001187,172.31.40.0-255,66,88346,65,192369
2136,0.001199,172.31.40.0-255,66,88412,65,192369
2137,0.001241,74.125.24.0-255,1484,89896,65,192369
2138,0.001246,74.125.24.0-255,2902,92798,65,192369
2139,0.001248,172.31.40.0-255,66,92864,65,192369
2140,0.001251,74.125.24.0-255,1484,94348,65,192369
2141,0.001277,74.125.24.0-255,4320,98668,65,192369
2142,0.001279,172.31.40.0-255,66,98734,65,192369
2143,0.001285,74.125.24.0-255,5738,104472,65,192369
2144,0.001288,172.31.40.0-255,66,104538,65,192369
2145,0.001323,172.31.40.0-255,66,104604,65,192369
2146,0.001329,74.125.24.0-255,5020,109624,65,192369
2147,0.001331,172.31.40.0-255,66,109690,65,192369
2148,0.001374,74.125.24.0-255,1484,111174,65,192369
2149,0.001379,74.125.24.0-255,2902,114076,65,192369
2150,0.001381,172.31.40.0-255,66,114142,65,192369
2151,0.001386,74.125.24.0-255,2902,117044,65,192369
2152,0.001388,172.31.40.0-255,66,117110,65,192369
2153,0.001411,74.125.24.0-255,2902,120012,65,192369
2154,0.001417,172.31.40.0-255,66,120078,65,192369
2155,0.001431,172.31.40.0-255,66,120144,65,192369
2156,0.001438,74.125.24.0-255,7156,127300,65,192369
2157,0.00144,172.31.40.0-255,66,127366,65,192369
2158,0.0015,74.125.24.0-255,3602,130968,65,192369
2159,0.001503,172.31.40.0-255,66,131034,65,192369
2160,0.001509,74.125.24.0-255,4320,135354,65,192369
2161,0.001511,172.31.40.0-255,66,135420,65,192369
2162,0.001522,172.31.40.0-255,66,135486,65,192369
2163,0.001525,74.125.24.0-255,1484,136970,65,192369
2164,0.001567,172.31.40.0-255,66,137036,65,192369
2165,0.001593,172.31.40.0-255,66,137102,65,192369
2166,0.001636,172.31.40.0-255,66,137168,65,192369
2167,0.001675,172.31.40.0-255,66,137234,65,192369
2168,0.001686,172.31.40.0-255,66,137300,65,192369
2169,0.001717,74.125.24.0-255,4320,141620,65,192369
2170,0.00172,172.31.40.0-255,66,141686,65,192369
2171,0.001743,74.125.24.0-255,4320,146006,65,192369
2172,0.001746,172.31.40.0-255,66,146072,65,192369
2173,0.001758,74.125.24.0-255,7156,153228,65,192369
2174,0.00176,172.31.40.0-255,66,153294,65,192369
2175,0.001776,172.31.40.0-255,66,153360,65,192369
2176,0.0018,74.125.24.0-255,1484,154844,65,192369
2177,0.001804,74.125.24.0-255,766,155610,65,192369
2178,0.001811,172.31.40.0-255,66,155676,65,192369
2179,0.001856,74.125.24.0-255,1484,157160,65,192369
2180,0.001862,74.125.24.0-255,2902,160062,65,192369
2181,0.001864,172.31.40.0-255,66,160128,65,192369
2182,0.001869,74.125.24.0-255,2902,163030,65,192369
2183,0.001871,172.31.40.0-255,66,163096,65,192369
2184,0.001903,74.125.24.0-255,2902,165998,65,192369
2185,0.001905,172.31.40.0-255,66,166064,65,192369
2186,0.00191,74.125.24.0-255,4320,170384,65,192369
2187,0.001913,172.31.40.0-255,66,170450,65,192369
2188,0.001919,74.125.24.0-255,4320,174770,65,192369
2189,0.001922,172.31.40.0-255,66,174836,65,192369
2190,0.001972,172.31.40.0-255,66,174902,65,192369
2191,0.001978,74.125.24.0-255,3602,178504,65,192369
2192,0.00198,172.31.40.0-255,66,178570,65,192369
2193,0.001983,74.125.24.0-255,1484,180054,65,192369
2194,0.002013,74.125.24.0-255,2902,182956,65,192369
2195,0.002016,172.31.40.0-255,66,183022,65,192369
2196,0.002023,74.125.24.0-255,5738,188760,65,192369
2197,0.002025,172.31.40.0-255,66,188826,65,192369
2198,0.002057,172.31.40.0-255,66,188892,65,192369
2199,0.00206,74.125.24.0-255,1484,190376,65,192369
2200,0.002165,74.125.24.0-255,1484,191860,65,192369
2201,0.00218,74.125.24.0-255,105,191965,65,192369
2202,0.006703,172.31.40.0-255,66,192031,65,192369
2203,0.007033,172.31.40.0-255,101,192132,65,192369
2204,0.009167,172.31.40.0-255,105,192237,65,192369
2205,0.00928,74.125.24.0-255,66,192303,65,192369
2206,0.011414,74.125.24.0-255,66,192369,65,192369
2207,0.0,74.125.68.0-255,153,153,65,213013
2208,2.6e-05,172.31.40.0-255,66,219,65,213013
2209,3.4e-05,74.125.68.0-255,1484,1703,65,213013
2210,3.9e-05,172.31.40.0-255,66,1769,65,213013
2211,4.1e-05,74.125.68.0-255,1484,3253,65,213013
2212,4.4e-05,172.31.40.0-255,66,3319,65,213013
2213,7.2e-05,74.125.68.0-255,4320,7639,65,213013
2214,7.5e-05,172.31.40.0-255,66,7705,65,213013
2215,0.00012,172.31.40.0-255,66,7771,65,213013
2216,0.000124,74.125.68.0-255,1484,9255,65,213013
2217,0.000125,172.31.40.0-255,66,9321,65,213013
2218,0.000153,74.125.68.0-255,1484,10805,65,213013
2219,0.000155,172.31.40.0-255,66,10871,65,213013
2220,0.000181,74.125.68.0-255,5738,16609,65,213013
2221,0.000184,172.31.40.0-255,66,16675,65,213013
2222,0.000194,74.125.68.0-255,1484,18159,65,213013
2223,0.000196,172.31.40.0-255,66,18225,65,213013
2224,0.000215,74.125.68.0-255,2543,20768,65,213013
2225,0.000218,172.31.40.0-255,66,20834,65,213013
2226,0.000303,74.125.68.0-255,1484,22318,65,213013
2227,0.000307,172.31.40.0-255,66,22384,65,213013
2228,0.000311,74.125.68.0-255,2902,25286,65,213013
2229,0.000315,172.31.40.0-255,66,25352,65,213013
2230,0.000341,74.125.68.0-255,5738,31090,65,213013
2231,0.000345,172.31.40.0-255,66,31156,65,213013
2232,0.00038,74.125.68.0-255,6797,37953,65,213013
2233,0.000383,172.31.40.0-255,66,38019,65,213013
2234,0.001098,74.125.68.0-255,1484,39503,65,213013
2235,0.001104,172.31.40.0-255,66,39569,65,213013
2236,0.001128,74.125.68.0-255,2902,42471,65,213013
2237,0.001131,172.31.40.0-255,66,42537,65,213013
2238,0.001147,74.125.68.0-255,4320,46857,65,213013
2239,0.001149,172.31.40.0-255,66,46923,65,213013
2240,0.001153,74.125.68.0-255,2902,49825,65,213013
2241,0.001155,172.31.40.0-255,66,49891,65,213013
2242,0.001177,74.125.68.0-255,1484,51375,65,213013
2243,0.001193,74.125.68.0-255,5379,56754,65,213013
2244,0.001198,172.31.40.0-255,66,56820,65,213013
2245,0.001209,74.125.68.0-255,2902,59722,65,213013
2246,0.001211,172.31.40.0-255,66,59788,65,213013
2247,0.001229,74.125.68.0-255,2902,62690,65,213013
2248,0.001232,172.31.40.0-255,66,62756,65,213013
2249,0.001256,74.125.68.0-255,7156,69912,65,213013
2250,0.001259,172.31.40.0-255,66,69978,65,213013
2251,0.001265,74.125.68.0-255,4320,74298,65,213013
2252,0.001267,172.31.40.0-255,66,74364,65,213013
2253,0.00127,74.125.68.0-255,1484,75848,65,213013
2254,0.001293,74.125.68.0-255,4320,80168,65,213013
2255,0.001296,172.31.40.0-255,66,80234,65,213013
2256,0.001308,74.125.68.0-255,2902,83136,65,213013
2257,0.00131,172.31.40.0-255,66,83202,65,213013
2258,0.00133,74.125.68.0-255,6438,89640,65,213013
2259,0.001333,172.31.40.0-255,66,89706,65,213013
2260,0.001437,74.125.68.0-255,1484,91190,65,213013
2261,0.001456,74.125.68.0-255,2902,94092,65,213013
2262,0.00146,172.31.40.0-255,66,94158,65,213013
2263,0.001465,74.125.68.0-255,4320,98478,65,213013
2264,0.001468,172.31.40.0-255,66,98544,65,213013
2265,0.001504,74.125.68.0-255,2902,101446,65,213013
2266,0.001507,172.31.40.0-255,66,101512,65,213013
2267,0.001528,74.125.68.0-255,5265,106777,65,213013
2268,0.001531,172.31.40.0-255,66,106843,65,213013
2269,0.002046,74.125.68.0-255,1484,108327,65,213013
2270,0.002069,74.125.68.0-255,2902,111229,65,213013
2271,0.002074,172.31.40.0-255,66,111295,65,213013
2272,0.00208,74.125.68.0-255,4320,115615,65,213013
2273,0.002082,172.31.40.0-255,66,115681,65,213013
2274,0.00211,74.125.68.0-255,2902,118583,65,213013
2275,0.002113,172.31.40.0-255,66,118649,65,213013
2276,0.002137,74.125.68.0-255,4320,122969,65,213013
2277,0.002139,172.31.40.0-255,66,123035,65,213013
2278,0.002169,74.125.68.0-255,7156,130191,65,213013
2279,0.002172,172.31.40.0-255,66,130257,65,213013
2280,0.002189,74.125.68.0-255,1484,131741,65,213013
2281,0.002193,74.125.68.0-255,2902,134643,65,213013
2282,0.002196,172.31.40.0-255,66,134709,65,213013
2283,0.00222,74.125.68.0-255,4320,139029,65,213013
2284,0.002223,172.31.40.0-255,66,139095,65,213013
2285,0.002241,74.125.68.0-255,2184,141279,65,213013
2286,0.002244,172.31.40.0-255,66,141345,65,213013
2287,0.002519,74.125.68.0-255,1484,142829,65,213013
2288,0.002528,74.125.68.0-255,2902,145731,65,213013
2289,0.002531,172.31.40.0-255,66,145797,65,213013
2290,0.002549,74.125.68.0-255,2902,148699,65,213013
2291,0.002551,172.31.40.0-255,66,148765,65,213013
2292,0.002564,74.125.68.0-255,2902,151667,65,213013
2293,0.002566,172.31.40.0-255,66,151733,65,213013
2294,0.002572,74.125.68.0-255,5738,157471,65,213013
2295,0.002574,172.31.40.0-255,66,157537,65,213013
2296,0.002577,74.125.68.0-255,1484,159021,65,213013
2297,0.002598,74.125.68.0-255,5738,164759,65,213013
2298,0.0026,172.31.40.0-255,66,164825,65,213013
2299,0.002619,74.125.68.0-255,4320,169145,65,213013
2300,0.002621,172.31.40.0-255,66,169211,65,213013
2301,0.002651,74.125.68.0-255,5738,174949,65,213013
2302,0.002653,172.31.40.0-255,66,175015,65,213013
2303,0.002656,74.125.68.0-255,766,175781,65,213013
2304,0.002677,74.125.68.0-255,1484,177265,65,213013
2305,0.002679,172.31.40.0-255,66,177331,65,213013
2306,0.005362,74.125.68.0-255,2902,180233,65,213013
2307,0.005365,172.31.40.0-255,66,180299,65,213013
2308,0.005402,74.125.68.0-255,2902,183201,65,213013
2309,0.005403,172.31.40.0-255,66,183267,65,213013
2310,0.008,74.125.68.0-255,2902,186169,65,213013
2311,0.008007,172.31.40.0-255,66,186235,65,213013
2312,0.008038,74.125.68.0-255,2902,189137,65,213013
2313,0.008041,172.31.40.0-255,66,189203,65,213013
2314,0.010662,74.125.68.0-255,2902,192105,65,213013
2315,0.010671,172.31.40.0-255,66,192171,65,213013
2316,0.010697,74.125.68.0-255,2902,195073,65,213013
2317,0.010701,172.31.40.0-255,66,195139,65,213013
2318,0.013307,74.125.68.0-255,2902,198041,65,213013
2319,0.013314,172.31.40.0-255,66,198107,65,213013
2320,0.013351,74.125.68.0-255,2902,201009,65,213013
2321,0.013355,172.31.40.0-255,66,201075,65,213013
2322,0.01597,74.125.68.0-255,2902,203977,65,213013
2323,0.015978,172.31.40.0-255,66,204043,65,213013
2324,0.016016,74.125.68.0-255,1484,205527,65,213013
2325,0.016036,74.125.68.0-255,1484,207011,65,213013
2326,0.01604,172.31.40.0-255,66,207077,65,213013
2327,0.018616,74.125.68.0-255,2902,209979,65,213013
2328,0.018622,172.31.40.0-255,66,210045,65,213013
2329,0.018666,74.125.68.0-255,2902,212947,65,213013
2330,0.01867,172.31.40.0-255,66,213013,65,213013
2331,0.0,172.217.194.0-255,156,156,65,173764
2332,1.4e-05,172.31.40.0-255,66,222,65,173764
2333,1.9e-05,172.217.194.0-255,1484,1706,65,173764
2334,2.3e-05,172.31.40.0-255,66,1772,65,173764
2335,5e-05,172.217.194.0-255,2902,4674,65,173764
2336,5.3e-05,172.31.40.0-255,66,4740,65,173764
2337,6.4e-05,172.217.194.0-255,7156,11896,65,173764
2338,6.6e-05,172.31.40.0-255,66,11962,65,173764
2339,9.2e-05,172.217.194.0-255,2001,13963,65,173764
2340,9.9e-05,172.31.40.0-255,66,14029,65,173764
2341,0.000156,172.217.194.0-255,1484,15513,65,173764
2342,0.000159,172.31.40.0-255,66,15579,65,173764
2343,0.000172,172.217.194.0-255,2902,18481,65,173764
2344,0.000179,172.31.40.0-255,66,18547,65,173764
2345,0.000185,172.217.194.0-255,4320,22867,65,173764
2346,0.000187,172.31.40.0-255,66,22933,65,173764
2347,0.000215,172.217.194.0-255,1484,24417,65,173764
2348,0.000218,172.31.40.0-255,66,24483,65,173764
2349,0.000226,172.217.194.0-255,6797,31280,65,173764
2350,0.000228,172.31.40.0-255,66,31346,65,173764
2351,0.000246,172.31.40.0-255,66,31412,65,173764
2352,0.000282,172.217.194.0-255,1484,32896,65,173764
2353,0.000284,172.31.40.0-255,66,32962,65,173764
2354,0.000307,172.31.40.0-255,66,33028,65,173764
2355,0.00031,172.217.194.0-255,1346,34374,65,173764
2356,0.000312,172.31.40.0-255,66,34440,65,173764
2357,0.000469,172.217.194.0-255,1484,35924,65,173764
2358,0.000475,172.31.40.0-255,66,35990,65,173764
2359,0.000493,172.217.194.0-255,2902,38892,65,173764
2360,0.000496,172.31.40.0-255,66,38958,65,173764
2361,0.000502,172.217.194.0-255,4320,43278,65,173764
2362,0.000504,172.31.40.0-255,66,43344,65,173764
2363,0.000552,172.31.40.0-255,66,43410,65,173764
2364,0.000555,172.217.194.0-255,1484,44894,65,173764
2365,0.000593,172.31.40.0-255,66,44960,65,173764
2366,0.000779,172.217.194.0-255,1484,46444,65,173764
2367,0.000785,172.217.194.0-255,2902,49346,65,173764
2368,0.000788,172.31.40.0-255,66,49412,65,173764
2369,0.000794,172.217.194.0-255,4320,53732,65,173764
2370,0.000796,172.31.40.0-255,66,53798,65,173764
2371,0.000817,172.217.194.0-255,1484,55282,65,173764
2372,0.000828,172.217.194.0-255,5738,61020,65,173764
2373,0.00083,172.31.40.0-255,66,61086,65,173764
2374,0.000837,172.217.194.0-255,7156,68242,65,173764
2375,0.00084,172.31.40.0-255,66,68308,65,173764
2376,0.000902,172.31.40.0-255,66,68374,65,173764
2377,0.000981,172.217.194.0-255,1484,69858,65,173764
2378,0.000987,172.217.194.0-255,2902,72760,65,173764
2379,0.00099,172.31.40.0-255,66,72826,65,173764
2380,0.000997,172.217.194.0-255,5738,78564,65,173764
2381,0.000999,172.31.40.0-255,66,78630,65,173764
2382,0.001034,172.31.40.0-255,66,78696,65,173764
2383,0.001065,172.217.194.0-255,4320,83016,65,173764
2384,0.001068,172.31.40.0-255,66,83082,65,173764
2385,0.001086,172.31.40.0-255,66,83148,65,173764
2386,0.001092,172.217.194.0-255,4320,87468,65,173764
2387,0.001094,172.31.40.0-255,66,87534,65,173764
2388,0.001127,172.217.194.0-255,7156,94690,65,173764
2389,0.00113,172.31.40.0-255,66,94756,65,173764
2390,0.001154,172.31.40.0-255,66,94822,65,173764
2391,0.001166,172.217.194.0-255,1484,96306,65,173764
2392,0.001198,172.31.40.0-255,66,96372,65,173764
2393,0.001218,172.217.194.0-255,1484,97856,65,173764
2394,0.001233,172.31.40.0-255,66,97922,65,173764
2395,0.001259,172.217.194.0-255,4320,102242,65,173764
2396,0.001266,172.31.40.0-255,66,102308,65,173764
2397,0.001299,172.217.194.0-255,5738,108046,65,173764
2398,0.001332,172.31.40.0-255,66,108112,65,173764
2399,0.001339,172.217.194.0-255,5738,113850,65,173764
2400,0.001345,172.31.40.0-255,66,113916,65,173764
2401,0.001375,172.217.194.0-255,5020,118936,65,173764
2402,0.001391,172.217.194.0-255,7156,126092,65,173764
2403,0.001412,172.217.194.0-255,2902,128994,65,173764
2404,0.001418,172.31.40.0-255,66,129060,65,173764
2405,0.001443,172.217.194.0-255,4320,133380,65,173764
2406,0.001448,172.31.40.0-255,66,133446,65,173764
2407,0.001494,172.217.194.0-255,4320,137766,65,173764
2408,0.001526,172.217.194.0-255,1484,139250,65,173764
2409,0.001534,172.31.40.0-255,66,139316,65,173764
2410,0.001555,172.217.194.0-255,4320,143636,65,173764
2411,0.001579,172.217.194.0-255,4320,147956,65,173764
2412,0.001584,172.217.194.0-255,4320,152276,65,173764
2413,0.001592,172.31.40.0-255,66,152342,65,173764
2414,0.001598,172.217.194.0-255,1484,153826,65,173764
2415,0.001605,172.217.194.0-255,7156,160982,65,173764
2416,0.00161,172.31.40.0-255,66,161048,65,173764
2417,0.001626,172.217.194.0-255,4320,165368,65,173764
2418,0.00165,172.217.194.0-255,3602,168970,65,173764
2419,0.001662,172.217.194.0-255,4320,173290,65,173764
2420,0.00167,172.31.40.0-255,66,173356,65,173764
2421,0.001725,172.31.40.0-255,66,173422,65,173764
2422,0.001751,172.217.194.0-255,105,173527,65,173764
2423,0.001759,172.31.40.0-255,66,173593,65,173764
2424,0.004345,172.31.40.0-255,105,173698,65,173764
2425,0.0063,172.217.194.0-255,66,173764,65,173764
2426,0.0,74.125.24.0-255,152,152,65,199944
2427,1.8e-05,172.31.40.0-255,66,218,65,199944
2428,2.6e-05,74.125.24.0-255,1484,1702,65,199944
2429,3e-05,172.31.40.0-255,66,1768,65,199944
2430,3.5e-05,74.125.24.0-255,2902,4670,65,199944
2431,4.6e-05,172.31.40.0-255,66,4736,65,199944
2432,5.1e-05,74.125.24.0-255,4320,9056,65,199944
2433,5.4e-05,172.31.40.0-255,66,9122,65,199944
2434,6.4e-05,172.31.40.0-255,66,9188,65,199944
2435,0.000102,74.125.24.0-255,3570,12758,65,199944
2436,0.000105,172.31.40.0-255,66,12824,65,199944
2437,0.000121,172.31.40.0-255,66,12890,65,199944
2438,0.000383,74.125.24.0-255,1484,14374,65,199944
2439,0.000389,74.125.24.0-255,2902,17276,65,199944
2440,0.000398,172.31.40.0-255,66,17342,65,199944
2441,0.000403,172.31.40.0-255,66,17408,65,199944
2442,0.000431,74.125.24.0-255,5738,23146,65,199944
2443,0.000439,172.31.40.0-255,66,23212,65,199944
2444,0.000477,172.31.40.0-255,66,23278,65,199944
2445,0.000517,172.31.40.0-255,66,23344,65,199944
2446,0.000521,74.125.24.0-255,1399,24743,65,199944
2447,0.000523,172.31.40.0-255,66,24809,65,199944
2448,0.000834,74.125.24.0-255,380,25189,65,199944
2449,0.000839,172.31.40.0-255,66,25255,65,199944
2450,0.001046,74.125.24.0-255,1484,26739,65,199944
2451,0.001051,172.31.40.0-255,66,26805,65,199944
2452,0.001056,74.125.24.0-255,2902,29707,65,199944
2453,0.001058,172.31.40.0-255,66,29773,65,199944
2454,0.001068,74.125.24.0-255,5738,35511,65,199944
2455,0.001096,74.125.24.0-255,2902,38413,65,199944
2456,0.001127,172.31.40.0-255,66,38479,65,199944
2457,0.001131,172.31.40.0-255,66,38545,65,199944
2458,0.001159,74.125.24.0-255,5738,44283,65,199944
2459,0.00119,74.125.24.0-255,2902,47185,65,199944
2460,0.001196,172.31.40.0-255,66,47251,65,199944
2461,0.001213,172.31.40.0-255,66,47317,65,199944
2462,0.00123,74.125.24.0-255,2543,49860,65,199944
2463,0.001235,74.125.24.0-255,4320,54180,65,199944
2464,0.001279,74.125.24.0-255,4320,58500,65,199944
2465,0.001291,172.31.40.0-255,66,58566,65,199944
2466,0.001301,74.125.24.0-255,4320,62886,65,199944
2467,0.001306,172.31.40.0-255,66,62952,65,199944
2468,0.001687,74.125.24.0-255,1484,64436,65,199944
2469,0.001695,74.125.24.0-255,2902,67338,65,199944
2470,0.001732,74.125.24.0-255,1484,68822,65,199944
2471,0.00176,74.125.24.0-255,4320,73142,65,199944
2472,0.001779,74.125.24.0-255,7156,80298,65,199944
2473,0.00182,74.125.24.0-255,3602,83900,65,199944
2474,0.002265,74.125.24.0-255,1484,85384,65,199944
2475,0.002274,74.125.24.0-255,2902,88286,65,199944
2476,0.002282,74.125.24.0-255,5738,94024,65,199944
2477,0.002308,74.125.24.0-255,2902,96926,65,199944
2478,0.002342,74.125.24.0-255,5738,102664,65,199944
2479,0.002363,74.125.24.0-255,1484,104148,65,199944
2480,0.002382,74.125.24.0-255,3602,107750,65,199944
2481,0.002389,74.125.24.0-255,5738,113488,65,199944
2482,0.002431,74.125.24.0-255,1484,114972,65,199944
2483,0.002444,74.125.24.0-255,7156,122128,65,199944
2484,0.00246,74.125.24.0-255,5738,127866,65,199944
2485,0.002498,74.125.24.0-255,2184,130050,65,199944
2486,0.00251,74.125.24.0-255,2902,132952,65,199944
2487,0.002525,74.125.24.0-255,1484,134436,65,199944
2488,0.002531,74.125.24.0-255,4320,138756,65,199944
2489,0.002568,74.125.24.0-255,2184,140940,65,199944
2490,0.002632,74.125.24.0-255,1484,142424,65,199944
2491,0.002666,74.125.24.0-255,2902,145326,65,199944
2492,0.00269,74.125.24.0-255,4320,149646,65,199944
2493,0.002712,74.125.24.0-255,4320,153966,65,199944
2494,0.002715,74.125.24.0-255,1484,155450,65,199944
2495,0.002727,74.125.24.0-255,1484,156934,65,199944
2496,0.002731,74.125.24.0-255,2902,159836,65,199944
2497,0.002746,74.125.24.0-255,1484,161320,65,199944
2498,0.002751,74.125.24.0-255,4320,165640,65,199944
2499,0.00277,74.125.24.0-255,4320,169960,65,199944
2500,0.002775,74.125.24.0-255,5020,174980,65,199944
2501,0.002856,74.125.24.0-255,1484,176464,65,199944
2502,0.002875,74.125.24.0-255,1484,177948,65,199944
2503,0.002888,74.125.24.0-255,1484,179432,65,199944
2504,0.002903,74.125.24.0-255,5738,185170,65,199944
2505,0.002976,74.125.24.0-255,1484,186654,65,199944
2506,0.003015,74.125.24.0-255,2184,188838,65,199944
2507,0.003026,74.125.24.0-255,1484,190322,65,199944
2508,0.003043,74.125.24.0-255,5738,196060,65,199944
2509,0.003064,74.125.24.0-255,3445,199505,65,199944
2510,0.003066,74.125.24.0-255,97,199602,65,199944
2511,0.003076,74.125.24.0-255,105,199707,65,199944
2512,0.007131,172.31.40.0-255,66,199773,65,199944
2513,0.009834,172.31.40.0-255,105,199878,65,199944
2514,0.012359,74.125.24.0-255,66,199944,65,199944
2515,0.0,74.125.200.0-255,149,149,65,272279
2516,1.6e-05,172.31.40.0-255,66,215,65,272279
2517,2.2e-05,74.125.200.0-255,1484,1699,65,272279
2518,2.6e-05,172.31.40.0-255,66,1765,65,272279
2519,3.1e-05,74.125.200.0-255,2902,4667,65,272279
2520,3.4e-05,172.31.40.0-255,66,4733,65,272279
2521,3.8e-05,74.125.200.0-255,2902,7635,65,272279
2522,4.1e-05,172.31.40.0-255,66,7701,65,272279
2523,7.4e-05,74.125.200.0-255,4320,12021,65,272279
2524,7.8e-05,172.31.40.0-255,66,12087,65,272279
2525,0.0001,74.125.200.0-255,2073,14160,65,272279
2526,0.000104,172.31.40.0-255,66,14226,65,272279
2527,0.000149,74.125.200.0-255,1484,15710,65,272279
2528,0.000153,172.31.40.0-255,66,15776,65,272279
2529,0.000157,74.125.200.0-255,1484,17260,65,272279
2530,0.000159,172.31.40.0-255,66,17326,65,272279
2531,0.000173,74.125.200.0-255,1484,18810,65,272279
2532,0.000176,172.31.40.0-255,66,18876,65,272279
2533,0.000183,74.125.200.0-255,5738,24614,65,272279
2534,0.000185,172.31.40.0-255,66,24680,65,272279
2535,0.000189,74.125.200.0-255,2902,27582,65,272279
2536,0.000191,172.31.40.0-255,66,27648,65,272279
2537,0.000221,74.125.200.0-255,3961,31609,65,272279
2538,0.000225,172.31.40.0-255,66,31675,65,272279
2539,0.000255,74.125.200.0-255,1484,33159,65,272279
2540,0.000259,172.31.40.0-255,66,33225,65,272279
2541,0.000263,74.125.200.0-255,1484,34709,65,272279
2542,0.000265,172.31.40.0-255,66,34775,65,272279
2543,0.000281,74.125.200.0-255,1484,36259,65,272279
2544,0.000284,172.31.40.0-255,66,36325,65,272279
2545,0.000287,74.125.200.0-255,1484,37809,65,272279
2546,0.000289,172.31.40.0-255,66,37875,65,272279
2547,0.000319,74.125.200.0-255,4320,42195,65,272279
2548,0.000327,74.125.200.0-255,6797,48992,65,272279
2549,0.000365,74.125.200.0-255,1484,50476,65,272279
2550,0.000377,74.125.200.0-255,1484,51960,65,272279
2551,0.000393,74.125.200.0-255,1484,53444,65,272279
2552,0.000398,74.125.200.0-255,5738,59182,65,272279
2553,0.000401,74.125.200.0-255,1484,60666,65,272279
2554,0.000428,74.125.200.0-255,5379,66045,65,272279
2555,0.000458,74.125.200.0-255,414,66459,65,272279
2556,0.000477,74.125.200.0-255,1484,67943,65,272279
2557,0.00049,74.125.200.0-255,1484,69427,65,272279
2558,0.000514,74.125.200.0-255,4320,73747,65,272279
2559,0.000538,74.125.200.0-255,4320,78067,65,272279
2560,0.000564,74.125.200.0-255,4320,82387,65,272279
2561,0.000579,172.31.40.0-255,66,82453,65,272279
2562,0.000589,74.125.200.0-255,1367,83820,65,272279
2563,0.000605,74.125.200.0-255,1484,85304,65,272279
2564,0.000624,74.125.200.0-255,4320,89624,65,272279
2565,0.000639,74.125.200.0-255,1484,91108,65,272279
2566,0.000672,74.125.200.0-255,5738,96846,65,272279
2567,0.000682,172.31.40.0-255,66,96912,65,272279
2568,0.0007,74.125.200.0-255,3961,100873,65,272279
2569,0.000729,172.31.40.0-255,66,100939,65,272279
2570,0.001205,74.125.200.0-255,1484,102423,65,272279
2571,0.001211,74.125.200.0-255,2902,105325,65,272279
2572,0.001216,172.31.40.0-255,66,105391,65,272279
2573,0.001246,74.125.200.0-255,2902,108293,65,272279
2574,0.00127,74.125.200.0-255,2902,111195,65,272279
2575,0.001283,74.125.200.0-255,1484,112679,65,272279
2576,0.001297,172.31.40.0-255,66,112745,65,272279
2577,0.001339,172.31.40.0-255,66,112811,65,272279
2578,0.001439,74.125.200.0-255,1484,114295,65,272279
2579,0.001444,74.125.200.0-255,2902,117197,65,272279
2580,0.001446,172.31.40.0-255,66,117263,65,272279
2581,0.001466,74.125.200.0-255,1484,118747,65,272279
2582,0.00147,74.125.200.0-255,2902,121649,65,272279
2583,0.001483,74.125.200.0-255,4320,125969,65,272279
2584,0.001493,74.125.200.0-255,1484,127453,65,272279
2585,0.001511,74.125.200.0-255,2902,130355,65,272279
2586,0.001518,172.31.40.0-255,66,130421,65,272279
2587,0.001527,74.125.200.0-255,2902,133323,65,272279
2588,0.001548,74.125.200.0-255,1484,134807,65,272279
2589,0.001554,172.31.40.0-255,66,134873,65,272279
2590,0.001564,74.125.200.0-255,5738,140611,65,272279
2591,0.001568,172.31.40.0-255,66,140677,65,272279
2592,0.001589,74.125.200.0-255,2902,143579,65,272279
2593,0.001602,74.125.200.0-255,3602,147181,65,272279
2594,0.001606,74.125.200.0-255,2902,150083,65,272279
2595,0.001611,172.31.40.0-255,66,150149,65,272279
2596,0.001633,74.125.200.0-255,4320,154469,65,272279
2597,0.001647,74.125.200.0-255,4320,158789,65,272279
2598,0.001651,172.31.40.0-255,66,158855,65,272279
2599,0.001672,74.125.200.0-255,5738,164593,65,272279
2600,0.001699,172.31.40.0-255,66,164659,65,272279
2601,0.001709,74.125.200.0-255,1484,166143,65,272279
2602,0.001732,74.125.200.0-255,2902,169045,65,272279
2603,0.001737,74.125.200.0-255,2902,171947,65,272279
2604,0.001747,172.31.40.0-255,66,172013,65,272279
2605,0.00177,74.125.200.0-255,2902,174915,65,272279
2606,0.001777,74.125.200.0-255,7156,182071,65,272279
2607,0.001782,74.125.200.0-255,5738,187809,65,272279
2608,0.001793,74.125.200.0-255,2902,190711,65,272279
2609,0.001805,74.125.200.0-255,1484,192195,65,272279
2610,0.00182,74.125.200.0-255,4320,196515,65,272279
2611,0.001827,172.31.40.0-255,66,196581,65,272279
2612,0.001838,74.125.200.0-255,2184,198765,65,272279
2613,0.001857,172.31.40.0-255,66,198831,65,272279
2614,0.002038,74.125.200.0-255,1484,200315,65,272279
2615,0.002042,74.125.200.0-255,1484,201799,65,272279
2616,0.002049,172.31.40.0-255,66,201865,65,272279
2617,0.002062,74.125.200.0-255,1484,203349,65,272279
2618,0.002067,74.125.200.0-255,2902,206251,65,272279
2619,0.002072,172.31.40.0-255,66,206317,65,272279
2620,0.002095,74.125.200.0-255,1484,207801,65,272279
2621,0.002101,74.125.200.0-255,5738,213539,65,272279
2622,0.002115,172.31.40.0-255,66,213605,65,272279
2623,0.002152,74.125.200.0-255,2902,216507,65,272279
2624,0.002165,74.125.200.0-255,2902,219409,65,272279
2625,0.002188,74.125.200.0-255,5020,224429,65,272279
2626,0.002531,74.125.200.0-255,1484,225913,65,272279
2627,0.00254,74.125.200.0-255,2902,228815,65,272279
2628,0.002551,74.125.200.0-255,5738,234553,65,272279
2629,0.00257,74.125.200.0-255,1484,236037,65,272279
2630,0.002596,74.125.200.0-255,7156,243193,65,272279
2631,0.002739,172.31.40.0-255,66,243259,65,272279
2632,0.005369,74.125.200.0-255,5738,248997,65,272279
2633,0.005389,172.31.40.0-255,66,249063,65,272279
2634,0.007944,74.125.200.0-255,5738,254801,65,272279
2635,0.010399,172.31.40.0-255,66,254867,65,272279
2636,0.012968,74.125.200.0-255,5738,260605,65,272279
2637,0.012986,172.31.40.0-255,66,260671,65,272279
2638,0.015554,74.125.200.0-255,5738,266409,65,272279
2639,0.01557,172.31.40.0-255,66,266475,65,272279
2640,0.018127,74.125.200.0-255,5738,272213,65,272279
2641,0.018135,172.31.40.0-255,66,272279,65,272279
2642,0.0,74.125.24.0-255,153,153,65,140018
2643,2.2e-05,172.31.40.0-255,66,219,65,140018
2644,2.8e-05,74.125.24.0-255,1484,1703,65,140018
2645,3.1e-05,172.31.40.0-255,66,1769,65,140018
2646,3.6e-05,74.125.24.0-255,2902,4671,65,140018
2647,3.9e-05,172.31.40.0-255,66,4737,65,140018
2648,4.6e-05,74.125.24.0-255,7156,11893,65,140018
2649,4.8e-05,172.31.40.0-255,66,11959,65,140018
2650,9e-05,172.31.40.0-255,66,12025,65,140018
2651,0.000119,74.125.24.0-255,4320,16345,65,140018
2652,0.000121,172.31.40.0-255,66,16411,65,140018
2653,0.000139,74.125.24.0-255,3961,20372,65,140018
2654,0.000141,172.31.40.0-255,66,20438,65,140018
2655,0.000244,74.125.24.0-255,1484,21922,65,140018
2656,0.000249,172.31.40.0-255,66,21988,65,140018
2657,0.000254,74.125.24.0-255,2902,24890,65,140018
2658,0.000256,172.31.40.0-255,66,24956,65,140018
2659,0.000275,74.125.24.0-255,5738,30694,65,140018
2660,0.000278,172.31.40.0-255,66,30760,65,140018
2661,0.000295,74.125.24.0-255,1484,32244,65,140018
2662,0.000297,172.31.40.0-255,66,32310,65,140018
2663,0.000319,172.31.40.0-255,66,32376,65,140018
2664,0.000332,74.125.24.0-255,1125,33501,65,140018
2665,0.000334,172.31.40.0-255,66,33567,65,140018
2666,0.000344,172.31.40.0-255,66,33633,65,140018
2667,0.000461,74.125.24.0-255,390,34023,65,140018
2668,0.000465,172.31.40.0-255,66,34089,65,140018
2669,0.000502,74.125.24.0-255,353,34442,65,140018
2670,0.000505,172.31.40.0-255,66,34508,65,140018
2671,0.00102,74.125.24.0-255,1484,35992,65,140018
2672,0.001028,74.125.24.0-255,2902,38894,65,140018
2673,0.001031,172.31.40.0-255,66,38960,65,140018
2674,0.001038,74.125.24.0-255,5738,44698,65,140018
2675,0.00104,172.31.40.0-255,66,44764,65,140018
2676,0.001062,74.125.24.0-255,7156,51920,65,140018
2677,0.001065,172.31.40.0-255,66,51986,65,140018
2678,0.001104,74.125.24.0-255,5738,57724,65,140018
2679,0.001108,172.31.40.0-255,66,57790,65,140018
2680,0.00112,172.31.40.0-255,66,57856,65,140018
2681,0.001773,74.125.24.0-255,1484,59340,65,140018
2682,0.001782,74.125.24.0-255,2902,62242,65,140018
2683,0.001786,172.31.40.0-255,66,62308,65,140018
2684,0.001804,74.125.24.0-255,4320,66628,65,140018
2685,0.001806,172.31.40.0-255,66,66694,65,140018
2686,0.001826,74.125.24.0-255,1484,68178,65,140018
2687,0.001862,172.31.40.0-255,66,68244,65,140018
2688,0.001871,172.31.40.0-255,66,68310,65,140018
2689,0.001889,74.125.24.0-255,1484,69794,65,140018
2690,0.001892,74.125.24.0-255,766,70560,65,140018
2691,0.001894,172.31.40.0-255,66,70626,65,140018
2692,0.001993,74.125.24.0-255,1484,72110,65,140018
2693,0.001998,74.125.24.0-255,2902,75012,65,140018
2694,0.002,172.31.40.0-255,66,75078,65,140018
2695,0.002014,74.125.24.0-255,4320,79398,65,140018
2696,0.002017,172.31.40.0-255,66,79464,65,140018
2697,0.002027,74.125.24.0-255,1484,80948,65,140018
2698,0.002038,74.125.24.0-255,2902,83850,65,140018
2699,0.00204,172.31.40.0-255,66,83916,65,140018
2700,0.002065,172.31.40.0-255,66,83982,65,140018
2701,0.002071,74.125.24.0-255,7156,91138,65,140018
2702,0.002073,172.31.40.0-255,66,91204,65,140018
2703,0.002092,74.125.24.0-255,3602,94806,65,140018
2704,0.002094,172.31.40.0-255,66,94872,65,140018
2705,0.004296,74.125.24.0-255,1484,96356,65,140018
2706,0.004314,74.125.24.0-255,2902,99258,65,140018
2707,0.004317,172.31.40.0-255,66,99324,65,140018
2708,0.004336,74.125.24.0-255,1484,100808,65,140018
2709,0.006405,74.125.24.0-255,4320,105128,65,140018
2710,0.006411,172.31.40.0-255,66,105194,65,140018
2711,0.008501,74.125.24.0-255,5738,110932,65,140018
2712,0.008515,172.31.40.0-255,66,110998,65,140018
2713,0.010601,74.125.24.0-255,5738,116736,65,140018
2714,0.010609,172.31.40.0-255,66,116802,65,140018
2715,0.012738,74.125.24.0-255,5738,122540,65,140018
2716,0.012748,172.31.40.0-255,66,122606,65,140018
2717,0.014857,74.125.24.0-255,5738,128344,65,140018
2718,0.014866,172.31.40.0-255,66,128410,65,140018
2719,0.016935,74.125.24.0-255,5738,134148,65,140018
2720,0.016941,172.31.40.0-255,66,134214,65,140018
2721,0.019009,74.125.24.0-255,5738,139952,65,140018
2722,0.019015,172.31.40.0-255,66,140018,65,140018
2723,0.0,216.58.203.0-255,153,153,65,171937
2724,2.6e-05,172.31.40.0-255,66,219,65,171937
2725,3.4e-05,216.58.203.0-255,1484,1703,65,171937
2726,3.9e-05,172.31.40.0-255,66,1769,65,171937
2727,5.5e-05,216.58.203.0-255,2902,4671,65,171937
2728,5.9e-05,172.31.40.0-255,66,4737,65,171937
2729,6.8e-05,216.58.203.0-255,7156,11893,65,171937
2730,7e-05,172.31.40.0-255,66,11959,65,171937
2731,7.4e-05,216.58.203.0-255,2137,14096,65,171937
2732,7.7e-05,172.31.40.0-255,66,14162,65,171937
2733,0.000107,216.58.203.0-255,1484,15646,65,171937
2734,0.000109,172.31.40.0-255,66,15712,65,171937
2735,0.000115,216.58.203.0-255,2902,18614,65,171937
2736,0.000118,172.31.40.0-255,66,18680,65,171937
2737,0.000129,216.58.203.0-255,5738,24418,65,171937
2738,0.000132,172.31.40.0-255,66,24484,65,171937
2739,0.000165,216.58.203.0-255,6797,31281,65,171937
2740,0.000168,172.31.40.0-255,66,31347,65,171937
2741,0.000236,216.58.203.0-255,1484,32831,65,171937
2742,0.000238,172.31.40.0-255,66,32897,65,171937
2743,0.000243,216.58.203.0-255,2902,35799,65,171937
2744,0.000245,172.31.40.0-255,66,35865,65,171937
2745,0.000248,216.58.203.0-255,1484,37349,65,171937
2746,0.00025,172.31.40.0-255,66,37415,65,171937
2747,0.000267,216.58.203.0-255,2902,40317,65,171937
2748,0.00027,172.31.40.0-255,66,40383,65,171937
2749,0.000275,216.58.203.0-255,5738,46121,65,171937
2750,0.000282,172.31.40.0-255,66,46187,65,171937
2751,0.000307,216.58.203.0-255,2543,48730,65,171937
2752,0.000309,172.31.40.0-255,66,48796,65,171937
2753,0.000588,216.58.203.0-255,1484,50280,65,171937
2754,0.000594,172.31.40.0-255,66,50346,65,171937
2755,0.0006,216.58.203.0-255,2902,53248,65,171937
2756,0.000604,172.31.40.0-255,66,53314,65,171937
2757,0.000633,216.58.203.0-255,5738,59052,65,171937
2758,0.000636,172.31.40.0-255,66,59118,65,171937
2759,0.000643,216.58.203.0-255,7091,66209,65,171937
2760,0.000646,172.31.40.0-255,66,66275,65,171937
2761,0.0007,216.58.203.0-255,133,66408,65,171937
2762,0.000705,216.58.203.0-255,349,66757,65,171937
2763,0.000862,216.58.203.0-255,1484,68241,65,171937
2764,0.000871,172.31.40.0-255,66,68307,65,171937
2765,0.000876,216.58.203.0-255,2902,71209,65,171937
2766,0.000878,172.31.40.0-255,66,71275,65,171937
2767,0.00091,216.58.203.0-255,2902,74177,65,171937
2768,0.000913,172.31.40.0-255,66,74243,65,171937
2769,0.000918,216.58.203.0-255,4320,78563,65,171937
2770,0.00092,172.31.40.0-255,66,78629,65,171937
2771,0.000925,216.58.203.0-255,4320,82949,65,171937
2772,0.000926,172.31.40.0-255,66,83015,65,171937
2773,0.00097,216.58.203.0-255,5379,88394,65,171937
2774,0.000972,172.31.40.0-255,66,88460,65,171937
2775,0.000988,172.31.40.0-255,66,88526,65,171937
2776,0.00099,216.58.203.0-255,1125,89651,65,171937
2777,0.001441,172.31.40.0-255,66,89717,65,171937
2778,0.001568,216.58.203.0-255,1484,91201,65,171937
2779,0.001576,216.58.203.0-255,2902,94103,65,171937
2780,0.001579,172.31.40.0-255,66,94169,65,171937
2781,0.001589,216.58.203.0-255,5738,99907,65,171937
2782,0.001591,172.31.40.0-255,66,99973,65,171937
2783,0.001624,216.58.203.0-255,7156,107129,65,171937
2784,0.001627,172.31.40.0-255,66,107195,65,171937
2785,0.001639,172.31.40.0-255,66,107261,65,171937
2786,0.001664,216.58.203.0-255,4320,111581,65,171937
2787,0.001667,172.31.40.0-255,66,111647,65,171937
2788,0.00167,216.58.203.0-255,2184,113831,65,171937
2789,0.001672,172.31.40.0-255,66,113897,65,171937
2790,0.003327,216.58.203.0-255,5738,119635,65,171937
2791,0.003334,172.31.40.0-255,66,119701,65,171937
2792,0.005008,216.58.203.0-255,5738,125439,65,171937
2793,0.005012,172.31.40.0-255,66,125505,65,171937
2794,0.006675,216.58.203.0-255,5738,131243,65,171937
2795,0.006682,172.31.40.0-255,66,131309,65,171937
2796,0.008367,216.58.203.0-255,5738,137047,65,171937
2797,0.008375,172.31.40.0-255,66,137113,65,171937
2798,0.010045,216.58.203.0-255,5738,142851,65,171937
2799,0.010055,172.31.40.0-255,66,142917,65,171937
2800,0.01174,216.58.203.0-255,5738,148655,65,171937
2801,0.011748,172.31.40.0-255,66,148721,65,171937
2802,0.013424,216.58.203.0-255,5738,154459,65,171937
2803,0.013431,172.31.40.0-255,66,154525,65,171937
2804,0.015126,216.58.203.0-255,5738,160263,65,171937
2805,0.015136,172.31.40.0-255,66,160329,65,171937
2806,0.016824,216.58.203.0-255,5738,166067,65,171937
2807,0.016838,172.31.40.0-255,66,166133,65,171937
2808,0.01853,216.58.203.0-255,5738,171871,65,171937
2809,0.018538,172.31.40.0-255,66,171937,65,171937
2810,0.0,74.125.24.0-255,150,150,65,227320
2811,2.4e-05,172.31.40.0-255,66,216,65,227320
2812,3.2e-05,74.125.24.0-255,1484,1700,65,227320
2813,3.6e-05,172.31.40.0-255,66,1766,65,227320
2814,4.2e-05,74.125.24.0-255,2902,4668,65,227320
2815,5.3e-05,172.31.40.0-255,66,4734,65,227320
2816,6.1e-05,74.125.24.0-255,7156,11890,65,227320
2817,6.4e-05,172.31.40.0-255,66,11956,65,227320
2818,6.9e-05,74.125.24.0-255,2001,13957,65,227320
2819,7.2e-05,172.31.40.0-255,66,14023,65,227320
2820,0.000119,74.125.24.0-255,1484,15507,65,227320
2821,0.000122,172.31.40.0-255,66,15573,65,227320
2822,0.000141,74.125.24.0-255,2902,18475,65,227320
2823,0.000144,172.31.40.0-255,66,18541,65,227320
2824,0.000147,74.125.24.0-255,1484,20025,65,227320
2825,0.000149,172.31.40.0-255,66,20091,65,227320
2826,0.000176,74.125.24.0-255,4320,24411,65,227320
2827,0.000178,172.31.40.0-255,66,24477,65,227320
2828,0.000207,74.125.24.0-255,6797,31274,65,227320
2829,0.00021,172.31.40.0-255,66,31340,65,227320
2830,0.000247,74.125.24.0-255,7156,38496,65,227320
2831,0.000249,172.31.40.0-255,66,38562,65,227320
2832,0.000256,74.125.24.0-255,5738,44300,65,227320
2833,0.000258,172.31.40.0-255,66,44366,65,227320
2834,0.000283,74.125.24.0-255,3961,48327,65,227320
2835,0.000285,172.31.40.0-255,66,48393,65,227320
2836,0.000318,74.125.24.0-255,1484,49877,65,227320
2837,0.00032,172.31.40.0-255,66,49943,65,227320
2838,0.000349,74.125.24.0-255,2902,52845,65,227320
2839,0.000352,172.31.40.0-255,66,52911,65,227320
2840,0.000358,74.125.24.0-255,5738,58649,65,227320
2841,0.000361,172.31.40.0-255,66,58715,65,227320
2842,0.000431,74.125.24.0-255,6797,65512,65,227320
2843,0.000539,74.125.24.0-255,413,65925,65,227320
2844,0.000576,74.125.24.0-255,332,66257,65,227320
2845,0.00061,172.31.40.0-255,66,66323,65,227320
2846,0.00067,74.125.24.0-255,1484,67807,65,227320
2847,0.000687,74.125.24.0-255,2902,70709,65,227320
2848,0.000706,74.125.24.0-255,2902,73611,65,227320
2849,0.000712,172.31.40.0-255,66,73677,65,227320
2850,0.000725,74.125.24.0-255,5738,79415,65,227320
2851,0.000746,74.125.24.0-255,1484,80899,65,227320
2852,0.00076,74.125.24.0-255,2902,83801,65,227320
2853,0.000786,172.31.40.0-255,66,83867,65,227320
2854,0.000791,172.31.40.0-255,66,83933,65,227320
2855,0.000814,74.125.24.0-255,3961,87894,65,227320
2856,0.000844,172.31.40.0-255,66,87960,65,227320
2857,0.000933,74.125.24.0-255,1484,89444,65,227320
2858,0.00094,74.125.24.0-255,2902,92346,65,227320
2859,0.000963,74.125.24.0-255,4320,96666,65,227320
2860,0.000966,172.31.40.0-255,66,96732,65,227320
2861,0.000971,172.31.40.0-255,66,96798,65,227320
2862,0.000996,74.125.24.0-255,1484,98282,65,227320
2863,0.001032,172.31.40.0-255,66,98348,65,227320
2864,0.00111,74.125.24.0-255,1484,99832,65,227320
2865,0.001115,74.125.24.0-255,2902,102734,65,227320
2866,0.001129,172.31.40.0-255,66,102800,65,227320
2867,0.001136,74.125.24.0-255,5738,108538,65,227320
2868,0.001145,172.31.40.0-255,66,108604,65,227320
2869,0.001199,172.31.40.0-255,66,108670,65,227320
2870,0.001218,74.125.24.0-255,2184,110854,65,227320
2871,0.001223,74.125.24.0-255,2902,113756,65,227320
2872,0.001236,172.31.40.0-255,66,113822,65,227320
2873,0.001263,74.125.24.0-255,7156,120978,65,227320
2874,0.001281,74.125.24.0-255,1484,122462,65,227320
2875,0.001301,74.125.24.0-255,6438,128900,65,227320
2876,0.001306,172.31.40.0-255,66,128966,65,227320
2877,0.001781,74.125.24.0-255,1484,130450,65,227320
2878,0.001787,74.125.24.0-255,2902,133352,65,227320
2879,0.00179,172.31.40.0-255,66,133418,65,227320
2880,0.001795,74.125.24.0-255,2902,136320,65,227320
2881,0.001822,74.125.24.0-255,2902,139222,65,227320
2882,0.001845,74.125.24.0-255,4320,143542,65,227320
2883,0.001859,172.31.40.0-255,66,143608,65,227320
2884,0.00187,172.31.40.0-255,66,143674,65,227320
2885,0.001905,74.125.24.0-255,1484,145158,65,227320
2886,0.001939,74.125.24.0-255,1484,146642,65,227320
2887,0.001947,172.31.40.0-255,66,146708,65,227320
2888,0.001972,74.125.24.0-255,1484,148192,65,227320
2889,0.001979,74.125.24.0-255,5738,153930,65,227320
2890,0.001984,74.125.24.0-255,4320,158250,65,227320
2891,0.001994,74.125.24.0-255,5738,163988,65,227320
2892,0.002009,74.125.24.0-255,2184,166172,65,227320
2893,0.002026,172.31.40.0-255,66,166238,65,227320
2894,0.002072,74.125.24.0-255,1484,167722,65,227320
2895,0.002077,74.125.24.0-255,2902,170624,65,227320
2896,0.002091,74.125.24.0-255,5738,176362,65,227320
2897,0.002094,172.31.40.0-255,66,176428,65,227320
2898,0.002099,172.31.40.0-255,66,176494,65,227320
2899,0.002139,74.125.24.0-255,1484,177978,65,227320
2900,0.002145,172.31.40.0-255,66,178044,65,227320
2901,0.002198,172.31.40.0-255,66,178110,65,227320
2902,0.002279,74.125.24.0-255,1484,179594,65,227320
2903,0.002294,74.125.24.0-255,2902,182496,65,227320
2904,0.002299,172.31.40.0-255,66,182562,65,227320
2905,0.00231,74.125.24.0-255,5738,188300,65,227320
2906,0.002342,172.31.40.0-255,66,188366,65,227320
2907,0.002371,74.125.24.0-255,4320,192686,65,227320
2908,0.002389,172.31.40.0-255,66,192752,65,227320
2909,0.002399,74.125.24.0-255,2902,195654,65,227320
2910,0.002419,74.125.24.0-255,3602,199256,65,227320
2911,0.00243,172.31.40.0-255,66,199322,65,227320
2912,0.002566,74.125.24.0-255,1484,200806,65,227320
2913,0.002578,74.125.24.0-255,1484,202290,65,227320
2914,0.002588,74.125.24.0-255,1484,203774,65,227320
2915,0.002609,74.125.24.0-255,5738,209512,65,227320
2916,0.002613,172.31.40.0-255,66,209578,65,227320
2917,0.002618,172.31.40.0-255,66,209644,65,227320
2918,0.002627,74.125.24.0-255,2902,212546,65,227320
2919,0.002652,172.31.40.0-255,66,212612,65,227320
2920,0.005186,74.125.24.0-255,2902,215514,65,227320
2921,0.005194,172.31.40.0-255,66,215580,65,227320
2922,0.005244,74.125.24.0-255,2902,218482,65,227320
2923,0.007765,74.125.24.0-255,2902,221384,65,227320
2924,0.015845,172.31.40.0-255,66,221450,65,227320
2925,0.016701,74.125.24.0-255,1484,222934,65,227320
2926,0.018412,74.125.24.0-255,4320,227254,65,227320
2927,0.018428,172.31.40.0-255,66,227320,65,227320
2928,0.0,172.217.27.0-255,155,155,65,214967
2929,1.4e-05,172.31.40.0-255,66,221,65,214967
2930,2.1e-05,172.217.27.0-255,1484,1705,65,214967
2931,2.6e-05,172.31.40.0-255,66,1771,65,214967
2932,3.1e-05,172.217.27.0-255,2902,4673,65,214967
2933,3.3e-05,172.31.40.0-255,66,4739,65,214967
2934,4.9e-05,172.217.27.0-255,7156,11895,65,214967
2935,5.2e-05,172.31.40.0-255,66,11961,65,214967
2936,5.6e-05,172.217.27.0-255,2100,14061,65,214967
2937,5.9e-05,172.31.40.0-255,66,14127,65,214967
2938,0.00011,172.217.27.0-255,1484,15611,65,214967
2939,0.000113,172.31.40.0-255,66,15677,65,214967
2940,0.000118,172.217.27.0-255,2902,18579,65,214967
2941,0.00012,172.31.40.0-255,66,18645,65,214967
2942,0.000141,172.217.27.0-255,5738,24383,65,214967
2943,0.000144,172.31.40.0-255,66,24449,65,214967
2944,0.000153,172.217.27.0-255,2902,27351,65,214967
2945,0.000155,172.31.40.0-255,66,27417,65,214967
2946,0.000183,172.217.27.0-255,3961,31378,65,214967
2947,0.00019,172.31.40.0-255,66,31444,65,214967
2948,0.000342,172.217.27.0-255,1484,32928,65,214967
2949,0.000347,172.31.40.0-255,66,32994,65,214967
2950,0.000353,172.217.27.0-255,2902,35896,65,214967
2951,0.000356,172.31.40.0-255,66,35962,65,214967
2952,0.000366,172.217.27.0-255,2902,38864,65,214967
2953,0.000368,172.31.40.0-255,66,38930,65,214967
2954,0.000399,172.217.27.0-255,2902,41832,65,214967
2955,0.000402,172.31.40.0-255,66,41898,65,214967
2956,0.000422,172.31.40.0-255,66,41964,65,214967
2957,0.000434,172.31.40.0-255,66,42030,65,214967
2958,0.000437,172.217.27.0-255,394,42424,65,214967
2959,0.000827,172.217.27.0-255,117,42541,65,214967
2960,0.001048,172.217.27.0-255,1484,44025,65,214967
2961,0.001053,172.31.40.0-255,66,44091,65,214967
2962,0.001059,172.217.27.0-255,2902,46993,65,214967
2963,0.001061,172.31.40.0-255,66,47059,65,214967
2964,0.001093,172.217.27.0-255,5738,52797,65,214967
2965,0.001095,172.31.40.0-255,66,52863,65,214967
2966,0.0011,172.217.27.0-255,2902,55765,65,214967
2967,0.001102,172.31.40.0-255,66,55831,65,214967
2968,0.001136,172.31.40.0-255,66,55897,65,214967
2969,0.001195,172.31.40.0-255,66,55963,65,214967
2970,0.001738,172.217.27.0-255,1484,57447,65,214967
2971,0.001747,172.217.27.0-255,2902,60349,65,214967
2972,0.001752,172.31.40.0-255,66,60415,65,214967
2973,0.001756,172.217.27.0-255,1484,61899,65,214967
2974,0.001783,172.217.27.0-255,5738,67637,65,214967
2975,0.001786,172.31.40.0-255,66,67703,65,214967
2976,0.00179,172.217.27.0-255,1484,69187,65,214967
2977,0.001816,172.31.40.0-255,66,69253,65,214967
2978,0.001826,172.31.40.0-255,66,69319,65,214967
2979,0.001851,172.217.27.0-255,2902,72221,65,214967
2980,0.001853,172.31.40.0-255,66,72287,65,214967
2981,0.00188,172.217.27.0-255,766,73053,65,214967
2982,0.002366,172.217.27.0-255,1484,74537,65,214967
2983,0.002372,172.31.40.0-255,66,74603,65,214967
2984,0.002379,172.217.27.0-255,2902,77505,65,214967
2985,0.002381,172.31.40.0-255,66,77571,65,214967
2986,0.002394,172.217.27.0-255,5738,83309,65,214967
2987,0.002396,172.31.40.0-255,66,83375,65,214967
2988,0.002436,172.31.40.0-255,66,83441,65,214967
2989,0.002464,172.217.27.0-255,7156,90597,65,214967
2990,0.002466,172.31.40.0-255,66,90663,65,214967
2991,0.00249,172.217.27.0-255,2902,93565,65,214967
2992,0.002493,172.31.40.0-255,66,93631,65,214967
2993,0.002496,172.217.27.0-255,1484,95115,65,214967
2994,0.0025,172.217.27.0-255,2902,98017,65,214967
2995,0.002502,172.31.40.0-255,66,98083,65,214967
2996,0.002509,172.217.27.0-255,766,98849,65,214967
2997,0.002813,172.217.27.0-255,1484,100333,65,214967
2998,0.002817,172.31.40.0-255,66,100399,65,214967
2999,0.002821,172.217.27.0-255,2902,103301,65,214967
3000,0.002823,172.31.40.0-255,66,103367,65,214967
3001,0.00285,172.217.27.0-255,5738,109105,65,214967
3002,0.002853,172.31.40.0-255,66,109171,65,214967
3003,0.002857,172.217.27.0-255,2902,112073,65,214967
3004,0.002859,172.31.40.0-255,66,112139,65,214967
3005,0.002902,172.31.40.0-255,66,112205,65,214967
3006,0.002908,172.217.27.0-255,5738,117943,65,214967
3007,0.00291,172.31.40.0-255,66,118009,65,214967
3008,0.002933,172.217.27.0-255,5020,123029,65,214967
3009,0.002936,172.31.40.0-255,66,123095,65,214967
3010,0.00296,172.217.27.0-255,1484,124579,65,214967
3011,0.002964,172.217.27.0-255,1484,126063,65,214967
3012,0.002966,172.31.40.0-255,66,126129,65,214967
3013,0.002978,172.217.27.0-255,1484,127613,65,214967
3014,0.002993,172.217.27.0-255,5738,133351,65,214967
3015,0.002996,172.31.40.0-255,66,133417,65,214967
3016,0.003,172.217.27.0-255,2902,136319,65,214967
3017,0.003003,172.31.40.0-255,66,136385,65,214967
3018,0.003035,172.217.27.0-255,4320,140705,65,214967
3019,0.003038,172.31.40.0-255,66,140771,65,214967
3020,0.003049,172.31.40.0-255,66,140837,65,214967
3021,0.003064,172.31.40.0-255,66,140903,65,214967
3022,0.003102,172.217.27.0-255,1484,142387,65,214967
3023,0.003116,172.217.27.0-255,2902,145289,65,214967
3024,0.003118,172.31.40.0-255,66,145355,65,214967
3025,0.003121,172.217.27.0-255,1484,146839,65,214967
3026,0.003148,172.217.27.0-255,4320,151159,65,214967
3027,0.003151,172.31.40.0-255,66,151225,65,214967
3028,0.003155,172.217.27.0-255,2902,154127,65,214967
3029,0.003158,172.31.40.0-255,66,154193,65,214967
3030,0.003195,172.217.27.0-255,4320,158513,65,214967
3031,0.003198,172.31.40.0-255,66,158579,65,214967
3032,0.003209,172.31.40.0-255,66,158645,65,214967
3033,0.003221,172.217.27.0-255,7156,165801,65,214967
3034,0.003224,172.31.40.0-255,66,165867,65,214967
3035,0.003226,172.217.27.0-255,766,166633,65,214967
3036,0.003329,172.217.27.0-255,1484,168117,65,214967
3037,0.003333,172.31.40.0-255,66,168183,65,214967
3038,0.003397,172.217.27.0-255,2902,171085,65,214967
3039,0.003401,172.31.40.0-255,66,171151,65,214967
3040,0.003407,172.217.27.0-255,5738,176889,65,214967
3041,0.003409,172.31.40.0-255,66,176955,65,214967
3042,0.003414,172.217.27.0-255,2902,179857,65,214967
3043,0.003421,172.31.40.0-255,66,179923,65,214967
3044,0.003443,172.217.27.0-255,7156,187079,65,214967
3045,0.003447,172.31.40.0-255,66,187145,65,214967
3046,0.00345,172.217.27.0-255,1484,188629,65,214967
3047,0.003469,172.217.27.0-255,2184,190813,65,214967
3048,0.003488,172.31.40.0-255,66,190879,65,214967
3049,0.00349,172.31.40.0-255,66,190945,65,214967
3050,0.00361,172.217.27.0-255,1484,192429,65,214967
3051,0.003617,172.217.27.0-255,2902,195331,65,214967
3052,0.00362,172.31.40.0-255,66,195397,65,214967
3053,0.003653,172.217.27.0-255,5738,201135,65,214967
3054,0.003656,172.31.40.0-255,66,201201,65,214967
3055,0.003661,172.217.27.0-255,4320,205521,65,214967
3056,0.003663,172.31.40.0-255,66,205587,65,214967
3057,0.003674,172.217.27.0-255,5738,211325,65,214967
3058,0.003677,172.31.40.0-255,66,211391,65,214967
3059,0.00372,172.31.40.0-255,66,211457,65,214967
3060,0.003725,172.217.27.0-255,2184,213641,65,214967
3061,0.003727,172.31.40.0-255,66,213707,65,214967
3062,0.003768,172.31.40.0-255,66,213773,65,214967
3063,0.003787,172.31.40.0-255,66,213839,65,214967
3064,0.003826,172.31.40.0-255,66,213905,65,214967
3065,0.003858,172.31.40.0-255,66,213971,65,214967
3066,0.003876,172.31.40.0-255,66,214037,65,214967
3067,0.003922,172.31.40.0-255,66,214103,65,214967
3068,0.003945,172.217.27.0-255,168,214271,65,214967
3069,0.010055,172.31.40.0-255,105,214376,65,214967
3070,0.010104,172.31.40.0-255,105,214481,65,214967
3071,0.010366,172.31.40.0-255,90,214571,65,214967
3072,0.010376,172.31.40.0-255,66,214637,65,214967
3073,0.011651,172.217.27.0-255,66,214703,65,214967
3074,0.01168,172.217.27.0-255,66,214769,65,214967
3075,0.011949,172.217.27.0-255,66,214835,65,214967
3076,0.011976,172.217.27.0-255,66,214901,65,214967
3077,0.011982,172.31.40.0-255,66,214967,65,214967
3078,0.0,74.125.200.0-255,146,146,65,218839
3079,3.1e-05,172.31.40.0-255,66,212,65,218839
3080,3.7e-05,74.125.200.0-255,1484,1696,65,218839
3081,4.2e-05,172.31.40.0-255,66,1762,65,218839
3082,4.5e-05,74.125.200.0-255,1484,3246,65,218839
3083,4.7e-05,172.31.40.0-255,66,3312,65,218839
3084,5.3e-05,74.125.200.0-255,2902,6214,65,218839
3085,5.5e-05,172.31.40.0-255,66,6280,65,218839
3086,6e-05,74.125.200.0-255,2902,9182,65,218839
3087,6.2e-05,172.31.40.0-255,66,9248,65,218839
3088,8.5e-05,74.125.200.0-255,2902,12150,65,218839
3089,8.7e-05,172.31.40.0-255,66,12216,65,218839
3090,9.4e-05,74.125.200.0-255,2101,14317,65,218839
3091,9.7e-05,172.31.40.0-255,66,14383,65,218839
3092,0.000223,74.125.200.0-255,1484,15867,65,218839
3093,0.000227,172.31.40.0-255,66,15933,65,218839
3094,0.000231,74.125.200.0-255,1484,17417,65,218839
3095,0.000233,172.31.40.0-255,66,17483,65,218839
3096,0.000247,74.125.200.0-255,1484,18967,65,218839
3097,0.00025,172.31.40.0-255,66,19033,65,218839
3098,0.000256,74.125.200.0-255,5738,24771,65,218839
3099,0.000258,172.31.40.0-255,66,24837,65,218839
3100,0.000313,74.125.200.0-255,6797,31634,65,218839
3101,0.000317,172.31.40.0-255,66,31700,65,218839
3102,0.000347,74.125.200.0-255,1484,33184,65,218839
3103,0.00035,172.31.40.0-255,66,33250,65,218839
3104,0.000355,74.125.200.0-255,2902,36152,65,218839
3105,0.000357,172.31.40.0-255,66,36218,65,218839
3106,0.000372,74.125.200.0-255,5738,41956,65,218839
3107,0.000375,172.31.40.0-255,66,42022,65,218839
3108,0.000396,74.125.200.0-255,4320,46342,65,218839
3109,0.000399,172.31.40.0-255,66,46408,65,218839
3110,0.000432,74.125.200.0-255,2543,48951,65,218839
3111,0.000458,74.125.200.0-255,2902,51853,65,218839
3112,0.000482,74.125.200.0-255,4320,56173,65,218839
3113,0.000503,74.125.200.0-255,2902,59075,65,218839
3114,0.000507,74.125.200.0-255,2902,61977,65,218839
3115,0.000551,74.125.200.0-255,4542,66519,65,218839
3116,0.000651,172.31.40.0-255,66,66585,65,218839
3117,0.000834,74.125.200.0-255,1484,68069,65,218839
3118,0.000839,74.125.200.0-255,1484,69553,65,218839
3119,0.000844,172.31.40.0-255,66,69619,65,218839
3120,0.000851,74.125.200.0-255,1484,71103,65,218839
3121,0.000856,74.125.200.0-255,4320,75423,65,218839
3122,0.000862,172.31.40.0-255,66,75489,65,218839
3123,0.00088,74.125.200.0-255,5738,81227,65,218839
3124,0.000887,172.31.40.0-255,66,81293,65,218839
3125,0.000895,74.125.200.0-255,2902,84195,65,218839
3126,0.000901,74.125.200.0-255,4320,88515,65,218839
3127,0.000906,172.31.40.0-255,66,88581,65,218839
3128,0.000914,74.125.200.0-255,4320,92901,65,218839
3129,0.000924,172.31.40.0-255,66,92967,65,218839
3130,0.000955,74.125.200.0-255,4320,97287,65,218839
3131,0.000961,172.31.40.0-255,66,97353,65,218839
3132,0.000975,74.125.200.0-255,3602,100955,65,218839
3133,0.000988,172.31.40.0-255,66,101021,65,218839
3134,0.00099,74.125.200.0-255,1484,102505,65,218839
3135,0.001011,74.125.200.0-255,7156,109661,65,218839
3136,0.001018,172.31.40.0-255,66,109727,65,218839
3137,0.00103,74.125.200.0-255,5738,115465,65,218839
3138,0.001046,172.31.40.0-255,66,115531,65,218839
3139,0.001047,74.125.200.0-255,4320,119851,65,218839
3140,0.00105,172.31.40.0-255,66,119917,65,218839
3141,0.001051,74.125.200.0-255,2902,122819,65,218839
3142,0.001062,172.31.40.0-255,66,122885,65,218839
3143,0.001093,172.31.40.0-255,66,122951,65,218839
3144,0.001104,74.125.200.0-255,3602,126553,65,218839
3145,0.001109,172.31.40.0-255,66,126619,65,218839
3146,0.001121,74.125.200.0-255,4320,130939,65,218839
3147,0.001136,172.31.40.0-255,66,131005,65,218839
3148,0.001163,74.125.200.0-255,4320,135325,65,218839
3149,0.001172,172.31.40.0-255,66,135391,65,218839
3150,0.001217,74.125.200.0-255,2902,138293,65,218839
3151,0.00123,172.31.40.0-255,66,138359,65,218839
3152,0.001257,172.31.40.0-255,66,138425,65,218839
3153,0.00157,74.125.200.0-255,1484,139909,65,218839
3154,0.001574,74.125.200.0-255,1484,141393,65,218839
3155,0.001578,172.31.40.0-255,66,141459,65,218839
3156,0.001585,74.125.200.0-255,1484,142943,65,218839
3157,0.00159,74.125.200.0-255,2902,145845,65,218839
3158,0.001596,172.31.40.0-255,66,145911,65,218839
3159,0.001615,74.125.200.0-255,2902,148813,65,218839
3160,0.001621,74.125.200.0-255,7156,155969,65,218839
3161,0.001621,172.31.40.0-255,66,156035,65,218839
3162,0.001625,172.31.40.0-255,66,156101,65,218839
3163,0.001658,74.125.200.0-255,1484,157585,65,218839
3164,0.001663,172.31.40.0-255,66,157651,65,218839
3165,0.001685,74.125.200.0-255,6438,164089,65,218839
3166,0.001696,172.31.40.0-255,66,164155,65,218839
3167,0.001722,74.125.200.0-255,1484,165639,65,218839
3168,0.001741,74.125.200.0-255,2902,168541,65,218839
3169,0.001747,172.31.40.0-255,66,168607,65,218839
3170,0.001766,74.125.200.0-255,5738,174345,65,218839
3171,0.001772,74.125.200.0-255,4320,178665,65,218839
3172,0.001775,74.125.200.0-255,1484,180149,65,218839
3173,0.001775,172.31.40.0-255,66,180215,65,218839
3174,0.001802,74.125.200.0-255,4320,184535,65,218839
3175,0.001807,74.125.200.0-255,2902,187437,65,218839
3176,0.00181,172.31.40.0-255,66,187503,65,218839
3177,0.001843,74.125.200.0-255,2184,189687,65,218839
3178,0.001848,172.31.40.0-255,66,189753,65,218839
3179,0.004101,74.125.200.0-255,5738,195491,65,218839
3180,0.004109,172.31.40.0-255,66,195557,65,218839
3181,0.00635,74.125.200.0-255,4320,199877,65,218839
3182,0.006368,74.125.200.0-255,1484,201361,65,218839
3183,0.008039,172.31.40.0-255,66,201427,65,218839
3184,0.010313,74.125.200.0-255,5738,207165,65,218839
3185,0.010323,172.31.40.0-255,66,207231,65,218839
3186,0.012585,74.125.200.0-255,5738,212969,65,218839
3187,0.016593,172.31.40.0-255,66,213035,65,218839
3188,0.018867,74.125.200.0-255,5738,218773,65,218839
3189,0.018888,172.31.40.0-255,66,218839,65,218839
3190,0.0,74.125.200.0-255,147,147,65,127126
3191,2.3e-05,172.31.40.0-255,66,213,65,127126
3192,3e-05,74.125.200.0-255,1484,1697,65,127126
3193,3.4e-05,172.31.40.0-255,66,1763,65,127126
3194,4e-05,74.125.200.0-255,2902,4665,65,127126
3195,4.3e-05,172.31.40.0-255,66,4731,65,127126
3196,5.1e-05,74.125.200.0-255,7156,11887,65,127126
3197,5.4e-05,172.31.40.0-255,66,11953,65,127126
3198,5.8e-05,74.125.200.0-255,2092,14045,65,127126
3199,6e-05,172.31.40.0-255,66,14111,65,127126
3200,8.6e-05,74.125.200.0-255,1484,15595,65,127126
3201,8.9e-05,172.31.40.0-255,66,15661,65,127126
3202,9.4e-05,74.125.200.0-255,2902,18563,65,127126
3203,9.6e-05,172.31.40.0-255,66,18629,65,127126
3204,9.9e-05,74.125.200.0-255,1484,20113,65,127126
3205,0.000101,172.31.40.0-255,66,20179,65,127126
3206,0.000136,74.125.200.0-255,4320,24499,65,127126
3207,0.000138,172.31.40.0-255,66,24565,65,127126
3208,0.000141,74.125.200.0-255,1484,26049,65,127126
3209,0.000143,172.31.40.0-255,66,26115,65,127126
3210,0.000191,74.125.200.0-255,1484,27599,65,127126
3211,0.000194,172.31.40.0-255,66,27665,65,127126
3212,0.000214,74.125.200.0-255,3961,31626,65,127126
3213,0.000217,172.31.40.0-255,66,31692,65,127126
3214,0.000283,74.125.200.0-255,1484,33176,65,127126
3215,0.000286,172.31.40.0-255,66,33242,65,127126
3216,0.000292,74.125.200.0-255,2902,36144,65,127126
3217,0.000294,172.31.40.0-255,66,36210,65,127126
3218,0.0003,74.125.200.0-255,5738,41948,65,127126
3219,0.000302,172.31.40.0-255,66,42014,65,127126
3220,0.000321,74.125.200.0-255,2902,44916,65,127126
3221,0.000323,172.31.40.0-255,66,44982,65,127126
3222,0.000346,74.125.200.0-255,3961,48943,65,127126
3223,0.000356,74.125.200.0-255,7156,56099,65,127126
3224,0.000396,74.125.200.0-255,402,56501,65,127126
3225,0.000487,172.31.40.0-255,66,56567,65,127126
3226,0.000515,74.125.200.0-255,109,56676,65,127126
3227,0.00057,74.125.200.0-255,332,57008,65,127126
3228,0.00105,74.125.200.0-255,1484,58492,65,127126
3229,0.001055,172.31.40.0-255,66,58558,65,127126
3230,0.001061,74.125.200.0-255,2902,61460,65,127126
3231,0.001076,74.125.200.0-255,4320,65780,65,127126
3232,0.001088,172.31.40.0-255,66,65846,65,127126
3233,0.001108,74.125.200.0-255,5738,71584,65,127126
3234,0.00113,74.125.200.0-255,2902,74486,65,127126
3235,0.001133,172.31.40.0-255,66,74552,65,127126
3236,0.001138,172.31.40.0-255,66,74618,65,127126
3237,0.001169,74.125.200.0-255,4320,78938,65,127126
3238,0.001173,172.31.40.0-255,66,79004,65,127126
3239,0.00119,74.125.200.0-255,3602,82606,65,127126
3240,0.001193,172.31.40.0-255,66,82672,65,127126
3241,0.003502,74.125.200.0-255,2902,85574,65,127126
3242,0.00351,172.31.40.0-255,66,85640,65,127126
3243,0.00353,74.125.200.0-255,2902,88542,65,127126
3244,0.004699,172.31.40.0-255,66,88608,65,127126
3245,0.005838,74.125.200.0-255,2902,91510,65,127126
3246,0.005844,172.31.40.0-255,66,91576,65,127126
3247,0.007021,74.125.200.0-255,1484,93060,65,127126
3248,0.00704,74.125.200.0-255,1484,94544,65,127126
3249,0.007043,172.31.40.0-255,66,94610,65,127126
3250,0.008186,74.125.200.0-255,2902,97512,65,127126
3251,0.008192,172.31.40.0-255,66,97578,65,127126
3252,0.009381,74.125.200.0-255,2902,100480,65,127126
3253,0.009388,172.31.40.0-255,66,100546,65,127126
3254,0.010514,74.125.200.0-255,2902,103448,65,127126
3255,0.010522,172.31.40.0-255,66,103514,65,127126
3256,0.011752,74.125.200.0-255,2902,106416,65,127126
3257,0.011758,172.31.40.0-255,66,106482,65,127126
3258,0.012849,74.125.200.0-255,2902,109384,65,127126
3259,0.01286,172.31.40.0-255,66,109450,65,127126
3260,0.014091,74.125.200.0-255,2902,112352,65,127126
3261,0.014098,172.31.40.0-255,66,112418,65,127126
3262,0.015182,74.125.200.0-255,2902,115320,65,127126
3263,0.01519,172.31.40.0-255,66,115386,65,127126
3264,0.016437,74.125.200.0-255,2902,118288,65,127126
3265,0.016445,172.31.40.0-255,66,118354,65,127126
3266,0.01752,74.125.200.0-255,2902,121256,65,127126
3267,0.017528,172.31.40.0-255,66,121322,65,127126
3268,0.018789,74.125.200.0-255,2902,124224,65,127126
3269,0.019892,74.125.200.0-255,2902,127126,65,127126
3270,0.0,74.125.200.0-255,150,150,65,177570
3271,2.3e-05,172.31.40.0-255,66,216,65,177570
3272,3e-05,74.125.200.0-255,1484,1700,65,177570
3273,3.4e-05,172.31.40.0-255,66,1766,65,177570
3274,3.9e-05,74.125.200.0-255,2902,4668,65,177570
3275,5e-05,172.31.40.0-255,66,4734,65,177570
3276,5.6e-05,74.125.200.0-255,5738,10472,65,177570
3277,6e-05,172.31.40.0-255,66,10538,65,177570
3278,6.7e-05,74.125.200.0-255,5738,16276,65,177570
3279,7e-05,172.31.40.0-255,66,16342,65,177570
3280,9.3e-05,74.125.200.0-255,2076,18418,65,177570
3281,9.9e-05,172.31.40.0-255,66,18484,65,177570
3282,0.000111,172.31.40.0-255,66,18550,65,177570
3283,0.000116,74.125.200.0-255,3961,22511,65,177570
3284,0.000118,172.31.40.0-255,66,22577,65,177570
3285,0.000199,74.125.200.0-255,1484,24061,65,177570
3286,0.000203,172.31.40.0-255,66,24127,65,177570
3287,0.000207,74.125.200.0-255,1484,25611,65,177570
3288,0.000209,172.31.40.0-255,66,25677,65,177570
3289,0.000238,74.125.200.0-255,1484,27161,65,177570
3290,0.00024,172.31.40.0-255,66,27227,65,177570
3291,0.000247,74.125.200.0-255,5738,32965,65,177570
3292,0.000249,172.31.40.0-255,66,33031,65,177570
3293,0.000254,74.125.200.0-255,4320,37351,65,177570
3294,0.000257,172.31.40.0-255,66,37417,65,177570
3295,0.000285,74.125.200.0-255,1484,38901,65,177570
3296,0.000288,172.31.40.0-255,66,38967,65,177570
3297,0.000296,74.125.200.0-255,6797,45764,65,177570
3298,0.000298,172.31.40.0-255,66,45830,65,177570
3299,0.000355,74.125.200.0-255,5738,51568,65,177570
3300,0.000357,172.31.40.0-255,66,51634,65,177570
3301,0.000363,74.125.200.0-255,5379,57013,65,177570
3302,0.000547,172.31.40.0-255,66,57079,65,177570
3303,0.000782,74.125.200.0-255,645,57724,65,177570
3304,0.00106,172.31.40.0-255,66,57790,65,177570
3305,0.001113,74.125.200.0-255,1484,59274,65,177570
3306,0.001127,74.125.200.0-255,2902,62176,65,177570
3307,0.001155,172.31.40.0-255,66,62242,65,177570
3308,0.001185,74.125.200.0-255,4320,66562,65,177570
3309,0.001201,172.31.40.0-255,66,66628,65,177570
3310,0.001225,74.125.200.0-255,5738,72366,65,177570
3311,0.001251,74.125.200.0-255,4320,76686,65,177570
3312,0.001265,74.125.200.0-255,2902,79588,65,177570
3313,0.001271,74.125.200.0-255,4320,83908,65,177570
3314,0.001286,172.31.40.0-255,66,83974,65,177570
3315,0.00129,74.125.200.0-255,1484,85458,65,177570
3316,0.001311,74.125.200.0-255,4320,89778,65,177570
3317,0.001322,74.125.200.0-255,2184,91962,65,177570
3318,0.001337,172.31.40.0-255,66,92028,65,177570
3319,0.001518,74.125.200.0-255,1484,93512,65,177570
3320,0.001534,74.125.200.0-255,2902,96414,65,177570
3321,0.001538,172.31.40.0-255,66,96480,65,177570
3322,0.001572,74.125.200.0-255,5738,102218,65,177570
3323,0.001575,74.125.200.0-255,1484,103702,65,177570
3324,0.001579,74.125.200.0-255,2902,106604,65,177570
3325,0.001595,172.31.40.0-255,66,106670,65,177570
3326,0.001606,74.125.200.0-255,5738,112408,65,177570
3327,0.001624,74.125.200.0-255,1484,113892,65,177570
3328,0.001641,172.31.40.0-255,66,113958,65,177570
3329,0.001645,74.125.200.0-255,2902,116860,65,177570
3330,0.00165,172.31.40.0-255,66,116926,65,177570
3331,0.001677,74.125.200.0-255,2902,119828,65,177570
3332,0.001686,172.31.40.0-255,66,119894,65,177570
3333,0.001712,74.125.200.0-255,4320,124214,65,177570
3334,0.001717,74.125.200.0-255,2184,126398,65,177570
3335,0.001732,172.31.40.0-255,66,126464,65,177570
3336,0.002013,74.125.200.0-255,1484,127948,65,177570
3337,0.00202,74.125.200.0-255,1484,129432,65,177570
3338,0.002023,172.31.40.0-255,66,129498,65,177570
3339,0.002027,74.125.200.0-255,1484,130982,65,177570
3340,0.002052,74.125.200.0-255,1484,132466,65,177570
3341,0.002058,74.125.200.0-255,5738,138204,65,177570
3342,0.002072,74.125.200.0-255,1484,139688,65,177570
3343,0.002075,172.31.40.0-255,78,139766,65,177570
3344,0.00208,74.125.200.0-255,2902,142668,65,177570
3345,0.002082,172.31.40.0-255,78,142746,65,177570
3346,0.002106,74.125.200.0-255,5738,148484,65,177570
3347,0.007553,172.31.40.0-255,66,148550,65,177570
3348,0.009626,74.125.200.0-255,5738,154288,65,177570
3349,0.009634,172.31.40.0-255,66,154354,65,177570
3350,0.01169,74.125.200.0-255,5738,160092,65,177570
3351,0.011697,172.31.40.0-255,66,160158,65,177570
3352,0.013771,74.125.200.0-255,5738,165896,65,177570
3353,0.013778,172.31.40.0-255,66,165962,65,177570
3354,0.015854,74.125.200.0-255,5738,171700,65,177570
3355,0.015863,172.31.40.0-255,66,171766,65,177570
3356,0.017929,74.125.200.0-255,5738,177504,65,177570
3357,0.017937,172.31.40.0-255,66,177570,65,177570
3358,0.0,74.125.130.0-255,151,151,65,187022
3359,2e-05,172.31.40.0-255,66,217,65,187022
3360,2.7e-05,74.125.130.0-255,1484,1701,65,187022
3361,3.1e-05,172.31.40.0-255,66,1767,65,187022
3362,6e-05,74.125.130.0-255,2902,4669,65,187022
3363,6.3e-05,172.31.40.0-255,66,4735,65,187022
3364,9.5e-05,74.125.130.0-255,7156,11891,65,187022
3365,9.8e-05,172.31.40.0-255,66,11957,65,187022
3366,0.000136,172.31.40.0-255,66,12023,65,187022
3367,0.000161,74.125.130.0-255,1484,13507,65,187022
3368,0.000164,172.31.40.0-255,66,13573,65,187022
3369,0.000202,74.125.130.0-255,7156,20729,65,187022
3370,0.000205,172.31.40.0-255,66,20795,65,187022
3371,0.000207,74.125.130.0-255,1484,22279,65,187022
3372,0.000209,172.31.40.0-255,66,22345,65,187022
3373,0.000231,74.125.130.0-255,1125,23470,65,187022
3374,0.000233,172.31.40.0-255,66,23536,65,187022
3375,0.000359,74.125.130.0-255,1484,25020,65,187022
3376,0.000363,172.31.40.0-255,66,25086,65,187022
3377,0.000368,74.125.130.0-255,2902,27988,65,187022
3378,0.000371,172.31.40.0-255,66,28054,65,187022
3379,0.000373,74.125.130.0-255,1484,29538,65,187022
3380,0.000375,172.31.40.0-255,66,29604,65,187022
3381,0.000385,74.125.130.0-255,2902,32506,65,187022
3382,0.000387,172.31.40.0-255,66,32572,65,187022
3383,0.000417,74.125.130.0-255,5738,38310,65,187022
3384,0.000419,172.31.40.0-255,66,38376,65,187022
3385,0.000423,74.125.130.0-255,1484,39860,65,187022
3386,0.000424,172.31.40.0-255,66,39926,65,187022
3387,0.000465,74.125.130.0-255,3961,43887,65,187022
3388,0.000468,172.31.40.0-255,66,43953,65,187022
3389,0.000474,74.125.130.0-255,5738,49691,65,187022
3390,0.000477,172.31.40.0-255,66,49757,65,187022
3391,0.000484,74.125.130.0-255,5738,55495,65,187022
3392,0.000486,172.31.40.0-255,66,55561,65,187022
3393,0.000518,74.125.130.0-255,2543,58104,65,187022
3394,0.000594,172.31.40.0-255,66,58170,65,187022
3395,0.000758,74.125.130.0-255,646,58816,65,187022
3396,0.001108,74.125.130.0-255,1484,60300,65,187022
3397,0.001113,172.31.40.0-255,66,60366,65,187022
3398,0.001118,74.125.130.0-255,2902,63268,65,187022
3399,0.001121,172.31.40.0-255,66,63334,65,187022
3400,0.001145,74.125.130.0-255,4320,67654,65,187022
3401,0.001147,172.31.40.0-255,66,67720,65,187022
3402,0.001176,74.125.130.0-255,5738,73458,65,187022
3403,0.001179,172.31.40.0-255,66,73524,65,187022
3404,0.001202,74.125.130.0-255,1484,75008,65,187022
3405,0.001218,74.125.130.0-255,4320,79328,65,187022
3406,0.00122,172.31.40.0-255,66,79394,65,187022
3407,0.001258,74.125.130.0-255,7156,86550,65,187022
3408,0.00126,172.31.40.0-255,66,86616,65,187022
3409,0.001265,74.125.130.0-255,2902,89518,65,187022
3410,0.001267,172.31.40.0-255,66,89584,65,187022
3411,0.001277,74.125.130.0-255,3602,93186,65,187022
3412,0.001279,172.31.40.0-255,66,93252,65,187022
3413,0.001665,74.125.130.0-255,1484,94736,65,187022
3414,0.001691,74.125.130.0-255,2902,97638,65,187022
3415,0.001695,172.31.40.0-255,66,97704,65,187022
3416,0.001699,74.125.130.0-255,1484,99188,65,187022
3417,0.001704,74.125.130.0-255,2902,102090,65,187022
3418,0.001706,172.31.40.0-255,66,102156,65,187022
3419,0.001743,74.125.130.0-255,5738,107894,65,187022
3420,0.001746,172.31.40.0-255,66,107960,65,187022
3421,0.001749,74.125.130.0-255,1484,109444,65,187022
3422,0.001773,74.125.130.0-255,2902,112346,65,187022
3423,0.001775,172.31.40.0-255,66,112412,65,187022
3424,0.001807,74.125.130.0-255,5738,118150,65,187022
3425,0.00181,172.31.40.0-255,66,118216,65,187022
3426,0.001813,74.125.130.0-255,1484,119700,65,187022
3427,0.001839,74.125.130.0-255,2902,122602,65,187022
3428,0.001842,172.31.40.0-255,66,122668,65,187022
3429,0.001846,74.125.130.0-255,2902,125570,65,187022
3430,0.001848,172.31.40.0-255,66,125636,65,187022
3431,0.001896,74.125.130.0-255,2184,127820,65,187022
3432,0.0019,172.31.40.0-255,66,127886,65,187022
3433,0.002062,74.125.130.0-255,1484,129370,65,187022
3434,0.002078,74.125.130.0-255,2902,132272,65,187022
3435,0.002082,172.31.40.0-255,66,132338,65,187022
3436,0.002085,74.125.130.0-255,1484,133822,65,187022
3437,0.002105,74.125.130.0-255,4320,138142,65,187022
3438,0.002108,172.31.40.0-255,66,138208,65,187022
3439,0.002113,74.125.130.0-255,2902,141110,65,187022
3440,0.002114,172.31.40.0-255,66,141176,65,187022
3441,0.002147,172.31.40.0-255,66,141242,65,187022
3442,0.002153,74.125.130.0-255,4320,145562,65,187022
3443,0.002155,172.31.40.0-255,66,145628,65,187022
3444,0.002208,74.125.130.0-255,2902,148530,65,187022
3445,0.002214,74.125.130.0-255,3602,152132,65,187022
3446,0.005016,172.31.40.0-255,66,152198,65,187022
3447,0.00731,74.125.130.0-255,5738,157936,65,187022
3448,0.007318,172.31.40.0-255,66,158002,65,187022
3449,0.009604,74.125.130.0-255,5738,163740,65,187022
3450,0.009611,172.31.40.0-255,66,163806,65,187022
3451,0.011898,74.125.130.0-255,5738,169544,65,187022
3452,0.011906,172.31.40.0-255,66,169610,65,187022
3453,0.014202,74.125.130.0-255,5738,175348,65,187022
3454,0.014212,172.31.40.0-255,66,175414,65,187022
3455,0.016501,74.125.130.0-255,5738,181152,65,187022
3456,0.01651,172.31.40.0-255,66,181218,65,187022
3457,0.018804,74.125.130.0-255,5738,186956,65,187022
3458,0.018816,172.31.40.0-255,66,187022,65,187022
3459,0.0,172.217.194.0-255,150,150,65,202121
3460,2.4e-05,172.31.40.0-255,66,216,65,202121
3461,3.2e-05,172.217.194.0-255,1484,1700,65,202121
3462,3.7e-05,172.31.40.0-255,66,1766,65,202121
3463,4.1e-05,172.217.194.0-255,2902,4668,65,202121
3464,4.7e-05,172.31.40.0-255,66,4734,65,202121
3465,5.5e-05,172.217.194.0-255,7156,11890,65,202121
3466,5.8e-05,172.31.40.0-255,66,11956,65,202121
3467,7.2e-05,172.31.40.0-255,66,12022,65,202121
3468,0.000112,172.31.40.0-255,66,12088,65,202121
3469,0.000159,172.217.194.0-255,4320,16408,65,202121
3470,0.000162,172.31.40.0-255,66,16474,65,202121
3471,0.000183,172.217.194.0-255,1484,17958,65,202121
3472,0.000185,172.31.40.0-255,66,18024,65,202121
3473,0.000207,172.217.194.0-255,4320,22344,65,202121
3474,0.000209,172.31.40.0-255,66,22410,65,202121
3475,0.000221,172.31.40.0-255,66,22476,65,202121
3476,0.00024,172.217.194.0-255,4320,26796,65,202121
3477,0.000243,172.31.40.0-255,66,26862,65,202121
3478,0.000267,172.217.194.0-255,7156,34018,65,202121
3479,0.00027,172.31.40.0-255,66,34084,65,202121
3480,0.000274,172.217.194.0-255,2495,36579,65,202121
3481,0.000276,172.31.40.0-255,66,36645,65,202121
3482,0.000293,172.217.194.0-255,365,37010,65,202121
3483,0.000295,172.31.40.0-255,66,37076,65,202121
3484,0.000411,172.217.194.0-255,1484,38560,65,202121
3485,0.000416,172.31.40.0-255,66,38626,65,202121
3486,0.000421,172.217.194.0-255,2902,41528,65,202121
3487,0.000423,172.31.40.0-255,66,41594,65,202121
3488,0.000429,172.217.194.0-255,4320,45914,65,202121
3489,0.000452,172.217.194.0-255,1484,47398,65,202121
3490,0.00046,172.217.194.0-255,7156,54554,65,202121
3491,0.000478,172.217.194.0-255,2902,57456,65,202121
3492,0.000511,172.217.194.0-255,2184,59640,65,202121
3493,0.000546,172.217.194.0-255,1484,61124,65,202121
3494,0.00057,172.217.194.0-255,2902,64026,65,202121
3495,0.000575,172.217.194.0-255,2902,66928,65,202121
3496,0.000592,172.217.194.0-255,2902,69830,65,202121
3497,0.000598,172.217.194.0-255,4320,74150,65,202121
3498,0.000698,172.217.194.0-255,7156,81306,65,202121
3499,0.000714,172.217.194.0-255,5738,87044,65,202121
3500,0.000885,172.31.40.0-255,66,87110,65,202121
3501,0.001007,172.217.194.0-255,1484,88594,65,202121
3502,0.001014,172.217.194.0-255,2902,91496,65,202121
3503,0.001019,172.217.194.0-255,2902,94398,65,202121
3504,0.001027,172.31.40.0-255,66,94464,65,202121
3505,0.001049,172.217.194.0-255,2902,97366,65,202121
3506,0.001057,172.217.194.0-255,7156,104522,65,202121
3507,0.001061,172.217.194.0-255,4320,108842,65,202121
3508,0.00107,172.31.40.0-255,66,108908,65,202121
3509,0.001093,172.217.194.0-255,2184,111092,65,202121
3510,0.001143,172.31.40.0-255,66,111158,65,202121
3511,0.00124,172.217.194.0-255,1484,112642,65,202121
3512,0.001244,172.217.194.0-255,1484,114126,65,202121
3513,0.001262,172.217.194.0-255,1484,115610,65,202121
3514,0.001266,172.217.194.0-255,2902,118512,65,202121
3515,0.001268,172.31.40.0-255,66,118578,65,202121
3516,0.001272,172.31.40.0-255,66,118644,65,202121
3517,0.001291,172.217.194.0-255,2902,121546,65,202121
3518,0.001293,172.217.194.0-255,1484,123030,65,202121
3519,0.001296,172.31.40.0-255,66,123096,65,202121
3520,0.001308,172.217.194.0-255,1484,124580,65,202121
3521,0.001335,172.217.194.0-255,7156,131736,65,202121
3522,0.001341,172.217.194.0-255,7156,138892,65,202121
3523,0.001355,172.31.40.0-255,66,138958,65,202121
3524,0.001393,172.217.194.0-255,6438,145396,65,202121
3525,0.001415,172.31.40.0-255,66,145462,65,202121
3526,0.001547,172.217.194.0-255,1484,146946,65,202121
3527,0.001574,172.217.194.0-255,2902,149848,65,202121
3528,0.00158,172.217.194.0-255,4320,154168,65,202121
3529,0.001595,172.31.40.0-255,66,154234,65,202121
3530,0.001614,172.31.40.0-255,66,154300,65,202121
3531,0.001679,172.31.40.0-255,66,154366,65,202121
3532,0.001686,172.217.194.0-255,5020,159386,65,202121
3533,0.001693,172.217.194.0-255,7156,166542,65,202121
3534,0.001698,172.31.40.0-255,66,166608,65,202121
3535,0.001754,172.217.194.0-255,7156,173764,65,202121
3536,0.001768,172.217.194.0-255,2902,176666,65,202121
3537,0.001785,172.31.40.0-255,66,176732,65,202121
3538,0.001826,172.217.194.0-255,1484,178216,65,202121
3539,0.001847,172.217.194.0-255,5738,183954,65,202121
3540,0.001856,172.31.40.0-255,66,184020,65,202121
3541,0.001866,172.217.194.0-255,5738,189758,65,202121
3542,0.001872,172.217.194.0-255,5738,195496,65,202121
3543,0.001886,172.217.194.0-255,5738,201234,65,202121
3544,0.001888,172.31.40.0-255,66,201300,65,202121
3545,0.001926,172.31.40.0-255,66,201366,65,202121
3546,0.001952,172.217.194.0-255,413,201779,65,202121
3547,0.001955,172.217.194.0-255,105,201884,65,202121
3548,0.002003,172.31.40.0-255,66,201950,65,202121
3549,0.004479,172.31.40.0-255,105,202055,65,202121
3550,0.007095,172.217.194.0-255,66,202121,65,202121
3551,0.0,172.217.194.0-255,153,153,65,122196
3552,2.8e-05,172.31.40.0-255,66,219,65,122196
3553,3.6e-05,172.217.194.0-255,1484,1703,65,122196
3554,4.1e-05,172.31.40.0-255,66,1769,65,122196
3555,5.5e-05,172.217.194.0-255,2902,4671,65,122196
3556,5.8e-05,172.31.40.0-255,66,4737,65,122196
3557,6.7e-05,172.217.194.0-255,7156,11893,65,122196
3558,7.1e-05,172.31.40.0-255,66,11959,65,122196
3559,7.4e-05,172.217.194.0-255,1484,13443,65,122196
3560,7.7e-05,172.31.40.0-255,66,13509,65,122196
3561,8.1e-05,172.217.194.0-255,524,14033,65,122196
3562,8.3e-05,172.31.40.0-255,66,14099,65,122196
3563,0.00013,172.217.194.0-255,1484,15583,65,122196
3564,0.000133,172.31.40.0-255,66,15649,65,122196
3565,0.000164,172.217.194.0-255,4320,19969,65,122196
3566,0.000167,172.31.40.0-255,66,20035,65,122196
3567,0.000174,172.217.194.0-255,5738,25773,65,122196
3568,0.000177,172.31.40.0-255,66,25839,65,122196
3569,0.000204,172.217.194.0-255,4320,30159,65,122196
3570,0.00021,172.31.40.0-255,66,30225,65,122196
3571,0.000225,172.31.40.0-255,66,30291,65,122196
3572,0.000229,172.217.194.0-255,2902,33193,65,122196
3573,0.000231,172.31.40.0-255,66,33259,65,122196
3574,0.000264,172.217.194.0-255,3961,37220,65,122196
3575,0.000266,172.31.40.0-255,66,37286,65,122196
3576,0.000271,172.217.194.0-255,2902,40188,65,122196
3577,0.000273,172.31.40.0-255,66,40254,65,122196
3578,0.000291,172.217.194.0-255,1484,41738,65,122196
3579,0.000293,172.31.40.0-255,66,41804,65,122196
3580,0.000312,172.31.40.0-255,66,41870,65,122196
3581,0.000319,172.217.194.0-255,2543,44413,65,122196
3582,0.000321,172.31.40.0-255,66,44479,65,122196
3583,0.000345,172.217.194.0-255,394,44873,65,122196
3584,0.00058,172.217.194.0-255,382,45255,65,122196
3585,0.000721,172.217.194.0-255,1484,46739,65,122196
3586,0.000726,172.31.40.0-255,66,46805,65,122196
3587,0.000732,172.217.194.0-255,2902,49707,65,122196
3588,0.000734,172.31.40.0-255,66,49773,65,122196
3589,0.000762,172.217.194.0-255,5738,55511,65,122196
3590,0.000769,172.31.40.0-255,66,55577,65,122196
3591,0.000815,172.31.40.0-255,66,55643,65,122196
3592,0.000826,172.31.40.0-255,66,55709,65,122196
3593,0.000845,172.217.194.0-255,1125,56834,65,122196
3594,0.001498,172.31.40.0-255,66,56900,65,122196
3595,0.002068,172.217.194.0-255,1484,58384,65,122196
3596,0.002081,172.217.194.0-255,2902,61286,65,122196
3597,0.002086,172.31.40.0-255,66,61352,65,122196
3598,0.002094,172.217.194.0-255,5738,67090,65,122196
3599,0.002097,172.31.40.0-255,66,67156,65,122196
3600,0.002131,172.217.194.0-255,4320,71476,65,122196
3601,0.002133,172.31.40.0-255,66,71542,65,122196
3602,0.002169,172.217.194.0-255,2902,74444,65,122196
3603,0.002171,172.31.40.0-255,66,74510,65,122196
3604,0.004215,172.217.194.0-255,2902,77412,65,122196
3605,0.004221,172.31.40.0-255,66,77478,65,122196
3606,0.004252,172.217.194.0-255,2902,80380,65,122196
3607,0.004254,172.31.40.0-255,66,80446,65,122196
3608,0.006322,172.217.194.0-255,2902,83348,65,122196
3609,0.006329,172.31.40.0-255,66,83414,65,122196
3610,0.006362,172.217.194.0-255,1484,84898,65,122196
3611,0.006376,172.217.194.0-255,1484,86382,65,122196
3612,0.006378,172.31.40.0-255,66,86448,65,122196
3613,0.008437,172.217.194.0-255,2902,89350,65,122196
3614,0.008443,172.31.40.0-255,66,89416,65,122196
3615,0.008473,172.217.194.0-255,2902,92318,65,122196
3616,0.008476,172.31.40.0-255,66,92384,65,122196
3617,0.010514,172.217.194.0-255,2902,95286,65,122196
3618,0.010522,172.31.40.0-255,66,95352,65,122196
3619,0.010556,172.217.194.0-255,2902,98254,65,122196
3620,0.010559,172.31.40.0-255,66,98320,65,122196
3621,0.012614,172.217.194.0-255,2902,101222,65,122196
3622,0.012625,172.31.40.0-255,66,101288,65,122196
3623,0.012643,172.217.194.0-255,1484,102772,65,122196
3624,0.012661,172.217.194.0-255,1484,104256,65,122196
3625,0.012663,172.31.40.0-255,66,104322,65,122196
3626,0.0147,172.217.194.0-255,2902,107224,65,122196
3627,0.014709,172.31.40.0-255,66,107290,65,122196
3628,0.014742,172.217.194.0-255,1484,108774,65,122196
3629,0.014759,172.217.194.0-255,1484,110258,65,122196
3630,0.014762,172.31.40.0-255,66,110324,65,122196
3631,0.016802,172.217.194.0-255,2902,113226,65,122196
3632,0.016818,172.31.40.0-255,66,113292,65,122196
3633,0.016865,172.217.194.0-255,2902,116194,65,122196
3634,0.016869,172.31.40.0-255,66,116260,65,122196
3635,0.018914,172.217.194.0-255,2902,119162,65,122196
3636,0.018928,172.31.40.0-255,66,119228,65,122196
3637,0.018963,172.217.194.0-255,2902,122130,65,122196
3638,0.018966,172.31.40.0-255,66,122196,65,122196
3639,0.0,172.31.40.0-255,105,105,65,459
3640,0.000234,172.31.40.0-255,90,195,65,459
3641,0.000245,172.31.40.0-255,66,261,65,459
3642,0.002728,74.125.68.0-255,66,327,65,459
3643,0.002758,74.125.68.0-255,66,393,65,459
3644,0.00278,172.31.40.0-255,66,459,65,459
3645,0.0,172.253.118.0-255,153,153,65,155328
3646,2.5e-05,172.31.40.0-255,66,219,65,155328
3647,3.2e-05,172.253.118.0-255,1484,1703,65,155328
3648,3.8e-05,172.31.40.0-255,66,1769,65,155328
3649,5.1e-05,172.253.118.0-255,2902,4671,65,155328
3650,5.4e-05,172.31.40.0-255,66,4737,65,155328
3651,6e-05,172.253.118.0-255,4320,9057,65,155328
3652,6.3e-05,172.31.40.0-255,66,9123,65,155328
3653,7.8e-05,172.31.40.0-255,66,9189,65,155328
3654,9e-05,172.31.40.0-255,66,9255,65,155328
3655,0.00028,172.253.118.0-255,1484,10739,65,155328
3656,0.000285,172.31.40.0-255,66,10805,65,155328
3657,0.000292,172.253.118.0-255,2902,13707,65,155328
3658,0.000294,172.31.40.0-255,66,13773,65,155328
3659,0.000306,172.253.118.0-255,5738,19511,65,155328
3660,0.000309,172.31.40.0-255,66,19577,65,155328
3661,0.000334,172.253.118.0-255,4320,23897,65,155328
3662,0.000336,172.31.40.0-255,66,23963,65,155328
3663,0.00037,172.253.118.0-255,3961,27924,65,155328
3664,0.000373,172.31.40.0-255,66,27990,65,155328
3665,0.000384,172.31.40.0-255,66,28056,65,155328
3666,0.000396,172.253.118.0-255,6797,34853,65,155328
3667,0.000399,172.31.40.0-255,66,34919,65,155328
3668,0.000429,172.253.118.0-255,410,35329,65,155328
3669,0.000432,172.31.40.0-255,66,35395,65,155328
3670,0.00057,172.253.118.0-255,332,35727,65,155328
3671,0.000575,172.31.40.0-255,66,35793,65,155328
3672,0.000815,172.253.118.0-255,1484,37277,65,155328
3673,0.00082,172.31.40.0-255,66,37343,65,155328
3674,0.000826,172.253.118.0-255,2902,40245,65,155328
3675,0.000828,172.31.40.0-255,66,40311,65,155328
3676,0.00084,172.253.118.0-255,5738,46049,65,155328
3677,0.000843,172.31.40.0-255,66,46115,65,155328
3678,0.000886,172.253.118.0-255,6797,52912,65,155328
3679,0.000889,172.31.40.0-255,66,52978,65,155328
3680,0.000921,172.253.118.0-255,4320,57298,65,155328
3681,0.000924,172.31.40.0-255,66,57364,65,155328
3682,0.000958,172.253.118.0-255,2902,60266,65,155328
3683,0.000962,172.31.40.0-255,66,60332,65,155328
3684,0.000969,172.253.118.0-255,5738,66070,65,155328
3685,0.000971,172.31.40.0-255,66,66136,65,155328
3686,0.000988,172.253.118.0-255,3961,70097,65,155328
3687,0.000995,172.31.40.0-255,66,70163,65,155328
3688,0.001579,172.253.118.0-255,1484,71647,65,155328
3689,0.001604,172.253.118.0-255,2902,74549,65,155328
3690,0.001608,172.31.40.0-255,66,74615,65,155328
3691,0.001618,172.253.118.0-255,5738,80353,65,155328
3692,0.00162,172.31.40.0-255,66,80419,65,155328
3693,0.001659,172.31.40.0-255,66,80485,65,155328
3694,0.001669,172.31.40.0-255,66,80551,65,155328
3695,0.001704,172.253.118.0-255,2184,82735,65,155328
3696,0.001706,172.31.40.0-255,66,82801,65,155328
3697,0.001866,172.253.118.0-255,1484,84285,65,155328
3698,0.001872,172.253.118.0-255,2902,87187,65,155328
3699,0.001876,172.31.40.0-255,66,87253,65,155328
3700,0.001893,172.253.118.0-255,1484,88737,65,155328
3701,0.001906,172.253.118.0-255,4320,93057,65,155328
3702,0.001909,172.31.40.0-255,66,93123,65,155328
3703,0.001916,172.253.118.0-255,7156,100279,65,155328
3704,0.001918,172.31.40.0-255,66,100345,65,155328
3705,0.001997,172.31.40.0-255,66,100411,65,155328
3706,0.002001,172.253.118.0-255,2184,102595,65,155328
3707,0.002003,172.31.40.0-255,66,102661,65,155328
3708,0.002113,172.253.118.0-255,1484,104145,65,155328
3709,0.002118,172.253.118.0-255,2902,107047,65,155328
3710,0.002121,172.31.40.0-255,66,107113,65,155328
3711,0.002125,172.253.118.0-255,1484,108597,65,155328
3712,0.002149,172.253.118.0-255,4320,112917,65,155328
3713,0.002151,172.31.40.0-255,66,112983,65,155328
3714,0.002162,172.31.40.0-255,66,113049,65,155328
3715,0.002192,172.253.118.0-255,1484,114533,65,155328
3716,0.002206,172.31.40.0-255,66,114599,65,155328
3717,0.004536,172.253.118.0-255,5738,120337,65,155328
3718,0.004544,172.31.40.0-255,66,120403,65,155328
3719,0.006865,172.253.118.0-255,5738,126141,65,155328
3720,0.006872,172.31.40.0-255,66,126207,65,155328
3721,0.009197,172.253.118.0-255,5738,131945,65,155328
3722,0.009204,172.31.40.0-255,66,132011,65,155328
3723,0.011525,172.253.118.0-255,5738,137749,65,155328
3724,0.01153,172.31.40.0-255,66,137815,65,155328
3725,0.013916,172.253.118.0-255,5738,143553,65,155328
3726,0.013925,172.31.40.0-255,66,143619,65,155328
3727,0.016251,172.253.118.0-255,5738,149357,65,155328
3728,0.016259,172.31.40.0-255,66,149423,65,155328
3729,0.018581,172.253.118.0-255,5738,155161,65,155328
3730,0.018591,172.31.40.0-255,66,155227,65,155328
3731,0.01868,172.31.40.0-255,101,155328,65,155328
3732,0.0,172.217.194.0-255,150,150,65,197379
3733,2.1e-05,172.31.40.0-255,66,216,65,197379
3734,2.8e-05,172.217.194.0-255,1484,1700,65,197379
3735,3.2e-05,172.31.40.0-255,66,1766,65,197379
3736,3.7e-05,172.217.194.0-255,2902,4668,65,197379
3737,4e-05,172.31.40.0-255,66,4734,65,197379
3738,5.4e-05,172.217.194.0-255,7156,11890,65,197379
3739,5.8e-05,172.31.40.0-255,66,11956,65,197379
3740,6.2e-05,172.217.194.0-255,2029,13985,65,197379
3741,6.5e-05,172.31.40.0-255,66,14051,65,197379
3742,0.000143,172.217.194.0-255,1484,15535,65,197379
3743,0.000146,172.31.40.0-255,66,15601,65,197379
3744,0.00015,172.217.194.0-255,2902,18503,65,197379
3745,0.000153,172.31.40.0-255,66,18569,65,197379
3746,0.000186,172.217.194.0-255,5738,24307,65,197379
3747,0.000188,172.31.40.0-255,66,24373,65,197379
3748,0.000202,172.217.194.0-255,2902,27275,65,197379
3749,0.000207,172.31.40.0-255,66,27341,65,197379
3750,0.00023,172.217.194.0-255,3961,31302,65,197379
3751,0.000233,172.31.40.0-255,66,31368,65,197379
3752,0.000333,172.217.194.0-255,1484,32852,65,197379
3753,0.000337,172.31.40.0-255,66,32918,65,197379
3754,0.000341,172.217.194.0-255,1484,34402,65,197379
3755,0.000343,172.31.40.0-255,66,34468,65,197379
3756,0.00037,172.217.194.0-255,1484,35952,65,197379
3757,0.000372,172.31.40.0-255,66,36018,65,197379
3758,0.000379,172.217.194.0-255,5738,41756,65,197379
3759,0.000381,172.31.40.0-255,66,41822,65,197379
3760,0.00043,172.31.40.0-255,66,41888,65,197379
3761,0.00046,172.217.194.0-255,5738,47626,65,197379
3762,0.000462,172.31.40.0-255,66,47692,65,197379
3763,0.000488,172.217.194.0-255,5379,53071,65,197379
3764,0.00049,172.31.40.0-255,66,53137,65,197379
3765,0.000599,172.217.194.0-255,648,53785,65,197379
3766,0.0007,172.217.194.0-255,1484,55269,65,197379
3767,0.000703,172.31.40.0-255,66,55335,65,197379
3768,0.000708,172.217.194.0-255,2902,58237,65,197379
3769,0.000711,172.31.40.0-255,66,58303,65,197379
3770,0.000735,172.217.194.0-255,5738,64041,65,197379
3771,0.000738,172.31.40.0-255,66,64107,65,197379
3772,0.000749,172.217.194.0-255,2902,67009,65,197379
3773,0.000752,172.31.40.0-255,66,67075,65,197379
3774,0.00081,172.217.194.0-255,2184,69259,65,197379
3775,0.00082,172.31.40.0-255,66,69325,65,197379
3776,0.000823,172.31.40.0-255,66,69391,65,197379
3777,0.000826,172.31.40.0-255,66,69457,65,197379
3778,0.0009,172.217.194.0-255,1484,70941,65,197379
3779,0.000917,172.217.194.0-255,2902,73843,65,197379
3780,0.00092,172.31.40.0-255,66,73909,65,197379
3781,0.000927,172.217.194.0-255,5738,79647,65,197379
3782,0.000929,172.31.40.0-255,66,79713,65,197379
3783,0.000971,172.31.40.0-255,66,79779,65,197379
3784,0.000983,172.31.40.0-255,66,79845,65,197379
3785,0.001162,172.217.194.0-255,1484,81329,65,197379
3786,0.001168,172.217.194.0-255,2902,84231,65,197379
3787,0.001171,172.31.40.0-255,66,84297,65,197379
3788,0.001176,172.217.194.0-255,2902,87199,65,197379
3789,0.001178,172.31.40.0-255,66,87265,65,197379
3790,0.001198,172.217.194.0-255,2902,90167,65,197379
3791,0.001201,172.31.40.0-255,66,90233,65,197379
3792,0.001216,172.31.40.0-255,66,90299,65,197379
3793,0.001247,172.217.194.0-255,2902,93201,65,197379
3794,0.00125,172.31.40.0-255,66,93267,65,197379
3795,0.001263,172.31.40.0-255,66,93333,65,197379
3796,0.001318,172.217.194.0-255,1484,94817,65,197379
3797,0.001323,172.217.194.0-255,1484,96301,65,197379
3798,0.001325,172.31.40.0-255,66,96367,65,197379
3799,0.001354,172.217.194.0-255,1484,97851,65,197379
3800,0.001361,172.217.194.0-255,5738,103589,65,197379
3801,0.001364,172.31.40.0-255,66,103655,65,197379
3802,0.001391,172.31.40.0-255,66,103721,65,197379
3803,0.001403,172.31.40.0-255,66,103787,65,197379
3804,0.001429,172.217.194.0-255,2902,106689,65,197379
3805,0.001431,172.31.40.0-255,66,106755,65,197379
3806,0.001435,172.217.194.0-255,2184,108939,65,197379
3807,0.001438,172.31.40.0-255,66,109005,65,197379
3808,0.001534,172.217.194.0-255,1484,110489,65,197379
3809,0.00154,172.217.194.0-255,2902,113391,65,197379
3810,0.001543,172.31.40.0-255,66,113457,65,197379
3811,0.00158,172.217.194.0-255,5738,119195,65,197379
3812,0.001583,172.31.40.0-255,66,119261,65,197379
3813,0.001598,172.31.40.0-255,66,119327,65,197379
3814,0.001608,172.31.40.0-255,66,119393,65,197379
3815,0.001637,172.217.194.0-255,2184,121577,65,197379
3816,0.001641,172.31.40.0-255,66,121643,65,197379
3817,0.001706,172.217.194.0-255,1484,123127,65,197379
3818,0.001721,172.217.194.0-255,2902,126029,65,197379
3819,0.001724,172.31.40.0-255,66,126095,65,197379
3820,0.001761,172.217.194.0-255,5738,131833,65,197379
3821,0.001764,172.31.40.0-255,66,131899,65,197379
3822,0.00177,172.217.194.0-255,5738,137637,65,197379
3823,0.001772,172.31.40.0-255,66,137703,65,197379
3824,0.001791,172.217.194.0-255,7156,144859,65,197379
3825,0.001793,172.31.40.0-255,66,144925,65,197379
3826,0.001817,172.217.194.0-255,5738,150663,65,197379
3827,0.00182,172.31.40.0-255,66,150729,65,197379
3828,0.001826,172.217.194.0-255,5020,155749,65,197379
3829,0.001828,172.31.40.0-255,66,155815,65,197379
3830,0.001877,172.217.194.0-255,1484,157299,65,197379
3831,0.001882,172.217.194.0-255,2902,160201,65,197379
3832,0.001886,172.31.40.0-255,66,160267,65,197379
3833,0.001889,172.217.194.0-255,1484,161751,65,197379
3834,0.001904,172.217.194.0-255,4320,166071,65,197379
3835,0.001911,172.31.40.0-255,66,166137,65,197379
3836,0.001924,172.31.40.0-255,66,166203,65,197379
3837,0.001945,172.217.194.0-255,4320,170523,65,197379
3838,0.001947,172.31.40.0-255,66,170589,65,197379
3839,0.001984,172.31.40.0-255,66,170655,65,197379
3840,0.00199,172.217.194.0-255,4320,174975,65,197379
3841,0.001993,172.31.40.0-255,66,175041,65,197379
3842,0.002042,172.31.40.0-255,66,175107,65,197379
3843,0.002053,172.31.40.0-255,66,175173,65,197379
3844,0.002074,172.217.194.0-255,4320,179493,65,197379
3845,0.002077,172.31.40.0-255,66,179559,65,197379
3846,0.002117,172.31.40.0-255,66,179625,65,197379
3847,0.00216,172.217.194.0-255,7156,186781,65,197379
3848,0.002162,172.31.40.0-255,66,186847,65,197379
3849,0.002211,172.31.40.0-255,66,186913,65,197379
3850,0.002217,172.217.194.0-255,5020,191933,65,197379
3851,0.00222,172.31.40.0-255,66,191999,65,197379
3852,0.002244,172.31.40.0-255,66,192065,65,197379
3853,0.00225,172.217.194.0-255,5143,197208,65,197379
3854,0.002252,172.31.40.0-255,66,197274,65,197379
3855,0.002255,172.217.194.0-255,105,197379,65,197379
3856,0.0,172.217.194.0-255,153,153,65,104558
3857,2.3e-05,172.31.40.0-255,66,219,65,104558
3858,3e-05,172.217.194.0-255,1484,1703,65,104558
3859,3.4e-05,172.31.40.0-255,66,1769,65,104558
3860,4e-05,172.217.194.0-255,2902,4671,65,104558
3861,4.4e-05,172.31.40.0-255,66,4737,65,104558
3862,4.9e-05,172.217.194.0-255,2902,7639,65,104558
3863,5.1e-05,172.31.40.0-255,66,7705,65,104558
3864,8.7e-05,172.217.194.0-255,2902,10607,65,104558
3865,9.1e-05,172.31.40.0-255,66,10673,65,104558
3866,0.000109,172.217.194.0-255,3428,14101,65,104558
3867,0.000111,172.31.40.0-255,66,14167,65,104558
3868,0.000374,172.217.194.0-255,1484,15651,65,104558
3869,0.000379,172.31.40.0-255,66,15717,65,104558
3870,0.000385,172.217.194.0-255,2902,18619,65,104558
3871,0.000387,172.31.40.0-255,66,18685,65,104558
3872,0.000394,172.217.194.0-255,5738,24423,65,104558
3873,0.000397,172.31.40.0-255,66,24489,65,104558
3874,0.000448,172.217.194.0-255,2902,27391,65,104558
3875,0.000451,172.31.40.0-255,66,27457,65,104558
3876,0.000474,172.217.194.0-255,3961,31418,65,104558
3877,0.000477,172.31.40.0-255,66,31484,65,104558
3878,0.000494,172.217.194.0-255,7156,38640,65,104558
3879,0.000498,172.31.40.0-255,66,38706,65,104558
3880,0.000516,172.31.40.0-255,66,38772,65,104558
3881,0.000551,172.217.194.0-255,2543,41315,65,104558
3882,0.000554,172.31.40.0-255,66,41381,65,104558
3883,0.000558,172.217.194.0-255,2902,44283,65,104558
3884,0.00056,172.31.40.0-255,66,44349,65,104558
3885,0.000575,172.217.194.0-255,4320,48669,65,104558
3886,0.000578,172.31.40.0-255,66,48735,65,104558
3887,0.000602,172.217.194.0-255,2902,51637,65,104558
3888,0.000605,172.31.40.0-255,66,51703,65,104558
3889,0.000611,172.217.194.0-255,5379,57082,65,104558
3890,0.000613,172.31.40.0-255,66,57148,65,104558
3891,0.00191,172.217.194.0-255,648,57796,65,104558
3892,0.00224,172.217.194.0-255,1484,59280,65,104558
3893,0.002245,172.31.40.0-255,66,59346,65,104558
3894,0.002281,172.217.194.0-255,2902,62248,65,104558
3895,0.002284,172.31.40.0-255,66,62314,65,104558
3896,0.002291,172.217.194.0-255,5738,68052,65,104558
3897,0.002293,172.31.40.0-255,66,68118,65,104558
3898,0.002296,172.217.194.0-255,1484,69602,65,104558
3899,0.002329,172.31.40.0-255,66,69668,65,104558
3900,0.002388,172.31.40.0-255,66,69734,65,104558
3901,0.004999,172.217.194.0-255,5738,75472,65,104558
3902,0.005003,172.31.40.0-255,66,75538,65,104558
3903,0.007639,172.217.194.0-255,5738,81276,65,104558
3904,0.007647,172.31.40.0-255,66,81342,65,104558
3905,0.010308,172.217.194.0-255,5738,87080,65,104558
3906,0.010316,172.31.40.0-255,66,87146,65,104558
3907,0.012958,172.217.194.0-255,5738,92884,65,104558
3908,0.012966,172.31.40.0-255,66,92950,65,104558
3909,0.015613,172.217.194.0-255,5738,98688,65,104558
3910,0.015622,172.31.40.0-255,66,98754,65,104558
3911,0.018248,172.217.194.0-255,5738,104492,65,104558
3912,0.018255,172.31.40.0-255,66,104558,65,104558
3913,0.0,74.125.200.0-255,153,153,65,145292
3914,2.3e-05,172.31.40.0-255,66,219,65,145292
3915,3e-05,74.125.200.0-255,1484,1703,65,145292
3916,3.5e-05,172.31.40.0-255,66,1769,65,145292
3917,4e-05,74.125.200.0-255,2902,4671,65,145292
3918,5.1e-05,172.31.40.0-255,66,4737,65,145292
3919,5.8e-05,74.125.200.0-255,5738,10475,65,145292
3920,6.2e-05,172.31.40.0-255,66,10541,65,145292
3921,9e-05,74.125.200.0-255,3422,13963,65,145292
3922,9.3e-05,172.31.40.0-255,66,14029,65,145292
3923,0.00028,74.125.200.0-255,1484,15513,65,145292
3924,0.000286,172.31.40.0-255,66,15579,65,145292
3925,0.00029,74.125.200.0-255,1484,17063,65,145292
3926,0.000292,172.31.40.0-255,66,17129,65,145292
3927,0.000326,74.125.200.0-255,1484,18613,65,145292
3928,0.000329,172.31.40.0-255,66,18679,65,145292
3929,0.000336,74.125.200.0-255,5738,24417,65,145292
3930,0.000338,172.31.40.0-255,66,24483,65,145292
3931,0.000347,74.125.200.0-255,2902,27385,65,145292
3932,0.000349,172.31.40.0-255,66,27451,65,145292
3933,0.000375,74.125.200.0-255,3961,31412,65,145292
3934,0.000377,172.31.40.0-255,66,31478,65,145292
3935,0.001144,74.125.200.0-255,1484,32962,65,145292
3936,0.00115,172.31.40.0-255,66,33028,65,145292
3937,0.001158,74.125.200.0-255,1484,34512,65,145292
3938,0.00116,172.31.40.0-255,66,34578,65,145292
3939,0.001172,74.125.200.0-255,2902,37480,65,145292
3940,0.001174,172.31.40.0-255,66,37546,65,145292
3941,0.00118,74.125.200.0-255,5738,43284,65,145292
3942,0.001182,172.31.40.0-255,66,43350,65,145292
3943,0.001213,74.125.200.0-255,5379,48729,65,145292
3944,0.001215,172.31.40.0-255,66,48795,65,145292
3945,0.001219,74.125.200.0-255,1484,50279,65,145292
3946,0.001243,74.125.200.0-255,4320,54599,65,145292
3947,0.001246,172.31.40.0-255,66,54665,65,145292
3948,0.001253,74.125.200.0-255,5738,60403,65,145292
3949,0.001255,172.31.40.0-255,66,60469,65,145292
3950,0.001278,74.125.200.0-255,5683,66152,65,145292
3951,0.001282,172.31.40.0-255,66,66218,65,145292
3952,0.0014,74.125.200.0-255,114,66332,65,145292
3953,0.001514,74.125.200.0-255,1484,67816,65,145292
3954,0.001519,172.31.40.0-255,66,67882,65,145292
3955,0.001526,74.125.200.0-255,2902,70784,65,145292
3956,0.001528,172.31.40.0-255,66,70850,65,145292
3957,0.001543,74.125.200.0-255,1484,72334,65,145292
3958,0.001566,74.125.200.0-255,2902,75236,65,145292
3959,0.001569,172.31.40.0-255,66,75302,65,145292
3960,0.001576,74.125.200.0-255,5738,81040,65,145292
3961,0.001578,172.31.40.0-255,66,81106,65,145292
3962,0.001616,172.31.40.0-255,66,81172,65,145292
3963,0.001672,172.31.40.0-255,66,81238,65,145292
3964,0.001807,74.125.200.0-255,334,81572,65,145292
3965,0.002056,74.125.200.0-255,1484,83056,65,145292
3966,0.002059,172.31.40.0-255,66,83122,65,145292
3967,0.002065,74.125.200.0-255,2902,86024,65,145292
3968,0.002068,172.31.40.0-255,66,86090,65,145292
3969,0.002101,74.125.200.0-255,5738,91828,65,145292
3970,0.002104,172.31.40.0-255,66,91894,65,145292
3971,0.002107,74.125.200.0-255,1484,93378,65,145292
3972,0.002111,74.125.200.0-255,2902,96280,65,145292
3973,0.002113,172.31.40.0-255,66,96346,65,145292
3974,0.002124,74.125.200.0-255,5738,102084,65,145292
3975,0.002127,172.31.40.0-255,66,102150,65,145292
3976,0.002163,172.31.40.0-255,66,102216,65,145292
3977,0.002188,74.125.200.0-255,1484,103700,65,145292
3978,0.002202,74.125.200.0-255,2184,105884,65,145292
3979,0.002206,172.31.40.0-255,66,105950,65,145292
3980,0.004465,74.125.200.0-255,1484,107434,65,145292
3981,0.004511,74.125.200.0-255,2902,110336,65,145292
3982,0.004514,172.31.40.0-255,66,110402,65,145292
3983,0.004525,74.125.200.0-255,1484,111886,65,145292
3984,0.006826,74.125.200.0-255,4320,116206,65,145292
3985,0.006833,172.31.40.0-255,66,116272,65,145292
3986,0.009142,74.125.200.0-255,5738,122010,65,145292
3987,0.00915,172.31.40.0-255,66,122076,65,145292
3988,0.011484,74.125.200.0-255,5738,127814,65,145292
3989,0.011493,172.31.40.0-255,66,127880,65,145292
3990,0.013812,74.125.200.0-255,5738,133618,65,145292
3991,0.013824,172.31.40.0-255,66,133684,65,145292
3992,0.016148,74.125.200.0-255,5738,139422,65,145292
3993,0.016159,172.31.40.0-255,66,139488,65,145292
3994,0.018476,74.125.200.0-255,5738,145226,65,145292
3995,0.018485,172.31.40.0-255,66,145292,65,145292
3996,0.0,172.217.194.0-255,154,154,65,155360
3997,2.3e-05,172.31.40.0-255,66,220,65,155360
3998,3e-05,172.217.194.0-255,1484,1704,65,155360
3999,3.4e-05,172.31.40.0-255,66,1770,65,155360
4000,4e-05,172.217.194.0-255,2902,4672,65,155360
4001,5.2e-05,172.31.40.0-255,66,4738,65,155360
4002,5.8e-05,172.217.194.0-255,5738,10476,65,155360
4003,6.1e-05,172.31.40.0-255,66,10542,65,155360
4004,6.6e-05,172.217.194.0-255,3449,13991,65,155360
4005,6.8e-05,172.31.40.0-255,66,14057,65,155360
4006,0.00012,172.31.40.0-255,66,14123,65,155360
4007,0.000126,172.217.194.0-255,5379,19502,65,155360
4008,0.000129,172.31.40.0-255,66,19568,65,155360
4009,0.000183,172.217.194.0-255,1484,21052,65,155360
4010,0.000185,172.31.40.0-255,66,21118,65,155360
4011,0.00019,172.217.194.0-255,2902,24020,65,155360
4012,0.000192,172.31.40.0-255,66,24086,65,155360
4013,0.000225,172.217.194.0-255,5738,29824,65,155360
4014,0.000228,172.31.40.0-255,66,29890,65,155360
4015,0.000238,172.31.40.0-255,66,29956,65,155360
4016,0.000271,172.217.194.0-255,2902,32858,65,155360
4017,0.000273,172.31.40.0-255,66,32924,65,155360
4018,0.000315,172.31.40.0-255,66,32990,65,155360
4019,0.000317,172.217.194.0-255,408,33398,65,155360
4020,0.000319,172.31.40.0-255,66,33464,65,155360
4021,0.000396,172.217.194.0-255,366,33830,65,155360
4022,0.000399,172.31.40.0-255,66,33896,65,155360
4023,0.000714,172.217.194.0-255,1484,35380,65,155360
4024,0.000719,172.31.40.0-255,66,35446,65,155360
4025,0.000726,172.217.194.0-255,2902,38348,65,155360
4026,0.000728,172.31.40.0-255,66,38414,65,155360
4027,0.000732,172.217.194.0-255,2902,41316,65,155360
4028,0.000739,172.31.40.0-255,66,41382,65,155360
4029,0.000774,172.217.194.0-255,2902,44284,65,155360
4030,0.000777,172.31.40.0-255,66,44350,65,155360
4031,0.000792,172.31.40.0-255,66,44416,65,155360
4032,0.000802,172.31.40.0-255,66,44482,65,155360
4033,0.001726,172.217.194.0-255,1484,45966,65,155360
4034,0.001751,172.217.194.0-255,2902,48868,65,155360
4035,0.001755,172.31.40.0-255,66,48934,65,155360
4036,0.001763,172.217.194.0-255,4320,53254,65,155360
4037,0.001765,172.31.40.0-255,66,53320,65,155360
4038,0.001783,172.217.194.0-255,1484,54804,65,155360
4039,0.001795,172.217.194.0-255,5738,60542,65,155360
4040,0.001797,172.31.40.0-255,66,60608,65,155360
4041,0.00182,172.217.194.0-255,7156,67764,65,155360
4042,0.001823,172.31.40.0-255,66,67830,65,155360
4043,0.00183,172.217.194.0-255,5738,73568,65,155360
4044,0.001832,172.31.40.0-255,66,73634,65,155360
4045,0.00186,172.217.194.0-255,5020,78654,65,155360
4046,0.001863,172.31.40.0-255,66,78720,65,155360
4047,0.002007,172.217.194.0-255,1484,80204,65,155360
4048,0.00203,172.217.194.0-255,2902,83106,65,155360
4049,0.002033,172.31.40.0-255,66,83172,65,155360
4050,0.002041,172.217.194.0-255,5738,88910,65,155360
4051,0.002043,172.31.40.0-255,66,88976,65,155360
4052,0.002073,172.217.194.0-255,7156,96132,65,155360
4053,0.002075,172.31.40.0-255,66,96198,65,155360
4054,0.002103,172.217.194.0-255,5738,101936,65,155360
4055,0.002105,172.31.40.0-255,66,102002,65,155360
4056,0.002116,172.31.40.0-255,66,102068,65,155360
4057,0.002197,172.31.40.0-255,66,102134,65,155360
4058,0.002211,172.31.40.0-255,66,102200,65,155360
4059,0.002286,172.217.194.0-255,1484,103684,65,155360
4060,0.00229,172.217.194.0-255,1484,105168,65,155360
4061,0.002293,172.31.40.0-255,66,105234,65,155360
4062,0.002314,172.217.194.0-255,1484,106718,65,155360
4063,0.002322,172.217.194.0-255,5738,112456,65,155360
4064,0.002325,172.31.40.0-255,66,112522,65,155360
4065,0.00233,172.217.194.0-255,2902,115424,65,155360
4066,0.002332,172.31.40.0-255,66,115490,65,155360
4067,0.002335,172.217.194.0-255,1484,116974,65,155360
4068,0.004626,172.217.194.0-255,1484,118458,65,155360
4069,0.004634,172.31.40.0-255,66,118524,65,155360
4070,0.004659,172.217.194.0-255,2902,121426,65,155360
4071,0.004662,172.31.40.0-255,66,121492,65,155360
4072,0.006933,172.217.194.0-255,2902,124394,65,155360
4073,0.00694,172.31.40.0-255,66,124460,65,155360
4074,0.006968,172.217.194.0-255,1484,125944,65,155360
4075,0.006989,172.217.194.0-255,1484,127428,65,155360
4076,0.006992,172.31.40.0-255,66,127494,65,155360
4077,0.009272,172.217.194.0-255,2902,130396,65,155360
4078,0.009276,172.31.40.0-255,66,130462,65,155360
4079,0.009302,172.217.194.0-255,1484,131946,65,155360
4080,0.009319,172.217.194.0-255,1484,133430,65,155360
4081,0.009321,172.31.40.0-255,66,133496,65,155360
4082,0.011601,172.217.194.0-255,4320,137816,65,155360
4083,0.011611,172.31.40.0-255,66,137882,65,155360
4084,0.011639,172.217.194.0-255,1484,139366,65,155360
4085,0.013938,172.217.194.0-255,4320,143686,65,155360
4086,0.013951,172.31.40.0-255,66,143752,65,155360
4087,0.016277,172.217.194.0-255,5738,149490,65,155360
4088,0.016286,172.31.40.0-255,66,149556,65,155360
4089,0.018626,172.217.194.0-255,5738,155294,65,155360
4090,0.01864,172.31.40.0-255,66,155360,65,155360
4091,0.0,172.217.160.0-255,153,153,65,205543
4092,1.4e-05,172.31.40.0-255,66,219,65,205543
4093,2.2e-05,172.217.160.0-255,1484,1703,65,205543
4094,2.6e-05,172.31.40.0-255,66,1769,65,205543
4095,3.2e-05,172.217.160.0-255,2902,4671,65,205543
4096,3.5e-05,172.31.40.0-255,66,4737,65,205543
4097,4.3e-05,172.217.160.0-255,7156,11893,65,205543
4098,4.6e-05,172.31.40.0-255,66,11959,65,205543
4099,7.9e-05,172.217.160.0-255,1958,13917,65,205543
4100,8.1e-05,172.31.40.0-255,66,13983,65,205543
4101,0.000212,172.217.160.0-255,1484,15467,65,205543
4102,0.000216,172.31.40.0-255,66,15533,65,205543
4103,0.00022,172.217.160.0-255,1484,17017,65,205543
4104,0.000222,172.31.40.0-255,66,17083,65,205543
4105,0.000237,172.217.160.0-255,1484,18567,65,205543
4106,0.000239,172.31.40.0-255,66,18633,65,205543
4107,0.000245,172.217.160.0-255,5738,24371,65,205543
4108,0.000247,172.31.40.0-255,66,24437,65,205543
4109,0.00025,172.217.160.0-255,1484,25921,65,205543
4110,0.000251,172.31.40.0-255,66,25987,65,205543
4111,0.000277,172.217.160.0-255,5379,31366,65,205543
4112,0.000279,172.31.40.0-255,66,31432,65,205543
4113,0.000362,172.217.160.0-255,1484,32916,65,205543
4114,0.000366,172.31.40.0-255,66,32982,65,205543
4115,0.00037,172.217.160.0-255,2902,35884,65,205543
4116,0.000372,172.31.40.0-255,66,35950,65,205543
4117,0.000375,172.217.160.0-255,1484,37434,65,205543
4118,0.000376,172.31.40.0-255,66,37500,65,205543
4119,0.000404,172.217.160.0-255,4320,41820,65,205543
4120,0.000407,172.31.40.0-255,66,41886,65,205543
4121,0.00041,172.217.160.0-255,1484,43370,65,205543
4122,0.000411,172.31.40.0-255,66,43436,65,205543
4123,0.000415,172.217.160.0-255,2902,46338,65,205543
4124,0.000417,172.31.40.0-255,66,46404,65,205543
4125,0.000452,172.217.160.0-255,2902,49306,65,205543
4126,0.000455,172.31.40.0-255,66,49372,65,205543
4127,0.000466,172.217.160.0-255,3961,53333,65,205543
4128,0.000468,172.31.40.0-255,66,53399,65,205543
4129,0.000471,172.217.160.0-255,1484,54883,65,205543
4130,0.000497,172.217.160.0-255,5738,60621,65,205543
4131,0.0005,172.31.40.0-255,66,60687,65,205543
4132,0.000517,172.217.160.0-255,2902,63589,65,205543
4133,0.000519,172.31.40.0-255,66,63655,65,205543
4134,0.000536,172.217.160.0-255,2543,66198,65,205543
4135,0.000539,172.31.40.0-255,66,66264,65,205543
4136,0.000541,172.217.160.0-255,337,66601,65,205543
4137,0.001107,172.217.160.0-255,120,66721,65,205543
4138,0.001224,172.217.160.0-255,1484,68205,65,205543
4139,0.001229,172.31.40.0-255,66,68271,65,205543
4140,0.001235,172.217.160.0-255,2902,71173,65,205543
4141,0.001237,172.31.40.0-255,66,71239,65,205543
4142,0.001263,172.217.160.0-255,5738,76977,65,205543
4143,0.001265,172.31.40.0-255,66,77043,65,205543
4144,0.001271,172.217.160.0-255,6797,83840,65,205543
4145,0.001273,172.31.40.0-255,66,83906,65,205543
4146,0.001301,172.217.160.0-255,1484,85390,65,205543
4147,0.001316,172.217.160.0-255,5738,91128,65,205543
4148,0.001318,172.31.40.0-255,66,91194,65,205543
4149,0.001323,172.217.160.0-255,4320,95514,65,205543
4150,0.001325,172.31.40.0-255,66,95580,65,205543
4151,0.001367,172.217.160.0-255,2902,98482,65,205543
4152,0.001369,172.31.40.0-255,66,98548,65,205543
4153,0.001386,172.217.160.0-255,2543,101091,65,205543
4154,0.001388,172.31.40.0-255,66,101157,65,205543
4155,0.001405,172.217.160.0-255,2902,104059,65,205543
4156,0.001407,172.31.40.0-255,66,104125,65,205543
4157,0.00142,172.217.160.0-255,2902,107027,65,205543
4158,0.001422,172.31.40.0-255,66,107093,65,205543
4159,0.001427,172.217.160.0-255,4320,111413,65,205543
4160,0.001429,172.31.40.0-255,66,111479,65,205543
4161,0.001432,172.217.160.0-255,1484,112963,65,205543
4162,0.001466,172.31.40.0-255,66,113029,65,205543
4163,0.001468,172.217.160.0-255,1484,114513,65,205543
4164,0.001495,172.31.40.0-255,66,114579,65,205543
4165,0.001648,172.217.160.0-255,1484,116063,65,205543
4166,0.001651,172.217.160.0-255,1484,117547,65,205543
4167,0.001653,172.31.40.0-255,66,117613,65,205543
4168,0.00167,172.217.160.0-255,1484,119097,65,205543
4169,0.001676,172.217.160.0-255,5738,124835,65,205543
4170,0.001678,172.31.40.0-255,66,124901,65,205543
4171,0.001681,172.217.160.0-255,1484,126385,65,205543
4172,0.001704,172.31.40.0-255,66,126451,65,205543
4173,0.001708,172.217.160.0-255,2902,129353,65,205543
4174,0.001711,172.31.40.0-255,66,129419,65,205543
4175,0.001732,172.217.160.0-255,4320,133739,65,205543
4176,0.001734,172.31.40.0-255,66,133805,65,205543
4177,0.001752,172.217.160.0-255,3339,137144,65,205543
4178,0.001754,172.31.40.0-255,66,137210,65,205543
4179,0.001794,172.217.160.0-255,1484,138694,65,205543
4180,0.001812,172.217.160.0-255,1484,140178,65,205543
4181,0.001814,172.31.40.0-255,66,140244,65,205543
4182,0.001819,172.217.160.0-255,4320,144564,65,205543
4183,0.001821,172.31.40.0-255,66,144630,65,205543
4184,0.001827,172.217.160.0-255,7156,151786,65,205543
4185,0.001829,172.31.40.0-255,66,151852,65,205543
4186,0.001846,172.217.160.0-255,1484,153336,65,205543
4187,0.001849,172.217.160.0-255,1125,154461,65,205543
4188,0.00185,172.31.40.0-255,66,154527,65,205543
4189,0.003761,172.217.160.0-255,2902,157429,65,205543
4190,0.003768,172.31.40.0-255,66,157495,65,205543
4191,0.003791,172.217.160.0-255,2902,160397,65,205543
4192,0.003793,172.31.40.0-255,66,160463,65,205543
4193,0.005729,172.217.160.0-255,4320,164783,65,205543
4194,0.005735,172.31.40.0-255,66,164849,65,205543
4195,0.005752,172.217.160.0-255,1484,166333,65,205543
4196,0.007678,172.217.160.0-255,4320,170653,65,205543
4197,0.007685,172.31.40.0-255,66,170719,65,205543
4198,0.009624,172.217.160.0-255,5738,176457,65,205543
4199,0.009631,172.31.40.0-255,66,176523,65,205543
4200,0.011585,172.217.160.0-255,5738,182261,65,205543
4201,0.011592,172.31.40.0-255,66,182327,65,205543
4202,0.013521,172.217.160.0-255,5738,188065,65,205543
4203,0.013527,172.31.40.0-255,66,188131,65,205543
4204,0.015462,172.217.160.0-255,5738,193869,65,205543
4205,0.01547,172.31.40.0-255,66,193935,65,205543
4206,0.017409,172.217.160.0-255,5738,199673,65,205543
4207,0.017416,172.31.40.0-255,66,199739,65,205543
4208,0.019353,172.217.160.0-255,5738,205477,65,205543
4209,0.01936,172.31.40.0-255,66,205543,65,205543
4210,0.0,74.125.24.0-255,156,156,65,98247
4211,2.5e-05,172.31.40.0-255,66,222,65,98247
4212,3.2e-05,74.125.24.0-255,1484,1706,65,98247
4213,3.8e-05,172.31.40.0-255,66,1772,65,98247
4214,5.5e-05,74.125.24.0-255,2902,4674,65,98247
4215,5.9e-05,172.31.40.0-255,66,4740,65,98247
4216,6.3e-05,74.125.24.0-255,1484,6224,65,98247
4217,6.6e-05,172.31.40.0-255,66,6290,65,98247
4218,7.3e-05,74.125.24.0-255,5738,12028,65,98247
4219,7.6e-05,172.31.40.0-255,66,12094,65,98247
4220,0.000103,74.125.24.0-255,2103,14197,65,98247
4221,0.000106,172.31.40.0-255,66,14263,65,98247
4222,0.000173,74.125.24.0-255,1484,15747,65,98247
4223,0.000177,172.31.40.0-255,66,15813,65,98247
4224,0.000199,74.125.24.0-255,1484,17297,65,98247
4225,0.000202,172.31.40.0-255,66,17363,65,98247
4226,0.000208,74.125.24.0-255,4320,21683,65,98247
4227,0.000211,172.31.40.0-255,66,21749,65,98247
4228,0.000222,172.31.40.0-255,66,21815,65,98247
4229,0.000225,74.125.24.0-255,1125,22940,65,98247
4230,0.000227,172.31.40.0-255,66,23006,65,98247
4231,0.000375,74.125.24.0-255,1484,24490,65,98247
4232,0.000378,172.31.40.0-255,66,24556,65,98247
4233,0.000384,74.125.24.0-255,2902,27458,65,98247
4234,0.000387,172.31.40.0-255,66,27524,65,98247
4235,0.000398,74.125.24.0-255,5738,33262,65,98247
4236,0.000401,172.31.40.0-255,66,33328,65,98247
4237,0.000435,172.31.40.0-255,66,33394,65,98247
4238,0.000456,74.125.24.0-255,2543,35937,65,98247
4239,0.000459,172.31.40.0-255,66,36003,65,98247
4240,0.000471,172.31.40.0-255,66,36069,65,98247
4241,0.000474,74.125.24.0-255,397,36466,65,98247
4242,0.000503,74.125.24.0-255,112,36578,65,98247
4243,0.000507,74.125.24.0-255,331,36909,65,98247
4244,0.000869,74.125.24.0-255,1484,38393,65,98247
4245,0.000873,172.31.40.0-255,66,38459,65,98247
4246,0.00088,74.125.24.0-255,2902,41361,65,98247
4247,0.000882,172.31.40.0-255,66,41427,65,98247
4248,0.000927,74.125.24.0-255,1484,42911,65,98247
4249,0.000946,74.125.24.0-255,4320,47231,65,98247
4250,0.000948,172.31.40.0-255,66,47297,65,98247
4251,0.000954,74.125.24.0-255,4320,51617,65,98247
4252,0.000957,172.31.40.0-255,66,51683,65,98247
4253,0.000969,172.31.40.0-255,66,51749,65,98247
4254,0.00098,172.31.40.0-255,66,51815,65,98247
4255,0.003257,74.125.24.0-255,5738,57553,65,98247
4256,0.003264,172.31.40.0-255,66,57619,65,98247
4257,0.005545,74.125.24.0-255,5738,63357,65,98247
4258,0.005552,172.31.40.0-255,66,63423,65,98247
4259,0.007866,74.125.24.0-255,5738,69161,65,98247
4260,0.00787,172.31.40.0-255,66,69227,65,98247
4261,0.010132,74.125.24.0-255,5738,74965,65,98247
4262,0.01014,172.31.40.0-255,66,75031,65,98247
4263,0.012405,74.125.24.0-255,5738,80769,65,98247
4264,0.012412,172.31.40.0-255,66,80835,65,98247
4265,0.014726,74.125.24.0-255,5738,86573,65,98247
4266,0.014734,172.31.40.0-255,66,86639,65,98247
4267,0.017043,74.125.24.0-255,5738,92377,65,98247
4268,0.017051,172.31.40.0-255,66,92443,65,98247
4269,0.019342,74.125.24.0-255,5738,98181,65,98247
4270,0.019351,172.31.40.0-255,66,98247,65,98247
4271,0.0,172.217.194.0-255,153,153,65,186501
4272,2.2e-05,172.31.40.0-255,66,219,65,186501
4273,3e-05,172.217.194.0-255,1484,1703,65,186501
4274,3.4e-05,172.31.40.0-255,66,1769,65,186501
4275,4.7e-05,172.217.194.0-255,2902,4671,65,186501
4276,5e-05,172.31.40.0-255,66,4737,65,186501
4277,5.8e-05,172.217.194.0-255,7156,11893,65,186501
4278,6.1e-05,172.31.40.0-255,66,11959,65,186501
4279,6.9e-05,172.217.194.0-255,7156,19115,65,186501
4280,7.2e-05,172.31.40.0-255,66,19181,65,186501
4281,0.000119,172.31.40.0-255,66,19247,65,186501
4282,0.000123,172.217.194.0-255,2543,21790,65,186501
4283,0.000126,172.31.40.0-255,66,21856,65,186501
4284,0.000269,172.217.194.0-255,1484,23340,65,186501
4285,0.000274,172.31.40.0-255,66,23406,65,186501
4286,0.00028,172.217.194.0-255,2902,26308,65,186501
4287,0.000282,172.31.40.0-255,66,26374,65,186501
4288,0.000299,172.217.194.0-255,1484,27858,65,186501
4289,0.000302,172.31.40.0-255,66,27924,65,186501
4290,0.000329,172.217.194.0-255,4320,32244,65,186501
4291,0.000332,172.31.40.0-255,66,32310,65,186501
4292,0.000337,172.217.194.0-255,4320,36630,65,186501
4293,0.000339,172.31.40.0-255,66,36696,65,186501
4294,0.000343,172.217.194.0-255,2902,39598,65,186501
4295,0.000346,172.31.40.0-255,66,39664,65,186501
4296,0.000382,172.31.40.0-255,66,39730,65,186501
4297,0.00039,172.217.194.0-255,6797,46527,65,186501
4298,0.000393,172.31.40.0-255,66,46593,65,186501
4299,0.000421,172.217.194.0-255,338,46931,65,186501
4300,0.000423,172.31.40.0-255,66,46997,65,186501
4301,0.000491,172.217.194.0-255,1484,48481,65,186501
4302,0.000497,172.217.194.0-255,2902,51383,65,186501
4303,0.0005,172.31.40.0-255,66,51449,65,186501
4304,0.000532,172.217.194.0-255,5738,57187,65,186501
4305,0.000534,172.31.40.0-255,66,57253,65,186501
4306,0.000576,172.217.194.0-255,6797,64050,65,186501
4307,0.000579,172.31.40.0-255,66,64116,65,186501
4308,0.000611,172.217.194.0-255,7156,71272,65,186501
4309,0.000616,172.31.40.0-255,66,71338,65,186501
4310,0.00064,172.217.194.0-255,7156,78494,65,186501
4311,0.000643,172.31.40.0-255,66,78560,65,186501
4312,0.000679,172.31.40.0-255,66,78626,65,186501
4313,0.000708,172.217.194.0-255,6556,85182,65,186501
4314,0.000711,172.31.40.0-255,66,85248,65,186501
4315,0.000715,172.217.194.0-255,2529,87777,65,186501
4316,0.000718,172.31.40.0-255,66,87843,65,186501
4317,0.000765,172.217.194.0-255,1484,89327,65,186501
4318,0.00077,172.217.194.0-255,2902,92229,65,186501
4319,0.000773,172.31.40.0-255,66,92295,65,186501
4320,0.000788,172.217.194.0-255,2902,95197,65,186501
4321,0.000791,172.31.40.0-255,66,95263,65,186501
4322,0.000811,172.217.194.0-255,2902,98165,65,186501
4323,0.000815,172.31.40.0-255,66,98231,65,186501
4324,0.000833,172.31.40.0-255,66,98297,65,186501
4325,0.000848,172.31.40.0-255,66,98363,65,186501
4326,0.00087,172.217.194.0-255,2184,100547,65,186501
4327,0.000873,172.31.40.0-255,66,100613,65,186501
4328,0.001433,172.217.194.0-255,1484,102097,65,186501
4329,0.00144,172.217.194.0-255,2902,104999,65,186501
4330,0.001445,172.31.40.0-255,66,105065,65,186501
4331,0.00145,172.217.194.0-255,1484,106549,65,186501
4332,0.001485,172.217.194.0-255,4320,110869,65,186501
4333,0.001488,172.31.40.0-255,66,110935,65,186501
4334,0.001496,172.217.194.0-255,7156,118091,65,186501
4335,0.001498,172.31.40.0-255,66,118157,65,186501
4336,0.001574,172.217.194.0-255,1484,119641,65,186501
4337,0.001578,172.217.194.0-255,2184,121825,65,186501
4338,0.001981,172.217.194.0-255,1484,123309,65,186501
4339,0.001989,172.217.194.0-255,2902,126211,65,186501
4340,0.002011,172.217.194.0-255,4320,130531,65,186501
4341,0.002063,172.217.194.0-255,4320,134851,65,186501
4342,0.002306,172.217.194.0-255,1484,136335,65,186501
4343,0.002313,172.217.194.0-255,2902,139237,65,186501
4344,0.002335,172.217.194.0-255,5738,144975,65,186501
4345,0.002375,172.217.194.0-255,4320,149295,65,186501
4346,0.002396,172.217.194.0-255,766,150061,65,186501
4347,0.002457,172.217.194.0-255,1484,151545,65,186501
4348,0.002466,172.217.194.0-255,1484,153029,65,186501
4349,0.002485,172.217.194.0-255,1484,154513,65,186501
4350,0.002491,172.217.194.0-255,5738,160251,65,186501
4351,0.002495,172.217.194.0-255,1484,161735,65,186501
4352,0.002584,172.217.194.0-255,1484,163219,65,186501
4353,0.009499,172.31.40.0-255,66,163285,65,186501
4354,0.012071,172.217.194.0-255,5738,169023,65,186501
4355,0.012084,172.31.40.0-255,66,169089,65,186501
4356,0.014645,172.217.194.0-255,5738,174827,65,186501
4357,0.014665,172.31.40.0-255,66,174893,65,186501
4358,0.017231,172.217.194.0-255,5738,180631,65,186501
4359,0.017238,172.31.40.0-255,66,180697,65,186501
4360,0.019855,172.217.194.0-255,5738,186435,65,186501
4361,0.019871,172.31.40.0-255,66,186501,65,186501
4362,0.0,172.217.194.0-255,150,150,65,237395
4363,1.8e-05,172.31.40.0-255,66,216,65,237395
4364,2.4e-05,172.217.194.0-255,1484,1700,65,237395
4365,2.9e-05,172.31.40.0-255,66,1766,65,237395
4366,3.4e-05,172.217.194.0-255,2902,4668,65,237395
4367,4.3e-05,172.31.40.0-255,66,4734,65,237395
4368,5e-05,172.217.194.0-255,7156,11890,65,237395
4369,5.3e-05,172.31.40.0-255,66,11956,65,237395
4370,8.8e-05,172.217.194.0-255,2029,13985,65,237395
4371,9.1e-05,172.31.40.0-255,66,14051,65,237395
4372,9.5e-05,172.217.194.0-255,2902,16953,65,237395
4373,9.7e-05,172.31.40.0-255,66,17019,65,237395
4374,0.000128,172.217.194.0-255,7156,24175,65,237395
4375,0.000131,172.31.40.0-255,66,24241,65,237395
4376,0.000135,172.217.194.0-255,2902,27143,65,237395
4377,0.000137,172.31.40.0-255,66,27209,65,237395
4378,0.000161,172.217.194.0-255,3961,31170,65,237395
4379,0.000163,172.31.40.0-255,66,31236,65,237395
4380,0.000191,172.217.194.0-255,2902,34138,65,237395
4381,0.000193,172.31.40.0-255,66,34204,65,237395
4382,0.000198,172.217.194.0-255,4320,38524,65,237395
4383,0.0002,172.31.40.0-255,66,38590,65,237395
4384,0.00021,172.31.40.0-255,66,38656,65,237395
4385,0.000257,172.217.194.0-255,1125,39781,65,237395
4386,0.00026,172.31.40.0-255,66,39847,65,237395
4387,0.000371,172.217.194.0-255,1484,41331,65,237395
4388,0.000375,172.31.40.0-255,66,41397,65,237395
4389,0.00038,172.217.194.0-255,2902,44299,65,237395
4390,0.000382,172.31.40.0-255,66,44365,65,237395
4391,0.000385,172.217.194.0-255,1484,45849,65,237395
4392,0.000386,172.31.40.0-255,66,45915,65,237395
4393,0.000422,172.217.194.0-255,4320,50235,65,237395
4394,0.000425,172.31.40.0-255,66,50301,65,237395
4395,0.00043,172.217.194.0-255,5738,56039,65,237395
4396,0.000432,172.31.40.0-255,66,56105,65,237395
4397,0.000452,172.217.194.0-255,1424,57529,65,237395
4398,0.000475,172.217.194.0-255,378,57907,65,237395
4399,0.000477,172.31.40.0-255,66,57973,65,237395
4400,0.000712,172.217.194.0-255,1484,59457,65,237395
4401,0.000718,172.217.194.0-255,2902,62359,65,237395
4402,0.000722,172.31.40.0-255,66,62425,65,237395
4403,0.000754,172.217.194.0-255,5738,68163,65,237395
4404,0.000757,172.31.40.0-255,66,68229,65,237395
4405,0.000765,172.217.194.0-255,6797,75026,65,237395
4406,0.000767,172.31.40.0-255,66,75092,65,237395
4407,0.000816,172.217.194.0-255,7156,82248,65,237395
4408,0.000819,172.31.40.0-255,66,82314,65,237395
4409,0.000827,172.217.194.0-255,7156,89470,65,237395
4410,0.000829,172.31.40.0-255,66,89536,65,237395
4411,0.000857,172.217.194.0-255,2543,92079,65,237395
4412,0.000859,172.31.40.0-255,66,92145,65,237395
4413,0.001074,172.217.194.0-255,1484,93629,65,237395
4414,0.001079,172.217.194.0-255,2902,96531,65,237395
4415,0.001085,172.31.40.0-255,66,96597,65,237395
4416,0.001098,172.217.194.0-255,4320,100917,65,237395
4417,0.0011,172.31.40.0-255,66,100983,65,237395
4418,0.001127,172.217.194.0-255,1484,102467,65,237395
4419,0.001141,172.31.40.0-255,66,102533,65,237395
4420,0.001154,172.31.40.0-255,66,102599,65,237395
4421,0.001362,172.217.194.0-255,1484,104083,65,237395
4422,0.001368,172.217.194.0-255,2902,106985,65,237395
4423,0.001371,172.31.40.0-255,66,107051,65,237395
4424,0.001406,172.217.194.0-255,5738,112789,65,237395
4425,0.001411,172.217.194.0-255,5738,118527,65,237395
4426,0.001416,172.31.40.0-255,66,118593,65,237395
4427,0.001423,172.31.40.0-255,66,118659,65,237395
4428,0.001443,172.31.40.0-255,66,118725,65,237395
4429,0.001477,172.217.194.0-255,2902,121627,65,237395
4430,0.001481,172.31.40.0-255,66,121693,65,237395
4431,0.001492,172.217.194.0-255,2184,123877,65,237395
4432,0.001495,172.31.40.0-255,66,123943,65,237395
4433,0.001638,172.217.194.0-255,1484,125427,65,237395
4434,0.001644,172.217.194.0-255,2902,128329,65,237395
4435,0.001647,172.31.40.0-255,66,128395,65,237395
4436,0.001675,172.217.194.0-255,5738,134133,65,237395
4437,0.001678,172.31.40.0-255,66,134199,65,237395
4438,0.001716,172.31.40.0-255,66,134265,65,237395
4439,0.001723,172.217.194.0-255,7156,141421,65,237395
4440,0.001726,172.31.40.0-255,66,141487,65,237395
4441,0.001773,172.217.194.0-255,3602,145089,65,237395
4442,0.001776,172.31.40.0-255,66,145155,65,237395
4443,0.001837,172.217.194.0-255,1484,146639,65,237395
4444,0.001857,172.217.194.0-255,2902,149541,65,237395
4445,0.001861,172.31.40.0-255,66,149607,65,237395
4446,0.001868,172.217.194.0-255,5738,155345,65,237395
4447,0.00187,172.31.40.0-255,66,155411,65,237395
4448,0.001901,172.217.194.0-255,5738,161149,65,237395
4449,0.001904,172.31.40.0-255,66,161215,65,237395
4450,0.001932,172.217.194.0-255,7156,168371,65,237395
4451,0.001935,172.31.40.0-255,66,168437,65,237395
4452,0.001947,172.31.40.0-255,66,168503,65,237395
4453,0.001954,172.217.194.0-255,766,169269,65,237395
4454,0.002032,172.217.194.0-255,1484,170753,65,237395
4455,0.002035,172.31.40.0-255,66,170819,65,237395
4456,0.002041,172.217.194.0-255,2902,173721,65,237395
4457,0.002043,172.31.40.0-255,66,173787,65,237395
4458,0.002074,172.217.194.0-255,5738,179525,65,237395
4459,0.002076,172.31.40.0-255,66,179591,65,237395
4460,0.002088,172.217.194.0-255,5738,185329,65,237395
4461,0.00209,172.31.40.0-255,66,185395,65,237395
4462,0.002108,172.31.40.0-255,66,185461,65,237395
4463,0.002141,172.217.194.0-255,5020,190481,65,237395
4464,0.002148,172.31.40.0-255,66,190547,65,237395
4465,0.002189,172.217.194.0-255,1484,192031,65,237395
4466,0.002192,172.217.194.0-255,1484,193515,65,237395
4467,0.002195,172.31.40.0-255,66,193581,65,237395
4468,0.002226,172.217.194.0-255,1484,195065,65,237395
4469,0.002233,172.217.194.0-255,5738,200803,65,237395
4470,0.002236,172.31.40.0-255,66,200869,65,237395
4471,0.002244,172.217.194.0-255,7156,208025,65,237395
4472,0.002246,172.31.40.0-255,66,208091,65,237395
4473,0.002251,172.217.194.0-255,2902,210993,65,237395
4474,0.002257,172.31.40.0-255,66,211059,65,237395
4475,0.002292,172.31.40.0-255,66,211125,65,237395
4476,0.002297,172.217.194.0-255,2184,213309,65,237395
4477,0.002304,172.31.40.0-255,66,213375,65,237395
4478,0.00233,172.217.194.0-255,2902,216277,65,237395
4479,0.002332,172.31.40.0-255,66,216343,65,237395
4480,0.002342,172.217.194.0-255,4320,220663,65,237395
4481,0.002345,172.31.40.0-255,66,220729,65,237395
4482,0.002369,172.217.194.0-255,5738,226467,65,237395
4483,0.002372,172.31.40.0-255,66,226533,65,237395
4484,0.002404,172.217.194.0-255,2902,229435,65,237395
4485,0.002406,172.31.40.0-255,66,229501,65,237395
4486,0.002429,172.31.40.0-255,66,229567,65,237395
4487,0.002473,172.31.40.0-255,66,229633,65,237395
4488,0.002509,172.217.194.0-255,7156,236789,65,237395
4489,0.002512,172.31.40.0-255,66,236855,65,237395
4490,0.002524,172.31.40.0-255,66,236921,65,237395
4491,0.002551,172.31.40.0-255,66,236987,65,237395
4492,0.002565,172.31.40.0-255,66,237053,65,237395
4493,0.005007,172.217.194.0-255,105,237158,65,237395
4494,0.008595,172.31.40.0-255,66,237224,65,237395
4495,0.008638,172.31.40.0-255,105,237329,65,237395
4496,0.011123,172.217.194.0-255,66,237395,65,237395
4497,0.0,172.31.40.0-255,105,105,65,459
4498,0.000231,172.31.40.0-255,90,195,65,459
4499,0.00024,172.31.40.0-255,66,261,65,459
4500,0.002871,172.217.194.0-255,66,327,65,459
4501,0.002888,172.217.194.0-255,66,393,65,459
4502,0.0029,172.31.40.0-255,66,459,65,459
4503,0.0,172.217.194.0-255,152,152,65,210890
4504,2.1e-05,172.31.40.0-255,66,218,65,210890
4505,2.8e-05,172.217.194.0-255,1484,1702,65,210890
4506,3.3e-05,172.31.40.0-255,66,1768,65,210890
4507,3.8e-05,172.217.194.0-255,2902,4670,65,210890
4508,4.2e-05,172.31.40.0-255,66,4736,65,210890
4509,5e-05,172.217.194.0-255,7156,11892,65,210890
4510,5.3e-05,172.31.40.0-255,66,11958,65,210890
4511,5.8e-05,172.217.194.0-255,2029,13987,65,210890
4512,6.1e-05,172.31.40.0-255,66,14053,65,210890
4513,0.000109,172.217.194.0-255,1484,15537,65,210890
4514,0.000111,172.31.40.0-255,66,15603,65,210890
4515,0.000116,172.217.194.0-255,2902,18505,65,210890
4516,0.000119,172.31.40.0-255,66,18571,65,210890
4517,0.000125,172.217.194.0-255,5738,24309,65,210890
4518,0.000127,172.31.40.0-255,66,24375,65,210890
4519,0.000152,172.217.194.0-255,6797,31172,65,210890
4520,0.000155,172.31.40.0-255,66,31238,65,210890
4521,0.000231,172.217.194.0-255,1484,32722,65,210890
4522,0.000234,172.31.40.0-255,66,32788,65,210890
4523,0.000239,172.217.194.0-255,2902,35690,65,210890
4524,0.000241,172.31.40.0-255,66,35756,65,210890
4525,0.000245,172.217.194.0-255,1484,37240,65,210890
4526,0.000247,172.31.40.0-255,66,37306,65,210890
4527,0.000275,172.217.194.0-255,1484,38790,65,210890
4528,0.000277,172.31.40.0-255,66,38856,65,210890
4529,0.000283,172.217.194.0-255,4320,43176,65,210890
4530,0.000285,172.31.40.0-255,66,43242,65,210890
4531,0.00029,172.217.194.0-255,4320,47562,65,210890
4532,0.000292,172.31.40.0-255,66,47628,65,210890
4533,0.000319,172.217.194.0-255,5379,53007,65,210890
4534,0.000322,172.31.40.0-255,66,53073,65,210890
4535,0.000329,172.217.194.0-255,7156,60229,65,210890
4536,0.000331,172.31.40.0-255,66,60295,65,210890
4537,0.000358,172.217.194.0-255,4320,64615,65,210890
4538,0.00036,172.31.40.0-255,66,64681,65,210890
4539,0.000379,172.217.194.0-255,1125,65806,65,210890
4540,0.000432,172.217.194.0-255,379,66185,65,210890
4541,0.000487,172.217.194.0-255,365,66550,65,210890
4542,0.00049,172.31.40.0-255,66,66616,65,210890
4543,0.000643,172.217.194.0-255,1484,68100,65,210890
4544,0.000649,172.217.194.0-255,2902,71002,65,210890
4545,0.000659,172.31.40.0-255,66,71068,65,210890
4546,0.000665,172.217.194.0-255,4320,75388,65,210890
4547,0.000667,172.31.40.0-255,66,75454,65,210890
4548,0.000685,172.217.194.0-255,5738,81192,65,210890
4549,0.000688,172.31.40.0-255,66,81258,65,210890
4550,0.00071,172.217.194.0-255,2902,84160,65,210890
4551,0.000712,172.31.40.0-255,66,84226,65,210890
4552,0.000717,172.217.194.0-255,2902,87128,65,210890
4553,0.00072,172.31.40.0-255,66,87194,65,210890
4554,0.000738,172.31.40.0-255,66,87260,65,210890
4555,0.000753,172.217.194.0-255,4320,91580,65,210890
4556,0.000755,172.31.40.0-255,66,91646,65,210890
4557,0.000758,172.217.194.0-255,766,92412,65,210890
4558,0.001195,172.217.194.0-255,1484,93896,65,210890
4559,0.001199,172.217.194.0-255,1484,95380,65,210890
4560,0.00121,172.31.40.0-255,66,95446,65,210890
4561,0.001215,172.217.194.0-255,1484,96930,65,210890
4562,0.001217,172.31.40.0-255,66,96996,65,210890
4563,0.001232,172.217.194.0-255,4320,101316,65,210890
4564,0.001235,172.31.40.0-255,66,101382,65,210890
4565,0.001259,172.217.194.0-255,1484,102866,65,210890
4566,0.001275,172.217.194.0-255,2902,105768,65,210890
4567,0.001278,172.31.40.0-255,66,105834,65,210890
4568,0.001304,172.217.194.0-255,5738,111572,65,210890
4569,0.001307,172.31.40.0-255,66,111638,65,210890
4570,0.001318,172.31.40.0-255,66,111704,65,210890
4571,0.001321,172.217.194.0-255,1484,113188,65,210890
4572,0.001341,172.217.194.0-255,3602,116790,65,210890
4573,0.001343,172.31.40.0-255,66,116856,65,210890
4574,0.001914,172.217.194.0-255,1484,118340,65,210890
4575,0.001924,172.217.194.0-255,2902,121242,65,210890
4576,0.001928,172.31.40.0-255,66,121308,65,210890
4577,0.001935,172.217.194.0-255,5738,127046,65,210890
4578,0.001937,172.31.40.0-255,66,127112,65,210890
4579,0.001968,172.31.40.0-255,66,127178,65,210890
4580,0.001984,172.217.194.0-255,1484,128662,65,210890
4581,0.001987,172.217.194.0-255,1484,130146,65,210890
4582,0.001989,172.31.40.0-255,66,130212,65,210890
4583,0.002023,172.31.40.0-255,66,130278,65,210890
4584,0.002053,172.217.194.0-255,1484,131762,65,210890
4585,0.002057,172.217.194.0-255,1484,133246,65,210890
4586,0.00206,172.31.40.0-255,66,133312,65,210890
4587,0.002074,172.217.194.0-255,1484,134796,65,210890
4588,0.00208,172.217.194.0-255,4320,139116,65,210890
4589,0.002082,172.31.40.0-255,66,139182,65,210890
4590,0.002102,172.217.194.0-255,1484,140666,65,210890
4591,0.002109,172.217.194.0-255,7156,147822,65,210890
4592,0.002111,172.31.40.0-255,66,147888,65,210890
4593,0.002114,172.217.194.0-255,1484,149372,65,210890
4594,0.002151,172.31.40.0-255,66,149438,65,210890
4595,0.002156,172.217.194.0-255,2184,151622,65,210890
4596,0.002157,172.31.40.0-255,66,151688,65,210890
4597,0.002206,172.217.194.0-255,1484,153172,65,210890
4598,0.002211,172.217.194.0-255,2902,156074,65,210890
4599,0.002213,172.31.40.0-255,66,156140,65,210890
4600,0.00222,172.217.194.0-255,5738,161878,65,210890
4601,0.002222,172.31.40.0-255,66,161944,65,210890
4602,0.002253,172.31.40.0-255,66,162010,65,210890
4603,0.002256,172.217.194.0-255,1484,163494,65,210890
4604,0.002276,172.217.194.0-255,5738,169232,65,210890
4605,0.002278,172.31.40.0-255,66,169298,65,210890
4606,0.002303,172.217.194.0-255,3602,172900,65,210890
4607,0.002305,172.31.40.0-255,66,172966,65,210890
4608,0.004543,172.217.194.0-255,4320,177286,65,210890
4609,0.004551,172.31.40.0-255,66,177352,65,210890
4610,0.004569,172.217.194.0-255,1484,178836,65,210890
4611,0.006806,172.217.194.0-255,2902,181738,65,210890
4612,0.00681,172.31.40.0-255,66,181804,65,210890
4613,0.006827,172.217.194.0-255,1484,183288,65,210890
4614,0.00906,172.217.194.0-255,4320,187608,65,210890
4615,0.009066,172.31.40.0-255,66,187674,65,210890
4616,0.01134,172.217.194.0-255,5738,193412,65,210890
4617,0.011356,172.31.40.0-255,66,193478,65,210890
4618,0.013621,172.217.194.0-255,5738,199216,65,210890
4619,0.013634,172.31.40.0-255,66,199282,65,210890
4620,0.015931,172.217.194.0-255,5738,205020,65,210890
4621,0.015946,172.31.40.0-255,66,205086,65,210890
4622,0.018211,172.217.194.0-255,5738,210824,65,210890
4623,0.018226,172.31.40.0-255,66,210890,65,210890
4624,0.0,74.125.24.0-255,143,143,65,283283
4625,2.1e-05,172.31.40.0-255,66,209,65,283283
4626,2.8e-05,74.125.24.0-255,1484,1693,65,283283
4627,3.3e-05,172.31.40.0-255,66,1759,65,283283
4628,3.9e-05,74.125.24.0-255,2902,4661,65,283283
4629,4.3e-05,172.31.40.0-255,66,4727,65,283283
4630,7e-05,74.125.24.0-255,4320,9047,65,283283
4631,7.4e-05,172.31.40.0-255,66,9113,65,283283
4632,9.3e-05,74.125.24.0-255,2902,12015,65,283283
4633,9.5e-05,172.31.40.0-255,66,12081,65,283283
4634,0.0001,74.125.24.0-255,2154,14235,65,283283
4635,0.000102,172.31.40.0-255,66,14301,65,283283
4636,0.000433,74.125.24.0-255,1484,15785,65,283283
4637,0.00044,172.31.40.0-255,66,15851,65,283283
4638,0.000447,74.125.24.0-255,2902,18753,65,283283
4639,0.00045,172.31.40.0-255,66,18819,65,283283
4640,0.000477,74.125.24.0-255,5738,24557,65,283283
4641,0.00048,172.31.40.0-255,66,24623,65,283283
4642,0.000483,74.125.24.0-255,1484,26107,65,283283
4643,0.000486,172.31.40.0-255,66,26173,65,283283
4644,0.0005,74.125.24.0-255,1484,27657,65,283283
4645,0.000503,172.31.40.0-255,66,27723,65,283283
4646,0.000517,74.125.24.0-255,1484,29207,65,283283
4647,0.000519,172.31.40.0-255,66,29273,65,283283
4648,0.000576,74.125.24.0-255,2902,32175,65,283283
4649,0.00058,172.31.40.0-255,66,32241,65,283283
4650,0.000598,74.125.24.0-255,1484,33725,65,283283
4651,0.0006,172.31.40.0-255,66,33791,65,283283
4652,0.000621,74.125.24.0-255,4320,38111,65,283283
4653,0.000624,172.31.40.0-255,66,38177,65,283283
4654,0.000645,172.31.40.0-255,66,38243,65,283283
4655,0.000668,74.125.24.0-255,4320,42563,65,283283
4656,0.00067,172.31.40.0-255,66,42629,65,283283
4657,0.000694,74.125.24.0-255,5738,48367,65,283283
4658,0.000697,172.31.40.0-255,66,48433,65,283283
4659,0.000704,74.125.24.0-255,7156,55589,65,283283
4660,0.000706,172.31.40.0-255,66,55655,65,283283
4661,0.000725,74.125.24.0-255,2184,57839,65,283283
4662,0.000727,172.31.40.0-255,66,57905,65,283283
4663,0.000751,74.125.24.0-255,676,58581,65,283283
4664,0.00095,74.125.24.0-255,1484,60065,65,283283
4665,0.000954,172.31.40.0-255,66,60131,65,283283
4666,0.000959,74.125.24.0-255,2902,63033,65,283283
4667,0.000961,172.31.40.0-255,66,63099,65,283283
4668,0.000976,74.125.24.0-255,4320,67419,65,283283
4669,0.000978,172.31.40.0-255,66,67485,65,283283
4670,0.000995,74.125.24.0-255,1484,68969,65,283283
4671,0.001012,74.125.24.0-255,2902,71871,65,283283
4672,0.001015,172.31.40.0-255,66,71937,65,283283
4673,0.001044,172.31.40.0-255,66,72003,65,283283
4674,0.001048,74.125.24.0-255,1484,73487,65,283283
4675,0.001067,74.125.24.0-255,7156,80643,65,283283
4676,0.001069,172.31.40.0-255,66,80709,65,283283
4677,0.001084,74.125.24.0-255,1484,82193,65,283283
4678,0.001102,74.125.24.0-255,766,82959,65,283283
4679,0.001104,172.31.40.0-255,66,83025,65,283283
4680,0.001891,74.125.24.0-255,1484,84509,65,283283
4681,0.001909,74.125.24.0-255,2902,87411,65,283283
4682,0.001914,172.31.40.0-255,66,87477,65,283283
4683,0.001933,74.125.24.0-255,1484,88961,65,283283
4684,0.001948,74.125.24.0-255,4320,93281,65,283283
4685,0.00195,172.31.40.0-255,66,93347,65,283283
4686,0.001955,74.125.24.0-255,2902,96249,65,283283
4687,0.001957,172.31.40.0-255,66,96315,65,283283
4688,0.001981,74.125.24.0-255,2902,99217,65,283283
4689,0.001984,172.31.40.0-255,66,99283,65,283283
4690,0.002002,74.125.24.0-255,2902,102185,65,283283
4691,0.002005,172.31.40.0-255,66,102251,65,283283
4692,0.002026,74.125.24.0-255,4320,106571,65,283283
4693,0.002029,172.31.40.0-255,66,106637,65,283283
4694,0.002043,74.125.24.0-255,1484,108121,65,283283
4695,0.002055,74.125.24.0-255,2902,111023,65,283283
4696,0.002058,172.31.40.0-255,66,111089,65,283283
4697,0.002069,74.125.24.0-255,2902,113991,65,283283
4698,0.002071,172.31.40.0-255,66,114057,65,283283
4699,0.002097,74.125.24.0-255,3602,117659,65,283283
4700,0.002099,172.31.40.0-255,66,117725,65,283283
4701,0.002245,74.125.24.0-255,1484,119209,65,283283
4702,0.002251,74.125.24.0-255,2902,122111,65,283283
4703,0.002254,172.31.40.0-255,66,122177,65,283283
4704,0.002261,74.125.24.0-255,5738,127915,65,283283
4705,0.002263,172.31.40.0-255,66,127981,65,283283
4706,0.002268,74.125.24.0-255,4320,132301,65,283283
4707,0.00227,172.31.40.0-255,66,132367,65,283283
4708,0.002291,74.125.24.0-255,5738,138105,65,283283
4709,0.002293,172.31.40.0-255,66,138171,65,283283
4710,0.002316,74.125.24.0-255,2902,141073,65,283283
4711,0.002319,172.31.40.0-255,66,141139,65,283283
4712,0.002326,74.125.24.0-255,7156,148295,65,283283
4713,0.002328,172.31.40.0-255,66,148361,65,283283
4714,0.002359,74.125.24.0-255,2902,151263,65,283283
4715,0.002362,172.31.40.0-255,66,151329,65,283283
4716,0.00239,172.31.40.0-255,66,151395,65,283283
4717,0.00241,74.125.24.0-255,5738,157133,65,283283
4718,0.002412,172.31.40.0-255,66,157199,65,283283
4719,0.002431,74.125.24.0-255,5020,162219,65,283283
4720,0.002434,172.31.40.0-255,66,162285,65,283283
4721,0.002442,74.125.24.0-255,7156,169441,65,283283
4722,0.002443,172.31.40.0-255,66,169507,65,283283
4723,0.002475,172.31.40.0-255,66,169573,65,283283
4724,0.002504,74.125.24.0-255,5020,174593,65,283283
4725,0.002507,172.31.40.0-255,66,174659,65,283283
4726,0.002514,74.125.24.0-255,7156,181815,65,283283
4727,0.002517,172.31.40.0-255,66,181881,65,283283
4728,0.002541,74.125.24.0-255,4320,186201,65,283283
4729,0.002544,172.31.40.0-255,66,186267,65,283283
4730,0.002549,74.125.24.0-255,2902,189169,65,283283
4731,0.002551,172.31.40.0-255,66,189235,65,283283
4732,0.002564,74.125.24.0-255,2902,192137,65,283283
4733,0.002567,172.31.40.0-255,66,192203,65,283283
4734,0.002632,172.31.40.0-255,66,192269,65,283283
4735,0.002665,172.31.40.0-255,66,192335,65,283283
4736,0.00268,172.31.40.0-255,66,192401,65,283283
4737,0.002711,172.31.40.0-255,66,192467,65,283283
4738,0.002729,74.125.24.0-255,3602,196069,65,283283
4739,0.002732,172.31.40.0-255,66,196135,65,283283
4740,0.002747,74.125.24.0-255,1484,197619,65,283283
4741,0.002765,74.125.24.0-255,7156,204775,65,283283
4742,0.002768,172.31.40.0-255,66,204841,65,283283
4743,0.002808,172.31.40.0-255,66,204907,65,283283
4744,0.00281,74.125.24.0-255,1484,206391,65,283283
4745,0.002814,74.125.24.0-255,2902,209293,65,283283
4746,0.002816,172.31.40.0-255,66,209359,65,283283
4747,0.002845,74.125.24.0-255,5738,215097,65,283283
4748,0.002847,172.31.40.0-255,66,215163,65,283283
4749,0.002856,74.125.24.0-255,7156,222319,65,283283
4750,0.002858,172.31.40.0-255,66,222385,65,283283
4751,0.002884,74.125.24.0-255,5738,228123,65,283283
4752,0.002887,172.31.40.0-255,66,228189,65,283283
4753,0.002892,74.125.24.0-255,4320,232509,65,283283
4754,0.002894,172.31.40.0-255,66,232575,65,283283
4755,0.002909,74.125.24.0-255,4320,236895,65,283283
4756,0.002912,172.31.40.0-255,66,236961,65,283283
4757,0.002932,74.125.24.0-255,2184,239145,65,283283
4758,0.002935,172.31.40.0-255,66,239211,65,283283
4759,0.00295,74.125.24.0-255,1484,240695,65,283283
4760,0.002953,74.125.24.0-255,1484,242179,65,283283
4761,0.002955,172.31.40.0-255,66,242245,65,283283
4762,0.002973,74.125.24.0-255,1484,243729,65,283283
4763,0.002981,74.125.24.0-255,5738,249467,65,283283
4764,0.002983,172.31.40.0-255,66,249533,65,283283
4765,0.003017,172.31.40.0-255,66,249599,65,283283
4766,0.003034,74.125.24.0-255,1484,251083,65,283283
4767,0.003041,74.125.24.0-255,5738,256821,65,283283
4768,0.003044,172.31.40.0-255,66,256887,65,283283
4769,0.003061,74.125.24.0-255,4320,261207,65,283283
4770,0.003064,172.31.40.0-255,66,261273,65,283283
4771,0.003103,74.125.24.0-255,1484,262757,65,283283
4772,0.003122,74.125.24.0-255,2902,265659,65,283283
4773,0.003125,172.31.40.0-255,66,265725,65,283283
4774,0.003145,74.125.24.0-255,4320,270045,65,283283
4775,0.003148,172.31.40.0-255,66,270111,65,283283
4776,0.003184,172.31.40.0-255,66,270177,65,283283
4777,0.003218,74.125.24.0-255,2902,273079,65,283283
4778,0.003221,172.31.40.0-255,66,273145,65,283283
4779,0.003235,74.125.24.0-255,4320,277465,65,283283
4780,0.003238,172.31.40.0-255,66,277531,65,283283
4781,0.003256,74.125.24.0-255,5086,282617,65,283283
4782,0.003259,172.31.40.0-255,66,282683,65,283283
4783,0.003263,74.125.24.0-255,105,282788,65,283283
4784,0.003292,74.125.24.0-255,129,282917,65,283283
4785,0.012006,172.31.40.0-255,105,283022,65,283283
4786,0.012064,172.31.40.0-255,105,283127,65,283283
4787,0.012293,172.31.40.0-255,90,283217,65,283283
4788,0.012312,172.31.40.0-255,66,283283,65,283283
4789,0.0,172.217.194.0-255,153,153,65,193840
4790,2.4e-05,172.31.40.0-255,66,219,65,193840
4791,3.1e-05,172.217.194.0-255,1484,1703,65,193840
4792,3.6e-05,172.31.40.0-255,66,1769,65,193840
4793,4.2e-05,172.217.194.0-255,2902,4671,65,193840
4794,4.5e-05,172.31.40.0-255,66,4737,65,193840
4795,5.3e-05,172.217.194.0-255,7156,11893,65,193840
4796,5.5e-05,172.31.40.0-255,66,11959,65,193840
4797,9.6e-05,172.31.40.0-255,66,12025,65,193840
4798,0.000103,172.217.194.0-255,6797,18822,65,193840
4799,0.000105,172.31.40.0-255,66,18888,65,193840
4800,0.000175,172.217.194.0-255,1484,20372,65,193840
4801,0.000179,172.217.194.0-255,2902,23274,65,193840
4802,0.000183,172.31.40.0-255,66,23340,65,193840
4803,0.000189,172.31.40.0-255,66,23406,65,193840
4804,0.000213,172.217.194.0-255,5738,29144,65,193840
4805,0.000216,172.31.40.0-255,66,29210,65,193840
4806,0.000221,172.217.194.0-255,2902,32112,65,193840
4807,0.000223,172.31.40.0-255,66,32178,65,193840
4808,0.000266,172.31.40.0-255,66,32244,65,193840
4809,0.000278,172.31.40.0-255,66,32310,65,193840
4810,0.000281,172.217.194.0-255,677,32987,65,193840
4811,0.000283,172.31.40.0-255,66,33053,65,193840
4812,0.000332,172.217.194.0-255,1484,34537,65,193840
4813,0.000334,172.31.40.0-255,66,34603,65,193840
4814,0.000338,172.217.194.0-255,1484,36087,65,193840
4815,0.00034,172.31.40.0-255,66,36153,65,193840
4816,0.000358,172.217.194.0-255,2902,39055,65,193840
4817,0.000361,172.31.40.0-255,66,39121,65,193840
4818,0.000368,172.217.194.0-255,7156,46277,65,193840
4819,0.000372,172.31.40.0-255,66,46343,65,193840
4820,0.000389,172.217.194.0-255,1484,47827,65,193840
4821,0.000401,172.217.194.0-255,2543,50370,65,193840
4822,0.000404,172.31.40.0-255,66,50436,65,193840
4823,0.000435,172.217.194.0-255,4320,54756,65,193840
4824,0.000438,172.31.40.0-255,66,54822,65,193840
4825,0.000453,172.217.194.0-255,2902,57724,65,193840
4826,0.000455,172.31.40.0-255,66,57790,65,193840
4827,0.000477,172.217.194.0-255,7156,64946,65,193840
4828,0.00048,172.31.40.0-255,66,65012,65,193840
4829,0.000482,172.217.194.0-255,1484,66496,65,193840
4830,0.000486,172.217.194.0-255,1125,67621,65,193840
4831,0.000488,172.31.40.0-255,66,67687,65,193840
4832,0.000634,172.217.194.0-255,1484,69171,65,193840
4833,0.000639,172.217.194.0-255,1484,70655,65,193840
4834,0.000642,172.31.40.0-255,66,70721,65,193840
4835,0.000658,172.217.194.0-255,1484,72205,65,193840
4836,0.000666,172.217.194.0-255,5738,77943,65,193840
4837,0.000669,172.31.40.0-255,66,78009,65,193840
4838,0.000675,172.217.194.0-255,5738,83747,65,193840
4839,0.000678,172.31.40.0-255,66,83813,65,193840
4840,0.000712,172.217.194.0-255,7156,90969,65,193840
4841,0.000715,172.31.40.0-255,66,91035,65,193840
4842,0.000729,172.31.40.0-255,66,91101,65,193840
4843,0.00079,172.217.194.0-255,7156,98257,65,193840
4844,0.000793,172.31.40.0-255,66,98323,65,193840
4845,0.000803,172.31.40.0-255,66,98389,65,193840
4846,0.00082,172.31.40.0-255,66,98455,65,193840
4847,0.000841,172.217.194.0-255,1484,99939,65,193840
4848,0.000845,172.217.194.0-255,766,100705,65,193840
4849,0.000847,172.31.40.0-255,66,100771,65,193840
4850,0.000883,172.217.194.0-255,4320,105091,65,193840
4851,0.000888,172.31.40.0-255,66,105157,65,193840
4852,0.000929,172.31.40.0-255,66,105223,65,193840
4853,0.000932,172.217.194.0-255,1484,106707,65,193840
4854,0.000944,172.31.40.0-255,66,106773,65,193840
4855,0.000977,172.217.194.0-255,3602,110375,65,193840
4856,0.000982,172.31.40.0-255,66,110441,65,193840
4857,0.000995,172.217.194.0-255,1484,111925,65,193840
4858,0.000999,172.217.194.0-255,1484,113409,65,193840
4859,0.001001,172.31.40.0-255,66,113475,65,193840
4860,0.001023,172.217.194.0-255,1484,114959,65,193840
4861,0.00103,172.217.194.0-255,5738,120697,65,193840
4862,0.001033,172.31.40.0-255,66,120763,65,193840
4863,0.001038,172.217.194.0-255,4320,125083,65,193840
4864,0.001041,172.31.40.0-255,66,125149,65,193840
4865,0.001066,172.31.40.0-255,66,125215,65,193840
4866,0.001079,172.31.40.0-255,66,125281,65,193840
4867,0.001126,172.217.194.0-255,1484,126765,65,193840
4868,0.00113,172.217.194.0-255,1484,128249,65,193840
4869,0.001133,172.31.40.0-255,66,128315,65,193840
4870,0.001164,172.217.194.0-255,1484,129799,65,193840
4871,0.00117,172.217.194.0-255,5738,135537,65,193840
4872,0.001173,172.31.40.0-255,66,135603,65,193840
4873,0.001179,172.217.194.0-255,5738,141341,65,193840
4874,0.001182,172.31.40.0-255,66,141407,65,193840
4875,0.001211,172.31.40.0-255,66,141473,65,193840
4876,0.001234,172.217.194.0-255,2902,144375,65,193840
4877,0.001236,172.31.40.0-255,66,144441,65,193840
4878,0.001242,172.217.194.0-255,5020,149461,65,193840
4879,0.001245,172.31.40.0-255,66,149527,65,193840
4880,0.001259,172.217.194.0-255,1484,151011,65,193840
4881,0.001282,172.217.194.0-255,2902,153913,65,193840
4882,0.001285,172.31.40.0-255,66,153979,65,193840
4883,0.001291,172.217.194.0-255,5738,159717,65,193840
4884,0.001293,172.31.40.0-255,66,159783,65,193840
4885,0.001297,172.217.194.0-255,2902,162685,65,193840
4886,0.0013,172.31.40.0-255,66,162751,65,193840
4887,0.001327,172.31.40.0-255,66,162817,65,193840
4888,0.001333,172.217.194.0-255,4320,167137,65,193840
4889,0.001335,172.31.40.0-255,66,167203,65,193840
4890,0.001364,172.217.194.0-255,6438,173641,65,193840
4891,0.001367,172.31.40.0-255,66,173707,65,193840
4892,0.00137,172.217.194.0-255,1484,175191,65,193840
4893,0.001387,172.217.194.0-255,2902,178093,65,193840
4894,0.00139,172.31.40.0-255,66,178159,65,193840
4895,0.001412,172.217.194.0-255,5738,183897,65,193840
4896,0.001415,172.31.40.0-255,66,183963,65,193840
4897,0.001445,172.31.40.0-255,66,184029,65,193840
4898,0.001514,172.31.40.0-255,66,184095,65,193840
4899,0.001527,172.31.40.0-255,66,184161,65,193840
4900,0.001567,172.217.194.0-255,1484,185645,65,193840
4901,0.001582,172.31.40.0-255,66,185711,65,193840
4902,0.001593,172.31.40.0-255,66,185777,65,193840
4903,0.001609,172.31.40.0-255,66,185843,65,193840
4904,0.001636,172.217.194.0-255,5738,191581,65,193840
4905,0.001639,172.31.40.0-255,66,191647,65,193840
4906,0.001658,172.217.194.0-255,1785,193432,65,193840
4907,0.001661,172.31.40.0-255,66,193498,65,193840
4908,0.001687,172.217.194.0-255,105,193603,65,193840
4909,0.017026,172.31.40.0-255,66,193669,65,193840
4910,0.017078,172.31.40.0-255,105,193774,65,193840
4911,0.019024,172.217.194.0-255,66,193840,65,193840
4912,0.0,172.217.194.0-255,147,147,65,169145
4913,2.1e-05,172.31.40.0-255,66,213,65,169145
4914,2.8e-05,172.217.194.0-255,1484,1697,65,169145
4915,3.2e-05,172.31.40.0-255,66,1763,65,169145
4916,3.8e-05,172.217.194.0-255,2902,4665,65,169145
4917,4.2e-05,172.31.40.0-255,66,4731,65,169145
4918,5e-05,172.217.194.0-255,7156,11887,65,169145
4919,5.2e-05,172.31.40.0-255,66,11953,65,169145
4920,0.000107,172.217.194.0-255,1966,13919,65,169145
4921,0.000111,172.31.40.0-255,66,13985,65,169145
4922,0.000572,172.217.194.0-255,1484,15469,65,169145
4923,0.000578,172.31.40.0-255,66,15535,65,169145
4924,0.000586,172.217.194.0-255,2902,18437,65,169145
4925,0.000588,172.31.40.0-255,66,18503,65,169145
4926,0.000593,172.217.194.0-255,2902,21405,65,169145
4927,0.000595,172.31.40.0-255,66,21471,65,169145
4928,0.000623,172.217.194.0-255,2902,24373,65,169145
4929,0.000625,172.31.40.0-255,66,24439,65,169145
4930,0.000644,172.217.194.0-255,4320,28759,65,169145
4931,0.000647,172.31.40.0-255,66,28825,65,169145
4932,0.000672,172.217.194.0-255,2543,31368,65,169145
4933,0.000675,172.31.40.0-255,66,31434,65,169145
4934,0.000712,172.217.194.0-255,4320,35754,65,169145
4935,0.000717,172.31.40.0-255,66,35820,65,169145
4936,0.000737,172.217.194.0-255,2902,38722,65,169145
4937,0.00074,172.31.40.0-255,66,38788,65,169145
4938,0.000781,172.217.194.0-255,7156,45944,65,169145
4939,0.000785,172.31.40.0-255,66,46010,65,169145
4940,0.000804,172.217.194.0-255,2543,48553,65,169145
4941,0.000806,172.31.40.0-255,66,48619,65,169145
4942,0.000874,172.217.194.0-255,7156,55775,65,169145
4943,0.000879,172.31.40.0-255,66,55841,65,169145
4944,0.000899,172.217.194.0-255,2902,58743,65,169145
4945,0.000902,172.31.40.0-255,66,58809,65,169145
4946,0.000966,172.217.194.0-255,7051,65860,65,169145
4947,0.000971,172.31.40.0-255,66,65926,65,169145
4948,0.001011,172.217.194.0-255,117,66043,65,169145
4949,0.00104,172.217.194.0-255,5738,71781,65,169145
4950,0.001047,172.31.40.0-255,66,71847,65,169145
4951,0.001069,172.217.194.0-255,2902,74749,65,169145
4952,0.001072,172.31.40.0-255,66,74815,65,169145
4953,0.001113,172.217.194.0-255,2902,77717,65,169145
4954,0.001116,172.31.40.0-255,66,77783,65,169145
4955,0.001144,172.31.40.0-255,66,77849,65,169145
4956,0.001158,172.217.194.0-255,1125,78974,65,169145
4957,0.001309,172.217.194.0-255,5379,84353,65,169145
4958,0.001316,172.31.40.0-255,66,84419,65,169145
4959,0.001496,172.217.194.0-255,1484,85903,65,169145
4960,0.001503,172.217.194.0-255,2902,88805,65,169145
4961,0.001508,172.31.40.0-255,66,88871,65,169145
4962,0.001523,172.217.194.0-255,5738,94609,65,169145
4963,0.001527,172.31.40.0-255,66,94675,65,169145
4964,0.001581,172.217.194.0-255,4320,98995,65,169145
4965,0.001585,172.31.40.0-255,66,99061,65,169145
4966,0.001695,172.217.194.0-255,7156,106217,65,169145
4967,0.001771,172.217.194.0-255,7156,113373,65,169145
4968,0.001973,172.217.194.0-255,2902,116275,65,169145
4969,0.002136,172.217.194.0-255,2184,118459,65,169145
4970,0.002204,172.217.194.0-255,7156,125615,65,169145
4971,0.002277,172.217.194.0-255,5738,131353,65,169145
4972,0.002488,172.217.194.0-255,4320,135673,65,169145
4973,0.002916,172.217.194.0-255,2902,138575,65,169145
4974,0.003099,172.217.194.0-255,1484,140059,65,169145
4975,0.006643,172.31.40.0-255,66,140125,65,169145
4976,0.008856,172.217.194.0-255,5738,145863,65,169145
4977,0.008867,172.31.40.0-255,66,145929,65,169145
4978,0.011107,172.217.194.0-255,5738,151667,65,169145
4979,0.011116,172.31.40.0-255,66,151733,65,169145
4980,0.013351,172.217.194.0-255,5738,157471,65,169145
4981,0.013365,172.31.40.0-255,66,157537,65,169145
4982,0.015588,172.217.194.0-255,5738,163275,65,169145
4983,0.0156,172.31.40.0-255,66,163341,65,169145
4984,0.017827,172.217.194.0-255,5738,169079,65,169145
4985,0.017834,172.31.40.0-255,66,169145,65,169145
4986,0.0,172.217.194.0-255,153,153,65,177064
4987,1.5e-05,172.31.40.0-255,66,219,65,177064
4988,2.3e-05,172.217.194.0-255,1484,1703,65,177064
4989,2.8e-05,172.31.40.0-255,66,1769,65,177064
4990,3.3e-05,172.217.194.0-255,2902,4671,65,177064
4991,4.4e-05,172.31.40.0-255,66,4737,65,177064
4992,5.2e-05,172.217.194.0-255,7156,11893,65,177064
4993,5.5e-05,172.31.40.0-255,66,11959,65,177064
4994,6e-05,172.217.194.0-255,2902,14861,65,177064
4995,6.3e-05,172.31.40.0-255,66,14927,65,177064
4996,0.000112,172.31.40.0-255,66,14993,65,177064
4997,0.000116,172.217.194.0-255,2543,17536,65,177064
4998,0.000118,172.31.40.0-255,66,17602,65,177064
4999,0.000165,172.217.194.0-255,1484,19086,65,177064
5000,0.000167,172.31.40.0-255,66,19152,65,177064
5001,0.000172,172.217.194.0-255,2902,22054,65,177064
5002,0.000175,172.31.40.0-255,66,22120,65,177064
5003,0.000204,172.217.194.0-255,5738,27858,65,177064
5004,0.000207,172.31.40.0-255,66,27924,65,177064
5005,0.000213,172.217.194.0-255,5738,33662,65,177064
5006,0.000216,172.31.40.0-255,66,33728,65,177064
5007,0.000251,172.31.40.0-255,66,33794,65,177064
5008,0.000277,172.31.40.0-255,66,33860,65,177064
5009,0.000303,172.217.194.0-255,365,34225,65,177064
5010,0.000305,172.31.40.0-255,66,34291,65,177064
5011,0.000446,172.217.194.0-255,1484,35775,65,177064
5012,0.000451,172.31.40.0-255,66,35841,65,177064
5013,0.000457,172.217.194.0-255,2902,38743,65,177064
5014,0.00046,172.31.40.0-255,66,38809,65,177064
5015,0.000472,172.217.194.0-255,5738,44547,65,177064
5016,0.000474,172.31.40.0-255,66,44613,65,177064
5017,0.000517,172.31.40.0-255,66,44679,65,177064
5018,0.00052,172.217.194.0-255,1484,46163,65,177064
5019,0.000549,172.217.194.0-255,5738,51901,65,177064
5020,0.000552,172.31.40.0-255,66,51967,65,177064
5021,0.000581,172.217.194.0-255,2543,54510,65,177064
5022,0.000583,172.31.40.0-255,66,54576,65,177064
5023,0.000783,172.217.194.0-255,1484,56060,65,177064
5024,0.000808,172.217.194.0-255,2902,58962,65,177064
5025,0.000812,172.31.40.0-255,66,59028,65,177064
5026,0.000817,172.217.194.0-255,2902,61930,65,177064
5027,0.000819,172.31.40.0-255,66,61996,65,177064
5028,0.000851,172.217.194.0-255,2902,64898,65,177064
5029,0.000854,172.31.40.0-255,66,64964,65,177064
5030,0.000873,172.31.40.0-255,66,65030,65,177064
5031,0.000903,172.217.194.0-255,7156,72186,65,177064
5032,0.000905,172.31.40.0-255,66,72252,65,177064
5033,0.000933,172.217.194.0-255,3602,75854,65,177064
5034,0.000936,172.31.40.0-255,66,75920,65,177064
5035,0.00094,172.217.194.0-255,1484,77404,65,177064
5036,0.000943,172.217.194.0-255,1484,78888,65,177064
5037,0.000945,172.31.40.0-255,66,78954,65,177064
5038,0.000969,172.217.194.0-255,1484,80438,65,177064
5039,0.000975,172.217.194.0-255,5738,86176,65,177064
5040,0.000978,172.31.40.0-255,66,86242,65,177064
5041,0.000983,172.217.194.0-255,4320,90562,65,177064
5042,0.000986,172.31.40.0-255,66,90628,65,177064
5043,0.001031,172.31.40.0-255,66,90694,65,177064
5044,0.001037,172.217.194.0-255,5738,96432,65,177064
5045,0.001039,172.31.40.0-255,66,96498,65,177064
5046,0.001042,172.217.194.0-255,1484,97982,65,177064
5047,0.001065,172.217.194.0-255,3602,101584,65,177064
5048,0.001067,172.31.40.0-255,66,101650,65,177064
5049,0.001097,172.217.194.0-255,1484,103134,65,177064
5050,0.001115,172.217.194.0-255,2902,106036,65,177064
5051,0.001118,172.31.40.0-255,66,106102,65,177064
5052,0.001125,172.217.194.0-255,5738,111840,65,177064
5053,0.001127,172.31.40.0-255,66,111906,65,177064
5054,0.001205,172.31.40.0-255,66,111972,65,177064
5055,0.001221,172.31.40.0-255,66,112038,65,177064
5056,0.001229,172.217.194.0-255,7156,119194,65,177064
5057,0.001231,172.31.40.0-255,66,119260,65,177064
5058,0.001271,172.31.40.0-255,66,119326,65,177064
5059,0.001286,172.31.40.0-255,66,119392,65,177064
5060,0.00134,172.217.194.0-255,1484,120876,65,177064
5061,0.001345,172.217.194.0-255,2902,123778,65,177064
5062,0.001347,172.31.40.0-255,66,123844,65,177064
5063,0.001375,172.217.194.0-255,4320,128164,65,177064
5064,0.001379,172.31.40.0-255,66,128230,65,177064
5065,0.001403,172.217.194.0-255,1484,129714,65,177064
5066,0.001423,172.31.40.0-255,66,129780,65,177064
5067,0.001468,172.31.40.0-255,66,129846,65,177064
5068,0.001555,172.217.194.0-255,1484,131330,65,177064
5069,0.001561,172.217.194.0-255,2902,134232,65,177064
5070,0.001584,172.217.194.0-255,5738,139970,65,177064
5071,0.001587,172.31.40.0-255,66,140036,65,177064
5072,0.001593,172.31.40.0-255,66,140102,65,177064
5073,0.001627,172.217.194.0-255,2902,143004,65,177064
5074,0.001644,172.217.194.0-255,7156,150160,65,177064
5075,0.001651,172.31.40.0-255,66,150226,65,177064
5076,0.001657,172.217.194.0-255,766,150992,65,177064
5077,0.00169,172.217.194.0-255,1484,152476,65,177064
5078,0.001704,172.217.194.0-255,4320,156796,65,177064
5079,0.001721,172.217.194.0-255,4320,161116,65,177064
5080,0.001726,172.31.40.0-255,66,161182,65,177064
5081,0.001755,172.217.194.0-255,5738,166920,65,177064
5082,0.001761,172.217.194.0-255,2902,169822,65,177064
5083,0.001768,172.31.40.0-255,66,169888,65,177064
5084,0.001807,172.217.194.0-255,2184,172072,65,177064
5085,0.00181,172.217.194.0-255,1484,173556,65,177064
5086,0.00182,172.31.40.0-255,66,173622,65,177064
5087,0.001909,172.31.40.0-255,66,173688,65,177064
5088,0.001946,172.31.40.0-255,66,173754,65,177064
5089,0.001956,172.217.194.0-255,2902,176656,65,177064
5090,0.001992,172.31.40.0-255,66,176722,65,177064
5091,0.004007,172.217.194.0-255,105,176827,65,177064
5092,0.014089,172.31.40.0-255,66,176893,65,177064
5093,0.014142,172.31.40.0-255,105,176998,65,177064
5094,0.016173,172.217.194.0-255,66,177064,65,177064
5095,0.0,74.125.24.0-255,155,155,65,249077
5096,1.6e-05,172.31.40.0-255,66,221,65,249077
5097,2.4e-05,74.125.24.0-255,1484,1705,65,249077
5098,2.8e-05,172.31.40.0-255,66,1771,65,249077
5099,3.3e-05,74.125.24.0-255,2902,4673,65,249077
5100,4.7e-05,172.31.40.0-255,66,4739,65,249077
5101,5.5e-05,74.125.24.0-255,7156,11895,65,249077
5102,5.8e-05,172.31.40.0-255,66,11961,65,249077
5103,9.7e-05,74.125.24.0-255,2038,13999,65,249077
5104,0.0001,172.31.40.0-255,66,14065,65,249077
5105,0.000123,74.125.24.0-255,2902,16967,65,249077
5106,0.000127,172.31.40.0-255,66,17033,65,249077
5107,0.000135,74.125.24.0-255,7156,24189,65,249077
5108,0.000137,172.31.40.0-255,66,24255,65,249077
5109,0.000142,74.125.24.0-255,4320,28575,65,249077
5110,0.000144,172.31.40.0-255,66,28641,65,249077
5111,0.000187,74.125.24.0-255,2543,31184,65,249077
5112,0.00019,172.31.40.0-255,66,31250,65,249077
5113,0.000661,74.125.24.0-255,1484,32734,65,249077
5114,0.000667,172.31.40.0-255,66,32800,65,249077
5115,0.000674,74.125.24.0-255,2902,35702,65,249077
5116,0.000677,172.31.40.0-255,66,35768,65,249077
5117,0.000689,74.125.24.0-255,5738,41506,65,249077
5118,0.000691,172.31.40.0-255,66,41572,65,249077
5119,0.000695,74.125.24.0-255,1484,43056,65,249077
5120,0.000697,172.31.40.0-255,66,43122,65,249077
5121,0.00073,74.125.24.0-255,6797,49919,65,249077
5122,0.000732,172.31.40.0-255,66,49985,65,249077
5123,0.000743,172.31.40.0-255,66,50051,65,249077
5124,0.000747,74.125.24.0-255,2902,52953,65,249077
5125,0.00075,172.31.40.0-255,66,53019,65,249077
5126,0.000787,74.125.24.0-255,3961,56980,65,249077
5127,0.00079,172.31.40.0-255,66,57046,65,249077
5128,0.000793,74.125.24.0-255,392,57438,65,249077
5129,0.000851,74.125.24.0-255,1484,58922,65,249077
5130,0.000854,172.31.40.0-255,66,58988,65,249077
5131,0.000859,74.125.24.0-255,2902,61890,65,249077
5132,0.000861,172.31.40.0-255,66,61956,65,249077
5133,0.000883,74.125.24.0-255,1484,63440,65,249077
5134,0.000906,74.125.24.0-255,4320,67760,65,249077
5135,0.000909,172.31.40.0-255,66,67826,65,249077
5136,0.000916,74.125.24.0-255,7082,74908,65,249077
5137,0.000919,172.31.40.0-255,66,74974,65,249077
5138,0.000977,74.125.24.0-255,1484,76458,65,249077
5139,0.00099,74.125.24.0-255,2902,79360,65,249077
5140,0.000993,172.31.40.0-255,66,79426,65,249077
5141,0.000996,74.125.24.0-255,1484,80910,65,249077
5142,0.001019,74.125.24.0-255,2902,83812,65,249077
5143,0.001022,172.31.40.0-255,66,83878,65,249077
5144,0.001026,74.125.24.0-255,2902,86780,65,249077
5145,0.001028,172.31.40.0-255,66,86846,65,249077
5146,0.00105,74.125.24.0-255,2902,89748,65,249077
5147,0.001053,172.31.40.0-255,66,89814,65,249077
5148,0.001062,74.125.24.0-255,1994,91808,65,249077
5149,0.001064,172.31.40.0-255,66,91874,65,249077
5150,0.001373,74.125.24.0-255,1484,93358,65,249077
5151,0.001378,74.125.24.0-255,1484,94842,65,249077
5152,0.001381,172.31.40.0-255,66,94908,65,249077
5153,0.001406,74.125.24.0-255,1484,96392,65,249077
5154,0.001412,74.125.24.0-255,5738,102130,65,249077
5155,0.001415,172.31.40.0-255,66,102196,65,249077
5156,0.001421,74.125.24.0-255,2902,105098,65,249077
5157,0.001423,172.31.40.0-255,66,105164,65,249077
5158,0.001439,172.31.40.0-255,66,105230,65,249077
5159,0.001489,172.31.40.0-255,66,105296,65,249077
5160,0.002061,74.125.24.0-255,1484,106780,65,249077
5161,0.002071,74.125.24.0-255,2902,109682,65,249077
5162,0.002075,172.31.40.0-255,66,109748,65,249077
5163,0.00208,74.125.24.0-255,1484,111232,65,249077
5164,0.002103,74.125.24.0-255,4320,115552,65,249077
5165,0.002105,172.31.40.0-255,66,115618,65,249077
5166,0.002114,74.125.24.0-255,7156,122774,65,249077
5167,0.002116,172.31.40.0-255,66,122840,65,249077
5168,0.002148,74.125.24.0-255,5738,128578,65,249077
5169,0.00215,172.31.40.0-255,66,128644,65,249077
5170,0.002158,74.125.24.0-255,7156,135800,65,249077
5171,0.00216,172.31.40.0-255,66,135866,65,249077
5172,0.00217,74.125.24.0-255,3602,139468,65,249077
5173,0.002172,172.31.40.0-255,66,139534,65,249077
5174,0.002684,74.125.24.0-255,1484,141018,65,249077
5175,0.002694,74.125.24.0-255,2902,143920,65,249077
5176,0.002698,172.31.40.0-255,66,143986,65,249077
5177,0.002705,74.125.24.0-255,4320,148306,65,249077
5178,0.002707,172.31.40.0-255,66,148372,65,249077
5179,0.00273,74.125.24.0-255,1484,149856,65,249077
5180,0.002739,74.125.24.0-255,2902,152758,65,249077
5181,0.002742,172.31.40.0-255,66,152824,65,249077
5182,0.002754,74.125.24.0-255,2902,155726,65,249077
5183,0.00276,172.31.40.0-255,66,155792,65,249077
5184,0.00279,74.125.24.0-255,7156,162948,65,249077
5185,0.002793,172.31.40.0-255,66,163014,65,249077
5186,0.002807,172.31.40.0-255,66,163080,65,249077
5187,0.003333,74.125.24.0-255,1484,164564,65,249077
5188,0.003342,74.125.24.0-255,2902,167466,65,249077
5189,0.003346,172.31.40.0-255,66,167532,65,249077
5190,0.003379,74.125.24.0-255,5738,173270,65,249077
5191,0.003383,172.31.40.0-255,66,173336,65,249077
5192,0.003385,74.125.24.0-255,1484,174820,65,249077
5193,0.00339,74.125.24.0-255,2902,177722,65,249077
5194,0.003393,172.31.40.0-255,66,177788,65,249077
5195,0.003417,74.125.24.0-255,5738,183526,65,249077
5196,0.00342,172.31.40.0-255,66,183592,65,249077
5197,0.003422,74.125.24.0-255,1484,185076,65,249077
5198,0.003462,172.31.40.0-255,66,185142,65,249077
5199,0.003465,74.125.24.0-255,766,185908,65,249077
5200,0.003568,74.125.24.0-255,1484,187392,65,249077
5201,0.00357,172.31.40.0-255,66,187458,65,249077
5202,0.003594,74.125.24.0-255,2902,190360,65,249077
5203,0.003597,172.31.40.0-255,66,190426,65,249077
5204,0.003603,74.125.24.0-255,5738,196164,65,249077
5205,0.003606,172.31.40.0-255,66,196230,65,249077
5206,0.003647,172.31.40.0-255,66,196296,65,249077
5207,0.003652,74.125.24.0-255,4320,200616,65,249077
5208,0.003655,172.31.40.0-255,66,200682,65,249077
5209,0.003688,74.125.24.0-255,7156,207838,65,249077
5210,0.003691,172.31.40.0-255,66,207904,65,249077
5211,0.003718,172.31.40.0-255,66,207970,65,249077
5212,0.003721,74.125.24.0-255,1484,209454,65,249077
5213,0.003743,74.125.24.0-255,5738,215192,65,249077
5214,0.003746,172.31.40.0-255,66,215258,65,249077
5215,0.00379,172.31.40.0-255,66,215324,65,249077
5216,0.003793,74.125.24.0-255,1484,216808,65,249077
5217,0.003824,74.125.24.0-255,2902,219710,65,249077
5218,0.003826,172.31.40.0-255,66,219776,65,249077
5219,0.003833,74.125.24.0-255,5738,225514,65,249077
5220,0.003836,172.31.40.0-255,66,225580,65,249077
5221,0.003843,74.125.24.0-255,1484,227064,65,249077
5222,0.003878,172.31.40.0-255,66,227130,65,249077
5223,0.003886,74.125.24.0-255,7156,234286,65,249077
5224,0.003889,172.31.40.0-255,66,234352,65,249077
5225,0.003922,74.125.24.0-255,3602,237954,65,249077
5226,0.003925,172.31.40.0-255,66,238020,65,249077
5227,0.00393,74.125.24.0-255,4320,242340,65,249077
5228,0.003933,172.31.40.0-255,66,242406,65,249077
5229,0.003988,172.31.40.0-255,66,242472,65,249077
5230,0.004002,172.31.40.0-255,66,242538,65,249077
5231,0.004008,74.125.24.0-255,4320,246858,65,249077
5232,0.00401,172.31.40.0-255,66,246924,65,249077
5233,0.00406,172.31.40.0-255,66,246990,65,249077
5234,0.004077,172.31.40.0-255,66,247056,65,249077
5235,0.004088,172.31.40.0-255,66,247122,65,249077
5236,0.004162,74.125.24.0-255,1430,248552,65,249077
5237,0.004166,74.125.24.0-255,105,248657,65,249077
5238,0.012438,172.31.40.0-255,66,248723,65,249077
5239,0.012493,172.31.40.0-255,105,248828,65,249077
5240,0.013454,74.125.24.0-255,105,248933,65,249077
5241,0.013466,172.31.40.0-255,78,249011,65,249077
5242,0.014739,74.125.24.0-255,66,249077,65,249077
5243,0.0,74.125.24.0-255,151,151,65,152554
5244,3.7e-05,172.31.40.0-255,66,217,65,152554
5245,4.4e-05,74.125.24.0-255,1484,1701,65,152554
5246,4.8e-05,172.31.40.0-255,66,1767,65,152554
5247,5.3e-05,74.125.24.0-255,2902,4669,65,152554
5248,5.7e-05,172.31.40.0-255,66,4735,65,152554
5249,6e-05,74.125.24.0-255,1484,6219,65,152554
5250,6.2e-05,172.31.40.0-255,66,6285,65,152554
5251,0.000112,172.31.40.0-255,66,6351,65,152554
5252,0.000124,74.125.24.0-255,4320,10671,65,152554
5253,0.000127,172.31.40.0-255,66,10737,65,152554
5254,0.000153,74.125.24.0-255,4320,15057,65,152554
5255,0.000155,172.31.40.0-255,66,15123,65,152554
5256,0.000161,74.125.24.0-255,4320,19443,65,152554
5257,0.000164,172.31.40.0-255,66,19509,65,152554
5258,0.000202,74.125.24.0-255,3961,23470,65,152554
5259,0.000206,172.31.40.0-255,66,23536,65,152554
5260,0.000243,74.125.24.0-255,1484,25020,65,152554
5261,0.000245,172.31.40.0-255,66,25086,65,152554
5262,0.000267,74.125.24.0-255,2902,27988,65,152554
5263,0.00027,172.31.40.0-255,66,28054,65,152554
5264,0.000276,74.125.24.0-255,5738,33792,65,152554
5265,0.000281,172.31.40.0-255,66,33858,65,152554
5266,0.000287,74.125.24.0-255,1484,35342,65,152554
5267,0.000291,172.31.40.0-255,66,35408,65,152554
5268,0.000315,172.31.40.0-255,66,35474,65,152554
5269,0.000326,172.31.40.0-255,66,35540,65,152554
5270,0.000344,74.125.24.0-255,1484,37024,65,152554
5271,0.000346,172.31.40.0-255,66,37090,65,152554
5272,0.000365,74.125.24.0-255,2878,39968,65,152554
5273,0.000368,172.31.40.0-255,66,40034,65,152554
5274,0.000392,74.125.24.0-255,110,40144,65,152554
5275,0.000422,74.125.24.0-255,330,40474,65,152554
5276,0.000706,74.125.24.0-255,1484,41958,65,152554
5277,0.000711,172.31.40.0-255,66,42024,65,152554
5278,0.000716,74.125.24.0-255,2902,44926,65,152554
5279,0.000718,172.31.40.0-255,66,44992,65,152554
5280,0.000732,74.125.24.0-255,2902,47894,65,152554
5281,0.000735,172.31.40.0-255,66,47960,65,152554
5282,0.000766,74.125.24.0-255,2902,50862,65,152554
5283,0.000769,172.31.40.0-255,66,50928,65,152554
5284,0.000775,74.125.24.0-255,7156,58084,65,152554
5285,0.000777,172.31.40.0-255,66,58150,65,152554
5286,0.00078,74.125.24.0-255,1484,59634,65,152554
5287,0.00081,172.31.40.0-255,66,59700,65,152554
5288,0.000814,74.125.24.0-255,2184,61884,65,152554
5289,0.000816,172.31.40.0-255,66,61950,65,152554
5290,0.001244,74.125.24.0-255,1484,63434,65,152554
5291,0.001262,74.125.24.0-255,2902,66336,65,152554
5292,0.001267,172.31.40.0-255,66,66402,65,152554
5293,0.001274,74.125.24.0-255,5738,72140,65,152554
5294,0.001276,172.31.40.0-255,66,72206,65,152554
5295,0.001291,74.125.24.0-255,2902,75108,65,152554
5296,0.001294,172.31.40.0-255,66,75174,65,152554
5297,0.001319,172.31.40.0-255,66,75240,65,152554
5298,0.001325,74.125.24.0-255,5738,80978,65,152554
5299,0.001327,172.31.40.0-255,66,81044,65,152554
5300,0.001357,74.125.24.0-255,5020,86064,65,152554
5301,0.00136,172.31.40.0-255,66,86130,65,152554
5302,0.001884,74.125.24.0-255,1484,87614,65,152554
5303,0.001893,74.125.24.0-255,2902,90516,65,152554
5304,0.001897,172.31.40.0-255,66,90582,65,152554
5305,0.001904,74.125.24.0-255,5738,96320,65,152554
5306,0.001906,172.31.40.0-255,66,96386,65,152554
5307,0.001912,74.125.24.0-255,4320,100706,65,152554
5308,0.001914,172.31.40.0-255,66,100772,65,152554
5309,0.001931,74.125.24.0-255,1484,102256,65,152554
5310,0.001937,74.125.24.0-255,4320,106576,65,152554
5311,0.001939,172.31.40.0-255,66,106642,65,152554
5312,0.001963,172.31.40.0-255,66,106708,65,152554
5313,0.001976,74.125.24.0-255,2902,109610,65,152554
5314,0.001978,172.31.40.0-255,66,109676,65,152554
5315,0.001998,74.125.24.0-255,2184,111860,65,152554
5316,0.002001,172.31.40.0-255,66,111926,65,152554
5317,0.00425,74.125.24.0-255,5738,117664,65,152554
5318,0.004255,172.31.40.0-255,66,117730,65,152554
5319,0.006574,74.125.24.0-255,5738,123468,65,152554
5320,0.006582,172.31.40.0-255,66,123534,65,152554
5321,0.008844,74.125.24.0-255,5738,129272,65,152554
5322,0.008855,172.31.40.0-255,66,129338,65,152554
5323,0.011135,74.125.24.0-255,5738,135076,65,152554
5324,0.011149,172.31.40.0-255,66,135142,65,152554
5325,0.01343,74.125.24.0-255,5738,140880,65,152554
5326,0.013447,172.31.40.0-255,66,140946,65,152554
5327,0.015716,74.125.24.0-255,5738,146684,65,152554
5328,0.015736,172.31.40.0-255,66,146750,65,152554
5329,0.018065,74.125.24.0-255,5738,152488,65,152554
5330,0.018085,172.31.40.0-255,66,152554,65,152554
5331,0.0,74.125.24.0-255,153,153,65,202483
5332,1.9e-05,172.31.40.0-255,66,219,65,202483
5333,2.5e-05,74.125.24.0-255,1484,1703,65,202483
5334,3e-05,172.31.40.0-255,66,1769,65,202483
5335,3.6e-05,74.125.24.0-255,2902,4671,65,202483
5336,4.6e-05,172.31.40.0-255,66,4737,65,202483
5337,5.5e-05,74.125.24.0-255,7156,11893,65,202483
5338,5.8e-05,172.31.40.0-255,66,11959,65,202483
5339,6.2e-05,74.125.24.0-255,2029,13988,65,202483
5340,6.5e-05,172.31.40.0-255,66,14054,65,202483
5341,0.000113,74.125.24.0-255,2902,16956,65,202483
5342,0.000116,172.31.40.0-255,66,17022,65,202483
5343,0.000144,172.31.40.0-255,66,17088,65,202483
5344,0.00015,74.125.24.0-255,5379,22467,65,202483
5345,0.000152,172.31.40.0-255,66,22533,65,202483
5346,0.000238,74.125.24.0-255,1484,24017,65,202483
5347,0.000241,172.31.40.0-255,66,24083,65,202483
5348,0.000245,74.125.24.0-255,2902,26985,65,202483
5349,0.000248,172.31.40.0-255,66,27051,65,202483
5350,0.000288,74.125.24.0-255,5738,32789,65,202483
5351,0.000292,172.31.40.0-255,66,32855,65,202483
5352,0.000295,74.125.24.0-255,1484,34339,65,202483
5353,0.000297,172.31.40.0-255,66,34405,65,202483
5354,0.000347,172.31.40.0-255,66,34471,65,202483
5355,0.000358,172.31.40.0-255,66,34537,65,202483
5356,0.000482,74.125.24.0-255,342,34879,65,202483
5357,0.000487,172.31.40.0-255,66,34945,65,202483
5358,0.000519,74.125.24.0-255,1484,36429,65,202483
5359,0.000522,172.31.40.0-255,66,36495,65,202483
5360,0.000549,74.125.24.0-255,4320,40815,65,202483
5361,0.000552,172.31.40.0-255,66,40881,65,202483
5362,0.000565,172.31.40.0-255,66,40947,65,202483
5363,0.000572,74.125.24.0-255,1125,42072,65,202483
5364,0.00062,74.125.24.0-255,1484,43556,65,202483
5365,0.000623,172.31.40.0-255,66,43622,65,202483
5366,0.000653,172.31.40.0-255,66,43688,65,202483
5367,0.000659,74.125.24.0-255,3961,47649,65,202483
5368,0.000661,172.31.40.0-255,66,47715,65,202483
5369,0.000811,74.125.24.0-255,1484,49199,65,202483
5370,0.00083,74.125.24.0-255,2902,52101,65,202483
5371,0.000834,172.31.40.0-255,66,52167,65,202483
5372,0.000868,74.125.24.0-255,5738,57905,65,202483
5373,0.000871,172.31.40.0-255,66,57971,65,202483
5374,0.000883,172.31.40.0-255,66,58037,65,202483
5375,0.000909,74.125.24.0-255,4320,62357,65,202483
5376,0.000912,172.31.40.0-255,66,62423,65,202483
5377,0.000918,74.125.24.0-255,5738,68161,65,202483
5378,0.000921,172.31.40.0-255,66,68227,65,202483
5379,0.000937,74.125.24.0-255,1484,69711,65,202483
5380,0.000961,74.125.24.0-255,3602,73313,65,202483
5381,0.000964,172.31.40.0-255,66,73379,65,202483
5382,0.001033,74.125.24.0-255,1484,74863,65,202483
5383,0.001054,74.125.24.0-255,2902,77765,65,202483
5384,0.001057,172.31.40.0-255,66,77831,65,202483
5385,0.001065,74.125.24.0-255,5738,83569,65,202483
5386,0.001067,172.31.40.0-255,66,83635,65,202483
5387,0.001091,74.125.24.0-255,1484,85119,65,202483
5388,0.001104,74.125.24.0-255,2902,88021,65,202483
5389,0.001106,172.31.40.0-255,66,88087,65,202483
5390,0.001137,74.125.24.0-255,7156,95243,65,202483
5391,0.001141,172.31.40.0-255,66,95309,65,202483
5392,0.001149,74.125.24.0-255,7156,102465,65,202483
5393,0.001151,172.31.40.0-255,66,102531,65,202483
5394,0.001178,74.125.24.0-255,5020,107551,65,202483
5395,0.001182,172.31.40.0-255,66,107617,65,202483
5396,0.001708,74.125.24.0-255,1484,109101,65,202483
5397,0.001715,74.125.24.0-255,2902,112003,65,202483
5398,0.001718,172.31.40.0-255,66,112069,65,202483
5399,0.001724,74.125.24.0-255,2902,114971,65,202483
5400,0.001726,172.31.40.0-255,66,115037,65,202483
5401,0.001748,74.125.24.0-255,2902,117939,65,202483
5402,0.00175,172.31.40.0-255,66,118005,65,202483
5403,0.001756,74.125.24.0-255,4320,122325,65,202483
5404,0.001758,172.31.40.0-255,66,122391,65,202483
5405,0.001804,172.31.40.0-255,66,122457,65,202483
5406,0.00182,172.31.40.0-255,66,122523,65,202483
5407,0.001823,74.125.24.0-255,766,123289,65,202483
5408,0.001968,74.125.24.0-255,1484,124773,65,202483
5409,0.001973,172.31.40.0-255,66,124839,65,202483
5410,0.001979,74.125.24.0-255,2902,127741,65,202483
5411,0.001981,172.31.40.0-255,66,127807,65,202483
5412,0.001985,74.125.24.0-255,2902,130709,65,202483
5413,0.001992,172.31.40.0-255,66,130775,65,202483
5414,0.00203,74.125.24.0-255,2902,133677,65,202483
5415,0.002033,172.31.40.0-255,66,133743,65,202483
5416,0.002052,172.31.40.0-255,66,133809,65,202483
5417,0.002065,172.31.40.0-255,66,133875,65,202483
5418,0.002076,74.125.24.0-255,1484,135359,65,202483
5419,0.002121,172.31.40.0-255,66,135425,65,202483
5420,0.002146,74.125.24.0-255,7156,142581,65,202483
5421,0.002149,172.31.40.0-255,66,142647,65,202483
5422,0.002161,172.31.40.0-255,66,142713,65,202483
5423,0.002172,172.31.40.0-255,66,142779,65,202483
5424,0.002217,172.31.40.0-255,66,142845,65,202483
5425,0.002221,74.125.24.0-255,2184,145029,65,202483
5426,0.002223,172.31.40.0-255,66,145095,65,202483
5427,0.002227,74.125.24.0-255,2902,147997,65,202483
5428,0.002229,172.31.40.0-255,66,148063,65,202483
5429,0.002259,74.125.24.0-255,7156,155219,65,202483
5430,0.002262,172.31.40.0-255,66,155285,65,202483
5431,0.002302,172.31.40.0-255,66,155351,65,202483
5432,0.002309,74.125.24.0-255,6438,161789,65,202483
5433,0.002311,172.31.40.0-255,66,161855,65,202483
5434,0.004587,74.125.24.0-255,5738,167593,65,202483
5435,0.004602,172.31.40.0-255,66,167659,65,202483
5436,0.006872,74.125.24.0-255,5738,173397,65,202483
5437,0.00689,172.31.40.0-255,66,173463,65,202483
5438,0.009163,74.125.24.0-255,5738,179201,65,202483
5439,0.009175,172.31.40.0-255,66,179267,65,202483
5440,0.011438,74.125.24.0-255,5738,185005,65,202483
5441,0.011442,172.31.40.0-255,66,185071,65,202483
5442,0.013723,74.125.24.0-255,5738,190809,65,202483
5443,0.013731,172.31.40.0-255,66,190875,65,202483
5444,0.016006,74.125.24.0-255,5738,196613,65,202483
5445,0.016023,172.31.40.0-255,66,196679,65,202483
5446,0.018301,74.125.24.0-255,5738,202417,65,202483
5447,0.018309,172.31.40.0-255,66,202483,65,202483
5448,0.0,216.58.203.0-255,66,66,65,66
5449,0.0,74.125.24.0-255,150,150,65,239698
5450,2.4e-05,172.31.40.0-255,66,216,65,239698
5451,3.1e-05,74.125.24.0-255,1484,1700,65,239698
5452,3.6e-05,172.31.40.0-255,66,1766,65,239698
5453,4.3e-05,74.125.24.0-255,2902,4668,65,239698
5454,5.5e-05,172.31.40.0-255,66,4734,65,239698
5455,6.3e-05,74.125.24.0-255,7156,11890,65,239698
5456,6.6e-05,172.31.40.0-255,66,11956,65,239698
5457,7e-05,74.125.24.0-255,1983,13939,65,239698
5458,7.3e-05,172.31.40.0-255,66,14005,65,239698
5459,0.000118,74.125.24.0-255,7156,21161,65,239698
5460,0.000121,172.31.40.0-255,66,21227,65,239698
5461,0.000128,74.125.24.0-255,7156,28383,65,239698
5462,0.000131,172.31.40.0-255,66,28449,65,239698
5463,0.000157,74.125.24.0-255,1484,29933,65,239698
5464,0.000159,172.31.40.0-255,66,29999,65,239698
5465,0.000164,74.125.24.0-255,1125,31124,65,239698
5466,0.000165,172.31.40.0-255,66,31190,65,239698
5467,0.000228,74.125.24.0-255,1484,32674,65,239698
5468,0.00023,172.31.40.0-255,66,32740,65,239698
5469,0.000235,74.125.24.0-255,2902,35642,65,239698
5470,0.000237,172.31.40.0-255,66,35708,65,239698
5471,0.000256,74.125.24.0-255,5738,41446,65,239698
5472,0.000258,172.31.40.0-255,66,41512,65,239698
5473,0.000289,74.125.24.0-255,6797,48309,65,239698
5474,0.000291,172.31.40.0-255,66,48375,65,239698
5475,0.000314,74.125.24.0-255,1484,49859,65,239698
5476,0.000316,172.31.40.0-255,66,49925,65,239698
5477,0.00032,74.125.24.0-255,2902,52827,65,239698
5478,0.000322,172.31.40.0-255,66,52893,65,239698
5479,0.000325,74.125.24.0-255,1484,54377,65,239698
5480,0.000327,172.31.40.0-255,66,54443,65,239698
5481,0.000348,74.125.24.0-255,4320,58763,65,239698
5482,0.00035,172.31.40.0-255,66,58829,65,239698
5483,0.000388,74.125.24.0-255,1484,60313,65,239698
5484,0.000407,74.125.24.0-255,5379,65692,65,239698
5485,0.00041,172.31.40.0-255,66,65758,65,239698
5486,0.000791,74.125.24.0-255,646,66404,65,239698
5487,0.000969,74.125.24.0-255,1484,67888,65,239698
5488,0.000974,172.31.40.0-255,66,67954,65,239698
5489,0.000979,74.125.24.0-255,2902,70856,65,239698
5490,0.000981,172.31.40.0-255,66,70922,65,239698
5491,0.000986,74.125.24.0-255,4320,75242,65,239698
5492,0.000988,172.31.40.0-255,66,75308,65,239698
5493,0.001016,74.125.24.0-255,1484,76792,65,239698
5494,0.001021,74.125.24.0-255,5738,82530,65,239698
5495,0.001027,172.31.40.0-255,66,82596,65,239698
5496,0.001061,74.125.24.0-255,7156,89752,65,239698
5497,0.001065,172.31.40.0-255,66,89818,65,239698
5498,0.001075,172.31.40.0-255,66,89884,65,239698
5499,0.001077,74.125.24.0-255,1484,91368,65,239698
5500,0.001097,74.125.24.0-255,766,92134,65,239698
5501,0.001099,172.31.40.0-255,66,92200,65,239698
5502,0.001334,74.125.24.0-255,1484,93684,65,239698
5503,0.001339,74.125.24.0-255,1484,95168,65,239698
5504,0.001342,172.31.40.0-255,66,95234,65,239698
5505,0.001378,74.125.24.0-255,1484,96718,65,239698
5506,0.001386,74.125.24.0-255,5738,102456,65,239698
5507,0.001388,172.31.40.0-255,66,102522,65,239698
5508,0.001396,74.125.24.0-255,7156,109678,65,239698
5509,0.001398,172.31.40.0-255,66,109744,65,239698
5510,0.001431,74.125.24.0-255,5738,115482,65,239698
5511,0.001433,172.31.40.0-255,66,115548,65,239698
5512,0.001492,172.31.40.0-255,66,115614,65,239698
5513,0.001517,74.125.24.0-255,1484,117098,65,239698
5514,0.001542,74.125.24.0-255,2902,120000,65,239698
5515,0.001546,172.31.40.0-255,66,120066,65,239698
5516,0.001553,74.125.24.0-255,5738,125804,65,239698
5517,0.001555,172.31.40.0-255,66,125870,65,239698
5518,0.001602,74.125.24.0-255,7156,133026,65,239698
5519,0.001607,172.31.40.0-255,66,133092,65,239698
5520,0.00161,172.31.40.0-255,66,133158,65,239698
5521,0.001646,74.125.24.0-255,3602,136760,65,239698
5522,0.001652,172.31.40.0-255,66,136826,65,239698
5523,0.001796,74.125.24.0-255,1484,138310,65,239698
5524,0.001801,74.125.24.0-255,1484,139794,65,239698
5525,0.001804,172.31.40.0-255,66,139860,65,239698
5526,0.001829,74.125.24.0-255,1484,141344,65,239698
5527,0.001836,74.125.24.0-255,5738,147082,65,239698
5528,0.001839,172.31.40.0-255,66,147148,65,239698
5529,0.001846,74.125.24.0-255,5738,152886,65,239698
5530,0.001847,172.31.40.0-255,66,152952,65,239698
5531,0.001877,74.125.24.0-255,2902,155854,65,239698
5532,0.001881,172.31.40.0-255,66,155920,65,239698
5533,0.001922,172.31.40.0-255,66,155986,65,239698
5534,0.002082,74.125.24.0-255,1484,157470,65,239698
5535,0.002088,74.125.24.0-255,2902,160372,65,239698
5536,0.002091,172.31.40.0-255,66,160438,65,239698
5537,0.002098,74.125.24.0-255,4320,164758,65,239698
5538,0.0021,172.31.40.0-255,66,164824,65,239698
5539,0.00213,74.125.24.0-255,1484,166308,65,239698
5540,0.002144,172.31.40.0-255,66,166374,65,239698
5541,0.002152,74.125.24.0-255,5738,172112,65,239698
5542,0.002154,172.31.40.0-255,66,172178,65,239698
5543,0.002182,74.125.24.0-255,5020,177198,65,239698
5544,0.002185,172.31.40.0-255,66,177264,65,239698
5545,0.002208,74.125.24.0-255,1484,178748,65,239698
5546,0.002212,74.125.24.0-255,2902,181650,65,239698
5547,0.002214,172.31.40.0-255,66,181716,65,239698
5548,0.00222,74.125.24.0-255,4320,186036,65,239698
5549,0.002222,172.31.40.0-255,66,186102,65,239698
5550,0.002239,74.125.24.0-255,1484,187586,65,239698
5551,0.002269,172.31.40.0-255,66,187652,65,239698
5552,0.002281,172.31.40.0-255,66,187718,65,239698
5553,0.002318,172.31.40.0-255,66,187784,65,239698
5554,0.002344,74.125.24.0-255,3602,191386,65,239698
5555,0.002347,172.31.40.0-255,66,191452,65,239698
5556,0.00236,172.31.40.0-255,66,191518,65,239698
5557,0.002375,172.31.40.0-255,66,191584,65,239698
5558,0.002409,74.125.24.0-255,4320,195904,65,239698
5559,0.002411,172.31.40.0-255,66,195970,65,239698
5560,0.002434,74.125.24.0-255,2902,198872,65,239698
5561,0.002437,172.31.40.0-255,66,198938,65,239698
5562,0.004747,74.125.24.0-255,2902,201840,65,239698
5563,0.004754,172.31.40.0-255,66,201906,65,239698
5564,0.004782,74.125.24.0-255,2902,204808,65,239698
5565,0.004784,172.31.40.0-255,66,204874,65,239698
5566,0.007126,74.125.24.0-255,5738,210612,65,239698
5567,0.007129,172.31.40.0-255,66,210678,65,239698
5568,0.00952,74.125.24.0-255,5738,216416,65,239698
5569,0.009528,172.31.40.0-255,66,216482,65,239698
5570,0.011895,74.125.24.0-255,5738,222220,65,239698
5571,0.011902,172.31.40.0-255,66,222286,65,239698
5572,0.014266,74.125.24.0-255,5738,228024,65,239698
5573,0.014273,172.31.40.0-255,66,228090,65,239698
5574,0.016621,74.125.24.0-255,5738,233828,65,239698
5575,0.016627,172.31.40.0-255,66,233894,65,239698
5576,0.019007,74.125.24.0-255,5738,239632,65,239698
5577,0.019014,172.31.40.0-255,66,239698,65,239698
5578,0.0,172.217.194.0-255,148,148,65,149920
5579,2.6e-05,172.31.40.0-255,66,214,65,149920
5580,3.2e-05,172.217.194.0-255,1484,1698,65,149920
5581,3.7e-05,172.31.40.0-255,66,1764,65,149920
5582,4.3e-05,172.217.194.0-255,2902,4666,65,149920
5583,4.7e-05,172.31.40.0-255,66,4732,65,149920
5584,6.2e-05,172.217.194.0-255,7156,11888,65,149920
5585,6.6e-05,172.31.40.0-255,66,11954,65,149920
5586,7e-05,172.217.194.0-255,1950,13904,65,149920
5587,7.2e-05,172.31.40.0-255,66,13970,65,149920
5588,0.000115,172.31.40.0-255,66,14036,65,149920
5589,0.000138,172.217.194.0-255,5379,19415,65,149920
5590,0.00014,172.31.40.0-255,66,19481,65,149920
5591,0.000199,172.217.194.0-255,1484,20965,65,149920
5592,0.000201,172.31.40.0-255,66,21031,65,149920
5593,0.000206,172.217.194.0-255,2902,23933,65,149920
5594,0.000209,172.31.40.0-255,66,23999,65,149920
5595,0.000271,172.217.194.0-255,5738,29737,65,149920
5596,0.000274,172.31.40.0-255,66,29803,65,149920
5597,0.000288,172.31.40.0-255,66,29869,65,149920
5598,0.0003,172.31.40.0-255,66,29935,65,149920
5599,0.000302,172.217.194.0-255,339,30274,65,149920
5600,0.000304,172.31.40.0-255,66,30340,65,149920
5601,0.000335,172.217.194.0-255,436,30776,65,149920
5602,0.000337,172.31.40.0-255,66,30842,65,149920
5603,0.000548,172.217.194.0-255,1484,32326,65,149920
5604,0.000554,172.31.40.0-255,66,32392,65,149920
5605,0.000559,172.217.194.0-255,2902,35294,65,149920
5606,0.000562,172.31.40.0-255,66,35360,65,149920
5607,0.000573,172.217.194.0-255,5738,41098,65,149920
5608,0.000576,172.31.40.0-255,66,41164,65,149920
5609,0.000582,172.217.194.0-255,5738,46902,65,149920
5610,0.000584,172.31.40.0-255,66,46968,65,149920
5611,0.00062,172.31.40.0-255,66,47034,65,149920
5612,0.000627,172.217.194.0-255,5020,52054,65,149920
5613,0.000629,172.31.40.0-255,66,52120,65,149920
5614,0.000863,172.217.194.0-255,1484,53604,65,149920
5615,0.000877,172.217.194.0-255,2902,56506,65,149920
5616,0.000881,172.31.40.0-255,66,56572,65,149920
5617,0.000888,172.217.194.0-255,5738,62310,65,149920
5618,0.00089,172.31.40.0-255,66,62376,65,149920
5619,0.000909,172.217.194.0-255,2902,65278,65,149920
5620,0.000911,172.31.40.0-255,66,65344,65,149920
5621,0.00098,172.217.194.0-255,2902,68246,65,149920
5622,0.001013,172.31.40.0-255,66,68312,65,149920
5623,0.001027,172.217.194.0-255,4320,72632,65,149920
5624,0.001038,172.217.194.0-255,6438,79070,65,149920
5625,0.001042,172.31.40.0-255,66,79136,65,149920
5626,0.001072,172.31.40.0-255,66,79202,65,149920
5627,0.001254,172.217.194.0-255,1484,80686,65,149920
5628,0.001262,172.217.194.0-255,2902,83588,65,149920
5629,0.001265,172.31.40.0-255,66,83654,65,149920
5630,0.001271,172.217.194.0-255,4320,87974,65,149920
5631,0.001289,172.217.194.0-255,1484,89458,65,149920
5632,0.001315,172.31.40.0-255,66,89524,65,149920
5633,0.001354,172.31.40.0-255,66,89590,65,149920
5634,0.001372,172.217.194.0-255,2184,91774,65,149920
5635,0.001383,172.31.40.0-255,66,91840,65,149920
5636,0.001793,172.217.194.0-255,1484,93324,65,149920
5637,0.0018,172.217.194.0-255,2902,96226,65,149920
5638,0.001804,172.31.40.0-255,66,96292,65,149920
5639,0.001815,172.217.194.0-255,1484,97776,65,149920
5640,0.00185,172.217.194.0-255,4320,102096,65,149920
5641,0.001924,172.31.40.0-255,66,102162,65,149920
5642,0.001975,172.217.194.0-255,1484,103646,65,149920
5643,0.001979,172.217.194.0-255,1484,105130,65,149920
5644,0.001985,172.31.40.0-255,66,105196,65,149920
5645,0.001996,172.217.194.0-255,1484,106680,65,149920
5646,0.002006,172.217.194.0-255,5738,112418,65,149920
5647,0.002044,172.31.40.0-255,66,112484,65,149920
5648,0.002073,172.217.194.0-255,2902,115386,65,149920
5649,0.002094,172.31.40.0-255,66,115452,65,149920
5650,0.002137,172.217.194.0-255,1484,116936,65,149920
5651,0.002143,172.217.194.0-255,2902,119838,65,149920
5652,0.002145,172.31.40.0-255,66,119904,65,149920
5653,0.002167,172.217.194.0-255,5738,125642,65,149920
5654,0.002173,172.31.40.0-255,66,125708,65,149920
5655,0.002213,172.217.194.0-255,4320,130028,65,149920
5656,0.002244,172.217.194.0-255,4320,134348,65,149920
5657,0.002254,172.31.40.0-255,66,134414,65,149920
5658,0.002261,172.217.194.0-255,7156,141570,65,149920
5659,0.002267,172.31.40.0-255,66,141636,65,149920
5660,0.00231,172.217.194.0-255,7156,148792,65,149920
5661,0.002319,172.31.40.0-255,66,148858,65,149920
5662,0.002388,172.31.40.0-255,66,148924,65,149920
5663,0.002417,172.31.40.0-255,66,148990,65,149920
5664,0.002477,172.31.40.0-255,66,149056,65,149920
5665,0.004791,172.217.194.0-255,168,149224,65,149920
5666,0.013735,172.31.40.0-255,105,149329,65,149920
5667,0.013784,172.31.40.0-255,105,149434,65,149920
5668,0.014021,172.31.40.0-255,90,149524,65,149920
5669,0.014032,172.31.40.0-255,66,149590,65,149920
5670,0.016064,172.217.194.0-255,66,149656,65,149920
5671,0.016088,172.217.194.0-255,66,149722,65,149920
5672,0.016332,172.217.194.0-255,66,149788,65,149920
5673,0.016346,172.217.194.0-255,66,149854,65,149920
5674,0.016352,172.31.40.0-255,66,149920,65,149920
5675,0.0,74.125.24.0-255,152,152,65,206917
5676,1.5e-05,172.31.40.0-255,66,218,65,206917
5677,2.2e-05,74.125.24.0-255,1484,1702,65,206917
5678,2.6e-05,172.31.40.0-255,66,1768,65,206917
5679,3.2e-05,74.125.24.0-255,2902,4670,65,206917
5680,3.5e-05,172.31.40.0-255,66,4736,65,206917
5681,4.3e-05,74.125.24.0-255,7156,11892,65,206917
5682,4.6e-05,172.31.40.0-255,66,11958,65,206917
5683,8.4e-05,172.31.40.0-255,66,12024,65,206917
5684,0.000104,74.125.24.0-255,2902,14926,65,206917
5685,0.000106,172.31.40.0-255,66,14992,65,206917
5686,0.000132,74.125.24.0-255,5738,20730,65,206917
5687,0.000134,172.31.40.0-255,66,20796,65,206917
5688,0.000153,172.31.40.0-255,66,20862,65,206917
5689,0.000156,74.125.24.0-255,766,21628,65,206917
5690,0.000159,172.31.40.0-255,66,21694,65,206917
5691,0.000198,172.31.40.0-255,66,21760,65,206917
5692,0.00024,74.125.24.0-255,5738,27498,65,206917
5693,0.000243,172.31.40.0-255,66,27564,65,206917
5694,0.000261,74.125.24.0-255,1423,28987,65,206917
5695,0.000264,172.31.40.0-255,66,29053,65,206917
5696,0.000282,74.125.24.0-255,131,29184,65,206917
5697,0.000284,172.31.40.0-255,66,29250,65,206917
5698,0.000384,74.125.24.0-255,1484,30734,65,206917
5699,0.000388,172.31.40.0-255,66,30800,65,206917
5700,0.000394,74.125.24.0-255,2902,33702,65,206917
5701,0.000397,172.31.40.0-255,66,33768,65,206917
5702,0.000414,74.125.24.0-255,4320,38088,65,206917
5703,0.000416,172.31.40.0-255,66,38154,65,206917
5704,0.000437,74.125.24.0-255,1484,39638,65,206917
5705,0.000457,74.125.24.0-255,4320,43958,65,206917
5706,0.00046,172.31.40.0-255,66,44024,65,206917
5707,0.000492,172.31.40.0-255,66,44090,65,206917
5708,0.000504,172.31.40.0-255,66,44156,65,206917
5709,0.000609,74.125.24.0-255,1484,45640,65,206917
5710,0.000623,74.125.24.0-255,2902,48542,65,206917
5711,0.000625,172.31.40.0-255,101,48643,65,206917
5712,0.000631,172.31.40.0-255,66,48709,65,206917
5713,0.000649,74.125.24.0-255,5738,54447,65,206917
5714,0.000654,172.31.40.0-255,66,54513,65,206917
5715,0.00066,74.125.24.0-255,7156,61669,65,206917
5716,0.000663,172.31.40.0-255,66,61735,65,206917
5717,0.00069,74.125.24.0-255,5738,67473,65,206917
5718,0.000694,74.125.24.0-255,4320,71793,65,206917
5719,0.000699,172.31.40.0-255,66,71859,65,206917
5720,0.000702,172.31.40.0-255,66,71925,65,206917
5721,0.000723,74.125.24.0-255,6438,78363,65,206917
5722,0.000727,172.31.40.0-255,66,78429,65,206917
5723,0.000741,74.125.24.0-255,1484,79913,65,206917
5724,0.000757,74.125.24.0-255,5738,85651,65,206917
5725,0.000761,172.31.40.0-255,66,85717,65,206917
5726,0.000788,172.31.40.0-255,66,85783,65,206917
5727,0.000824,74.125.24.0-255,4320,90103,65,206917
5728,0.000827,172.31.40.0-255,66,90169,65,206917
5729,0.000861,172.31.40.0-255,66,90235,65,206917
5730,0.001259,74.125.24.0-255,1484,91719,65,206917
5731,0.001282,74.125.24.0-255,2902,94621,65,206917
5732,0.001287,172.31.40.0-255,66,94687,65,206917
5733,0.001302,74.125.24.0-255,5738,100425,65,206917
5734,0.001305,172.31.40.0-255,66,100491,65,206917
5735,0.001335,172.31.40.0-255,66,100557,65,206917
5736,0.00135,74.125.24.0-255,2902,103459,65,206917
5737,0.001352,172.31.40.0-255,66,103525,65,206917
5738,0.001397,172.31.40.0-255,66,103591,65,206917
5739,0.001805,74.125.24.0-255,1484,105075,65,206917
5740,0.001811,74.125.24.0-255,2902,107977,65,206917
5741,0.001815,172.31.40.0-255,66,108043,65,206917
5742,0.001853,74.125.24.0-255,4320,112363,65,206917
5743,0.001856,172.31.40.0-255,66,112429,65,206917
5744,0.001869,74.125.24.0-255,1484,113913,65,206917
5745,0.001875,74.125.24.0-255,4320,118233,65,206917
5746,0.001877,172.31.40.0-255,66,118299,65,206917
5747,0.001889,172.31.40.0-255,66,118365,65,206917
5748,0.001896,74.125.24.0-255,7156,125521,65,206917
5749,0.001899,172.31.40.0-255,66,125587,65,206917
5750,0.001943,172.31.40.0-255,66,125653,65,206917
5751,0.001963,172.31.40.0-255,66,125719,65,206917
5752,0.001975,172.31.40.0-255,66,125785,65,206917
5753,0.002067,74.125.24.0-255,1484,127269,65,206917
5754,0.002072,74.125.24.0-255,2902,130171,65,206917
5755,0.002082,172.31.40.0-255,66,130237,65,206917
5756,0.002087,74.125.24.0-255,2902,133139,65,206917
5757,0.002088,172.31.40.0-255,66,133205,65,206917
5758,0.002106,74.125.24.0-255,2902,136107,65,206917
5759,0.00211,172.31.40.0-255,66,136173,65,206917
5760,0.002117,74.125.24.0-255,7156,143329,65,206917
5761,0.00212,172.31.40.0-255,66,143395,65,206917
5762,0.00214,74.125.24.0-255,5738,149133,65,206917
5763,0.002143,172.31.40.0-255,66,149199,65,206917
5764,0.002154,172.31.40.0-255,66,149265,65,206917
5765,0.002168,74.125.24.0-255,2184,151449,65,206917
5766,0.00217,172.31.40.0-255,66,151515,65,206917
5767,0.002269,74.125.24.0-255,1484,152999,65,206917
5768,0.002274,74.125.24.0-255,2902,155901,65,206917
5769,0.002277,172.31.40.0-255,66,155967,65,206917
5770,0.002281,74.125.24.0-255,1484,157451,65,206917
5771,0.002301,74.125.24.0-255,4320,161771,65,206917
5772,0.002304,172.31.40.0-255,66,161837,65,206917
5773,0.00231,74.125.24.0-255,4320,166157,65,206917
5774,0.002312,172.31.40.0-255,66,166223,65,206917
5775,0.002873,74.125.24.0-255,66,166289,65,206917
5776,0.004563,74.125.24.0-255,5738,172027,65,206917
5777,0.004571,172.31.40.0-255,66,172093,65,206917
5778,0.006844,74.125.24.0-255,5738,177831,65,206917
5779,0.006849,172.31.40.0-255,66,177897,65,206917
5780,0.009103,74.125.24.0-255,5738,183635,65,206917
5781,0.009108,172.31.40.0-255,66,183701,65,206917
5782,0.011379,74.125.24.0-255,5738,189439,65,206917
5783,0.011387,172.31.40.0-255,66,189505,65,206917
5784,0.01364,74.125.24.0-255,5738,195243,65,206917
5785,0.01365,172.31.40.0-255,66,195309,65,206917
5786,0.015902,74.125.24.0-255,5738,201047,65,206917
5787,0.015909,172.31.40.0-255,66,201113,65,206917
5788,0.018174,74.125.24.0-255,5738,206851,65,206917
5789,0.018186,172.31.40.0-255,66,206917,65,206917
5790,0.0,74.125.24.0-255,302,302,65,96998
5791,3e-05,172.31.40.0-255,66,368,65,96998
5792,3.7e-05,74.125.24.0-255,1484,1852,65,96998
5793,4.1e-05,172.31.40.0-255,66,1918,65,96998
5794,4.9e-05,74.125.24.0-255,4320,6238,65,96998
5795,5.3e-05,172.31.40.0-255,66,6304,65,96998
5796,9.5e-05,172.31.40.0-255,66,6370,65,96998
5797,0.000116,74.125.24.0-255,2902,9272,65,96998
5798,0.000119,172.31.40.0-255,66,9338,65,96998
5799,0.000136,74.125.24.0-255,5738,15076,65,96998
5800,0.000139,172.31.40.0-255,66,15142,65,96998
5801,0.000195,172.31.40.0-255,66,15208,65,96998
5802,0.000305,74.125.24.0-255,1484,16692,65,96998
5803,0.000308,172.31.40.0-255,66,16758,65,96998
5804,0.000312,74.125.24.0-255,1484,18242,65,96998
5805,0.000314,172.31.40.0-255,66,18308,65,96998
5806,0.000333,74.125.24.0-255,1484,19792,65,96998
5807,0.000335,172.31.40.0-255,66,19858,65,96998
5808,0.000343,74.125.24.0-255,5738,25596,65,96998
5809,0.000346,172.31.40.0-255,66,25662,65,96998
5810,0.000372,74.125.24.0-255,4320,29982,65,96998
5811,0.000375,172.31.40.0-255,66,30048,65,96998
5812,0.000402,172.31.40.0-255,66,30114,65,96998
5813,0.000418,74.125.24.0-255,2902,33016,65,96998
5814,0.00042,172.31.40.0-255,66,33082,65,96998
5815,0.000446,74.125.24.0-255,7109,40191,65,96998
5816,0.000449,172.31.40.0-255,66,40257,65,96998
5817,0.000452,74.125.24.0-255,111,40368,65,96998
5818,0.000454,172.31.40.0-255,66,40434,65,96998
5819,0.000626,74.125.24.0-255,330,40764,65,96998
5820,0.000973,74.125.24.0-255,1484,42248,65,96998
5821,0.000981,74.125.24.0-255,2902,45150,65,96998
5822,0.000996,74.125.24.0-255,5738,50888,65,96998
5823,0.001013,74.125.24.0-255,2902,53790,65,96998
5824,0.001036,74.125.24.0-255,4320,58110,65,96998
5825,0.001053,172.31.40.0-255,66,58176,65,96998
5826,0.001083,74.125.24.0-255,2902,61078,65,96998
5827,0.001089,172.31.40.0-255,66,61144,65,96998
5828,0.001103,74.125.24.0-255,3602,64746,65,96998
5829,0.00112,172.31.40.0-255,66,64812,65,96998
5830,0.001744,74.125.24.0-255,1484,66296,65,96998
5831,0.001752,74.125.24.0-255,1484,67780,65,96998
5832,0.001756,172.31.40.0-255,66,67846,65,96998
5833,0.00178,74.125.24.0-255,1484,69330,65,96998
5834,0.001787,74.125.24.0-255,5738,75068,65,96998
5835,0.001814,74.125.24.0-255,1484,76552,65,96998
5836,0.001838,74.125.24.0-255,1484,78036,65,96998
5837,0.01114,74.125.24.0-255,1484,79520,65,96998
5838,0.01296,172.31.40.0-255,66,79586,65,96998
5839,0.014996,74.125.24.0-255,5738,85324,65,96998
5840,0.015015,172.31.40.0-255,66,85390,65,96998
5841,0.01707,74.125.24.0-255,5738,91128,65,96998
5842,0.017087,172.31.40.0-255,66,91194,65,96998
5843,0.019117,74.125.24.0-255,5738,96932,65,96998
5844,0.019134,172.31.40.0-255,66,96998,65,96998
5845,0.0,74.125.24.0-255,143,143,65,207691
5846,1.6e-05,172.31.40.0-255,66,209,65,207691
5847,2.3e-05,74.125.24.0-255,1484,1693,65,207691
5848,2.8e-05,172.31.40.0-255,66,1759,65,207691
5849,3.4e-05,74.125.24.0-255,2902,4661,65,207691
5850,4.5e-05,172.31.40.0-255,66,4727,65,207691
5851,5.3e-05,74.125.24.0-255,7156,11883,65,207691
5852,5.7e-05,172.31.40.0-255,66,11949,65,207691
5853,7.4e-05,172.31.40.0-255,66,12015,65,207691
5854,7.8e-05,74.125.24.0-255,2543,14558,65,207691
5855,8.1e-05,172.31.40.0-255,66,14624,65,207691
5856,0.000117,74.125.24.0-255,1484,16108,65,207691
5857,0.00012,172.31.40.0-255,66,16174,65,207691
5858,0.000126,74.125.24.0-255,2902,19076,65,207691
5859,0.000128,172.31.40.0-255,66,19142,65,207691
5860,0.000132,74.125.24.0-255,1484,20626,65,207691
5861,0.000134,172.31.40.0-255,66,20692,65,207691
5862,0.000172,74.125.24.0-255,4320,25012,65,207691
5863,0.000175,172.31.40.0-255,66,25078,65,207691
5864,0.00018,74.125.24.0-255,4320,29398,65,207691
5865,0.000182,172.31.40.0-255,66,29464,65,207691
5866,0.000192,74.125.24.0-255,5379,34843,65,207691
5867,0.000194,172.31.40.0-255,66,34909,65,207691
5868,0.000198,74.125.24.0-255,1484,36393,65,207691
5869,0.000203,172.31.40.0-255,66,36459,65,207691
5870,0.000244,172.31.40.0-255,66,36525,65,207691
5871,0.000274,74.125.24.0-255,2821,39346,65,207691
5872,0.000276,172.31.40.0-255,66,39412,65,207691
5873,0.000438,74.125.24.0-255,377,39789,65,207691
5874,0.000442,172.31.40.0-255,66,39855,65,207691
5875,0.000604,74.125.24.0-255,1484,41339,65,207691
5876,0.000611,74.125.24.0-255,2902,44241,65,207691
5877,0.000614,172.31.40.0-255,66,44307,65,207691
5878,0.000618,74.125.24.0-255,1484,45791,65,207691
5879,0.000648,74.125.24.0-255,4320,50111,65,207691
5880,0.000651,172.31.40.0-255,66,50177,65,207691
5881,0.000654,74.125.24.0-255,1484,51661,65,207691
5882,0.000685,74.125.24.0-255,5379,57040,65,207691
5883,0.000689,172.31.40.0-255,66,57106,65,207691
5884,0.000697,74.125.24.0-255,7156,64262,65,207691
5885,0.000699,172.31.40.0-255,66,64328,65,207691
5886,0.000713,74.125.24.0-255,4320,68648,65,207691
5887,0.000721,172.31.40.0-255,66,68714,65,207691
5888,0.00075,74.125.24.0-255,5379,74093,65,207691
5889,0.000753,172.31.40.0-255,66,74159,65,207691
5890,0.000756,74.125.24.0-255,1484,75643,65,207691
5891,0.00078,74.125.24.0-255,2902,78545,65,207691
5892,0.000782,172.31.40.0-255,66,78611,65,207691
5893,0.000811,74.125.24.0-255,5738,84349,65,207691
5894,0.000814,172.31.40.0-255,66,84415,65,207691
5895,0.000817,74.125.24.0-255,1484,85899,65,207691
5896,0.000854,172.31.40.0-255,66,85965,65,207691
5897,0.000858,74.125.24.0-255,2902,88867,65,207691
5898,0.000861,172.31.40.0-255,66,88933,65,207691
5899,0.000905,172.31.40.0-255,66,88999,65,207691
5900,0.000908,74.125.24.0-255,1484,90483,65,207691
5901,0.000933,74.125.24.0-255,2902,93385,65,207691
5902,0.000935,172.31.40.0-255,66,93451,65,207691
5903,0.00094,74.125.24.0-255,2902,96353,65,207691
5904,0.000942,172.31.40.0-255,66,96419,65,207691
5905,0.000962,74.125.24.0-255,2902,99321,65,207691
5906,0.000965,172.31.40.0-255,66,99387,65,207691
5907,0.000979,172.31.40.0-255,66,99453,65,207691
5908,0.001,74.125.24.0-255,1484,100937,65,207691
5909,0.001022,74.125.24.0-255,4320,105257,65,207691
5910,0.001025,172.31.40.0-255,66,105323,65,207691
5911,0.001065,172.31.40.0-255,66,105389,65,207691
5912,0.001207,74.125.24.0-255,1484,106873,65,207691
5913,0.001213,74.125.24.0-255,2902,109775,65,207691
5914,0.001216,172.31.40.0-255,66,109841,65,207691
5915,0.001247,74.125.24.0-255,5738,115579,65,207691
5916,0.00125,172.31.40.0-255,66,115645,65,207691
5917,0.001268,74.125.24.0-255,2902,118547,65,207691
5918,0.00127,172.31.40.0-255,66,118613,65,207691
5919,0.001307,172.31.40.0-255,66,118679,65,207691
5920,0.001335,172.31.40.0-255,66,118745,65,207691
5921,0.001421,74.125.24.0-255,1484,120229,65,207691
5922,0.001438,74.125.24.0-255,2902,123131,65,207691
5923,0.001441,172.31.40.0-255,66,123197,65,207691
5924,0.00147,74.125.24.0-255,2902,126099,65,207691
5925,0.001473,172.31.40.0-255,66,126165,65,207691
5926,0.001476,74.125.24.0-255,1484,127649,65,207691
5927,0.001523,74.125.24.0-255,2902,130551,65,207691
5928,0.001536,74.125.24.0-255,5738,136289,65,207691
5929,0.001541,172.31.40.0-255,66,136355,65,207691
5930,0.001544,172.31.40.0-255,66,136421,65,207691
5931,0.001547,172.31.40.0-255,66,136487,65,207691
5932,0.001578,172.31.40.0-255,66,136553,65,207691
5933,0.001601,74.125.24.0-255,1484,138037,65,207691
5934,0.001606,74.125.24.0-255,2902,140939,65,207691
5935,0.001609,74.125.24.0-255,2902,143841,65,207691
5936,0.001615,172.31.40.0-255,66,143907,65,207691
5937,0.001642,74.125.24.0-255,2902,146809,65,207691
5938,0.001648,74.125.24.0-255,4320,151129,65,207691
5939,0.001665,74.125.24.0-255,1484,152613,65,207691
5940,0.001685,74.125.24.0-255,6438,159051,65,207691
5941,0.00169,172.31.40.0-255,66,159117,65,207691
5942,0.001733,74.125.24.0-255,1484,160601,65,207691
5943,0.001747,74.125.24.0-255,2902,163503,65,207691
5944,0.001759,172.31.40.0-255,66,163569,65,207691
5945,0.00177,74.125.24.0-255,5738,169307,65,207691
5946,0.001773,74.125.24.0-255,2902,172209,65,207691
5947,0.001785,172.31.40.0-255,66,172275,65,207691
5948,0.001796,74.125.24.0-255,7156,179431,65,207691
5949,0.001818,74.125.24.0-255,2902,182333,65,207691
5950,0.001844,172.31.40.0-255,66,182399,65,207691
5951,0.001855,172.31.40.0-255,66,182465,65,207691
5952,0.001898,74.125.24.0-255,1484,183949,65,207691
5953,0.001917,74.125.24.0-255,2902,186851,65,207691
5954,0.001932,74.125.24.0-255,4320,191171,65,207691
5955,0.001936,172.31.40.0-255,66,191237,65,207691
5956,0.001943,74.125.24.0-255,1484,192721,65,207691
5957,0.001945,74.125.24.0-255,1484,194205,65,207691
5958,0.00195,172.31.40.0-255,66,194271,65,207691
5959,0.002003,172.31.40.0-255,66,194337,65,207691
5960,0.002113,74.125.24.0-255,4320,198657,65,207691
5961,0.00213,172.31.40.0-255,66,198723,65,207691
5962,0.002156,74.125.24.0-255,4320,203043,65,207691
5963,0.002162,172.31.40.0-255,66,203109,65,207691
5964,0.002181,74.125.24.0-255,3586,206695,65,207691
5965,0.002184,74.125.24.0-255,105,206800,65,207691
5966,0.002187,74.125.24.0-255,129,206929,65,207691
5967,0.0022,172.31.40.0-255,66,206995,65,207691
5968,0.01637,172.31.40.0-255,105,207100,65,207691
5969,0.016424,172.31.40.0-255,105,207205,65,207691
5970,0.016703,172.31.40.0-255,90,207295,65,207691
5971,0.016722,172.31.40.0-255,66,207361,65,207691
5972,0.018697,74.125.24.0-255,66,207427,65,207691
5973,0.018722,74.125.24.0-255,66,207493,65,207691
5974,0.01902,74.125.24.0-255,66,207559,65,207691
5975,0.019045,74.125.24.0-255,66,207625,65,207691
5976,0.019065,172.31.40.0-255,66,207691,65,207691
5977,0.0,74.125.68.0-255,293,293,65,243780
5978,1.4e-05,172.31.40.0-255,66,359,65,243780
5979,2e-05,74.125.68.0-255,1484,1843,65,243780
5980,2.4e-05,172.31.40.0-255,66,1909,65,243780
5981,2.8e-05,74.125.68.0-255,2902,4811,65,243780
5982,3.1e-05,172.31.40.0-255,66,4877,65,243780
5983,5.8e-05,74.125.68.0-255,5738,10615,65,243780
5984,6e-05,172.31.40.0-255,66,10681,65,243780
5985,6.3e-05,74.125.68.0-255,1484,12165,65,243780
5986,6.5e-05,172.31.40.0-255,66,12231,65,243780
5987,9.3e-05,74.125.68.0-255,1796,14027,65,243780
5988,9.5e-05,172.31.40.0-255,66,14093,65,243780
5989,0.0001,74.125.68.0-255,4320,18413,65,243780
5990,0.000102,172.31.40.0-255,66,18479,65,243780
5991,0.000108,74.125.68.0-255,7156,25635,65,243780
5992,0.00011,172.31.40.0-255,66,25701,65,243780
5993,0.000127,74.125.68.0-255,2902,28603,65,243780
5994,0.000128,172.31.40.0-255,66,28669,65,243780
5995,0.000133,74.125.68.0-255,2543,31212,65,243780
5996,0.000135,172.31.40.0-255,66,31278,65,243780
5997,0.000227,74.125.68.0-255,1484,32762,65,243780
5998,0.00023,172.31.40.0-255,66,32828,65,243780
5999,0.000234,74.125.68.0-255,1484,34312,65,243780
6000,0.000236,172.31.40.0-255,66,34378,65,243780
6001,0.00025,74.125.68.0-255,1484,35862,65,243780
6002,0.000252,172.31.40.0-255,66,35928,65,243780
6003,0.000259,74.125.68.0-255,5738,41666,65,243780
6004,0.000261,172.31.40.0-255,66,41732,65,243780
6005,0.000264,74.125.68.0-255,2902,44634,65,243780
6006,0.000267,172.31.40.0-255,66,44700,65,243780
6007,0.000303,74.125.68.0-255,2902,47602,65,243780
6008,0.000305,172.31.40.0-255,66,47668,65,243780
6009,0.000326,74.125.68.0-255,7156,54824,65,243780
6010,0.000329,172.31.40.0-255,66,54890,65,243780
6011,0.000331,74.125.68.0-255,1484,56374,65,243780
6012,0.000333,172.31.40.0-255,66,56440,65,243780
6013,0.000374,74.125.68.0-255,4320,60760,65,243780
6014,0.000377,172.31.40.0-255,66,60826,65,243780
6015,0.000397,74.125.68.0-255,5020,65846,65,243780
6016,0.0004,172.31.40.0-255,66,65912,65,243780
6017,0.000402,74.125.68.0-255,442,66354,65,243780
6018,0.000404,172.31.40.0-255,66,66420,65,243780
6019,0.000506,74.125.68.0-255,1484,67904,65,243780
6020,0.00051,172.31.40.0-255,66,67970,65,243780
6021,0.00053,74.125.68.0-255,2902,70872,65,243780
6022,0.000534,74.125.68.0-255,4320,75192,65,243780
6023,0.000538,172.31.40.0-255,66,75258,65,243780
6024,0.000541,172.31.40.0-255,66,75324,65,243780
6025,0.000576,172.31.40.0-255,66,75390,65,243780
6026,0.000602,172.31.40.0-255,66,75456,65,243780
6027,0.000638,74.125.68.0-255,6438,81894,65,243780
6028,0.00064,172.31.40.0-255,66,81960,65,243780
6029,0.000643,74.125.68.0-255,332,82292,65,243780
6030,0.000726,74.125.68.0-255,1484,83776,65,243780
6031,0.000729,172.31.40.0-255,66,83842,65,243780
6032,0.000733,74.125.68.0-255,1484,85326,65,243780
6033,0.000746,74.125.68.0-255,1484,86810,65,243780
6034,0.000748,172.31.40.0-255,66,86876,65,243780
6035,0.000752,74.125.68.0-255,1484,88360,65,243780
6036,0.000771,74.125.68.0-255,4320,92680,65,243780
6037,0.000774,172.31.40.0-255,66,92746,65,243780
6038,0.000779,74.125.68.0-255,5738,98484,65,243780
6039,0.000781,172.31.40.0-255,66,98550,65,243780
6040,0.000796,74.125.68.0-255,7156,105706,65,243780
6041,0.000798,172.31.40.0-255,66,105772,65,243780
6042,0.000825,74.125.68.0-255,4320,110092,65,243780
6043,0.000828,172.31.40.0-255,66,110158,65,243780
6044,0.000847,74.125.68.0-255,6438,116596,65,243780
6045,0.000849,172.31.40.0-255,66,116662,65,243780
6046,0.001442,74.125.68.0-255,1484,118146,65,243780
6047,0.001456,74.125.68.0-255,2902,121048,65,243780
6048,0.001459,172.31.40.0-255,66,121114,65,243780
6049,0.001477,74.125.68.0-255,1484,122598,65,243780
6050,0.001495,74.125.68.0-255,4320,126918,65,243780
6051,0.001498,172.31.40.0-255,66,126984,65,243780
6052,0.001503,74.125.68.0-255,4320,131304,65,243780
6053,0.001505,172.31.40.0-255,66,131370,65,243780
6054,0.001521,74.125.68.0-255,2902,134272,65,243780
6055,0.001523,172.31.40.0-255,66,134338,65,243780
6056,0.001535,74.125.68.0-255,4320,138658,65,243780
6057,0.001537,172.31.40.0-255,66,138724,65,243780
6058,0.001556,74.125.68.0-255,4320,143044,65,243780
6059,0.001558,172.31.40.0-255,66,143110,65,243780
6060,0.001587,74.125.68.0-255,5738,148848,65,243780
6061,0.001591,172.31.40.0-255,66,148914,65,243780
6062,0.001611,74.125.68.0-255,2184,151098,65,243780
6063,0.001613,172.31.40.0-255,66,151164,65,243780
6064,0.001999,74.125.68.0-255,1484,152648,65,243780
6065,0.002005,74.125.68.0-255,1484,154132,65,243780
6066,0.002009,172.31.40.0-255,66,154198,65,243780
6067,0.002031,74.125.68.0-255,1484,155682,65,243780
6068,0.002037,74.125.68.0-255,5738,161420,65,243780
6069,0.002039,172.31.40.0-255,66,161486,65,243780
6070,0.002044,74.125.68.0-255,2902,164388,65,243780
6071,0.002046,172.31.40.0-255,66,164454,65,243780
6072,0.002066,74.125.68.0-255,1484,165938,65,243780
6073,0.002095,172.31.40.0-255,66,166004,65,243780
6074,0.0021,74.125.68.0-255,2902,168906,65,243780
6075,0.002102,172.31.40.0-255,66,168972,65,243780
6076,0.002141,74.125.68.0-255,1484,170456,65,243780
6077,0.002166,172.31.40.0-255,66,170522,65,243780
6078,0.002179,74.125.68.0-255,2184,172706,65,243780
6079,0.002181,172.31.40.0-255,66,172772,65,243780
6080,0.002192,172.31.40.0-255,66,172838,65,243780
6081,0.002224,74.125.68.0-255,7156,179994,65,243780
6082,0.002228,172.31.40.0-255,66,180060,65,243780
6083,0.002234,74.125.68.0-255,5738,185798,65,243780
6084,0.002236,172.31.40.0-255,66,185864,65,243780
6085,0.002239,74.125.68.0-255,1484,187348,65,243780
6086,0.002268,74.125.68.0-255,3602,190950,65,243780
6087,0.002271,172.31.40.0-255,66,191016,65,243780
6088,0.002299,74.125.68.0-255,1484,192500,65,243780
6089,0.00232,74.125.68.0-255,2902,195402,65,243780
6090,0.002323,172.31.40.0-255,66,195468,65,243780
6091,0.002328,74.125.68.0-255,2902,198370,65,243780
6092,0.00233,172.31.40.0-255,66,198436,65,243780
6093,0.002346,74.125.68.0-255,2902,201338,65,243780
6094,0.002348,172.31.40.0-255,66,201404,65,243780
6095,0.002358,74.125.68.0-255,2902,204306,65,243780
6096,0.00236,172.31.40.0-255,66,204372,65,243780
6097,0.004679,74.125.68.0-255,2902,207274,65,243780
6098,0.004689,172.31.40.0-255,66,207340,65,243780
6099,0.004711,74.125.68.0-255,2902,210242,65,243780
6100,0.004713,172.31.40.0-255,66,210308,65,243780
6101,0.007066,74.125.68.0-255,5738,216046,65,243780
6102,0.007072,172.31.40.0-255,66,216112,65,243780
6103,0.009403,74.125.68.0-255,4320,220432,65,243780
6104,0.009407,172.31.40.0-255,66,220498,65,243780
6105,0.009428,74.125.68.0-255,1484,221982,65,243780
6106,0.011757,74.125.68.0-255,4320,226302,65,243780
6107,0.01177,172.31.40.0-255,66,226368,65,243780
6108,0.014109,74.125.68.0-255,5738,232106,65,243780
6109,0.014116,172.31.40.0-255,66,232172,65,243780
6110,0.01646,74.125.68.0-255,5738,237910,65,243780
6111,0.016471,172.31.40.0-255,66,237976,65,243780
6112,0.018813,74.125.68.0-255,5738,243714,65,243780
6113,0.018824,172.31.40.0-255,66,243780,65,243780
6114,0.0,172.217.194.0-255,153,153,65,191064
6115,2.6e-05,172.31.40.0-255,66,219,65,191064
6116,3.3e-05,172.217.194.0-255,1484,1703,65,191064
6117,3.8e-05,172.31.40.0-255,66,1769,65,191064
6118,5.1e-05,172.217.194.0-255,2902,4671,65,191064
6119,5.5e-05,172.31.40.0-255,66,4737,65,191064
6120,6.3e-05,172.217.194.0-255,7156,11893,65,191064
6121,6.7e-05,172.31.40.0-255,66,11959,65,191064
6122,7.1e-05,172.217.194.0-255,1982,13941,65,191064
6123,7.5e-05,172.31.40.0-255,66,14007,65,191064
6124,8.2e-05,172.217.194.0-255,4320,18327,65,191064
6125,8.5e-05,172.31.40.0-255,66,18393,65,191064
6126,0.000109,172.217.194.0-255,2902,21295,65,191064
6127,0.000116,172.31.40.0-255,66,21361,65,191064
6128,0.000129,172.31.40.0-255,66,21427,65,191064
6129,0.000131,172.217.194.0-255,1125,22552,65,191064
6130,0.000134,172.31.40.0-255,66,22618,65,191064
6131,0.00018,172.217.194.0-255,1484,24102,65,191064
6132,0.000183,172.31.40.0-255,66,24168,65,191064
6133,0.000201,172.217.194.0-255,2902,27070,65,191064
6134,0.000204,172.31.40.0-255,66,27136,65,191064
6135,0.00021,172.217.194.0-255,5738,32874,65,191064
6136,0.000213,172.31.40.0-255,66,32940,65,191064
6137,0.000247,172.217.194.0-255,5738,38678,65,191064
6138,0.00025,172.31.40.0-255,66,38744,65,191064
6139,0.000285,172.31.40.0-255,66,38810,65,191064
6140,0.000293,172.217.194.0-255,7156,45966,65,191064
6141,0.000296,172.31.40.0-255,66,46032,65,191064
6142,0.000324,172.217.194.0-255,2543,48575,65,191064
6143,0.000327,172.31.40.0-255,66,48641,65,191064
6144,0.000329,172.217.194.0-255,381,49022,65,191064
6145,0.000394,172.217.194.0-255,1484,50506,65,191064
6146,0.0004,172.217.194.0-255,2902,53408,65,191064
6147,0.000422,172.217.194.0-255,5738,59146,65,191064
6148,0.000435,172.217.194.0-255,1484,60630,65,191064
6149,0.000492,172.217.194.0-255,4320,64950,65,191064
6150,0.000511,172.217.194.0-255,6734,71684,65,191064
6151,0.000654,172.31.40.0-255,66,71750,65,191064
6152,0.000792,172.217.194.0-255,1484,73234,65,191064
6153,0.000799,172.217.194.0-255,2902,76136,65,191064
6154,0.000804,172.217.194.0-255,4320,80456,65,191064
6155,0.000816,172.217.194.0-255,1484,81940,65,191064
6156,0.000819,172.217.194.0-255,1484,83424,65,191064
6157,0.000823,172.31.40.0-255,66,83490,65,191064
6158,0.000828,172.31.40.0-255,66,83556,65,191064
6159,0.000902,172.217.194.0-255,4320,87876,65,191064
6160,0.000905,172.217.194.0-255,1484,89360,65,191064
6161,0.000907,172.31.40.0-255,66,89426,65,191064
6162,0.000913,172.31.40.0-255,66,89492,65,191064
6163,0.000938,172.217.194.0-255,4320,93812,65,191064
6164,0.000974,172.217.194.0-255,2184,95996,65,191064
6165,0.000984,172.31.40.0-255,66,96062,65,191064
6166,0.001094,172.217.194.0-255,1484,97546,65,191064
6167,0.0011,172.217.194.0-255,2902,100448,65,191064
6168,0.001112,172.31.40.0-255,66,100514,65,191064
6169,0.001119,172.217.194.0-255,5738,106252,65,191064
6170,0.001123,172.31.40.0-255,66,106318,65,191064
6171,0.001138,172.217.194.0-255,4320,110638,65,191064
6172,0.001167,172.217.194.0-255,5738,116376,65,191064
6173,0.001187,172.31.40.0-255,66,116442,65,191064
6174,0.001208,172.217.194.0-255,5020,121462,65,191064
6175,0.001226,172.31.40.0-255,66,121528,65,191064
6176,0.001424,172.217.194.0-255,1484,123012,65,191064
6177,0.00143,172.217.194.0-255,2902,125914,65,191064
6178,0.001436,172.31.40.0-255,66,125980,65,191064
6179,0.001474,172.217.194.0-255,5738,131718,65,191064
6180,0.00148,172.217.194.0-255,4320,136038,65,191064
6181,0.001514,172.217.194.0-255,1484,137522,65,191064
6182,0.001527,172.31.40.0-255,66,137588,65,191064
6183,0.001563,172.31.40.0-255,66,137654,65,191064
6184,0.001758,172.217.194.0-255,1484,139138,65,191064
6185,0.00178,172.217.194.0-255,2902,142040,65,191064
6186,0.001787,172.217.194.0-255,5738,147778,65,191064
6187,0.001802,172.31.40.0-255,66,147844,65,191064
6188,0.001815,172.217.194.0-255,5738,153582,65,191064
6189,0.001843,172.217.194.0-255,7156,160738,65,191064
6190,0.001864,172.217.194.0-255,2184,162922,65,191064
6191,0.001872,172.31.40.0-255,66,162988,65,191064
6192,0.00192,172.217.194.0-255,2902,165890,65,191064
6193,0.00193,172.31.40.0-255,66,165956,65,191064
6194,0.001951,172.217.194.0-255,4320,170276,65,191064
6195,0.001978,172.217.194.0-255,4320,174596,65,191064
6196,0.001983,172.31.40.0-255,66,174662,65,191064
6197,0.002029,172.217.194.0-255,7156,181818,65,191064
6198,0.002054,172.217.194.0-255,1484,183302,65,191064
6199,0.002061,172.31.40.0-255,66,183368,65,191064
6200,0.002088,172.217.194.0-255,5738,189106,65,191064
6201,0.002122,172.31.40.0-255,66,189172,65,191064
6202,0.002159,172.217.194.0-255,1484,190656,65,191064
6203,0.002195,172.31.40.0-255,66,190722,65,191064
6204,0.002241,172.217.194.0-255,105,190827,65,191064
6205,0.002281,172.31.40.0-255,66,190893,65,191064
6206,0.008836,172.31.40.0-255,105,190998,65,191064
6207,0.011385,172.217.194.0-255,66,191064,65,191064
6208,0.0,74.125.24.0-255,150,150,65,242185
6209,2.9e-05,172.31.40.0-255,66,216,65,242185
6210,3.7e-05,74.125.24.0-255,1484,1700,65,242185
6211,4.1e-05,172.31.40.0-255,66,1766,65,242185
6212,5.6e-05,74.125.24.0-255,2902,4668,65,242185
6213,6e-05,172.31.40.0-255,66,4734,65,242185
6214,6.7e-05,74.125.24.0-255,5738,10472,65,242185
6215,7e-05,172.31.40.0-255,66,10538,65,242185
6216,8.6e-05,172.31.40.0-255,66,10604,65,242185
6217,9e-05,74.125.24.0-255,2902,13506,65,242185
6218,9.3e-05,172.31.40.0-255,66,13572,65,242185
6219,0.000116,74.125.24.0-255,1484,15056,65,242185
6220,0.000118,172.31.40.0-255,66,15122,65,242185
6221,0.000149,74.125.24.0-255,2543,17665,65,242185
6222,0.000152,172.31.40.0-255,66,17731,65,242185
6223,0.000159,74.125.24.0-255,4320,22051,65,242185
6224,0.000161,172.31.40.0-255,66,22117,65,242185
6225,0.000193,74.125.24.0-255,5738,27855,65,242185
6226,0.000195,172.31.40.0-255,66,27921,65,242185
6227,0.000223,74.125.24.0-255,6797,34718,65,242185
6228,0.000225,172.31.40.0-255,66,34784,65,242185
6229,0.000393,74.125.24.0-255,1484,36268,65,242185
6230,0.000397,172.31.40.0-255,66,36334,65,242185
6231,0.000402,74.125.24.0-255,2902,39236,65,242185
6232,0.000404,172.31.40.0-255,66,39302,65,242185
6233,0.000407,74.125.24.0-255,1484,40786,65,242185
6234,0.000408,172.31.40.0-255,66,40852,65,242185
6235,0.000444,74.125.24.0-255,4320,45172,65,242185
6236,0.000446,172.31.40.0-255,66,45238,65,242185
6237,0.000451,74.125.24.0-255,4320,49558,65,242185
6238,0.000453,172.31.40.0-255,66,49624,65,242185
6239,0.000482,74.125.24.0-255,5379,55003,65,242185
6240,0.000485,172.31.40.0-255,66,55069,65,242185
6241,0.000489,74.125.24.0-255,2902,57971,65,242185
6242,0.000491,172.31.40.0-255,66,58037,65,242185
6243,0.000518,74.125.24.0-255,2902,60939,65,242185
6244,0.00052,172.31.40.0-255,66,61005,65,242185
6245,0.000523,74.125.24.0-255,1484,62489,65,242185
6246,0.000549,74.125.24.0-255,6797,69286,65,242185
6247,0.000551,172.31.40.0-255,66,69352,65,242185
6248,0.000617,74.125.24.0-255,1484,70836,65,242185
6249,0.000634,74.125.24.0-255,2902,73738,65,242185
6250,0.000637,172.31.40.0-255,66,73804,65,242185
6251,0.000641,74.125.24.0-255,2902,76706,65,242185
6252,0.000643,172.31.40.0-255,66,76772,65,242185
6253,0.000666,74.125.24.0-255,2902,79674,65,242185
6254,0.000668,172.31.40.0-255,66,79740,65,242185
6255,0.000671,74.125.24.0-255,1484,81224,65,242185
6256,0.000705,74.125.24.0-255,5379,86603,65,242185
6257,0.000708,172.31.40.0-255,66,86669,65,242185
6258,0.001091,74.125.24.0-255,1484,88153,65,242185
6259,0.001112,74.125.24.0-255,2902,91055,65,242185
6260,0.001115,172.31.40.0-255,66,91121,65,242185
6261,0.001138,74.125.24.0-255,5738,96859,65,242185
6262,0.00114,172.31.40.0-255,66,96925,65,242185
6263,0.001144,74.125.24.0-255,2902,99827,65,242185
6264,0.001145,172.31.40.0-255,66,99893,65,242185
6265,0.001208,74.125.24.0-255,2902,102795,65,242185
6266,0.00121,172.31.40.0-255,66,102861,65,242185
6267,0.001236,74.125.24.0-255,7156,110017,65,242185
6268,0.001238,172.31.40.0-255,66,110083,65,242185
6269,0.001242,74.125.24.0-255,2902,112985,65,242185
6270,0.001243,172.31.40.0-255,66,113051,65,242185
6271,0.00126,74.125.24.0-255,4320,117371,65,242185
6272,0.001262,172.31.40.0-255,66,117437,65,242185
6273,0.001285,74.125.24.0-255,3602,121039,65,242185
6274,0.001289,172.31.40.0-255,66,121105,65,242185
6275,0.00194,74.125.24.0-255,1484,122589,65,242185
6276,0.00197,74.125.24.0-255,2902,125491,65,242185
6277,0.001974,172.31.40.0-255,66,125557,65,242185
6278,0.001981,74.125.24.0-255,5738,131295,65,242185
6279,0.001983,172.31.40.0-255,66,131361,65,242185
6280,0.001999,172.31.40.0-255,66,131427,65,242185
6281,0.002032,172.31.40.0-255,66,131493,65,242185
6282,0.002296,74.125.24.0-255,1484,132977,65,242185
6283,0.002303,74.125.24.0-255,2902,135879,65,242185
6284,0.002306,172.31.40.0-255,66,135945,65,242185
6285,0.002333,74.125.24.0-255,5738,141683,65,242185
6286,0.002335,172.31.40.0-255,66,141749,65,242185
6287,0.002359,74.125.24.0-255,2902,144651,65,242185
6288,0.002361,172.31.40.0-255,66,144717,65,242185
6289,0.002397,74.125.24.0-255,7156,151873,65,242185
6290,0.0024,172.31.40.0-255,66,151939,65,242185
6291,0.002405,74.125.24.0-255,5738,157677,65,242185
6292,0.002407,172.31.40.0-255,66,157743,65,242185
6293,0.00241,74.125.24.0-255,1484,159227,65,242185
6294,0.002416,74.125.24.0-255,1484,160711,65,242185
6295,0.002418,172.31.40.0-255,66,160777,65,242185
6296,0.002442,74.125.24.0-255,1484,162261,65,242185
6297,0.002446,74.125.24.0-255,2902,165163,65,242185
6298,0.002448,172.31.40.0-255,66,165229,65,242185
6299,0.00245,74.125.24.0-255,766,165995,65,242185
6300,0.002705,74.125.24.0-255,1484,167479,65,242185
6301,0.00271,172.31.40.0-255,66,167545,65,242185
6302,0.002716,74.125.24.0-255,2902,170447,65,242185
6303,0.002717,172.31.40.0-255,66,170513,65,242185
6304,0.002723,74.125.24.0-255,5738,176251,65,242185
6305,0.002725,172.31.40.0-255,66,176317,65,242185
6306,0.002782,172.31.40.0-255,66,176383,65,242185
6307,0.002787,74.125.24.0-255,2902,179285,65,242185
6308,0.002788,172.31.40.0-255,66,179351,65,242185
6309,0.002791,74.125.24.0-255,1484,180835,65,242185
6310,0.002794,74.125.24.0-255,1484,182319,65,242185
6311,0.002796,172.31.40.0-255,66,182385,65,242185
6312,0.002802,74.125.24.0-255,5020,187405,65,242185
6313,0.002804,172.31.40.0-255,66,187471,65,242185
6314,0.002924,74.125.24.0-255,1484,188955,65,242185
6315,0.002929,74.125.24.0-255,1484,190439,65,242185
6316,0.002933,172.31.40.0-255,66,190505,65,242185
6317,0.002957,74.125.24.0-255,1484,191989,65,242185
6318,0.002961,74.125.24.0-255,2902,194891,65,242185
6319,0.002963,172.31.40.0-255,66,194957,65,242185
6320,0.002968,74.125.24.0-255,4320,199277,65,242185
6321,0.00297,172.31.40.0-255,66,199343,65,242185
6322,0.003014,74.125.24.0-255,5738,205081,65,242185
6323,0.003016,172.31.40.0-255,66,205147,65,242185
6324,0.003028,172.31.40.0-255,66,205213,65,242185
6325,0.003033,74.125.24.0-255,5020,210233,65,242185
6326,0.003035,172.31.40.0-255,66,210299,65,242185
6327,0.003038,74.125.24.0-255,1484,211783,65,242185
6328,0.003069,74.125.24.0-255,2902,214685,65,242185
6329,0.003071,172.31.40.0-255,66,214751,65,242185
6330,0.003077,74.125.24.0-255,5738,220489,65,242185
6331,0.003079,172.31.40.0-255,66,220555,65,242185
6332,0.003091,172.31.40.0-255,66,220621,65,242185
6333,0.003125,74.125.24.0-255,5738,226359,65,242185
6334,0.003127,172.31.40.0-255,66,226425,65,242185
6335,0.003146,74.125.24.0-255,2902,229327,65,242185
6336,0.003148,172.31.40.0-255,66,229393,65,242185
6337,0.003162,172.31.40.0-255,66,229459,65,242185
6338,0.003204,172.31.40.0-255,66,229525,65,242185
6339,0.003216,172.31.40.0-255,66,229591,65,242185
6340,0.003231,172.31.40.0-255,66,229657,65,242185
6341,0.003267,172.31.40.0-255,66,229723,65,242185
6342,0.00327,74.125.24.0-255,766,230489,65,242185
6343,0.003305,74.125.24.0-255,1484,231973,65,242185
6344,0.003307,172.31.40.0-255,66,232039,65,242185
6345,0.003347,172.31.40.0-255,66,232105,65,242185
6346,0.003354,74.125.24.0-255,7156,239261,65,242185
6347,0.003356,172.31.40.0-255,66,239327,65,242185
6348,0.003387,74.125.24.0-255,766,240093,65,242185
6349,0.00339,74.125.24.0-255,1096,241189,65,242185
6350,0.003448,74.125.24.0-255,105,241294,65,242185
6351,0.003474,74.125.24.0-255,129,241423,65,242185
6352,0.006435,172.31.40.0-255,66,241489,65,242185
6353,0.009232,172.31.40.0-255,105,241594,65,242185
6354,0.009276,172.31.40.0-255,105,241699,65,242185
6355,0.009555,172.31.40.0-255,90,241789,65,242185
6356,0.009565,172.31.40.0-255,66,241855,65,242185
6357,0.011462,74.125.24.0-255,66,241921,65,242185
6358,0.011515,74.125.24.0-255,66,241987,65,242185
6359,0.011781,74.125.24.0-255,66,242053,65,242185
6360,0.011814,74.125.24.0-255,66,242119,65,242185
6361,0.01182,172.31.40.0-255,66,242185,65,242185
6362,0.0,74.125.200.0-255,156,156,65,200613
6363,2e-05,172.31.40.0-255,66,222,65,200613
6364,2.8e-05,74.125.200.0-255,1484,1706,65,200613
6365,3.3e-05,172.31.40.0-255,66,1772,65,200613
6366,3.9e-05,74.125.200.0-255,2902,4674,65,200613
6367,4.2e-05,172.31.40.0-255,66,4740,65,200613
6368,4.8e-05,74.125.200.0-255,4320,9060,65,200613
6369,5.1e-05,172.31.40.0-255,66,9126,65,200613
6370,8.4e-05,74.125.200.0-255,2902,12028,65,200613
6371,8.7e-05,172.31.40.0-255,66,12094,65,200613
6372,0.000109,74.125.200.0-255,3458,15552,65,200613
6373,0.000112,172.31.40.0-255,66,15618,65,200613
6374,0.000133,74.125.200.0-255,7156,22774,65,200613
6375,0.000136,172.31.40.0-255,66,22840,65,200613
6376,0.000191,74.125.200.0-255,4320,27160,65,200613
6377,0.000195,172.31.40.0-255,66,27226,65,200613
6378,0.000216,74.125.200.0-255,3961,31187,65,200613
6379,0.000219,172.31.40.0-255,66,31253,65,200613
6380,0.000263,74.125.200.0-255,2902,34155,65,200613
6381,0.000267,172.31.40.0-255,66,34221,65,200613
6382,0.000289,74.125.200.0-255,5738,39959,65,200613
6383,0.000292,172.31.40.0-255,66,40025,65,200613
6384,0.000346,74.125.200.0-255,4320,44345,65,200613
6385,0.00035,172.31.40.0-255,66,44411,65,200613
6386,0.000364,74.125.200.0-255,5738,50149,65,200613
6387,0.000367,172.31.40.0-255,66,50215,65,200613
6388,0.000435,74.125.200.0-255,4320,54535,65,200613
6389,0.000438,172.31.40.0-255,66,54601,65,200613
6390,0.000461,74.125.200.0-255,7156,61757,65,200613
6391,0.000465,172.31.40.0-255,66,61823,65,200613
6392,0.000547,74.125.200.0-255,3892,65715,65,200613
6393,0.000551,172.31.40.0-255,66,65781,65,200613
6394,0.0006,74.125.200.0-255,136,65917,65,200613
6395,0.000757,74.125.200.0-255,1484,67401,65,200613
6396,0.000761,172.31.40.0-255,66,67467,65,200613
6397,0.000766,74.125.200.0-255,1484,68951,65,200613
6398,0.000779,74.125.200.0-255,1484,70435,65,200613
6399,0.000781,172.31.40.0-255,66,70501,65,200613
6400,0.000784,74.125.200.0-255,1484,71985,65,200613
6401,0.000812,74.125.200.0-255,2902,74887,65,200613
6402,0.000815,172.31.40.0-255,66,74953,65,200613
6403,0.000821,74.125.200.0-255,4320,79273,65,200613
6404,0.000823,172.31.40.0-255,66,79339,65,200613
6405,0.000837,74.125.200.0-255,1484,80823,65,200613
6406,0.00087,74.125.200.0-255,1484,82307,65,200613
6407,0.000874,172.31.40.0-255,66,82373,65,200613
6408,0.000887,74.125.200.0-255,2902,85275,65,200613
6409,0.000889,172.31.40.0-255,66,85341,65,200613
6410,0.000959,74.125.200.0-255,2902,88243,65,200613
6411,0.000963,172.31.40.0-255,66,88309,65,200613
6412,0.001016,74.125.200.0-255,1484,89793,65,200613
6413,0.001035,74.125.200.0-255,2902,92695,65,200613
6414,0.001039,172.31.40.0-255,66,92761,65,200613
6415,0.001056,74.125.200.0-255,2902,95663,65,200613
6416,0.001059,172.31.40.0-255,66,95729,65,200613
6417,0.00108,74.125.200.0-255,1484,97213,65,200613
6418,0.001101,74.125.200.0-255,2902,100115,65,200613
6419,0.001106,172.31.40.0-255,66,100181,65,200613
6420,0.001129,74.125.200.0-255,766,100947,65,200613
6421,0.001272,74.125.200.0-255,1484,102431,65,200613
6422,0.001276,172.31.40.0-255,66,102497,65,200613
6423,0.00128,74.125.200.0-255,1484,103981,65,200613
6424,0.001295,74.125.200.0-255,1484,105465,65,200613
6425,0.001297,172.31.40.0-255,66,105531,65,200613
6426,0.001312,74.125.200.0-255,1484,107015,65,200613
6427,0.001325,74.125.200.0-255,2902,109917,65,200613
6428,0.001328,172.31.40.0-255,66,109983,65,200613
6429,0.001397,74.125.200.0-255,2902,112885,65,200613
6430,0.0014,172.31.40.0-255,66,112951,65,200613
6431,0.001415,74.125.200.0-255,5738,118689,65,200613
6432,0.001417,172.31.40.0-255,66,118755,65,200613
6433,0.001422,74.125.200.0-255,2902,121657,65,200613
6434,0.001425,172.31.40.0-255,66,121723,65,200613
6435,0.001445,74.125.200.0-255,7156,128879,65,200613
6436,0.001448,172.31.40.0-255,66,128945,65,200613
6437,0.001506,74.125.200.0-255,1484,130429,65,200613
6438,0.001511,74.125.200.0-255,2902,133331,65,200613
6439,0.001515,172.31.40.0-255,66,133397,65,200613
6440,0.001536,74.125.200.0-255,2184,135581,65,200613
6441,0.001539,172.31.40.0-255,66,135647,65,200613
6442,0.001557,74.125.200.0-255,2902,138549,65,200613
6443,0.001559,172.31.40.0-255,66,138615,65,200613
6444,0.001582,74.125.200.0-255,2902,141517,65,200613
6445,0.001585,172.31.40.0-255,66,141583,65,200613
6446,0.001605,74.125.200.0-255,1484,143067,65,200613
6447,0.001628,74.125.200.0-255,4320,147387,65,200613
6448,0.001631,172.31.40.0-255,66,147453,65,200613
6449,0.001649,74.125.200.0-255,4320,151773,65,200613
6450,0.001652,172.31.40.0-255,66,151839,65,200613
6451,0.001712,74.125.200.0-255,4320,156159,65,200613
6452,0.001716,172.31.40.0-255,66,156225,65,200613
6453,0.001767,172.31.40.0-255,66,156291,65,200613
6454,0.001887,172.31.40.0-255,66,156357,65,200613
6455,0.001926,172.31.40.0-255,66,156423,65,200613
6456,0.002055,74.125.200.0-255,2902,159325,65,200613
6457,0.00206,172.31.40.0-255,66,159391,65,200613
6458,0.002084,74.125.200.0-255,5738,165129,65,200613
6459,0.002087,172.31.40.0-255,66,165195,65,200613
6460,0.00213,74.125.200.0-255,4320,169515,65,200613
6461,0.002134,172.31.40.0-255,66,169581,65,200613
6462,0.002159,74.125.200.0-255,5020,174601,65,200613
6463,0.002162,172.31.40.0-255,66,174667,65,200613
6464,0.002217,74.125.200.0-255,2902,177569,65,200613
6465,0.00222,172.31.40.0-255,66,177635,65,200613
6466,0.002269,172.31.40.0-255,66,177701,65,200613
6467,0.002359,74.125.200.0-255,2902,180603,65,200613
6468,0.002363,172.31.40.0-255,66,180669,65,200613
6469,0.002458,74.125.200.0-255,3884,184553,65,200613
6470,0.00279,74.125.200.0-255,2902,187455,65,200613
6471,0.014077,74.125.200.0-255,1484,188939,65,200613
6472,0.01436,172.31.40.0-255,66,189005,65,200613
6473,0.01697,74.125.200.0-255,5738,194743,65,200613
6474,0.016977,172.31.40.0-255,66,194809,65,200613
6475,0.019568,74.125.200.0-255,5738,200547,65,200613
6476,0.019578,172.31.40.0-255,66,200613,65,200613
6477,0.0,172.217.194.0-255,156,156,65,231872
6478,2.5e-05,172.31.40.0-255,66,222,65,231872
6479,3.2e-05,172.217.194.0-255,1484,1706,65,231872
6480,3.6e-05,172.31.40.0-255,66,1772,65,231872
6481,4.2e-05,172.217.194.0-255,2902,4674,65,231872
6482,4.5e-05,172.31.40.0-255,66,4740,65,231872
6483,5e-05,172.217.194.0-255,5738,10478,65,231872
6484,5.3e-05,172.31.40.0-255,66,10544,65,231872
6485,7.6e-05,172.217.194.0-255,1484,12028,65,231872
6486,7.8e-05,172.31.40.0-255,66,12094,65,231872
6487,0.000105,172.31.40.0-255,66,12160,65,231872
6488,0.000144,172.31.40.0-255,66,12226,65,231872
6489,0.00016,172.217.194.0-255,1125,13351,65,231872
6490,0.000161,172.31.40.0-255,66,13417,65,231872
6491,0.000267,172.217.194.0-255,1484,14901,65,231872
6492,0.00027,172.31.40.0-255,66,14967,65,231872
6493,0.000275,172.217.194.0-255,2902,17869,65,231872
6494,0.000277,172.31.40.0-255,66,17935,65,231872
6495,0.000309,172.217.194.0-255,5738,23673,65,231872
6496,0.000311,172.31.40.0-255,66,23739,65,231872
6497,0.000315,172.217.194.0-255,2902,26641,65,231872
6498,0.000317,172.31.40.0-255,66,26707,65,231872
6499,0.000342,172.31.40.0-255,66,26773,65,231872
6500,0.000345,172.217.194.0-255,1484,28257,65,231872
6501,0.000346,172.31.40.0-255,66,28323,65,231872
6502,0.000368,172.217.194.0-255,7156,35479,65,231872
6503,0.00037,172.31.40.0-255,66,35545,65,231872
6504,0.000389,172.217.194.0-255,1379,36924,65,231872
6505,0.000391,172.31.40.0-255,66,36990,65,231872
6506,0.000419,172.217.194.0-255,401,37391,65,231872
6507,0.00052,172.217.194.0-255,1484,38875,65,231872
6508,0.000525,172.217.194.0-255,2902,41777,65,231872
6509,0.000533,172.31.40.0-255,66,41843,65,231872
6510,0.000543,172.217.194.0-255,2902,44745,65,231872
6511,0.000553,172.217.194.0-255,2902,47647,65,231872
6512,0.000566,172.217.194.0-255,4320,51967,65,231872
6513,0.000576,172.31.40.0-255,66,52033,65,231872
6514,0.000592,172.31.40.0-255,66,52099,65,231872
6515,0.000606,172.217.194.0-255,5738,57837,65,231872
6516,0.000615,172.31.40.0-255,66,57903,65,231872
6517,0.000624,172.217.194.0-255,3961,61864,65,231872
6518,0.000628,172.31.40.0-255,66,61930,65,231872
6519,0.000795,172.217.194.0-255,1484,63414,65,231872
6520,0.0008,172.217.194.0-255,2902,66316,65,231872
6521,0.000804,172.217.194.0-255,2902,69218,65,231872
6522,0.000819,172.217.194.0-255,2902,72120,65,231872
6523,0.000825,172.217.194.0-255,5738,77858,65,231872
6524,0.000832,172.31.40.0-255,66,77924,65,231872
6525,0.000853,172.217.194.0-255,7156,85080,65,231872
6526,0.000878,172.217.194.0-255,766,85846,65,231872
6527,0.000881,172.31.40.0-255,66,85912,65,231872
6528,0.000941,172.217.194.0-255,1484,87396,65,231872
6529,0.000945,172.217.194.0-255,2902,90298,65,231872
6530,0.000965,172.217.194.0-255,1484,91782,65,231872
6531,0.000972,172.31.40.0-255,66,91848,65,231872
6532,0.000987,172.217.194.0-255,4320,96168,65,231872
6533,0.001003,172.217.194.0-255,1484,97652,65,231872
6534,0.001006,172.31.40.0-255,66,97718,65,231872
6535,0.00105,172.217.194.0-255,1484,99202,65,231872
6536,0.001054,172.31.40.0-255,66,99268,65,231872
6537,0.001091,172.31.40.0-255,66,99334,65,231872
6538,0.001107,172.217.194.0-255,1484,100818,65,231872
6539,0.001112,172.217.194.0-255,2902,103720,65,231872
6540,0.001116,172.217.194.0-255,2902,106622,65,231872
6541,0.001119,172.31.40.0-255,66,106688,65,231872
6542,0.00113,172.217.194.0-255,2902,109590,65,231872
6543,0.001141,172.217.194.0-255,2902,112492,65,231872
6544,0.001146,172.31.40.0-255,66,112558,65,231872
6545,0.001156,172.217.194.0-255,4320,116878,65,231872
6546,0.001188,172.217.194.0-255,2902,119780,65,231872
6547,0.001191,172.217.194.0-255,2184,121964,65,231872
6548,0.001193,172.31.40.0-255,66,122030,65,231872
6549,0.001198,172.31.40.0-255,66,122096,65,231872
6550,0.001231,172.217.194.0-255,2902,124998,65,231872
6551,0.00125,172.31.40.0-255,66,125064,65,231872
6552,0.001264,172.217.194.0-255,4320,129384,65,231872
6553,0.001274,172.31.40.0-255,66,129450,65,231872
6554,0.001292,172.217.194.0-255,5738,135188,65,231872
6555,0.001297,172.31.40.0-255,66,135254,65,231872
6556,0.001306,172.217.194.0-255,2902,138156,65,231872
6557,0.001311,172.217.194.0-255,5738,143894,65,231872
6558,0.001386,172.217.194.0-255,5738,149632,65,231872
6559,0.001423,172.217.194.0-255,7156,156788,65,231872
6560,0.001447,172.217.194.0-255,1484,158272,65,231872
6561,0.001808,172.217.194.0-255,1484,159756,65,231872
6562,0.001824,172.217.194.0-255,2902,162658,65,231872
6563,0.001828,172.217.194.0-255,2902,165560,65,231872
6564,0.001831,172.31.40.0-255,66,165626,65,231872
6565,0.001837,172.31.40.0-255,66,165692,65,231872
6566,0.001843,172.217.194.0-255,2902,168594,65,231872
6567,0.001875,172.31.40.0-255,66,168660,65,231872
6568,0.001908,172.217.194.0-255,5738,174398,65,231872
6569,0.001928,172.217.194.0-255,6438,180836,65,231872
6570,0.001947,172.31.40.0-255,66,180902,65,231872
6571,0.001972,172.217.194.0-255,1484,182386,65,231872
6572,0.001988,172.217.194.0-255,2902,185288,65,231872
6573,0.00199,172.217.194.0-255,1484,186772,65,231872
6574,0.001994,172.31.40.0-255,66,186838,65,231872
6575,0.002013,172.217.194.0-255,1484,188322,65,231872
6576,0.002025,172.217.194.0-255,4320,192642,65,231872
6577,0.002032,172.31.40.0-255,66,192708,65,231872
6578,0.002038,172.217.194.0-255,1484,194192,65,231872
6579,0.002055,172.217.194.0-255,5738,199930,65,231872
6580,0.002064,172.31.40.0-255,66,199996,65,231872
6581,0.002074,172.217.194.0-255,5738,205734,65,231872
6582,0.002082,172.217.194.0-255,766,206500,65,231872
6583,0.002087,172.31.40.0-255,66,206566,65,231872
6584,0.002121,172.217.194.0-255,1484,208050,65,231872
6585,0.002126,172.217.194.0-255,2902,210952,65,231872
6586,0.00213,172.31.40.0-255,66,211018,65,231872
6587,0.002147,172.217.194.0-255,4320,215338,65,231872
6588,0.002151,172.31.40.0-255,66,215404,65,231872
6589,0.002189,172.31.40.0-255,66,215470,65,231872
6590,0.002199,172.217.194.0-255,5738,221208,65,231872
6591,0.002204,172.31.40.0-255,66,221274,65,231872
6592,0.002223,172.217.194.0-255,2902,224176,65,231872
6593,0.002234,172.31.40.0-255,66,224242,65,231872
6594,0.002251,172.31.40.0-255,66,224308,65,231872
6595,0.002268,172.217.194.0-255,7156,231464,65,231872
6596,0.002276,172.31.40.0-255,66,231530,65,231872
6597,0.002297,172.217.194.0-255,105,231635,65,231872
6598,0.002346,172.31.40.0-255,66,231701,65,231872
6599,0.004271,172.31.40.0-255,105,231806,65,231872
6600,0.006233,172.217.194.0-255,66,231872,65,231872
6601,0.0,172.217.194.0-255,297,297,65,184154
6602,1.9e-05,172.31.40.0-255,66,363,65,184154
6603,2.5e-05,172.217.194.0-255,1484,1847,65,184154
6604,2.9e-05,172.31.40.0-255,66,1913,65,184154
6605,3.8e-05,172.217.194.0-255,4320,6233,65,184154
6606,4.2e-05,172.31.40.0-255,66,6299,65,184154
6607,7.9e-05,172.31.40.0-255,66,6365,65,184154
6608,9.1e-05,172.31.40.0-255,66,6431,65,184154
6609,9.4e-05,172.217.194.0-255,1484,7915,65,184154
6610,9.6e-05,172.31.40.0-255,66,7981,65,184154
6611,0.000123,172.217.194.0-255,3961,11942,65,184154
6612,0.000125,172.31.40.0-255,66,12008,65,184154
6613,0.00015,172.217.194.0-255,1484,13492,65,184154
6614,0.000153,172.31.40.0-255,66,13558,65,184154
6615,0.000173,172.217.194.0-255,2902,16460,65,184154
6616,0.000177,172.31.40.0-255,66,16526,65,184154
6617,0.0002,172.217.194.0-255,5738,22264,65,184154
6618,0.000203,172.31.40.0-255,66,22330,65,184154
6619,0.000225,172.217.194.0-255,5738,28068,65,184154
6620,0.000228,172.31.40.0-255,66,28134,65,184154
6621,0.000249,172.217.194.0-255,1125,29259,65,184154
6622,0.000251,172.31.40.0-255,66,29325,65,184154
6623,0.000438,172.217.194.0-255,1484,30809,65,184154
6624,0.000443,172.31.40.0-255,66,30875,65,184154
6625,0.000449,172.217.194.0-255,2902,33777,65,184154
6626,0.000451,172.31.40.0-255,66,33843,65,184154
6627,0.000484,172.217.194.0-255,5738,39581,65,184154
6628,0.000488,172.31.40.0-255,66,39647,65,184154
6629,0.000502,172.217.194.0-255,2902,42549,65,184154
6630,0.000504,172.31.40.0-255,66,42615,65,184154
6631,0.000522,172.217.194.0-255,3961,46576,65,184154
6632,0.000525,172.31.40.0-255,66,46642,65,184154
6633,0.000595,172.217.194.0-255,1484,48126,65,184154
6634,0.0006,172.217.194.0-255,2902,51028,65,184154
6635,0.000604,172.31.40.0-255,66,51094,65,184154
6636,0.00063,172.217.194.0-255,5738,56832,65,184154
6637,0.000633,172.31.40.0-255,66,56898,65,184154
6638,0.000652,172.217.194.0-255,2902,59800,65,184154
6639,0.000654,172.31.40.0-255,66,59866,65,184154
6640,0.000667,172.217.194.0-255,3961,63827,65,184154
6641,0.000674,172.217.194.0-255,7156,70983,65,184154
6642,0.000707,172.31.40.0-255,66,71049,65,184154
6643,0.000709,172.31.40.0-255,66,71115,65,184154
6644,0.000731,172.31.40.0-255,66,71181,65,184154
6645,0.001639,172.217.194.0-255,1484,72665,65,184154
6646,0.001648,172.217.194.0-255,2902,75567,65,184154
6647,0.001652,172.31.40.0-255,66,75633,65,184154
6648,0.00166,172.217.194.0-255,5738,81371,65,184154
6649,0.001662,172.31.40.0-255,66,81437,65,184154
6650,0.001665,172.217.194.0-255,1484,82921,65,184154
6651,0.001704,172.31.40.0-255,66,82987,65,184154
6652,0.001715,172.31.40.0-255,66,83053,65,184154
6653,0.001718,172.217.194.0-255,766,83819,65,184154
6654,0.001809,172.217.194.0-255,1484,85303,65,184154
6655,0.001814,172.31.40.0-255,66,85369,65,184154
6656,0.001819,172.217.194.0-255,2902,88271,65,184154
6657,0.001821,172.31.40.0-255,66,88337,65,184154
6658,0.001845,172.217.194.0-255,5738,94075,65,184154
6659,0.001847,172.31.40.0-255,66,94141,65,184154
6660,0.001854,172.217.194.0-255,7156,101297,65,184154
6661,0.001856,172.31.40.0-255,66,101363,65,184154
6662,0.00188,172.217.194.0-255,5738,107101,65,184154
6663,0.001883,172.31.40.0-255,66,107167,65,184154
6664,0.001888,172.217.194.0-255,4320,111487,65,184154
6665,0.00189,172.31.40.0-255,66,111553,65,184154
6666,0.001921,172.217.194.0-255,6438,117991,65,184154
6667,0.001924,172.31.40.0-255,66,118057,65,184154
6668,0.001929,172.217.194.0-255,2902,120959,65,184154
6669,0.001931,172.31.40.0-255,66,121025,65,184154
6670,0.001948,172.217.194.0-255,1484,122509,65,184154
6671,0.001955,172.217.194.0-255,5738,128247,65,184154
6672,0.001957,172.31.40.0-255,66,128313,65,184154
6673,0.001968,172.31.40.0-255,66,128379,65,184154
6674,0.001985,172.217.194.0-255,2902,131281,65,184154
6675,0.001987,172.31.40.0-255,66,131347,65,184154
6676,0.001999,172.31.40.0-255,66,131413,65,184154
6677,0.00205,172.217.194.0-255,2184,133597,65,184154
6678,0.002053,172.31.40.0-255,66,133663,65,184154
6679,0.002073,172.217.194.0-255,2902,136565,65,184154
6680,0.002076,172.31.40.0-255,66,136631,65,184154
6681,0.002913,172.31.40.0-255,101,136732,65,184154
6682,0.004093,172.217.194.0-255,2902,139634,65,184154
6683,0.0041,172.31.40.0-255,66,139700,65,184154
6684,0.004121,172.217.194.0-255,2902,142602,65,184154
6685,0.004123,172.31.40.0-255,66,142668,65,184154
6686,0.004943,172.217.194.0-255,66,142734,65,184154
6687,0.006153,172.217.194.0-255,2902,145636,65,184154
6688,0.006158,172.31.40.0-255,66,145702,65,184154
6689,0.006183,172.217.194.0-255,2902,148604,65,184154
6690,0.006185,172.31.40.0-255,66,148670,65,184154
6691,0.008184,172.217.194.0-255,2902,151572,65,184154
6692,0.008189,172.31.40.0-255,66,151638,65,184154
6693,0.008227,172.217.194.0-255,2902,154540,65,184154
6694,0.008231,172.31.40.0-255,66,154606,65,184154
6695,0.010257,172.217.194.0-255,2902,157508,65,184154
6696,0.010264,172.31.40.0-255,66,157574,65,184154
6697,0.010315,172.217.194.0-255,2902,160476,65,184154
6698,0.010318,172.31.40.0-255,66,160542,65,184154
6699,0.012313,172.217.194.0-255,2902,163444,65,184154
6700,0.01232,172.31.40.0-255,66,163510,65,184154
6701,0.012351,172.217.194.0-255,2902,166412,65,184154
6702,0.012353,172.31.40.0-255,66,166478,65,184154
6703,0.014388,172.217.194.0-255,2902,169380,65,184154
6704,0.014396,172.31.40.0-255,66,169446,65,184154
6705,0.014416,172.217.194.0-255,2902,172348,65,184154
6706,0.014418,172.31.40.0-255,66,172414,65,184154
6707,0.016432,172.217.194.0-255,2902,175316,65,184154
6708,0.016441,172.31.40.0-255,66,175382,65,184154
6709,0.016468,172.217.194.0-255,2902,178284,65,184154
6710,0.01647,172.31.40.0-255,66,178350,65,184154
6711,0.018512,172.217.194.0-255,5738,184088,65,184154
6712,0.01852,172.31.40.0-255,66,184154,65,184154
6713,0.0,74.125.24.0-255,150,150,65,171511
6714,1.9e-05,172.31.40.0-255,66,216,65,171511
6715,2.5e-05,74.125.24.0-255,1484,1700,65,171511
6716,3e-05,172.31.40.0-255,66,1766,65,171511
6717,3.3e-05,74.125.24.0-255,1484,3250,65,171511
6718,3.5e-05,172.31.40.0-255,66,3316,65,171511
6719,4.3e-05,74.125.24.0-255,4320,7636,65,171511
6720,4.6e-05,172.31.40.0-255,66,7702,65,171511
6721,7.8e-05,74.125.24.0-255,7156,14858,65,171511
6722,8.1e-05,172.31.40.0-255,66,14924,65,171511
6723,0.000113,74.125.24.0-255,3436,18360,65,171511
6724,0.000116,172.31.40.0-255,66,18426,65,171511
6725,0.000126,172.31.40.0-255,66,18492,65,171511
6726,0.000131,74.125.24.0-255,3961,22453,65,171511
6727,0.000133,172.31.40.0-255,66,22519,65,171511
6728,0.000168,74.125.24.0-255,1484,24003,65,171511
6729,0.00017,172.31.40.0-255,66,24069,65,171511
6730,0.000193,74.125.24.0-255,2902,26971,65,171511
6731,0.000196,172.31.40.0-255,66,27037,65,171511
6732,0.000201,74.125.24.0-255,4320,31357,65,171511
6733,0.000203,172.31.40.0-255,66,31423,65,171511
6734,0.000216,172.31.40.0-255,66,31489,65,171511
6735,0.000265,172.31.40.0-255,66,31555,65,171511
6736,0.000268,74.125.24.0-255,128,31683,65,171511
6737,0.000271,172.31.40.0-255,66,31749,65,171511
6738,0.000297,74.125.24.0-255,344,32093,65,171511
6739,0.0003,172.31.40.0-255,66,32159,65,171511
6740,0.000553,74.125.24.0-255,1484,33643,65,171511
6741,0.000558,172.31.40.0-255,66,33709,65,171511
6742,0.000565,74.125.24.0-255,2902,36611,65,171511
6743,0.000567,172.31.40.0-255,66,36677,65,171511
6744,0.00057,74.125.24.0-255,1484,38161,65,171511
6745,0.000595,74.125.24.0-255,4320,42481,65,171511
6746,0.000598,172.31.40.0-255,66,42547,65,171511
6747,0.000616,74.125.24.0-255,2902,45449,65,171511
6748,0.000618,172.31.40.0-255,66,45515,65,171511
6749,0.000655,172.31.40.0-255,66,45581,65,171511
6750,0.000682,74.125.24.0-255,7156,52737,65,171511
6751,0.000686,172.31.40.0-255,66,52803,65,171511
6752,0.00071,74.125.24.0-255,3602,56405,65,171511
6753,0.000713,172.31.40.0-255,66,56471,65,171511
6754,0.001258,74.125.24.0-255,1484,57955,65,171511
6755,0.001281,74.125.24.0-255,2902,60857,65,171511
6756,0.001284,172.31.40.0-255,66,60923,65,171511
6757,0.00129,74.125.24.0-255,4320,65243,65,171511
6758,0.001292,172.31.40.0-255,66,65309,65,171511
6759,0.001306,74.125.24.0-255,1484,66793,65,171511
6760,0.001312,74.125.24.0-255,5738,72531,65,171511
6761,0.001314,172.31.40.0-255,66,72597,65,171511
6762,0.001338,74.125.24.0-255,5738,78335,65,171511
6763,0.00134,172.31.40.0-255,66,78401,65,171511
6764,0.001373,74.125.24.0-255,7156,85557,65,171511
6765,0.001376,172.31.40.0-255,66,85623,65,171511
6766,0.001383,74.125.24.0-255,5020,90643,65,171511
6767,0.001385,172.31.40.0-255,66,90709,65,171511
6768,0.001678,74.125.24.0-255,1484,92193,65,171511
6769,0.001699,74.125.24.0-255,2902,95095,65,171511
6770,0.001702,172.31.40.0-255,66,95161,65,171511
6771,0.001709,74.125.24.0-255,4320,99481,65,171511
6772,0.001711,172.31.40.0-255,66,99547,65,171511
6773,0.001724,74.125.24.0-255,1484,101031,65,171511
6774,0.001757,74.125.24.0-255,5738,106769,65,171511
6775,0.001759,172.31.40.0-255,66,106835,65,171511
6776,0.001786,74.125.24.0-255,7156,113991,65,171511
6777,0.001789,172.31.40.0-255,66,114057,65,171511
6778,0.001797,74.125.24.0-255,7156,121213,65,171511
6779,0.001799,172.31.40.0-255,66,121279,65,171511
6780,0.001822,74.125.24.0-255,1484,122763,65,171511
6781,0.001836,74.125.24.0-255,2184,124947,65,171511
6782,0.001838,172.31.40.0-255,66,125013,65,171511
6783,0.003828,74.125.24.0-255,1484,126497,65,171511
6784,0.003879,74.125.24.0-255,4320,130817,65,171511
6785,0.003884,172.31.40.0-255,66,130883,65,171511
6786,0.005905,74.125.24.0-255,5738,136621,65,171511
6787,0.005909,172.31.40.0-255,66,136687,65,171511
6788,0.007917,74.125.24.0-255,5738,142425,65,171511
6789,0.007924,172.31.40.0-255,66,142491,65,171511
6790,0.009957,74.125.24.0-255,5738,148229,65,171511
6791,0.009966,172.31.40.0-255,66,148295,65,171511
6792,0.012004,74.125.24.0-255,5738,154033,65,171511
6793,0.012011,172.31.40.0-255,66,154099,65,171511
6794,0.014051,74.125.24.0-255,5738,159837,65,171511
6795,0.014058,172.31.40.0-255,66,159903,65,171511
6796,0.016062,74.125.24.0-255,5738,165641,65,171511
6797,0.016069,172.31.40.0-255,66,165707,65,171511
6798,0.018097,74.125.24.0-255,5738,171445,65,171511
6799,0.018107,172.31.40.0-255,66,171511,65,171511
6800,0.0,34.213.241.0-255,66,66,65,5144
6801,0.001415,34.213.241.0-255,3551,3617,65,5144
6802,0.001433,172.31.40.0-255,66,3683,65,5144
6803,0.009021,172.31.40.0-255,192,3875,65,5144
6804,0.011454,172.31.40.0-255,1269,5144,65,5144
6805,0.0,184.29.88.0-255,90,90,65,663
6806,2.3e-05,172.31.40.0-255,66,156,65,663
6807,2.8e-05,184.29.88.0-255,66,222,65,663
6808,0.000179,172.31.40.0-255,105,327,65,663
6809,0.000321,172.31.40.0-255,90,417,65,663
6810,0.000332,172.31.40.0-255,66,483,65,663
6811,0.001875,184.29.88.0-255,60,543,65,663
6812,0.002008,184.29.88.0-255,60,603,65,663
6813,0.002027,184.29.88.0-255,60,663,65,663
6814,0.0,172.217.194.0-255,297,297,65,174993
6815,1.6e-05,172.31.40.0-255,66,363,65,174993
6816,2.3e-05,172.217.194.0-255,1484,1847,65,174993
6817,2.7e-05,172.31.40.0-255,66,1913,65,174993
6818,3.3e-05,172.217.194.0-255,4320,6233,65,174993
6819,3.7e-05,172.31.40.0-255,66,6299,65,174993
6820,6.2e-05,172.217.194.0-255,2902,9201,65,174993
6821,6.4e-05,172.31.40.0-255,66,9267,65,174993
6822,8.6e-05,172.217.194.0-255,4648,13915,65,174993
6823,8.9e-05,172.31.40.0-255,66,13981,65,174993
6824,0.000406,172.217.194.0-255,1484,15465,65,174993
6825,0.000411,172.31.40.0-255,66,15531,65,174993
6826,0.000417,172.217.194.0-255,2902,18433,65,174993
6827,0.00042,172.31.40.0-255,66,18499,65,174993
6828,0.000426,172.217.194.0-255,5738,24237,65,174993
6829,0.000429,172.31.40.0-255,66,24303,65,174993
6830,0.000461,172.217.194.0-255,1484,25787,65,174993
6831,0.000463,172.31.40.0-255,66,25853,65,174993
6832,0.000495,172.31.40.0-255,66,25919,65,174993
6833,0.000509,172.217.194.0-255,2902,28821,65,174993
6834,0.000511,172.31.40.0-255,66,28887,65,174993
6835,0.000538,172.31.40.0-255,66,28953,65,174993
6836,0.001359,172.217.194.0-255,1484,30437,65,174993
6837,0.001367,172.31.40.0-255,66,30503,65,174993
6838,0.001377,172.217.194.0-255,2902,33405,65,174993
6839,0.001379,172.31.40.0-255,66,33471,65,174993
6840,0.001386,172.217.194.0-255,5738,39209,65,174993
6841,0.001388,172.31.40.0-255,66,39275,65,174993
6842,0.001425,172.217.194.0-255,4320,43595,65,174993
6843,0.001428,172.31.40.0-255,66,43661,65,174993
6844,0.00145,172.217.194.0-255,3123,46784,65,174993
6845,0.001503,172.217.194.0-255,1484,48268,65,174993
6846,0.001517,172.217.194.0-255,2902,51170,65,174993
6847,0.001537,172.217.194.0-255,5738,56908,65,174993
6848,0.001553,172.217.194.0-255,1484,58392,65,174993
6849,0.001966,172.31.40.0-255,66,58458,65,174993
6850,0.002148,172.217.194.0-255,1484,59942,65,174993
6851,0.002156,172.217.194.0-255,2902,62844,65,174993
6852,0.002161,172.217.194.0-255,2902,65746,65,174993
6853,0.00217,172.31.40.0-255,66,65812,65,174993
6854,0.002189,172.217.194.0-255,2902,68714,65,174993
6855,0.002215,172.31.40.0-255,66,68780,65,174993
6856,0.002234,172.217.194.0-255,4320,73100,65,174993
6857,0.002254,172.217.194.0-255,5738,78838,65,174993
6858,0.002274,172.217.194.0-255,3602,82440,65,174993
6859,0.002281,172.31.40.0-255,66,82506,65,174993
6860,0.002889,172.217.194.0-255,1484,83990,65,174993
6861,0.002897,172.217.194.0-255,2902,86892,65,174993
6862,0.002901,172.31.40.0-255,66,86958,65,174993
6863,0.002908,172.217.194.0-255,5738,92696,65,174993
6864,0.002949,172.217.194.0-255,4320,97016,65,174993
6865,0.00297,172.217.194.0-255,2184,99200,65,174993
6866,0.003013,172.31.40.0-255,66,99266,65,174993
6867,0.003053,172.31.40.0-255,101,99367,65,174993
6868,0.003093,172.217.194.0-255,1484,100851,65,174993
6869,0.003098,172.217.194.0-255,1484,102335,65,174993
6870,0.003109,172.217.194.0-255,1484,103819,65,174993
6871,0.003124,172.217.194.0-255,5738,109557,65,174993
6872,0.003138,172.217.194.0-255,2902,112459,65,174993
6873,0.003164,172.217.194.0-255,4320,116779,65,174993
6874,0.003181,172.217.194.0-255,6438,123217,65,174993
6875,0.003219,172.31.40.0-255,66,123283,65,174993
6876,0.003226,172.217.194.0-255,1484,124767,65,174993
6877,0.003231,172.217.194.0-255,2902,127669,65,174993
6878,0.003236,172.217.194.0-255,4320,131989,65,174993
6879,0.003243,172.31.40.0-255,66,132055,65,174993
6880,0.003252,172.217.194.0-255,1484,133539,65,174993
6881,0.003265,172.217.194.0-255,2902,136441,65,174993
6882,0.003278,172.217.194.0-255,2902,139343,65,174993
6883,0.003287,172.31.40.0-255,66,139409,65,174993
6884,0.003306,172.217.194.0-255,7156,146565,65,174993
6885,0.003336,172.217.194.0-255,6438,153003,65,174993
6886,0.00338,172.217.194.0-255,5738,158741,65,174993
6887,0.003423,172.217.194.0-255,3602,162343,65,174993
6888,0.003448,172.217.194.0-255,4320,166663,65,174993
6889,0.003474,172.217.194.0-255,5020,171683,65,174993
6890,0.003522,172.217.194.0-255,2902,174585,65,174993
6891,0.00365,172.217.194.0-255,105,174690,65,174993
6892,0.005313,172.217.194.0-255,66,174756,65,174993
6893,0.008812,172.31.40.0-255,66,174822,65,174993
6894,0.011034,172.31.40.0-255,105,174927,65,174993
6895,0.013292,172.217.194.0-255,66,174993,65,174993
6896,0.0,74.125.24.0-255,152,152,65,194570
6897,1.9e-05,172.31.40.0-255,66,218,65,194570
6898,2.5e-05,74.125.24.0-255,1484,1702,65,194570
6899,2.9e-05,172.31.40.0-255,66,1768,65,194570
6900,3.4e-05,74.125.24.0-255,2902,4670,65,194570
6901,4.4e-05,172.31.40.0-255,66,4736,65,194570
6902,5.1e-05,74.125.24.0-255,5738,10474,65,194570
6903,5.4e-05,172.31.40.0-255,66,10540,65,194570
6904,7.3e-05,74.125.24.0-255,3369,13909,65,194570
6905,7.9e-05,172.31.40.0-255,66,13975,65,194570
6906,8.4e-05,74.125.24.0-255,4320,18295,65,194570
6907,8.6e-05,172.31.40.0-255,66,18361,65,194570
6908,0.000131,172.31.40.0-255,66,18427,65,194570
6909,0.000134,74.125.24.0-255,2543,20970,65,194570
6910,0.000136,172.31.40.0-255,66,21036,65,194570
6911,0.000184,172.31.40.0-255,66,21102,65,194570
6912,0.000205,74.125.24.0-255,1484,22586,65,194570
6913,0.000207,172.31.40.0-255,66,22652,65,194570
6914,0.000227,74.125.24.0-255,3961,26613,65,194570
6915,0.00023,172.31.40.0-255,66,26679,65,194570
6916,0.000235,74.125.24.0-255,4320,30999,65,194570
6917,0.000236,172.31.40.0-255,66,31065,65,194570
6918,0.000279,172.31.40.0-255,66,31131,65,194570
6919,0.000282,74.125.24.0-255,2543,33674,65,194570
6920,0.000284,172.31.40.0-255,66,33740,65,194570
6921,0.000305,74.125.24.0-255,649,34389,65,194570
6922,0.000307,172.31.40.0-255,66,34455,65,194570
6923,0.00043,74.125.24.0-255,1484,35939,65,194570
6924,0.000434,172.31.40.0-255,66,36005,65,194570
6925,0.00044,74.125.24.0-255,2902,38907,65,194570
6926,0.000443,172.31.40.0-255,66,38973,65,194570
6927,0.000448,74.125.24.0-255,4320,43293,65,194570
6928,0.000451,172.31.40.0-255,66,43359,65,194570
6929,0.00048,74.125.24.0-255,1484,44843,65,194570
6930,0.000504,74.125.24.0-255,5738,50581,65,194570
6931,0.000507,172.31.40.0-255,66,50647,65,194570
6932,0.000518,74.125.24.0-255,573,51220,65,194570
6933,0.000541,74.125.24.0-255,5738,56958,65,194570
6934,0.000544,172.31.40.0-255,66,57024,65,194570
6935,0.000555,74.125.24.0-255,1484,58508,65,194570
6936,0.000579,74.125.24.0-255,5738,64246,65,194570
6937,0.000581,172.31.40.0-255,66,64312,65,194570
6938,0.000599,74.125.24.0-255,3961,68273,65,194570
6939,0.000601,172.31.40.0-255,66,68339,65,194570
6940,0.000744,74.125.24.0-255,1484,69823,65,194570
6941,0.000749,74.125.24.0-255,1484,71307,65,194570
6942,0.000753,172.31.40.0-255,66,71373,65,194570
6943,0.000777,74.125.24.0-255,1484,72857,65,194570
6944,0.000785,74.125.24.0-255,5738,78595,65,194570
6945,0.000788,172.31.40.0-255,66,78661,65,194570
6946,0.000793,74.125.24.0-255,4320,82981,65,194570
6947,0.000795,172.31.40.0-255,66,83047,65,194570
6948,0.000822,74.125.24.0-255,2543,85590,65,194570
6949,0.000825,172.31.40.0-255,66,85656,65,194570
6950,0.001188,74.125.24.0-255,1484,87140,65,194570
6951,0.001206,74.125.24.0-255,2902,90042,65,194570
6952,0.00121,172.31.40.0-255,66,90108,65,194570
6953,0.001217,74.125.24.0-255,5738,95846,65,194570
6954,0.001219,172.31.40.0-255,66,95912,65,194570
6955,0.001226,74.125.24.0-255,5738,101650,65,194570
6956,0.001228,172.31.40.0-255,66,101716,65,194570
6957,0.001257,74.125.24.0-255,1484,103200,65,194570
6958,0.001269,172.31.40.0-255,66,103266,65,194570
6959,0.001297,74.125.24.0-255,2902,106168,65,194570
6960,0.0013,172.31.40.0-255,66,106234,65,194570
6961,0.001305,74.125.24.0-255,2184,108418,65,194570
6962,0.001307,172.31.40.0-255,66,108484,65,194570
6963,0.001476,74.125.24.0-255,1484,109968,65,194570
6964,0.001491,74.125.24.0-255,2902,112870,65,194570
6965,0.001495,172.31.40.0-255,66,112936,65,194570
6966,0.001498,74.125.24.0-255,1484,114420,65,194570
6967,0.001518,74.125.24.0-255,4320,118740,65,194570
6968,0.00152,172.31.40.0-255,66,118806,65,194570
6969,0.001539,172.31.40.0-255,66,118872,65,194570
6970,0.001546,74.125.24.0-255,5738,124610,65,194570
6971,0.001548,172.31.40.0-255,66,124676,65,194570
6972,0.00161,74.125.24.0-255,5020,129696,65,194570
6973,0.001614,172.31.40.0-255,66,129762,65,194570
6974,0.001897,74.125.24.0-255,1484,131246,65,194570
6975,0.001904,74.125.24.0-255,2902,134148,65,194570
6976,0.001907,172.31.40.0-255,66,134214,65,194570
6977,0.001942,74.125.24.0-255,5738,139952,65,194570
6978,0.001945,172.31.40.0-255,66,140018,65,194570
6979,0.001952,74.125.24.0-255,5738,145756,65,194570
6980,0.001954,172.31.40.0-255,66,145822,65,194570
6981,0.001958,74.125.24.0-255,2902,148724,65,194570
6982,0.00196,172.31.40.0-255,66,148790,65,194570
6983,0.001997,172.31.40.0-255,66,148856,65,194570
6984,0.002003,74.125.24.0-255,5020,153876,65,194570
6985,0.002005,172.31.40.0-255,66,153942,65,194570
6986,0.004268,74.125.24.0-255,5738,159680,65,194570
6987,0.004275,172.31.40.0-255,66,159746,65,194570
6988,0.00652,74.125.24.0-255,5738,165484,65,194570
6989,0.006527,172.31.40.0-255,66,165550,65,194570
6990,0.008803,74.125.24.0-255,5738,171288,65,194570
6991,0.00881,172.31.40.0-255,66,171354,65,194570
6992,0.011083,74.125.24.0-255,5738,177092,65,194570
6993,0.01109,172.31.40.0-255,66,177158,65,194570
6994,0.013341,74.125.24.0-255,5738,182896,65,194570
6995,0.013349,172.31.40.0-255,66,182962,65,194570
6996,0.015642,74.125.24.0-255,5738,188700,65,194570
6997,0.015652,172.31.40.0-255,66,188766,65,194570
6998,0.017942,74.125.24.0-255,5738,194504,65,194570
6999,0.01796,172.31.40.0-255,66,194570,65,194570
7000,0.0,74.125.200.0-255,153,153,65,247927
7001,1.9e-05,172.31.40.0-255,66,219,65,247927
7002,2.8e-05,74.125.200.0-255,1484,1703,65,247927
7003,3.3e-05,172.31.40.0-255,66,1769,65,247927
7004,4.6e-05,74.125.200.0-255,2902,4671,65,247927
7005,4.9e-05,172.31.40.0-255,66,4737,65,247927
7006,5.6e-05,74.125.200.0-255,5738,10475,65,247927
7007,5.9e-05,172.31.40.0-255,66,10541,65,247927
7008,6.4e-05,74.125.200.0-255,3528,14069,65,247927
7009,6.7e-05,172.31.40.0-255,66,14135,65,247927
7010,7.1e-05,74.125.200.0-255,1484,15619,65,247927
7011,7.3e-05,172.31.40.0-255,66,15685,65,247927
7012,0.000101,74.125.200.0-255,2902,18587,65,247927
7013,0.000105,172.31.40.0-255,66,18653,65,247927
7014,0.000117,172.31.40.0-255,66,18719,65,247927
7015,0.000121,74.125.200.0-255,2543,21262,65,247927
7016,0.000123,172.31.40.0-255,66,21328,65,247927
7017,0.000201,74.125.200.0-255,1484,22812,65,247927
7018,0.000204,172.31.40.0-255,66,22878,65,247927
7019,0.000233,74.125.200.0-255,1484,24362,65,247927
7020,0.000236,172.31.40.0-255,66,24428,65,247927
7021,0.00024,74.125.200.0-255,2902,27330,65,247927
7022,0.000243,172.31.40.0-255,66,27396,65,247927
7023,0.000249,74.125.200.0-255,5738,33134,65,247927
7024,0.000252,172.31.40.0-255,66,33200,65,247927
7025,0.00029,74.125.200.0-255,5379,38579,65,247927
7026,0.000293,172.31.40.0-255,66,38645,65,247927
7027,0.000299,74.125.200.0-255,5738,44383,65,247927
7028,0.000302,172.31.40.0-255,66,44449,65,247927
7029,0.00033,74.125.200.0-255,7156,51605,65,247927
7030,0.000333,172.31.40.0-255,66,51671,65,247927
7031,0.000359,74.125.200.0-255,4267,55938,65,247927
7032,0.000362,172.31.40.0-255,66,56004,65,247927
7033,0.000364,74.125.200.0-255,113,56117,65,247927
7034,0.000437,74.125.200.0-255,1484,57601,65,247927
7035,0.00044,172.31.40.0-255,66,57667,65,247927
7036,0.00047,74.125.200.0-255,2902,60569,65,247927
7037,0.000473,172.31.40.0-255,66,60635,65,247927
7038,0.00048,74.125.200.0-255,5738,66373,65,247927
7039,0.000482,172.31.40.0-255,66,66439,65,247927
7040,0.000485,74.125.200.0-255,1484,67923,65,247927
7041,0.000513,74.125.200.0-255,5379,73302,65,247927
7042,0.000517,172.31.40.0-255,66,73368,65,247927
7043,0.000521,74.125.200.0-255,2902,76270,65,247927
7044,0.000523,172.31.40.0-255,66,76336,65,247927
7045,0.000556,74.125.200.0-255,1484,77820,65,247927
7046,0.000563,74.125.200.0-255,5738,83558,65,247927
7047,0.000566,172.31.40.0-255,66,83624,65,247927
7048,0.00057,74.125.200.0-255,1484,85108,65,247927
7049,0.000593,74.125.200.0-255,5625,90733,65,247927
7050,0.000596,172.31.40.0-255,66,90799,65,247927
7051,0.000755,74.125.200.0-255,1484,92283,65,247927
7052,0.000776,74.125.200.0-255,2902,95185,65,247927
7053,0.00078,172.31.40.0-255,66,95251,65,247927
7054,0.000786,74.125.200.0-255,2902,98153,65,247927
7055,0.000788,172.31.40.0-255,66,98219,65,247927
7056,0.00082,74.125.200.0-255,1484,99703,65,247927
7057,0.000827,74.125.200.0-255,5738,105441,65,247927
7058,0.00083,172.31.40.0-255,66,105507,65,247927
7059,0.000843,172.31.40.0-255,66,105573,65,247927
7060,0.000849,74.125.200.0-255,4320,109893,65,247927
7061,0.00085,172.31.40.0-255,66,109959,65,247927
7062,0.000904,74.125.200.0-255,3602,113561,65,247927
7063,0.000906,172.31.40.0-255,66,113627,65,247927
7064,0.000912,74.125.200.0-255,4320,117947,65,247927
7065,0.000914,172.31.40.0-255,66,118013,65,247927
7066,0.00095,74.125.200.0-255,7156,125169,65,247927
7067,0.000953,172.31.40.0-255,66,125235,65,247927
7068,0.000978,74.125.200.0-255,2902,128137,65,247927
7069,0.00098,172.31.40.0-255,66,128203,65,247927
7070,0.000994,172.31.40.0-255,66,128269,65,247927
7071,0.001001,74.125.200.0-255,7156,135425,65,247927
7072,0.001003,172.31.40.0-255,66,135491,65,247927
7073,0.001029,74.125.200.0-255,766,136257,65,247927
7074,0.001085,74.125.200.0-255,1484,137741,65,247927
7075,0.001088,172.31.40.0-255,66,137807,65,247927
7076,0.001092,74.125.200.0-255,1484,139291,65,247927
7077,0.001116,74.125.200.0-255,1484,140775,65,247927
7078,0.001118,172.31.40.0-255,66,140841,65,247927
7079,0.001126,74.125.200.0-255,5738,146579,65,247927
7080,0.001128,172.31.40.0-255,66,146645,65,247927
7081,0.001164,74.125.200.0-255,7156,153801,65,247927
7082,0.001166,172.31.40.0-255,66,153867,65,247927
7083,0.001176,172.31.40.0-255,66,153933,65,247927
7084,0.001198,74.125.200.0-255,1484,155417,65,247927
7085,0.001233,74.125.200.0-255,6438,161855,65,247927
7086,0.001237,172.31.40.0-255,66,161921,65,247927
7087,0.001312,74.125.200.0-255,1484,163405,65,247927
7088,0.001317,74.125.200.0-255,1484,164889,65,247927
7089,0.00132,172.31.40.0-255,66,164955,65,247927
7090,0.001348,74.125.200.0-255,1484,166439,65,247927
7091,0.001356,74.125.200.0-255,5738,172177,65,247927
7092,0.001359,172.31.40.0-255,66,172243,65,247927
7093,0.001366,74.125.200.0-255,5738,177981,65,247927
7094,0.001368,172.31.40.0-255,66,178047,65,247927
7095,0.001395,74.125.200.0-255,1484,179531,65,247927
7096,0.001412,172.31.40.0-255,66,179597,65,247927
7097,0.001443,74.125.200.0-255,2184,181781,65,247927
7098,0.001446,172.31.40.0-255,66,181847,65,247927
7099,0.001459,74.125.200.0-255,2902,184749,65,247927
7100,0.001466,172.31.40.0-255,66,184815,65,247927
7101,0.001471,74.125.200.0-255,2902,187717,65,247927
7102,0.001473,172.31.40.0-255,66,187783,65,247927
7103,0.001499,74.125.200.0-255,4320,192103,65,247927
7104,0.001502,172.31.40.0-255,66,192169,65,247927
7105,0.001516,74.125.200.0-255,7156,199325,65,247927
7106,0.001518,172.31.40.0-255,66,199391,65,247927
7107,0.001528,172.31.40.0-255,66,199457,65,247927
7108,0.001566,172.31.40.0-255,66,199523,65,247927
7109,0.001662,74.125.200.0-255,1484,201007,65,247927
7110,0.001668,74.125.200.0-255,2902,203909,65,247927
7111,0.001671,172.31.40.0-255,66,203975,65,247927
7112,0.001675,74.125.200.0-255,1484,205459,65,247927
7113,0.001694,74.125.200.0-255,4320,209779,65,247927
7114,0.001697,172.31.40.0-255,66,209845,65,247927
7115,0.001699,74.125.200.0-255,1484,211329,65,247927
7116,0.001728,172.31.40.0-255,66,211395,65,247927
7117,0.001775,172.31.40.0-255,66,211461,65,247927
7118,0.001778,74.125.200.0-255,766,212227,65,247927
7119,0.001862,74.125.200.0-255,1484,213711,65,247927
7120,0.001865,172.31.40.0-255,66,213777,65,247927
7121,0.001871,74.125.200.0-255,2902,216679,65,247927
7122,0.001874,172.31.40.0-255,66,216745,65,247927
7123,0.001911,74.125.200.0-255,5738,222483,65,247927
7124,0.001914,172.31.40.0-255,66,222549,65,247927
7125,0.001918,74.125.200.0-255,2902,225451,65,247927
7126,0.00192,172.31.40.0-255,66,225517,65,247927
7127,0.001959,74.125.200.0-255,5738,231255,65,247927
7128,0.001961,172.31.40.0-255,66,231321,65,247927
7129,0.001993,74.125.200.0-255,4320,235641,65,247927
7130,0.002018,74.125.200.0-255,4320,239961,65,247927
7131,0.002023,172.31.40.0-255,66,240027,65,247927
7132,0.002026,172.31.40.0-255,66,240093,65,247927
7133,0.002034,172.31.40.0-255,66,240159,65,247927
7134,0.00204,172.31.40.0-255,66,240225,65,247927
7135,0.002044,74.125.200.0-255,1484,241709,65,247927
7136,0.002077,172.31.40.0-255,66,241775,65,247927
7137,0.00208,74.125.200.0-255,766,242541,65,247927
7138,0.002127,172.31.40.0-255,66,242607,65,247927
7139,0.002163,172.31.40.0-255,66,242673,65,247927
7140,0.002173,172.31.40.0-255,66,242739,65,247927
7141,0.002208,74.125.200.0-255,4780,247519,65,247927
7142,0.002212,172.31.40.0-255,66,247585,65,247927
7143,0.002215,74.125.200.0-255,105,247690,65,247927
7144,0.012703,172.31.40.0-255,66,247756,65,247927
7145,0.012755,172.31.40.0-255,105,247861,65,247927
7146,0.014986,74.125.200.0-255,66,247927,65,247927
7147,0.0,172.217.194.0-255,168,168,65,217814
7148,2.2e-05,172.31.40.0-255,66,234,65,217814
7149,2.9e-05,172.217.194.0-255,1484,1718,65,217814
7150,3.4e-05,172.31.40.0-255,66,1784,65,217814
7151,4e-05,172.217.194.0-255,2902,4686,65,217814
7152,4.3e-05,172.31.40.0-255,66,4752,65,217814
7153,5e-05,172.217.194.0-255,7156,11908,65,217814
7154,5.3e-05,172.31.40.0-255,66,11974,65,217814
7155,5.8e-05,172.217.194.0-255,2000,13974,65,217814
7156,6.1e-05,172.31.40.0-255,66,14040,65,217814
7157,0.000176,172.217.194.0-255,1484,15524,65,217814
7158,0.00018,172.31.40.0-255,66,15590,65,217814
7159,0.000186,172.217.194.0-255,2902,18492,65,217814
7160,0.000188,172.31.40.0-255,66,18558,65,217814
7161,0.000194,172.217.194.0-255,4320,22878,65,217814
7162,0.000197,172.31.40.0-255,66,22944,65,217814
7163,0.00021,172.217.194.0-255,1484,24428,65,217814
7164,0.000212,172.31.40.0-255,66,24494,65,217814
7165,0.000245,172.217.194.0-255,6797,31291,65,217814
7166,0.000248,172.31.40.0-255,66,31357,65,217814
7167,0.000319,172.217.194.0-255,1484,32841,65,217814
7168,0.000322,172.31.40.0-255,66,32907,65,217814
7169,0.000346,172.217.194.0-255,2902,35809,65,217814
7170,0.000349,172.31.40.0-255,66,35875,65,217814
7171,0.000355,172.217.194.0-255,5738,41613,65,217814
7172,0.000357,172.31.40.0-255,66,41679,65,217814
7173,0.000392,172.31.40.0-255,66,41745,65,217814
7174,0.000398,172.217.194.0-255,4320,46065,65,217814
7175,0.0004,172.31.40.0-255,66,46131,65,217814
7176,0.000438,172.31.40.0-255,66,46197,65,217814
7177,0.00044,172.217.194.0-255,378,46575,65,217814
7178,0.000504,172.217.194.0-255,364,46939,65,217814
7179,0.00056,172.217.194.0-255,1484,48423,65,217814
7180,0.000564,172.31.40.0-255,66,48489,65,217814
7181,0.000568,172.217.194.0-255,1484,49973,65,217814
7182,0.000588,172.217.194.0-255,2902,52875,65,217814
7183,0.000591,172.31.40.0-255,66,52941,65,217814
7184,0.000597,172.217.194.0-255,4320,57261,65,217814
7185,0.000599,172.31.40.0-255,66,57327,65,217814
7186,0.000615,172.217.194.0-255,4320,61647,65,217814
7187,0.000617,172.31.40.0-255,66,61713,65,217814
7188,0.00065,172.217.194.0-255,7156,68869,65,217814
7189,0.000653,172.31.40.0-255,66,68935,65,217814
7190,0.000686,172.31.40.0-255,66,69001,65,217814
7191,0.000691,172.217.194.0-255,3961,72962,65,217814
7192,0.000693,172.31.40.0-255,66,73028,65,217814
7193,0.000949,172.217.194.0-255,1484,74512,65,217814
7194,0.000968,172.217.194.0-255,2902,77414,65,217814
7195,0.000972,172.31.40.0-255,66,77480,65,217814
7196,0.000979,172.217.194.0-255,5738,83218,65,217814
7197,0.000981,172.31.40.0-255,66,83284,65,217814
7198,0.001006,172.31.40.0-255,66,83350,65,217814
7199,0.00102,172.217.194.0-255,4320,87670,65,217814
7200,0.001023,172.31.40.0-255,66,87736,65,217814
7201,0.001036,172.31.40.0-255,66,87802,65,217814
7202,0.001124,172.31.40.0-255,66,87868,65,217814
7203,0.001135,172.31.40.0-255,66,87934,65,217814
7204,0.001138,172.217.194.0-255,1484,89418,65,217814
7205,0.001157,172.217.194.0-255,2902,92320,65,217814
7206,0.00116,172.31.40.0-255,66,92386,65,217814
7207,0.001172,172.217.194.0-255,2902,95288,65,217814
7208,0.001174,172.31.40.0-255,66,95354,65,217814
7209,0.001198,172.217.194.0-255,1484,96838,65,217814
7210,0.001211,172.31.40.0-255,66,96904,65,217814
7211,0.00124,172.31.40.0-255,66,96970,65,217814
7212,0.00127,172.217.194.0-255,2902,99872,65,217814
7213,0.001273,172.31.40.0-255,66,99938,65,217814
7214,0.001287,172.31.40.0-255,66,100004,65,217814
7215,0.001299,172.31.40.0-255,66,100070,65,217814
7216,0.001317,172.217.194.0-255,4320,104390,65,217814
7217,0.001319,172.31.40.0-255,66,104456,65,217814
7218,0.001343,172.217.194.0-255,5738,110194,65,217814
7219,0.001346,172.31.40.0-255,66,110260,65,217814
7220,0.001376,172.31.40.0-255,66,110326,65,217814
7221,0.001397,172.217.194.0-255,2902,113228,65,217814
7222,0.0014,172.31.40.0-255,66,113294,65,217814
7223,0.001413,172.31.40.0-255,66,113360,65,217814
7224,0.001438,172.217.194.0-255,766,114126,65,217814
7225,0.001446,172.217.194.0-255,1484,115610,65,217814
7226,0.001449,172.31.40.0-255,66,115676,65,217814
7227,0.001455,172.217.194.0-255,4320,119996,65,217814
7228,0.001458,172.31.40.0-255,66,120062,65,217814
7229,0.001461,172.217.194.0-255,1484,121546,65,217814
7230,0.001495,172.31.40.0-255,66,121612,65,217814
7231,0.001505,172.217.194.0-255,4320,125932,65,217814
7232,0.001519,172.217.194.0-255,4320,130252,65,217814
7233,0.001533,172.217.194.0-255,4320,134572,65,217814
7234,0.001543,172.31.40.0-255,66,134638,65,217814
7235,0.001554,172.217.194.0-255,5020,139658,65,217814
7236,0.00156,172.31.40.0-255,66,139724,65,217814
7237,0.001609,172.217.194.0-255,1484,141208,65,217814
7238,0.001615,172.217.194.0-255,2902,144110,65,217814
7239,0.001625,172.31.40.0-255,66,144176,65,217814
7240,0.001628,172.217.194.0-255,1484,145660,65,217814
7241,0.001666,172.217.194.0-255,2902,148562,65,217814
7242,0.001674,172.217.194.0-255,5738,154300,65,217814
7243,0.001682,172.217.194.0-255,7156,161456,65,217814
7244,0.001699,172.217.194.0-255,5738,167194,65,217814
7245,0.001707,172.217.194.0-255,6438,173632,65,217814
7246,0.001748,172.31.40.0-255,66,173698,65,217814
7247,0.001863,172.217.194.0-255,1484,175182,65,217814
7248,0.001867,172.217.194.0-255,1484,176666,65,217814
7249,0.00187,172.31.40.0-255,66,176732,65,217814
7250,0.0019,172.217.194.0-255,1484,178216,65,217814
7251,0.001907,172.217.194.0-255,5738,183954,65,217814
7252,0.001909,172.217.194.0-255,1484,185438,65,217814
7253,0.001929,172.31.40.0-255,66,185504,65,217814
7254,0.001946,172.217.194.0-255,4320,189824,65,217814
7255,0.001956,172.31.40.0-255,66,189890,65,217814
7256,0.001994,172.217.194.0-255,2902,192792,65,217814
7257,0.002004,172.31.40.0-255,66,192858,65,217814
7258,0.002045,172.217.194.0-255,2902,195760,65,217814
7259,0.002052,172.31.40.0-255,66,195826,65,217814
7260,0.002063,172.217.194.0-255,5020,200846,65,217814
7261,0.002075,172.217.194.0-255,1484,202330,65,217814
7262,0.002087,172.31.40.0-255,66,202396,65,217814
7263,0.00212,172.217.194.0-255,7156,209552,65,217814
7264,0.002126,172.217.194.0-255,6962,216514,65,217814
7265,0.002128,172.217.194.0-255,97,216611,65,217814
7266,0.002135,172.31.40.0-255,66,216677,65,217814
7267,0.002142,172.217.194.0-255,105,216782,65,217814
7268,0.002204,172.217.194.0-255,129,216911,65,217814
7269,0.011089,172.31.40.0-255,105,217016,65,217814
7270,0.011129,172.31.40.0-255,105,217121,65,217814
7271,0.01135,172.217.194.0-255,129,217250,65,217814
7272,0.011357,172.31.40.0-255,78,217328,65,217814
7273,0.011399,172.31.40.0-255,90,217418,65,217814
7274,0.011409,172.31.40.0-255,66,217484,65,217814
7275,0.013342,172.217.194.0-255,66,217550,65,217814
7276,0.013382,172.217.194.0-255,66,217616,65,217814
7277,0.013665,172.217.194.0-255,66,217682,65,217814
7278,0.013679,172.217.194.0-255,66,217748,65,217814
7279,0.013686,172.31.40.0-255,66,217814,65,217814
7280,0.0,172.217.27.0-255,143,143,65,158404
7281,2.2e-05,172.31.40.0-255,66,209,65,158404
7282,2.9e-05,172.217.27.0-255,1484,1693,65,158404
7283,3.3e-05,172.31.40.0-255,66,1759,65,158404
7284,3.9e-05,172.217.27.0-255,2902,4661,65,158404
7285,4.3e-05,172.31.40.0-255,66,4727,65,158404
7286,5.1e-05,172.217.27.0-255,7156,11883,65,158404
7287,5.6e-05,172.31.40.0-255,66,11949,65,158404
7288,6e-05,172.217.27.0-255,2000,13949,65,158404
7289,6.3e-05,172.31.40.0-255,66,14015,65,158404
7290,6.8e-05,172.217.27.0-255,2902,16917,65,158404
7291,7e-05,172.31.40.0-255,66,16983,65,158404
7292,7.8e-05,172.217.27.0-255,7156,24139,65,158404
7293,8e-05,172.31.40.0-255,66,24205,65,158404
7294,0.000116,172.217.27.0-255,6797,31002,65,158404
7295,0.000119,172.31.40.0-255,66,31068,65,158404
7296,0.000235,172.217.27.0-255,1484,32552,65,158404
7297,0.000239,172.31.40.0-255,66,32618,65,158404
7298,0.000257,172.217.27.0-255,1484,34102,65,158404
7299,0.000259,172.31.40.0-255,66,34168,65,158404
7300,0.000264,172.217.27.0-255,2902,37070,65,158404
7301,0.000266,172.31.40.0-255,66,37136,65,158404
7302,0.000297,172.217.27.0-255,5738,42874,65,158404
7303,0.0003,172.31.40.0-255,66,42940,65,158404
7304,0.000306,172.217.27.0-255,5379,48319,65,158404
7305,0.000308,172.31.40.0-255,66,48385,65,158404
7306,0.000313,172.217.27.0-255,2902,51287,65,158404
7307,0.000315,172.31.40.0-255,66,51353,65,158404
7308,0.00034,172.217.27.0-255,2902,54255,65,158404
7309,0.000343,172.31.40.0-255,66,54321,65,158404
7310,0.000355,172.217.27.0-255,2902,57223,65,158404
7311,0.000358,172.31.40.0-255,66,57289,65,158404
7312,0.000393,172.31.40.0-255,66,57355,65,158404
7313,0.000769,172.217.27.0-255,114,57469,65,158404
7314,0.000775,172.217.27.0-255,330,57799,65,158404
7315,0.001057,172.217.27.0-255,1484,59283,65,158404
7316,0.001064,172.31.40.0-255,66,59349,65,158404
7317,0.001071,172.217.27.0-255,2902,62251,65,158404
7318,0.001073,172.31.40.0-255,66,62317,65,158404
7319,0.001079,172.217.27.0-255,4320,66637,65,158404
7320,0.001082,172.31.40.0-255,66,66703,65,158404
7321,0.001096,172.217.27.0-255,1484,68187,65,158404
7322,0.001119,172.217.27.0-255,7156,75343,65,158404
7323,0.001122,172.31.40.0-255,66,75409,65,158404
7324,0.001125,172.217.27.0-255,1484,76893,65,158404
7325,0.001154,172.31.40.0-255,66,76959,65,158404
7326,0.001158,172.217.27.0-255,2184,79143,65,158404
7327,0.00116,172.31.40.0-255,66,79209,65,158404
7328,0.001164,172.217.27.0-255,2902,82111,65,158404
7329,0.001166,172.31.40.0-255,66,82177,65,158404
7330,0.001174,172.217.27.0-255,7156,89333,65,158404
7331,0.001177,172.31.40.0-255,66,89399,65,158404
7332,0.001182,172.217.27.0-255,2902,92301,65,158404
7333,0.001184,172.31.40.0-255,66,92367,65,158404
7334,0.001211,172.217.27.0-255,3413,95780,65,158404
7335,0.001214,172.31.40.0-255,66,95846,65,158404
7336,0.002813,172.217.27.0-255,1484,97330,65,158404
7337,0.00285,172.217.27.0-255,2902,100232,65,158404
7338,0.002856,172.31.40.0-255,66,100298,65,158404
7339,0.002872,172.217.27.0-255,1484,101782,65,158404
7340,0.004528,172.217.27.0-255,4320,106102,65,158404
7341,0.004532,172.31.40.0-255,66,106168,65,158404
7342,0.006164,172.217.27.0-255,5738,111906,65,158404
7343,0.006172,172.31.40.0-255,66,111972,65,158404
7344,0.007809,172.217.27.0-255,5738,117710,65,158404
7345,0.007815,172.31.40.0-255,66,117776,65,158404
7346,0.009458,172.217.27.0-255,5738,123514,65,158404
7347,0.009466,172.31.40.0-255,66,123580,65,158404
7348,0.011101,172.217.27.0-255,5738,129318,65,158404
7349,0.011106,172.31.40.0-255,66,129384,65,158404
7350,0.012748,172.217.27.0-255,5738,135122,65,158404
7351,0.012756,172.31.40.0-255,66,135188,65,158404
7352,0.014397,172.217.27.0-255,5738,140926,65,158404
7353,0.014406,172.31.40.0-255,66,140992,65,158404
7354,0.016031,172.217.27.0-255,5738,146730,65,158404
7355,0.016038,172.31.40.0-255,66,146796,65,158404
7356,0.017681,172.217.27.0-255,5738,152534,65,158404
7357,0.017688,172.31.40.0-255,66,152600,65,158404
7358,0.019322,172.217.27.0-255,5738,158338,65,158404
7359,0.019331,172.31.40.0-255,66,158404,65,158404
7360,0.0,74.125.24.0-255,146,146,65,205757
7361,2.6e-05,172.31.40.0-255,66,212,65,205757
7362,3.3e-05,74.125.24.0-255,1484,1696,65,205757
7363,3.8e-05,172.31.40.0-255,66,1762,65,205757
7364,4.4e-05,74.125.24.0-255,2902,4664,65,205757
7365,4.8e-05,172.31.40.0-255,66,4730,65,205757
7366,5.4e-05,74.125.24.0-255,5738,10468,65,205757
7367,5.9e-05,172.31.40.0-255,66,10534,65,205757
7368,8.9e-05,172.31.40.0-255,66,10600,65,205757
7369,0.000104,74.125.24.0-255,649,11249,65,205757
7370,0.000106,172.31.40.0-255,66,11315,65,205757
7371,0.000127,74.125.24.0-255,5738,17053,65,205757
7372,0.00013,172.31.40.0-255,66,17119,65,205757
7373,0.000153,74.125.24.0-255,2543,19662,65,205757
7374,0.000155,172.31.40.0-255,66,19728,65,205757
7375,0.000232,74.125.24.0-255,1484,21212,65,205757
7376,0.000235,172.31.40.0-255,66,21278,65,205757
7377,0.000239,74.125.24.0-255,2902,24180,65,205757
7378,0.000242,172.31.40.0-255,66,24246,65,205757
7379,0.000261,74.125.24.0-255,5738,29984,65,205757
7380,0.000264,172.31.40.0-255,66,30050,65,205757
7381,0.000267,74.125.24.0-255,1484,31534,65,205757
7382,0.000269,172.31.40.0-255,66,31600,65,205757
7383,0.000292,74.125.24.0-255,5379,36979,65,205757
7384,0.000294,172.31.40.0-255,66,37045,65,205757
7385,0.00031,74.125.24.0-255,4320,41365,65,205757
7386,0.000312,172.31.40.0-255,66,41431,65,205757
7387,0.000333,172.31.40.0-255,66,41497,65,205757
7388,0.000337,74.125.24.0-255,2818,44315,65,205757
7389,0.000339,172.31.40.0-255,66,44381,65,205757
7390,0.000342,74.125.24.0-255,129,44510,65,205757
7391,0.000431,74.125.24.0-255,1484,45994,65,205757
7392,0.000461,74.125.24.0-255,2902,48896,65,205757
7393,0.000468,74.125.24.0-255,5738,54634,65,205757
7394,0.000473,74.125.24.0-255,2902,57536,65,205757
7395,0.000494,74.125.24.0-255,5379,62915,65,205757
7396,0.000506,74.125.24.0-255,2902,65817,65,205757
7397,0.000632,172.31.40.0-255,66,65883,65,205757
7398,0.000655,74.125.24.0-255,1484,67367,65,205757
7399,0.000683,74.125.24.0-255,2902,70269,65,205757
7400,0.00069,172.31.40.0-255,66,70335,65,205757
7401,0.000701,74.125.24.0-255,5738,76073,65,205757
7402,0.000712,172.31.40.0-255,66,76139,65,205757
7403,0.000735,74.125.24.0-255,7156,83295,65,205757
7404,0.000751,74.125.24.0-255,4320,87615,65,205757
7405,0.000756,172.31.40.0-255,66,87681,65,205757
7406,0.000764,74.125.24.0-255,2902,90583,65,205757
7407,0.000768,172.31.40.0-255,66,90649,65,205757
7408,0.000808,172.31.40.0-255,66,90715,65,205757
7409,0.000867,74.125.24.0-255,1484,92199,65,205757
7410,0.00088,74.125.24.0-255,2902,95101,65,205757
7411,0.000894,74.125.24.0-255,4320,99421,65,205757
7412,0.000901,172.31.40.0-255,66,99487,65,205757
7413,0.000911,74.125.24.0-255,1484,100971,65,205757
7414,0.000933,74.125.24.0-255,5738,106709,65,205757
7415,0.000943,172.31.40.0-255,66,106775,65,205757
7416,0.000959,74.125.24.0-255,7156,113931,65,205757
7417,0.000982,172.31.40.0-255,66,113997,65,205757
7418,0.000995,74.125.24.0-255,1484,115481,65,205757
7419,0.001042,172.31.40.0-255,66,115547,65,205757
7420,0.001096,74.125.24.0-255,1484,117031,65,205757
7421,0.0011,74.125.24.0-255,1484,118515,65,205757
7422,0.001114,74.125.24.0-255,1484,119999,65,205757
7423,0.001117,74.125.24.0-255,1484,121483,65,205757
7424,0.00112,172.31.40.0-255,66,121549,65,205757
7425,0.00113,172.31.40.0-255,66,121615,65,205757
7426,0.001145,74.125.24.0-255,4320,125935,65,205757
7427,0.001152,74.125.24.0-255,5738,131673,65,205757
7428,0.001159,74.125.24.0-255,7156,138829,65,205757
7429,0.001193,172.31.40.0-255,66,138895,65,205757
7430,0.001204,74.125.24.0-255,2184,141079,65,205757
7431,0.001208,172.31.40.0-255,66,141145,65,205757
7432,0.001228,74.125.24.0-255,4320,145465,65,205757
7433,0.001248,74.125.24.0-255,7156,152621,65,205757
7434,0.001252,74.125.24.0-255,2902,155523,65,205757
7435,0.001301,172.31.40.0-255,66,155589,65,205757
7436,0.001319,74.125.24.0-255,3602,159191,65,205757
7437,0.001331,172.31.40.0-255,66,159257,65,205757
7438,0.001601,74.125.24.0-255,1484,160741,65,205757
7439,0.001607,74.125.24.0-255,2902,163643,65,205757
7440,0.00161,74.125.24.0-255,1484,165127,65,205757
7441,0.001624,74.125.24.0-255,4320,169447,65,205757
7442,0.001636,172.31.40.0-255,66,169513,65,205757
7443,0.001679,74.125.24.0-255,7156,176669,65,205757
7444,0.001686,172.31.40.0-255,66,176735,65,205757
7445,0.001696,74.125.24.0-255,1484,178219,65,205757
7446,0.001714,74.125.24.0-255,2184,180403,65,205757
7447,0.001722,172.31.40.0-255,66,180469,65,205757
7448,0.001743,74.125.24.0-255,4320,184789,65,205757
7449,0.001762,74.125.24.0-255,4320,189109,65,205757
7450,0.001768,172.31.40.0-255,66,189175,65,205757
7451,0.001805,172.31.40.0-255,66,189241,65,205757
7452,0.001853,74.125.24.0-255,5738,194979,65,205757
7453,0.001874,172.31.40.0-255,66,195045,65,205757
7454,0.001907,172.31.40.0-255,66,195111,65,205757
7455,0.001917,74.125.24.0-255,1484,196595,65,205757
7456,0.001969,74.125.24.0-255,5020,201615,65,205757
7457,0.002001,74.125.24.0-255,2902,204517,65,205757
7458,0.002004,74.125.24.0-255,766,205283,65,205757
7459,0.002026,172.31.40.0-255,66,205349,65,205757
7460,0.002097,74.125.24.0-255,105,205454,65,205757
7461,0.0021,172.31.40.0-255,66,205520,65,205757
7462,0.002125,172.31.40.0-255,66,205586,65,205757
7463,0.004787,172.31.40.0-255,105,205691,65,205757
7464,0.007098,74.125.24.0-255,66,205757,65,205757
7465,0.0,74.125.24.0-255,143,143,65,136158
7466,2.6e-05,172.31.40.0-255,66,209,65,136158
7467,5.2e-05,74.125.24.0-255,1484,1693,65,136158
7468,5.6e-05,172.31.40.0-255,66,1759,65,136158
7469,6.3e-05,74.125.24.0-255,2902,4661,65,136158
7470,6.6e-05,172.31.40.0-255,66,4727,65,136158
7471,7.2e-05,74.125.24.0-255,4320,9047,65,136158
7472,7.6e-05,172.31.40.0-255,66,9113,65,136158
7473,8.2e-05,74.125.24.0-255,4936,14049,65,136158
7474,8.5e-05,172.31.40.0-255,66,14115,65,136158
7475,8.8e-05,74.125.24.0-255,1484,15599,65,136158
7476,9.1e-05,172.31.40.0-255,66,15665,65,136158
7477,0.000119,74.125.24.0-255,4320,19985,65,136158
7478,0.000121,172.31.40.0-255,66,20051,65,136158
7479,0.000135,74.125.24.0-255,2902,22953,65,136158
7480,0.000138,172.31.40.0-255,66,23019,65,136158
7481,0.000158,172.31.40.0-255,66,23085,65,136158
7482,0.000193,74.125.24.0-255,1484,24569,65,136158
7483,0.000195,172.31.40.0-255,66,24635,65,136158
7484,0.0002,74.125.24.0-255,2902,27537,65,136158
7485,0.000202,172.31.40.0-255,66,27603,65,136158
7486,0.00023,74.125.24.0-255,5738,33341,65,136158
7487,0.000232,172.31.40.0-255,66,33407,65,136158
7488,0.000237,74.125.24.0-255,2902,36309,65,136158
7489,0.000239,172.31.40.0-255,66,36375,65,136158
7490,0.000262,172.31.40.0-255,66,36441,65,136158
7491,0.000285,74.125.24.0-255,2902,39343,65,136158
7492,0.000288,172.31.40.0-255,66,39409,65,136158
7493,0.000314,172.31.40.0-255,66,39475,65,136158
7494,0.000419,74.125.24.0-255,645,40120,65,136158
7495,0.000559,74.125.24.0-255,1484,41604,65,136158
7496,0.000565,172.31.40.0-255,66,41670,65,136158
7497,0.00057,74.125.24.0-255,2902,44572,65,136158
7498,0.000572,172.31.40.0-255,66,44638,65,136158
7499,0.000577,74.125.24.0-255,2902,47540,65,136158
7500,0.00058,172.31.40.0-255,66,47606,65,136158
7501,0.000599,74.125.24.0-255,2902,50508,65,136158
7502,0.000601,172.31.40.0-255,66,50574,65,136158
7503,0.000614,172.31.40.0-255,66,50640,65,136158
7504,0.000651,74.125.24.0-255,4320,54960,65,136158
7505,0.000654,172.31.40.0-255,66,55026,65,136158
7506,0.000687,172.31.40.0-255,66,55092,65,136158
7507,0.001284,74.125.24.0-255,1484,56576,65,136158
7508,0.001292,74.125.24.0-255,2902,59478,65,136158
7509,0.001295,172.31.40.0-255,66,59544,65,136158
7510,0.001299,74.125.24.0-255,1484,61028,65,136158
7511,0.001319,74.125.24.0-255,4320,65348,65,136158
7512,0.001321,172.31.40.0-255,66,65414,65,136158
7513,0.001324,74.125.24.0-255,1484,66898,65,136158
7514,0.001351,74.125.24.0-255,7156,74054,65,136158
7515,0.001354,172.31.40.0-255,66,74120,65,136158
7516,0.001366,172.31.40.0-255,66,74186,65,136158
7517,0.00137,74.125.24.0-255,1484,75670,65,136158
7518,0.001387,74.125.24.0-255,3602,79272,65,136158
7519,0.001389,172.31.40.0-255,66,79338,65,136158
7520,0.002271,74.125.24.0-255,1484,80822,65,136158
7521,0.002282,74.125.24.0-255,2902,83724,65,136158
7522,0.002287,172.31.40.0-255,66,83790,65,136158
7523,0.002294,74.125.24.0-255,4320,88110,65,136158
7524,0.002296,172.31.40.0-255,66,88176,65,136158
7525,0.002331,172.31.40.0-255,66,88242,65,136158
7526,0.002354,74.125.24.0-255,7156,95398,65,136158
7527,0.002356,172.31.40.0-255,66,95464,65,136158
7528,0.002387,172.31.40.0-255,66,95530,65,136158
7529,0.004762,74.125.24.0-255,5738,101268,65,136158
7530,0.004767,172.31.40.0-255,66,101334,65,136158
7531,0.007224,74.125.24.0-255,5738,107072,65,136158
7532,0.007231,172.31.40.0-255,66,107138,65,136158
7533,0.00964,74.125.24.0-255,5738,112876,65,136158
7534,0.009648,172.31.40.0-255,66,112942,65,136158
7535,0.012057,74.125.24.0-255,5738,118680,65,136158
7536,0.012066,172.31.40.0-255,66,118746,65,136158
7537,0.014422,74.125.24.0-255,5738,124484,65,136158
7538,0.01443,172.31.40.0-255,66,124550,65,136158
7539,0.016818,74.125.24.0-255,5738,130288,65,136158
7540,0.016827,172.31.40.0-255,66,130354,65,136158
7541,0.019192,74.125.24.0-255,5738,136092,65,136158
7542,0.0192,172.31.40.0-255,66,136158,65,136158
7543,0.0,74.125.68.0-255,155,155,65,332376
7544,2.3e-05,172.31.40.0-255,66,221,65,332376
7545,3e-05,74.125.68.0-255,1484,1705,65,332376
7546,3.5e-05,172.31.40.0-255,66,1771,65,332376
7547,3.8e-05,74.125.68.0-255,1484,3255,65,332376
7548,4.2e-05,172.31.40.0-255,66,3321,65,332376
7549,4.8e-05,74.125.68.0-255,2902,6223,65,332376
7550,5.1e-05,172.31.40.0-255,66,6289,65,332376
7551,5.8e-05,74.125.68.0-255,5738,12027,65,332376
7552,6.2e-05,172.31.40.0-255,66,12093,65,332376
7553,6.6e-05,74.125.68.0-255,2099,14192,65,332376
7554,6.8e-05,172.31.40.0-255,66,14258,65,332376
7555,7.3e-05,74.125.68.0-255,2902,17160,65,332376
7556,7.6e-05,172.31.40.0-255,66,17226,65,332376
7557,8.1e-05,74.125.68.0-255,4320,21546,65,332376
7558,8.4e-05,172.31.40.0-255,66,21612,65,332376
7559,0.000107,74.125.68.0-255,5738,27350,65,332376
7560,0.00011,172.31.40.0-255,66,27416,65,332376
7561,0.000128,74.125.68.0-255,2902,30318,65,332376
7562,0.00013,172.31.40.0-255,66,30384,65,332376
7563,0.000133,74.125.68.0-255,1125,31509,65,332376
7564,0.000135,172.31.40.0-255,66,31575,65,332376
7565,0.000211,74.125.68.0-255,1484,33059,65,332376
7566,0.000215,172.31.40.0-255,66,33125,65,332376
7567,0.000218,74.125.68.0-255,1484,34609,65,332376
7568,0.00022,172.31.40.0-255,66,34675,65,332376
7569,0.000235,74.125.68.0-255,1484,36159,65,332376
7570,0.000237,172.31.40.0-255,66,36225,65,332376
7571,0.000244,74.125.68.0-255,5738,41963,65,332376
7572,0.000247,172.31.40.0-255,66,42029,65,332376
7573,0.000271,74.125.68.0-255,4320,46349,65,332376
7574,0.000274,172.31.40.0-255,66,46415,65,332376
7575,0.000286,74.125.68.0-255,3961,50376,65,332376
7576,0.000288,172.31.40.0-255,66,50442,65,332376
7577,0.000292,74.125.68.0-255,1484,51926,65,332376
7578,0.000323,74.125.68.0-255,7156,59082,65,332376
7579,0.000327,172.31.40.0-255,66,59148,65,332376
7580,0.00033,74.125.68.0-255,1484,60632,65,332376
7581,0.000347,74.125.68.0-255,5691,66323,65,332376
7582,0.00035,172.31.40.0-255,66,66389,65,332376
7583,0.000352,74.125.68.0-255,112,66501,65,332376
7584,0.000379,74.125.68.0-255,329,66830,65,332376
7585,0.000717,74.125.68.0-255,1484,68314,65,332376
7586,0.000722,172.31.40.0-255,66,68380,65,332376
7587,0.000728,74.125.68.0-255,2902,71282,65,332376
7588,0.00073,172.31.40.0-255,66,71348,65,332376
7589,0.000758,74.125.68.0-255,5738,77086,65,332376
7590,0.000761,172.31.40.0-255,66,77152,65,332376
7591,0.000789,74.125.68.0-255,5738,82890,65,332376
7592,0.000792,172.31.40.0-255,66,82956,65,332376
7593,0.000806,74.125.68.0-255,5738,88694,65,332376
7594,0.000811,74.125.68.0-255,4320,93014,65,332376
7595,0.000814,172.31.40.0-255,66,93080,65,332376
7596,0.000817,172.31.40.0-255,66,93146,65,332376
7597,0.000846,172.31.40.0-255,66,93212,65,332376
7598,0.000972,74.125.68.0-255,1484,94696,65,332376
7599,0.000989,74.125.68.0-255,2902,97598,65,332376
7600,0.000992,172.31.40.0-255,66,97664,65,332376
7601,0.000997,74.125.68.0-255,2902,100566,65,332376
7602,0.000999,172.31.40.0-255,66,100632,65,332376
7603,0.001016,74.125.68.0-255,2902,103534,65,332376
7604,0.001019,172.31.40.0-255,66,103600,65,332376
7605,0.001033,74.125.68.0-255,2902,106502,65,332376
7606,0.001036,172.31.40.0-255,66,106568,65,332376
7607,0.001062,172.31.40.0-255,66,106634,65,332376
7608,0.001091,74.125.68.0-255,2902,109536,65,332376
7609,0.001094,172.31.40.0-255,66,109602,65,332376
7610,0.001124,172.31.40.0-255,66,109668,65,332376
7611,0.001224,74.125.68.0-255,1484,111152,65,332376
7612,0.001239,74.125.68.0-255,2902,114054,65,332376
7613,0.001243,172.31.40.0-255,66,114120,65,332376
7614,0.001267,74.125.68.0-255,5738,119858,65,332376
7615,0.00127,172.31.40.0-255,66,119924,65,332376
7616,0.001292,74.125.68.0-255,4320,124244,65,332376
7617,0.001294,172.31.40.0-255,66,124310,65,332376
7618,0.001297,74.125.68.0-255,1484,125794,65,332376
7619,0.001317,74.125.68.0-255,4320,130114,65,332376
7620,0.001324,172.31.40.0-255,66,130180,65,332376
7621,0.00136,74.125.68.0-255,2902,133082,65,332376
7622,0.001363,172.31.40.0-255,66,133148,65,332376
7623,0.001394,172.31.40.0-255,66,133214,65,332376
7624,0.001398,74.125.68.0-255,2184,135398,65,332376
7625,0.0014,172.31.40.0-255,66,135464,65,332376
7626,0.001527,74.125.68.0-255,1484,136948,65,332376
7627,0.001531,74.125.68.0-255,1484,138432,65,332376
7628,0.001534,172.31.40.0-255,66,138498,65,332376
7629,0.001556,74.125.68.0-255,1484,139982,65,332376
7630,0.001561,74.125.68.0-255,4320,144302,65,332376
7631,0.001578,74.125.68.0-255,7156,151458,65,332376
7632,0.001597,172.31.40.0-255,66,151524,65,332376
7633,0.0016,74.125.68.0-255,1484,153008,65,332376
7634,0.001606,74.125.68.0-255,5738,158746,65,332376
7635,0.001612,74.125.68.0-255,7156,165902,65,332376
7636,0.001623,172.31.40.0-255,66,165968,65,332376
7637,0.001641,74.125.68.0-255,3602,169570,65,332376
7638,0.001653,172.31.40.0-255,66,169636,65,332376
7639,0.00179,74.125.68.0-255,1484,171120,65,332376
7640,0.001795,74.125.68.0-255,1484,172604,65,332376
7641,0.001798,172.31.40.0-255,66,172670,65,332376
7642,0.001814,74.125.68.0-255,1484,174154,65,332376
7643,0.001819,74.125.68.0-255,2902,177056,65,332376
7644,0.001835,74.125.68.0-255,2902,179958,65,332376
7645,0.001838,74.125.68.0-255,1484,181442,65,332376
7646,0.001843,172.31.40.0-255,66,181508,65,332376
7647,0.001858,74.125.68.0-255,4320,185828,65,332376
7648,0.001863,74.125.68.0-255,4320,190148,65,332376
7649,0.001877,172.31.40.0-255,66,190214,65,332376
7650,0.001882,74.125.68.0-255,2902,193116,65,332376
7651,0.001892,172.31.40.0-255,66,193182,65,332376
7652,0.001897,74.125.68.0-255,4320,197502,65,332376
7653,0.001916,172.31.40.0-255,66,197568,65,332376
7654,0.001923,74.125.68.0-255,6438,204006,65,332376
7655,0.001934,172.31.40.0-255,66,204072,65,332376
7656,0.001975,74.125.68.0-255,1484,205556,65,332376
7657,0.001993,74.125.68.0-255,2902,208458,65,332376
7658,0.001996,74.125.68.0-255,1484,209942,65,332376
7659,0.002013,74.125.68.0-255,2902,212844,65,332376
7660,0.002019,172.31.40.0-255,66,212910,65,332376
7661,0.002036,74.125.68.0-255,4320,217230,65,332376
7662,0.002041,172.31.40.0-255,66,217296,65,332376
7663,0.00206,74.125.68.0-255,4320,221616,65,332376
7664,0.002065,74.125.68.0-255,4320,225936,65,332376
7665,0.00207,74.125.68.0-255,5738,231674,65,332376
7666,0.002094,74.125.68.0-255,1484,233158,65,332376
7667,0.002119,74.125.68.0-255,5020,238178,65,332376
7668,0.00221,74.125.68.0-255,1484,239662,65,332376
7669,0.002216,74.125.68.0-255,2902,242564,65,332376
7670,0.002218,74.125.68.0-255,1484,244048,65,332376
7671,0.002235,74.125.68.0-255,4320,248368,65,332376
7672,0.002271,74.125.68.0-255,4320,252688,65,332376
7673,0.002285,74.125.68.0-255,5738,258426,65,332376
7674,0.002287,74.125.68.0-255,1484,259910,65,332376
7675,0.002304,74.125.68.0-255,3602,263512,65,332376
7676,0.002349,74.125.68.0-255,1484,264996,65,332376
7677,0.002366,74.125.68.0-255,2902,267898,65,332376
7678,0.002393,74.125.68.0-255,5738,273636,65,332376
7679,0.002397,74.125.68.0-255,2902,276538,65,332376
7680,0.002399,74.125.68.0-255,1484,278022,65,332376
7681,0.002412,74.125.68.0-255,2902,280924,65,332376
7682,0.002423,74.125.68.0-255,1484,282408,65,332376
7683,0.002445,74.125.68.0-255,7156,289564,65,332376
7684,0.002451,74.125.68.0-255,5738,295302,65,332376
7685,0.002474,74.125.68.0-255,4320,299622,65,332376
7686,0.002488,74.125.68.0-255,2184,301806,65,332376
7687,0.002506,74.125.68.0-255,5738,307544,65,332376
7688,0.002523,74.125.68.0-255,1484,309028,65,332376
7689,0.002557,74.125.68.0-255,4320,313348,65,332376
7690,0.002569,74.125.68.0-255,1484,314832,65,332376
7691,0.012385,172.31.40.0-255,66,314898,65,332376
7692,0.013402,74.125.68.0-255,1484,316382,65,332376
7693,0.014911,74.125.68.0-255,4320,320702,65,332376
7694,0.014917,172.31.40.0-255,66,320768,65,332376
7695,0.017441,74.125.68.0-255,5738,326506,65,332376
7696,0.017447,172.31.40.0-255,66,326572,65,332376
7697,0.019959,74.125.68.0-255,5738,332310,65,332376
7698,0.019972,172.31.40.0-255,66,332376,65,332376
7699,0.0,172.31.40.0-255,105,105,65,276
7700,0.001791,157.240.24.0-255,105,210,65,276
7701,0.001806,172.31.40.0-255,66,276,65,276
7702,0.0,74.125.24.0-255,152,152,65,279666
7703,1.7e-05,172.31.40.0-255,66,218,65,279666
7704,2.4e-05,74.125.24.0-255,1484,1702,65,279666
7705,2.8e-05,172.31.40.0-255,66,1768,65,279666
7706,5.6e-05,74.125.24.0-255,2902,4670,65,279666
7707,6e-05,172.31.40.0-255,66,4736,65,279666
7708,6.7e-05,74.125.24.0-255,5738,10474,65,279666
7709,7e-05,172.31.40.0-255,66,10540,65,279666
7710,7.6e-05,74.125.24.0-255,3356,13896,65,279666
7711,7.9e-05,172.31.40.0-255,66,13962,65,279666
7712,0.000117,74.125.24.0-255,2902,16864,65,279666
7713,0.00012,172.31.40.0-255,66,16930,65,279666
7714,0.00016,172.31.40.0-255,66,16996,65,279666
7715,0.000191,74.125.24.0-255,5379,22375,65,279666
7716,0.000194,172.31.40.0-255,66,22441,65,279666
7717,0.00033,74.125.24.0-255,1484,23925,65,279666
7718,0.000335,172.31.40.0-255,66,23991,65,279666
7719,0.000342,74.125.24.0-255,2902,26893,65,279666
7720,0.000343,172.31.40.0-255,66,26959,65,279666
7721,0.000378,74.125.24.0-255,5738,32697,65,279666
7722,0.000381,172.31.40.0-255,66,32763,65,279666
7723,0.000387,74.125.24.0-255,4320,37083,65,279666
7724,0.000389,172.31.40.0-255,66,37149,65,279666
7725,0.000422,172.31.40.0-255,66,37215,65,279666
7726,0.000452,74.125.24.0-255,1125,38340,65,279666
7727,0.000454,172.31.40.0-255,66,38406,65,279666
7728,0.000459,74.125.24.0-255,2902,41308,65,279666
7729,0.000461,172.31.40.0-255,66,41374,65,279666
7730,0.000492,74.125.24.0-255,3961,45335,65,279666
7731,0.000495,172.31.40.0-255,66,45401,65,279666
7732,0.000519,74.125.24.0-255,403,45804,65,279666
7733,0.000577,74.125.24.0-255,112,45916,65,279666
7734,0.000762,74.125.24.0-255,1484,47400,65,279666
7735,0.000767,172.31.40.0-255,66,47466,65,279666
7736,0.000771,74.125.24.0-255,1484,48950,65,279666
7737,0.000797,74.125.24.0-255,1484,50434,65,279666
7738,0.000799,172.31.40.0-255,66,50500,65,279666
7739,0.000807,74.125.24.0-255,5738,56238,65,279666
7740,0.000809,172.31.40.0-255,66,56304,65,279666
7741,0.000841,74.125.24.0-255,6797,63101,65,279666
7742,0.000843,172.31.40.0-255,66,63167,65,279666
7743,0.000851,74.125.24.0-255,7156,70323,65,279666
7744,0.000854,172.31.40.0-255,66,70389,65,279666
7745,0.000878,74.125.24.0-255,5738,76127,65,279666
7746,0.000881,172.31.40.0-255,66,76193,65,279666
7747,0.000907,74.125.24.0-255,3961,80154,65,279666
7748,0.00091,172.31.40.0-255,66,80220,65,279666
7749,0.001088,74.125.24.0-255,1484,81704,65,279666
7750,0.001095,74.125.24.0-255,2902,84606,65,279666
7751,0.001098,172.31.40.0-255,66,84672,65,279666
7752,0.001124,74.125.24.0-255,5738,90410,65,279666
7753,0.001126,172.31.40.0-255,66,90476,65,279666
7754,0.001129,74.125.24.0-255,1484,91960,65,279666
7755,0.001156,74.125.24.0-255,2902,94862,65,279666
7756,0.001161,172.31.40.0-255,66,94928,65,279666
7757,0.001186,74.125.24.0-255,2222,97150,65,279666
7758,0.001188,172.31.40.0-255,66,97216,65,279666
7759,0.001266,74.125.24.0-255,1484,98700,65,279666
7760,0.00129,74.125.24.0-255,2902,101602,65,279666
7761,0.001293,172.31.40.0-255,66,101668,65,279666
7762,0.0013,74.125.24.0-255,5738,107406,65,279666
7763,0.001302,172.31.40.0-255,66,107472,65,279666
7764,0.001344,74.125.24.0-255,1484,108956,65,279666
7765,0.00139,172.31.40.0-255,66,109022,65,279666
7766,0.001393,172.31.40.0-255,66,109088,65,279666
7767,0.001432,74.125.24.0-255,1484,110572,65,279666
7768,0.00145,74.125.24.0-255,2902,113474,65,279666
7769,0.001454,172.31.40.0-255,66,113540,65,279666
7770,0.001476,74.125.24.0-255,5738,119278,65,279666
7771,0.001479,172.31.40.0-255,66,119344,65,279666
7772,0.001512,74.125.24.0-255,6797,126141,65,279666
7773,0.001516,172.31.40.0-255,66,126207,65,279666
7774,0.002307,74.125.24.0-255,1484,127691,65,279666
7775,0.002315,74.125.24.0-255,2902,130593,65,279666
7776,0.002319,172.31.40.0-255,66,130659,65,279666
7777,0.002326,74.125.24.0-255,5738,136397,65,279666
7778,0.002328,172.31.40.0-255,66,136463,65,279666
7779,0.002339,74.125.24.0-255,4320,140783,65,279666
7780,0.002341,172.31.40.0-255,66,140849,65,279666
7781,0.002365,74.125.24.0-255,5738,146587,65,279666
7782,0.002368,172.31.40.0-255,66,146653,65,279666
7783,0.002403,74.125.24.0-255,5738,152391,65,279666
7784,0.002406,172.31.40.0-255,66,152457,65,279666
7785,0.002416,172.31.40.0-255,66,152523,65,279666
7786,0.002456,74.125.24.0-255,2902,155425,65,279666
7787,0.002459,172.31.40.0-255,66,155491,65,279666
7788,0.002462,74.125.24.0-255,1484,156975,65,279666
7789,0.002488,74.125.24.0-255,2902,159877,65,279666
7790,0.002491,172.31.40.0-255,66,159943,65,279666
7791,0.002522,74.125.24.0-255,5738,165681,65,279666
7792,0.002525,172.31.40.0-255,66,165747,65,279666
7793,0.002529,74.125.24.0-255,2902,168649,65,279666
7794,0.002532,172.31.40.0-255,66,168715,65,279666
7795,0.002559,172.31.40.0-255,66,168781,65,279666
7796,0.002595,172.31.40.0-255,66,168847,65,279666
7797,0.00261,74.125.24.0-255,5020,173867,65,279666
7798,0.002612,172.31.40.0-255,66,173933,65,279666
7799,0.002624,74.125.24.0-255,7156,181089,65,279666
7800,0.002626,172.31.40.0-255,66,181155,65,279666
7801,0.00263,74.125.24.0-255,2902,184057,65,279666
7802,0.002636,172.31.40.0-255,66,184123,65,279666
7803,0.00266,74.125.24.0-255,1125,185248,65,279666
7804,0.002755,74.125.24.0-255,1484,186732,65,279666
7805,0.00276,172.31.40.0-255,66,186798,65,279666
7806,0.002765,74.125.24.0-255,1484,188282,65,279666
7807,0.00279,74.125.24.0-255,1484,189766,65,279666
7808,0.002793,172.31.40.0-255,66,189832,65,279666
7809,0.0028,74.125.24.0-255,5738,195570,65,279666
7810,0.002803,172.31.40.0-255,66,195636,65,279666
7811,0.002808,74.125.24.0-255,4320,199956,65,279666
7812,0.002811,172.31.40.0-255,66,200022,65,279666
7813,0.002814,74.125.24.0-255,1484,201506,65,279666
7814,0.002848,172.31.40.0-255,66,201572,65,279666
7815,0.002858,172.31.40.0-255,66,201638,65,279666
7816,0.003311,74.125.24.0-255,1484,203122,65,279666
7817,0.003318,74.125.24.0-255,2902,206024,65,279666
7818,0.003322,172.31.40.0-255,66,206090,65,279666
7819,0.003328,74.125.24.0-255,4320,210410,65,279666
7820,0.003331,172.31.40.0-255,66,210476,65,279666
7821,0.003369,74.125.24.0-255,1484,211960,65,279666
7822,0.003376,74.125.24.0-255,5738,217698,65,279666
7823,0.003378,172.31.40.0-255,66,217764,65,279666
7824,0.003386,74.125.24.0-255,7156,224920,65,279666
7825,0.003388,172.31.40.0-255,66,224986,65,279666
7826,0.003424,74.125.24.0-255,2902,227888,65,279666
7827,0.003426,172.31.40.0-255,66,227954,65,279666
7828,0.003457,172.31.40.0-255,66,228020,65,279666
7829,0.00387,74.125.24.0-255,1484,229504,65,279666
7830,0.003903,74.125.24.0-255,2902,232406,65,279666
7831,0.003908,172.31.40.0-255,66,232472,65,279666
7832,0.003914,74.125.24.0-255,5738,238210,65,279666
7833,0.003917,172.31.40.0-255,66,238276,65,279666
7834,0.003927,74.125.24.0-255,4320,242596,65,279666
7835,0.00393,172.31.40.0-255,66,242662,65,279666
7836,0.003936,74.125.24.0-255,7156,249818,65,279666
7837,0.003939,172.31.40.0-255,66,249884,65,279666
7838,0.003979,172.31.40.0-255,66,249950,65,279666
7839,0.003984,74.125.24.0-255,3602,253552,65,279666
7840,0.003986,172.31.40.0-255,66,253618,65,279666
7841,0.004128,74.125.24.0-255,1484,255102,65,279666
7842,0.004132,74.125.24.0-255,1484,256586,65,279666
7843,0.004134,172.31.40.0-255,66,256652,65,279666
7844,0.004151,74.125.24.0-255,1484,258136,65,279666
7845,0.004158,74.125.24.0-255,5738,263874,65,279666
7846,0.004165,172.31.40.0-255,66,263940,65,279666
7847,0.004171,74.125.24.0-255,5738,269678,65,279666
7848,0.004174,172.31.40.0-255,66,269744,65,279666
7849,0.004205,172.31.40.0-255,66,269810,65,279666
7850,0.004232,74.125.24.0-255,2902,272712,65,279666
7851,0.004234,172.31.40.0-255,66,272778,65,279666
7852,0.00424,74.125.24.0-255,5020,277798,65,279666
7853,0.004243,172.31.40.0-255,66,277864,65,279666
7854,0.004282,172.31.40.0-255,66,277930,65,279666
7855,0.004313,74.125.24.0-255,1394,279324,65,279666
7856,0.004385,74.125.24.0-255,105,279429,65,279666
7857,0.010441,172.31.40.0-255,66,279495,65,279666
7858,0.010487,172.31.40.0-255,105,279600,65,279666
7859,0.012503,74.125.24.0-255,66,279666,65,279666
7860,0.0,74.125.24.0-255,145,145,65,244035
7861,2.2e-05,172.31.40.0-255,66,211,65,244035
7862,3e-05,74.125.24.0-255,1484,1695,65,244035
7863,3.4e-05,172.31.40.0-255,66,1761,65,244035
7864,4e-05,74.125.24.0-255,2902,4663,65,244035
7865,5.1e-05,172.31.40.0-255,66,4729,65,244035
7866,5.9e-05,74.125.24.0-255,7156,11885,65,244035
7867,6.3e-05,172.31.40.0-255,66,11951,65,244035
7868,6.7e-05,74.125.24.0-255,2127,14078,65,244035
7869,6.9e-05,172.31.40.0-255,66,14144,65,244035
7870,0.000134,74.125.24.0-255,1484,15628,65,244035
7871,0.000137,172.31.40.0-255,66,15694,65,244035
7872,0.000142,74.125.24.0-255,2902,18596,65,244035
7873,0.000145,172.31.40.0-255,66,18662,65,244035
7874,0.000176,74.125.24.0-255,5738,24400,65,244035
7875,0.000179,172.31.40.0-255,66,24466,65,244035
7876,0.000187,74.125.24.0-255,6797,31263,65,244035
7877,0.000189,172.31.40.0-255,66,31329,65,244035
7878,0.000254,74.125.24.0-255,1484,32813,65,244035
7879,0.000257,172.31.40.0-255,66,32879,65,244035
7880,0.000262,74.125.24.0-255,2902,35781,65,244035
7881,0.000264,172.31.40.0-255,66,35847,65,244035
7882,0.000267,74.125.24.0-255,1484,37331,65,244035
7883,0.00027,172.31.40.0-255,66,37397,65,244035
7884,0.000306,74.125.24.0-255,4320,41717,65,244035
7885,0.000309,172.31.40.0-255,66,41783,65,244035
7886,0.000314,74.125.24.0-255,2902,44685,65,244035
7887,0.000316,172.31.40.0-255,66,44751,65,244035
7888,0.00034,74.125.24.0-255,3961,48712,65,244035
7889,0.000347,172.31.40.0-255,66,48778,65,244035
7890,0.000601,74.125.24.0-255,1484,50262,65,244035
7891,0.000606,172.31.40.0-255,66,50328,65,244035
7892,0.000613,74.125.24.0-255,2902,53230,65,244035
7893,0.000617,172.31.40.0-255,66,53296,65,244035
7894,0.000643,74.125.24.0-255,5738,59034,65,244035
7895,0.000648,74.125.24.0-255,4320,63354,65,244035
7896,0.000654,172.31.40.0-255,66,63420,65,244035
7897,0.000656,172.31.40.0-255,66,63486,65,244035
7898,0.000689,74.125.24.0-255,2835,66321,65,244035
7899,0.000691,172.31.40.0-255,66,66387,65,244035
7900,0.000715,74.125.24.0-255,386,66773,65,244035
7901,0.000826,74.125.24.0-255,1484,68257,65,244035
7902,0.00083,172.31.40.0-255,66,68323,65,244035
7903,0.000836,74.125.24.0-255,2902,71225,65,244035
7904,0.000838,172.31.40.0-255,66,71291,65,244035
7905,0.000843,74.125.24.0-255,2902,74193,65,244035
7906,0.000845,172.31.40.0-255,66,74259,65,244035
7907,0.000879,74.125.24.0-255,2902,77161,65,244035
7908,0.000882,172.31.40.0-255,66,77227,65,244035
7909,0.000885,74.125.24.0-255,1484,78711,65,244035
7910,0.000914,74.125.24.0-255,5379,84090,65,244035
7911,0.000917,172.31.40.0-255,66,84156,65,244035
7912,0.000925,74.125.24.0-255,7156,91312,65,244035
7913,0.000927,172.31.40.0-255,66,91378,65,244035
7914,0.000967,172.31.40.0-255,66,91444,65,244035
7915,0.001162,74.125.24.0-255,1484,92928,65,244035
7916,0.001168,74.125.24.0-255,2902,95830,65,244035
7917,0.001171,172.31.40.0-255,66,95896,65,244035
7918,0.001175,74.125.24.0-255,1484,97380,65,244035
7919,0.001206,74.125.24.0-255,4320,101700,65,244035
7920,0.001209,172.31.40.0-255,66,101766,65,244035
7921,0.001214,74.125.24.0-255,2902,104668,65,244035
7922,0.001216,172.31.40.0-255,66,104734,65,244035
7923,0.00123,172.31.40.0-255,66,104800,65,244035
7924,0.001251,74.125.24.0-255,1484,106284,65,244035
7925,0.001262,172.31.40.0-255,66,106350,65,244035
7926,0.001291,74.125.24.0-255,2184,108534,65,244035
7927,0.001294,172.31.40.0-255,66,108600,65,244035
7928,0.001301,74.125.24.0-255,5738,114338,65,244035
7929,0.001303,172.31.40.0-255,66,114404,65,244035
7930,0.001334,74.125.24.0-255,2902,117306,65,244035
7931,0.001337,172.31.40.0-255,66,117372,65,244035
7932,0.001349,172.31.40.0-255,66,117438,65,244035
7933,0.001355,74.125.24.0-255,5738,123176,65,244035
7934,0.001357,172.31.40.0-255,66,123242,65,244035
7935,0.0014,172.31.40.0-255,66,123308,65,244035
7936,0.001403,74.125.24.0-255,1484,124792,65,244035
7937,0.001406,74.125.24.0-255,1484,126276,65,244035
7938,0.001408,172.31.40.0-255,66,126342,65,244035
7939,0.001442,74.125.24.0-255,1484,127826,65,244035
7940,0.001449,74.125.24.0-255,5738,133564,65,244035
7941,0.001452,172.31.40.0-255,66,133630,65,244035
7942,0.001465,172.31.40.0-255,66,133696,65,244035
7943,0.001511,74.125.24.0-255,2902,136598,65,244035
7944,0.001514,172.31.40.0-255,66,136664,65,244035
7945,0.001551,172.31.40.0-255,66,136730,65,244035
7946,0.001554,74.125.24.0-255,1484,138214,65,244035
7947,0.001558,74.125.24.0-255,2902,141116,65,244035
7948,0.001561,172.31.40.0-255,66,141182,65,244035
7949,0.001607,74.125.24.0-255,5738,146920,65,244035
7950,0.00161,172.31.40.0-255,66,146986,65,244035
7951,0.001617,74.125.24.0-255,5738,152724,65,244035
7952,0.001626,172.31.40.0-255,66,152790,65,244035
7953,0.001676,172.31.40.0-255,66,152856,65,244035
7954,0.001682,74.125.24.0-255,5020,157876,65,244035
7955,0.001684,172.31.40.0-255,66,157942,65,244035
7956,0.001722,172.31.40.0-255,66,158008,65,244035
7957,0.001752,74.125.24.0-255,4829,162837,65,244035
7958,0.001755,172.31.40.0-255,66,162903,65,244035
7959,0.00178,74.125.24.0-255,1484,164387,65,244035
7960,0.001785,74.125.24.0-255,2902,167289,65,244035
7961,0.001788,172.31.40.0-255,66,167355,65,244035
7962,0.001825,74.125.24.0-255,5738,173093,65,244035
7963,0.001828,172.31.40.0-255,66,173159,65,244035
7964,0.001833,74.125.24.0-255,4320,177479,65,244035
7965,0.001835,172.31.40.0-255,66,177545,65,244035
7966,0.001861,74.125.24.0-255,2543,180088,65,244035
7967,0.001863,172.31.40.0-255,66,180154,65,244035
7968,0.002105,74.125.24.0-255,1484,181638,65,244035
7969,0.002112,74.125.24.0-255,2902,184540,65,244035
7970,0.002115,172.31.40.0-255,66,184606,65,244035
7971,0.002147,74.125.24.0-255,5738,190344,65,244035
7972,0.00215,172.31.40.0-255,66,190410,65,244035
7973,0.002186,172.31.40.0-255,66,190476,65,244035
7974,0.002205,74.125.24.0-255,1484,191960,65,244035
7975,0.002235,172.31.40.0-255,66,192026,65,244035
7976,0.002476,74.125.24.0-255,1484,193510,65,244035
7977,0.002482,74.125.24.0-255,2902,196412,65,244035
7978,0.002485,172.31.40.0-255,66,196478,65,244035
7979,0.002492,74.125.24.0-255,4320,200798,65,244035
7980,0.002495,172.31.40.0-255,66,200864,65,244035
7981,0.002516,74.125.24.0-255,1484,202348,65,244035
7982,0.002528,74.125.24.0-255,6797,209145,65,244035
7983,0.00253,172.31.40.0-255,66,209211,65,244035
7984,0.005131,74.125.24.0-255,5738,214949,65,244035
7985,0.005139,172.31.40.0-255,66,215015,65,244035
7986,0.00772,74.125.24.0-255,5738,220753,65,244035
7987,0.007727,172.31.40.0-255,66,220819,65,244035
7988,0.010338,74.125.24.0-255,5738,226557,65,244035
7989,0.010356,172.31.40.0-255,66,226623,65,244035
7990,0.012923,74.125.24.0-255,5738,232361,65,244035
7991,0.01293,172.31.40.0-255,66,232427,65,244035
7992,0.015505,74.125.24.0-255,5738,238165,65,244035
7993,0.015513,172.31.40.0-255,66,238231,65,244035
7994,0.018156,74.125.24.0-255,5738,243969,65,244035
7995,0.018175,172.31.40.0-255,66,244035,65,244035
7996,0.0,172.217.194.0-255,288,288,65,225617
7997,2.3e-05,172.31.40.0-255,66,354,65,225617
7998,2.9e-05,172.217.194.0-255,1484,1838,65,225617
7999,3.3e-05,172.31.40.0-255,66,1904,65,225617
8000,3.6e-05,172.217.194.0-255,1484,3388,65,225617
8001,3.9e-05,172.31.40.0-255,66,3454,65,225617
8002,4.5e-05,172.217.194.0-255,4320,7774,65,225617
8003,4.8e-05,172.31.40.0-255,66,7840,65,225617
8004,8.6e-05,172.31.40.0-255,66,7906,65,225617
8005,9.1e-05,172.217.194.0-255,2902,10808,65,225617
8006,9.2e-05,172.31.40.0-255,66,10874,65,225617
8007,0.000107,172.217.194.0-255,2902,13776,65,225617
8008,0.00011,172.31.40.0-255,66,13842,65,225617
8009,0.000133,172.217.194.0-255,4320,18162,65,225617
8010,0.000136,172.31.40.0-255,66,18228,65,225617
8011,0.000156,172.217.194.0-255,2543,20771,65,225617
8012,0.000158,172.31.40.0-255,66,20837,65,225617
8013,0.000219,172.217.194.0-255,1484,22321,65,225617
8014,0.000222,172.31.40.0-255,66,22387,65,225617
8015,0.000228,172.217.194.0-255,2902,25289,65,225617
8016,0.00023,172.31.40.0-255,66,25355,65,225617
8017,0.000247,172.217.194.0-255,5738,31093,65,225617
8018,0.00025,172.31.40.0-255,66,31159,65,225617
8019,0.000283,172.217.194.0-255,2902,34061,65,225617
8020,0.000286,172.31.40.0-255,66,34127,65,225617
8021,0.000299,172.217.194.0-255,4320,38447,65,225617
8022,0.000302,172.31.40.0-255,66,38513,65,225617
8023,0.000327,172.217.194.0-255,6797,45310,65,225617
8024,0.00033,172.31.40.0-255,66,45376,65,225617
8025,0.000336,172.217.194.0-255,5738,51114,65,225617
8026,0.000339,172.31.40.0-255,66,51180,65,225617
8027,0.000344,172.217.194.0-255,3961,55141,65,225617
8028,0.000346,172.31.40.0-255,66,55207,65,225617
8029,0.000368,172.217.194.0-255,381,55588,65,225617
8030,0.000399,172.217.194.0-255,1484,57072,65,225617
8031,0.000402,172.31.40.0-255,66,57138,65,225617
8032,0.000405,172.217.194.0-255,1484,58622,65,225617
8033,0.000423,172.217.194.0-255,2902,61524,65,225617
8034,0.000425,172.31.40.0-255,66,61590,65,225617
8035,0.00044,172.217.194.0-255,5738,67328,65,225617
8036,0.000442,172.31.40.0-255,66,67394,65,225617
8037,0.000462,172.217.194.0-255,4320,71714,65,225617
8038,0.000465,172.31.40.0-255,66,71780,65,225617
8039,0.000471,172.217.194.0-255,5738,77518,65,225617
8040,0.000473,172.31.40.0-255,66,77584,65,225617
8041,0.000497,172.217.194.0-255,1484,79068,65,225617
8042,0.000512,172.217.194.0-255,5738,84806,65,225617
8043,0.000515,172.31.40.0-255,66,84872,65,225617
8044,0.000538,172.217.194.0-255,5316,90188,65,225617
8045,0.00054,172.31.40.0-255,66,90254,65,225617
8046,0.000727,172.217.194.0-255,1484,91738,65,225617
8047,0.000733,172.217.194.0-255,2902,94640,65,225617
8048,0.000737,172.31.40.0-255,66,94706,65,225617
8049,0.000741,172.217.194.0-255,1484,96190,65,225617
8050,0.000757,172.217.194.0-255,4320,100510,65,225617
8051,0.00076,172.31.40.0-255,66,100576,65,225617
8052,0.000777,172.217.194.0-255,1484,102060,65,225617
8053,0.000802,172.31.40.0-255,66,102126,65,225617
8054,0.00081,172.217.194.0-255,7156,109282,65,225617
8055,0.000812,172.31.40.0-255,66,109348,65,225617
8056,0.000849,172.217.194.0-255,4369,113717,65,225617
8057,0.000853,172.31.40.0-255,66,113783,65,225617
8058,0.000966,172.217.194.0-255,1484,115267,65,225617
8059,0.000972,172.217.194.0-255,2902,118169,65,225617
8060,0.000975,172.31.40.0-255,66,118235,65,225617
8061,0.000981,172.217.194.0-255,5738,123973,65,225617
8062,0.000983,172.31.40.0-255,66,124039,65,225617
8063,0.001019,172.31.40.0-255,66,124105,65,225617
8064,0.001027,172.217.194.0-255,7156,131261,65,225617
8065,0.001029,172.31.40.0-255,66,131327,65,225617
8066,0.001067,172.217.194.0-255,3602,134929,65,225617
8067,0.001069,172.31.40.0-255,66,134995,65,225617
8068,0.00124,172.217.194.0-255,1484,136479,65,225617
8069,0.001244,172.217.194.0-255,1484,137963,65,225617
8070,0.001248,172.31.40.0-255,66,138029,65,225617
8071,0.00127,172.217.194.0-255,1484,139513,65,225617
8072,0.001276,172.217.194.0-255,5738,145251,65,225617
8073,0.001279,172.31.40.0-255,66,145317,65,225617
8074,0.001289,172.31.40.0-255,66,145383,65,225617
8075,0.001356,172.217.194.0-255,7156,152539,65,225617
8076,0.001359,172.31.40.0-255,66,152605,65,225617
8077,0.001382,172.31.40.0-255,66,152671,65,225617
8078,0.001894,172.217.194.0-255,1484,154155,65,225617
8079,0.0019,172.217.194.0-255,2902,157057,65,225617
8080,0.001903,172.31.40.0-255,66,157123,65,225617
8081,0.001906,172.217.194.0-255,1484,158607,65,225617
8082,0.001921,172.217.194.0-255,4320,162927,65,225617
8083,0.001923,172.31.40.0-255,66,162993,65,225617
8084,0.00195,172.31.40.0-255,66,163059,65,225617
8085,0.001966,172.217.194.0-255,2902,165961,65,225617
8086,0.001968,172.31.40.0-255,66,166027,65,225617
8087,0.001973,172.217.194.0-255,5738,171765,65,225617
8088,0.001975,172.31.40.0-255,66,171831,65,225617
8089,0.001977,172.217.194.0-255,1484,173315,65,225617
8090,0.001999,172.31.40.0-255,66,173381,65,225617
8091,0.003972,172.217.194.0-255,5738,179119,65,225617
8092,0.003979,172.31.40.0-255,66,179185,65,225617
8093,0.005954,172.217.194.0-255,5738,184923,65,225617
8094,0.005959,172.31.40.0-255,66,184989,65,225617
8095,0.007944,172.217.194.0-255,5738,190727,65,225617
8096,0.007949,172.31.40.0-255,66,190793,65,225617
8097,0.009925,172.217.194.0-255,5738,196531,65,225617
8098,0.009933,172.31.40.0-255,66,196597,65,225617
8099,0.011893,172.217.194.0-255,5738,202335,65,225617
8100,0.0119,172.31.40.0-255,66,202401,65,225617
8101,0.013883,172.217.194.0-255,5738,208139,65,225617
8102,0.01389,172.31.40.0-255,66,208205,65,225617
8103,0.015857,172.217.194.0-255,5738,213943,65,225617
8104,0.015864,172.31.40.0-255,66,214009,65,225617
8105,0.017838,172.217.194.0-255,5738,219747,65,225617
8106,0.017845,172.31.40.0-255,66,219813,65,225617
8107,0.019814,172.217.194.0-255,5738,225551,65,225617
8108,0.019821,172.31.40.0-255,66,225617,65,225617
8109,0.0,172.217.194.0-255,151,151,65,159140
8110,2.2e-05,172.31.40.0-255,66,217,65,159140
8111,2.8e-05,172.217.194.0-255,1484,1701,65,159140
8112,3.2e-05,172.31.40.0-255,66,1767,65,159140
8113,3.7e-05,172.217.194.0-255,2902,4669,65,159140
8114,4.1e-05,172.31.40.0-255,66,4735,65,159140
8115,6.9e-05,172.217.194.0-255,7156,11891,65,159140
8116,7.2e-05,172.31.40.0-255,66,11957,65,159140
8117,0.000104,172.217.194.0-255,3402,15359,65,159140
8118,0.000106,172.31.40.0-255,66,15425,65,159140
8119,0.00011,172.217.194.0-255,1484,16909,65,159140
8120,0.000112,172.31.40.0-255,66,16975,65,159140
8121,0.00013,172.217.194.0-255,2902,19877,65,159140
8122,0.000132,172.31.40.0-255,66,19943,65,159140
8123,0.000139,172.217.194.0-255,5738,25681,65,159140
8124,0.000142,172.31.40.0-255,66,25747,65,159140
8125,0.000158,172.217.194.0-255,4320,30067,65,159140
8126,0.000161,172.31.40.0-255,66,30133,65,159140
8127,0.000165,172.217.194.0-255,1125,31258,65,159140
8128,0.000167,172.31.40.0-255,66,31324,65,159140
8129,0.000191,172.217.194.0-255,1484,32808,65,159140
8130,0.000193,172.31.40.0-255,66,32874,65,159140
8131,0.000198,172.217.194.0-255,4320,37194,65,159140
8132,0.0002,172.31.40.0-255,66,37260,65,159140
8133,0.000205,172.217.194.0-255,5738,42998,65,159140
8134,0.000207,172.31.40.0-255,66,43064,65,159140
8135,0.000222,172.217.194.0-255,1484,44548,65,159140
8136,0.000224,172.31.40.0-255,66,44614,65,159140
8137,0.000242,172.217.194.0-255,3961,48575,65,159140
8138,0.000244,172.31.40.0-255,66,48641,65,159140
8139,0.00025,172.217.194.0-255,5738,54379,65,159140
8140,0.000252,172.31.40.0-255,66,54445,65,159140
8141,0.000287,172.217.194.0-255,4320,58765,65,159140
8142,0.00031,172.217.194.0-255,7110,65875,65,159140
8143,0.000438,172.31.40.0-255,66,65941,65,159140
8144,0.000458,172.217.194.0-255,364,66305,65,159140
8145,0.000588,172.217.194.0-255,1484,67789,65,159140
8146,0.000609,172.217.194.0-255,2902,70691,65,159140
8147,0.000616,172.31.40.0-255,66,70757,65,159140
8148,0.000632,172.217.194.0-255,5738,76495,65,159140
8149,0.000636,172.217.194.0-255,1484,77979,65,159140
8150,0.000656,172.217.194.0-255,5379,83358,65,159140
8151,0.00067,172.31.40.0-255,66,83424,65,159140
8152,0.000678,172.217.194.0-255,7156,90580,65,159140
8153,0.000687,172.31.40.0-255,66,90646,65,159140
8154,0.000713,172.217.194.0-255,1484,92130,65,159140
8155,0.000747,172.31.40.0-255,66,92196,65,159140
8156,0.000935,172.217.194.0-255,1484,93680,65,159140
8157,0.00094,172.217.194.0-255,2902,96582,65,159140
8158,0.000943,172.31.40.0-255,66,96648,65,159140
8159,0.000973,172.217.194.0-255,4320,100968,65,159140
8160,0.000993,172.217.194.0-255,1484,102452,65,159140
8161,0.001007,172.217.194.0-255,1484,103936,65,159140
8162,0.001009,172.31.40.0-255,66,104002,65,159140
8163,0.00103,172.31.40.0-255,66,104068,65,159140
8164,0.00173,172.217.194.0-255,1484,105552,65,159140
8165,0.001739,172.217.194.0-255,2902,108454,65,159140
8166,0.001742,172.31.40.0-255,66,108520,65,159140
8167,0.001763,172.217.194.0-255,5738,114258,65,159140
8168,0.001768,172.217.194.0-255,4320,118578,65,159140
8169,0.001784,172.217.194.0-255,4320,122898,65,159140
8170,0.001799,172.217.194.0-255,7156,130054,65,159140
8171,0.006561,172.31.40.0-255,66,130120,65,159140
8172,0.008669,172.217.194.0-255,5738,135858,65,159140
8173,0.008677,172.31.40.0-255,66,135924,65,159140
8174,0.010804,172.217.194.0-255,5738,141662,65,159140
8175,0.011779,172.31.40.0-255,66,141728,65,159140
8176,0.013885,172.217.194.0-255,5738,147466,65,159140
8177,0.013896,172.31.40.0-255,66,147532,65,159140
8178,0.015979,172.217.194.0-255,5738,153270,65,159140
8179,0.015987,172.31.40.0-255,66,153336,65,159140
8180,0.018087,172.217.194.0-255,5738,159074,65,159140
8181,0.018095,172.31.40.0-255,66,159140,65,159140
8182,0.0,74.125.24.0-255,153,153,65,258184
8183,2.4e-05,172.31.40.0-255,66,219,65,258184
8184,3.1e-05,74.125.24.0-255,1484,1703,65,258184
8185,3.6e-05,172.31.40.0-255,66,1769,65,258184
8186,4.2e-05,74.125.24.0-255,2902,4671,65,258184
8187,5.3e-05,172.31.40.0-255,66,4737,65,258184
8188,6.2e-05,74.125.24.0-255,7156,11893,65,258184
8189,6.5e-05,172.31.40.0-255,66,11959,65,258184
8190,6.9e-05,74.125.24.0-255,2038,13997,65,258184
8191,7.3e-05,172.31.40.0-255,66,14063,65,258184
8192,0.000139,74.125.24.0-255,1484,15547,65,258184
8193,0.000141,172.31.40.0-255,66,15613,65,258184
8194,0.000164,74.125.24.0-255,2902,18515,65,258184
8195,0.000167,172.31.40.0-255,66,18581,65,258184
8196,0.000174,74.125.24.0-255,5738,24319,65,258184
8197,0.000176,172.31.40.0-255,66,24385,65,258184
8198,0.000226,74.125.24.0-255,5738,30123,65,258184
8199,0.000229,172.31.40.0-255,66,30189,65,258184
8200,0.000251,74.125.24.0-255,1125,31314,65,258184
8201,0.000254,172.31.40.0-255,66,31380,65,258184
8202,0.000416,74.125.24.0-255,1484,32864,65,258184
8203,0.000421,172.31.40.0-255,66,32930,65,258184
8204,0.000425,74.125.24.0-255,1484,34414,65,258184
8205,0.000427,172.31.40.0-255,66,34480,65,258184
8206,0.00045,74.125.24.0-255,1484,35964,65,258184
8207,0.000457,172.31.40.0-255,66,36030,65,258184
8208,0.000464,74.125.24.0-255,5738,41768,65,258184
8209,0.000467,172.31.40.0-255,66,41834,65,258184
8210,0.000503,172.31.40.0-255,66,41900,65,258184
8211,0.000511,74.125.24.0-255,7156,49056,65,258184
8212,0.000513,172.31.40.0-255,66,49122,65,258184
8213,0.000551,74.125.24.0-255,4320,53442,65,258184
8214,0.000554,172.31.40.0-255,66,53508,65,258184
8215,0.000557,74.125.24.0-255,1398,54906,65,258184
8216,0.000561,74.125.24.0-255,132,55038,65,258184
8217,0.000617,74.125.24.0-255,1484,56522,65,258184
8218,0.000621,172.31.40.0-255,66,56588,65,258184
8219,0.000625,74.125.24.0-255,1484,58072,65,258184
8220,0.000645,74.125.24.0-255,1484,59556,65,258184
8221,0.000647,172.31.40.0-255,66,59622,65,258184
8222,0.000655,74.125.24.0-255,5738,65360,65,258184
8223,0.000657,172.31.40.0-255,66,65426,65,258184
8224,0.000682,74.125.24.0-255,4320,69746,65,258184
8225,0.000696,172.31.40.0-255,66,69812,65,258184
8226,0.000727,74.125.24.0-255,2543,72355,65,258184
8227,0.000729,172.31.40.0-255,66,72421,65,258184
8228,0.000737,74.125.24.0-255,7156,79577,65,258184
8229,0.000739,172.31.40.0-255,66,79643,65,258184
8230,0.000747,74.125.24.0-255,7156,86799,65,258184
8231,0.00075,172.31.40.0-255,66,86865,65,258184
8232,0.000777,74.125.24.0-255,2543,89408,65,258184
8233,0.00078,172.31.40.0-255,66,89474,65,258184
8234,0.001495,74.125.24.0-255,1484,90958,65,258184
8235,0.001506,74.125.24.0-255,2902,93860,65,258184
8236,0.00151,172.31.40.0-255,66,93926,65,258184
8237,0.001518,74.125.24.0-255,5738,99664,65,258184
8238,0.001521,172.31.40.0-255,66,99730,65,258184
8239,0.001561,172.31.40.0-255,66,99796,65,258184
8240,0.001569,74.125.24.0-255,7156,106952,65,258184
8241,0.001571,172.31.40.0-255,66,107018,65,258184
8242,0.001605,74.125.24.0-255,3602,110620,65,258184
8243,0.001608,172.31.40.0-255,66,110686,65,258184
8244,0.001611,74.125.24.0-255,1484,112170,65,258184
8245,0.001637,74.125.24.0-255,2902,115072,65,258184
8246,0.00165,172.31.40.0-255,66,115138,65,258184
8247,0.001653,172.31.40.0-255,66,115204,65,258184
8248,0.001679,74.125.24.0-255,1484,116688,65,258184
8249,0.00169,172.31.40.0-255,66,116754,65,258184
8250,0.001722,172.31.40.0-255,66,116820,65,258184
8251,0.001754,74.125.24.0-255,7156,123976,65,258184
8252,0.001757,172.31.40.0-255,66,124042,65,258184
8253,0.001779,74.125.24.0-255,4320,128362,65,258184
8254,0.001782,172.31.40.0-255,66,128428,65,258184
8255,0.001785,74.125.24.0-255,1484,129912,65,258184
8256,0.0018,172.31.40.0-255,66,129978,65,258184
8257,0.001807,74.125.24.0-255,6438,136416,65,258184
8258,0.00181,172.31.40.0-255,66,136482,65,258184
8259,0.001917,74.125.24.0-255,1484,137966,65,258184
8260,0.001937,74.125.24.0-255,2902,140868,65,258184
8261,0.001941,172.31.40.0-255,66,140934,65,258184
8262,0.001948,74.125.24.0-255,5738,146672,65,258184
8263,0.00195,172.31.40.0-255,66,146738,65,258184
8264,0.001958,74.125.24.0-255,1484,148222,65,258184
8265,0.001986,74.125.24.0-255,4320,152542,65,258184
8266,0.001989,172.31.40.0-255,66,152608,65,258184
8267,0.002001,172.31.40.0-255,66,152674,65,258184
8268,0.002031,74.125.24.0-255,2902,155576,65,258184
8269,0.002034,172.31.40.0-255,66,155642,65,258184
8270,0.002039,74.125.24.0-255,5020,160662,65,258184
8271,0.002042,172.31.40.0-255,66,160728,65,258184
8272,0.002165,74.125.24.0-255,1484,162212,65,258184
8273,0.002171,74.125.24.0-255,2902,165114,65,258184
8274,0.002174,172.31.40.0-255,66,165180,65,258184
8275,0.002205,74.125.24.0-255,5738,170918,65,258184
8276,0.002208,172.31.40.0-255,66,170984,65,258184
8277,0.00222,74.125.24.0-255,7156,178140,65,258184
8278,0.002222,172.31.40.0-255,66,178206,65,258184
8279,0.002252,74.125.24.0-255,5738,183944,65,258184
8280,0.002258,74.125.24.0-255,5738,189682,65,258184
8281,0.002263,172.31.40.0-255,66,189748,65,258184
8282,0.002267,172.31.40.0-255,66,189814,65,258184
8283,0.002285,74.125.24.0-255,4320,194134,65,258184
8284,0.002287,172.31.40.0-255,66,194200,65,258184
8285,0.002328,172.31.40.0-255,66,194266,65,258184
8286,0.00234,172.31.40.0-255,66,194332,65,258184
8287,0.002376,172.31.40.0-255,66,194398,65,258184
8288,0.002381,74.125.24.0-255,4320,198718,65,258184
8289,0.002383,172.31.40.0-255,66,198784,65,258184
8290,0.002389,74.125.24.0-255,4320,203104,65,258184
8291,0.002392,172.31.40.0-255,66,203170,65,258184
8292,0.002421,74.125.24.0-255,1484,204654,65,258184
8293,0.002435,172.31.40.0-255,66,204720,65,258184
8294,0.002448,172.31.40.0-255,66,204786,65,258184
8295,0.00248,74.125.24.0-255,766,205552,65,258184
8296,0.002505,74.125.24.0-255,1484,207036,65,258184
8297,0.002509,172.31.40.0-255,66,207102,65,258184
8298,0.002521,74.125.24.0-255,2902,210004,65,258184
8299,0.002528,172.31.40.0-255,66,210070,65,258184
8300,0.002552,74.125.24.0-255,1484,211554,65,258184
8301,0.002559,74.125.24.0-255,5738,217292,65,258184
8302,0.002562,172.31.40.0-255,66,217358,65,258184
8303,0.002565,74.125.24.0-255,1484,218842,65,258184
8304,0.002593,172.31.40.0-255,66,218908,65,258184
8305,0.002612,74.125.24.0-255,4320,223228,65,258184
8306,0.002614,172.31.40.0-255,66,223294,65,258184
8307,0.005115,74.125.24.0-255,1484,224778,65,258184
8308,0.005144,74.125.24.0-255,4320,229098,65,258184
8309,0.00515,172.31.40.0-255,66,229164,65,258184
8310,0.007696,74.125.24.0-255,5738,234902,65,258184
8311,0.007701,172.31.40.0-255,66,234968,65,258184
8312,0.010244,74.125.24.0-255,5738,240706,65,258184
8313,0.010251,172.31.40.0-255,66,240772,65,258184
8314,0.012847,74.125.24.0-255,5738,246510,65,258184
8315,0.012856,172.31.40.0-255,66,246576,65,258184
8316,0.015404,74.125.24.0-255,5738,252314,65,258184
8317,0.015413,172.31.40.0-255,66,252380,65,258184
8318,0.017974,74.125.24.0-255,5738,258118,65,258184
8319,0.017985,172.31.40.0-255,66,258184,65,258184
8320,0.0,172.217.194.0-255,298,298,65,206511
8321,2.2e-05,172.31.40.0-255,66,364,65,206511
8322,2.8e-05,172.217.194.0-255,1484,1848,65,206511
8323,3.2e-05,172.31.40.0-255,66,1914,65,206511
8324,3.6e-05,172.217.194.0-255,1484,3398,65,206511
8325,3.8e-05,172.31.40.0-255,66,3464,65,206511
8326,7.7e-05,172.217.194.0-255,1484,4948,65,206511
8327,8.1e-05,172.31.40.0-255,66,5014,65,206511
8328,8.9e-05,172.217.194.0-255,5738,10752,65,206511
8329,9.2e-05,172.31.40.0-255,66,10818,65,206511
8330,9.5e-05,172.217.194.0-255,1484,12302,65,206511
8331,9.8e-05,172.31.40.0-255,66,12368,65,206511
8332,0.000147,172.31.40.0-255,66,12434,65,206511
8333,0.000154,172.217.194.0-255,6797,19231,65,206511
8334,0.000157,172.31.40.0-255,66,19297,65,206511
8335,0.000245,172.217.194.0-255,1484,20781,65,206511
8336,0.000249,172.31.40.0-255,66,20847,65,206511
8337,0.000254,172.217.194.0-255,2902,23749,65,206511
8338,0.000256,172.31.40.0-255,66,23815,65,206511
8339,0.000262,172.217.194.0-255,4320,28135,65,206511
8340,0.000265,172.31.40.0-255,66,28201,65,206511
8341,0.000303,172.217.194.0-255,1484,29685,65,206511
8342,0.000305,172.31.40.0-255,66,29751,65,206511
8343,0.000321,172.31.40.0-255,66,29817,65,206511
8344,0.000347,172.217.194.0-255,7156,36973,65,206511
8345,0.00035,172.31.40.0-255,66,37039,65,206511
8346,0.000377,172.217.194.0-255,3913,40952,65,206511
8347,0.000379,172.31.40.0-255,66,41018,65,206511
8348,0.000612,172.217.194.0-255,98,41116,65,206511
8349,0.000618,172.31.40.0-255,66,41182,65,206511
8350,0.000654,172.217.194.0-255,1484,42666,65,206511
8351,0.00066,172.217.194.0-255,1484,44150,65,206511
8352,0.000663,172.31.40.0-255,66,44216,65,206511
8353,0.00069,172.217.194.0-255,1484,45700,65,206511
8354,0.000699,172.217.194.0-255,7156,52856,65,206511
8355,0.000701,172.31.40.0-255,66,52922,65,206511
8356,0.000708,172.217.194.0-255,5738,58660,65,206511
8357,0.000712,172.31.40.0-255,66,58726,65,206511
8358,0.000746,172.31.40.0-255,66,58792,65,206511
8359,0.000814,172.31.40.0-255,66,58858,65,206511
8360,0.000941,172.217.194.0-255,1484,60342,65,206511
8361,0.000946,172.217.194.0-255,1484,61826,65,206511
8362,0.000949,172.31.40.0-255,66,61892,65,206511
8363,0.000976,172.217.194.0-255,1484,63376,65,206511
8364,0.000982,172.217.194.0-255,5738,69114,65,206511
8365,0.000986,172.217.194.0-255,2902,72016,65,206511
8366,0.000992,172.31.40.0-255,66,72082,65,206511
8367,0.000995,172.31.40.0-255,66,72148,65,206511
8368,0.001032,172.31.40.0-255,66,72214,65,206511
8369,0.001044,172.31.40.0-255,66,72280,65,206511
8370,0.001054,172.31.40.0-255,66,72346,65,206511
8371,0.001081,172.217.194.0-255,2902,75248,65,206511
8372,0.001085,172.31.40.0-255,66,75314,65,206511
8373,0.001088,172.217.194.0-255,1484,76798,65,206511
8374,0.001139,172.31.40.0-255,66,76864,65,206511
8375,0.001146,172.217.194.0-255,4739,81603,65,206511
8376,0.001148,172.31.40.0-255,66,81669,65,206511
8377,0.001214,172.217.194.0-255,1484,83153,65,206511
8378,0.001219,172.217.194.0-255,2902,86055,65,206511
8379,0.001223,172.31.40.0-255,66,86121,65,206511
8380,0.001226,172.217.194.0-255,1484,87605,65,206511
8381,0.001253,172.217.194.0-255,4320,91925,65,206511
8382,0.001256,172.31.40.0-255,66,91991,65,206511
8383,0.001263,172.217.194.0-255,7156,99147,65,206511
8384,0.001266,172.31.40.0-255,66,99213,65,206511
8385,0.001295,172.217.194.0-255,5738,104951,65,206511
8386,0.001298,172.31.40.0-255,66,105017,65,206511
8387,0.001301,172.217.194.0-255,1484,106501,65,206511
8388,0.001314,172.217.194.0-255,4320,110821,65,206511
8389,0.001317,172.31.40.0-255,66,110887,65,206511
8390,0.001348,172.217.194.0-255,5020,115907,65,206511
8391,0.001351,172.31.40.0-255,66,115973,65,206511
8392,0.001743,172.217.194.0-255,1484,117457,65,206511
8393,0.001774,172.217.194.0-255,2902,120359,65,206511
8394,0.001778,172.31.40.0-255,66,120425,65,206511
8395,0.001784,172.217.194.0-255,5738,126163,65,206511
8396,0.001786,172.31.40.0-255,66,126229,65,206511
8397,0.001798,172.217.194.0-255,7156,133385,65,206511
8398,0.001801,172.31.40.0-255,66,133451,65,206511
8399,0.001804,172.217.194.0-255,1484,134935,65,206511
8400,0.001855,172.31.40.0-255,66,135001,65,206511
8401,0.00186,172.217.194.0-255,2184,137185,65,206511
8402,0.001862,172.31.40.0-255,66,137251,65,206511
8403,0.001901,172.217.194.0-255,1484,138735,65,206511
8404,0.001919,172.217.194.0-255,2902,141637,65,206511
8405,0.001924,172.31.40.0-255,66,141703,65,206511
8406,0.001949,172.217.194.0-255,2902,144605,65,206511
8407,0.001951,172.31.40.0-255,66,144671,65,206511
8408,0.001959,172.217.194.0-255,7156,151827,65,206511
8409,0.001961,172.31.40.0-255,66,151893,65,206511
8410,0.001996,172.217.194.0-255,4320,156213,65,206511
8411,0.001999,172.31.40.0-255,66,156279,65,206511
8412,0.002043,172.31.40.0-255,66,156345,65,206511
8413,0.002082,172.217.194.0-255,3602,159947,65,206511
8414,0.002089,172.31.40.0-255,66,160013,65,206511
8415,0.004177,172.217.194.0-255,1484,161497,65,206511
8416,0.004244,172.217.194.0-255,4320,165817,65,206511
8417,0.004249,172.31.40.0-255,66,165883,65,206511
8418,0.006365,172.217.194.0-255,5738,171621,65,206511
8419,0.006369,172.31.40.0-255,66,171687,65,206511
8420,0.008461,172.217.194.0-255,5738,177425,65,206511
8421,0.008467,172.31.40.0-255,66,177491,65,206511
8422,0.010597,172.217.194.0-255,5738,183229,65,206511
8423,0.010613,172.31.40.0-255,66,183295,65,206511
8424,0.012716,172.217.194.0-255,5738,189033,65,206511
8425,0.012732,172.31.40.0-255,66,189099,65,206511
8426,0.014843,172.217.194.0-255,5738,194837,65,206511
8427,0.014861,172.31.40.0-255,66,194903,65,206511
8428,0.016955,172.217.194.0-255,5738,200641,65,206511
8429,0.016969,172.31.40.0-255,66,200707,65,206511
8430,0.019083,172.217.194.0-255,5738,206445,65,206511
8431,0.019098,172.31.40.0-255,66,206511,65,206511
8432,0.0,74.125.130.0-255,150,150,65,180539
8433,1.9e-05,172.31.40.0-255,66,216,65,180539
8434,2.6e-05,74.125.130.0-255,1484,1700,65,180539
8435,3e-05,172.31.40.0-255,66,1766,65,180539
8436,3.3e-05,74.125.130.0-255,1484,3250,65,180539
8437,3.6e-05,172.31.40.0-255,66,3316,65,180539
8438,4.2e-05,74.125.130.0-255,2902,6218,65,180539
8439,4.4e-05,172.31.40.0-255,66,6284,65,180539
8440,8.5e-05,74.125.130.0-255,2902,9186,65,180539
8441,8.8e-05,172.31.40.0-255,66,9252,65,180539
8442,0.000103,74.125.130.0-255,2902,12154,65,180539
8443,0.000106,172.31.40.0-255,66,12220,65,180539
8444,0.000177,74.125.130.0-255,1484,13704,65,180539
8445,0.000181,172.31.40.0-255,66,13770,65,180539
8446,0.000195,74.125.130.0-255,654,14424,65,180539
8447,0.000198,172.31.40.0-255,66,14490,65,180539
8448,0.000214,74.125.130.0-255,2902,17392,65,180539
8449,0.000217,172.31.40.0-255,66,17458,65,180539
8450,0.000237,74.125.130.0-255,1484,18942,65,180539
8451,0.000239,172.31.40.0-255,66,19008,65,180539
8452,0.000286,74.125.130.0-255,4320,23328,65,180539
8453,0.000289,172.31.40.0-255,66,23394,65,180539
8454,0.000309,74.125.130.0-255,5738,29132,65,180539
8455,0.000311,172.31.40.0-255,66,29198,65,180539
8456,0.000457,74.125.130.0-255,2543,31741,65,180539
8457,0.000462,172.31.40.0-255,66,31807,65,180539
8458,0.000499,74.125.130.0-255,1484,33291,65,180539
8459,0.000502,172.31.40.0-255,66,33357,65,180539
8460,0.000522,74.125.130.0-255,1484,34841,65,180539
8461,0.000524,172.31.40.0-255,66,34907,65,180539
8462,0.000554,74.125.130.0-255,7156,42063,65,180539
8463,0.000557,172.31.40.0-255,66,42129,65,180539
8464,0.000666,74.125.130.0-255,7156,49285,65,180539
8465,0.000672,172.31.40.0-255,66,49351,65,180539
8466,0.00069,172.31.40.0-255,66,49417,65,180539
8467,0.000933,74.125.130.0-255,5738,55155,65,180539
8468,0.000937,172.31.40.0-255,66,55221,65,180539
8469,0.000955,74.125.130.0-255,2543,57764,65,180539
8470,0.001016,172.31.40.0-255,66,57830,65,180539
8471,0.001048,74.125.130.0-255,645,58475,65,180539
8472,0.001069,74.125.130.0-255,1484,59959,65,180539
8473,0.001084,172.31.40.0-255,66,60025,65,180539
8474,0.001105,74.125.130.0-255,4320,64345,65,180539
8475,0.001136,172.31.40.0-255,66,64411,65,180539
8476,0.001174,74.125.130.0-255,2902,67313,65,180539
8477,0.00118,172.31.40.0-255,66,67379,65,180539
8478,0.001204,74.125.130.0-255,7156,74535,65,180539
8479,0.001217,172.31.40.0-255,66,74601,65,180539
8480,0.001366,74.125.130.0-255,4320,78921,65,180539
8481,0.00137,172.31.40.0-255,66,78987,65,180539
8482,0.001418,74.125.130.0-255,2902,81889,65,180539
8483,0.001421,172.31.40.0-255,66,81955,65,180539
8484,0.001449,172.31.40.0-255,66,82021,65,180539
8485,0.001606,74.125.130.0-255,2184,84205,65,180539
8486,0.001611,172.31.40.0-255,66,84271,65,180539
8487,0.00165,74.125.130.0-255,1484,85755,65,180539
8488,0.001665,74.125.130.0-255,4320,90075,65,180539
8489,0.001667,172.31.40.0-255,66,90141,65,180539
8490,0.001696,172.31.40.0-255,66,90207,65,180539
8491,0.00172,74.125.130.0-255,5738,95945,65,180539
8492,0.002242,74.125.130.0-255,7156,103101,65,180539
8493,0.002497,74.125.130.0-255,4320,107421,65,180539
8494,0.002716,74.125.130.0-255,3602,111023,65,180539
8495,0.002776,74.125.130.0-255,4320,115343,65,180539
8496,0.002791,74.125.130.0-255,7156,122499,65,180539
8497,0.002804,74.125.130.0-255,4320,126819,65,180539
8498,0.002818,74.125.130.0-255,2902,129721,65,180539
8499,0.002946,172.31.40.0-255,66,129787,65,180539
8500,0.0031,74.125.130.0-255,4320,134107,65,180539
8501,0.003116,74.125.130.0-255,5738,139845,65,180539
8502,0.003124,172.31.40.0-255,66,139911,65,180539
8503,0.005447,74.125.130.0-255,5738,145649,65,180539
8504,0.005452,172.31.40.0-255,66,145715,65,180539
8505,0.007785,74.125.130.0-255,5738,151453,65,180539
8506,0.00779,172.31.40.0-255,66,151519,65,180539
8507,0.010112,74.125.130.0-255,5738,157257,65,180539
8508,0.01012,172.31.40.0-255,66,157323,65,180539
8509,0.012458,74.125.130.0-255,5738,163061,65,180539
8510,0.012466,172.31.40.0-255,66,163127,65,180539
8511,0.014794,74.125.130.0-255,5738,168865,65,180539
8512,0.014801,172.31.40.0-255,66,168931,65,180539
8513,0.017139,74.125.130.0-255,5738,174669,65,180539
8514,0.017147,172.31.40.0-255,66,174735,65,180539
8515,0.01949,74.125.130.0-255,5738,180473,65,180539
8516,0.019503,172.31.40.0-255,66,180539,65,180539
8517,0.0,74.125.68.0-255,145,145,65,162553
8518,2.1e-05,172.31.40.0-255,66,211,65,162553
8519,2.8e-05,74.125.68.0-255,1484,1695,65,162553
8520,3.2e-05,172.31.40.0-255,66,1761,65,162553
8521,3.8e-05,74.125.68.0-255,2902,4663,65,162553
8522,4.1e-05,172.31.40.0-255,66,4729,65,162553
8523,4.7e-05,74.125.68.0-255,4320,9049,65,162553
8524,5e-05,172.31.40.0-255,66,9115,65,162553
8525,7.8e-05,74.125.68.0-255,1484,10599,65,162553
8526,8.1e-05,172.31.40.0-255,66,10665,65,162553
8527,0.000102,74.125.68.0-255,3507,14172,65,162553
8528,0.000105,172.31.40.0-255,66,14238,65,162553
8529,0.000117,74.125.68.0-255,1484,15722,65,162553
8530,0.000119,172.31.40.0-255,66,15788,65,162553
8531,0.000137,74.125.68.0-255,4320,20108,65,162553
8532,0.00014,172.31.40.0-255,66,20174,65,162553
8533,0.000143,74.125.68.0-255,1484,21658,65,162553
8534,0.000145,172.31.40.0-255,66,21724,65,162553
8535,0.000148,74.125.68.0-255,1484,23208,65,162553
8536,0.00015,172.31.40.0-255,66,23274,65,162553
8537,0.000177,74.125.68.0-255,7156,30430,65,162553
8538,0.00018,172.31.40.0-255,66,30496,65,162553
8539,0.000183,74.125.68.0-255,1125,31621,65,162553
8540,0.000185,172.31.40.0-255,66,31687,65,162553
8541,0.000609,74.125.68.0-255,1484,33171,65,162553
8542,0.000614,172.31.40.0-255,66,33237,65,162553
8543,0.000637,74.125.68.0-255,2902,36139,65,162553
8544,0.00064,172.31.40.0-255,66,36205,65,162553
8545,0.000645,74.125.68.0-255,4320,40525,65,162553
8546,0.000647,172.31.40.0-255,66,40591,65,162553
8547,0.000686,74.125.68.0-255,4320,44911,65,162553
8548,0.000689,172.31.40.0-255,66,44977,65,162553
8549,0.000712,74.125.68.0-255,3961,48938,65,162553
8550,0.000715,172.31.40.0-255,66,49004,65,162553
8551,0.000726,172.31.40.0-255,66,49070,65,162553
8552,0.000733,74.125.68.0-255,7156,56226,65,162553
8553,0.000735,172.31.40.0-255,66,56292,65,162553
8554,0.000763,74.125.68.0-255,1125,57417,65,162553
8555,0.001022,172.31.40.0-255,66,57483,65,162553
8556,0.001498,74.125.68.0-255,648,58131,65,162553
8557,0.001523,74.125.68.0-255,1484,59615,65,162553
8558,0.001528,172.31.40.0-255,66,59681,65,162553
8559,0.001546,74.125.68.0-255,2902,62583,65,162553
8560,0.001549,172.31.40.0-255,66,62649,65,162553
8561,0.001555,74.125.68.0-255,2902,65551,65,162553
8562,0.001557,172.31.40.0-255,66,65617,65,162553
8563,0.001572,74.125.68.0-255,1484,67101,65,162553
8564,0.001576,74.125.68.0-255,2902,70003,65,162553
8565,0.001578,172.31.40.0-255,66,70069,65,162553
8566,0.001606,74.125.68.0-255,5738,75807,65,162553
8567,0.001609,172.31.40.0-255,66,75873,65,162553
8568,0.001612,74.125.68.0-255,1484,77357,65,162553
8569,0.001616,74.125.68.0-255,2902,80259,65,162553
8570,0.001618,172.31.40.0-255,66,80325,65,162553
8571,0.001623,74.125.68.0-255,2902,83227,65,162553
8572,0.001624,172.31.40.0-255,66,83293,65,162553
8573,0.001647,74.125.68.0-255,2902,86195,65,162553
8574,0.001649,172.31.40.0-255,66,86261,65,162553
8575,0.001654,74.125.68.0-255,2902,89163,65,162553
8576,0.001656,172.31.40.0-255,66,89229,65,162553
8577,0.001661,74.125.68.0-255,3602,92831,65,162553
8578,0.001663,172.31.40.0-255,66,92897,65,162553
8579,0.002188,74.125.68.0-255,1484,94381,65,162553
8580,0.002197,74.125.68.0-255,2902,97283,65,162553
8581,0.002201,172.31.40.0-255,66,97349,65,162553
8582,0.002207,74.125.68.0-255,2902,100251,65,162553
8583,0.002209,172.31.40.0-255,66,100317,65,162553
8584,0.002222,74.125.68.0-255,2902,103219,65,162553
8585,0.002226,172.31.40.0-255,66,103285,65,162553
8586,0.00226,172.31.40.0-255,66,103351,65,162553
8587,0.002265,74.125.68.0-255,2902,106253,65,162553
8588,0.002267,172.31.40.0-255,66,106319,65,162553
8589,0.002288,74.125.68.0-255,7156,113475,65,162553
8590,0.00229,172.31.40.0-255,66,113541,65,162553
8591,0.002293,74.125.68.0-255,1484,115025,65,162553
8592,0.002309,74.125.68.0-255,3602,118627,65,162553
8593,0.002312,172.31.40.0-255,66,118693,65,162553
8594,0.002523,74.125.68.0-255,1484,120177,65,162553
8595,0.00254,74.125.68.0-255,2902,123079,65,162553
8596,0.002543,172.31.40.0-255,66,123145,65,162553
8597,0.002566,74.125.68.0-255,4320,127465,65,162553
8598,0.002568,172.31.40.0-255,66,127531,65,162553
8599,0.00508,74.125.68.0-255,1484,129015,65,162553
8600,0.005109,74.125.68.0-255,4320,133335,65,162553
8601,0.005114,172.31.40.0-255,66,133401,65,162553
8602,0.007654,74.125.68.0-255,1484,134885,65,162553
8603,0.007675,74.125.68.0-255,4320,139205,65,162553
8604,0.007679,172.31.40.0-255,66,139271,65,162553
8605,0.010243,74.125.68.0-255,5738,145009,65,162553
8606,0.010253,172.31.40.0-255,66,145075,65,162553
8607,0.012823,74.125.68.0-255,5738,150813,65,162553
8608,0.012831,172.31.40.0-255,66,150879,65,162553
8609,0.01539,74.125.68.0-255,5738,156617,65,162553
8610,0.015397,172.31.40.0-255,66,156683,65,162553
8611,0.017943,74.125.68.0-255,4320,161003,65,162553
8612,0.01795,172.31.40.0-255,66,161069,65,162553
8613,0.017968,74.125.68.0-255,1484,162553,65,162553
8614,0.0,172.217.194.0-255,150,150,65,182762
8615,1.7e-05,172.31.40.0-255,66,216,65,182762
8616,2.4e-05,172.217.194.0-255,1484,1700,65,182762
8617,2.9e-05,172.31.40.0-255,66,1766,65,182762
8618,3.5e-05,172.217.194.0-255,2902,4668,65,182762
8619,4.6e-05,172.31.40.0-255,66,4734,65,182762
8620,5.3e-05,172.217.194.0-255,5738,10472,65,182762
8621,5.7e-05,172.31.40.0-255,66,10538,65,182762
8622,7.9e-05,172.217.194.0-255,1484,12022,65,182762
8623,8.6e-05,172.31.40.0-255,66,12088,65,182762
8624,0.000116,172.217.194.0-255,2030,14118,65,182762
8625,0.000118,172.31.40.0-255,66,14184,65,182762
8626,0.000379,172.217.194.0-255,1484,15668,65,182762
8627,0.000385,172.31.40.0-255,66,15734,65,182762
8628,0.000392,172.217.194.0-255,2902,18636,65,182762
8629,0.000394,172.31.40.0-255,66,18702,65,182762
8630,0.000407,172.217.194.0-255,5738,24440,65,182762
8631,0.00041,172.31.40.0-255,66,24506,65,182762
8632,0.000437,172.217.194.0-255,2902,27408,65,182762
8633,0.000439,172.31.40.0-255,66,27474,65,182762
8634,0.000465,172.217.194.0-255,3961,31435,65,182762
8635,0.000468,172.31.40.0-255,66,31501,65,182762
8636,0.000475,172.217.194.0-255,7156,38657,65,182762
8637,0.000478,172.31.40.0-255,66,38723,65,182762
8638,0.000486,172.217.194.0-255,2902,41625,65,182762
8639,0.000489,172.31.40.0-255,66,41691,65,182762
8640,0.000524,172.217.194.0-255,6797,48488,65,182762
8641,0.000528,172.31.40.0-255,66,48554,65,182762
8642,0.000841,172.217.194.0-255,1484,50038,65,182762
8643,0.000845,172.31.40.0-255,66,50104,65,182762
8644,0.000851,172.217.194.0-255,2902,53006,65,182762
8645,0.000854,172.31.40.0-255,66,53072,65,182762
8646,0.000866,172.217.194.0-255,5738,58810,65,182762
8647,0.000869,172.31.40.0-255,66,58876,65,182762
8648,0.000904,172.31.40.0-255,66,58942,65,182762
8649,0.001015,172.217.194.0-255,1484,60426,65,182762
8650,0.001022,172.217.194.0-255,2902,63328,65,182762
8651,0.001025,172.31.40.0-255,66,63394,65,182762
8652,0.001032,172.217.194.0-255,5738,69132,65,182762
8653,0.001034,172.31.40.0-255,66,69198,65,182762
8654,0.001062,172.217.194.0-255,7156,76354,65,182762
8655,0.001064,172.31.40.0-255,66,76420,65,182762
8656,0.001093,172.31.40.0-255,66,76486,65,182762
8657,0.001126,172.217.194.0-255,5738,82224,65,182762
8658,0.001129,172.31.40.0-255,66,82290,65,182762
8659,0.001133,172.217.194.0-255,2184,84474,65,182762
8660,0.001136,172.31.40.0-255,66,84540,65,182762
8661,0.001548,172.217.194.0-255,1484,86024,65,182762
8662,0.001558,172.217.194.0-255,2902,88926,65,182762
8663,0.001562,172.31.40.0-255,66,88992,65,182762
8664,0.00157,172.217.194.0-255,5738,94730,65,182762
8665,0.001572,172.31.40.0-255,66,94796,65,182762
8666,0.001596,172.217.194.0-255,5738,100534,65,182762
8667,0.001599,172.31.40.0-255,66,100600,65,182762
8668,0.001635,172.217.194.0-255,7156,107756,65,182762
8669,0.001638,172.31.40.0-255,66,107822,65,182762
8670,0.001655,172.31.40.0-255,66,107888,65,182762
8671,0.001658,172.217.194.0-255,1484,109372,65,182762
8672,0.001705,172.217.194.0-255,2902,112274,65,182762
8673,0.001708,172.31.40.0-255,66,112340,65,182762
8674,0.001714,172.217.194.0-255,5738,118078,65,182762
8675,0.001717,172.31.40.0-255,66,118144,65,182762
8676,0.001734,172.31.40.0-255,66,118210,65,182762
8677,0.001776,172.31.40.0-255,66,118276,65,182762
8678,0.001808,172.217.194.0-255,4320,122596,65,182762
8679,0.001811,172.31.40.0-255,66,122662,65,182762
8680,0.001838,172.217.194.0-255,1484,124146,65,182762
8681,0.001848,172.217.194.0-255,7156,131302,65,182762
8682,0.001851,172.31.40.0-255,66,131368,65,182762
8683,0.001867,172.31.40.0-255,66,131434,65,182762
8684,0.001874,172.217.194.0-255,6438,137872,65,182762
8685,0.001877,172.31.40.0-255,66,137938,65,182762
8686,0.001911,172.217.194.0-255,4320,142258,65,182762
8687,0.001914,172.31.40.0-255,66,142324,65,182762
8688,0.00195,172.31.40.0-255,66,142390,65,182762
8689,0.001952,172.217.194.0-255,1484,143874,65,182762
8690,0.001957,172.217.194.0-255,2902,146776,65,182762
8691,0.001959,172.31.40.0-255,66,146842,65,182762
8692,0.002002,172.217.194.0-255,6438,153280,65,182762
8693,0.002006,172.31.40.0-255,66,153346,65,182762
8694,0.002018,172.31.40.0-255,66,153412,65,182762
8695,0.002046,172.31.40.0-255,66,153478,65,182762
8696,0.002094,172.31.40.0-255,66,153544,65,182762
8697,0.002113,172.31.40.0-255,66,153610,65,182762
8698,0.002124,172.31.40.0-255,66,153676,65,182762
8699,0.004334,172.217.194.0-255,5738,159414,65,182762
8700,0.009774,172.31.40.0-255,66,159480,65,182762
8701,0.011441,172.217.194.0-255,1484,160964,65,182762
8702,0.011953,172.217.194.0-255,4320,165284,65,182762
8703,0.01196,172.31.40.0-255,66,165350,65,182762
8704,0.01421,172.217.194.0-255,5738,171088,65,182762
8705,0.014215,172.31.40.0-255,66,171154,65,182762
8706,0.016428,172.217.194.0-255,5738,176892,65,182762
8707,0.01644,172.31.40.0-255,66,176958,65,182762
8708,0.018669,172.217.194.0-255,5738,182696,65,182762
8709,0.018681,172.31.40.0-255,66,182762,65,182762
8710,0.0,74.125.24.0-255,153,153,65,251405
8711,2.4e-05,172.31.40.0-255,66,219,65,251405
8712,3.2e-05,74.125.24.0-255,1484,1703,65,251405
8713,3.7e-05,172.31.40.0-255,66,1769,65,251405
8714,5e-05,74.125.24.0-255,2902,4671,65,251405
8715,5.3e-05,172.31.40.0-255,66,4737,65,251405
8716,5.9e-05,74.125.24.0-255,4320,9057,65,251405
8717,6.2e-05,172.31.40.0-255,66,9123,65,251405
8718,7.1e-05,74.125.24.0-255,7156,16279,65,251405
8719,7.4e-05,172.31.40.0-255,66,16345,65,251405
8720,0.000107,74.125.24.0-255,2155,18500,65,251405
8721,0.00011,172.31.40.0-255,66,18566,65,251405
8722,0.000128,172.31.40.0-255,66,18632,65,251405
8723,0.000132,74.125.24.0-255,2543,21175,65,251405
8724,0.000134,172.31.40.0-255,66,21241,65,251405
8725,0.000234,74.125.24.0-255,1484,22725,65,251405
8726,0.000239,172.31.40.0-255,66,22791,65,251405
8727,0.000245,74.125.24.0-255,2902,25693,65,251405
8728,0.000247,172.31.40.0-255,66,25759,65,251405
8729,0.000252,74.125.24.0-255,2902,28661,65,251405
8730,0.000259,172.31.40.0-255,66,28727,65,251405
8731,0.000289,74.125.24.0-255,2902,31629,65,251405
8732,0.000292,172.31.40.0-255,66,31695,65,251405
8733,0.000297,74.125.24.0-255,2902,34597,65,251405
8734,0.0003,172.31.40.0-255,66,34663,65,251405
8735,0.000305,74.125.24.0-255,3961,38624,65,251405
8736,0.000312,172.31.40.0-255,66,38690,65,251405
8737,0.000323,172.31.40.0-255,66,38756,65,251405
8738,0.000329,74.125.24.0-255,4320,43076,65,251405
8739,0.000332,172.31.40.0-255,66,43142,65,251405
8740,0.000365,74.125.24.0-255,3961,47103,65,251405
8741,0.000368,172.31.40.0-255,66,47169,65,251405
8742,0.000401,74.125.24.0-255,395,47564,65,251405
8743,0.000559,74.125.24.0-255,1484,49048,65,251405
8744,0.000564,172.31.40.0-255,66,49114,65,251405
8745,0.00057,74.125.24.0-255,2902,52016,65,251405
8746,0.000572,172.31.40.0-255,66,52082,65,251405
8747,0.000584,74.125.24.0-255,5738,57820,65,251405
8748,0.000587,172.31.40.0-255,66,57886,65,251405
8749,0.00059,74.125.24.0-255,1484,59370,65,251405
8750,0.000626,74.125.24.0-255,5379,64749,65,251405
8751,0.000629,172.31.40.0-255,66,64815,65,251405
8752,0.000666,74.125.24.0-255,4320,69135,65,251405
8753,0.000668,172.31.40.0-255,66,69201,65,251405
8754,0.000705,172.31.40.0-255,66,69267,65,251405
8755,0.00071,74.125.24.0-255,2543,71810,65,251405
8756,0.000712,172.31.40.0-255,66,71876,65,251405
8757,0.000715,74.125.24.0-255,1484,73360,65,251405
8758,0.000742,74.125.24.0-255,1484,74844,65,251405
8759,0.000744,172.31.40.0-255,66,74910,65,251405
8760,0.000769,74.125.24.0-255,1484,76394,65,251405
8761,0.000774,74.125.24.0-255,2902,79296,65,251405
8762,0.000776,172.31.40.0-255,66,79362,65,251405
8763,0.000802,74.125.24.0-255,2902,82264,65,251405
8764,0.000805,172.31.40.0-255,66,82330,65,251405
8765,0.000811,74.125.24.0-255,6499,88829,65,251405
8766,0.000814,172.31.40.0-255,66,88895,65,251405
8767,0.000983,74.125.24.0-255,1484,90379,65,251405
8768,0.000988,74.125.24.0-255,1484,91863,65,251405
8769,0.000992,172.31.40.0-255,66,91929,65,251405
8770,0.001018,74.125.24.0-255,1484,93413,65,251405
8771,0.001025,74.125.24.0-255,5738,99151,65,251405
8772,0.001027,172.31.40.0-255,66,99217,65,251405
8773,0.001054,74.125.24.0-255,2902,102119,65,251405
8774,0.001058,74.125.24.0-255,4320,106439,65,251405
8775,0.001066,172.31.40.0-255,66,106505,65,251405
8776,0.001068,172.31.40.0-255,66,106571,65,251405
8777,0.001088,172.31.40.0-255,66,106637,65,251405
8778,0.001092,74.125.24.0-255,1484,108121,65,251405
8779,0.001117,74.125.24.0-255,2902,111023,65,251405
8780,0.00112,172.31.40.0-255,66,111089,65,251405
8781,0.001142,74.125.24.0-255,3602,114691,65,251405
8782,0.001145,172.31.40.0-255,66,114757,65,251405
8783,0.001385,74.125.24.0-255,1484,116241,65,251405
8784,0.001392,74.125.24.0-255,2902,119143,65,251405
8785,0.001395,172.31.40.0-255,66,119209,65,251405
8786,0.001403,74.125.24.0-255,5738,124947,65,251405
8787,0.001405,172.31.40.0-255,66,125013,65,251405
8788,0.001425,74.125.24.0-255,4320,129333,65,251405
8789,0.001428,172.31.40.0-255,66,129399,65,251405
8790,0.001464,172.31.40.0-255,66,129465,65,251405
8791,0.001471,74.125.24.0-255,7156,136621,65,251405
8792,0.001474,172.31.40.0-255,66,136687,65,251405
8793,0.001478,74.125.24.0-255,4320,141007,65,251405
8794,0.001486,172.31.40.0-255,66,141073,65,251405
8795,0.00151,74.125.24.0-255,3602,144675,65,251405
8796,0.001513,172.31.40.0-255,66,144741,65,251405
8797,0.001532,172.31.40.0-255,66,144807,65,251405
8798,0.001545,172.31.40.0-255,66,144873,65,251405
8799,0.001568,74.125.24.0-255,3602,148475,65,251405
8800,0.001576,172.31.40.0-255,66,148541,65,251405
8801,0.001596,74.125.24.0-255,1484,150025,65,251405
8802,0.001599,74.125.24.0-255,1484,151509,65,251405
8803,0.001604,172.31.40.0-255,66,151575,65,251405
8804,0.001625,74.125.24.0-255,1484,153059,65,251405
8805,0.001632,74.125.24.0-255,5738,158797,65,251405
8806,0.001635,172.31.40.0-255,66,158863,65,251405
8807,0.001679,172.31.40.0-255,66,158929,65,251405
8808,0.001687,74.125.24.0-255,7156,166085,65,251405
8809,0.001689,172.31.40.0-255,66,166151,65,251405
8810,0.001723,74.125.24.0-255,6438,172589,65,251405
8811,0.001726,172.31.40.0-255,66,172655,65,251405
8812,0.001733,74.125.24.0-255,7156,179811,65,251405
8813,0.001736,172.31.40.0-255,66,179877,65,251405
8814,0.001801,172.31.40.0-255,66,179943,65,251405
8815,0.001831,74.125.24.0-255,7156,187099,65,251405
8816,0.001834,172.31.40.0-255,66,187165,65,251405
8817,0.001841,74.125.24.0-255,7156,194321,65,251405
8818,0.001844,172.31.40.0-255,66,194387,65,251405
8819,0.00187,172.31.40.0-255,66,194453,65,251405
8820,0.001882,172.31.40.0-255,66,194519,65,251405
8821,0.002067,74.125.24.0-255,1484,196003,65,251405
8822,0.002073,74.125.24.0-255,2902,198905,65,251405
8823,0.002076,172.31.40.0-255,66,198971,65,251405
8824,0.00211,74.125.24.0-255,5738,204709,65,251405
8825,0.002113,172.31.40.0-255,66,204775,65,251405
8826,0.002126,172.31.40.0-255,66,204841,65,251405
8827,0.00214,74.125.24.0-255,1484,206325,65,251405
8828,0.002169,74.125.24.0-255,4320,210645,65,251405
8829,0.002172,172.31.40.0-255,66,210711,65,251405
8830,0.002207,172.31.40.0-255,66,210777,65,251405
8831,0.004505,74.125.24.0-255,5738,216515,65,251405
8832,0.004513,172.31.40.0-255,66,216581,65,251405
8833,0.006828,74.125.24.0-255,5738,222319,65,251405
8834,0.006836,172.31.40.0-255,66,222385,65,251405
8835,0.009164,74.125.24.0-255,5738,228123,65,251405
8836,0.009172,172.31.40.0-255,66,228189,65,251405
8837,0.011502,74.125.24.0-255,5738,233927,65,251405
8838,0.011514,172.31.40.0-255,66,233993,65,251405
8839,0.013828,74.125.24.0-255,5738,239731,65,251405
8840,0.013835,172.31.40.0-255,66,239797,65,251405
8841,0.016163,74.125.24.0-255,5738,245535,65,251405
8842,0.016171,172.31.40.0-255,66,245601,65,251405
8843,0.018468,74.125.24.0-255,5738,251339,65,251405
8844,0.018475,172.31.40.0-255,66,251405,65,251405
8845,0.0,172.217.194.0-255,162,162,65,165234
8846,1.5e-05,172.31.40.0-255,66,228,65,165234
8847,2.3e-05,172.217.194.0-255,1484,1712,65,165234
8848,2.8e-05,172.31.40.0-255,66,1778,65,165234
8849,3.4e-05,172.217.194.0-255,2902,4680,65,165234
8850,3.9e-05,172.31.40.0-255,66,4746,65,165234
8851,4.6e-05,172.217.194.0-255,7156,11902,65,165234
8852,4.9e-05,172.31.40.0-255,66,11968,65,165234
8853,8.5e-05,172.217.194.0-255,2902,14870,65,165234
8854,8.8e-05,172.31.40.0-255,66,14936,65,165234
8855,0.00011,172.217.194.0-255,1938,16874,65,165234
8856,0.000113,172.31.40.0-255,66,16940,65,165234
8857,0.000119,172.217.194.0-255,5738,22678,65,165234
8858,0.000122,172.31.40.0-255,66,22744,65,165234
8859,0.000141,172.217.194.0-255,5738,28482,65,165234
8860,0.000144,172.31.40.0-255,66,28548,65,165234
8861,0.000164,172.217.194.0-255,2543,31091,65,165234
8862,0.000166,172.31.40.0-255,66,31157,65,165234
8863,0.000183,172.217.194.0-255,1484,32641,65,165234
8864,0.000185,172.31.40.0-255,66,32707,65,165234
8865,0.000204,172.217.194.0-255,2902,35609,65,165234
8866,0.000206,172.31.40.0-255,66,35675,65,165234
8867,0.000209,172.217.194.0-255,1484,37159,65,165234
8868,0.000211,172.31.40.0-255,66,37225,65,165234
8869,0.000232,172.217.194.0-255,4320,41545,65,165234
8870,0.000235,172.31.40.0-255,66,41611,65,165234
8871,0.000239,172.217.194.0-255,2902,44513,65,165234
8872,0.000241,172.31.40.0-255,66,44579,65,165234
8873,0.000272,172.31.40.0-255,66,44645,65,165234
8874,0.000328,172.31.40.0-255,66,44711,65,165234
8875,0.000374,172.217.194.0-255,646,45357,65,165234
8876,0.000953,172.217.194.0-255,1484,46841,65,165234
8877,0.000958,172.31.40.0-255,66,46907,65,165234
8878,0.000964,172.217.194.0-255,2902,49809,65,165234
8879,0.000967,172.31.40.0-255,66,49875,65,165234
8880,0.000974,172.217.194.0-255,5738,55613,65,165234
8881,0.000976,172.31.40.0-255,66,55679,65,165234
8882,0.00104,172.31.40.0-255,66,55745,65,165234
8883,0.00106,172.217.194.0-255,2902,58647,65,165234
8884,0.001062,172.31.40.0-255,66,58713,65,165234
8885,0.001093,172.31.40.0-255,66,58779,65,165234
8886,0.001362,172.217.194.0-255,1484,60263,65,165234
8887,0.001369,172.217.194.0-255,2902,63165,65,165234
8888,0.001372,172.31.40.0-255,66,63231,65,165234
8889,0.001399,172.217.194.0-255,5738,68969,65,165234
8890,0.001402,172.31.40.0-255,66,69035,65,165234
8891,0.001408,172.217.194.0-255,5738,74773,65,165234
8892,0.00141,172.31.40.0-255,66,74839,65,165234
8893,0.001444,172.217.194.0-255,7156,81995,65,165234
8894,0.001447,172.31.40.0-255,66,82061,65,165234
8895,0.001453,172.217.194.0-255,4320,86381,65,165234
8896,0.001455,172.31.40.0-255,66,86447,65,165234
8897,0.001478,172.217.194.0-255,6438,92885,65,165234
8898,0.001481,172.31.40.0-255,66,92951,65,165234
8899,0.001506,172.217.194.0-255,2902,95853,65,165234
8900,0.001508,172.31.40.0-255,66,95919,65,165234
8901,0.001536,172.217.194.0-255,5738,101657,65,165234
8902,0.001539,172.31.40.0-255,66,101723,65,165234
8903,0.00155,172.31.40.0-255,66,101789,65,165234
8904,0.001557,172.217.194.0-255,5738,107527,65,165234
8905,0.001559,172.31.40.0-255,66,107593,65,165234
8906,0.001597,172.31.40.0-255,66,107659,65,165234
8907,0.001619,172.217.194.0-255,1484,109143,65,165234
8908,0.001622,172.217.194.0-255,1484,110627,65,165234
8909,0.001625,172.31.40.0-255,66,110693,65,165234
8910,0.001643,172.217.194.0-255,1484,112177,65,165234
8911,0.001647,172.217.194.0-255,2902,115079,65,165234
8912,0.00165,172.31.40.0-255,66,115145,65,165234
8913,0.001697,172.217.194.0-255,2902,118047,65,165234
8914,0.001701,172.31.40.0-255,66,118113,65,165234
8915,0.001708,172.217.194.0-255,7156,125269,65,165234
8916,0.001711,172.31.40.0-255,66,125335,65,165234
8917,0.001726,172.31.40.0-255,66,125401,65,165234
8918,0.001753,172.217.194.0-255,2184,127585,65,165234
8919,0.001756,172.31.40.0-255,66,127651,65,165234
8920,0.00192,172.217.194.0-255,1484,129135,65,165234
8921,0.001979,172.217.194.0-255,2902,132037,65,165234
8922,0.001985,172.31.40.0-255,66,132103,65,165234
8923,0.001991,172.217.194.0-255,5738,137841,65,165234
8924,0.001993,172.31.40.0-255,66,137907,65,165234
8925,0.001998,172.217.194.0-255,4320,142227,65,165234
8926,0.002,172.31.40.0-255,66,142293,65,165234
8927,0.002013,172.31.40.0-255,66,142359,65,165234
8928,0.002023,172.31.40.0-255,66,142425,65,165234
8929,0.002057,172.31.40.0-255,66,142491,65,165234
8930,0.002063,172.217.194.0-255,5738,148229,65,165234
8931,0.002066,172.31.40.0-255,66,148295,65,165234
8932,0.0021,172.31.40.0-255,66,148361,65,165234
8933,0.002138,172.217.194.0-255,5738,154099,65,165234
8934,0.00214,172.31.40.0-255,66,154165,65,165234
8935,0.002162,172.31.40.0-255,66,154231,65,165234
8936,0.002176,172.31.40.0-255,66,154297,65,165234
8937,0.002187,172.31.40.0-255,66,154363,65,165234
8938,0.002234,172.31.40.0-255,66,154429,65,165234
8939,0.002253,172.31.40.0-255,66,154495,65,165234
8940,0.002263,172.31.40.0-255,66,154561,65,165234
8941,0.002288,172.217.194.0-255,7156,161717,65,165234
8942,0.002291,172.31.40.0-255,66,161783,65,165234
8943,0.002349,172.31.40.0-255,66,161849,65,165234
8944,0.002375,172.31.40.0-255,66,161915,65,165234
8945,0.00238,172.217.194.0-255,2389,164304,65,165234
8946,0.002383,172.31.40.0-255,66,164370,65,165234
8947,0.004712,172.217.194.0-255,168,164538,65,165234
8948,0.00825,172.31.40.0-255,105,164643,65,165234
8949,0.008293,172.31.40.0-255,105,164748,65,165234
8950,0.008568,172.31.40.0-255,90,164838,65,165234
8951,0.00858,172.31.40.0-255,66,164904,65,165234
8952,0.01062,172.217.194.0-255,66,164970,65,165234
8953,0.010632,172.217.194.0-255,66,165036,65,165234
8954,0.010879,172.217.194.0-255,66,165102,65,165234
8955,0.011055,172.217.194.0-255,66,165168,65,165234
8956,0.011061,172.31.40.0-255,66,165234,65,165234
8957,0.0,74.125.68.0-255,226,226,65,72898
8958,2.9e-05,172.31.40.0-255,66,292,65,72898
8959,3.7e-05,74.125.68.0-255,1484,1776,65,72898
8960,4.1e-05,172.31.40.0-255,66,1842,65,72898
8961,6.1e-05,74.125.68.0-255,1484,3326,65,72898
8962,6.4e-05,172.31.40.0-255,66,3392,65,72898
8963,0.000118,74.125.68.0-255,1484,4876,65,72898
8964,0.000121,172.31.40.0-255,66,4942,65,72898
8965,0.000138,74.125.68.0-255,1484,6426,65,72898
8966,0.00014,172.31.40.0-255,66,6492,65,72898
8967,0.000255,74.125.68.0-255,5738,12230,65,72898
8968,0.000259,172.31.40.0-255,66,12296,65,72898
8969,0.000501,74.125.68.0-255,2063,14359,65,72898
8970,0.000507,172.31.40.0-255,66,14425,65,72898
8971,0.000582,74.125.68.0-255,2902,17327,65,72898
8972,0.000586,172.31.40.0-255,66,17393,65,72898
8973,0.000709,74.125.68.0-255,2902,20295,65,72898
8974,0.000713,172.31.40.0-255,66,20361,65,72898
8975,0.000728,74.125.68.0-255,4320,24681,65,72898
8976,0.00073,172.31.40.0-255,66,24747,65,72898
8977,0.001027,74.125.68.0-255,6797,31544,65,72898
8978,0.001033,172.31.40.0-255,66,31610,65,72898
8979,0.003623,74.125.68.0-255,5738,37348,65,72898
8980,0.003639,172.31.40.0-255,66,37414,65,72898
8981,0.006229,74.125.68.0-255,5738,43152,65,72898
8982,0.006237,172.31.40.0-255,66,43218,65,72898
8983,0.008816,74.125.68.0-255,2902,46120,65,72898
8984,0.008836,172.31.40.0-255,66,46186,65,72898
8985,0.008846,74.125.68.0-255,2902,49088,65,72898
8986,0.008848,172.31.40.0-255,66,49154,65,72898
8987,0.011419,74.125.68.0-255,2902,52056,65,72898
8988,0.011437,172.31.40.0-255,66,52122,65,72898
8989,0.011461,74.125.68.0-255,2902,55024,65,72898
8990,0.011463,172.31.40.0-255,66,55090,65,72898
8991,0.014016,74.125.68.0-255,2902,57992,65,72898
8992,0.014035,172.31.40.0-255,66,58058,65,72898
8993,0.014065,74.125.68.0-255,2902,60960,65,72898
8994,0.014068,172.31.40.0-255,66,61026,65,72898
8995,0.016622,74.125.68.0-255,2902,63928,65,72898
8996,0.016639,172.31.40.0-255,66,63994,65,72898
8997,0.016665,74.125.68.0-255,2902,66896,65,72898
8998,0.016667,172.31.40.0-255,66,66962,65,72898
8999,0.019226,74.125.68.0-255,2902,69864,65,72898
9000,0.019237,172.31.40.0-255,66,69930,65,72898
9001,0.019263,74.125.68.0-255,2902,72832,65,72898
9002,0.019266,172.31.40.0-255,66,72898,65,72898
9003,0.0,172.217.194.0-255,299,299,65,55221
9004,2.2e-05,172.31.40.0-255,66,365,65,55221
9005,2.8e-05,172.217.194.0-255,1484,1849,65,55221
9006,3.2e-05,172.31.40.0-255,66,1915,65,55221
9007,3.9e-05,172.217.194.0-255,4320,6235,65,55221
9008,4.2e-05,172.31.40.0-255,66,6301,65,55221
9009,8.9e-05,172.217.194.0-255,4320,10621,65,55221
9010,9.2e-05,172.31.40.0-255,66,10687,65,55221
9011,0.000109,172.217.194.0-255,4682,15369,65,55221
9012,0.000112,172.31.40.0-255,66,15435,65,55221
9013,0.000222,172.217.194.0-255,7156,22591,65,55221
9014,0.000226,172.31.40.0-255,66,22657,65,55221
9015,0.000239,172.217.194.0-255,2902,25559,65,55221
9016,0.000242,172.31.40.0-255,66,25625,65,55221
9017,0.000389,172.31.40.0-255,66,25691,65,55221
9018,0.000423,172.31.40.0-255,66,25757,65,55221
9019,0.000719,172.217.194.0-255,766,26523,65,55221
9020,0.000723,172.31.40.0-255,66,26589,65,55221
9021,0.000774,172.31.40.0-255,66,26655,65,55221
9022,0.001138,172.217.194.0-255,1484,28139,65,55221
9023,0.001143,172.31.40.0-255,66,28205,65,55221
9024,0.001192,172.31.40.0-255,66,28271,65,55221
9025,0.001214,172.217.194.0-255,3602,31873,65,55221
9026,0.001216,172.31.40.0-255,66,31939,65,55221
9027,0.001651,172.31.40.0-255,66,32005,65,55221
9028,0.001683,172.31.40.0-255,66,32071,65,55221
9029,0.003094,172.217.194.0-255,7156,39227,65,55221
9030,0.004065,172.217.194.0-255,4320,43547,65,55221
9031,0.010193,172.31.40.0-255,66,43613,65,55221
9032,0.01273,172.217.194.0-255,5738,49351,65,55221
9033,0.012742,172.31.40.0-255,66,49417,65,55221
9034,0.015325,172.217.194.0-255,5738,55155,65,55221
9035,0.017703,172.31.40.0-255,66,55221,65,55221
9036,0.0,172.217.194.0-255,153,153,65,132126
9037,2.4e-05,172.31.40.0-255,66,219,65,132126
9038,3.2e-05,172.217.194.0-255,1484,1703,65,132126
9039,3.6e-05,172.31.40.0-255,66,1769,65,132126
9040,5.1e-05,172.217.194.0-255,1484,3253,65,132126
9041,5.4e-05,172.31.40.0-255,66,3319,65,132126
9042,6.1e-05,172.217.194.0-255,2902,6221,65,132126
9043,6.5e-05,172.31.40.0-255,66,6287,65,132126
9044,7.1e-05,172.217.194.0-255,5738,12025,65,132126
9045,7.5e-05,172.31.40.0-255,66,12091,65,132126
9046,8e-05,172.217.194.0-255,2001,14092,65,132126
9047,8.3e-05,172.31.40.0-255,66,14158,65,132126
9048,0.000133,172.217.194.0-255,1484,15642,65,132126
9049,0.000137,172.31.40.0-255,66,15708,65,132126
9050,0.000142,172.217.194.0-255,2902,18610,65,132126
9051,0.000145,172.31.40.0-255,66,18676,65,132126
9052,0.000148,172.217.194.0-255,1484,20160,65,132126
9053,0.000149,172.31.40.0-255,66,20226,65,132126
9054,0.000176,172.217.194.0-255,4320,24546,65,132126
9055,0.000179,172.31.40.0-255,66,24612,65,132126
9056,0.000185,172.217.194.0-255,4320,28932,65,132126
9057,0.000187,172.31.40.0-255,66,28998,65,132126
9058,0.000216,172.217.194.0-255,3961,32959,65,132126
9059,0.000219,172.31.40.0-255,66,33025,65,132126
9060,0.00023,172.31.40.0-255,66,33091,65,132126
9061,0.000248,172.217.194.0-255,6797,39888,65,132126
9062,0.000251,172.31.40.0-255,66,39954,65,132126
9063,0.000805,172.217.194.0-255,1484,41438,65,132126
9064,0.000809,172.31.40.0-255,66,41504,65,132126
9065,0.000814,172.217.194.0-255,2902,44406,65,132126
9066,0.000817,172.31.40.0-255,66,44472,65,132126
9067,0.000822,172.217.194.0-255,2902,47374,65,132126
9068,0.000824,172.31.40.0-255,66,47440,65,132126
9069,0.000846,172.217.194.0-255,2902,50342,65,132126
9070,0.000849,172.31.40.0-255,66,50408,65,132126
9071,0.000859,172.31.40.0-255,66,50474,65,132126
9072,0.0012,172.217.194.0-255,1484,51958,65,132126
9073,0.001208,172.217.194.0-255,2902,54860,65,132126
9074,0.001213,172.31.40.0-255,66,54926,65,132126
9075,0.00122,172.217.194.0-255,5738,60664,65,132126
9076,0.001223,172.31.40.0-255,66,60730,65,132126
9077,0.001264,172.217.194.0-255,5738,66468,65,132126
9078,0.001268,172.31.40.0-255,66,66534,65,132126
9079,0.001293,172.217.194.0-255,7156,73690,65,132126
9080,0.001296,172.31.40.0-255,66,73756,65,132126
9081,0.001309,172.31.40.0-255,66,73822,65,132126
9082,0.002156,172.217.194.0-255,1484,75306,65,132126
9083,0.002167,172.217.194.0-255,2902,78208,65,132126
9084,0.00217,172.31.40.0-255,66,78274,65,132126
9085,0.002177,172.217.194.0-255,4320,82594,65,132126
9086,0.00218,172.31.40.0-255,66,82660,65,132126
9087,0.002206,172.217.194.0-255,1484,84144,65,132126
9088,0.002218,172.31.40.0-255,66,84210,65,132126
9089,0.002261,172.217.194.0-255,7156,91366,65,132126
9090,0.002264,172.31.40.0-255,66,91432,65,132126
9091,0.002291,172.31.40.0-255,66,91498,65,132126
9092,0.004665,172.217.194.0-255,5738,97236,65,132126
9093,0.004703,172.31.40.0-255,66,97302,65,132126
9094,0.007113,172.217.194.0-255,5738,103040,65,132126
9095,0.007134,172.31.40.0-255,66,103106,65,132126
9096,0.009526,172.217.194.0-255,5738,108844,65,132126
9097,0.009534,172.31.40.0-255,66,108910,65,132126
9098,0.011912,172.217.194.0-255,5738,114648,65,132126
9099,0.011927,172.31.40.0-255,66,114714,65,132126
9100,0.014341,172.217.194.0-255,5738,120452,65,132126
9101,0.014355,172.31.40.0-255,66,120518,65,132126
9102,0.016729,172.217.194.0-255,5738,126256,65,132126
9103,0.016746,172.31.40.0-255,66,126322,65,132126
9104,0.019131,172.217.194.0-255,5738,132060,65,132126
9105,0.019145,172.31.40.0-255,66,132126,65,132126
9106,0.0,172.217.194.0-255,156,156,65,146235
9107,2.3e-05,172.31.40.0-255,66,222,65,146235
9108,3e-05,172.217.194.0-255,1484,1706,65,146235
9109,3.5e-05,172.31.40.0-255,66,1772,65,146235
9110,4.1e-05,172.217.194.0-255,2902,4674,65,146235
9111,4.5e-05,172.31.40.0-255,66,4740,65,146235
9112,5.9e-05,172.217.194.0-255,7156,11896,65,146235
9113,6.3e-05,172.31.40.0-255,66,11962,65,146235
9114,9.1e-05,172.217.194.0-255,2063,14025,65,146235
9115,9.4e-05,172.31.40.0-255,66,14091,65,146235
9116,0.000139,172.217.194.0-255,1484,15575,65,146235
9117,0.000142,172.31.40.0-255,66,15641,65,146235
9118,0.000147,172.217.194.0-255,2902,18543,65,146235
9119,0.000149,172.31.40.0-255,66,18609,65,146235
9120,0.000152,172.217.194.0-255,1484,20093,65,146235
9121,0.000154,172.31.40.0-255,66,20159,65,146235
9122,0.000187,172.217.194.0-255,4320,24479,65,146235
9123,0.000191,172.31.40.0-255,66,24545,65,146235
9124,0.000202,172.31.40.0-255,66,24611,65,146235
9125,0.000208,172.217.194.0-255,4320,28931,65,146235
9126,0.00021,172.31.40.0-255,66,28997,65,146235
9127,0.000244,172.217.194.0-255,4320,33317,65,146235
9128,0.000246,172.31.40.0-255,66,33383,65,146235
9129,0.000254,172.217.194.0-255,6797,40180,65,146235
9130,0.000257,172.31.40.0-255,66,40246,65,146235
9131,0.000295,172.217.194.0-255,1484,41730,65,146235
9132,0.000298,172.31.40.0-255,66,41796,65,146235
9133,0.000303,172.217.194.0-255,2902,44698,65,146235
9134,0.000306,172.31.40.0-255,66,44764,65,146235
9135,0.000318,172.217.194.0-255,5738,50502,65,146235
9136,0.00032,172.31.40.0-255,66,50568,65,146235
9137,0.000348,172.217.194.0-255,5738,56306,65,146235
9138,0.000351,172.31.40.0-255,66,56372,65,146235
9139,0.000372,172.217.194.0-255,1125,57497,65,146235
9140,0.000469,172.217.194.0-255,367,57864,65,146235
9141,0.000472,172.217.194.0-255,376,58240,65,146235
9142,0.000474,172.31.40.0-255,66,58306,65,146235
9143,0.000607,172.217.194.0-255,1484,59790,65,146235
9144,0.000611,172.217.194.0-255,1484,61274,65,146235
9145,0.000613,172.31.40.0-255,66,61340,65,146235
9146,0.000638,172.217.194.0-255,1484,62824,65,146235
9147,0.000645,172.217.194.0-255,5738,68562,65,146235
9148,0.000647,172.31.40.0-255,66,68628,65,146235
9149,0.000653,172.217.194.0-255,4320,72948,65,146235
9150,0.000655,172.31.40.0-255,66,73014,65,146235
9151,0.000691,172.217.194.0-255,2543,75557,65,146235
9152,0.000693,172.31.40.0-255,66,75623,65,146235
9153,0.000701,172.217.194.0-255,7156,82779,65,146235
9154,0.000704,172.31.40.0-255,66,82845,65,146235
9155,0.000707,172.217.194.0-255,1484,84329,65,146235
9156,0.000743,172.31.40.0-255,66,84395,65,146235
9157,0.001617,172.217.194.0-255,1484,85879,65,146235
9158,0.001632,172.217.194.0-255,2902,88781,65,146235
9159,0.001635,172.31.40.0-255,66,88847,65,146235
9160,0.001642,172.217.194.0-255,5738,94585,65,146235
9161,0.001644,172.31.40.0-255,66,94651,65,146235
9162,0.001685,172.31.40.0-255,66,94717,65,146235
9163,0.001691,172.217.194.0-255,5738,100455,65,146235
9164,0.001694,172.31.40.0-255,66,100521,65,146235
9165,0.001719,172.217.194.0-255,5020,105541,65,146235
9166,0.001721,172.31.40.0-255,66,105607,65,146235
9167,0.00428,172.217.194.0-255,5738,111345,65,146235
9168,0.004288,172.31.40.0-255,66,111411,65,146235
9169,0.006858,172.217.194.0-255,5738,117149,65,146235
9170,0.006864,172.31.40.0-255,66,117215,65,146235
9171,0.009455,172.217.194.0-255,5738,122953,65,146235
9172,0.009461,172.31.40.0-255,66,123019,65,146235
9173,0.012092,172.217.194.0-255,5738,128757,65,146235
9174,0.012099,172.31.40.0-255,66,128823,65,146235
9175,0.014655,172.217.194.0-255,5738,134561,65,146235
9176,0.014664,172.31.40.0-255,66,134627,65,146235
9177,0.017231,172.217.194.0-255,5738,140365,65,146235
9178,0.017239,172.31.40.0-255,66,140431,65,146235
9179,0.019822,172.217.194.0-255,5738,146169,65,146235
9180,0.019831,172.31.40.0-255,66,146235,65,146235
9181,0.0,74.125.68.0-255,153,153,65,235112
9182,1.5e-05,172.31.40.0-255,66,219,65,235112
9183,2.2e-05,74.125.68.0-255,1484,1703,65,235112
9184,2.7e-05,172.31.40.0-255,66,1769,65,235112
9185,3.1e-05,74.125.68.0-255,1484,3253,65,235112
9186,3.4e-05,172.31.40.0-255,66,3319,65,235112
9187,5.3e-05,74.125.68.0-255,1484,4803,65,235112
9188,5.5e-05,172.31.40.0-255,66,4869,65,235112
9189,7.4e-05,74.125.68.0-255,1484,6353,65,235112
9190,7.7e-05,172.31.40.0-255,66,6419,65,235112
9191,0.000103,74.125.68.0-255,4320,10739,65,235112
9192,0.000106,172.31.40.0-255,66,10805,65,235112
9193,0.00011,74.125.68.0-255,2902,13707,65,235112
9194,0.000113,172.31.40.0-255,66,13773,65,235112
9195,0.000135,74.125.68.0-255,728,14501,65,235112
9196,0.000137,172.31.40.0-255,66,14567,65,235112
9197,0.000197,74.125.68.0-255,1484,16051,65,235112
9198,0.0002,172.31.40.0-255,66,16117,65,235112
9199,0.000203,74.125.68.0-255,1484,17601,65,235112
9200,0.000206,172.31.40.0-255,66,17667,65,235112
9201,0.000221,74.125.68.0-255,1484,19151,65,235112
9202,0.000223,172.31.40.0-255,66,19217,65,235112
9203,0.00023,74.125.68.0-255,5738,24955,65,235112
9204,0.000232,172.31.40.0-255,66,25021,65,235112
9205,0.000235,74.125.68.0-255,1484,26505,65,235112
9206,0.000237,172.31.40.0-255,66,26571,65,235112
9207,0.000259,74.125.68.0-255,2902,29473,65,235112
9208,0.000262,172.31.40.0-255,66,29539,65,235112
9209,0.000291,74.125.68.0-255,2543,32082,65,235112
9210,0.000294,172.31.40.0-255,66,32148,65,235112
9211,0.000329,74.125.68.0-255,2902,35050,65,235112
9212,0.000332,172.31.40.0-255,66,35116,65,235112
9213,0.000335,74.125.68.0-255,1484,36600,65,235112
9214,0.000352,74.125.68.0-255,2902,39502,65,235112
9215,0.000354,172.31.40.0-255,66,39568,65,235112
9216,0.000359,74.125.68.0-255,2902,42470,65,235112
9217,0.000361,172.31.40.0-255,66,42536,65,235112
9218,0.000375,74.125.68.0-255,2902,45438,65,235112
9219,0.000378,172.31.40.0-255,66,45504,65,235112
9220,0.000381,74.125.68.0-255,1484,46988,65,235112
9221,0.000394,74.125.68.0-255,2543,49531,65,235112
9222,0.000396,172.31.40.0-255,66,49597,65,235112
9223,0.00046,74.125.68.0-255,1484,51081,65,235112
9224,0.000465,74.125.68.0-255,2902,53983,65,235112
9225,0.000468,172.31.40.0-255,66,54049,65,235112
9226,0.000491,74.125.68.0-255,5738,59787,65,235112
9227,0.000493,172.31.40.0-255,66,59853,65,235112
9228,0.000517,74.125.68.0-255,6797,66650,65,235112
9229,0.00052,172.31.40.0-255,66,66716,65,235112
9230,0.000522,74.125.68.0-255,357,67073,65,235112
9231,0.00068,74.125.68.0-255,137,67210,65,235112
9232,0.000685,74.125.68.0-255,346,67556,65,235112
9233,0.00084,74.125.68.0-255,1484,69040,65,235112
9234,0.000844,172.31.40.0-255,66,69106,65,235112
9235,0.000848,74.125.68.0-255,1484,70590,65,235112
9236,0.000851,74.125.68.0-255,1484,72074,65,235112
9237,0.000853,172.31.40.0-255,66,72140,65,235112
9238,0.000867,74.125.68.0-255,1484,73624,65,235112
9239,0.000894,74.125.68.0-255,4320,77944,65,235112
9240,0.000897,172.31.40.0-255,66,78010,65,235112
9241,0.000913,74.125.68.0-255,1484,79494,65,235112
9242,0.000928,74.125.68.0-255,1484,80978,65,235112
9243,0.000932,172.31.40.0-255,66,81044,65,235112
9244,0.000947,74.125.68.0-255,3961,85005,65,235112
9245,0.00095,172.31.40.0-255,66,85071,65,235112
9246,0.001069,74.125.68.0-255,1484,86555,65,235112
9247,0.001075,74.125.68.0-255,2902,89457,65,235112
9248,0.001078,172.31.40.0-255,66,89523,65,235112
9249,0.001083,74.125.68.0-255,2902,92425,65,235112
9250,0.001084,172.31.40.0-255,66,92491,65,235112
9251,0.0011,74.125.68.0-255,2902,95393,65,235112
9252,0.001103,172.31.40.0-255,66,95459,65,235112
9253,0.001135,74.125.68.0-255,6797,102256,65,235112
9254,0.001137,172.31.40.0-255,66,102322,65,235112
9255,0.001369,74.125.68.0-255,1484,103806,65,235112
9256,0.001388,74.125.68.0-255,2902,106708,65,235112
9257,0.001392,172.31.40.0-255,66,106774,65,235112
9258,0.001398,74.125.68.0-255,4320,111094,65,235112
9259,0.0014,172.31.40.0-255,66,111160,65,235112
9260,0.001413,74.125.68.0-255,1484,112644,65,235112
9261,0.001428,74.125.68.0-255,1484,114128,65,235112
9262,0.001431,172.31.40.0-255,66,114194,65,235112
9263,0.00146,172.31.40.0-255,66,114260,65,235112
9264,0.001478,74.125.68.0-255,1484,115744,65,235112
9265,0.001511,74.125.68.0-255,4320,120064,65,235112
9266,0.001513,172.31.40.0-255,66,120130,65,235112
9267,0.001533,172.31.40.0-255,66,120196,65,235112
9268,0.001536,74.125.68.0-255,1484,121680,65,235112
9269,0.00154,74.125.68.0-255,2902,124582,65,235112
9270,0.001542,172.31.40.0-255,66,124648,65,235112
9271,0.001577,74.125.68.0-255,5738,130386,65,235112
9272,0.001581,172.31.40.0-255,66,130452,65,235112
9273,0.0016,74.125.68.0-255,1484,131936,65,235112
9274,0.001625,172.31.40.0-255,66,132002,65,235112
9275,0.001651,74.125.68.0-255,7156,139158,65,235112
9276,0.001655,172.31.40.0-255,66,139224,65,235112
9277,0.001679,74.125.68.0-255,5020,144244,65,235112
9278,0.001683,172.31.40.0-255,66,144310,65,235112
9279,0.001863,74.125.68.0-255,1484,145794,65,235112
9280,0.001867,74.125.68.0-255,1484,147278,65,235112
9281,0.001871,172.31.40.0-255,66,147344,65,235112
9282,0.001893,74.125.68.0-255,1484,148828,65,235112
9283,0.001899,74.125.68.0-255,5738,154566,65,235112
9284,0.001901,172.31.40.0-255,66,154632,65,235112
9285,0.001906,74.125.68.0-255,2902,157534,65,235112
9286,0.001908,172.31.40.0-255,66,157600,65,235112
9287,0.001914,74.125.68.0-255,4320,161920,65,235112
9288,0.001916,172.31.40.0-255,66,161986,65,235112
9289,0.001954,172.31.40.0-255,66,162052,65,235112
9290,0.00196,74.125.68.0-255,5738,167790,65,235112
9291,0.001962,172.31.40.0-255,66,167856,65,235112
9292,0.002023,74.125.68.0-255,2184,170040,65,235112
9293,0.002027,172.31.40.0-255,66,170106,65,235112
9294,0.002043,74.125.68.0-255,2902,173008,65,235112
9295,0.002047,172.31.40.0-255,66,173074,65,235112
9296,0.00206,74.125.68.0-255,5738,178812,65,235112
9297,0.002062,172.31.40.0-255,66,178878,65,235112
9298,0.002065,74.125.68.0-255,1484,180362,65,235112
9299,0.002083,74.125.68.0-255,5738,186100,65,235112
9300,0.002086,172.31.40.0-255,66,186166,65,235112
9301,0.002101,74.125.68.0-255,1484,187650,65,235112
9302,0.002116,74.125.68.0-255,4320,191970,65,235112
9303,0.002119,172.31.40.0-255,66,192036,65,235112
9304,0.00215,172.31.40.0-255,66,192102,65,235112
9305,0.002154,74.125.68.0-255,3602,195704,65,235112
9306,0.002157,172.31.40.0-255,66,195770,65,235112
9307,0.004456,74.125.68.0-255,1484,197254,65,235112
9308,0.004478,74.125.68.0-255,4320,201574,65,235112
9309,0.004484,172.31.40.0-255,66,201640,65,235112
9310,0.006786,74.125.68.0-255,4320,205960,65,235112
9311,0.006793,172.31.40.0-255,66,206026,65,235112
9312,0.006817,74.125.68.0-255,1484,207510,65,235112
9313,0.009132,74.125.68.0-255,4320,211830,65,235112
9314,0.00915,172.31.40.0-255,66,211896,65,235112
9315,0.011474,74.125.68.0-255,5738,217634,65,235112
9316,0.011487,172.31.40.0-255,66,217700,65,235112
9317,0.013815,74.125.68.0-255,5738,223438,65,235112
9318,0.013829,172.31.40.0-255,66,223504,65,235112
9319,0.016142,74.125.68.0-255,5738,229242,65,235112
9320,0.01615,172.31.40.0-255,66,229308,65,235112
9321,0.01847,74.125.68.0-255,5738,235046,65,235112
9322,0.018478,172.31.40.0-255,66,235112,65,235112
9323,0.0,74.125.68.0-255,153,153,65,228560
9324,1.7e-05,172.31.40.0-255,66,219,65,228560
9325,2.4e-05,74.125.68.0-255,1484,1703,65,228560
9326,2.8e-05,172.31.40.0-255,66,1769,65,228560
9327,3.4e-05,74.125.68.0-255,2902,4671,65,228560
9328,3.6e-05,172.31.40.0-255,66,4737,65,228560
9329,4e-05,74.125.68.0-255,2902,7639,65,228560
9330,4.2e-05,172.31.40.0-255,66,7705,65,228560
9331,4.7e-05,74.125.68.0-255,4320,12025,65,228560
9332,5e-05,172.31.40.0-255,66,12091,65,228560
9333,8.9e-05,74.125.68.0-255,5738,17829,65,228560
9334,9.3e-05,172.31.40.0-255,66,17895,65,228560
9335,0.00011,74.125.68.0-255,3555,21450,65,228560
9336,0.000113,172.31.40.0-255,66,21516,65,228560
9337,0.000124,172.31.40.0-255,66,21582,65,228560
9338,0.000274,74.125.68.0-255,1484,23066,65,228560
9339,0.000279,172.31.40.0-255,66,23132,65,228560
9340,0.000283,74.125.68.0-255,1484,24616,65,228560
9341,0.000285,172.31.40.0-255,66,24682,65,228560
9342,0.000288,74.125.68.0-255,1484,26166,65,228560
9343,0.00029,172.31.40.0-255,66,26232,65,228560
9344,0.000316,74.125.68.0-255,1484,27716,65,228560
9345,0.000318,172.31.40.0-255,66,27782,65,228560
9346,0.000325,74.125.68.0-255,5738,33520,65,228560
9347,0.000328,172.31.40.0-255,66,33586,65,228560
9348,0.000331,74.125.68.0-255,1484,35070,65,228560
9349,0.000332,172.31.40.0-255,66,35136,65,228560
9350,0.000357,74.125.68.0-255,3961,39097,65,228560
9351,0.00036,172.31.40.0-255,66,39163,65,228560
9352,0.000365,74.125.68.0-255,5738,44901,65,228560
9353,0.000367,172.31.40.0-255,66,44967,65,228560
9354,0.000426,74.125.68.0-255,1435,46402,65,228560
9355,0.000456,74.125.68.0-255,109,46511,65,228560
9356,0.000478,172.31.40.0-255,66,46577,65,228560
9357,0.000529,74.125.68.0-255,1484,48061,65,228560
9358,0.000532,74.125.68.0-255,1484,49545,65,228560
9359,0.000536,172.31.40.0-255,66,49611,65,228560
9360,0.000543,74.125.68.0-255,1484,51095,65,228560
9361,0.000559,74.125.68.0-255,5738,56833,65,228560
9362,0.000621,74.125.68.0-255,7156,63989,65,228560
9363,0.000634,74.125.68.0-255,4320,68309,65,228560
9364,0.000638,74.125.68.0-255,2184,70493,65,228560
9365,0.000644,172.31.40.0-255,66,70559,65,228560
9366,0.000662,74.125.68.0-255,333,70892,65,228560
9367,0.000791,74.125.68.0-255,1484,72376,65,228560
9368,0.000797,74.125.68.0-255,2902,75278,65,228560
9369,0.000807,172.31.40.0-255,66,75344,65,228560
9370,0.000825,74.125.68.0-255,5738,81082,65,228560
9371,0.000837,172.31.40.0-255,66,81148,65,228560
9372,0.00085,74.125.68.0-255,5738,86886,65,228560
9373,0.000856,74.125.68.0-255,5738,92624,65,228560
9374,0.000871,74.125.68.0-255,1484,94108,65,228560
9375,0.000888,74.125.68.0-255,5738,99846,65,228560
9376,0.000896,172.31.40.0-255,66,99912,65,228560
9377,0.000906,74.125.68.0-255,4471,104383,65,228560
9378,0.000915,172.31.40.0-255,66,104449,65,228560
9379,0.000973,74.125.68.0-255,1484,105933,65,228560
9380,0.000979,74.125.68.0-255,2902,108835,65,228560
9381,0.00099,74.125.68.0-255,1484,110319,65,228560
9382,0.000995,74.125.68.0-255,2902,113221,65,228560
9383,0.001003,172.31.40.0-255,66,113287,65,228560
9384,0.001027,74.125.68.0-255,5738,119025,65,228560
9385,0.00103,74.125.68.0-255,1484,120509,65,228560
9386,0.001038,172.31.40.0-255,66,120575,65,228560
9387,0.001051,74.125.68.0-255,2902,123477,65,228560
9388,0.001057,74.125.68.0-255,4320,127797,65,228560
9389,0.001073,74.125.68.0-255,1484,129281,65,228560
9390,0.00108,172.31.40.0-255,66,129347,65,228560
9391,0.00112,172.31.40.0-255,66,129413,65,228560
9392,0.001146,74.125.68.0-255,1484,130897,65,228560
9393,0.001166,74.125.68.0-255,2902,133799,65,228560
9394,0.001172,74.125.68.0-255,4320,138119,65,228560
9395,0.001177,172.31.40.0-255,66,138185,65,228560
9396,0.001185,74.125.68.0-255,1484,139669,65,228560
9397,0.001189,74.125.68.0-255,2902,142571,65,228560
9398,0.001195,172.31.40.0-255,66,142637,65,228560
9399,0.001204,74.125.68.0-255,1484,144121,65,228560
9400,0.001211,74.125.68.0-255,5738,149859,65,228560
9401,0.001233,74.125.68.0-255,1484,151343,65,228560
9402,0.00126,74.125.68.0-255,2184,153527,65,228560
9403,0.001265,172.31.40.0-255,66,153593,65,228560
9404,0.001708,74.125.68.0-255,1484,155077,65,228560
9405,0.001729,74.125.68.0-255,2902,157979,65,228560
9406,0.001733,172.31.40.0-255,66,158045,65,228560
9407,0.00174,74.125.68.0-255,5738,163783,65,228560
9408,0.001747,172.31.40.0-255,66,163849,65,228560
9409,0.001757,74.125.68.0-255,4320,168169,65,228560
9410,0.001762,172.31.40.0-255,66,168235,65,228560
9411,0.001789,74.125.68.0-255,5738,173973,65,228560
9412,0.001806,74.125.68.0-255,2902,176875,65,228560
9413,0.001811,172.31.40.0-255,66,176941,65,228560
9414,0.001823,74.125.68.0-255,5738,182679,65,228560
9415,0.001865,74.125.68.0-255,5020,187699,65,228560
9416,0.00195,74.125.68.0-255,1484,189183,65,228560
9417,0.001968,74.125.68.0-255,2902,192085,65,228560
9418,0.002001,74.125.68.0-255,5738,197823,65,228560
9419,0.002008,74.125.68.0-255,4320,202143,65,228560
9420,0.002029,74.125.68.0-255,2902,205045,65,228560
9421,0.010055,172.31.40.0-255,66,205111,65,228560
9422,0.010452,172.31.40.0-255,101,205212,65,228560
9423,0.011527,74.125.68.0-255,1484,206696,65,228560
9424,0.012113,74.125.68.0-255,4320,211016,65,228560
9425,0.012119,172.31.40.0-255,66,211082,65,228560
9426,0.012468,74.125.68.0-255,66,211148,65,228560
9427,0.014176,74.125.68.0-255,5738,216886,65,228560
9428,0.015005,172.31.40.0-255,66,216952,65,228560
9429,0.017075,74.125.68.0-255,5738,222690,65,228560
9430,0.017089,172.31.40.0-255,66,222756,65,228560
9431,0.019164,74.125.68.0-255,5738,228494,65,228560
9432,0.019171,172.31.40.0-255,66,228560,65,228560
9433,0.0,74.125.24.0-255,153,153,65,84109
9434,2.3e-05,172.31.40.0-255,66,219,65,84109
9435,3e-05,74.125.24.0-255,1484,1703,65,84109
9436,3.4e-05,172.31.40.0-255,66,1769,65,84109
9437,3.6e-05,74.125.24.0-255,1484,3253,65,84109
9438,4e-05,172.31.40.0-255,66,3319,65,84109
9439,5.4e-05,74.125.24.0-255,4320,7639,65,84109
9440,5.7e-05,172.31.40.0-255,66,7705,65,84109
9441,8.7e-05,74.125.24.0-255,6257,13962,65,84109
9442,9e-05,172.31.40.0-255,66,14028,65,84109
9443,0.000379,74.125.24.0-255,1484,15512,65,84109
9444,0.000384,172.31.40.0-255,66,15578,65,84109
9445,0.000388,74.125.24.0-255,1484,17062,65,84109
9446,0.00039,172.31.40.0-255,66,17128,65,84109
9447,0.000412,74.125.24.0-255,1484,18612,65,84109
9448,0.000415,172.31.40.0-255,66,18678,65,84109
9449,0.000422,74.125.24.0-255,5738,24416,65,84109
9450,0.000424,172.31.40.0-255,66,24482,65,84109
9451,0.00046,74.125.24.0-255,1484,25966,65,84109
9452,0.000462,172.31.40.0-255,66,26032,65,84109
9453,0.000499,172.31.40.0-255,66,26098,65,84109
9454,0.000502,74.125.24.0-255,1484,27582,65,84109
9455,0.000503,172.31.40.0-255,66,27648,65,84109
9456,0.000532,74.125.24.0-255,7156,34804,65,84109
9457,0.000535,172.31.40.0-255,66,34870,65,84109
9458,0.000552,74.125.24.0-255,3961,38831,65,84109
9459,0.000555,172.31.40.0-255,66,38897,65,84109
9460,0.003255,74.125.24.0-255,1484,40381,65,84109
9461,0.003261,172.31.40.0-255,66,40447,65,84109
9462,0.00327,74.125.24.0-255,2902,43349,65,84109
9463,0.003272,172.31.40.0-255,66,43415,65,84109
9464,0.00328,74.125.24.0-255,1484,44899,65,84109
9465,0.005599,74.125.24.0-255,4320,49219,65,84109
9466,0.005605,172.31.40.0-255,66,49285,65,84109
9467,0.007928,74.125.24.0-255,5738,55023,65,84109
9468,0.007937,172.31.40.0-255,66,55089,65,84109
9469,0.01024,74.125.24.0-255,5738,60827,65,84109
9470,0.010249,172.31.40.0-255,66,60893,65,84109
9471,0.012561,74.125.24.0-255,5738,66631,65,84109
9472,0.01257,172.31.40.0-255,66,66697,65,84109
9473,0.014895,74.125.24.0-255,5738,72435,65,84109
9474,0.014905,172.31.40.0-255,66,72501,65,84109
9475,0.017229,74.125.24.0-255,5738,78239,65,84109
9476,0.017241,172.31.40.0-255,66,78305,65,84109
9477,0.019607,74.125.24.0-255,5738,84043,65,84109
9478,0.019616,172.31.40.0-255,66,84109,65,84109
9479,0.0,172.31.40.0-255,105,105,65,459
9480,0.000212,172.31.40.0-255,90,195,65,459
9481,0.000223,172.31.40.0-255,66,261,65,459
9482,0.00243,74.125.200.0-255,66,327,65,459
9483,0.002463,74.125.200.0-255,66,393,65,459
9484,0.002486,172.31.40.0-255,66,459,65,459
9485,0.0,172.217.26.0-255,152,152,65,127779
9486,2.2e-05,172.31.40.0-255,66,218,65,127779
9487,2.9e-05,172.217.26.0-255,1484,1702,65,127779
9488,3.3e-05,172.31.40.0-255,66,1768,65,127779
9489,3.8e-05,172.217.26.0-255,2902,4670,65,127779
9490,4.2e-05,172.31.40.0-255,66,4736,65,127779
9491,4.9e-05,172.217.26.0-255,7156,11892,65,127779
9492,5.3e-05,172.31.40.0-255,66,11958,65,127779
9493,5.8e-05,172.217.26.0-255,1983,13941,65,127779
9494,6e-05,172.31.40.0-255,66,14007,65,127779
9495,0.000154,172.217.26.0-255,1484,15491,65,127779
9496,0.000157,172.31.40.0-255,66,15557,65,127779
9497,0.000161,172.217.26.0-255,1484,17041,65,127779
9498,0.000164,172.31.40.0-255,66,17107,65,127779
9499,0.000178,172.217.26.0-255,1484,18591,65,127779
9500,0.00018,172.31.40.0-255,66,18657,65,127779
9501,0.000187,172.217.26.0-255,5738,24395,65,127779
9502,0.000189,172.31.40.0-255,66,24461,65,127779
9503,0.000197,172.217.26.0-255,6797,31258,65,127779
9504,0.000199,172.31.40.0-255,66,31324,65,127779
9505,0.000379,172.217.26.0-255,1484,32808,65,127779
9506,0.000383,172.217.26.0-255,1484,34292,65,127779
9507,0.000388,172.31.40.0-255,66,34358,65,127779
9508,0.000396,172.31.40.0-255,66,34424,65,127779
9509,0.000402,172.217.26.0-255,2902,37326,65,127779
9510,0.000405,172.31.40.0-255,66,37392,65,127779
9511,0.000412,172.217.26.0-255,5738,43130,65,127779
9512,0.000414,172.31.40.0-255,66,43196,65,127779
9513,0.000442,172.217.26.0-255,4320,47516,65,127779
9514,0.000445,172.31.40.0-255,66,47582,65,127779
9515,0.000471,172.31.40.0-255,66,47648,65,127779
9516,0.00051,172.31.40.0-255,66,47714,65,127779
9517,0.001096,172.217.26.0-255,647,48361,65,127779
9518,0.001165,172.31.40.0-255,66,48427,65,127779
9519,0.001345,172.217.26.0-255,1484,49911,65,127779
9520,0.001368,172.217.26.0-255,2902,52813,65,127779
9521,0.001373,172.31.40.0-255,66,52879,65,127779
9522,0.001381,172.217.26.0-255,5738,58617,65,127779
9523,0.001383,172.31.40.0-255,66,58683,65,127779
9524,0.001386,172.217.26.0-255,1484,60167,65,127779
9525,0.001409,172.217.26.0-255,1484,61651,65,127779
9526,0.001412,172.31.40.0-255,66,61717,65,127779
9527,0.001425,172.31.40.0-255,66,61783,65,127779
9528,0.00143,172.217.26.0-255,2902,64685,65,127779
9529,0.001432,172.31.40.0-255,66,64751,65,127779
9530,0.001459,172.217.26.0-255,6438,71189,65,127779
9531,0.001461,172.31.40.0-255,66,71255,65,127779
9532,0.001964,172.217.26.0-255,1484,72739,65,127779
9533,0.001972,172.217.26.0-255,1484,74223,65,127779
9534,0.001976,172.31.40.0-255,66,74289,65,127779
9535,0.003398,172.217.26.0-255,2902,77191,65,127779
9536,0.003405,172.31.40.0-255,66,77257,65,127779
9537,0.003915,172.217.26.0-255,2902,80159,65,127779
9538,0.003919,172.31.40.0-255,66,80225,65,127779
9539,0.00535,172.217.26.0-255,2902,83127,65,127779
9540,0.005367,172.31.40.0-255,66,83193,65,127779
9541,0.005855,172.217.26.0-255,2902,86095,65,127779
9542,0.005859,172.31.40.0-255,66,86161,65,127779
9543,0.00731,172.217.26.0-255,2902,89063,65,127779
9544,0.007316,172.31.40.0-255,66,89129,65,127779
9545,0.007806,172.217.26.0-255,2902,92031,65,127779
9546,0.00781,172.31.40.0-255,66,92097,65,127779
9547,0.009269,172.217.26.0-255,2902,94999,65,127779
9548,0.009275,172.31.40.0-255,66,95065,65,127779
9549,0.009756,172.217.26.0-255,2902,97967,65,127779
9550,0.009762,172.31.40.0-255,66,98033,65,127779
9551,0.011216,172.217.26.0-255,2902,100935,65,127779
9552,0.011224,172.31.40.0-255,66,101001,65,127779
9553,0.011706,172.217.26.0-255,2902,103903,65,127779
9554,0.011712,172.31.40.0-255,66,103969,65,127779
9555,0.01317,172.217.26.0-255,2902,106871,65,127779
9556,0.013176,172.31.40.0-255,66,106937,65,127779
9557,0.013657,172.217.26.0-255,2902,109839,65,127779
9558,0.013663,172.31.40.0-255,66,109905,65,127779
9559,0.015116,172.217.26.0-255,2902,112807,65,127779
9560,0.015124,172.31.40.0-255,66,112873,65,127779
9561,0.01561,172.217.26.0-255,2902,115775,65,127779
9562,0.015617,172.31.40.0-255,66,115841,65,127779
9563,0.017079,172.217.26.0-255,2902,118743,65,127779
9564,0.017086,172.31.40.0-255,66,118809,65,127779
9565,0.017585,172.217.26.0-255,1484,120293,65,127779
9566,0.017601,172.217.26.0-255,1484,121777,65,127779
9567,0.017606,172.31.40.0-255,66,121843,65,127779
9568,0.019038,172.217.26.0-255,2902,124745,65,127779
9569,0.019045,172.31.40.0-255,66,124811,65,127779
9570,0.019561,172.217.26.0-255,2902,127713,65,127779
9571,0.019568,172.31.40.0-255,66,127779,65,127779
9572,0.0,172.217.194.0-255,149,149,65,255107
9573,1.6e-05,172.31.40.0-255,66,215,65,255107
9574,3.1e-05,172.217.194.0-255,1484,1699,65,255107
9575,4.2e-05,172.31.40.0-255,66,1765,65,255107
9576,4.9e-05,172.217.194.0-255,2902,4667,65,255107
9577,5.1e-05,172.31.40.0-255,66,4733,65,255107
9578,5.9e-05,172.217.194.0-255,7156,11889,65,255107
9579,6.2e-05,172.31.40.0-255,66,11955,65,255107
9580,9.3e-05,172.217.194.0-255,1999,13954,65,255107
9581,9.6e-05,172.31.40.0-255,66,14020,65,255107
9582,0.000191,172.217.194.0-255,1484,15504,65,255107
9583,0.000194,172.31.40.0-255,66,15570,65,255107
9584,0.000199,172.217.194.0-255,2902,18472,65,255107
9585,0.000202,172.31.40.0-255,66,18538,65,255107
9586,0.000206,172.217.194.0-255,2902,21440,65,255107
9587,0.000208,172.31.40.0-255,66,21506,65,255107
9588,0.00023,172.217.194.0-255,2902,24408,65,255107
9589,0.000237,172.31.40.0-255,66,24474,65,255107
9590,0.000243,172.217.194.0-255,4320,28794,65,255107
9591,0.000246,172.31.40.0-255,66,28860,65,255107
9592,0.000277,172.31.40.0-255,66,28926,65,255107
9593,0.00031,172.217.194.0-255,2543,31469,65,255107
9594,0.000312,172.31.40.0-255,66,31535,65,255107
9595,0.000322,172.217.194.0-255,6797,38332,65,255107
9596,0.000324,172.31.40.0-255,66,38398,65,255107
9597,0.00033,172.217.194.0-255,5738,44136,65,255107
9598,0.000332,172.31.40.0-255,66,44202,65,255107
9599,0.000335,172.217.194.0-255,1484,45686,65,255107
9600,0.000338,172.31.40.0-255,66,45752,65,255107
9601,0.000367,172.217.194.0-255,5738,51490,65,255107
9602,0.00037,172.31.40.0-255,66,51556,65,255107
9603,0.000375,172.217.194.0-255,3961,55517,65,255107
9604,0.000378,172.31.40.0-255,66,55583,65,255107
9605,0.000404,172.217.194.0-255,378,55961,65,255107
9606,0.000473,172.217.194.0-255,364,56325,65,255107
9607,0.000584,172.217.194.0-255,1484,57809,65,255107
9608,0.000588,172.31.40.0-255,66,57875,65,255107
9609,0.000594,172.217.194.0-255,2902,60777,65,255107
9610,0.000597,172.31.40.0-255,66,60843,65,255107
9611,0.000622,172.217.194.0-255,5738,66581,65,255107
9612,0.000625,172.31.40.0-255,66,66647,65,255107
9613,0.00063,172.217.194.0-255,4320,70967,65,255107
9614,0.000632,172.31.40.0-255,66,71033,65,255107
9615,0.000659,172.217.194.0-255,2543,73576,65,255107
9616,0.000661,172.31.40.0-255,66,73642,65,255107
9617,0.000686,172.217.194.0-255,1484,75126,65,255107
9618,0.000691,172.217.194.0-255,2902,78028,65,255107
9619,0.000693,172.31.40.0-255,66,78094,65,255107
9620,0.000704,172.217.194.0-255,5738,83832,65,255107
9621,0.000707,172.31.40.0-255,66,83898,65,255107
9622,0.000739,172.217.194.0-255,6797,90695,65,255107
9623,0.000742,172.31.40.0-255,66,90761,65,255107
9624,0.000814,172.217.194.0-255,1484,92245,65,255107
9625,0.00082,172.217.194.0-255,2902,95147,65,255107
9626,0.000822,172.31.40.0-255,66,95213,65,255107
9627,0.000826,172.217.194.0-255,1484,96697,65,255107
9628,0.000852,172.217.194.0-255,4320,101017,65,255107
9629,0.000855,172.31.40.0-255,66,101083,65,255107
9630,0.000898,172.31.40.0-255,66,101149,65,255107
9631,0.000916,172.31.40.0-255,66,101215,65,255107
9632,0.000955,172.217.194.0-255,1484,102699,65,255107
9633,0.00096,172.217.194.0-255,2902,105601,65,255107
9634,0.000963,172.31.40.0-255,66,105667,65,255107
9635,0.001005,172.217.194.0-255,1484,107151,65,255107
9636,0.001023,172.217.194.0-255,4320,111471,65,255107
9637,0.001026,172.31.40.0-255,66,111537,65,255107
9638,0.001038,172.31.40.0-255,66,111603,65,255107
9639,0.001055,172.31.40.0-255,66,111669,65,255107
9640,0.001059,172.217.194.0-255,2184,113853,65,255107
9641,0.001062,172.31.40.0-255,66,113919,65,255107
9642,0.001688,172.217.194.0-255,1484,115403,65,255107
9643,0.001696,172.217.194.0-255,2902,118305,65,255107
9644,0.001699,172.31.40.0-255,66,118371,65,255107
9645,0.001703,172.217.194.0-255,1484,119855,65,255107
9646,0.001723,172.217.194.0-255,4320,124175,65,255107
9647,0.001725,172.31.40.0-255,66,124241,65,255107
9648,0.001731,172.217.194.0-255,4320,128561,65,255107
9649,0.001733,172.31.40.0-255,66,128627,65,255107
9650,0.001768,172.31.40.0-255,66,128693,65,255107
9651,0.00178,172.31.40.0-255,66,128759,65,255107
9652,0.002502,172.217.194.0-255,1484,130243,65,255107
9653,0.002509,172.217.194.0-255,2902,133145,65,255107
9654,0.002512,172.31.40.0-255,66,133211,65,255107
9655,0.002518,172.217.194.0-255,2902,136113,65,255107
9656,0.00252,172.31.40.0-255,66,136179,65,255107
9657,0.002556,172.217.194.0-255,2902,139081,65,255107
9658,0.002558,172.31.40.0-255,66,139147,65,255107
9659,0.002572,172.31.40.0-255,66,139213,65,255107
9660,0.002588,172.31.40.0-255,66,139279,65,255107
9661,0.002649,172.217.194.0-255,1484,140763,65,255107
9662,0.002654,172.217.194.0-255,2902,143665,65,255107
9663,0.002656,172.31.40.0-255,66,143731,65,255107
9664,0.002686,172.217.194.0-255,5738,149469,65,255107
9665,0.002689,172.31.40.0-255,66,149535,65,255107
9666,0.0027,172.217.194.0-255,7156,156691,65,255107
9667,0.002702,172.31.40.0-255,66,156757,65,255107
9668,0.002742,172.31.40.0-255,66,156823,65,255107
9669,0.002766,172.217.194.0-255,3602,160425,65,255107
9670,0.002768,172.31.40.0-255,66,160491,65,255107
9671,0.003949,172.217.194.0-255,1484,161975,65,255107
9672,0.003956,172.217.194.0-255,2902,164877,65,255107
9673,0.00396,172.31.40.0-255,66,164943,65,255107
9674,0.003964,172.217.194.0-255,1484,166427,65,255107
9675,0.003987,172.217.194.0-255,4320,170747,65,255107
9676,0.003988,172.31.40.0-255,66,170813,65,255107
9677,0.003991,172.217.194.0-255,1484,172297,65,255107
9678,0.00403,172.31.40.0-255,66,172363,65,255107
9679,0.004037,172.217.194.0-255,7156,179519,65,255107
9680,0.004038,172.31.40.0-255,66,179585,65,255107
9681,0.004065,172.217.194.0-255,3602,183187,65,255107
9682,0.004067,172.31.40.0-255,66,183253,65,255107
9683,0.00407,172.217.194.0-255,1484,184737,65,255107
9684,0.004075,172.217.194.0-255,2902,187639,65,255107
9685,0.004076,172.31.40.0-255,66,187705,65,255107
9686,0.004079,172.217.194.0-255,1484,189189,65,255107
9687,0.0041,172.217.194.0-255,4320,193509,65,255107
9688,0.004102,172.31.40.0-255,66,193575,65,255107
9689,0.004111,172.217.194.0-255,4320,197895,65,255107
9690,0.004113,172.31.40.0-255,66,197961,65,255107
9691,0.004146,172.31.40.0-255,66,198027,65,255107
9692,0.004178,172.217.194.0-255,4320,202347,65,255107
9693,0.00418,172.31.40.0-255,66,202413,65,255107
9694,0.004207,172.217.194.0-255,6438,208851,65,255107
9695,0.00421,172.31.40.0-255,66,208917,65,255107
9696,0.004213,172.217.194.0-255,1484,210401,65,255107
9697,0.004216,172.217.194.0-255,2902,213303,65,255107
9698,0.004218,172.31.40.0-255,66,213369,65,255107
9699,0.004224,172.217.194.0-255,4320,217689,65,255107
9700,0.004226,172.31.40.0-255,66,217755,65,255107
9701,0.004252,172.217.194.0-255,1484,219239,65,255107
9702,0.004266,172.217.194.0-255,5738,224977,65,255107
9703,0.004269,172.31.40.0-255,66,225043,65,255107
9704,0.004301,172.217.194.0-255,7156,232199,65,255107
9705,0.004304,172.31.40.0-255,66,232265,65,255107
9706,0.004349,172.31.40.0-255,66,232331,65,255107
9707,0.004357,172.217.194.0-255,7156,239487,65,255107
9708,0.004359,172.31.40.0-255,66,239553,65,255107
9709,0.004393,172.217.194.0-255,4320,243873,65,255107
9710,0.004395,172.31.40.0-255,66,243939,65,255107
9711,0.004401,172.217.194.0-255,4320,248259,65,255107
9712,0.004404,172.31.40.0-255,66,248325,65,255107
9713,0.004438,172.31.40.0-255,66,248391,65,255107
9714,0.004464,172.217.194.0-255,6308,254699,65,255107
9715,0.004467,172.31.40.0-255,66,254765,65,255107
9716,0.00447,172.217.194.0-255,105,254870,65,255107
9717,0.008223,172.31.40.0-255,66,254936,65,255107
9718,0.008261,172.31.40.0-255,105,255041,65,255107
9719,0.010838,172.217.194.0-255,66,255107,65,255107
9720,0.0,172.217.194.0-255,153,153,65,161247
9721,1.5e-05,172.31.40.0-255,66,219,65,161247
9722,2.2e-05,172.217.194.0-255,1484,1703,65,161247
9723,2.7e-05,172.31.40.0-255,66,1769,65,161247
9724,4e-05,172.217.194.0-255,2902,4671,65,161247
9725,4.4e-05,172.31.40.0-255,66,4737,65,161247
9726,5.1e-05,172.217.194.0-255,7156,11893,65,161247
9727,5.4e-05,172.31.40.0-255,66,11959,65,161247
9728,6e-05,172.217.194.0-255,4320,16279,65,161247
9729,6.3e-05,172.31.40.0-255,66,16345,65,161247
9730,8.8e-05,172.31.40.0-255,66,16411,65,161247
9731,0.000128,172.217.194.0-255,6797,23208,65,161247
9732,0.000131,172.31.40.0-255,66,23274,65,161247
9733,0.000134,172.217.194.0-255,1484,24758,65,161247
9734,0.000136,172.31.40.0-255,66,24824,65,161247
9735,0.000174,172.217.194.0-255,5738,30562,65,161247
9736,0.000177,172.31.40.0-255,66,30628,65,161247
9737,0.000188,172.31.40.0-255,66,30694,65,161247
9738,0.000896,172.217.194.0-255,1484,32178,65,161247
9739,0.000901,172.31.40.0-255,66,32244,65,161247
9740,0.000909,172.217.194.0-255,2902,35146,65,161247
9741,0.000911,172.31.40.0-255,66,35212,65,161247
9742,0.000924,172.217.194.0-255,5738,40950,65,161247
9743,0.000926,172.31.40.0-255,66,41016,65,161247
9744,0.000933,172.217.194.0-255,5738,46754,65,161247
9745,0.000935,172.31.40.0-255,66,46820,65,161247
9746,0.000965,172.217.194.0-255,1705,48525,65,161247
9747,0.000967,172.31.40.0-255,66,48591,65,161247
9748,0.000978,172.31.40.0-255,66,48657,65,161247
9749,0.000983,172.217.194.0-255,2902,51559,65,161247
9750,0.000988,172.31.40.0-255,66,51625,65,161247
9751,0.001015,172.217.194.0-255,4320,55945,65,161247
9752,0.001018,172.31.40.0-255,66,56011,65,161247
9753,0.001036,172.31.40.0-255,66,56077,65,161247
9754,0.001426,172.217.194.0-255,1484,57561,65,161247
9755,0.001436,172.217.194.0-255,2902,60463,65,161247
9756,0.00144,172.31.40.0-255,66,60529,65,161247
9757,0.001444,172.217.194.0-255,1484,62013,65,161247
9758,0.001469,172.217.194.0-255,4320,66333,65,161247
9759,0.001472,172.31.40.0-255,66,66399,65,161247
9760,0.001476,172.217.194.0-255,2902,69301,65,161247
9761,0.001479,172.31.40.0-255,66,69367,65,161247
9762,0.001501,172.217.194.0-255,3294,72661,65,161247
9763,0.001508,172.31.40.0-255,66,72727,65,161247
9764,0.001512,172.217.194.0-255,2902,75629,65,161247
9765,0.001515,172.31.40.0-255,66,75695,65,161247
9766,0.00154,172.217.194.0-255,4320,80015,65,161247
9767,0.001543,172.31.40.0-255,66,80081,65,161247
9768,0.001554,172.31.40.0-255,66,80147,65,161247
9769,0.001565,172.31.40.0-255,66,80213,65,161247
9770,0.001602,172.31.40.0-255,66,80279,65,161247
9771,0.001979,172.217.194.0-255,1484,81763,65,161247
9772,0.001989,172.217.194.0-255,2902,84665,65,161247
9773,0.001993,172.31.40.0-255,66,84731,65,161247
9774,0.002001,172.217.194.0-255,5738,90469,65,161247
9775,0.002003,172.31.40.0-255,66,90535,65,161247
9776,0.002024,172.31.40.0-255,66,90601,65,161247
9777,0.002094,172.31.40.0-255,66,90667,65,161247
9778,0.002107,172.31.40.0-255,66,90733,65,161247
9779,0.002123,172.31.40.0-255,66,90799,65,161247
9780,0.002157,172.217.194.0-255,6438,97237,65,161247
9781,0.00216,172.31.40.0-255,66,97303,65,161247
9782,0.002165,172.217.194.0-255,2902,100205,65,161247
9783,0.002167,172.31.40.0-255,66,100271,65,161247
9784,0.002196,172.217.194.0-255,4320,104591,65,161247
9785,0.002199,172.31.40.0-255,66,104657,65,161247
9786,0.002202,172.217.194.0-255,1484,106141,65,161247
9787,0.002264,172.31.40.0-255,66,106207,65,161247
9788,0.002277,172.31.40.0-255,66,106273,65,161247
9789,0.002298,172.217.194.0-255,1484,107757,65,161247
9790,0.002306,172.217.194.0-255,1484,109241,65,161247
9791,0.002308,172.31.40.0-255,66,109307,65,161247
9792,0.002339,172.217.194.0-255,1484,110791,65,161247
9793,0.002346,172.217.194.0-255,5738,116529,65,161247
9794,0.002349,172.31.40.0-255,66,116595,65,161247
9795,0.002353,172.217.194.0-255,2902,119497,65,161247
9796,0.002356,172.31.40.0-255,66,119563,65,161247
9797,0.004606,172.217.194.0-255,1484,121047,65,161247
9798,0.004622,172.217.194.0-255,1484,122531,65,161247
9799,0.004625,172.31.40.0-255,66,122597,65,161247
9800,0.00465,172.217.194.0-255,2902,125499,65,161247
9801,0.004653,172.31.40.0-255,66,125565,65,161247
9802,0.00689,172.217.194.0-255,2902,128467,65,161247
9803,0.006906,172.31.40.0-255,66,128533,65,161247
9804,0.006935,172.217.194.0-255,2902,131435,65,161247
9805,0.00694,172.31.40.0-255,66,131501,65,161247
9806,0.009181,172.217.194.0-255,2902,134403,65,161247
9807,0.009198,172.31.40.0-255,66,134469,65,161247
9808,0.009255,172.217.194.0-255,2902,137371,65,161247
9809,0.009259,172.31.40.0-255,66,137437,65,161247
9810,0.011447,172.217.194.0-255,2902,140339,65,161247
9811,0.011454,172.31.40.0-255,66,140405,65,161247
9812,0.011567,172.217.194.0-255,2902,143307,65,161247
9813,0.01157,172.31.40.0-255,66,143373,65,161247
9814,0.013748,172.217.194.0-255,2902,146275,65,161247
9815,0.013765,172.31.40.0-255,66,146341,65,161247
9816,0.013861,172.217.194.0-255,2902,149243,65,161247
9817,0.013865,172.31.40.0-255,66,149309,65,161247
9818,0.016046,172.217.194.0-255,2902,152211,65,161247
9819,0.016053,172.31.40.0-255,66,152277,65,161247
9820,0.016099,172.217.194.0-255,2902,155179,65,161247
9821,0.016102,172.31.40.0-255,66,155245,65,161247
9822,0.018305,172.217.194.0-255,2902,158147,65,161247
9823,0.018321,172.31.40.0-255,66,158213,65,161247
9824,0.018354,172.217.194.0-255,1484,159697,65,161247
9825,0.018366,172.217.194.0-255,1484,161181,65,161247
9826,0.018369,172.31.40.0-255,66,161247,65,161247
9827,0.0,74.125.130.0-255,165,165,65,191195
9828,2.4e-05,172.31.40.0-255,66,231,65,191195
9829,3.1e-05,74.125.130.0-255,1484,1715,65,191195
9830,3.5e-05,172.31.40.0-255,66,1781,65,191195
9831,4.1e-05,74.125.130.0-255,2902,4683,65,191195
9832,4.5e-05,172.31.40.0-255,66,4749,65,191195
9833,6.2e-05,74.125.130.0-255,1484,6233,65,191195
9834,6.5e-05,172.31.40.0-255,66,6299,65,191195
9835,8.5e-05,74.125.130.0-255,1484,7783,65,191195
9836,8.6e-05,172.31.40.0-255,66,7849,65,191195
9837,9.2e-05,74.125.130.0-255,4320,12169,65,191195
9838,9.5e-05,172.31.40.0-255,66,12235,65,191195
9839,0.000112,74.125.130.0-255,1484,13719,65,191195
9840,0.000114,172.31.40.0-255,66,13785,65,191195
9841,0.000137,74.125.130.0-255,6238,20023,65,191195
9842,0.000139,172.31.40.0-255,66,20089,65,191195
9843,0.000169,74.125.130.0-255,1484,21573,65,191195
9844,0.000171,172.31.40.0-255,66,21639,65,191195
9845,0.000203,74.125.130.0-255,7156,28795,65,191195
9846,0.000205,172.31.40.0-255,66,28861,65,191195
9847,0.000209,74.125.130.0-255,2543,31404,65,191195
9848,0.000211,172.31.40.0-255,66,31470,65,191195
9849,0.000276,74.125.130.0-255,1484,32954,65,191195
9850,0.000278,172.31.40.0-255,66,33020,65,191195
9851,0.000284,74.125.130.0-255,2902,35922,65,191195
9852,0.000286,172.31.40.0-255,66,35988,65,191195
9853,0.000315,74.125.130.0-255,5738,41726,65,191195
9854,0.000317,172.31.40.0-255,66,41792,65,191195
9855,0.000323,74.125.130.0-255,5738,47530,65,191195
9856,0.000326,172.31.40.0-255,66,47596,65,191195
9857,0.000347,74.125.130.0-255,2902,50498,65,191195
9858,0.00035,172.31.40.0-255,66,50564,65,191195
9859,0.000367,74.125.130.0-255,4320,54884,65,191195
9860,0.000369,172.31.40.0-255,66,54950,65,191195
9861,0.000379,172.31.40.0-255,66,55016,65,191195
9862,0.000421,74.125.130.0-255,2494,57510,65,191195
9863,0.000423,172.31.40.0-255,66,57576,65,191195
9864,0.000509,74.125.130.0-255,367,57943,65,191195
9865,0.000512,172.31.40.0-255,66,58009,65,191195
9866,0.000709,74.125.130.0-255,1484,59493,65,191195
9867,0.000713,172.31.40.0-255,66,59559,65,191195
9868,0.000716,74.125.130.0-255,1484,61043,65,191195
9869,0.000718,172.31.40.0-255,66,61109,65,191195
9870,0.000734,74.125.130.0-255,2902,64011,65,191195
9871,0.000736,172.31.40.0-255,66,64077,65,191195
9872,0.000761,74.125.130.0-255,5738,69815,65,191195
9873,0.000763,172.31.40.0-255,66,69881,65,191195
9874,0.000766,74.125.130.0-255,1484,71365,65,191195
9875,0.000768,172.31.40.0-255,66,71431,65,191195
9876,0.000794,74.125.130.0-255,5738,77169,65,191195
9877,0.000797,172.31.40.0-255,66,77235,65,191195
9878,0.000804,74.125.130.0-255,7156,84391,65,191195
9879,0.000806,172.31.40.0-255,66,84457,65,191195
9880,0.000818,74.125.130.0-255,1484,85941,65,191195
9881,0.00082,172.31.40.0-255,66,86007,65,191195
9882,0.000827,74.125.130.0-255,5738,91745,65,191195
9883,0.000829,172.31.40.0-255,66,91811,65,191195
9884,0.000858,74.125.130.0-255,766,92577,65,191195
9885,0.000861,172.31.40.0-255,66,92643,65,191195
9886,0.001596,74.125.130.0-255,1484,94127,65,191195
9887,0.001601,172.31.40.0-255,66,94193,65,191195
9888,0.001641,74.125.130.0-255,1484,95677,65,191195
9889,0.001644,172.31.40.0-255,66,95743,65,191195
9890,0.001647,74.125.130.0-255,1484,97227,65,191195
9891,0.001649,172.31.40.0-255,66,97293,65,191195
9892,0.001661,74.125.130.0-255,1484,98777,65,191195
9893,0.001663,172.31.40.0-255,66,98843,65,191195
9894,0.001675,74.125.130.0-255,1484,100327,65,191195
9895,0.001677,172.31.40.0-255,66,100393,65,191195
9896,0.001694,74.125.130.0-255,2902,103295,65,191195
9897,0.001696,172.31.40.0-255,66,103361,65,191195
9898,0.001739,74.125.130.0-255,2902,106263,65,191195
9899,0.001742,172.31.40.0-255,66,106329,65,191195
9900,0.001766,74.125.130.0-255,2902,109231,65,191195
9901,0.001769,172.31.40.0-255,66,109297,65,191195
9902,0.001775,74.125.130.0-255,5738,115035,65,191195
9903,0.001777,172.31.40.0-255,66,115101,65,191195
9904,0.001799,74.125.130.0-255,1484,116585,65,191195
9905,0.001801,172.31.40.0-255,66,116651,65,191195
9906,0.001804,74.125.130.0-255,1484,118135,65,191195
9907,0.001806,172.31.40.0-255,66,118201,65,191195
9908,0.001842,74.125.130.0-255,7156,125357,65,191195
9909,0.001844,172.31.40.0-255,66,125423,65,191195
9910,0.001862,74.125.130.0-255,2184,127607,65,191195
9911,0.001864,172.31.40.0-255,66,127673,65,191195
9912,0.002082,74.125.130.0-255,1484,129157,65,191195
9913,0.002088,172.31.40.0-255,66,129223,65,191195
9914,0.002095,74.125.130.0-255,2902,132125,65,191195
9915,0.002097,172.31.40.0-255,66,132191,65,191195
9916,0.002103,74.125.130.0-255,4320,136511,65,191195
9917,0.002105,172.31.40.0-255,66,136577,65,191195
9918,0.002123,74.125.130.0-255,1484,138061,65,191195
9919,0.002126,172.31.40.0-255,66,138127,65,191195
9920,0.002168,74.125.130.0-255,1484,139611,65,191195
9921,0.002192,74.125.130.0-255,1484,141095,65,191195
9922,0.002227,74.125.130.0-255,2902,143997,65,191195
9923,0.002262,74.125.130.0-255,4320,148317,65,191195
9924,0.002277,74.125.130.0-255,1484,149801,65,191195
9925,0.00229,74.125.130.0-255,2184,151985,65,191195
9926,0.002331,74.125.130.0-255,1484,153469,65,191195
9927,0.002344,74.125.130.0-255,2902,156371,65,191195
9928,0.002368,74.125.130.0-255,5738,162109,65,191195
9929,0.007203,172.31.40.0-255,66,162175,65,191195
9930,0.009559,74.125.130.0-255,5738,167913,65,191195
9931,0.009567,172.31.40.0-255,66,167979,65,191195
9932,0.011913,74.125.130.0-255,5738,173717,65,191195
9933,0.011921,172.31.40.0-255,66,173783,65,191195
9934,0.014265,74.125.130.0-255,5738,179521,65,191195
9935,0.014839,172.31.40.0-255,66,179587,65,191195
9936,0.017182,74.125.130.0-255,5738,185325,65,191195
9937,0.01719,172.31.40.0-255,66,185391,65,191195
9938,0.019587,74.125.130.0-255,5738,191129,65,191195
9939,0.019597,172.31.40.0-255,66,191195,65,191195
9940,0.0,172.217.194.0-255,152,152,65,138996
9941,2.4e-05,172.31.40.0-255,66,218,65,138996
9942,3e-05,172.217.194.0-255,1484,1702,65,138996
9943,3.5e-05,172.31.40.0-255,66,1768,65,138996
9944,4.9e-05,172.217.194.0-255,2902,4670,65,138996
9945,5.2e-05,172.31.40.0-255,66,4736,65,138996
9946,5.9e-05,172.217.194.0-255,7156,11892,65,138996
9947,6.2e-05,172.31.40.0-255,66,11958,65,138996
9948,0.000133,172.217.194.0-255,2099,14057,65,138996
9949,0.000136,172.31.40.0-255,66,14123,65,138996
9950,0.000173,172.31.40.0-255,66,14189,65,138996
9951,0.000282,172.217.194.0-255,5379,19568,65,138996
9952,0.000286,172.31.40.0-255,66,19634,65,138996
9953,0.000343,172.217.194.0-255,4320,23954,65,138996
9954,0.000347,172.31.40.0-255,66,24020,65,138996
9955,0.000389,172.31.40.0-255,66,24086,65,138996
9956,0.000537,172.217.194.0-255,4320,28406,65,138996
9957,0.000541,172.31.40.0-255,66,28472,65,138996
9958,0.000581,172.31.40.0-255,66,28538,65,138996
9959,0.000696,172.217.194.0-255,364,28902,65,138996
9960,0.0007,172.31.40.0-255,66,28968,65,138996
9961,0.000724,172.217.194.0-255,1484,30452,65,138996
9962,0.000727,172.31.40.0-255,66,30518,65,138996
9963,0.000754,172.217.194.0-255,4320,34838,65,138996
9964,0.000757,172.31.40.0-255,66,34904,65,138996
9965,0.000798,172.217.194.0-255,4320,39224,65,138996
9966,0.000801,172.31.40.0-255,66,39290,65,138996
9967,0.00083,172.217.194.0-255,5738,45028,65,138996
9968,0.000833,172.31.40.0-255,66,45094,65,138996
9969,0.000899,172.217.194.0-255,2902,47996,65,138996
9970,0.000902,172.31.40.0-255,66,48062,65,138996
9971,0.000943,172.31.40.0-255,66,48128,65,138996
9972,0.001152,172.217.194.0-255,1484,49612,65,138996
9973,0.001158,172.217.194.0-255,2902,52514,65,138996
9974,0.001161,172.31.40.0-255,66,52580,65,138996
9975,0.001186,172.217.194.0-255,1484,54064,65,138996
9976,0.001208,172.217.194.0-255,4320,58384,65,138996
9977,0.001212,172.31.40.0-255,66,58450,65,138996
9978,0.001239,172.217.194.0-255,1484,59934,65,138996
9979,0.001263,172.217.194.0-255,5738,65672,65,138996
9980,0.001266,172.31.40.0-255,66,65738,65,138996
9981,0.001296,172.217.194.0-255,2902,68640,65,138996
9982,0.001299,172.31.40.0-255,66,68706,65,138996
9983,0.001356,172.217.194.0-255,1484,70190,65,138996
9984,0.001385,172.31.40.0-255,66,70256,65,138996
9985,0.001512,172.217.194.0-255,1484,71740,65,138996
9986,0.00153,172.217.194.0-255,2902,74642,65,138996
9987,0.001533,172.31.40.0-255,66,74708,65,138996
9988,0.001585,172.217.194.0-255,2902,77610,65,138996
9989,0.00159,172.31.40.0-255,66,77676,65,138996
9990,0.001617,172.217.194.0-255,2902,80578,65,138996
9991,0.00162,172.31.40.0-255,66,80644,65,138996
9992,0.00165,172.217.194.0-255,4320,84964,65,138996
9993,0.001653,172.31.40.0-255,66,85030,65,138996
9994,0.001691,172.31.40.0-255,66,85096,65,138996
9995,0.001771,172.217.194.0-255,5738,90834,65,138996
9996,0.001775,172.31.40.0-255,66,90900,65,138996
9997,0.001808,172.217.194.0-255,5020,95920,65,138996
9998,0.001811,172.31.40.0-255,66,95986,65,138996
9999,0.001913,172.31.40.0-255,66,96052,65,138996
10000,0.00196,172.31.40.0-255,66,96118,65,138996
10001,0.002275,172.31.40.0-255,66,96184,65,138996
10002,0.002366,172.217.194.0-255,4320,100504,65,138996
10003,0.002368,172.31.40.0-255,66,100570,65,138996
10004,0.003012,172.217.194.0-255,5020,105590,65,138996
10005,0.003069,172.217.194.0-255,4320,109910,65,138996
10006,0.008322,172.31.40.0-255,66,109976,65,138996
10007,0.010595,172.217.194.0-255,5738,115714,65,138996
10008,0.010613,172.31.40.0-255,66,115780,65,138996
10009,0.012857,172.217.194.0-255,5738,121518,65,138996
10010,0.012873,172.31.40.0-255,66,121584,65,138996
10011,0.015121,172.217.194.0-255,5738,127322,65,138996
10012,0.015132,172.31.40.0-255,66,127388,65,138996
10013,0.017361,172.217.194.0-255,5738,133126,65,138996
10014,0.01737,172.31.40.0-255,66,133192,65,138996
10015,0.019628,172.217.194.0-255,5738,138930,65,138996
10016,0.01964,172.31.40.0-255,66,138996,65,138996
10017,0.0,172.31.40.0-255,105,105,65,158748
10018,0.000254,172.31.40.0-255,90,195,65,158748
10019,0.000264,172.31.40.0-255,66,261,65,158748
10020,0.001589,216.58.221.0-255,147,408,65,158748
10021,0.001601,172.31.40.0-255,66,474,65,158748
10022,0.001643,216.58.221.0-255,1484,1958,65,158748
10023,0.001646,172.31.40.0-255,66,2024,65,158748
10024,0.00165,216.58.221.0-255,1484,3508,65,158748
10025,0.001653,172.31.40.0-255,66,3574,65,158748
10026,0.001665,216.58.221.0-255,1484,5058,65,158748
10027,0.001669,172.31.40.0-255,66,5124,65,158748
10028,0.001676,216.58.221.0-255,4320,9444,65,158748
10029,0.001678,172.31.40.0-255,66,9510,65,158748
10030,0.001707,216.58.221.0-255,4993,14503,65,158748
10031,0.00171,172.31.40.0-255,66,14569,65,158748
10032,0.001776,216.58.221.0-255,1484,16053,65,158748
10033,0.001779,172.31.40.0-255,66,16119,65,158748
10034,0.001812,216.58.221.0-255,1484,17603,65,158748
10035,0.001814,172.31.40.0-255,66,17669,65,158748
10036,0.001818,216.58.221.0-255,1484,19153,65,158748
10037,0.00182,172.31.40.0-255,66,19219,65,158748
10038,0.001832,216.58.221.0-255,1484,20703,65,158748
10039,0.001834,172.31.40.0-255,66,20769,65,158748
10040,0.001837,216.58.221.0-255,1484,22253,65,158748
10041,0.001839,172.31.40.0-255,66,22319,65,158748
10042,0.001871,216.58.221.0-255,4320,26639,65,158748
10043,0.001873,172.31.40.0-255,66,26705,65,158748
10044,0.001879,216.58.221.0-255,5379,32084,65,158748
10045,0.001882,172.31.40.0-255,66,32150,65,158748
10046,0.001913,216.58.221.0-255,1484,33634,65,158748
10047,0.001915,172.31.40.0-255,66,33700,65,158748
10048,0.00193,216.58.221.0-255,2902,36602,65,158748
10049,0.001933,172.31.40.0-255,66,36668,65,158748
10050,0.001937,216.58.221.0-255,2902,39570,65,158748
10051,0.001939,172.31.40.0-255,66,39636,65,158748
10052,0.001966,216.58.221.0-255,2902,42538,65,158748
10053,0.001969,172.31.40.0-255,66,42604,65,158748
10054,0.001976,216.58.221.0-255,6797,49401,65,158748
10055,0.001978,172.31.40.0-255,66,49467,65,158748
10056,0.002137,216.58.221.0-255,1484,50951,65,158748
10057,0.002141,172.31.40.0-255,66,51017,65,158748
10058,0.002145,216.58.221.0-255,2902,53919,65,158748
10059,0.002171,216.58.221.0-255,1484,55403,65,158748
10060,0.002176,216.58.221.0-255,2902,58305,65,158748
10061,0.002181,216.58.221.0-255,4320,62625,65,158748
10062,0.002189,172.31.40.0-255,66,62691,65,158748
10063,0.002197,216.58.221.0-255,1484,64175,65,158748
10064,0.002209,216.58.221.0-255,2833,67008,65,158748
10065,0.002249,172.31.40.0-255,66,67074,65,158748
10066,0.002815,74.125.68.0-255,66,67140,65,158748
10067,0.00283,74.125.68.0-255,66,67206,65,158748
10068,0.002843,172.31.40.0-255,66,67272,65,158748
10069,0.002847,216.58.221.0-255,135,67407,65,158748
10070,0.002853,216.58.221.0-255,1484,68891,65,158748
10071,0.002861,172.31.40.0-255,66,68957,65,158748
10072,0.002867,216.58.221.0-255,2902,71859,65,158748
10073,0.00287,172.31.40.0-255,66,71925,65,158748
10074,0.002875,216.58.221.0-255,4320,76245,65,158748
10075,0.002951,216.58.221.0-255,5738,81983,65,158748
10076,0.003177,216.58.221.0-255,1484,83467,65,158748
10077,0.003181,216.58.221.0-255,1484,84951,65,158748
10078,0.0032,216.58.221.0-255,1484,86435,65,158748
10079,0.003207,216.58.221.0-255,5738,92173,65,158748
10080,0.00321,216.58.221.0-255,1484,93657,65,158748
10081,0.003265,216.58.221.0-255,766,94423,65,158748
10082,0.0033,216.58.221.0-255,1484,95907,65,158748
10083,0.003338,216.58.221.0-255,2902,98809,65,158748
10084,0.003396,216.58.221.0-255,1484,100293,65,158748
10085,0.0034,216.58.221.0-255,1484,101777,65,158748
10086,0.003404,216.58.221.0-255,2902,104679,65,158748
10087,0.003407,216.58.221.0-255,1484,106163,65,158748
10088,0.003425,216.58.221.0-255,4320,110483,65,158748
10089,0.003428,216.58.221.0-255,1484,111967,65,158748
10090,0.003534,216.58.221.0-255,4603,116570,65,158748
10091,0.003538,216.58.221.0-255,1484,118054,65,158748
10092,0.004519,172.31.40.0-255,66,118120,65,158748
10093,0.006468,216.58.221.0-255,5738,123858,65,158748
10094,0.006475,172.31.40.0-255,66,123924,65,158748
10095,0.008426,216.58.221.0-255,5738,129662,65,158748
10096,0.008516,172.31.40.0-255,66,129728,65,158748
10097,0.010473,216.58.221.0-255,5738,135466,65,158748
10098,0.010478,172.31.40.0-255,66,135532,65,158748
10099,0.012445,216.58.221.0-255,5738,141270,65,158748
10100,0.012453,172.31.40.0-255,66,141336,65,158748
10101,0.014394,216.58.221.0-255,5738,147074,65,158748
10102,0.014403,172.31.40.0-255,66,147140,65,158748
10103,0.016353,216.58.221.0-255,5738,152878,65,158748
10104,0.016361,172.31.40.0-255,66,152944,65,158748
10105,0.018296,216.58.221.0-255,5738,158682,65,158748
10106,0.018303,172.31.40.0-255,66,158748,65,158748
10107,0.0,172.217.27.0-255,153,153,65,117669
10108,1.5e-05,172.31.40.0-255,66,219,65,117669
10109,2.1e-05,172.217.27.0-255,1484,1703,65,117669
10110,2.5e-05,172.31.40.0-255,66,1769,65,117669
10111,3.1e-05,172.217.27.0-255,2902,4671,65,117669
10112,3.4e-05,172.31.40.0-255,66,4737,65,117669
10113,4.9e-05,172.217.27.0-255,5738,10475,65,117669
10114,5.3e-05,172.31.40.0-255,66,10541,65,117669
10115,8.9e-05,172.217.27.0-255,4838,15379,65,117669
10116,9.3e-05,172.31.40.0-255,66,15445,65,117669
10117,9.9e-05,172.217.27.0-255,5738,21183,65,117669
10118,0.000102,172.31.40.0-255,66,21249,65,117669
10119,0.000145,172.31.40.0-255,66,21315,65,117669
10120,0.000216,172.217.27.0-255,1484,22799,65,117669
10121,0.000219,172.31.40.0-255,66,22865,65,117669
10122,0.000225,172.217.27.0-255,2902,25767,65,117669
10123,0.000227,172.31.40.0-255,66,25833,65,117669
10124,0.000256,172.217.27.0-255,5738,31571,65,117669
10125,0.000258,172.31.40.0-255,66,31637,65,117669
10126,0.000275,172.217.27.0-255,1484,33121,65,117669
10127,0.000277,172.31.40.0-255,66,33187,65,117669
10128,0.000314,172.217.27.0-255,5379,38566,65,117669
10129,0.000317,172.31.40.0-255,66,38632,65,117669
10130,0.000377,172.217.27.0-255,1484,40116,65,117669
10131,0.00038,172.31.40.0-255,66,40182,65,117669
10132,0.000385,172.217.27.0-255,2902,43084,65,117669
10133,0.000387,172.31.40.0-255,66,43150,65,117669
10134,0.000416,172.217.27.0-255,1484,44634,65,117669
10135,0.000418,172.31.40.0-255,66,44700,65,117669
10136,0.000451,172.217.27.0-255,4320,49020,65,117669
10137,0.000454,172.31.40.0-255,66,49086,65,117669
10138,0.000462,172.217.27.0-255,6797,55883,65,117669
10139,0.000464,172.31.40.0-255,66,55949,65,117669
10140,0.001533,172.217.27.0-255,646,56595,65,117669
10141,0.002107,172.217.27.0-255,4320,60915,65,117669
10142,0.002113,172.31.40.0-255,66,60981,65,117669
10143,0.003748,172.217.27.0-255,4320,65301,65,117669
10144,0.003751,172.31.40.0-255,66,65367,65,117669
10145,0.003778,172.217.27.0-255,1484,66851,65,117669
10146,0.005398,172.217.27.0-255,4320,71171,65,117669
10147,0.005404,172.31.40.0-255,66,71237,65,117669
10148,0.007057,172.217.27.0-255,5738,76975,65,117669
10149,0.007063,172.31.40.0-255,66,77041,65,117669
10150,0.008697,172.217.27.0-255,5738,82779,65,117669
10151,0.008704,172.31.40.0-255,66,82845,65,117669
10152,0.010345,172.217.27.0-255,5738,88583,65,117669
10153,0.010353,172.31.40.0-255,66,88649,65,117669
10154,0.011995,172.217.27.0-255,5738,94387,65,117669
10155,0.012003,172.31.40.0-255,66,94453,65,117669
10156,0.013641,172.217.27.0-255,5738,100191,65,117669
10157,0.013649,172.31.40.0-255,66,100257,65,117669
10158,0.015289,172.217.27.0-255,5738,105995,65,117669
10159,0.015298,172.31.40.0-255,66,106061,65,117669
10160,0.016947,172.217.27.0-255,5738,111799,65,117669
10161,0.016956,172.31.40.0-255,66,111865,65,117669
10162,0.018602,172.217.27.0-255,5738,117603,65,117669
10163,0.018609,172.31.40.0-255,66,117669,65,117669
10164,0.0,172.217.27.0-255,147,147,65,152405
10165,2.6e-05,172.31.40.0-255,66,213,65,152405
10166,3.4e-05,172.217.27.0-255,1484,1697,65,152405
10167,3.8e-05,172.31.40.0-255,66,1763,65,152405
10168,4.4e-05,172.217.27.0-255,2902,4665,65,152405
10169,4.7e-05,172.31.40.0-255,66,4731,65,152405
10170,5.6e-05,172.217.27.0-255,7156,11887,65,152405
10171,5.9e-05,172.31.40.0-255,66,11953,65,152405
10172,6.3e-05,172.217.27.0-255,2163,14116,65,152405
10173,6.5e-05,172.31.40.0-255,66,14182,65,152405
10174,0.000103,172.217.27.0-255,1484,15666,65,152405
10175,0.000106,172.31.40.0-255,66,15732,65,152405
10176,0.00011,172.217.27.0-255,2902,18634,65,152405
10177,0.000113,172.31.40.0-255,66,18700,65,152405
10178,0.000119,172.217.27.0-255,5738,24438,65,152405
10179,0.000122,172.31.40.0-255,66,24504,65,152405
10180,0.000152,172.217.27.0-255,6797,31301,65,152405
10181,0.000155,172.31.40.0-255,66,31367,65,152405
10182,0.000419,172.217.27.0-255,1484,32851,65,152405
10183,0.000424,172.31.40.0-255,66,32917,65,152405
10184,0.00043,172.217.27.0-255,2902,35819,65,152405
10185,0.000432,172.31.40.0-255,66,35885,65,152405
10186,0.000439,172.217.27.0-255,5738,41623,65,152405
10187,0.000442,172.31.40.0-255,66,41689,65,152405
10188,0.000463,172.217.27.0-255,6797,48486,65,152405
10189,0.000466,172.31.40.0-255,66,48552,65,152405
10190,0.000483,172.217.27.0-255,7156,55708,65,152405
10191,0.000486,172.31.40.0-255,66,55774,65,152405
10192,0.000514,172.217.27.0-255,7156,62930,65,152405
10193,0.000518,172.31.40.0-255,66,62996,65,152405
10194,0.000521,172.217.27.0-255,2816,65812,65,152405
10195,0.000524,172.31.40.0-255,66,65878,65,152405
10196,0.001318,172.217.27.0-255,383,66261,65,152405
10197,0.001327,172.217.27.0-255,1484,67745,65,152405
10198,0.001332,172.31.40.0-255,66,67811,65,152405
10199,0.001339,172.217.27.0-255,4320,72131,65,152405
10200,0.001356,172.217.27.0-255,4320,76451,65,152405
10201,0.001362,172.217.27.0-255,5738,82189,65,152405
10202,0.001382,172.217.27.0-255,4320,86509,65,152405
10203,0.0014,172.217.27.0-255,7156,93665,65,152405
10204,0.001407,172.217.27.0-255,6438,100103,65,152405
10205,0.004749,172.31.40.0-255,66,100169,65,152405
10206,0.006381,172.217.27.0-255,5738,105907,65,152405
10207,0.006389,172.31.40.0-255,66,105973,65,152405
10208,0.008018,172.217.27.0-255,5738,111711,65,152405
10209,0.008025,172.31.40.0-255,66,111777,65,152405
10210,0.009657,172.217.27.0-255,5738,117515,65,152405
10211,0.009665,172.31.40.0-255,66,117581,65,152405
10212,0.011297,172.217.27.0-255,5738,123319,65,152405
10213,0.011305,172.31.40.0-255,66,123385,65,152405
10214,0.012936,172.217.27.0-255,5738,129123,65,152405
10215,0.012944,172.31.40.0-255,66,129189,65,152405
10216,0.014578,172.217.27.0-255,5738,134927,65,152405
10217,0.014585,172.31.40.0-255,66,134993,65,152405
10218,0.016216,172.217.27.0-255,5738,140731,65,152405
10219,0.016223,172.31.40.0-255,66,140797,65,152405
10220,0.017851,172.217.27.0-255,5738,146535,65,152405
10221,0.017859,172.31.40.0-255,66,146601,65,152405
10222,0.019498,172.217.27.0-255,5738,152339,65,152405
10223,0.019505,172.31.40.0-255,66,152405,65,152405
10224,0.0,172.217.194.0-255,150,150,65,132245
10225,1.8e-05,172.31.40.0-255,66,216,65,132245
10226,2.5e-05,172.217.194.0-255,1484,1700,65,132245
10227,3e-05,172.31.40.0-255,66,1766,65,132245
10228,3.6e-05,172.217.194.0-255,2902,4668,65,132245
10229,4.8e-05,172.31.40.0-255,66,4734,65,132245
10230,5.7e-05,172.217.194.0-255,7156,11890,65,132245
10231,5.9e-05,172.31.40.0-255,66,11956,65,132245
10232,7.7e-05,172.217.194.0-255,2902,14858,65,132245
10233,7.9e-05,172.31.40.0-255,66,14924,65,132245
10234,0.000135,172.31.40.0-255,66,14990,65,132245
10235,0.000139,172.217.194.0-255,2543,17533,65,132245
10236,0.000141,172.31.40.0-255,66,17599,65,132245
10237,0.00016,172.217.194.0-255,1484,19083,65,132245
10238,0.000167,172.31.40.0-255,66,19149,65,132245
10239,0.000171,172.217.194.0-255,2902,22051,65,132245
10240,0.000174,172.31.40.0-255,66,22117,65,132245
10241,0.000177,172.217.194.0-255,1484,23601,65,132245
10242,0.000179,172.31.40.0-255,66,23667,65,132245
10243,0.000208,172.217.194.0-255,4320,27987,65,132245
10244,0.000211,172.31.40.0-255,66,28053,65,132245
10245,0.000218,172.217.194.0-255,7156,35209,65,132245
10246,0.00022,172.31.40.0-255,66,35275,65,132245
10247,0.000261,172.217.194.0-255,6797,42072,65,132245
10248,0.000263,172.31.40.0-255,66,42138,65,132245
10249,0.000284,172.217.194.0-255,4320,46458,65,132245
10250,0.000287,172.31.40.0-255,66,46524,65,132245
10251,0.000312,172.217.194.0-255,5631,52155,65,132245
10252,0.000314,172.31.40.0-255,66,52221,65,132245
10253,0.000317,172.217.194.0-255,120,52341,65,132245
10254,0.00032,172.31.40.0-255,66,52407,65,132245
10255,0.000608,172.217.194.0-255,380,52787,65,132245
10256,0.000979,172.217.194.0-255,1484,54271,65,132245
10257,0.000983,172.31.40.0-255,66,54337,65,132245
10258,0.000989,172.217.194.0-255,2902,57239,65,132245
10259,0.000991,172.31.40.0-255,66,57305,65,132245
10260,0.001003,172.217.194.0-255,5738,63043,65,132245
10261,0.001005,172.31.40.0-255,66,63109,65,132245
10262,0.001019,172.31.40.0-255,66,63175,65,132245
10263,0.001053,172.31.40.0-255,66,63241,65,132245
10264,0.001077,172.217.194.0-255,2184,65425,65,132245
10265,0.001079,172.31.40.0-255,66,65491,65,132245
10266,0.00149,172.217.194.0-255,1484,66975,65,132245
10267,0.001496,172.217.194.0-255,2902,69877,65,132245
10268,0.001499,172.31.40.0-255,66,69943,65,132245
10269,0.001531,172.217.194.0-255,5738,75681,65,132245
10270,0.001533,172.31.40.0-255,66,75747,65,132245
10271,0.001537,172.217.194.0-255,1484,77231,65,132245
10272,0.001566,172.31.40.0-255,66,77297,65,132245
10273,0.001606,172.31.40.0-255,66,77363,65,132245
10274,0.001642,172.217.194.0-255,1484,78847,65,132245
10275,0.001659,172.217.194.0-255,2902,81749,65,132245
10276,0.001662,172.31.40.0-255,66,81815,65,132245
10277,0.001666,172.217.194.0-255,2902,84717,65,132245
10278,0.001668,172.31.40.0-255,66,84783,65,132245
10279,0.001694,172.217.194.0-255,2902,87685,65,132245
10280,0.001696,172.31.40.0-255,66,87751,65,132245
10281,0.001707,172.31.40.0-255,66,87817,65,132245
10282,0.001756,172.31.40.0-255,66,87883,65,132245
10283,0.001783,172.217.194.0-255,5020,92903,65,132245
10284,0.001785,172.31.40.0-255,66,92969,65,132245
10285,0.004358,172.217.194.0-255,5738,98707,65,132245
10286,0.004366,172.31.40.0-255,66,98773,65,132245
10287,0.006952,172.217.194.0-255,4320,103093,65,132245
10288,0.006958,172.31.40.0-255,66,103159,65,132245
10289,0.006991,172.217.194.0-255,1484,104643,65,132245
10290,0.00957,172.217.194.0-255,4320,108963,65,132245
10291,0.009577,172.31.40.0-255,66,109029,65,132245
10292,0.012183,172.217.194.0-255,5738,114767,65,132245
10293,0.012192,172.31.40.0-255,66,114833,65,132245
10294,0.014755,172.217.194.0-255,5738,120571,65,132245
10295,0.014763,172.31.40.0-255,66,120637,65,132245
10296,0.017359,172.217.194.0-255,5738,126375,65,132245
10297,0.017368,172.31.40.0-255,66,126441,65,132245
10298,0.019977,172.217.194.0-255,5738,132179,65,132245
10299,0.019986,172.31.40.0-255,66,132245,65,132245
10300,0.0,74.125.130.0-255,152,152,65,82574
10301,2.5e-05,172.31.40.0-255,66,218,65,82574
10302,3.3e-05,74.125.130.0-255,1484,1702,65,82574
10303,3.7e-05,172.31.40.0-255,66,1768,65,82574
10304,4.2e-05,74.125.130.0-255,2902,4670,65,82574
10305,4.6e-05,172.31.40.0-255,66,4736,65,82574
10306,8.2e-05,74.125.130.0-255,2902,7638,65,82574
10307,8.5e-05,172.31.40.0-255,66,7704,65,82574
10308,0.000103,74.125.130.0-255,1484,9188,65,82574
10309,0.000105,172.31.40.0-255,66,9254,65,82574
10310,0.000164,74.125.130.0-255,4987,14241,65,82574
10311,0.000167,172.31.40.0-255,66,14307,65,82574
10312,0.00026,74.125.130.0-255,5738,20045,65,82574
10313,0.000265,172.31.40.0-255,66,20111,65,82574
10314,0.000378,172.31.40.0-255,66,20177,65,82574
10315,0.000389,74.125.130.0-255,2543,22720,65,82574
10316,0.000392,172.31.40.0-255,66,22786,65,82574
10317,0.000569,74.125.130.0-255,5738,28524,65,82574
10318,0.000575,172.31.40.0-255,66,28590,65,82574
10319,0.000595,74.125.130.0-255,4320,32910,65,82574
10320,0.000597,172.31.40.0-255,66,32976,65,82574
10321,0.000756,74.125.130.0-255,2902,35878,65,82574
10322,0.000761,172.31.40.0-255,66,35944,65,82574
10323,0.000784,172.31.40.0-255,66,36010,65,82574
10324,0.000964,74.125.130.0-255,4320,40330,65,82574
10325,0.000968,172.31.40.0-255,66,40396,65,82574
10326,0.000992,172.31.40.0-255,66,40462,65,82574
10327,0.001217,74.125.130.0-255,7156,47618,65,82574
10328,0.001222,172.31.40.0-255,66,47684,65,82574
10329,0.006307,172.31.40.0-255,66,47750,65,82574
10330,0.008373,74.125.130.0-255,5738,53488,65,82574
10331,0.00838,172.31.40.0-255,66,53554,65,82574
10332,0.010428,74.125.130.0-255,5738,59292,65,82574
10333,0.010436,172.31.40.0-255,66,59358,65,82574
10334,0.01249,74.125.130.0-255,5738,65096,65,82574
10335,0.012847,172.31.40.0-255,66,65162,65,82574
10336,0.014895,74.125.130.0-255,5738,70900,65,82574
10337,0.014903,172.31.40.0-255,66,70966,65,82574
10338,0.016955,74.125.130.0-255,5738,76704,65,82574
10339,0.016964,172.31.40.0-255,66,76770,65,82574
10340,0.019038,74.125.130.0-255,5738,82508,65,82574
10341,0.019044,172.31.40.0-255,66,82574,65,82574
10342,0.0,172.217.194.0-255,159,159,65,236866
10343,2.4e-05,172.31.40.0-255,66,225,65,236866
10344,3.1e-05,172.217.194.0-255,1484,1709,65,236866
10345,3.6e-05,172.31.40.0-255,66,1775,65,236866
10346,4.2e-05,172.217.194.0-255,2902,4677,65,236866
10347,4.5e-05,172.31.40.0-255,66,4743,65,236866
10348,5.3e-05,172.217.194.0-255,7156,11899,65,236866
10349,5.6e-05,172.31.40.0-255,66,11965,65,236866
10350,8.4e-05,172.217.194.0-255,2031,13996,65,236866
10351,8.7e-05,172.31.40.0-255,66,14062,65,236866
10352,9.2e-05,172.217.194.0-255,2902,16964,65,236866
10353,9.5e-05,172.31.40.0-255,66,17030,65,236866
10354,0.000102,172.217.194.0-255,7156,24186,65,236866
10355,0.000105,172.31.40.0-255,66,24252,65,236866
10356,0.000137,172.217.194.0-255,6797,31049,65,236866
10357,0.000139,172.31.40.0-255,66,31115,65,236866
10358,0.000175,172.217.194.0-255,2902,34017,65,236866
10359,0.000177,172.31.40.0-255,66,34083,65,236866
10360,0.000199,172.217.194.0-255,4320,38403,65,236866
10361,0.000202,172.31.40.0-255,66,38469,65,236866
10362,0.000208,172.217.194.0-255,5738,44207,65,236866
10363,0.00021,172.31.40.0-255,66,44273,65,236866
10364,0.000226,172.217.194.0-255,2902,47175,65,236866
10365,0.000228,172.31.40.0-255,66,47241,65,236866
10366,0.000231,172.217.194.0-255,1125,48366,65,236866
10367,0.000232,172.31.40.0-255,66,48432,65,236866
10368,0.000236,172.217.194.0-255,1484,49916,65,236866
10369,0.000238,172.31.40.0-255,66,49982,65,236866
10370,0.000244,172.217.194.0-255,4320,54302,65,236866
10371,0.000247,172.31.40.0-255,66,54368,65,236866
10372,0.00025,172.217.194.0-255,1484,55852,65,236866
10373,0.000253,172.31.40.0-255,66,55918,65,236866
10374,0.000288,172.31.40.0-255,66,55984,65,236866
10375,0.000291,172.217.194.0-255,1125,57109,65,236866
10376,0.000395,172.217.194.0-255,380,57489,65,236866
10377,0.000429,172.217.194.0-255,365,57854,65,236866
10378,0.000432,172.31.40.0-255,66,57920,65,236866
10379,0.000736,172.217.194.0-255,1484,59404,65,236866
10380,0.00074,172.217.194.0-255,1484,60888,65,236866
10381,0.000744,172.31.40.0-255,66,60954,65,236866
10382,0.000762,172.217.194.0-255,1484,62438,65,236866
10383,0.000769,172.217.194.0-255,5738,68176,65,236866
10384,0.000772,172.31.40.0-255,66,68242,65,236866
10385,0.000778,172.217.194.0-255,7156,75398,65,236866
10386,0.000781,172.31.40.0-255,66,75464,65,236866
10387,0.000836,172.31.40.0-255,66,75530,65,236866
10388,0.00086,172.217.194.0-255,5738,81268,65,236866
10389,0.000863,172.31.40.0-255,66,81334,65,236866
10390,0.000878,172.31.40.0-255,66,81400,65,236866
10391,0.000893,172.31.40.0-255,66,81466,65,236866
10392,0.000905,172.31.40.0-255,66,81532,65,236866
10393,0.001416,172.217.194.0-255,1484,83016,65,236866
10394,0.001422,172.217.194.0-255,2902,85918,65,236866
10395,0.001425,172.31.40.0-255,66,85984,65,236866
10396,0.001454,172.217.194.0-255,5738,91722,65,236866
10397,0.001457,172.31.40.0-255,66,91788,65,236866
10398,0.001464,172.217.194.0-255,5738,97526,65,236866
10399,0.001466,172.31.40.0-255,66,97592,65,236866
10400,0.001483,172.217.194.0-255,7156,104748,65,236866
10401,0.001485,172.31.40.0-255,66,104814,65,236866
10402,0.001498,172.31.40.0-255,66,104880,65,236866
10403,0.001598,172.217.194.0-255,1484,106364,65,236866
10404,0.001603,172.217.194.0-255,2902,109266,65,236866
10405,0.001607,172.31.40.0-255,66,109332,65,236866
10406,0.001613,172.217.194.0-255,4320,113652,65,236866
10407,0.001614,172.31.40.0-255,66,113718,65,236866
10408,0.001628,172.217.194.0-255,1484,115202,65,236866
10409,0.001639,172.217.194.0-255,1484,116686,65,236866
10410,0.001642,172.31.40.0-255,66,116752,65,236866
10411,0.001679,172.31.40.0-255,66,116818,65,236866
10412,0.001696,172.217.194.0-255,4320,121138,65,236866
10413,0.001698,172.31.40.0-255,66,121204,65,236866
10414,0.001714,172.217.194.0-255,6438,127642,65,236866
10415,0.001716,172.31.40.0-255,66,127708,65,236866
10416,0.001732,172.217.194.0-255,1484,129192,65,236866
10417,0.001736,172.217.194.0-255,2902,132094,65,236866
10418,0.001738,172.31.40.0-255,66,132160,65,236866
10419,0.001762,172.217.194.0-255,5738,137898,65,236866
10420,0.001766,172.31.40.0-255,66,137964,65,236866
10421,0.001776,172.217.194.0-255,2902,140866,65,236866
10422,0.001794,172.31.40.0-255,66,140932,65,236866
10423,0.001833,172.31.40.0-255,66,140998,65,236866
10424,0.001845,172.31.40.0-255,66,141064,65,236866
10425,0.001847,172.217.194.0-255,766,141830,65,236866
10426,0.001953,172.217.194.0-255,1484,143314,65,236866
10427,0.001958,172.31.40.0-255,66,143380,65,236866
10428,0.001961,172.217.194.0-255,1484,144864,65,236866
10429,0.001977,172.217.194.0-255,1484,146348,65,236866
10430,0.001979,172.31.40.0-255,66,146414,65,236866
10431,0.001986,172.217.194.0-255,5738,152152,65,236866
10432,0.001989,172.31.40.0-255,66,152218,65,236866
10433,0.001992,172.217.194.0-255,1484,153702,65,236866
10434,0.002035,172.217.194.0-255,5738,159440,65,236866
10435,0.002039,172.31.40.0-255,66,159506,65,236866
10436,0.002061,172.217.194.0-255,7156,166662,65,236866
10437,0.002064,172.31.40.0-255,66,166728,65,236866
10438,0.002076,172.31.40.0-255,66,166794,65,236866
10439,0.002164,172.217.194.0-255,1484,168278,65,236866
10440,0.00217,172.217.194.0-255,2902,171180,65,236866
10441,0.002174,172.31.40.0-255,66,171246,65,236866
10442,0.002222,172.217.194.0-255,5738,176984,65,236866
10443,0.002225,172.31.40.0-255,66,177050,65,236866
10444,0.002232,172.217.194.0-255,7156,184206,65,236866
10445,0.002234,172.31.40.0-255,66,184272,65,236866
10446,0.002247,172.31.40.0-255,66,184338,65,236866
10447,0.00226,172.217.194.0-255,2902,187240,65,236866
10448,0.002262,172.31.40.0-255,66,187306,65,236866
10449,0.002266,172.217.194.0-255,2184,189490,65,236866
10450,0.002268,172.31.40.0-255,66,189556,65,236866
10451,0.002314,172.217.194.0-255,1484,191040,65,236866
10452,0.00232,172.217.194.0-255,2902,193942,65,236866
10453,0.002323,172.31.40.0-255,66,194008,65,236866
10454,0.002347,172.217.194.0-255,5738,199746,65,236866
10455,0.00235,172.31.40.0-255,66,199812,65,236866
10456,0.002356,172.217.194.0-255,4320,204132,65,236866
10457,0.002358,172.31.40.0-255,66,204198,65,236866
10458,0.002371,172.217.194.0-255,1484,205682,65,236866
10459,0.002393,172.31.40.0-255,66,205748,65,236866
10460,0.002398,172.217.194.0-255,2902,208650,65,236866
10461,0.0024,172.31.40.0-255,66,208716,65,236866
10462,0.002417,172.217.194.0-255,5020,213736,65,236866
10463,0.002419,172.31.40.0-255,66,213802,65,236866
10464,0.00243,172.31.40.0-255,66,213868,65,236866
10465,0.002461,172.31.40.0-255,66,213934,65,236866
10466,0.002487,172.217.194.0-255,5738,219672,65,236866
10467,0.00249,172.31.40.0-255,66,219738,65,236866
10468,0.002498,172.217.194.0-255,6438,226176,65,236866
10469,0.0025,172.31.40.0-255,66,226242,65,236866
10470,0.002505,172.217.194.0-255,4320,230562,65,236866
10471,0.002507,172.31.40.0-255,66,230628,65,236866
10472,0.002546,172.31.40.0-255,66,230694,65,236866
10473,0.002553,172.217.194.0-255,5242,235936,65,236866
10474,0.002556,172.31.40.0-255,66,236002,65,236866
10475,0.005053,172.217.194.0-255,168,236170,65,236866
10476,0.012419,172.31.40.0-255,105,236275,65,236866
10477,0.012468,172.31.40.0-255,105,236380,65,236866
10478,0.01271,172.31.40.0-255,90,236470,65,236866
10479,0.012721,172.31.40.0-255,66,236536,65,236866
10480,0.014945,172.217.194.0-255,66,236602,65,236866
10481,0.014964,172.217.194.0-255,66,236668,65,236866
10482,0.015177,172.217.194.0-255,66,236734,65,236866
10483,0.015199,172.217.194.0-255,66,236800,65,236866
10484,0.01521,172.31.40.0-255,66,236866,65,236866
10485,0.0,172.217.194.0-255,148,148,65,270650
10486,2.1e-05,172.31.40.0-255,66,214,65,270650
10487,2.8e-05,172.217.194.0-255,1484,1698,65,270650
10488,3.1e-05,172.31.40.0-255,66,1764,65,270650
10489,3.6e-05,172.217.194.0-255,2902,4666,65,270650
10490,3.9e-05,172.31.40.0-255,66,4732,65,270650
10491,5.1e-05,172.217.194.0-255,7156,11888,65,270650
10492,5.4e-05,172.31.40.0-255,66,11954,65,270650
10493,5.9e-05,172.217.194.0-255,4320,16274,65,270650
10494,6.2e-05,172.31.40.0-255,66,16340,65,270650
10495,8.9e-05,172.217.194.0-255,3387,19727,65,270650
10496,9.2e-05,172.31.40.0-255,66,19793,65,270650
10497,0.000105,172.31.40.0-255,66,19859,65,270650
10498,0.000109,172.217.194.0-255,2543,22402,65,270650
10499,0.000111,172.31.40.0-255,66,22468,65,270650
10500,0.00022,172.217.194.0-255,1484,23952,65,270650
10501,0.000225,172.31.40.0-255,66,24018,65,270650
10502,0.000229,172.217.194.0-255,2902,26920,65,270650
10503,0.000231,172.31.40.0-255,66,26986,65,270650
10504,0.000255,172.217.194.0-255,5738,32724,65,270650
10505,0.000257,172.31.40.0-255,66,32790,65,270650
10506,0.000262,172.217.194.0-255,4320,37110,65,270650
10507,0.000264,172.31.40.0-255,66,37176,65,270650
10508,0.000302,172.217.194.0-255,4320,41496,65,270650
10509,0.000305,172.31.40.0-255,66,41562,65,270650
10510,0.000337,172.31.40.0-255,66,41628,65,270650
10511,0.000343,172.217.194.0-255,5738,47366,65,270650
10512,0.000345,172.31.40.0-255,66,47432,65,270650
10513,0.000363,172.217.194.0-255,1429,48861,65,270650
10514,0.000368,172.31.40.0-255,66,48927,65,270650
10515,0.000397,172.217.194.0-255,383,49310,65,270650
10516,0.000489,172.217.194.0-255,1484,50794,65,270650
10517,0.0005,172.217.194.0-255,1484,52278,65,270650
10518,0.000518,172.217.194.0-255,1484,53762,65,270650
10519,0.000524,172.217.194.0-255,5738,59500,65,270650
10520,0.00053,172.31.40.0-255,66,59566,65,270650
10521,0.000549,172.217.194.0-255,7156,66722,65,270650
10522,0.00057,172.217.194.0-255,1484,68206,65,270650
10523,0.000581,172.31.40.0-255,66,68272,65,270650
10524,0.000619,172.31.40.0-255,66,68338,65,270650
10525,0.000632,172.217.194.0-255,2902,71240,65,270650
10526,0.000652,172.217.194.0-255,3602,74842,65,270650
10527,0.000659,172.31.40.0-255,66,74908,65,270650
10528,0.001065,172.217.194.0-255,1484,76392,65,270650
10529,0.00107,172.217.194.0-255,2902,79294,65,270650
10530,0.001075,172.31.40.0-255,66,79360,65,270650
10531,0.001082,172.217.194.0-255,1484,80844,65,270650
10532,0.001107,172.217.194.0-255,4320,85164,65,270650
10533,0.00111,172.31.40.0-255,66,85230,65,270650
10534,0.001122,172.217.194.0-255,1484,86714,65,270650
10535,0.001135,172.31.40.0-255,66,86780,65,270650
10536,0.001166,172.31.40.0-255,66,86846,65,270650
10537,0.001176,172.217.194.0-255,2902,89748,65,270650
10538,0.001197,172.217.194.0-255,7156,96904,65,270650
10539,0.00123,172.217.194.0-255,7156,104060,65,270650
10540,0.001237,172.31.40.0-255,66,104126,65,270650
10541,0.001245,172.217.194.0-255,4320,108446,65,270650
10542,0.001265,172.217.194.0-255,3602,112048,65,270650
10543,0.001268,172.31.40.0-255,66,112114,65,270650
10544,0.001287,172.31.40.0-255,66,112180,65,270650
10545,0.001725,172.217.194.0-255,1484,113664,65,270650
10546,0.001731,172.217.194.0-255,2902,116566,65,270650
10547,0.001734,172.31.40.0-255,66,116632,65,270650
10548,0.001766,172.217.194.0-255,5738,122370,65,270650
10549,0.001779,172.31.40.0-255,66,122436,65,270650
10550,0.001817,172.217.194.0-255,5738,128174,65,270650
10551,0.001826,172.31.40.0-255,66,128240,65,270650
10552,0.00183,172.217.194.0-255,2902,131142,65,270650
10553,0.001834,172.31.40.0-255,66,131208,65,270650
10554,0.001845,172.217.194.0-255,1484,132692,65,270650
10555,0.001851,172.217.194.0-255,5020,137712,65,270650
10556,0.001883,172.31.40.0-255,66,137778,65,270650
10557,0.001973,172.217.194.0-255,1484,139262,65,270650
10558,0.00198,172.217.194.0-255,2902,142164,65,270650
10559,0.001982,172.31.40.0-255,66,142230,65,270650
10560,0.002016,172.217.194.0-255,5738,147968,65,270650
10561,0.002019,172.217.194.0-255,1484,149452,65,270650
10562,0.002047,172.217.194.0-255,4320,153772,65,270650
10563,0.002069,172.217.194.0-255,5738,159510,65,270650
10564,0.002071,172.217.194.0-255,766,160276,65,270650
10565,0.002084,172.31.40.0-255,66,160342,65,270650
10566,0.002124,172.217.194.0-255,1484,161826,65,270650
10567,0.002141,172.217.194.0-255,4320,166146,65,270650
10568,0.002144,172.217.194.0-255,1484,167630,65,270650
10569,0.002148,172.31.40.0-255,66,167696,65,270650
10570,0.002167,172.217.194.0-255,5738,173434,65,270650
10571,0.00217,172.217.194.0-255,1484,174918,65,270650
10572,0.002226,172.217.194.0-255,1484,176402,65,270650
10573,0.002232,172.217.194.0-255,5020,181422,65,270650
10574,0.002267,172.217.194.0-255,1484,182906,65,270650
10575,0.002272,172.217.194.0-255,2902,185808,65,270650
10576,0.002292,172.217.194.0-255,5738,191546,65,270650
10577,0.002295,172.217.194.0-255,1484,193030,65,270650
10578,0.002307,172.217.194.0-255,2902,195932,65,270650
10579,0.002324,172.217.194.0-255,5738,201670,65,270650
10580,0.002414,172.217.194.0-255,7156,208826,65,270650
10581,0.002501,172.217.194.0-255,1484,210310,65,270650
10582,0.002505,172.217.194.0-255,1484,211794,65,270650
10583,0.002526,172.217.194.0-255,1484,213278,65,270650
10584,0.002533,172.217.194.0-255,5738,219016,65,270650
10585,0.002538,172.217.194.0-255,4320,223336,65,270650
10586,0.00256,172.217.194.0-255,7156,230492,65,270650
10587,0.002577,172.217.194.0-255,1484,231976,65,270650
10588,0.002583,172.217.194.0-255,4320,236296,65,270650
10589,0.002614,172.217.194.0-255,2902,239198,65,270650
10590,0.002642,172.217.194.0-255,6438,245636,65,270650
10591,0.00265,172.217.194.0-255,7156,252792,65,270650
10592,0.00267,172.217.194.0-255,2902,255694,65,270650
10593,0.002675,172.217.194.0-255,2902,258596,65,270650
10594,0.002688,172.217.194.0-255,5738,264334,65,270650
10595,0.002701,172.217.194.0-255,4320,268654,65,270650
10596,0.002724,172.217.194.0-255,1484,270138,65,270650
10597,0.010488,172.31.40.0-255,66,270204,65,270650
10598,0.01314,172.217.194.0-255,275,270479,65,270650
10599,0.01892,172.31.40.0-255,66,270545,65,270650
10600,0.018976,172.31.40.0-255,105,270650,65,270650
10601,0.0,74.125.24.0-255,143,143,65,139512
10602,2.1e-05,172.31.40.0-255,66,209,65,139512
10603,2.8e-05,74.125.24.0-255,1484,1693,65,139512
10604,3.2e-05,172.31.40.0-255,66,1759,65,139512
10605,3.9e-05,74.125.24.0-255,2902,4661,65,139512
10606,4.2e-05,172.31.40.0-255,66,4727,65,139512
10607,4.9e-05,74.125.24.0-255,7156,11883,65,139512
10608,5.2e-05,172.31.40.0-255,66,11949,65,139512
10609,6.4e-05,172.31.40.0-255,66,12015,65,139512
10610,0.000113,172.31.40.0-255,66,12081,65,139512
10611,0.000143,74.125.24.0-255,2902,14983,65,139512
10612,0.000145,172.31.40.0-255,66,15049,65,139512
10613,0.000165,74.125.24.0-255,2902,17951,65,139512
10614,0.000167,172.31.40.0-255,66,18017,65,139512
10615,0.000173,74.125.24.0-255,5738,23755,65,139512
10616,0.000175,172.31.40.0-255,66,23821,65,139512
10617,0.000188,74.125.24.0-255,1484,25305,65,139512
10618,0.00019,172.31.40.0-255,66,25371,65,139512
10619,0.000195,74.125.24.0-255,4320,29691,65,139512
10620,0.000197,172.31.40.0-255,66,29757,65,139512
10621,0.000224,172.31.40.0-255,66,29823,65,139512
10622,0.000231,74.125.24.0-255,6732,36555,65,139512
10623,0.000233,172.31.40.0-255,66,36621,65,139512
10624,0.000497,74.125.24.0-255,133,36754,65,139512
10625,0.000502,172.31.40.0-255,66,36820,65,139512
10626,0.000708,74.125.24.0-255,1484,38304,65,139512
10627,0.000712,172.31.40.0-255,66,38370,65,139512
10628,0.000718,74.125.24.0-255,2902,41272,65,139512
10629,0.00072,172.31.40.0-255,66,41338,65,139512
10630,0.000741,74.125.24.0-255,5738,47076,65,139512
10631,0.000744,172.31.40.0-255,66,47142,65,139512
10632,0.000749,74.125.24.0-255,4320,51462,65,139512
10633,0.000751,172.31.40.0-255,66,51528,65,139512
10634,0.000774,74.125.24.0-255,1484,53012,65,139512
10635,0.000798,172.31.40.0-255,66,53078,65,139512
10636,0.000808,172.31.40.0-255,66,53144,65,139512
10637,0.001202,74.125.24.0-255,1484,54628,65,139512
10638,0.001223,74.125.24.0-255,2902,57530,65,139512
10639,0.001227,172.31.40.0-255,66,57596,65,139512
10640,0.001231,74.125.24.0-255,1484,59080,65,139512
10641,0.001247,74.125.24.0-255,4320,63400,65,139512
10642,0.00125,172.31.40.0-255,66,63466,65,139512
10643,0.001256,74.125.24.0-255,5738,69204,65,139512
10644,0.001258,172.31.40.0-255,66,69270,65,139512
10645,0.00128,74.125.24.0-255,1484,70754,65,139512
10646,0.001283,74.125.24.0-255,1484,72238,65,139512
10647,0.001286,172.31.40.0-255,66,72304,65,139512
10648,0.001314,172.31.40.0-255,66,72370,65,139512
10649,0.001321,74.125.24.0-255,5020,77390,65,139512
10650,0.001323,172.31.40.0-255,66,77456,65,139512
10651,0.001347,172.31.40.0-255,66,77522,65,139512
10652,0.001369,172.31.40.0-255,66,77588,65,139512
10653,0.00138,172.31.40.0-255,66,77654,65,139512
10654,0.001422,74.125.24.0-255,1484,79138,65,139512
10655,0.001427,74.125.24.0-255,2902,82040,65,139512
10656,0.00143,172.31.40.0-255,66,82106,65,139512
10657,0.001433,74.125.24.0-255,1484,83590,65,139512
10658,0.001455,74.125.24.0-255,4320,87910,65,139512
10659,0.001461,74.125.24.0-255,7156,95066,65,139512
10660,0.001465,172.31.40.0-255,66,95132,65,139512
10661,0.001472,172.31.40.0-255,66,95198,65,139512
10662,0.001479,74.125.24.0-255,5738,100936,65,139512
10663,0.001482,172.31.40.0-255,66,101002,65,139512
10664,0.001508,172.31.40.0-255,66,101068,65,139512
10665,0.001512,74.125.24.0-255,2184,103252,65,139512
10666,0.001514,172.31.40.0-255,66,103318,65,139512
10667,0.001531,74.125.24.0-255,2902,106220,65,139512
10668,0.001534,172.31.40.0-255,66,106286,65,139512
10669,0.001548,74.125.24.0-255,1484,107770,65,139512
10670,0.001569,74.125.24.0-255,5738,113508,65,139512
10671,0.001575,74.125.24.0-255,7156,120664,65,139512
10672,0.00158,172.31.40.0-255,66,120730,65,139512
10673,0.001583,172.31.40.0-255,66,120796,65,139512
10674,0.001618,172.31.40.0-255,66,120862,65,139512
10675,0.001633,172.31.40.0-255,66,120928,65,139512
10676,0.001667,74.125.24.0-255,766,121694,65,139512
10677,0.001689,172.31.40.0-255,66,121760,65,139512
10678,0.001702,172.31.40.0-255,66,121826,65,139512
10679,0.001714,172.31.40.0-255,66,121892,65,139512
10680,0.001753,74.125.24.0-255,7156,129048,65,139512
10681,0.001756,172.31.40.0-255,66,129114,65,139512
10682,0.001792,172.31.40.0-255,66,129180,65,139512
10683,0.00181,172.31.40.0-255,66,129246,65,139512
10684,0.001824,172.31.40.0-255,66,129312,65,139512
10685,0.001835,172.31.40.0-255,66,129378,65,139512
10686,0.001883,172.31.40.0-255,66,129444,65,139512
10687,0.001904,172.31.40.0-255,66,129510,65,139512
10688,0.00193,74.125.24.0-255,4320,133830,65,139512
10689,0.001932,172.31.40.0-255,66,133896,65,139512
10690,0.001939,74.125.24.0-255,4620,138516,65,139512
10691,0.001941,172.31.40.0-255,66,138582,65,139512
10692,0.001944,74.125.24.0-255,105,138687,65,139512
10693,0.001961,74.125.24.0-255,129,138816,65,139512
10694,0.004194,172.31.40.0-255,105,138921,65,139512
10695,0.004237,172.31.40.0-255,105,139026,65,139512
10696,0.004505,172.31.40.0-255,90,139116,65,139512
10697,0.004514,172.31.40.0-255,66,139182,65,139512
10698,0.006445,74.125.24.0-255,66,139248,65,139512
10699,0.006461,74.125.24.0-255,66,139314,65,139512
10700,0.006707,74.125.24.0-255,66,139380,65,139512
10701,0.006751,74.125.24.0-255,66,139446,65,139512
10702,0.006763,172.31.40.0-255,66,139512,65,139512
10703,0.0,74.125.24.0-255,147,147,65,162208
10704,1.6e-05,172.31.40.0-255,66,213,65,162208
10705,2.3e-05,74.125.24.0-255,1484,1697,65,162208
10706,2.8e-05,172.31.40.0-255,66,1763,65,162208
10707,3.4e-05,74.125.24.0-255,2902,4665,65,162208
10708,3.7e-05,172.31.40.0-255,66,4731,65,162208
10709,4.5e-05,74.125.24.0-255,7156,11887,65,162208
10710,4.8e-05,172.31.40.0-255,66,11953,65,162208
10711,5.2e-05,74.125.24.0-255,2037,13990,65,162208
10712,5.5e-05,172.31.40.0-255,66,14056,65,162208
10713,0.000105,74.125.24.0-255,1484,15540,65,162208
10714,0.000108,172.31.40.0-255,66,15606,65,162208
10715,0.000113,74.125.24.0-255,2902,18508,65,162208
10716,0.000115,172.31.40.0-255,66,18574,65,162208
10717,0.000143,74.125.24.0-255,5738,24312,65,162208
10718,0.000146,172.31.40.0-255,66,24378,65,162208
10719,0.000168,74.125.24.0-255,5738,30116,65,162208
10720,0.00017,172.31.40.0-255,66,30182,65,162208
10721,0.000181,74.125.24.0-255,1125,31307,65,162208
10722,0.000183,172.31.40.0-255,66,31373,65,162208
10723,0.000191,74.125.24.0-255,7156,38529,65,162208
10724,0.000194,172.31.40.0-255,66,38595,65,162208
10725,0.000228,172.31.40.0-255,66,38661,65,162208
10726,0.000264,172.31.40.0-255,66,38727,65,162208
10727,0.000281,74.125.24.0-255,1484,40211,65,162208
10728,0.000283,172.31.40.0-255,66,40277,65,162208
10729,0.00031,74.125.24.0-255,4320,44597,65,162208
10730,0.000313,172.31.40.0-255,66,44663,65,162208
10731,0.000332,74.125.24.0-255,2543,47206,65,162208
10732,0.000335,172.31.40.0-255,66,47272,65,162208
10733,0.001529,74.125.24.0-255,645,47917,65,162208
10734,0.001655,74.125.24.0-255,1484,49401,65,162208
10735,0.00166,172.31.40.0-255,66,49467,65,162208
10736,0.001667,74.125.24.0-255,2902,52369,65,162208
10737,0.001669,172.31.40.0-255,66,52435,65,162208
10738,0.001676,74.125.24.0-255,5738,58173,65,162208
10739,0.001678,172.31.40.0-255,66,58239,65,162208
10740,0.001709,74.125.24.0-255,6249,64488,65,162208
10741,0.001712,172.31.40.0-255,66,64554,65,162208
10742,0.001775,74.125.24.0-255,1484,66038,65,162208
10743,0.001779,74.125.24.0-255,2902,68940,65,162208
10744,0.001781,172.31.40.0-255,66,69006,65,162208
10745,0.001803,74.125.24.0-255,5738,74744,65,162208
10746,0.001805,172.31.40.0-255,66,74810,65,162208
10747,0.00186,74.125.24.0-255,6797,81607,65,162208
10748,0.001863,172.31.40.0-255,66,81673,65,162208
10749,0.001961,74.125.24.0-255,1484,83157,65,162208
10750,0.001964,74.125.24.0-255,1484,84641,65,162208
10751,0.001967,172.31.40.0-255,66,84707,65,162208
10752,0.001982,74.125.24.0-255,1484,86191,65,162208
10753,0.001986,74.125.24.0-255,2902,89093,65,162208
10754,0.001988,172.31.40.0-255,66,89159,65,162208
10755,0.002012,74.125.24.0-255,2902,92061,65,162208
10756,0.002014,172.31.40.0-255,66,92127,65,162208
10757,0.002019,74.125.24.0-255,4320,96447,65,162208
10758,0.002021,172.31.40.0-255,66,96513,65,162208
10759,0.002048,74.125.24.0-255,2543,99056,65,162208
10760,0.00205,172.31.40.0-255,66,99122,65,162208
10761,0.002167,74.125.24.0-255,1484,100606,65,162208
10762,0.002173,74.125.24.0-255,2902,103508,65,162208
10763,0.002175,172.31.40.0-255,66,103574,65,162208
10764,0.002179,74.125.24.0-255,1484,105058,65,162208
10765,0.002197,74.125.24.0-255,4320,109378,65,162208
10766,0.0022,172.31.40.0-255,66,109444,65,162208
10767,0.002206,74.125.24.0-255,4320,113764,65,162208
10768,0.002208,172.31.40.0-255,66,113830,65,162208
10769,0.002225,74.125.24.0-255,5738,119568,65,162208
10770,0.002229,172.31.40.0-255,66,119634,65,162208
10771,0.002285,74.125.24.0-255,2902,122536,65,162208
10772,0.002288,172.31.40.0-255,66,122602,65,162208
10773,0.002319,172.31.40.0-255,66,122668,65,162208
10774,0.002336,172.31.40.0-255,66,122734,65,162208
10775,0.002351,172.31.40.0-255,66,122800,65,162208
10776,0.002364,172.31.40.0-255,66,122866,65,162208
10777,0.002379,74.125.24.0-255,1484,124350,65,162208
10778,0.004656,74.125.24.0-255,2902,127252,65,162208
10779,0.004659,172.31.40.0-255,66,127318,65,162208
10780,0.004675,74.125.24.0-255,1484,128802,65,162208
10781,0.006973,74.125.24.0-255,4320,133122,65,162208
10782,0.006978,172.31.40.0-255,66,133188,65,162208
10783,0.009305,74.125.24.0-255,5738,138926,65,162208
10784,0.009315,172.31.40.0-255,66,138992,65,162208
10785,0.011647,74.125.24.0-255,5738,144730,65,162208
10786,0.011653,172.31.40.0-255,66,144796,65,162208
10787,0.013982,74.125.24.0-255,5738,150534,65,162208
10788,0.013991,172.31.40.0-255,66,150600,65,162208
10789,0.016299,74.125.24.0-255,5738,156338,65,162208
10790,0.016307,172.31.40.0-255,66,156404,65,162208
10791,0.018636,74.125.24.0-255,5738,162142,65,162208
10792,0.018647,172.31.40.0-255,66,162208,65,162208
10793,0.0,172.217.194.0-255,156,156,65,115671
10794,1.7e-05,172.31.40.0-255,66,222,65,115671
10795,2.4e-05,172.217.194.0-255,1484,1706,65,115671
10796,2.9e-05,172.31.40.0-255,66,1772,65,115671
10797,3.6e-05,172.217.194.0-255,2902,4674,65,115671
10798,3.9e-05,172.31.40.0-255,66,4740,65,115671
10799,5.2e-05,172.217.194.0-255,5738,10478,65,115671
10800,5.7e-05,172.31.40.0-255,66,10544,65,115671
10801,0.00015,172.31.40.0-255,66,10610,65,115671
10802,0.000157,172.217.194.0-255,6797,17407,65,115671
10803,0.00016,172.31.40.0-255,66,17473,65,115671
10804,0.000163,172.217.194.0-255,1484,18957,65,115671
10805,0.000165,172.31.40.0-255,66,19023,65,115671
10806,0.000175,172.217.194.0-255,2902,21925,65,115671
10807,0.000177,172.31.40.0-255,66,21991,65,115671
10808,0.000183,172.217.194.0-255,5738,27729,65,115671
10809,0.000186,172.31.40.0-255,66,27795,65,115671
10810,0.00024,172.31.40.0-255,66,27861,65,115671
10811,0.000252,172.31.40.0-255,66,27927,65,115671
10812,0.00026,172.217.194.0-255,676,28603,65,115671
10813,0.000262,172.31.40.0-255,66,28669,65,115671
10814,0.000474,172.217.194.0-255,1484,30153,65,115671
10815,0.00048,172.31.40.0-255,66,30219,65,115671
10816,0.000487,172.217.194.0-255,2902,33121,65,115671
10817,0.000489,172.31.40.0-255,66,33187,65,115671
10818,0.000495,172.217.194.0-255,5738,38925,65,115671
10819,0.000498,172.31.40.0-255,66,38991,65,115671
10820,0.000563,172.31.40.0-255,66,39057,65,115671
10821,0.000576,172.31.40.0-255,66,39123,65,115671
10822,0.001387,172.217.194.0-255,1484,40607,65,115671
10823,0.001396,172.217.194.0-255,2902,43509,65,115671
10824,0.0014,172.31.40.0-255,66,43575,65,115671
10825,0.001407,172.217.194.0-255,5738,49313,65,115671
10826,0.001409,172.31.40.0-255,66,49379,65,115671
10827,0.001437,172.31.40.0-255,66,49445,65,115671
10828,0.001452,172.217.194.0-255,4320,53765,65,115671
10829,0.001454,172.31.40.0-255,66,53831,65,115671
10830,0.001484,172.217.194.0-255,7156,60987,65,115671
10831,0.001486,172.31.40.0-255,66,61053,65,115671
10832,0.001532,172.217.194.0-255,3602,64655,65,115671
10833,0.001536,172.31.40.0-255,66,64721,65,115671
10834,0.00341,172.217.194.0-255,1484,66205,65,115671
10835,0.003441,172.217.194.0-255,4320,70525,65,115671
10836,0.003446,172.31.40.0-255,66,70591,65,115671
10837,0.005397,172.217.194.0-255,5738,76329,65,115671
10838,0.005404,172.31.40.0-255,66,76395,65,115671
10839,0.00734,172.217.194.0-255,4320,80715,65,115671
10840,0.007345,172.31.40.0-255,66,80781,65,115671
10841,0.007379,172.217.194.0-255,1484,82265,65,115671
10842,0.009277,172.217.194.0-255,4320,86585,65,115671
10843,0.009284,172.31.40.0-255,66,86651,65,115671
10844,0.011208,172.217.194.0-255,5738,92389,65,115671
10845,0.011218,172.31.40.0-255,66,92455,65,115671
10846,0.013183,172.217.194.0-255,5738,98193,65,115671
10847,0.013191,172.31.40.0-255,66,98259,65,115671
10848,0.015135,172.217.194.0-255,5738,103997,65,115671
10849,0.015143,172.31.40.0-255,66,104063,65,115671
10850,0.017075,172.217.194.0-255,5738,109801,65,115671
10851,0.017083,172.31.40.0-255,66,109867,65,115671
10852,0.019058,172.217.194.0-255,5738,115605,65,115671
10853,0.019068,172.31.40.0-255,66,115671,65,115671
10854,0.0,172.217.24.0-255,153,153,65,127992
10855,2.2e-05,172.31.40.0-255,66,219,65,127992
10856,2.9e-05,172.217.24.0-255,1484,1703,65,127992
10857,3.4e-05,172.31.40.0-255,66,1769,65,127992
10858,3.8e-05,172.217.24.0-255,1484,3253,65,127992
10859,4.1e-05,172.31.40.0-255,66,3319,65,127992
10860,4.7e-05,172.217.24.0-255,2902,6221,65,127992
10861,5e-05,172.31.40.0-255,66,6287,65,127992
10862,5.7e-05,172.217.24.0-255,5738,12025,65,127992
10863,6e-05,172.31.40.0-255,66,12091,65,127992
10864,8.4e-05,172.217.24.0-255,2164,14255,65,127992
10865,8.7e-05,172.31.40.0-255,66,14321,65,127992
10866,0.000104,172.217.24.0-255,2902,17223,65,127992
10867,0.000107,172.31.40.0-255,66,17289,65,127992
10868,0.000113,172.217.24.0-255,5738,23027,65,127992
10869,0.000116,172.31.40.0-255,66,23093,65,127992
10870,0.000134,172.217.24.0-255,1484,24577,65,127992
10871,0.000136,172.31.40.0-255,66,24643,65,127992
10872,0.000157,172.217.24.0-255,6797,31440,65,127992
10873,0.000159,172.31.40.0-255,66,31506,65,127992
10874,0.00031,172.217.24.0-255,1484,32990,65,127992
10875,0.000315,172.31.40.0-255,66,33056,65,127992
10876,0.00032,172.217.24.0-255,2902,35958,65,127992
10877,0.000323,172.31.40.0-255,66,36024,65,127992
10878,0.000339,172.217.24.0-255,5738,41762,65,127992
10879,0.000342,172.31.40.0-255,66,41828,65,127992
10880,0.000373,172.217.24.0-255,6797,48625,65,127992
10881,0.000376,172.31.40.0-255,66,48691,65,127992
10882,0.000409,172.217.24.0-255,4320,53011,65,127992
10883,0.000412,172.31.40.0-255,66,53077,65,127992
10884,0.000415,172.217.24.0-255,1484,54561,65,127992
10885,0.000417,172.31.40.0-255,66,54627,65,127992
10886,0.000435,172.217.24.0-255,4320,58947,65,127992
10887,0.000438,172.31.40.0-255,66,59013,65,127992
10888,0.000461,172.217.24.0-255,6797,65810,65,127992
10889,0.000464,172.31.40.0-255,66,65876,65,127992
10890,0.001803,172.217.24.0-255,646,66522,65,127992
10891,0.001914,172.217.24.0-255,1484,68006,65,127992
10892,0.00192,172.31.40.0-255,66,68072,65,127992
10893,0.001926,172.217.24.0-255,2902,70974,65,127992
10894,0.001929,172.31.40.0-255,66,71040,65,127992
10895,0.001934,172.217.24.0-255,4320,75360,65,127992
10896,0.001936,172.31.40.0-255,66,75426,65,127992
10897,0.001964,172.31.40.0-255,66,75492,65,127992
10898,0.003913,172.217.24.0-255,2902,78394,65,127992
10899,0.003917,172.31.40.0-255,66,78460,65,127992
10900,0.003933,172.217.24.0-255,2902,81362,65,127992
10901,0.003935,172.31.40.0-255,66,81428,65,127992
10902,0.005853,172.217.24.0-255,2902,84330,65,127992
10903,0.005859,172.31.40.0-255,66,84396,65,127992
10904,0.005882,172.217.24.0-255,2902,87298,65,127992
10905,0.005885,172.31.40.0-255,66,87364,65,127992
10906,0.007843,172.217.24.0-255,5738,93102,65,127992
10907,0.00785,172.31.40.0-255,66,93168,65,127992
10908,0.009799,172.217.24.0-255,5738,98906,65,127992
10909,0.009806,172.31.40.0-255,66,98972,65,127992
10910,0.011759,172.217.24.0-255,5738,104710,65,127992
10911,0.011766,172.31.40.0-255,66,104776,65,127992
10912,0.013713,172.217.24.0-255,5738,110514,65,127992
10913,0.013723,172.31.40.0-255,66,110580,65,127992
10914,0.015665,172.217.24.0-255,5738,116318,65,127992
10915,0.015672,172.31.40.0-255,66,116384,65,127992
10916,0.017617,172.217.24.0-255,5738,122122,65,127992
10917,0.017624,172.31.40.0-255,66,122188,65,127992
10918,0.019575,172.217.24.0-255,5738,127926,65,127992
10919,0.019584,172.31.40.0-255,66,127992,65,127992
10920,0.0,172.31.40.0-255,105,105,65,459
10921,0.000288,172.31.40.0-255,90,195,65,459
10922,0.000299,172.31.40.0-255,66,261,65,459
10923,0.002814,74.125.24.0-255,66,327,65,459
10924,0.002844,74.125.24.0-255,66,393,65,459
10925,0.002866,172.31.40.0-255,66,459,65,459
10926,0.0,74.125.130.0-255,150,150,65,256374
10927,1.3e-05,172.31.40.0-255,66,216,65,256374
10928,2e-05,74.125.130.0-255,1484,1700,65,256374
10929,2.5e-05,172.31.40.0-255,66,1766,65,256374
10930,3.1e-05,74.125.130.0-255,2902,4668,65,256374
10931,3.4e-05,172.31.40.0-255,66,4734,65,256374
10932,3.7e-05,74.125.130.0-255,1484,6218,65,256374
10933,3.9e-05,172.31.40.0-255,66,6284,65,256374
10934,6.7e-05,74.125.130.0-255,5738,12022,65,256374
10935,7e-05,172.31.40.0-255,66,12088,65,256374
10936,7.6e-05,74.125.130.0-255,4320,16408,65,256374
10937,7.8e-05,172.31.40.0-255,66,16474,65,256374
10938,9.4e-05,74.125.130.0-255,3486,19960,65,256374
10939,9.6e-05,172.31.40.0-255,66,20026,65,256374
10940,0.000102,74.125.130.0-255,5738,25764,65,256374
10941,0.000105,172.31.40.0-255,66,25830,65,256374
10942,0.000147,74.125.130.0-255,2902,28732,65,256374
10943,0.00015,172.31.40.0-255,66,28798,65,256374
10944,0.000171,74.125.130.0-255,2543,31341,65,256374
10945,0.000175,172.31.40.0-255,66,31407,65,256374
10946,0.000255,74.125.130.0-255,1484,32891,65,256374
10947,0.000259,172.31.40.0-255,66,32957,65,256374
10948,0.000265,74.125.130.0-255,2902,35859,65,256374
10949,0.000267,172.31.40.0-255,66,35925,65,256374
10950,0.000282,74.125.130.0-255,2902,38827,65,256374
10951,0.000284,172.31.40.0-255,66,38893,65,256374
10952,0.000306,74.125.130.0-255,2902,41795,65,256374
10953,0.000309,172.31.40.0-255,66,41861,65,256374
10954,0.000313,74.125.130.0-255,2902,44763,65,256374
10955,0.000315,172.31.40.0-255,66,44829,65,256374
10956,0.00032,74.125.130.0-255,4320,49149,65,256374
10957,0.000322,172.31.40.0-255,66,49215,65,256374
10958,0.000352,74.125.130.0-255,1484,50699,65,256374
10959,0.000357,74.125.130.0-255,2902,53601,65,256374
10960,0.00036,172.31.40.0-255,66,53667,65,256374
10961,0.000383,74.125.130.0-255,5738,59405,65,256374
10962,0.000386,172.31.40.0-255,66,59471,65,256374
10963,0.000402,74.125.130.0-255,4320,63791,65,256374
10964,0.000405,172.31.40.0-255,66,63857,65,256374
10965,0.000425,74.125.130.0-255,2184,66041,65,256374
10966,0.000428,172.31.40.0-255,66,66107,65,256374
10967,0.000604,74.125.130.0-255,338,66445,65,256374
10968,0.00062,74.125.130.0-255,120,66565,65,256374
10969,0.000819,74.125.130.0-255,1484,68049,65,256374
10970,0.000824,172.31.40.0-255,66,68115,65,256374
10971,0.000829,74.125.130.0-255,1484,69599,65,256374
10972,0.000846,74.125.130.0-255,1484,71083,65,256374
10973,0.000848,172.31.40.0-255,66,71149,65,256374
10974,0.000854,74.125.130.0-255,2902,74051,65,256374
10975,0.000856,172.31.40.0-255,66,74117,65,256374
10976,0.000861,74.125.130.0-255,2902,77019,65,256374
10977,0.000863,172.31.40.0-255,66,77085,65,256374
10978,0.000881,74.125.130.0-255,1484,78569,65,256374
10979,0.000896,74.125.130.0-255,1484,80053,65,256374
10980,0.000898,172.31.40.0-255,66,80119,65,256374
10981,0.000922,74.125.130.0-255,4255,84374,65,256374
10982,0.000924,172.31.40.0-255,66,84440,65,256374
10983,0.000931,74.125.130.0-255,5738,90178,65,256374
10984,0.000933,172.31.40.0-255,66,90244,65,256374
10985,0.000951,74.125.130.0-255,1484,91728,65,256374
10986,0.000984,172.31.40.0-255,66,91794,65,256374
10987,0.001117,74.125.130.0-255,1484,93278,65,256374
10988,0.001124,74.125.130.0-255,2902,96180,65,256374
10989,0.001128,172.31.40.0-255,66,96246,65,256374
10990,0.001155,74.125.130.0-255,2902,99148,65,256374
10991,0.001157,172.31.40.0-255,66,99214,65,256374
10992,0.001178,74.125.130.0-255,2902,102116,65,256374
10993,0.001181,172.31.40.0-255,66,102182,65,256374
10994,0.001184,74.125.130.0-255,1484,103666,65,256374
10995,0.001204,74.125.130.0-255,5738,109404,65,256374
10996,0.001207,172.31.40.0-255,66,109470,65,256374
10997,0.00121,74.125.130.0-255,1484,110954,65,256374
10998,0.001214,74.125.130.0-255,2902,113856,65,256374
10999,0.001216,172.31.40.0-255,66,113922,65,256374
11000,0.001267,74.125.130.0-255,5738,119660,65,256374
11001,0.00127,172.31.40.0-255,66,119726,65,256374
11002,0.001277,74.125.130.0-255,6438,126164,65,256374
11003,0.00128,172.31.40.0-255,66,126230,65,256374
11004,0.001676,74.125.130.0-255,1484,127714,65,256374
11005,0.001683,74.125.130.0-255,2902,130616,65,256374
11006,0.001687,172.31.40.0-255,66,130682,65,256374
11007,0.001712,74.125.130.0-255,5738,136420,65,256374
11008,0.001715,172.31.40.0-255,66,136486,65,256374
11009,0.001719,74.125.130.0-255,2902,139388,65,256374
11010,0.001721,172.31.40.0-255,66,139454,65,256374
11011,0.001726,74.125.130.0-255,2902,142356,65,256374
11012,0.001727,172.31.40.0-255,66,142422,65,256374
11013,0.001754,74.125.130.0-255,1484,143906,65,256374
11014,0.001762,74.125.130.0-255,7156,151062,65,256374
11015,0.001764,172.31.40.0-255,66,151128,65,256374
11016,0.001789,74.125.130.0-255,1484,152612,65,256374
11017,0.001796,74.125.130.0-255,5738,158350,65,256374
11018,0.001798,172.31.40.0-255,66,158416,65,256374
11019,0.001819,74.125.130.0-255,2184,160600,65,256374
11020,0.001822,172.31.40.0-255,66,160666,65,256374
11021,0.00186,74.125.130.0-255,1484,162150,65,256374
11022,0.001874,74.125.130.0-255,2902,165052,65,256374
11023,0.001877,172.31.40.0-255,66,165118,65,256374
11024,0.0019,74.125.130.0-255,5738,170856,65,256374
11025,0.001902,172.31.40.0-255,66,170922,65,256374
11026,0.001915,74.125.130.0-255,4320,175242,65,256374
11027,0.001917,172.31.40.0-255,66,175308,65,256374
11028,0.001938,74.125.130.0-255,4320,179628,65,256374
11029,0.001941,172.31.40.0-255,66,179694,65,256374
11030,0.001955,74.125.130.0-255,4320,184014,65,256374
11031,0.001957,172.31.40.0-255,66,184080,65,256374
11032,0.001975,74.125.130.0-255,5738,189818,65,256374
11033,0.001978,172.31.40.0-255,66,189884,65,256374
11034,0.00198,74.125.130.0-255,1484,191368,65,256374
11035,0.002018,74.125.130.0-255,3602,194970,65,256374
11036,0.002021,172.31.40.0-255,66,195036,65,256374
11037,0.002205,74.125.130.0-255,1484,196520,65,256374
11038,0.002213,74.125.130.0-255,2902,199422,65,256374
11039,0.002216,172.31.40.0-255,66,199488,65,256374
11040,0.002228,74.125.130.0-255,1484,200972,65,256374
11041,0.002233,74.125.130.0-255,2902,203874,65,256374
11042,0.002236,172.31.40.0-255,66,203940,65,256374
11043,0.002255,74.125.130.0-255,4320,208260,65,256374
11044,0.002258,172.31.40.0-255,66,208326,65,256374
11045,0.002268,74.125.130.0-255,1484,209810,65,256374
11046,0.002273,74.125.130.0-255,2902,212712,65,256374
11047,0.002274,172.31.40.0-255,66,212778,65,256374
11048,0.002296,74.125.130.0-255,7156,219934,65,256374
11049,0.002299,172.31.40.0-255,66,220000,65,256374
11050,0.002319,74.125.130.0-255,1484,221484,65,256374
11051,0.00235,172.31.40.0-255,66,221550,65,256374
11052,0.004873,74.125.130.0-255,5738,227288,65,256374
11053,0.004882,172.31.40.0-255,66,227354,65,256374
11054,0.007413,74.125.130.0-255,5738,233092,65,256374
11055,0.007418,172.31.40.0-255,66,233158,65,256374
11056,0.009966,74.125.130.0-255,5738,238896,65,256374
11057,0.009985,172.31.40.0-255,66,238962,65,256374
11058,0.012528,74.125.130.0-255,5738,244700,65,256374
11059,0.012545,172.31.40.0-255,66,244766,65,256374
11060,0.015077,74.125.130.0-255,5738,250504,65,256374
11061,0.015086,172.31.40.0-255,66,250570,65,256374
11062,0.01766,74.125.130.0-255,5738,256308,65,256374
11063,0.017675,172.31.40.0-255,66,256374,65,256374
11064,0.0,74.125.130.0-255,145,145,65,245495
11065,2.4e-05,172.31.40.0-255,66,211,65,245495
11066,3.1e-05,74.125.130.0-255,1484,1695,65,245495
11067,3.6e-05,172.31.40.0-255,66,1761,65,245495
11068,5e-05,74.125.130.0-255,2902,4663,65,245495
11069,5.4e-05,172.31.40.0-255,66,4729,65,245495
11070,5.8e-05,74.125.130.0-255,1484,6213,65,245495
11071,6.1e-05,172.31.40.0-255,66,6279,65,245495
11072,6.6e-05,74.125.130.0-255,2902,9181,65,245495
11073,6.9e-05,172.31.40.0-255,66,9247,65,245495
11074,0.000107,74.125.130.0-255,4866,14113,65,245495
11075,0.000111,172.31.40.0-255,66,14179,65,245495
11076,0.00033,74.125.130.0-255,1484,15663,65,245495
11077,0.000335,172.31.40.0-255,66,15729,65,245495
11078,0.000341,74.125.130.0-255,2902,18631,65,245495
11079,0.000343,172.31.40.0-255,66,18697,65,245495
11080,0.000349,74.125.130.0-255,4320,23017,65,245495
11081,0.000357,172.31.40.0-255,66,23083,65,245495
11082,0.000412,172.31.40.0-255,66,23149,65,245495
11083,0.000535,74.125.130.0-255,1484,24633,65,245495
11084,0.00054,172.31.40.0-255,66,24699,65,245495
11085,0.000546,74.125.130.0-255,2902,27601,65,245495
11086,0.000548,172.31.40.0-255,66,27667,65,245495
11087,0.000578,74.125.130.0-255,2902,30569,65,245495
11088,0.000581,172.31.40.0-255,66,30635,65,245495
11089,0.000606,74.125.130.0-255,2902,33537,65,245495
11090,0.00061,172.31.40.0-255,66,33603,65,245495
11091,0.000616,74.125.130.0-255,5738,39341,65,245495
11092,0.000618,172.31.40.0-255,66,39407,65,245495
11093,0.000654,172.31.40.0-255,66,39473,65,245495
11094,0.00066,74.125.130.0-255,3961,43434,65,245495
11095,0.000662,172.31.40.0-255,66,43500,65,245495
11096,0.000665,74.125.130.0-255,379,43879,65,245495
11097,0.000721,74.125.130.0-255,364,44243,65,245495
11098,0.000957,74.125.130.0-255,1484,45727,65,245495
11099,0.000961,172.31.40.0-255,66,45793,65,245495
11100,0.000966,74.125.130.0-255,2902,48695,65,245495
11101,0.000969,172.31.40.0-255,66,48761,65,245495
11102,0.000989,74.125.130.0-255,5738,54499,65,245495
11103,0.000993,74.125.130.0-255,2902,57401,65,245495
11104,0.001025,172.31.40.0-255,66,57467,65,245495
11105,0.001028,172.31.40.0-255,66,57533,65,245495
11106,0.001054,74.125.130.0-255,4320,61853,65,245495
11107,0.001061,172.31.40.0-255,66,61919,65,245495
11108,0.001072,172.31.40.0-255,66,61985,65,245495
11109,0.001079,74.125.130.0-255,7156,69141,65,245495
11110,0.001081,172.31.40.0-255,66,69207,65,245495
11111,0.001084,74.125.130.0-255,766,69973,65,245495
11112,0.001147,74.125.130.0-255,1484,71457,65,245495
11113,0.001151,172.31.40.0-255,66,71523,65,245495
11114,0.001177,74.125.130.0-255,2902,74425,65,245495
11115,0.001181,172.31.40.0-255,66,74491,65,245495
11116,0.001213,74.125.130.0-255,5738,80229,65,245495
11117,0.001216,172.31.40.0-255,66,80295,65,245495
11118,0.001221,74.125.130.0-255,2902,83197,65,245495
11119,0.001223,172.31.40.0-255,66,83263,65,245495
11120,0.001228,74.125.130.0-255,4320,87583,65,245495
11121,0.00123,172.31.40.0-255,66,87649,65,245495
11122,0.001233,74.125.130.0-255,1484,89133,65,245495
11123,0.001269,74.125.130.0-255,7156,96289,65,245495
11124,0.001273,172.31.40.0-255,66,96355,65,245495
11125,0.001278,74.125.130.0-255,4320,100675,65,245495
11126,0.00128,172.31.40.0-255,66,100741,65,245495
11127,0.001303,74.125.130.0-255,3602,104343,65,245495
11128,0.001306,172.31.40.0-255,66,104409,65,245495
11129,0.001362,74.125.130.0-255,1484,105893,65,245495
11130,0.001369,74.125.130.0-255,2902,108795,65,245495
11131,0.001372,172.31.40.0-255,66,108861,65,245495
11132,0.001405,74.125.130.0-255,5738,114599,65,245495
11133,0.001408,172.31.40.0-255,66,114665,65,245495
11134,0.001412,74.125.130.0-255,2902,117567,65,245495
11135,0.001415,172.31.40.0-255,66,117633,65,245495
11136,0.001425,74.125.130.0-255,4320,121953,65,245495
11137,0.001427,172.31.40.0-255,66,122019,65,245495
11138,0.001431,74.125.130.0-255,2902,124921,65,245495
11139,0.001434,172.31.40.0-255,66,124987,65,245495
11140,0.00147,74.125.130.0-255,5738,130725,65,245495
11141,0.001474,172.31.40.0-255,66,130791,65,245495
11142,0.001484,172.31.40.0-255,66,130857,65,245495
11143,0.001536,74.125.130.0-255,1484,132341,65,245495
11144,0.001542,74.125.130.0-255,2902,135243,65,245495
11145,0.001544,172.31.40.0-255,66,135309,65,245495
11146,0.001548,74.125.130.0-255,1484,136793,65,245495
11147,0.001572,74.125.130.0-255,2902,139695,65,245495
11148,0.001578,74.125.130.0-255,4320,144015,65,245495
11149,0.001583,172.31.40.0-255,66,144081,65,245495
11150,0.00159,172.31.40.0-255,66,144147,65,245495
11151,0.001593,74.125.130.0-255,1484,145631,65,245495
11152,0.001631,172.31.40.0-255,66,145697,65,245495
11153,0.001658,74.125.130.0-255,4320,150017,65,245495
11154,0.001661,172.31.40.0-255,66,150083,65,245495
11155,0.001688,74.125.130.0-255,3602,153685,65,245495
11156,0.001693,172.31.40.0-255,66,153751,65,245495
11157,0.00172,74.125.130.0-255,1484,155235,65,245495
11158,0.001724,74.125.130.0-255,2902,158137,65,245495
11159,0.001728,172.31.40.0-255,66,158203,65,245495
11160,0.001761,74.125.130.0-255,5738,163941,65,245495
11161,0.001765,172.31.40.0-255,66,164007,65,245495
11162,0.001769,74.125.130.0-255,2902,166909,65,245495
11163,0.001772,172.31.40.0-255,66,166975,65,245495
11164,0.001777,74.125.130.0-255,4320,171295,65,245495
11165,0.001781,172.31.40.0-255,66,171361,65,245495
11166,0.001787,74.125.130.0-255,5738,177099,65,245495
11167,0.00179,172.31.40.0-255,66,177165,65,245495
11168,0.001828,74.125.130.0-255,2902,180067,65,245495
11169,0.001832,172.31.40.0-255,66,180133,65,245495
11170,0.001848,172.31.40.0-255,66,180199,65,245495
11171,0.001946,74.125.130.0-255,1484,181683,65,245495
11172,0.00195,74.125.130.0-255,1484,183167,65,245495
11173,0.001953,172.31.40.0-255,66,183233,65,245495
11174,0.00198,74.125.130.0-255,1484,184717,65,245495
11175,0.001988,74.125.130.0-255,5738,190455,65,245495
11176,0.00199,172.31.40.0-255,66,190521,65,245495
11177,0.002021,74.125.130.0-255,4320,194841,65,245495
11178,0.002026,172.31.40.0-255,66,194907,65,245495
11179,0.002052,172.31.40.0-255,66,194973,65,245495
11180,0.002055,74.125.130.0-255,1484,196457,65,245495
11181,0.002085,172.31.40.0-255,66,196523,65,245495
11182,0.002248,74.125.130.0-255,1484,198007,65,245495
11183,0.002255,74.125.130.0-255,2902,200909,65,245495
11184,0.002258,172.31.40.0-255,66,200975,65,245495
11185,0.002286,74.125.130.0-255,2902,203877,65,245495
11186,0.00229,172.31.40.0-255,66,203943,65,245495
11187,0.004522,74.125.130.0-255,2902,206845,65,245495
11188,0.004541,172.31.40.0-255,66,206911,65,245495
11189,0.004574,74.125.130.0-255,2902,209813,65,245495
11190,0.004577,172.31.40.0-255,66,209879,65,245495
11191,0.00681,74.125.130.0-255,2902,212781,65,245495
11192,0.006828,172.31.40.0-255,66,212847,65,245495
11193,0.00685,74.125.130.0-255,2902,215749,65,245495
11194,0.006853,172.31.40.0-255,66,215815,65,245495
11195,0.009086,74.125.130.0-255,2902,218717,65,245495
11196,0.009092,172.31.40.0-255,66,218783,65,245495
11197,0.009124,74.125.130.0-255,2902,221685,65,245495
11198,0.009127,172.31.40.0-255,66,221751,65,245495
11199,0.011346,74.125.130.0-255,2902,224653,65,245495
11200,0.011351,172.31.40.0-255,66,224719,65,245495
11201,0.011381,74.125.130.0-255,2902,227621,65,245495
11202,0.011384,172.31.40.0-255,66,227687,65,245495
11203,0.013628,74.125.130.0-255,2902,230589,65,245495
11204,0.013643,172.31.40.0-255,66,230655,65,245495
11205,0.013673,74.125.130.0-255,2902,233557,65,245495
11206,0.013676,172.31.40.0-255,66,233623,65,245495
11207,0.015906,74.125.130.0-255,2902,236525,65,245495
11208,0.015921,172.31.40.0-255,66,236591,65,245495
11209,0.015947,74.125.130.0-255,2902,239493,65,245495
11210,0.015951,172.31.40.0-255,66,239559,65,245495
11211,0.018184,74.125.130.0-255,2902,242461,65,245495
11212,0.018192,172.31.40.0-255,66,242527,65,245495
11213,0.018222,74.125.130.0-255,2902,245429,65,245495
11214,0.018224,172.31.40.0-255,66,245495,65,245495
11215,0.0,172.217.194.0-255,150,150,65,145702
11216,2.3e-05,172.31.40.0-255,66,216,65,145702
11217,3e-05,172.217.194.0-255,1484,1700,65,145702
11218,3.5e-05,172.31.40.0-255,66,1766,65,145702
11219,4.1e-05,172.217.194.0-255,2902,4668,65,145702
11220,4.5e-05,172.31.40.0-255,66,4734,65,145702
11221,5.3e-05,172.217.194.0-255,7156,11890,65,145702
11222,5.6e-05,172.31.40.0-255,66,11956,65,145702
11223,8.1e-05,172.217.194.0-255,2038,13994,65,145702
11224,8.4e-05,172.31.40.0-255,66,14060,65,145702
11225,0.000427,172.217.194.0-255,1484,15544,65,145702
11226,0.000433,172.31.40.0-255,66,15610,65,145702
11227,0.000439,172.217.194.0-255,2902,18512,65,145702
11228,0.000442,172.31.40.0-255,66,18578,65,145702
11229,0.000449,172.217.194.0-255,5738,24316,65,145702
11230,0.000451,172.31.40.0-255,66,24382,65,145702
11231,0.000459,172.217.194.0-255,6797,31179,65,145702
11232,0.000461,172.31.40.0-255,66,31245,65,145702
11233,0.000594,172.217.194.0-255,1484,32729,65,145702
11234,0.000599,172.31.40.0-255,66,32795,65,145702
11235,0.000605,172.217.194.0-255,2902,35697,65,145702
11236,0.000607,172.31.40.0-255,66,35763,65,145702
11237,0.000627,172.217.194.0-255,5738,41501,65,145702
11238,0.000631,172.31.40.0-255,66,41567,65,145702
11239,0.000656,172.217.194.0-255,5738,47305,65,145702
11240,0.00066,172.31.40.0-255,66,47371,65,145702
11241,0.000677,172.217.194.0-255,1125,48496,65,145702
11242,0.00068,172.31.40.0-255,66,48562,65,145702
11243,0.000732,172.217.194.0-255,1484,50046,65,145702
11244,0.000736,172.31.40.0-255,66,50112,65,145702
11245,0.000759,172.217.194.0-255,2902,53014,65,145702
11246,0.000762,172.31.40.0-255,66,53080,65,145702
11247,0.000769,172.217.194.0-255,5738,58818,65,145702
11248,0.000771,172.31.40.0-255,66,58884,65,145702
11249,0.000813,172.217.194.0-255,2902,61786,65,145702
11250,0.000816,172.31.40.0-255,66,61852,65,145702
11251,0.000838,172.217.194.0-255,4256,66108,65,145702
11252,0.00084,172.31.40.0-255,66,66174,65,145702
11253,0.001165,172.217.194.0-255,382,66556,65,145702
11254,0.001214,172.31.40.0-255,66,66622,65,145702
11255,0.001633,172.217.194.0-255,1484,68106,65,145702
11256,0.001644,172.217.194.0-255,2902,71008,65,145702
11257,0.001648,172.31.40.0-255,66,71074,65,145702
11258,0.001658,172.217.194.0-255,5738,76812,65,145702
11259,0.00166,172.31.40.0-255,66,76878,65,145702
11260,0.001663,172.217.194.0-255,1484,78362,65,145702
11261,0.00169,172.31.40.0-255,66,78428,65,145702
11262,0.001713,172.217.194.0-255,1484,79912,65,145702
11263,0.001741,172.31.40.0-255,66,79978,65,145702
11264,0.001792,172.217.194.0-255,1484,81462,65,145702
11265,0.001796,172.217.194.0-255,1484,82946,65,145702
11266,0.001799,172.31.40.0-255,66,83012,65,145702
11267,0.001815,172.217.194.0-255,1484,84496,65,145702
11268,0.001822,172.217.194.0-255,5738,90234,65,145702
11269,0.001824,172.31.40.0-255,66,90300,65,145702
11270,0.001846,172.31.40.0-255,66,90366,65,145702
11271,0.001863,172.217.194.0-255,1484,91850,65,145702
11272,0.001866,172.217.194.0-255,1484,93334,65,145702
11273,0.001868,172.31.40.0-255,66,93400,65,145702
11274,0.001901,172.31.40.0-255,66,93466,65,145702
11275,0.003896,172.217.194.0-255,5738,99204,65,145702
11276,0.003902,172.31.40.0-255,66,99270,65,145702
11277,0.005925,172.217.194.0-255,5738,105008,65,145702
11278,0.005935,172.31.40.0-255,66,105074,65,145702
11279,0.007933,172.217.194.0-255,5738,110812,65,145702
11280,0.007938,172.31.40.0-255,66,110878,65,145702
11281,0.009923,172.217.194.0-255,5738,116616,65,145702
11282,0.009931,172.31.40.0-255,66,116682,65,145702
11283,0.011904,172.217.194.0-255,5738,122420,65,145702
11284,0.011914,172.31.40.0-255,66,122486,65,145702
11285,0.01391,172.217.194.0-255,5738,128224,65,145702
11286,0.013918,172.31.40.0-255,66,128290,65,145702
11287,0.015925,172.217.194.0-255,5738,134028,65,145702
11288,0.015935,172.31.40.0-255,66,134094,65,145702
11289,0.017924,172.217.194.0-255,5738,139832,65,145702
11290,0.017931,172.31.40.0-255,66,139898,65,145702
11291,0.019902,172.217.194.0-255,5738,145636,65,145702
11292,0.019909,172.31.40.0-255,66,145702,65,145702
11293,0.0,172.217.194.0-255,153,153,65,173503
11294,2.6e-05,172.31.40.0-255,66,219,65,173503
11295,3.4e-05,172.217.194.0-255,1484,1703,65,173503
11296,3.8e-05,172.31.40.0-255,66,1769,65,173503
11297,5.2e-05,172.217.194.0-255,2902,4671,65,173503
11298,5.5e-05,172.31.40.0-255,66,4737,65,173503
11299,6.3e-05,172.217.194.0-255,7156,11893,65,173503
11300,6.6e-05,172.31.40.0-255,66,11959,65,173503
11301,9.1e-05,172.217.194.0-255,2031,13990,65,173503
11302,9.4e-05,172.31.40.0-255,66,14056,65,173503
11303,0.000232,172.217.194.0-255,1484,15540,65,173503
11304,0.000236,172.31.40.0-255,66,15606,65,173503
11305,0.000243,172.217.194.0-255,2902,18508,65,173503
11306,0.000245,172.31.40.0-255,66,18574,65,173503
11307,0.000252,172.217.194.0-255,5738,24312,65,173503
11308,0.00026,172.31.40.0-255,66,24378,65,173503
11309,0.000297,172.217.194.0-255,2902,27280,65,173503
11310,0.000299,172.31.40.0-255,66,27346,65,173503
11311,0.000328,172.217.194.0-255,3961,31307,65,173503
11312,0.000331,172.31.40.0-255,66,31373,65,173503
11313,0.000671,172.217.194.0-255,1484,32857,65,173503
11314,0.000677,172.31.40.0-255,66,32923,65,173503
11315,0.000683,172.217.194.0-255,2902,35825,65,173503
11316,0.000686,172.31.40.0-255,66,35891,65,173503
11317,0.000719,172.217.194.0-255,5738,41629,65,173503
11318,0.000722,172.31.40.0-255,66,41695,65,173503
11319,0.000725,172.217.194.0-255,1484,43179,65,173503
11320,0.000727,172.31.40.0-255,66,43245,65,173503
11321,0.000746,172.217.194.0-255,2902,46147,65,173503
11322,0.000749,172.31.40.0-255,66,46213,65,173503
11323,0.000792,172.217.194.0-255,6797,53010,65,173503
11324,0.000796,172.31.40.0-255,66,53076,65,173503
11325,0.000811,172.31.40.0-255,66,53142,65,173503
11326,0.000814,172.217.194.0-255,645,53787,65,173503
11327,0.000894,172.217.194.0-255,1484,55271,65,173503
11328,0.000898,172.31.40.0-255,66,55337,65,173503
11329,0.000903,172.217.194.0-255,2902,58239,65,173503
11330,0.000905,172.31.40.0-255,66,58305,65,173503
11331,0.000938,172.217.194.0-255,5738,64043,65,173503
11332,0.000941,172.31.40.0-255,66,64109,65,173503
11333,0.000958,172.31.40.0-255,66,64175,65,173503
11334,0.000987,172.217.194.0-255,2902,67077,65,173503
11335,0.00099,172.31.40.0-255,66,67143,65,173503
11336,0.001031,172.31.40.0-255,66,67209,65,173503
11337,0.001479,172.217.194.0-255,1484,68693,65,173503
11338,0.001487,172.217.194.0-255,2902,71595,65,173503
11339,0.001492,172.31.40.0-255,66,71661,65,173503
11340,0.0015,172.217.194.0-255,5738,77399,65,173503
11341,0.001503,172.31.40.0-255,66,77465,65,173503
11342,0.00152,172.31.40.0-255,66,77531,65,173503
11343,0.001543,172.217.194.0-255,1484,79015,65,173503
11344,0.001584,172.31.40.0-255,66,79081,65,173503
11345,0.00172,172.217.194.0-255,1484,80565,65,173503
11346,0.001726,172.217.194.0-255,2902,83467,65,173503
11347,0.00173,172.31.40.0-255,66,83533,65,173503
11348,0.001737,172.217.194.0-255,5738,89271,65,173503
11349,0.00174,172.31.40.0-255,66,89337,65,173503
11350,0.001749,172.217.194.0-255,2902,92239,65,173503
11351,0.001751,172.31.40.0-255,66,92305,65,173503
11352,0.001797,172.31.40.0-255,66,92371,65,173503
11353,0.001824,172.217.194.0-255,4320,96691,65,173503
11354,0.001827,172.31.40.0-255,66,96757,65,173503
11355,0.00186,172.217.194.0-255,6438,103195,65,173503
11356,0.001864,172.31.40.0-255,66,103261,65,173503
11357,0.002222,172.217.194.0-255,1484,104745,65,173503
11358,0.00224,172.217.194.0-255,2902,107647,65,173503
11359,0.002244,172.31.40.0-255,66,107713,65,173503
11360,0.002251,172.217.194.0-255,5738,113451,65,173503
11361,0.002253,172.31.40.0-255,66,113517,65,173503
11362,0.002278,172.217.194.0-255,5738,119255,65,173503
11363,0.00228,172.31.40.0-255,66,119321,65,173503
11364,0.00232,172.217.194.0-255,4320,123641,65,173503
11365,0.002323,172.31.40.0-255,66,123707,65,173503
11366,0.002352,172.217.194.0-255,5738,129445,65,173503
11367,0.002357,172.31.40.0-255,66,129511,65,173503
11368,0.002367,172.217.194.0-255,2902,132413,65,173503
11369,0.002373,172.31.40.0-255,66,132479,65,173503
11370,0.004586,172.217.194.0-255,2902,135381,65,173503
11371,0.004593,172.31.40.0-255,66,135447,65,173503
11372,0.004623,172.217.194.0-255,2902,138349,65,173503
11373,0.004627,172.31.40.0-255,66,138415,65,173503
11374,0.006811,172.217.194.0-255,2902,141317,65,173503
11375,0.006815,172.31.40.0-255,66,141383,65,173503
11376,0.006846,172.217.194.0-255,2902,144285,65,173503
11377,0.006848,172.31.40.0-255,66,144351,65,173503
11378,0.009053,172.217.194.0-255,2902,147253,65,173503
11379,0.009059,172.31.40.0-255,66,147319,65,173503
11380,0.009084,172.217.194.0-255,2902,150221,65,173503
11381,0.009086,172.31.40.0-255,66,150287,65,173503
11382,0.011317,172.217.194.0-255,5738,156025,65,173503
11383,0.011324,172.31.40.0-255,66,156091,65,173503
11384,0.013579,172.217.194.0-255,5738,161829,65,173503
11385,0.013586,172.31.40.0-255,66,161895,65,173503
11386,0.015866,172.217.194.0-255,5738,167633,65,173503
11387,0.015876,172.31.40.0-255,66,167699,65,173503
11388,0.018147,172.217.194.0-255,5738,173437,65,173503
11389,0.018166,172.31.40.0-255,66,173503,65,173503
11390,0.0,74.125.24.0-255,153,153,65,162765
11391,2.3e-05,172.31.40.0-255,66,219,65,162765
11392,2.9e-05,74.125.24.0-255,1484,1703,65,162765
11393,3.4e-05,172.31.40.0-255,66,1769,65,162765
11394,4e-05,74.125.24.0-255,2902,4671,65,162765
11395,5.2e-05,172.31.40.0-255,66,4737,65,162765
11396,6e-05,74.125.24.0-255,7156,11893,65,162765
11397,6.4e-05,172.31.40.0-255,66,11959,65,162765
11398,7.1e-05,74.125.24.0-255,6381,18340,65,162765
11399,7.4e-05,172.31.40.0-255,66,18406,65,162765
11400,8.1e-05,74.125.24.0-255,7156,25562,65,162765
11401,8.5e-05,172.31.40.0-255,66,25628,65,162765
11402,0.000136,172.31.40.0-255,66,25694,65,162765
11403,0.000143,74.125.24.0-255,6438,32132,65,162765
11404,0.000145,172.31.40.0-255,66,32198,65,162765
11405,0.000183,172.31.40.0-255,66,32264,65,162765
11406,0.000223,172.31.40.0-255,66,32330,65,162765
11407,0.000288,74.125.24.0-255,110,32440,65,162765
11408,0.000291,172.31.40.0-255,66,32506,65,162765
11409,0.000425,74.125.24.0-255,1484,33990,65,162765
11410,0.000429,172.31.40.0-255,66,34056,65,162765
11411,0.000435,74.125.24.0-255,2902,36958,65,162765
11412,0.000438,172.31.40.0-255,66,37024,65,162765
11413,0.000442,74.125.24.0-255,2902,39926,65,162765
11414,0.00045,172.31.40.0-255,66,39992,65,162765
11415,0.000482,74.125.24.0-255,2902,42894,65,162765
11416,0.000485,172.31.40.0-255,66,42960,65,162765
11417,0.000503,172.31.40.0-255,66,43026,65,162765
11418,0.000518,172.31.40.0-255,66,43092,65,162765
11419,0.000924,74.125.24.0-255,1484,44576,65,162765
11420,0.00094,74.125.24.0-255,2902,47478,65,162765
11421,0.000944,172.31.40.0-255,66,47544,65,162765
11422,0.000949,74.125.24.0-255,2902,50446,65,162765
11423,0.000951,172.31.40.0-255,66,50512,65,162765
11424,0.000983,74.125.24.0-255,2902,53414,65,162765
11425,0.000986,172.31.40.0-255,66,53480,65,162765
11426,0.001039,172.31.40.0-255,66,53546,65,162765
11427,0.001048,172.31.40.0-255,66,53612,65,162765
11428,0.001068,172.31.40.0-255,66,53678,65,162765
11429,0.001122,74.125.24.0-255,1484,55162,65,162765
11430,0.001127,74.125.24.0-255,2902,58064,65,162765
11431,0.001129,172.31.40.0-255,66,58130,65,162765
11432,0.001136,74.125.24.0-255,5738,63868,65,162765
11433,0.001138,172.31.40.0-255,66,63934,65,162765
11434,0.001147,74.125.24.0-255,4320,68254,65,162765
11435,0.001149,172.31.40.0-255,66,68320,65,162765
11436,0.001187,172.31.40.0-255,66,68386,65,162765
11437,0.001194,74.125.24.0-255,5738,74124,65,162765
11438,0.001197,172.31.40.0-255,66,74190,65,162765
11439,0.001216,74.125.24.0-255,2184,76374,65,162765
11440,0.00122,172.31.40.0-255,66,76440,65,162765
11441,0.001278,74.125.24.0-255,1484,77924,65,162765
11442,0.001283,74.125.24.0-255,2902,80826,65,162765
11443,0.001286,172.31.40.0-255,66,80892,65,162765
11444,0.001316,74.125.24.0-255,5738,86630,65,162765
11445,0.001318,172.31.40.0-255,66,86696,65,162765
11446,0.001323,74.125.24.0-255,2902,89598,65,162765
11447,0.001325,172.31.40.0-255,66,89664,65,162765
11448,0.001356,172.31.40.0-255,66,89730,65,162765
11449,0.001372,172.31.40.0-255,66,89796,65,162765
11450,0.001465,74.125.24.0-255,1484,91280,65,162765
11451,0.00147,74.125.24.0-255,2902,94182,65,162765
11452,0.001473,172.31.40.0-255,66,94248,65,162765
11453,0.001479,74.125.24.0-255,4320,98568,65,162765
11454,0.001481,172.31.40.0-255,66,98634,65,162765
11455,0.001515,74.125.24.0-255,1484,100118,65,162765
11456,0.001523,74.125.24.0-255,7156,107274,65,162765
11457,0.001526,172.31.40.0-255,66,107340,65,162765
11458,0.001545,172.31.40.0-255,66,107406,65,162765
11459,0.001549,74.125.24.0-255,2184,109590,65,162765
11460,0.001551,172.31.40.0-255,66,109656,65,162765
11461,0.001633,74.125.24.0-255,1484,111140,65,162765
11462,0.001644,74.125.24.0-255,2902,114042,65,162765
11463,0.001648,172.31.40.0-255,66,114108,65,162765
11464,0.001654,74.125.24.0-255,5738,119846,65,162765
11465,0.001656,172.31.40.0-255,66,119912,65,162765
11466,0.0017,172.31.40.0-255,66,119978,65,162765
11467,0.001712,172.31.40.0-255,66,120044,65,162765
11468,0.001721,74.125.24.0-255,4320,124364,65,162765
11469,0.001723,172.31.40.0-255,66,124430,65,162765
11470,0.001753,74.125.24.0-255,7156,131586,65,162765
11471,0.001756,172.31.40.0-255,66,131652,65,162765
11472,0.001778,172.31.40.0-255,66,131718,65,162765
11473,0.001782,74.125.24.0-255,1484,133202,65,162765
11474,0.001826,172.31.40.0-255,66,133268,65,162765
11475,0.001841,172.31.40.0-255,66,133334,65,162765
11476,0.001906,172.31.40.0-255,66,133400,65,162765
11477,0.002229,74.125.24.0-255,1484,134884,65,162765
11478,0.002236,74.125.24.0-255,2902,137786,65,162765
11479,0.002239,172.31.40.0-255,66,137852,65,162765
11480,0.002265,74.125.24.0-255,5738,143590,65,162765
11481,0.002268,172.31.40.0-255,66,143656,65,162765
11482,0.002273,74.125.24.0-255,2902,146558,65,162765
11483,0.002275,172.31.40.0-255,66,146624,65,162765
11484,0.002286,172.31.40.0-255,66,146690,65,162765
11485,0.002322,172.31.40.0-255,66,146756,65,162765
11486,0.002554,74.125.24.0-255,1484,148240,65,162765
11487,0.002578,74.125.24.0-255,2902,151142,65,162765
11488,0.002583,172.31.40.0-255,66,151208,65,162765
11489,0.002589,74.125.24.0-255,5738,156946,65,162765
11490,0.002591,172.31.40.0-255,66,157012,65,162765
11491,0.002626,74.125.24.0-255,5244,162256,65,162765
11492,0.002628,172.31.40.0-255,66,162322,65,162765
11493,0.005219,74.125.24.0-255,105,162427,65,162765
11494,0.009507,172.31.40.0-255,101,162528,65,162765
11495,0.010651,172.31.40.0-255,105,162633,65,162765
11496,0.012082,74.125.24.0-255,66,162699,65,162765
11497,0.013263,74.125.24.0-255,66,162765,65,162765
11498,0.0,172.217.194.0-255,153,153,65,169868
11499,1.7e-05,172.31.40.0-255,66,219,65,169868
11500,2.3e-05,172.217.194.0-255,1484,1703,65,169868
11501,2.7e-05,172.31.40.0-255,66,1769,65,169868
11502,4.1e-05,172.217.194.0-255,2902,4671,65,169868
11503,4.5e-05,172.31.40.0-255,66,4737,65,169868
11504,5.3e-05,172.217.194.0-255,7156,11893,65,169868
11505,5.6e-05,172.31.40.0-255,66,11959,65,169868
11506,9e-05,172.217.194.0-255,2022,13981,65,169868
11507,9.3e-05,172.31.40.0-255,66,14047,65,169868
11508,0.000119,172.217.194.0-255,2902,16949,65,169868
11509,0.000122,172.31.40.0-255,66,17015,65,169868
11510,0.000127,172.217.194.0-255,4320,21335,65,169868
11511,0.000129,172.31.40.0-255,66,21401,65,169868
11512,0.000164,172.217.194.0-255,5738,27139,65,169868
11513,0.000166,172.31.40.0-255,66,27205,65,169868
11514,0.000193,172.217.194.0-255,2902,30107,65,169868
11515,0.000195,172.31.40.0-255,66,30173,65,169868
11516,0.000198,172.217.194.0-255,1125,31298,65,169868
11517,0.0002,172.31.40.0-255,66,31364,65,169868
11518,0.000288,172.217.194.0-255,1484,32848,65,169868
11519,0.000292,172.31.40.0-255,66,32914,65,169868
11520,0.000305,172.217.194.0-255,2902,35816,65,169868
11521,0.000312,172.31.40.0-255,66,35882,65,169868
11522,0.000318,172.217.194.0-255,5738,41620,65,169868
11523,0.000321,172.31.40.0-255,66,41686,65,169868
11524,0.000324,172.217.194.0-255,1484,43170,65,169868
11525,0.000329,172.31.40.0-255,66,43236,65,169868
11526,0.000368,172.217.194.0-255,6797,50033,65,169868
11527,0.000372,172.31.40.0-255,66,50099,65,169868
11528,0.000384,172.31.40.0-255,66,50165,65,169868
11529,0.000405,172.217.194.0-255,7049,57214,65,169868
11530,0.000408,172.31.40.0-255,66,57280,65,169868
11531,0.000411,172.217.194.0-255,119,57399,65,169868
11532,0.001033,172.31.40.0-255,66,57465,65,169868
11533,0.001096,172.217.194.0-255,380,57845,65,169868
11534,0.001115,172.31.40.0-255,66,57911,65,169868
11535,0.001223,172.217.194.0-255,1484,59395,65,169868
11536,0.001231,172.217.194.0-255,1484,60879,65,169868
11537,0.001235,172.31.40.0-255,66,60945,65,169868
11538,0.001268,172.217.194.0-255,1484,62429,65,169868
11539,0.001275,172.217.194.0-255,5738,68167,65,169868
11540,0.001277,172.31.40.0-255,66,68233,65,169868
11541,0.001304,172.217.194.0-255,1484,69717,65,169868
11542,0.001321,172.217.194.0-255,4831,74548,65,169868
11543,0.001324,172.31.40.0-255,66,74614,65,169868
11544,0.001417,172.217.194.0-255,1484,76098,65,169868
11545,0.00143,172.217.194.0-255,2902,79000,65,169868
11546,0.001433,172.31.40.0-255,66,79066,65,169868
11547,0.001438,172.217.194.0-255,2902,81968,65,169868
11548,0.00144,172.31.40.0-255,66,82034,65,169868
11549,0.001472,172.217.194.0-255,2902,84936,65,169868
11550,0.001475,172.31.40.0-255,66,85002,65,169868
11551,0.001484,172.217.194.0-255,7156,92158,65,169868
11552,0.001486,172.31.40.0-255,66,92224,65,169868
11553,0.001523,172.217.194.0-255,5738,97962,65,169868
11554,0.001527,172.31.40.0-255,66,98028,65,169868
11555,0.001538,172.31.40.0-255,66,98094,65,169868
11556,0.001568,172.217.194.0-255,2184,100278,65,169868
11557,0.001571,172.31.40.0-255,66,100344,65,169868
11558,0.00207,172.217.194.0-255,1484,101828,65,169868
11559,0.002078,172.217.194.0-255,2902,104730,65,169868
11560,0.002083,172.31.40.0-255,66,104796,65,169868
11561,0.002092,172.217.194.0-255,5738,110534,65,169868
11562,0.002094,172.31.40.0-255,66,110600,65,169868
11563,0.002158,172.31.40.0-255,66,110666,65,169868
11564,0.00217,172.31.40.0-255,66,110732,65,169868
11565,0.002176,172.217.194.0-255,5020,115752,65,169868
11566,0.002178,172.31.40.0-255,66,115818,65,169868
11567,0.002349,172.217.194.0-255,1484,117302,65,169868
11568,0.002367,172.217.194.0-255,2902,120204,65,169868
11569,0.00237,172.31.40.0-255,66,120270,65,169868
11570,0.002374,172.217.194.0-255,2902,123172,65,169868
11571,0.002376,172.31.40.0-255,66,123238,65,169868
11572,0.002406,172.217.194.0-255,2902,126140,65,169868
11573,0.002408,172.31.40.0-255,66,126206,65,169868
11574,0.002413,172.217.194.0-255,2902,129108,65,169868
11575,0.002415,172.31.40.0-255,66,129174,65,169868
11576,0.002458,172.31.40.0-255,66,129240,65,169868
11577,0.004849,172.217.194.0-255,5738,134978,65,169868
11578,0.004854,172.31.40.0-255,66,135044,65,169868
11579,0.007233,172.217.194.0-255,5738,140782,65,169868
11580,0.00724,172.31.40.0-255,66,140848,65,169868
11581,0.009688,172.217.194.0-255,5738,146586,65,169868
11582,0.009695,172.31.40.0-255,66,146652,65,169868
11583,0.012113,172.217.194.0-255,5738,152390,65,169868
11584,0.01212,172.31.40.0-255,66,152456,65,169868
11585,0.014509,172.217.194.0-255,5738,158194,65,169868
11586,0.014516,172.31.40.0-255,66,158260,65,169868
11587,0.016944,172.217.194.0-255,5738,163998,65,169868
11588,0.016954,172.31.40.0-255,66,164064,65,169868
11589,0.019369,172.217.194.0-255,5738,169802,65,169868
11590,0.019378,172.31.40.0-255,66,169868,65,169868
11591,0.0,172.217.194.0-255,156,156,65,191973
11592,3.4e-05,172.31.40.0-255,66,222,65,191973
11593,4.1e-05,172.217.194.0-255,1484,1706,65,191973
11594,4.5e-05,172.31.40.0-255,66,1772,65,191973
11595,5.1e-05,172.217.194.0-255,2902,4674,65,191973
11596,6.1e-05,172.31.40.0-255,66,4740,65,191973
11597,6.8e-05,172.217.194.0-255,7156,11896,65,191973
11598,7.2e-05,172.31.40.0-255,66,11962,65,191973
11599,7.5e-05,172.217.194.0-255,2041,14003,65,191973
11600,7.8e-05,172.31.40.0-255,66,14069,65,191973
11601,0.000139,172.217.194.0-255,5738,19807,65,191973
11602,0.000143,172.31.40.0-255,66,19873,65,191973
11603,0.000151,172.217.194.0-255,7156,27029,65,191973
11604,0.000153,172.31.40.0-255,66,27095,65,191973
11605,0.000159,172.217.194.0-255,3961,31056,65,191973
11606,0.000161,172.31.40.0-255,66,31122,65,191973
11607,0.000251,172.217.194.0-255,1484,32606,65,191973
11608,0.000255,172.31.40.0-255,66,32672,65,191973
11609,0.000259,172.217.194.0-255,2902,35574,65,191973
11610,0.000261,172.31.40.0-255,66,35640,65,191973
11611,0.000294,172.217.194.0-255,5738,41378,65,191973
11612,0.000297,172.31.40.0-255,66,41444,65,191973
11613,0.000311,172.217.194.0-255,2902,44346,65,191973
11614,0.000318,172.31.40.0-255,66,44412,65,191973
11615,0.000347,172.217.194.0-255,3961,48373,65,191973
11616,0.00035,172.31.40.0-255,66,48439,65,191973
11617,0.000357,172.217.194.0-255,7156,55595,65,191973
11618,0.000359,172.31.40.0-255,66,55661,65,191973
11619,0.00037,172.31.40.0-255,66,55727,65,191973
11620,0.000394,172.217.194.0-255,340,56067,65,191973
11621,0.000398,172.31.40.0-255,66,56133,65,191973
11622,0.000428,172.217.194.0-255,404,56537,65,191973
11623,0.000569,172.217.194.0-255,1484,58021,65,191973
11624,0.000574,172.31.40.0-255,66,58087,65,191973
11625,0.000578,172.217.194.0-255,2902,60989,65,191973
11626,0.00058,172.31.40.0-255,66,61055,65,191973
11627,0.000605,172.217.194.0-255,5738,66793,65,191973
11628,0.000608,172.31.40.0-255,66,66859,65,191973
11629,0.000618,172.31.40.0-255,66,66925,65,191973
11630,0.000665,172.31.40.0-255,66,66991,65,191973
11631,0.000669,172.217.194.0-255,2184,69175,65,191973
11632,0.000671,172.31.40.0-255,66,69241,65,191973
11633,0.000742,172.217.194.0-255,1484,70725,65,191973
11634,0.000747,172.217.194.0-255,2902,73627,65,191973
11635,0.00075,172.31.40.0-255,66,73693,65,191973
11636,0.000785,172.217.194.0-255,5738,79431,65,191973
11637,0.000788,172.31.40.0-255,66,79497,65,191973
11638,0.000798,172.31.40.0-255,66,79563,65,191973
11639,0.000828,172.217.194.0-255,1484,81047,65,191973
11640,0.000841,172.31.40.0-255,66,81113,65,191973
11641,0.001017,172.217.194.0-255,1484,82597,65,191973
11642,0.001034,172.217.194.0-255,2902,85499,65,191973
11643,0.001037,172.31.40.0-255,66,85565,65,191973
11644,0.001044,172.217.194.0-255,5738,91303,65,191973
11645,0.001046,172.31.40.0-255,66,91369,65,191973
11646,0.001075,172.31.40.0-255,66,91435,65,191973
11647,0.001105,172.217.194.0-255,4320,95755,65,191973
11648,0.001109,172.31.40.0-255,66,95821,65,191973
11649,0.00112,172.31.40.0-255,66,95887,65,191973
11650,0.001456,172.217.194.0-255,1484,97371,65,191973
11651,0.001465,172.217.194.0-255,2902,100273,65,191973
11652,0.001468,172.31.40.0-255,66,100339,65,191973
11653,0.001476,172.217.194.0-255,5738,106077,65,191973
11654,0.001478,172.31.40.0-255,66,106143,65,191973
11655,0.001524,172.31.40.0-255,66,106209,65,191973
11656,0.001533,172.31.40.0-255,66,106275,65,191973
11657,0.001606,172.31.40.0-255,66,106341,65,191973
11658,0.00161,172.217.194.0-255,1484,107825,65,191973
11659,0.001656,172.31.40.0-255,66,107891,65,191973
11660,0.00197,172.217.194.0-255,1484,109375,65,191973
11661,0.001978,172.217.194.0-255,2902,112277,65,191973
11662,0.001983,172.31.40.0-255,66,112343,65,191973
11663,0.00199,172.217.194.0-255,5738,118081,65,191973
11664,0.001992,172.31.40.0-255,66,118147,65,191973
11665,0.002056,172.31.40.0-255,66,118213,65,191973
11666,0.00207,172.31.40.0-255,66,118279,65,191973
11667,0.002074,172.217.194.0-255,766,119045,65,191973
11668,0.002109,172.217.194.0-255,1484,120529,65,191973
11669,0.002114,172.31.40.0-255,66,120595,65,191973
11670,0.00212,172.217.194.0-255,4320,124915,65,191973
11671,0.002122,172.31.40.0-255,66,124981,65,191973
11672,0.002133,172.31.40.0-255,66,125047,65,191973
11673,0.00217,172.31.40.0-255,66,125113,65,191973
11674,0.002176,172.217.194.0-255,6438,131551,65,191973
11675,0.002178,172.31.40.0-255,66,131617,65,191973
11676,0.002219,172.217.194.0-255,5738,137355,65,191973
11677,0.002223,172.31.40.0-255,66,137421,65,191973
11678,0.002236,172.217.194.0-255,4320,141741,65,191973
11679,0.002238,172.31.40.0-255,66,141807,65,191973
11680,0.002275,172.217.194.0-255,2902,144709,65,191973
11681,0.002278,172.31.40.0-255,66,144775,65,191973
11682,0.00229,172.31.40.0-255,66,144841,65,191973
11683,0.002296,172.217.194.0-255,6438,151279,65,191973
11684,0.002299,172.31.40.0-255,66,151345,65,191973
11685,0.004633,172.217.194.0-255,5738,157083,65,191973
11686,0.004642,172.31.40.0-255,66,157149,65,191973
11687,0.006978,172.217.194.0-255,5738,162887,65,191973
11688,0.00699,172.31.40.0-255,66,162953,65,191973
11689,0.00932,172.217.194.0-255,5738,168691,65,191973
11690,0.009335,172.31.40.0-255,66,168757,65,191973
11691,0.011649,172.217.194.0-255,5738,174495,65,191973
11692,0.011665,172.31.40.0-255,66,174561,65,191973
11693,0.013996,172.217.194.0-255,5738,180299,65,191973
11694,0.014002,172.31.40.0-255,66,180365,65,191973
11695,0.016342,172.217.194.0-255,5738,186103,65,191973
11696,0.016357,172.31.40.0-255,66,186169,65,191973
11697,0.018687,172.217.194.0-255,5738,191907,65,191973
11698,0.018718,172.31.40.0-255,66,191973,65,191973
11699,0.0,172.217.194.0-255,149,149,65,101177
11700,2.2e-05,172.31.40.0-255,66,215,65,101177
11701,2.9e-05,172.217.194.0-255,1484,1699,65,101177
11702,3.3e-05,172.31.40.0-255,66,1765,65,101177
11703,4e-05,172.217.194.0-255,2902,4667,65,101177
11704,5.1e-05,172.31.40.0-255,66,4733,65,101177
11705,5.9e-05,172.217.194.0-255,7156,11889,65,101177
11706,6.2e-05,172.31.40.0-255,66,11955,65,101177
11707,0.000133,172.217.194.0-255,2108,14063,65,101177
11708,0.000137,172.31.40.0-255,66,14129,65,101177
11709,0.000851,172.217.194.0-255,1484,15613,65,101177
11710,0.000858,172.31.40.0-255,66,15679,65,101177
11711,0.000868,172.217.194.0-255,2902,18581,65,101177
11712,0.000876,172.31.40.0-255,66,18647,65,101177
11713,0.000883,172.217.194.0-255,4320,22967,65,101177
11714,0.000886,172.31.40.0-255,66,23033,65,101177
11715,0.000919,172.217.194.0-255,1484,24517,65,101177
11716,0.000921,172.31.40.0-255,66,24583,65,101177
11717,0.00096,172.217.194.0-255,5738,30321,65,101177
11718,0.000963,172.31.40.0-255,66,30387,65,101177
11719,0.000985,172.217.194.0-255,5379,35766,65,101177
11720,0.000988,172.31.40.0-255,66,35832,65,101177
11721,0.001115,172.31.40.0-255,66,35898,65,101177
11722,0.001236,172.217.194.0-255,4320,40218,65,101177
11723,0.001243,172.31.40.0-255,66,40284,65,101177
11724,0.001277,172.31.40.0-255,66,40350,65,101177
11725,0.001476,172.31.40.0-255,66,40416,65,101177
11726,0.001498,172.217.194.0-255,1520,41936,65,101177
11727,0.0015,172.31.40.0-255,66,42002,65,101177
11728,0.001604,172.217.194.0-255,4320,46322,65,101177
11729,0.001887,172.217.194.0-255,1484,47806,65,101177
11730,0.001904,172.217.194.0-255,2902,50708,65,101177
11731,0.001946,172.217.194.0-255,2902,53610,65,101177
11732,0.001959,172.217.194.0-255,2902,56512,65,101177
11733,0.002014,172.217.194.0-255,2902,59414,65,101177
11734,0.002171,172.217.194.0-255,1484,60898,65,101177
11735,0.002397,172.217.194.0-255,1484,62382,65,101177
11736,0.002413,172.217.194.0-255,2902,65284,65,101177
11737,0.002438,172.217.194.0-255,1484,66768,65,101177
11738,0.002452,172.217.194.0-255,4320,71088,65,101177
11739,0.00251,172.217.194.0-255,1484,72572,65,101177
11740,0.002535,172.217.194.0-255,4320,76892,65,101177
11741,0.002691,172.217.194.0-255,1484,78376,65,101177
11742,0.002827,172.217.194.0-255,1484,79860,65,101177
11743,0.002935,172.217.194.0-255,4320,84180,65,101177
11744,0.003203,172.217.194.0-255,2184,86364,65,101177
11745,0.00323,172.217.194.0-255,4320,90684,65,101177
11746,0.003723,172.217.194.0-255,1484,92168,65,101177
11747,0.004514,172.217.194.0-255,2902,95070,65,101177
11748,0.004632,172.217.194.0-255,5738,100808,65,101177
11749,0.008484,172.31.40.0-255,66,100874,65,101177
11750,0.010575,172.31.40.0-255,66,100940,65,101177
11751,0.010632,172.31.40.0-255,66,101006,65,101177
11752,0.011703,172.31.40.0-255,105,101111,65,101177
11753,0.013702,172.217.194.0-255,66,101177,65,101177
11754,0.0,74.125.24.0-255,150,150,65,169688
11755,1.3e-05,172.31.40.0-255,66,216,65,169688
11756,1.8e-05,74.125.24.0-255,1484,1700,65,169688
11757,2.2e-05,172.31.40.0-255,66,1766,65,169688
11758,2.7e-05,74.125.24.0-255,2902,4668,65,169688
11759,2.9e-05,172.31.40.0-255,66,4734,65,169688
11760,3.2e-05,74.125.24.0-255,1484,6218,65,169688
11761,4.2e-05,172.31.40.0-255,66,6284,65,169688
11762,6.5e-05,74.125.24.0-255,5738,12022,65,169688
11763,6.8e-05,172.31.40.0-255,66,12088,65,169688
11764,7.1e-05,74.125.24.0-255,2902,14990,65,169688
11765,7.3e-05,172.31.40.0-255,66,15056,65,169688
11766,0.000103,74.125.24.0-255,4909,19965,65,169688
11767,0.00011,172.31.40.0-255,66,20031,65,169688
11768,0.000121,172.31.40.0-255,66,20097,65,169688
11769,0.000362,74.125.24.0-255,1484,21581,65,169688
11770,0.000368,172.31.40.0-255,66,21647,65,169688
11771,0.000373,74.125.24.0-255,2902,24549,65,169688
11772,0.000375,172.31.40.0-255,66,24615,65,169688
11773,0.000386,74.125.24.0-255,5738,30353,65,169688
11774,0.000388,172.31.40.0-255,66,30419,65,169688
11775,0.000423,74.125.24.0-255,6797,37216,65,169688
11776,0.000427,172.31.40.0-255,66,37282,65,169688
11777,0.000828,74.125.24.0-255,1484,38766,65,169688
11778,0.000834,172.31.40.0-255,66,38832,65,169688
11779,0.000863,74.125.24.0-255,2902,41734,65,169688
11780,0.000866,172.31.40.0-255,66,41800,65,169688
11781,0.000874,74.125.24.0-255,5738,47538,65,169688
11782,0.000876,172.31.40.0-255,66,47604,65,169688
11783,0.000883,74.125.24.0-255,6797,54401,65,169688
11784,0.000885,172.31.40.0-255,66,54467,65,169688
11785,0.001121,74.125.24.0-255,1484,55951,65,169688
11786,0.001128,74.125.24.0-255,2902,58853,65,169688
11787,0.001132,172.31.40.0-255,66,58919,65,169688
11788,0.001159,74.125.24.0-255,5738,64657,65,169688
11789,0.001163,74.125.24.0-255,2902,67559,65,169688
11790,0.001187,172.31.40.0-255,66,67625,65,169688
11791,0.001222,74.125.24.0-255,1705,69330,65,169688
11792,0.001239,172.31.40.0-255,66,69396,65,169688
11793,0.001281,74.125.24.0-255,1484,70880,65,169688
11794,0.001294,74.125.24.0-255,1484,72364,65,169688
11795,0.001304,74.125.24.0-255,1484,73848,65,169688
11796,0.001307,74.125.24.0-255,1484,75332,65,169688
11797,0.001314,172.31.40.0-255,66,75398,65,169688
11798,0.001331,74.125.24.0-255,4320,79718,65,169688
11799,0.001346,74.125.24.0-255,4320,84038,65,169688
11800,0.001355,74.125.24.0-255,1484,85522,65,169688
11801,0.001359,172.31.40.0-255,66,85588,65,169688
11802,0.001399,172.31.40.0-255,66,85654,65,169688
11803,0.001433,172.31.40.0-255,66,85720,65,169688
11804,0.001488,74.125.24.0-255,1484,87204,65,169688
11805,0.001502,74.125.24.0-255,2902,90106,65,169688
11806,0.001506,74.125.24.0-255,2902,93008,65,169688
11807,0.001513,172.31.40.0-255,66,93074,65,169688
11808,0.001524,74.125.24.0-255,2902,95976,65,169688
11809,0.001532,74.125.24.0-255,4320,100296,65,169688
11810,0.001562,172.31.40.0-255,66,100362,65,169688
11811,0.001571,74.125.24.0-255,4320,104682,65,169688
11812,0.001576,172.31.40.0-255,66,104748,65,169688
11813,0.001592,74.125.24.0-255,1484,106232,65,169688
11814,0.001623,74.125.24.0-255,2184,108416,65,169688
11815,0.001641,172.31.40.0-255,66,108482,65,169688
11816,0.00199,74.125.24.0-255,1484,109966,65,169688
11817,0.001996,74.125.24.0-255,2902,112868,65,169688
11818,0.001999,172.31.40.0-255,66,112934,65,169688
11819,0.002002,74.125.24.0-255,1484,114418,65,169688
11820,0.002032,74.125.24.0-255,4320,118738,65,169688
11821,0.002058,172.31.40.0-255,66,118804,65,169688
11822,0.002067,74.125.24.0-255,4320,123124,65,169688
11823,0.002075,172.31.40.0-255,66,123190,65,169688
11824,0.002111,172.31.40.0-255,66,123256,65,169688
11825,0.004161,74.125.24.0-255,5738,128994,65,169688
11826,0.004166,172.31.40.0-255,66,129060,65,169688
11827,0.006238,74.125.24.0-255,5738,134798,65,169688
11828,0.006243,172.31.40.0-255,66,134864,65,169688
11829,0.008277,74.125.24.0-255,5738,140602,65,169688
11830,0.008285,172.31.40.0-255,66,140668,65,169688
11831,0.01035,74.125.24.0-255,5738,146406,65,169688
11832,0.01036,172.31.40.0-255,66,146472,65,169688
11833,0.012454,74.125.24.0-255,5738,152210,65,169688
11834,0.012467,172.31.40.0-255,66,152276,65,169688
11835,0.014514,74.125.24.0-255,5738,158014,65,169688
11836,0.014524,172.31.40.0-255,66,158080,65,169688
11837,0.016588,74.125.24.0-255,5738,163818,65,169688
11838,0.016597,172.31.40.0-255,66,163884,65,169688
11839,0.018698,74.125.24.0-255,5738,169622,65,169688
11840,0.018706,172.31.40.0-255,66,169688,65,169688
11841,0.0,74.125.24.0-255,153,153,65,165142
11842,2.3e-05,172.31.40.0-255,66,219,65,165142
11843,3.1e-05,74.125.24.0-255,1484,1703,65,165142
11844,3.5e-05,172.31.40.0-255,66,1769,65,165142
11845,4.1e-05,74.125.24.0-255,2902,4671,65,165142
11846,5.2e-05,172.31.40.0-255,66,4737,65,165142
11847,6e-05,74.125.24.0-255,7156,11893,65,165142
11848,6.3e-05,172.31.40.0-255,66,11959,65,165142
11849,9.5e-05,74.125.24.0-255,2029,13988,65,165142
11850,9.8e-05,172.31.40.0-255,66,14054,65,165142
11851,0.000381,74.125.24.0-255,1484,15538,65,165142
11852,0.000386,172.31.40.0-255,66,15604,65,165142
11853,0.000393,74.125.24.0-255,2902,18506,65,165142
11854,0.000396,172.31.40.0-255,66,18572,65,165142
11855,0.000408,74.125.24.0-255,5738,24310,65,165142
11856,0.00041,172.31.40.0-255,66,24376,65,165142
11857,0.000453,74.125.24.0-255,6797,31173,65,165142
11858,0.000457,172.31.40.0-255,66,31239,65,165142
11859,0.000611,74.125.24.0-255,1484,32723,65,165142
11860,0.000616,172.31.40.0-255,66,32789,65,165142
11861,0.000634,74.125.24.0-255,2902,35691,65,165142
11862,0.000636,172.31.40.0-255,66,35757,65,165142
11863,0.000665,74.125.24.0-255,5738,41495,65,165142
11864,0.000667,172.31.40.0-255,66,41561,65,165142
11865,0.000697,74.125.24.0-255,7156,48717,65,165142
11866,0.000704,172.31.40.0-255,66,48783,65,165142
11867,0.000733,74.125.24.0-255,6797,55580,65,165142
11868,0.000735,172.31.40.0-255,66,55646,65,165142
11869,0.00074,74.125.24.0-255,2902,58548,65,165142
11870,0.000742,172.31.40.0-255,66,58614,65,165142
11871,0.000754,74.125.24.0-255,6797,65411,65,165142
11872,0.000756,172.31.40.0-255,66,65477,65,165142
11873,0.000784,74.125.24.0-255,412,65889,65,165142
11874,0.000879,74.125.24.0-255,331,66220,65,165142
11875,0.00111,172.31.40.0-255,66,66286,65,165142
11876,0.001496,74.125.24.0-255,1484,67770,65,165142
11877,0.001506,74.125.24.0-255,2902,70672,65,165142
11878,0.00151,172.31.40.0-255,66,70738,65,165142
11879,0.00154,74.125.24.0-255,5738,76476,65,165142
11880,0.001542,172.31.40.0-255,66,76542,65,165142
11881,0.001581,172.31.40.0-255,66,76608,65,165142
11882,0.001607,74.125.24.0-255,2902,79510,65,165142
11883,0.00161,172.31.40.0-255,66,79576,65,165142
11884,0.001618,74.125.24.0-255,7156,86732,65,165142
11885,0.001619,172.31.40.0-255,66,86798,65,165142
11886,0.001629,74.125.24.0-255,3602,90400,65,165142
11887,0.001631,172.31.40.0-255,66,90466,65,165142
11888,0.001635,74.125.24.0-255,1484,91950,65,165142
11889,0.001673,74.125.24.0-255,2902,94852,65,165142
11890,0.001676,172.31.40.0-255,66,94918,65,165142
11891,0.001682,74.125.24.0-255,4320,99238,65,165142
11892,0.001684,172.31.40.0-255,66,99304,65,165142
11893,0.001701,172.31.40.0-255,66,99370,65,165142
11894,0.00173,74.125.24.0-255,5738,105108,65,165142
11895,0.001732,172.31.40.0-255,66,105174,65,165142
11896,0.001777,172.31.40.0-255,66,105240,65,165142
11897,0.001805,172.31.40.0-255,66,105306,65,165142
11898,0.00181,74.125.24.0-255,3602,108908,65,165142
11899,0.001811,172.31.40.0-255,66,108974,65,165142
11900,0.001835,74.125.24.0-255,1484,110458,65,165142
11901,0.00184,74.125.24.0-255,2902,113360,65,165142
11902,0.001847,172.31.40.0-255,66,113426,65,165142
11903,0.001854,74.125.24.0-255,5738,119164,65,165142
11904,0.001856,172.31.40.0-255,66,119230,65,165142
11905,0.001897,172.31.40.0-255,66,119296,65,165142
11906,0.001909,172.31.40.0-255,66,119362,65,165142
11907,0.001931,74.125.24.0-255,766,120128,65,165142
11908,0.003931,74.125.24.0-255,4320,124448,65,165142
11909,0.003938,172.31.40.0-255,66,124514,65,165142
11910,0.00596,74.125.24.0-255,5738,130252,65,165142
11911,0.005967,172.31.40.0-255,66,130318,65,165142
11912,0.008006,74.125.24.0-255,5738,136056,65,165142
11913,0.008011,172.31.40.0-255,66,136122,65,165142
11914,0.010018,74.125.24.0-255,5738,141860,65,165142
11915,0.010025,172.31.40.0-255,66,141926,65,165142
11916,0.012081,74.125.24.0-255,5738,147664,65,165142
11917,0.012092,172.31.40.0-255,66,147730,65,165142
11918,0.014158,74.125.24.0-255,5738,153468,65,165142
11919,0.014168,172.31.40.0-255,66,153534,65,165142
11920,0.016214,74.125.24.0-255,5738,159272,65,165142
11921,0.016223,172.31.40.0-255,66,159338,65,165142
11922,0.018254,74.125.24.0-255,5738,165076,65,165142
11923,0.018263,172.31.40.0-255,66,165142,65,165142
11924,0.0,172.217.194.0-255,153,153,65,171854
11925,1.4e-05,172.31.40.0-255,66,219,65,171854
11926,1.9e-05,172.217.194.0-255,1484,1703,65,171854
11927,2.4e-05,172.31.40.0-255,66,1769,65,171854
11928,2.8e-05,172.217.194.0-255,2902,4671,65,171854
11929,3.1e-05,172.31.40.0-255,66,4737,65,171854
11930,6.6e-05,172.217.194.0-255,7156,11893,65,171854
11931,6.8e-05,172.31.40.0-255,66,11959,65,171854
11932,7.2e-05,172.217.194.0-255,1983,13942,65,171854
11933,7.4e-05,172.31.40.0-255,66,14008,65,171854
11934,8.6e-05,172.31.40.0-255,66,14074,65,171854
11935,8.9e-05,172.217.194.0-255,2902,16976,65,171854
11936,9.1e-05,172.31.40.0-255,66,17042,65,171854
11937,0.00011,172.217.194.0-255,2543,19585,65,171854
11938,0.000112,172.31.40.0-255,66,19651,65,171854
11939,0.000144,172.217.194.0-255,2902,22553,65,171854
11940,0.000148,172.31.40.0-255,66,22619,65,171854
11941,0.000182,172.31.40.0-255,66,22685,65,171854
11942,0.000198,172.217.194.0-255,1484,24169,65,171854
11943,0.0002,172.31.40.0-255,66,24235,65,171854
11944,0.000214,172.31.40.0-255,66,24301,65,171854
11945,0.000217,172.217.194.0-255,1107,25408,65,171854
11946,0.000218,172.31.40.0-255,66,25474,65,171854
11947,0.00029,172.217.194.0-255,1484,26958,65,171854
11948,0.000293,172.31.40.0-255,66,27024,65,171854
11949,0.000298,172.217.194.0-255,2902,29926,65,171854
11950,0.0003,172.31.40.0-255,66,29992,65,171854
11951,0.000303,172.217.194.0-255,1484,31476,65,171854
11952,0.000304,172.31.40.0-255,66,31542,65,171854
11953,0.000331,172.217.194.0-255,4320,35862,65,171854
11954,0.000334,172.31.40.0-255,66,35928,65,171854
11955,0.000344,172.31.40.0-255,66,35994,65,171854
11956,0.000357,172.217.194.0-255,2902,38896,65,171854
11957,0.000359,172.31.40.0-255,66,38962,65,171854
11958,0.000365,172.217.194.0-255,7156,46118,65,171854
11959,0.000367,172.31.40.0-255,66,46184,65,171854
11960,0.000386,172.217.194.0-255,3602,49786,65,171854
11961,0.000388,172.31.40.0-255,66,49852,65,171854
11962,0.00039,172.217.194.0-255,366,50218,65,171854
11963,0.000609,172.217.194.0-255,1484,51702,65,171854
11964,0.000613,172.31.40.0-255,66,51768,65,171854
11965,0.000618,172.217.194.0-255,2902,54670,65,171854
11966,0.00062,172.31.40.0-255,66,54736,65,171854
11967,0.000647,172.217.194.0-255,5738,60474,65,171854
11968,0.000649,172.31.40.0-255,66,60540,65,171854
11969,0.000654,172.217.194.0-255,4320,64860,65,171854
11970,0.000656,172.31.40.0-255,66,64926,65,171854
11971,0.000672,172.217.194.0-255,7156,72082,65,171854
11972,0.000674,172.31.40.0-255,66,72148,65,171854
11973,0.000684,172.217.194.0-255,1484,73632,65,171854
11974,0.000707,172.217.194.0-255,4320,77952,65,171854
11975,0.00071,172.31.40.0-255,66,78018,65,171854
11976,0.000734,172.217.194.0-255,6438,84456,65,171854
11977,0.000736,172.31.40.0-255,66,84522,65,171854
11978,0.000778,172.217.194.0-255,1484,86006,65,171854
11979,0.000781,172.217.194.0-255,1484,87490,65,171854
11980,0.000784,172.31.40.0-255,66,87556,65,171854
11981,0.0008,172.217.194.0-255,1484,89040,65,171854
11982,0.000806,172.217.194.0-255,5738,94778,65,171854
11983,0.000809,172.31.40.0-255,66,94844,65,171854
11984,0.000822,172.217.194.0-255,1484,96328,65,171854
11985,0.000852,172.31.40.0-255,66,96394,65,171854
11986,0.000858,172.217.194.0-255,4320,100714,65,171854
11987,0.00086,172.31.40.0-255,66,100780,65,171854
11988,0.000877,172.217.194.0-255,7156,107936,65,171854
11989,0.000879,172.31.40.0-255,66,108002,65,171854
11990,0.000909,172.217.194.0-255,3602,111604,65,171854
11991,0.000912,172.31.40.0-255,66,111670,65,171854
11992,0.000928,172.31.40.0-255,66,111736,65,171854
11993,0.000943,172.31.40.0-255,66,111802,65,171854
11994,0.001069,172.217.194.0-255,1484,113286,65,171854
11995,0.001087,172.217.194.0-255,2902,116188,65,171854
11996,0.00109,172.217.194.0-255,1484,117672,65,171854
11997,0.001094,172.31.40.0-255,66,117738,65,171854
11998,0.00111,172.217.194.0-255,4320,122058,65,171854
11999,0.001112,172.31.40.0-255,66,122124,65,171854
12000,0.00112,172.217.194.0-255,5738,127862,65,171854
12001,0.001123,172.31.40.0-255,66,127928,65,171854
12002,0.001155,172.31.40.0-255,66,127994,65,171854
12003,0.001162,172.217.194.0-255,5020,133014,65,171854
12004,0.001164,172.31.40.0-255,66,133080,65,171854
12005,0.001222,172.217.194.0-255,1484,134564,65,171854
12006,0.001227,172.217.194.0-255,2902,137466,65,171854
12007,0.001229,172.31.40.0-255,66,137532,65,171854
12008,0.001236,172.217.194.0-255,5738,143270,65,171854
12009,0.001239,172.31.40.0-255,66,143336,65,171854
12010,0.001283,172.31.40.0-255,66,143402,65,171854
12011,0.00129,172.217.194.0-255,7156,150558,65,171854
12012,0.001293,172.31.40.0-255,66,150624,65,171854
12013,0.00131,172.217.194.0-255,2902,153526,65,171854
12014,0.001312,172.31.40.0-255,66,153592,65,171854
12015,0.001336,172.31.40.0-255,66,153658,65,171854
12016,0.00137,172.217.194.0-255,6438,160096,65,171854
12017,0.001388,172.217.194.0-255,4320,164416,65,171854
12018,0.001392,172.31.40.0-255,66,164482,65,171854
12019,0.001396,172.31.40.0-255,66,164548,65,171854
12020,0.001399,172.31.40.0-255,66,164614,65,171854
12021,0.001439,172.217.194.0-255,2902,167516,65,171854
12022,0.001452,172.31.40.0-255,66,167582,65,171854
12023,0.001474,172.31.40.0-255,66,167648,65,171854
12024,0.001541,172.217.194.0-255,3697,171345,65,171854
12025,0.001544,172.217.194.0-255,105,171450,65,171854
12026,0.001562,172.31.40.0-255,66,171516,65,171854
12027,0.002032,172.31.40.0-255,101,171617,65,171854
12028,0.004358,172.217.194.0-255,66,171683,65,171854
12029,0.00905,172.31.40.0-255,105,171788,65,171854
12030,0.011328,172.217.194.0-255,66,171854,65,171854
12031,0.0,74.125.68.0-255,153,153,65,97272
12032,1.8e-05,172.31.40.0-255,66,219,65,97272
12033,2.5e-05,74.125.68.0-255,1484,1703,65,97272
12034,3e-05,172.31.40.0-255,66,1769,65,97272
12035,3.5e-05,74.125.68.0-255,2902,4671,65,97272
12036,4.6e-05,172.31.40.0-255,66,4737,65,97272
12037,7.6e-05,74.125.68.0-255,4320,9057,65,97272
12038,8.4e-05,172.31.40.0-255,66,9123,65,97272
12039,0.000113,74.125.68.0-255,2902,12025,65,97272
12040,0.000115,172.31.40.0-255,66,12091,65,97272
12041,0.000217,74.125.68.0-255,4320,16411,65,97272
12042,0.000222,172.31.40.0-255,66,16477,65,97272
12043,0.000254,74.125.68.0-255,3556,20033,65,97272
12044,0.000256,172.31.40.0-255,66,20099,65,97272
12045,0.000384,74.125.68.0-255,5738,25837,65,97272
12046,0.000388,172.31.40.0-255,66,25903,65,97272
12047,0.000414,74.125.68.0-255,1484,27387,65,97272
12048,0.000416,172.31.40.0-255,66,27453,65,97272
12049,0.000527,74.125.68.0-255,1484,28937,65,97272
12050,0.000531,172.31.40.0-255,66,29003,65,97272
12051,0.000573,172.31.40.0-255,66,29069,65,97272
12052,0.000896,74.125.68.0-255,7156,36225,65,97272
12053,0.000901,172.31.40.0-255,66,36291,65,97272
12054,0.000929,74.125.68.0-255,2902,39193,65,97272
12055,0.000931,172.31.40.0-255,66,39259,65,97272
12056,0.0011,74.125.68.0-255,7156,46415,65,97272
12057,0.001105,172.31.40.0-255,66,46481,65,97272
12058,0.001136,74.125.68.0-255,3897,50378,65,97272
12059,0.001139,172.31.40.0-255,66,50444,65,97272
12060,0.001313,74.125.68.0-255,5738,56182,65,97272
12061,0.001318,172.31.40.0-255,66,56248,65,97272
12062,0.002569,172.31.40.0-255,66,56314,65,97272
12063,0.002736,172.31.40.0-255,66,56380,65,97272
12064,0.002771,172.31.40.0-255,66,56446,65,97272
12065,0.003433,74.125.68.0-255,7156,63602,65,97272
12066,0.003438,172.31.40.0-255,66,63668,65,97272
12067,0.003553,172.31.40.0-255,66,63734,65,97272
12068,0.006048,74.125.68.0-255,5738,69472,65,97272
12069,0.006054,172.31.40.0-255,66,69538,65,97272
12070,0.008573,74.125.68.0-255,4320,73858,65,97272
12071,0.00858,172.31.40.0-255,66,73924,65,97272
12072,0.008607,74.125.68.0-255,1484,75408,65,97272
12073,0.011089,74.125.68.0-255,4320,79728,65,97272
12074,0.011098,172.31.40.0-255,66,79794,65,97272
12075,0.013605,74.125.68.0-255,5738,85532,65,97272
12076,0.013874,172.31.40.0-255,66,85598,65,97272
12077,0.016409,74.125.68.0-255,5738,91336,65,97272
12078,0.016421,172.31.40.0-255,66,91402,65,97272
12079,0.018931,74.125.68.0-255,4320,95722,65,97272
12080,0.018945,172.31.40.0-255,66,95788,65,97272
12081,0.018978,74.125.68.0-255,1484,97272,65,97272
12082,0.0,74.125.24.0-255,150,150,65,228002
12083,2.3e-05,172.31.40.0-255,66,216,65,228002
12084,3e-05,74.125.24.0-255,1484,1700,65,228002
12085,3.5e-05,172.31.40.0-255,66,1766,65,228002
12086,4.1e-05,74.125.24.0-255,2902,4668,65,228002
12087,4.6e-05,172.31.40.0-255,66,4734,65,228002
12088,5.3e-05,74.125.24.0-255,7156,11890,65,228002
12089,5.6e-05,172.31.40.0-255,66,11956,65,228002
12090,6e-05,74.125.24.0-255,2099,14055,65,228002
12091,6.2e-05,172.31.40.0-255,66,14121,65,228002
12092,9e-05,172.31.40.0-255,66,14187,65,228002
12093,0.000137,74.125.24.0-255,4320,18507,65,228002
12094,0.00014,172.31.40.0-255,66,18573,65,228002
12095,0.000155,74.125.24.0-255,3961,22534,65,228002
12096,0.000157,172.31.40.0-255,66,22600,65,228002
12097,0.000206,74.125.24.0-255,1484,24084,65,228002
12098,0.000209,172.31.40.0-255,66,24150,65,228002
12099,0.000214,74.125.24.0-255,2902,27052,65,228002
12100,0.000216,172.31.40.0-255,66,27118,65,228002
12101,0.000221,74.125.24.0-255,4320,31438,65,228002
12102,0.000224,172.31.40.0-255,66,31504,65,228002
12103,0.000246,74.125.24.0-255,1484,32988,65,228002
12104,0.000248,172.31.40.0-255,66,33054,65,228002
12105,0.000252,74.125.24.0-255,2902,35956,65,228002
12106,0.000255,172.31.40.0-255,66,36022,65,228002
12107,0.000258,74.125.24.0-255,1484,37506,65,228002
12108,0.000261,172.31.40.0-255,66,37572,65,228002
12109,0.000287,172.31.40.0-255,66,37638,65,228002
12110,0.000293,74.125.24.0-255,5379,43017,65,228002
12111,0.000295,172.31.40.0-255,66,43083,65,228002
12112,0.000326,74.125.24.0-255,677,43760,65,228002
12113,0.000949,74.125.24.0-255,1484,45244,65,228002
12114,0.000955,172.31.40.0-255,66,45310,65,228002
12115,0.000959,74.125.24.0-255,1484,46794,65,228002
12116,0.000974,74.125.24.0-255,1484,48278,65,228002
12117,0.000976,172.31.40.0-255,66,48344,65,228002
12118,0.000984,74.125.24.0-255,5738,54082,65,228002
12119,0.000986,172.31.40.0-255,66,54148,65,228002
12120,0.001011,74.125.24.0-255,4320,58468,65,228002
12121,0.001013,172.31.40.0-255,66,58534,65,228002
12122,0.001019,74.125.24.0-255,4320,62854,65,228002
12123,0.001021,172.31.40.0-255,66,62920,65,228002
12124,0.001039,74.125.24.0-255,7156,70076,65,228002
12125,0.001041,172.31.40.0-255,66,70142,65,228002
12126,0.001052,172.31.40.0-255,66,70208,65,228002
12127,0.0011,74.125.24.0-255,1484,71692,65,228002
12128,0.001104,74.125.24.0-255,1484,73176,65,228002
12129,0.001106,172.31.40.0-255,66,73242,65,228002
12130,0.00113,74.125.24.0-255,1484,74726,65,228002
12131,0.001136,74.125.24.0-255,5738,80464,65,228002
12132,0.001139,172.31.40.0-255,66,80530,65,228002
12133,0.001143,74.125.24.0-255,2902,83432,65,228002
12134,0.001145,172.31.40.0-255,66,83498,65,228002
12135,0.001164,74.125.24.0-255,5738,89236,65,228002
12136,0.001167,172.31.40.0-255,66,89302,65,228002
12137,0.001191,74.125.24.0-255,4320,93622,65,228002
12138,0.001194,172.31.40.0-255,66,93688,65,228002
12139,0.001227,74.125.24.0-255,5738,99426,65,228002
12140,0.001229,172.31.40.0-255,66,99492,65,228002
12141,0.001251,74.125.24.0-255,5020,104512,65,228002
12142,0.001254,172.31.40.0-255,66,104578,65,228002
12143,0.001257,74.125.24.0-255,1484,106062,65,228002
12144,0.001261,74.125.24.0-255,2902,108964,65,228002
12145,0.001263,172.31.40.0-255,66,109030,65,228002
12146,0.001269,74.125.24.0-255,5738,114768,65,228002
12147,0.001272,172.31.40.0-255,66,114834,65,228002
12148,0.001287,74.125.24.0-255,4320,119154,65,228002
12149,0.00129,172.31.40.0-255,66,119220,65,228002
12150,0.001319,172.31.40.0-255,66,119286,65,228002
12151,0.001335,74.125.24.0-255,4320,123606,65,228002
12152,0.001337,172.31.40.0-255,66,123672,65,228002
12153,0.001365,74.125.24.0-255,6438,130110,65,228002
12154,0.001369,172.31.40.0-255,66,130176,65,228002
12155,0.001385,74.125.24.0-255,1484,131660,65,228002
12156,0.001389,74.125.24.0-255,2902,134562,65,228002
12157,0.001392,172.31.40.0-255,66,134628,65,228002
12158,0.001395,74.125.24.0-255,1484,136112,65,228002
12159,0.001417,74.125.24.0-255,4320,140432,65,228002
12160,0.00142,172.31.40.0-255,66,140498,65,228002
12161,0.001423,74.125.24.0-255,1484,141982,65,228002
12162,0.001443,74.125.24.0-255,7156,149138,65,228002
12163,0.001446,172.31.40.0-255,66,149204,65,228002
12164,0.001471,74.125.24.0-255,4320,153524,65,228002
12165,0.001474,172.31.40.0-255,66,153590,65,228002
12166,0.001484,172.31.40.0-255,66,153656,65,228002
12167,0.001488,74.125.24.0-255,2184,155840,65,228002
12168,0.00149,172.31.40.0-255,66,155906,65,228002
12169,0.001516,74.125.24.0-255,2902,158808,65,228002
12170,0.001519,172.31.40.0-255,66,158874,65,228002
12171,0.001538,74.125.24.0-255,4320,163194,65,228002
12172,0.001541,172.31.40.0-255,66,163260,65,228002
12173,0.001553,74.125.24.0-255,2902,166162,65,228002
12174,0.001555,172.31.40.0-255,66,166228,65,228002
12175,0.001559,74.125.24.0-255,2902,169130,65,228002
12176,0.001562,172.31.40.0-255,66,169196,65,228002
12177,0.001593,74.125.24.0-255,7156,176352,65,228002
12178,0.001596,172.31.40.0-255,66,176418,65,228002
12179,0.001626,172.31.40.0-255,66,176484,65,228002
12180,0.001648,74.125.24.0-255,5020,181504,65,228002
12181,0.001652,172.31.40.0-255,66,181570,65,228002
12182,0.003695,74.125.24.0-255,5738,187308,65,228002
12183,0.003703,172.31.40.0-255,66,187374,65,228002
12184,0.005747,74.125.24.0-255,5738,193112,65,228002
12185,0.005751,172.31.40.0-255,66,193178,65,228002
12186,0.007783,74.125.24.0-255,5738,198916,65,228002
12187,0.007786,172.31.40.0-255,66,198982,65,228002
12188,0.00985,74.125.24.0-255,5738,204720,65,228002
12189,0.009866,172.31.40.0-255,66,204786,65,228002
12190,0.011916,74.125.24.0-255,5738,210524,65,228002
12191,0.011929,172.31.40.0-255,66,210590,65,228002
12192,0.013966,74.125.24.0-255,5738,216328,65,228002
12193,0.013978,172.31.40.0-255,66,216394,65,228002
12194,0.016037,74.125.24.0-255,5738,222132,65,228002
12195,0.016051,172.31.40.0-255,66,222198,65,228002
12196,0.018093,74.125.24.0-255,5738,227936,65,228002
12197,0.018104,172.31.40.0-255,66,228002,65,228002
12198,0.0,172.217.160.0-255,153,153,65,117252
12199,1.6e-05,172.31.40.0-255,66,219,65,117252
12200,2.3e-05,172.217.160.0-255,1484,1703,65,117252
12201,2.8e-05,172.31.40.0-255,66,1769,65,117252
12202,3.4e-05,172.217.160.0-255,2902,4671,65,117252
12203,3.7e-05,172.31.40.0-255,66,4737,65,117252
12204,4.5e-05,172.217.160.0-255,7156,11893,65,117252
12205,5e-05,172.31.40.0-255,66,11959,65,117252
12206,8.5e-05,172.217.160.0-255,4822,16781,65,117252
12207,8.8e-05,172.31.40.0-255,66,16847,65,117252
12208,9.5e-05,172.217.160.0-255,5738,22585,65,117252
12209,9.7e-05,172.31.40.0-255,66,22651,65,117252
12210,0.000139,172.31.40.0-255,66,22717,65,117252
12211,0.000151,172.31.40.0-255,66,22783,65,117252
12212,0.000189,172.217.160.0-255,7156,29939,65,117252
12213,0.000191,172.31.40.0-255,66,30005,65,117252
12214,0.000212,172.217.160.0-255,2184,32189,65,117252
12215,0.000214,172.31.40.0-255,66,32255,65,117252
12216,0.000227,172.31.40.0-255,66,32321,65,117252
12217,0.000754,172.217.160.0-255,371,32692,65,117252
12218,0.000759,172.31.40.0-255,66,32758,65,117252
12219,0.000902,172.217.160.0-255,1484,34242,65,117252
12220,0.000907,172.31.40.0-255,66,34308,65,117252
12221,0.000926,172.217.160.0-255,1484,35792,65,117252
12222,0.000929,172.31.40.0-255,66,35858,65,117252
12223,0.000944,172.217.160.0-255,1484,37342,65,117252
12224,0.000946,172.31.40.0-255,66,37408,65,117252
12225,0.000953,172.217.160.0-255,5738,43146,65,117252
12226,0.000956,172.31.40.0-255,66,43212,65,117252
12227,0.000961,172.217.160.0-255,4320,47532,65,117252
12228,0.000976,172.31.40.0-255,66,47598,65,117252
12229,0.001001,172.217.160.0-255,1484,49082,65,117252
12230,0.001016,172.217.160.0-255,5738,54820,65,117252
12231,0.001024,172.31.40.0-255,66,54886,65,117252
12232,0.001031,172.217.160.0-255,1484,56370,65,117252
12233,0.001045,172.217.160.0-255,2543,58913,65,117252
12234,0.001059,172.31.40.0-255,66,58979,65,117252
12235,0.002658,172.217.160.0-255,1484,60463,65,117252
12236,0.002701,172.217.160.0-255,4320,64783,65,117252
12237,0.002706,172.31.40.0-255,66,64849,65,117252
12238,0.004378,172.217.160.0-255,5738,70587,65,117252
12239,0.005202,172.31.40.0-255,66,70653,65,117252
12240,0.005247,172.31.40.0-255,101,70754,65,117252
12241,0.00685,172.217.160.0-255,5738,76492,65,117252
12242,0.006855,172.31.40.0-255,66,76558,65,117252
12243,0.00686,172.217.160.0-255,66,76624,65,117252
12244,0.008513,172.217.160.0-255,5738,82362,65,117252
12245,0.008519,172.31.40.0-255,66,82428,65,117252
12246,0.010158,172.217.160.0-255,5738,88166,65,117252
12247,0.011378,172.31.40.0-255,66,88232,65,117252
12248,0.013023,172.217.160.0-255,5738,93970,65,117252
12249,0.013034,172.31.40.0-255,66,94036,65,117252
12250,0.014695,172.217.160.0-255,5738,99774,65,117252
12251,0.014704,172.31.40.0-255,66,99840,65,117252
12252,0.016349,172.217.160.0-255,5738,105578,65,117252
12253,0.016357,172.31.40.0-255,66,105644,65,117252
12254,0.018008,172.217.160.0-255,5738,111382,65,117252
12255,0.018016,172.31.40.0-255,66,111448,65,117252
12256,0.019661,172.217.160.0-255,5738,117186,65,117252
12257,0.019668,172.31.40.0-255,66,117252,65,117252
12258,0.0,172.217.194.0-255,153,153,65,220198
12259,2.3e-05,172.31.40.0-255,66,219,65,220198
12260,3.1e-05,172.217.194.0-255,1484,1703,65,220198
12261,3.5e-05,172.31.40.0-255,66,1769,65,220198
12262,3.9e-05,172.217.194.0-255,1484,3253,65,220198
12263,5.3e-05,172.31.40.0-255,66,3319,65,220198
12264,6e-05,172.217.194.0-255,4320,7639,65,220198
12265,6.3e-05,172.31.40.0-255,66,7705,65,220198
12266,9e-05,172.217.194.0-255,6428,14133,65,220198
12267,9.8e-05,172.31.40.0-255,66,14199,65,220198
12268,0.000139,172.217.194.0-255,1484,15683,65,220198
12269,0.000142,172.31.40.0-255,66,15749,65,220198
12270,0.000146,172.217.194.0-255,1484,17233,65,220198
12271,0.000148,172.31.40.0-255,66,17299,65,220198
12272,0.000179,172.217.194.0-255,1484,18783,65,220198
12273,0.000182,172.31.40.0-255,66,18849,65,220198
12274,0.000188,172.217.194.0-255,5738,24587,65,220198
12275,0.000191,172.31.40.0-255,66,24653,65,220198
12276,0.000197,172.217.194.0-255,6797,31450,65,220198
12277,0.0002,172.31.40.0-255,66,31516,65,220198
12278,0.000252,172.31.40.0-255,66,31582,65,220198
12279,0.000257,172.217.194.0-255,2543,34125,65,220198
12280,0.000259,172.31.40.0-255,66,34191,65,220198
12281,0.000284,172.217.194.0-255,1484,35675,65,220198
12282,0.000287,172.31.40.0-255,66,35741,65,220198
12283,0.000292,172.217.194.0-255,2902,38643,65,220198
12284,0.000295,172.31.40.0-255,66,38709,65,220198
12285,0.000322,172.217.194.0-255,5738,44447,65,220198
12286,0.000325,172.31.40.0-255,66,44513,65,220198
12287,0.000358,172.217.194.0-255,7072,51585,65,220198
12288,0.00036,172.31.40.0-255,66,51651,65,220198
12289,0.000363,172.217.194.0-255,433,52084,65,220198
12290,0.000638,172.217.194.0-255,1484,53568,65,220198
12291,0.000645,172.31.40.0-255,66,53634,65,220198
12292,0.00065,172.217.194.0-255,2902,56536,65,220198
12293,0.000652,172.31.40.0-255,66,56602,65,220198
12294,0.000663,172.217.194.0-255,5738,62340,65,220198
12295,0.000666,172.31.40.0-255,66,62406,65,220198
12296,0.000672,172.217.194.0-255,4320,66726,65,220198
12297,0.000677,172.31.40.0-255,66,66792,65,220198
12298,0.000705,172.217.194.0-255,2543,69335,65,220198
12299,0.000708,172.31.40.0-255,66,69401,65,220198
12300,0.000726,172.217.194.0-255,1994,71395,65,220198
12301,0.000732,172.31.40.0-255,66,71461,65,220198
12302,0.000734,172.31.40.0-255,66,71527,65,220198
12303,0.000876,172.217.194.0-255,1484,73011,65,220198
12304,0.000882,172.217.194.0-255,2902,75913,65,220198
12305,0.000886,172.31.40.0-255,66,75979,65,220198
12306,0.00089,172.217.194.0-255,1484,77463,65,220198
12307,0.000915,172.217.194.0-255,4320,81783,65,220198
12308,0.000919,172.31.40.0-255,66,81849,65,220198
12309,0.00095,172.217.194.0-255,6797,88646,65,220198
12310,0.000953,172.31.40.0-255,66,88712,65,220198
12311,0.001226,172.217.194.0-255,1484,90196,65,220198
12312,0.001233,172.217.194.0-255,2902,93098,65,220198
12313,0.001236,172.31.40.0-255,66,93164,65,220198
12314,0.001241,172.217.194.0-255,2902,96066,65,220198
12315,0.001244,172.31.40.0-255,66,96132,65,220198
12316,0.001276,172.217.194.0-255,2902,99034,65,220198
12317,0.001278,172.31.40.0-255,66,99100,65,220198
12318,0.001291,172.31.40.0-255,66,99166,65,220198
12319,0.001297,172.217.194.0-255,4320,103486,65,220198
12320,0.0013,172.31.40.0-255,66,103552,65,220198
12321,0.001328,172.217.194.0-255,6438,109990,65,220198
12322,0.00133,172.31.40.0-255,66,110056,65,220198
12323,0.001386,172.217.194.0-255,1484,111540,65,220198
12324,0.00139,172.217.194.0-255,2902,114442,65,220198
12325,0.001393,172.31.40.0-255,66,114508,65,220198
12326,0.001422,172.217.194.0-255,5738,120246,65,220198
12327,0.001425,172.31.40.0-255,66,120312,65,220198
12328,0.001441,172.31.40.0-255,66,120378,65,220198
12329,0.001485,172.31.40.0-255,66,120444,65,220198
12330,0.001847,172.217.194.0-255,1484,121928,65,220198
12331,0.001854,172.217.194.0-255,2902,124830,65,220198
12332,0.001857,172.31.40.0-255,66,124896,65,220198
12333,0.001863,172.217.194.0-255,4320,129216,65,220198
12334,0.001865,172.31.40.0-255,66,129282,65,220198
12335,0.001887,172.217.194.0-255,1484,130766,65,220198
12336,0.001906,172.31.40.0-255,66,130832,65,220198
12337,0.001913,172.217.194.0-255,5738,136570,65,220198
12338,0.001915,172.31.40.0-255,66,136636,65,220198
12339,0.001946,172.217.194.0-255,5020,141656,65,220198
12340,0.001949,172.31.40.0-255,66,141722,65,220198
12341,0.002057,172.217.194.0-255,1484,143206,65,220198
12342,0.002061,172.217.194.0-255,1484,144690,65,220198
12343,0.002064,172.31.40.0-255,66,144756,65,220198
12344,0.002087,172.217.194.0-255,1484,146240,65,220198
12345,0.002094,172.217.194.0-255,5738,151978,65,220198
12346,0.002097,172.31.40.0-255,66,152044,65,220198
12347,0.002102,172.217.194.0-255,2902,154946,65,220198
12348,0.002104,172.31.40.0-255,66,155012,65,220198
12349,0.002132,172.31.40.0-255,66,155078,65,220198
12350,0.002143,172.31.40.0-255,66,155144,65,220198
12351,0.002178,172.217.194.0-255,2184,157328,65,220198
12352,0.002182,172.31.40.0-255,66,157394,65,220198
12353,0.002186,172.217.194.0-255,2902,160296,65,220198
12354,0.002189,172.31.40.0-255,66,160362,65,220198
12355,0.002196,172.217.194.0-255,7156,167518,65,220198
12356,0.002198,172.31.40.0-255,66,167584,65,220198
12357,0.002242,172.31.40.0-255,66,167650,65,220198
12358,0.002245,172.217.194.0-255,1484,169134,65,220198
12359,0.002272,172.217.194.0-255,6438,175572,65,220198
12360,0.002274,172.31.40.0-255,66,175638,65,220198
12361,0.002405,172.217.194.0-255,1484,177122,65,220198
12362,0.002411,172.217.194.0-255,2902,180024,65,220198
12363,0.002414,172.31.40.0-255,66,180090,65,220198
12364,0.002439,172.217.194.0-255,5738,185828,65,220198
12365,0.002442,172.31.40.0-255,66,185894,65,220198
12366,0.002487,172.31.40.0-255,66,185960,65,220198
12367,0.002503,172.31.40.0-255,66,186026,65,220198
12368,0.002506,172.217.194.0-255,766,186792,65,220198
12369,0.004994,172.217.194.0-255,4320,191112,65,220198
12370,0.005012,172.31.40.0-255,66,191178,65,220198
12371,0.007519,172.217.194.0-255,5738,196916,65,220198
12372,0.007536,172.31.40.0-255,66,196982,65,220198
12373,0.010059,172.217.194.0-255,5738,202720,65,220198
12374,0.010069,172.31.40.0-255,66,202786,65,220198
12375,0.012546,172.217.194.0-255,5738,208524,65,220198
12376,0.012551,172.31.40.0-255,66,208590,65,220198
12377,0.015037,172.217.194.0-255,5738,214328,65,220198
12378,0.015044,172.31.40.0-255,66,214394,65,220198
12379,0.017555,172.217.194.0-255,5738,220132,65,220198
12380,0.017574,172.31.40.0-255,66,220198,65,220198
12381,0.0,74.125.24.0-255,153,153,65,231432
12382,2.4e-05,172.31.40.0-255,66,219,65,231432
12383,3.1e-05,74.125.24.0-255,1484,1703,65,231432
12384,3.6e-05,172.31.40.0-255,66,1769,65,231432
12385,4.1e-05,74.125.24.0-255,2902,4671,65,231432
12386,4.5e-05,172.31.40.0-255,66,4737,65,231432
12387,5.3e-05,74.125.24.0-255,7156,11893,65,231432
12388,5.6e-05,172.31.40.0-255,66,11959,65,231432
12389,0.000107,74.125.24.0-255,4320,16279,65,231432
12390,0.00011,172.31.40.0-255,66,16345,65,231432
12391,0.000132,74.125.24.0-255,3445,19790,65,231432
12392,0.000135,172.31.40.0-255,66,19856,65,231432
12393,0.000187,74.125.24.0-255,4320,24176,65,231432
12394,0.00019,172.31.40.0-255,66,24242,65,231432
12395,0.000205,74.125.24.0-255,4320,28562,65,231432
12396,0.000207,172.31.40.0-255,66,28628,65,231432
12397,0.000271,74.125.24.0-255,2543,31171,65,231432
12398,0.000274,172.31.40.0-255,66,31237,65,231432
12399,0.000296,74.125.24.0-255,2902,34139,65,231432
12400,0.000299,172.31.40.0-255,66,34205,65,231432
12401,0.00034,74.125.24.0-255,4320,38525,65,231432
12402,0.000343,172.31.40.0-255,66,38591,65,231432
12403,0.00037,74.125.24.0-255,4320,42911,65,231432
12404,0.000372,172.31.40.0-255,66,42977,65,231432
12405,0.000393,74.125.24.0-255,4320,47297,65,231432
12406,0.000395,172.31.40.0-255,66,47363,65,231432
12407,0.000449,74.125.24.0-255,2902,50265,65,231432
12408,0.000452,172.31.40.0-255,66,50331,65,231432
12409,0.000471,74.125.24.0-255,6797,57128,65,231432
12410,0.000474,172.31.40.0-255,66,57194,65,231432
12411,0.000551,74.125.24.0-255,4320,61514,65,231432
12412,0.000556,172.31.40.0-255,66,61580,65,231432
12413,0.000576,74.125.24.0-255,4294,65874,65,231432
12414,0.000579,172.31.40.0-255,66,65940,65,231432
12415,0.000616,74.125.24.0-255,344,66284,65,231432
12416,0.000646,74.125.24.0-255,1484,67768,65,231432
12417,0.000649,172.31.40.0-255,66,67834,65,231432
12418,0.000653,74.125.24.0-255,1484,69318,65,231432
12419,0.000672,74.125.24.0-255,2902,72220,65,231432
12420,0.000675,172.31.40.0-255,66,72286,65,231432
12421,0.000693,74.125.24.0-255,1484,73770,65,231432
12422,0.000723,172.31.40.0-255,66,73836,65,231432
12423,0.000801,74.125.24.0-255,4320,78156,65,231432
12424,0.000805,172.31.40.0-255,66,78222,65,231432
12425,0.000834,172.31.40.0-255,66,78288,65,231432
12426,0.000929,74.125.24.0-255,5020,83308,65,231432
12427,0.000933,172.31.40.0-255,66,83374,65,231432
12428,0.001055,74.125.24.0-255,1484,84858,65,231432
12429,0.001062,74.125.24.0-255,2902,87760,65,231432
12430,0.001066,172.31.40.0-255,66,87826,65,231432
12431,0.00109,74.125.24.0-255,5738,93564,65,231432
12432,0.001093,172.31.40.0-255,66,93630,65,231432
12433,0.001144,74.125.24.0-255,5738,99368,65,231432
12434,0.001147,172.31.40.0-255,66,99434,65,231432
12435,0.001172,74.125.24.0-255,7156,106590,65,231432
12436,0.001176,172.31.40.0-255,66,106656,65,231432
12437,0.001269,74.125.24.0-255,5738,112394,65,231432
12438,0.001278,172.31.40.0-255,66,112460,65,231432
12439,0.001284,74.125.24.0-255,2902,115362,65,231432
12440,0.001286,172.31.40.0-255,66,115428,65,231432
12441,0.001349,74.125.24.0-255,2184,117612,65,231432
12442,0.001352,172.31.40.0-255,66,117678,65,231432
12443,0.001385,74.125.24.0-255,2902,120580,65,231432
12444,0.001387,172.31.40.0-255,66,120646,65,231432
12445,0.001406,74.125.24.0-255,7156,127802,65,231432
12446,0.00141,172.31.40.0-255,66,127868,65,231432
12447,0.001474,74.125.24.0-255,4320,132188,65,231432
12448,0.001478,172.31.40.0-255,66,132254,65,231432
12449,0.001505,74.125.24.0-255,5738,137992,65,231432
12450,0.001507,172.31.40.0-255,66,138058,65,231432
12451,0.001581,74.125.24.0-255,7156,145214,65,231432
12452,0.001585,172.31.40.0-255,66,145280,65,231432
12453,0.001605,74.125.24.0-255,6438,151718,65,231432
12454,0.001607,172.31.40.0-255,66,151784,65,231432
12455,0.001962,74.125.24.0-255,1484,153268,65,231432
12456,0.001965,74.125.24.0-255,1484,154752,65,231432
12457,0.001972,172.31.40.0-255,66,154818,65,231432
12458,0.001982,74.125.24.0-255,1484,156302,65,231432
12459,0.002017,74.125.24.0-255,5738,162040,65,231432
12460,0.00202,172.31.40.0-255,66,162106,65,231432
12461,0.002056,74.125.24.0-255,5738,167844,65,231432
12462,0.002059,172.31.40.0-255,66,167910,65,231432
12463,0.002085,74.125.24.0-255,7156,175066,65,231432
12464,0.002088,172.31.40.0-255,66,175132,65,231432
12465,0.002162,74.125.24.0-255,1484,176616,65,231432
12466,0.002189,74.125.24.0-255,4320,180936,65,231432
12467,0.002194,172.31.40.0-255,66,181002,65,231432
12468,0.002207,74.125.24.0-255,5020,186022,65,231432
12469,0.00221,172.31.40.0-255,66,186088,65,231432
12470,0.002279,74.125.24.0-255,4320,190408,65,231432
12471,0.002282,172.31.40.0-255,66,190474,65,231432
12472,0.002312,172.31.40.0-255,66,190540,65,231432
12473,0.00242,172.31.40.0-255,66,190606,65,231432
12474,0.002501,74.125.24.0-255,1484,192090,65,231432
12475,0.002532,172.31.40.0-255,66,192156,65,231432
12476,0.004884,74.125.24.0-255,4320,196476,65,231432
12477,0.004891,172.31.40.0-255,66,196542,65,231432
12478,0.004912,74.125.24.0-255,1484,198026,65,231432
12479,0.007214,74.125.24.0-255,4320,202346,65,231432
12480,0.00722,172.31.40.0-255,66,202412,65,231432
12481,0.009561,74.125.24.0-255,5738,208150,65,231432
12482,0.009568,172.31.40.0-255,66,208216,65,231432
12483,0.011952,74.125.24.0-255,5738,213954,65,231432
12484,0.011971,172.31.40.0-255,66,214020,65,231432
12485,0.014325,74.125.24.0-255,5738,219758,65,231432
12486,0.014341,172.31.40.0-255,66,219824,65,231432
12487,0.016683,74.125.24.0-255,5738,225562,65,231432
12488,0.016699,172.31.40.0-255,66,225628,65,231432
12489,0.019035,74.125.24.0-255,5738,231366,65,231432
12490,0.019044,172.31.40.0-255,66,231432,65,231432
12491,0.0,74.125.24.0-255,160,160,65,152725
12492,1.8e-05,172.31.40.0-255,66,226,65,152725
12493,3.5e-05,74.125.24.0-255,1484,1710,65,152725
12494,4.1e-05,172.31.40.0-255,66,1776,65,152725
12495,4.7e-05,74.125.24.0-255,2902,4678,65,152725
12496,5e-05,172.31.40.0-255,66,4744,65,152725
12497,7.3e-05,74.125.24.0-255,7156,11900,65,152725
12498,7.6e-05,172.31.40.0-255,66,11966,65,152725
12499,8e-05,74.125.24.0-255,1901,13867,65,152725
12500,8.3e-05,172.31.40.0-255,66,13933,65,152725
12501,0.000147,74.125.24.0-255,5738,19671,65,152725
12502,0.00015,172.31.40.0-255,66,19737,65,152725
12503,0.000173,74.125.24.0-255,5738,25475,65,152725
12504,0.000176,172.31.40.0-255,66,25541,65,152725
12505,0.000182,74.125.24.0-255,5379,30920,65,152725
12506,0.000185,172.31.40.0-255,66,30986,65,152725
12507,0.000292,74.125.24.0-255,1484,32470,65,152725
12508,0.000296,172.31.40.0-255,66,32536,65,152725
12509,0.000302,74.125.24.0-255,2902,35438,65,152725
12510,0.000304,172.31.40.0-255,66,35504,65,152725
12511,0.000325,74.125.24.0-255,5738,41242,65,152725
12512,0.000328,172.31.40.0-255,66,41308,65,152725
12513,0.000333,74.125.24.0-255,4320,45628,65,152725
12514,0.000335,172.31.40.0-255,66,45694,65,152725
12515,0.000382,172.31.40.0-255,66,45760,65,152725
12516,0.000389,74.125.24.0-255,5738,51498,65,152725
12517,0.000391,172.31.40.0-255,66,51564,65,152725
12518,0.000411,74.125.24.0-255,1437,53001,65,152725
12519,0.000414,172.31.40.0-255,66,53067,65,152725
12520,0.000951,74.125.24.0-255,110,53177,65,152725
12521,0.000956,172.31.40.0-255,66,53243,65,152725
12522,0.001086,74.125.24.0-255,1484,54727,65,152725
12523,0.001093,74.125.24.0-255,1484,56211,65,152725
12524,0.001096,172.31.40.0-255,66,56277,65,152725
12525,0.001115,74.125.24.0-255,1484,57761,65,152725
12526,0.001129,74.125.24.0-255,2902,60663,65,152725
12527,0.001149,74.125.24.0-255,2902,63565,65,152725
12528,0.001168,74.125.24.0-255,4320,67885,65,152725
12529,0.001182,74.125.24.0-255,2543,70428,65,152725
12530,0.001207,74.125.24.0-255,5738,76166,65,152725
12531,0.001212,74.125.24.0-255,2543,78709,65,152725
12532,0.001483,74.125.24.0-255,1484,80193,65,152725
12533,0.001497,74.125.24.0-255,1484,81677,65,152725
12534,0.001513,74.125.24.0-255,1484,83161,65,152725
12535,0.001517,74.125.24.0-255,2902,86063,65,152725
12536,0.001543,74.125.24.0-255,2902,88965,65,152725
12537,0.001558,74.125.24.0-255,7156,96121,65,152725
12538,0.001578,74.125.24.0-255,2902,99023,65,152725
12539,0.001584,74.125.24.0-255,5020,104043,65,152725
12540,0.002274,74.125.24.0-255,1484,105527,65,152725
12541,0.002282,74.125.24.0-255,2902,108429,65,152725
12542,0.002293,74.125.24.0-255,1484,109913,65,152725
12543,0.002305,74.125.24.0-255,2902,112815,65,152725
12544,0.002322,74.125.24.0-255,1484,114299,65,152725
12545,0.002325,74.125.24.0-255,1484,115783,65,152725
12546,0.002351,74.125.24.0-255,5738,121521,65,152725
12547,0.002376,74.125.24.0-255,5738,127259,65,152725
12548,0.002393,74.125.24.0-255,2184,129443,65,152725
12549,0.007282,172.31.40.0-255,66,129509,65,152725
12550,0.009719,74.125.24.0-255,5738,135247,65,152725
12551,0.009729,172.31.40.0-255,66,135313,65,152725
12552,0.012089,74.125.24.0-255,5738,141051,65,152725
12553,0.012098,172.31.40.0-255,66,141117,65,152725
12554,0.014471,74.125.24.0-255,5738,146855,65,152725
12555,0.016048,172.31.40.0-255,66,146921,65,152725
12556,0.018408,74.125.24.0-255,5738,152659,65,152725
12557,0.018429,172.31.40.0-255,66,152725,65,152725
12558,0.0,172.217.194.0-255,157,157,65,200001
12559,1.3e-05,172.31.40.0-255,66,223,65,200001
12560,2e-05,172.217.194.0-255,1484,1707,65,200001
12561,2.4e-05,172.31.40.0-255,66,1773,65,200001
12562,3e-05,172.217.194.0-255,2902,4675,65,200001
12563,3.9e-05,172.31.40.0-255,66,4741,65,200001
12564,4.6e-05,172.217.194.0-255,7156,11897,65,200001
12565,4.9e-05,172.31.40.0-255,66,11963,65,200001
12566,7.9e-05,172.217.194.0-255,1965,13928,65,200001
12567,8.1e-05,172.31.40.0-255,66,13994,65,200001
12568,9.6e-05,172.217.194.0-255,4320,18314,65,200001
12569,0.000102,172.31.40.0-255,66,18380,65,200001
12570,0.000124,172.217.194.0-255,7156,25536,65,200001
12571,0.000127,172.31.40.0-255,66,25602,65,200001
12572,0.000132,172.217.194.0-255,5379,30981,65,200001
12573,0.000134,172.31.40.0-255,66,31047,65,200001
12574,0.000173,172.217.194.0-255,5738,36785,65,200001
12575,0.000175,172.31.40.0-255,66,36851,65,200001
12576,0.000214,172.31.40.0-255,66,36917,65,200001
12577,0.000216,172.217.194.0-255,1484,38401,65,200001
12578,0.000218,172.31.40.0-255,66,38467,65,200001
12579,0.000243,172.217.194.0-255,1484,39951,65,200001
12580,0.000247,172.31.40.0-255,66,40017,65,200001
12581,0.000256,172.217.194.0-255,1484,41501,65,200001
12582,0.000258,172.31.40.0-255,66,41567,65,200001
12583,0.000268,172.217.194.0-255,5738,47305,65,200001
12584,0.00027,172.31.40.0-255,66,47371,65,200001
12585,0.000315,172.217.194.0-255,2902,50273,65,200001
12586,0.000318,172.31.40.0-255,66,50339,65,200001
12587,0.000342,172.217.194.0-255,4239,54578,65,200001
12588,0.000345,172.31.40.0-255,66,54644,65,200001
12589,0.000429,172.217.194.0-255,118,54762,65,200001
12590,0.000516,172.217.194.0-255,1484,56246,65,200001
12591,0.00052,172.31.40.0-255,66,56312,65,200001
12592,0.000526,172.217.194.0-255,2902,59214,65,200001
12593,0.000528,172.31.40.0-255,66,59280,65,200001
12594,0.000539,172.217.194.0-255,5738,65018,65,200001
12595,0.000541,172.31.40.0-255,66,65084,65,200001
12596,0.000583,172.31.40.0-255,66,65150,65,200001
12597,0.000593,172.31.40.0-255,66,65216,65,200001
12598,0.000596,172.217.194.0-255,379,65595,65,200001
12599,0.000827,172.217.194.0-255,1484,67079,65,200001
12600,0.000832,172.31.40.0-255,66,67145,65,200001
12601,0.000839,172.217.194.0-255,2902,70047,65,200001
12602,0.000841,172.31.40.0-255,66,70113,65,200001
12603,0.000843,172.217.194.0-255,1484,71597,65,200001
12604,0.000868,172.217.194.0-255,4320,75917,65,200001
12605,0.000871,172.31.40.0-255,66,75983,65,200001
12606,0.000877,172.217.194.0-255,5738,81721,65,200001
12607,0.000879,172.31.40.0-255,66,81787,65,200001
12608,0.000902,172.217.194.0-255,7156,88943,65,200001
12609,0.000904,172.31.40.0-255,66,89009,65,200001
12610,0.000914,172.31.40.0-255,66,89075,65,200001
12611,0.000937,172.217.194.0-255,2184,91259,65,200001
12612,0.00094,172.31.40.0-255,66,91325,65,200001
12613,0.00104,172.217.194.0-255,1484,92809,65,200001
12614,0.001044,172.217.194.0-255,1484,94293,65,200001
12615,0.001046,172.31.40.0-255,66,94359,65,200001
12616,0.001067,172.217.194.0-255,1484,95843,65,200001
12617,0.001073,172.217.194.0-255,5738,101581,65,200001
12618,0.001075,172.31.40.0-255,66,101647,65,200001
12619,0.001078,172.217.194.0-255,1484,103131,65,200001
12620,0.001107,172.31.40.0-255,66,103197,65,200001
12621,0.001141,172.217.194.0-255,2902,106099,65,200001
12622,0.001144,172.31.40.0-255,66,106165,65,200001
12623,0.001168,172.31.40.0-255,66,106231,65,200001
12624,0.001471,172.217.194.0-255,1484,107715,65,200001
12625,0.001476,172.217.194.0-255,2902,110617,65,200001
12626,0.001479,172.31.40.0-255,66,110683,65,200001
12627,0.001485,172.217.194.0-255,5738,116421,65,200001
12628,0.001486,172.31.40.0-255,66,116487,65,200001
12629,0.001491,172.217.194.0-255,2902,119389,65,200001
12630,0.001496,172.31.40.0-255,66,119455,65,200001
12631,0.001522,172.217.194.0-255,2902,122357,65,200001
12632,0.001524,172.31.40.0-255,66,122423,65,200001
12633,0.001537,172.31.40.0-255,66,122489,65,200001
12634,0.001571,172.217.194.0-255,5020,127509,65,200001
12635,0.001574,172.31.40.0-255,66,127575,65,200001
12636,0.001755,172.217.194.0-255,1484,129059,65,200001
12637,0.001761,172.217.194.0-255,2902,131961,65,200001
12638,0.001763,172.31.40.0-255,66,132027,65,200001
12639,0.001768,172.217.194.0-255,4320,136347,65,200001
12640,0.00177,172.31.40.0-255,66,136413,65,200001
12641,0.001806,172.217.194.0-255,1484,137897,65,200001
12642,0.001819,172.31.40.0-255,66,137963,65,200001
12643,0.001831,172.31.40.0-255,66,138029,65,200001
12644,0.001896,172.217.194.0-255,1484,139513,65,200001
12645,0.001901,172.217.194.0-255,2902,142415,65,200001
12646,0.001903,172.31.40.0-255,66,142481,65,200001
12647,0.00193,172.217.194.0-255,5738,148219,65,200001
12648,0.001933,172.31.40.0-255,66,148285,65,200001
12649,0.001936,172.217.194.0-255,1484,149769,65,200001
12650,0.001971,172.217.194.0-255,4320,154089,65,200001
12651,0.001975,172.31.40.0-255,66,154155,65,200001
12652,0.001977,172.31.40.0-255,66,154221,65,200001
12653,0.001992,172.217.194.0-255,6438,160659,65,200001
12654,0.001999,172.31.40.0-255,66,160725,65,200001
12655,0.004309,172.217.194.0-255,5738,166463,65,200001
12656,0.00432,172.31.40.0-255,66,166529,65,200001
12657,0.006606,172.217.194.0-255,5738,172267,65,200001
12658,0.006614,172.31.40.0-255,66,172333,65,200001
12659,0.008952,172.217.194.0-255,4320,176653,65,200001
12660,0.008957,172.31.40.0-255,66,176719,65,200001
12661,0.008981,172.217.194.0-255,1484,178203,65,200001
12662,0.011274,172.217.194.0-255,4320,182523,65,200001
12663,0.011284,172.31.40.0-255,66,182589,65,200001
12664,0.013609,172.217.194.0-255,5738,188327,65,200001
12665,0.013624,172.31.40.0-255,66,188393,65,200001
12666,0.01595,172.217.194.0-255,5738,194131,65,200001
12667,0.015964,172.31.40.0-255,66,194197,65,200001
12668,0.01829,172.217.194.0-255,5738,199935,65,200001
12669,0.018298,172.31.40.0-255,66,200001,65,200001
12670,0.0,74.125.24.0-255,153,153,65,216159
12671,2.2e-05,172.31.40.0-255,66,219,65,216159
12672,2.9e-05,74.125.24.0-255,1484,1703,65,216159
12673,3.3e-05,172.31.40.0-255,66,1769,65,216159
12674,3.9e-05,74.125.24.0-255,2902,4671,65,216159
12675,4.2e-05,172.31.40.0-255,66,4737,65,216159
12676,5e-05,74.125.24.0-255,7156,11893,65,216159
12677,5.3e-05,172.31.40.0-255,66,11959,65,216159
12678,5.8e-05,74.125.24.0-255,1976,13935,65,216159
12679,6e-05,172.31.40.0-255,66,14001,65,216159
12680,6.6e-05,74.125.24.0-255,2902,16903,65,216159
12681,6.9e-05,172.31.40.0-255,66,16969,65,216159
12682,7.3e-05,74.125.24.0-255,2902,19871,65,216159
12683,7.5e-05,172.31.40.0-255,66,19937,65,216159
12684,9.5e-05,74.125.24.0-255,4320,24257,65,216159
12685,9.8e-05,172.31.40.0-255,66,24323,65,216159
12686,0.000106,74.125.24.0-255,6797,31120,65,216159
12687,0.000108,172.31.40.0-255,66,31186,65,216159
12688,0.000162,74.125.24.0-255,1484,32670,65,216159
12689,0.000165,172.31.40.0-255,66,32736,65,216159
12690,0.000178,74.125.24.0-255,2902,35638,65,216159
12691,0.000181,172.31.40.0-255,66,35704,65,216159
12692,0.000184,74.125.24.0-255,1484,37188,65,216159
12693,0.000186,172.31.40.0-255,66,37254,65,216159
12694,0.000203,74.125.24.0-255,4320,41574,65,216159
12695,0.000205,172.31.40.0-255,66,41640,65,216159
12696,0.000211,74.125.24.0-255,5738,47378,65,216159
12697,0.000213,172.31.40.0-255,66,47444,65,216159
12698,0.000254,74.125.24.0-255,3961,51405,65,216159
12699,0.000257,172.31.40.0-255,66,51471,65,216159
12700,0.000262,74.125.24.0-255,4320,55791,65,216159
12701,0.000264,172.31.40.0-255,66,55857,65,216159
12702,0.00028,74.125.24.0-255,2902,58759,65,216159
12703,0.000283,172.31.40.0-255,66,58825,65,216159
12704,0.000304,74.125.24.0-255,6797,65622,65,216159
12705,0.000309,74.125.24.0-255,364,65986,65,216159
12706,0.000471,172.31.40.0-255,66,66052,65,216159
12707,0.000476,74.125.24.0-255,130,66182,65,216159
12708,0.000585,74.125.24.0-255,1484,67666,65,216159
12709,0.000603,172.31.40.0-255,66,67732,65,216159
12710,0.000615,74.125.24.0-255,2902,70634,65,216159
12711,0.000621,74.125.24.0-255,5738,76372,65,216159
12712,0.000632,172.31.40.0-255,66,76438,65,216159
12713,0.000666,74.125.24.0-255,7156,83594,65,216159
12714,0.000671,172.31.40.0-255,66,83660,65,216159
12715,0.00069,74.125.24.0-255,5379,89039,65,216159
12716,0.000704,74.125.24.0-255,1484,90523,65,216159
12717,0.000708,172.31.40.0-255,66,90589,65,216159
12718,0.000805,74.125.24.0-255,5379,95968,65,216159
12719,0.000946,74.125.24.0-255,1484,97452,65,216159
12720,0.000951,74.125.24.0-255,1484,98936,65,216159
12721,0.000966,74.125.24.0-255,1484,100420,65,216159
12722,0.000983,74.125.24.0-255,5738,106158,65,216159
12723,0.000989,74.125.24.0-255,4320,110478,65,216159
12724,0.001218,74.125.24.0-255,1484,111962,65,216159
12725,0.001225,74.125.24.0-255,2902,114864,65,216159
12726,0.001232,74.125.24.0-255,5738,120602,65,216159
12727,0.001255,74.125.24.0-255,4320,124922,65,216159
12728,0.001284,74.125.24.0-255,5738,130660,65,216159
12729,0.001317,74.125.24.0-255,5020,135680,65,216159
12730,0.001425,74.125.24.0-255,1484,137164,65,216159
12731,0.001432,74.125.24.0-255,2902,140066,65,216159
12732,0.001439,74.125.24.0-255,5738,145804,65,216159
12733,0.001457,74.125.24.0-255,4320,150124,65,216159
12734,0.001485,74.125.24.0-255,7156,157280,65,216159
12735,0.001522,74.125.24.0-255,3602,160882,65,216159
12736,0.001631,74.125.24.0-255,1484,162366,65,216159
12737,0.001644,74.125.24.0-255,1484,163850,65,216159
12738,0.001661,74.125.24.0-255,1484,165334,65,216159
12739,0.001667,74.125.24.0-255,5738,171072,65,216159
12740,0.001684,172.31.40.0-255,66,171138,65,216159
12741,0.001714,74.125.24.0-255,2902,174040,65,216159
12742,0.001727,74.125.24.0-255,2184,176224,65,216159
12743,0.001747,74.125.24.0-255,5738,181962,65,216159
12744,0.00175,74.125.24.0-255,1484,183446,65,216159
12745,0.001782,74.125.24.0-255,4320,187766,65,216159
12746,0.001787,172.31.40.0-255,66,187832,65,216159
12747,0.001793,172.31.40.0-255,66,187898,65,216159
12748,0.001804,74.125.24.0-255,4320,192218,65,216159
12749,0.001826,74.125.24.0-255,5738,197956,65,216159
12750,0.001841,74.125.24.0-255,3602,201558,65,216159
12751,0.001859,74.125.24.0-255,1484,203042,65,216159
12752,0.001863,74.125.24.0-255,1484,204526,65,216159
12753,0.00187,172.31.40.0-255,66,204592,65,216159
12754,0.001911,172.31.40.0-255,66,204658,65,216159
12755,0.001951,172.31.40.0-255,66,204724,65,216159
12756,0.002036,74.125.24.0-255,5020,209744,65,216159
12757,0.00207,172.31.40.0-255,66,209810,65,216159
12758,0.002079,74.125.24.0-255,2902,212712,65,216159
12759,0.002087,172.31.40.0-255,66,212778,65,216159
12760,0.002152,74.125.24.0-255,2385,215163,65,216159
12761,0.002156,74.125.24.0-255,105,215268,65,216159
12762,0.002158,74.125.24.0-255,129,215397,65,216159
12763,0.002166,172.31.40.0-255,66,215463,65,216159
12764,0.016206,172.31.40.0-255,105,215568,65,216159
12765,0.016257,172.31.40.0-255,105,215673,65,216159
12766,0.016476,172.31.40.0-255,90,215763,65,216159
12767,0.016487,172.31.40.0-255,66,215829,65,216159
12768,0.018708,74.125.24.0-255,66,215895,65,216159
12769,0.018758,74.125.24.0-255,66,215961,65,216159
12770,0.01897,74.125.24.0-255,66,216027,65,216159
12771,0.019015,74.125.24.0-255,66,216093,65,216159
12772,0.019021,172.31.40.0-255,66,216159,65,216159
12773,0.0,74.125.24.0-255,147,147,65,187367
12774,2.4e-05,172.31.40.0-255,66,213,65,187367
12775,3.1e-05,74.125.24.0-255,1484,1697,65,187367
12776,3.5e-05,172.31.40.0-255,66,1763,65,187367
12777,4e-05,74.125.24.0-255,2902,4665,65,187367
12778,5.1e-05,172.31.40.0-255,66,4731,65,187367
12779,5.8e-05,74.125.24.0-255,7156,11887,65,187367
12780,6.1e-05,172.31.40.0-255,66,11953,65,187367
12781,6.4e-05,74.125.24.0-255,1484,13437,65,187367
12782,6.6e-05,172.31.40.0-255,66,13503,65,187367
12783,8.1e-05,74.125.24.0-255,565,14068,65,187367
12784,8.4e-05,172.31.40.0-255,66,14134,65,187367
12785,0.000111,74.125.24.0-255,2902,17036,65,187367
12786,0.000114,172.31.40.0-255,66,17102,65,187367
12787,0.000119,74.125.24.0-255,5738,22840,65,187367
12788,0.000122,172.31.40.0-255,66,22906,65,187367
12789,0.000138,74.125.24.0-255,1484,24390,65,187367
12790,0.00014,172.31.40.0-255,66,24456,65,187367
12791,0.000146,74.125.24.0-255,1484,25940,65,187367
12792,0.000148,172.31.40.0-255,66,26006,65,187367
12793,0.000187,74.125.24.0-255,5738,31744,65,187367
12794,0.000189,172.31.40.0-255,66,31810,65,187367
12795,0.000224,172.31.40.0-255,66,31876,65,187367
12796,0.000227,74.125.24.0-255,1484,33360,65,187367
12797,0.000229,172.31.40.0-255,66,33426,65,187367
12798,0.000234,74.125.24.0-255,4320,37746,65,187367
12799,0.000236,172.31.40.0-255,66,37812,65,187367
12800,0.000273,74.125.24.0-255,5379,43191,65,187367
12801,0.000275,172.31.40.0-255,66,43257,65,187367
12802,0.000286,172.31.40.0-255,66,43323,65,187367
12803,0.000294,74.125.24.0-255,2543,45866,65,187367
12804,0.000295,172.31.40.0-255,66,45932,65,187367
12805,0.000318,74.125.24.0-255,677,46609,65,187367
12806,0.000415,74.125.24.0-255,1484,48093,65,187367
12807,0.000419,172.31.40.0-255,66,48159,65,187367
12808,0.000438,74.125.24.0-255,2902,51061,65,187367
12809,0.000441,172.31.40.0-255,66,51127,65,187367
12810,0.000445,74.125.24.0-255,2902,54029,65,187367
12811,0.000446,172.31.40.0-255,66,54095,65,187367
12812,0.000467,74.125.24.0-255,2902,56997,65,187367
12813,0.000469,172.31.40.0-255,66,57063,65,187367
12814,0.000473,74.125.24.0-255,2902,59965,65,187367
12815,0.000475,172.31.40.0-255,66,60031,65,187367
12816,0.000519,172.31.40.0-255,66,60097,65,187367
12817,0.000529,172.31.40.0-255,66,60163,65,187367
12818,0.000968,74.125.24.0-255,1484,61647,65,187367
12819,0.000984,74.125.24.0-255,2902,64549,65,187367
12820,0.000988,172.31.40.0-255,66,64615,65,187367
12821,0.001022,74.125.24.0-255,5738,70353,65,187367
12822,0.001025,74.125.24.0-255,1484,71837,65,187367
12823,0.001028,172.31.40.0-255,66,71903,65,187367
12824,0.001051,74.125.24.0-255,1484,73387,65,187367
12825,0.001053,172.31.40.0-255,66,73453,65,187367
12826,0.001064,172.31.40.0-255,66,73519,65,187367
12827,0.001102,172.31.40.0-255,66,73585,65,187367
12828,0.001127,74.125.24.0-255,7156,80741,65,187367
12829,0.00113,172.31.40.0-255,66,80807,65,187367
12830,0.001135,74.125.24.0-255,4320,85127,65,187367
12831,0.001138,172.31.40.0-255,66,85193,65,187367
12832,0.001162,74.125.24.0-255,4320,89513,65,187367
12833,0.001164,172.31.40.0-255,66,89579,65,187367
12834,0.001171,74.125.24.0-255,7156,96735,65,187367
12835,0.001173,172.31.40.0-255,66,96801,65,187367
12836,0.001201,172.31.40.0-255,66,96867,65,187367
12837,0.001206,74.125.24.0-255,4320,101187,65,187367
12838,0.001208,172.31.40.0-255,66,101253,65,187367
12839,0.001249,74.125.24.0-255,2184,103437,65,187367
12840,0.001252,172.31.40.0-255,66,103503,65,187367
12841,0.001276,172.31.40.0-255,66,103569,65,187367
12842,0.001279,74.125.24.0-255,2184,105753,65,187367
12843,0.001282,172.31.40.0-255,66,105819,65,187367
12844,0.001329,74.125.24.0-255,1484,107303,65,187367
12845,0.001334,74.125.24.0-255,2902,110205,65,187367
12846,0.001337,172.31.40.0-255,66,110271,65,187367
12847,0.001341,74.125.24.0-255,2902,113173,65,187367
12848,0.001342,172.31.40.0-255,66,113239,65,187367
12849,0.001362,74.125.24.0-255,2902,116141,65,187367
12850,0.001364,172.31.40.0-255,66,116207,65,187367
12851,0.001372,74.125.24.0-255,7156,123363,65,187367
12852,0.001373,172.31.40.0-255,66,123429,65,187367
12853,0.001398,74.125.24.0-255,5738,129167,65,187367
12854,0.001404,172.31.40.0-255,66,129233,65,187367
12855,0.001436,74.125.24.0-255,5738,134971,65,187367
12856,0.00144,172.31.40.0-255,66,135037,65,187367
12857,0.001467,74.125.24.0-255,5020,140057,65,187367
12858,0.00147,172.31.40.0-255,66,140123,65,187367
12859,0.001492,172.31.40.0-255,66,140189,65,187367
12860,0.001518,74.125.24.0-255,2902,143091,65,187367
12861,0.001521,172.31.40.0-255,66,143157,65,187367
12862,0.00154,172.31.40.0-255,66,143223,65,187367
12863,0.001561,74.125.24.0-255,7156,150379,65,187367
12864,0.001565,74.125.24.0-255,3602,153981,65,187367
12865,0.00157,172.31.40.0-255,66,154047,65,187367
12866,0.001573,172.31.40.0-255,66,154113,65,187367
12867,0.00165,74.125.24.0-255,1484,155597,65,187367
12868,0.001667,74.125.24.0-255,2902,158499,65,187367
12869,0.00167,172.31.40.0-255,66,158565,65,187367
12870,0.001676,74.125.24.0-255,5738,164303,65,187367
12871,0.001678,172.31.40.0-255,66,164369,65,187367
12872,0.001728,172.31.40.0-255,66,164435,65,187367
12873,0.001744,172.31.40.0-255,66,164501,65,187367
12874,0.001795,74.125.24.0-255,1484,165985,65,187367
12875,0.00181,74.125.24.0-255,2902,168887,65,187367
12876,0.001812,172.31.40.0-255,66,168953,65,187367
12877,0.001816,74.125.24.0-255,2902,171855,65,187367
12878,0.001818,172.31.40.0-255,66,171921,65,187367
12879,0.001838,74.125.24.0-255,1484,173405,65,187367
12880,0.001851,172.31.40.0-255,66,173471,65,187367
12881,0.00189,172.31.40.0-255,66,173537,65,187367
12882,0.002055,74.125.24.0-255,1484,175021,65,187367
12883,0.002062,74.125.24.0-255,2902,177923,65,187367
12884,0.002065,172.31.40.0-255,66,177989,65,187367
12885,0.002072,74.125.24.0-255,5738,183727,65,187367
12886,0.002074,172.31.40.0-255,66,183793,65,187367
12887,0.00211,172.31.40.0-255,66,183859,65,187367
12888,0.002137,74.125.24.0-255,2902,186761,65,187367
12889,0.00214,172.31.40.0-255,66,186827,65,187367
12890,0.002157,172.31.40.0-255,66,186893,65,187367
12891,0.002199,172.31.40.0-255,66,186959,65,187367
12892,0.002235,172.31.40.0-255,66,187025,65,187367
12893,0.002261,74.125.24.0-255,105,187130,65,187367
12894,0.004928,172.31.40.0-255,66,187196,65,187367
12895,0.004967,172.31.40.0-255,105,187301,65,187367
12896,0.007476,74.125.24.0-255,66,187367,65,187367
12897,0.0,172.217.194.0-255,147,147,65,180635
12898,2.3e-05,172.31.40.0-255,66,213,65,180635
12899,3e-05,172.217.194.0-255,1484,1697,65,180635
12900,3.4e-05,172.31.40.0-255,66,1763,65,180635
12901,4.8e-05,172.217.194.0-255,2902,4665,65,180635
12902,5e-05,172.31.40.0-255,66,4731,65,180635
12903,5.8e-05,172.217.194.0-255,7156,11887,65,180635
12904,6e-05,172.31.40.0-255,66,11953,65,180635
12905,6.4e-05,172.217.194.0-255,2062,14015,65,180635
12906,6.6e-05,172.31.40.0-255,66,14081,65,180635
12907,9.2e-05,172.217.194.0-255,2902,16983,65,180635
12908,9.5e-05,172.31.40.0-255,66,17049,65,180635
12909,0.000107,172.217.194.0-255,7156,24205,65,180635
12910,0.000109,172.31.40.0-255,66,24271,65,180635
12911,0.000114,172.217.194.0-255,2902,27173,65,180635
12912,0.000116,172.31.40.0-255,66,27239,65,180635
12913,0.000151,172.217.194.0-255,3961,31200,65,180635
12914,0.000154,172.31.40.0-255,66,31266,65,180635
12915,0.000179,172.217.194.0-255,1484,32750,65,180635
12916,0.000181,172.31.40.0-255,66,32816,65,180635
12917,0.000186,172.217.194.0-255,2902,35718,65,180635
12918,0.000189,172.31.40.0-255,66,35784,65,180635
12919,0.000211,172.217.194.0-255,5738,41522,65,180635
12920,0.000214,172.31.40.0-255,66,41588,65,180635
12921,0.000228,172.217.194.0-255,6797,48385,65,180635
12922,0.00023,172.31.40.0-255,66,48451,65,180635
12923,0.000261,172.217.194.0-255,1484,49935,65,180635
12924,0.000263,172.31.40.0-255,66,50001,65,180635
12925,0.000303,172.31.40.0-255,66,50067,65,180635
12926,0.000307,172.217.194.0-255,2822,52889,65,180635
12927,0.000309,172.31.40.0-255,66,52955,65,180635
12928,0.000312,172.217.194.0-255,118,53073,65,180635
12929,0.00032,172.217.194.0-255,378,53451,65,180635
12930,0.000568,172.217.194.0-255,1484,54935,65,180635
12931,0.000574,172.31.40.0-255,66,55001,65,180635
12932,0.000579,172.217.194.0-255,2902,57903,65,180635
12933,0.000581,172.31.40.0-255,66,57969,65,180635
12934,0.000586,172.217.194.0-255,2902,60871,65,180635
12935,0.000594,172.31.40.0-255,66,60937,65,180635
12936,0.00062,172.217.194.0-255,2902,63839,65,180635
12937,0.00064,172.217.194.0-255,5738,69577,65,180635
12938,0.000645,172.31.40.0-255,66,69643,65,180635
12939,0.000648,172.31.40.0-255,66,69709,65,180635
12940,0.000651,172.31.40.0-255,66,69775,65,180635
12941,0.000675,172.217.194.0-255,5020,74795,65,180635
12942,0.000682,172.31.40.0-255,66,74861,65,180635
12943,0.001366,172.217.194.0-255,1484,76345,65,180635
12944,0.001373,172.217.194.0-255,2902,79247,65,180635
12945,0.001376,172.31.40.0-255,66,79313,65,180635
12946,0.001413,172.217.194.0-255,5738,85051,65,180635
12947,0.001416,172.31.40.0-255,66,85117,65,180635
12948,0.001431,172.31.40.0-255,66,85183,65,180635
12949,0.001447,172.31.40.0-255,66,85249,65,180635
12950,0.001476,172.217.194.0-255,2184,87433,65,180635
12951,0.001478,172.31.40.0-255,66,87499,65,180635
12952,0.001516,172.31.40.0-255,66,87565,65,180635
12953,0.001529,172.31.40.0-255,66,87631,65,180635
12954,0.001572,172.217.194.0-255,5738,93369,65,180635
12955,0.001576,172.31.40.0-255,66,93435,65,180635
12956,0.001589,172.31.40.0-255,66,93501,65,180635
12957,0.001599,172.217.194.0-255,4320,97821,65,180635
12958,0.001601,172.31.40.0-255,66,97887,65,180635
12959,0.001649,172.31.40.0-255,66,97953,65,180635
12960,0.001668,172.217.194.0-255,1484,99437,65,180635
12961,0.001672,172.217.194.0-255,2902,102339,65,180635
12962,0.001677,172.31.40.0-255,66,102405,65,180635
12963,0.001685,172.217.194.0-255,1484,103889,65,180635
12964,0.001706,172.217.194.0-255,4320,108209,65,180635
12965,0.001708,172.31.40.0-255,66,108275,65,180635
12966,0.001727,172.31.40.0-255,66,108341,65,180635
12967,0.001755,172.217.194.0-255,1484,109825,65,180635
12968,0.001768,172.31.40.0-255,66,109891,65,180635
12969,0.001825,172.217.194.0-255,1484,111375,65,180635
12970,0.00183,172.217.194.0-255,2902,114277,65,180635
12971,0.001834,172.31.40.0-255,66,114343,65,180635
12972,0.001841,172.217.194.0-255,5738,120081,65,180635
12973,0.001843,172.31.40.0-255,66,120147,65,180635
12974,0.001854,172.217.194.0-255,5738,125885,65,180635
12975,0.001856,172.31.40.0-255,66,125951,65,180635
12976,0.001899,172.217.194.0-255,7156,133107,65,180635
12977,0.001903,172.31.40.0-255,66,133173,65,180635
12978,0.001915,172.31.40.0-255,66,133239,65,180635
12979,0.001974,172.31.40.0-255,66,133305,65,180635
12980,0.001999,172.217.194.0-255,2184,135489,65,180635
12981,0.002027,172.31.40.0-255,66,135555,65,180635
12982,0.004128,172.217.194.0-255,5738,141293,65,180635
12983,0.004136,172.31.40.0-255,66,141359,65,180635
12984,0.006224,172.217.194.0-255,5738,147097,65,180635
12985,0.006238,172.31.40.0-255,66,147163,65,180635
12986,0.008377,172.217.194.0-255,5738,152901,65,180635
12987,0.008387,172.31.40.0-255,66,152967,65,180635
12988,0.0105,172.217.194.0-255,4320,157287,65,180635
12989,0.010507,172.31.40.0-255,66,157353,65,180635
12990,0.010534,172.217.194.0-255,1484,158837,65,180635
12991,0.012647,172.217.194.0-255,4320,163157,65,180635
12992,0.012654,172.31.40.0-255,66,163223,65,180635
12993,0.014774,172.217.194.0-255,5738,168961,65,180635
12994,0.01478,172.31.40.0-255,66,169027,65,180635
12995,0.016883,172.217.194.0-255,5738,174765,65,180635
12996,0.0169,172.31.40.0-255,66,174831,65,180635
12997,0.019009,172.217.194.0-255,5738,180569,65,180635
12998,0.019018,172.31.40.0-255,66,180635,65,180635
12999,0.0,74.125.24.0-255,298,298,65,139477
13000,2.3e-05,172.31.40.0-255,66,364,65,139477
13001,3e-05,74.125.24.0-255,1484,1848,65,139477
13002,3.4e-05,172.31.40.0-255,66,1914,65,139477
13003,4.2e-05,74.125.24.0-255,4320,6234,65,139477
13004,5.1e-05,172.31.40.0-255,66,6300,65,139477
13005,5.9e-05,74.125.24.0-255,7156,13456,65,139477
13006,6.3e-05,172.31.40.0-255,66,13522,65,139477
13007,0.000104,74.125.24.0-255,1829,15351,65,139477
13008,0.000106,172.31.40.0-255,66,15417,65,139477
13009,0.000126,172.31.40.0-255,66,15483,65,139477
13010,0.00013,74.125.24.0-255,2543,18026,65,139477
13011,0.000132,172.31.40.0-255,66,18092,65,139477
13012,0.000137,74.125.24.0-255,2902,20994,65,139477
13013,0.000139,172.31.40.0-255,66,21060,65,139477
13014,0.000156,74.125.24.0-255,1484,22544,65,139477
13015,0.000158,172.31.40.0-255,66,22610,65,139477
13016,0.000197,74.125.24.0-255,5738,28348,65,139477
13017,0.0002,172.31.40.0-255,66,28414,65,139477
13018,0.000222,172.31.40.0-255,66,28480,65,139477
13019,0.000233,172.31.40.0-255,66,28546,65,139477
13020,0.000236,74.125.24.0-255,113,28659,65,139477
13021,0.000239,172.31.40.0-255,66,28725,65,139477
13022,0.000315,74.125.24.0-255,328,29053,65,139477
13023,0.000319,172.31.40.0-255,66,29119,65,139477
13024,0.000664,74.125.24.0-255,1484,30603,65,139477
13025,0.00067,172.31.40.0-255,66,30669,65,139477
13026,0.000705,74.125.24.0-255,2902,33571,65,139477
13027,0.000708,172.31.40.0-255,66,33637,65,139477
13028,0.000715,74.125.24.0-255,5738,39375,65,139477
13029,0.000718,172.31.40.0-255,66,39441,65,139477
13030,0.000734,172.31.40.0-255,66,39507,65,139477
13031,0.000768,74.125.24.0-255,2902,42409,65,139477
13032,0.000771,172.31.40.0-255,66,42475,65,139477
13033,0.000774,74.125.24.0-255,1484,43959,65,139477
13034,0.000791,172.31.40.0-255,66,44025,65,139477
13035,0.001063,74.125.24.0-255,1484,45509,65,139477
13036,0.00107,74.125.24.0-255,2902,48411,65,139477
13037,0.001072,74.125.24.0-255,1484,49895,65,139477
13038,0.001079,172.31.40.0-255,66,49961,65,139477
13039,0.001092,74.125.24.0-255,4320,54281,65,139477
13040,0.0011,172.31.40.0-255,66,54347,65,139477
13041,0.001114,172.31.40.0-255,66,54413,65,139477
13042,0.001152,74.125.24.0-255,1484,55897,65,139477
13043,0.001167,172.31.40.0-255,66,55963,65,139477
13044,0.001449,74.125.24.0-255,1484,57447,65,139477
13045,0.001457,74.125.24.0-255,2902,60349,65,139477
13046,0.001461,172.31.40.0-255,66,60415,65,139477
13047,0.001497,74.125.24.0-255,5738,66153,65,139477
13048,0.001499,172.31.40.0-255,66,66219,65,139477
13049,0.001505,74.125.24.0-255,4320,70539,65,139477
13050,0.001507,172.31.40.0-255,66,70605,65,139477
13051,0.001525,172.31.40.0-255,66,70671,65,139477
13052,0.001569,74.125.24.0-255,2902,73573,65,139477
13053,0.001571,172.31.40.0-255,66,73639,65,139477
13054,0.001588,172.31.40.0-255,66,73705,65,139477
13055,0.001692,74.125.24.0-255,1484,75189,65,139477
13056,0.001724,74.125.24.0-255,2902,78091,65,139477
13057,0.001729,172.31.40.0-255,66,78157,65,139477
13058,0.001741,74.125.24.0-255,5738,83895,65,139477
13059,0.001749,172.31.40.0-255,66,83961,65,139477
13060,0.001762,172.31.40.0-255,66,84027,65,139477
13061,0.001796,172.31.40.0-255,66,84093,65,139477
13062,0.001843,172.31.40.0-255,66,84159,65,139477
13063,0.001863,172.31.40.0-255,66,84225,65,139477
13064,0.001904,74.125.24.0-255,5738,89963,65,139477
13065,0.001906,172.31.40.0-255,66,90029,65,139477
13066,0.002061,74.125.24.0-255,5020,95049,65,139477
13067,0.002238,74.125.24.0-255,1484,96533,65,139477
13068,0.002246,74.125.24.0-255,2902,99435,65,139477
13069,0.002251,74.125.24.0-255,2902,102337,65,139477
13070,0.002265,74.125.24.0-255,2902,105239,65,139477
13071,0.002269,74.125.24.0-255,2902,108141,65,139477
13072,0.002296,74.125.24.0-255,1484,109625,65,139477
13073,0.002326,74.125.24.0-255,766,110391,65,139477
13074,0.006469,172.31.40.0-255,66,110457,65,139477
13075,0.008783,74.125.24.0-255,5738,116195,65,139477
13076,0.008791,172.31.40.0-255,66,116261,65,139477
13077,0.01109,74.125.24.0-255,5738,121999,65,139477
13078,0.011098,172.31.40.0-255,66,122065,65,139477
13079,0.013428,74.125.24.0-255,5738,127803,65,139477
13080,0.01344,172.31.40.0-255,66,127869,65,139477
13081,0.015788,74.125.24.0-255,5738,133607,65,139477
13082,0.015796,172.31.40.0-255,66,133673,65,139477
13083,0.018126,74.125.24.0-255,5738,139411,65,139477
13084,0.018135,172.31.40.0-255,66,139477,65,139477
13085,0.0,74.125.130.0-255,143,143,65,226039
13086,1.7e-05,172.31.40.0-255,66,209,65,226039
13087,2.3e-05,74.125.130.0-255,1484,1693,65,226039
13088,2.7e-05,172.31.40.0-255,66,1759,65,226039
13089,7.7e-05,74.125.130.0-255,2902,4661,65,226039
13090,8.1e-05,172.31.40.0-255,66,4727,65,226039
13091,8.8e-05,74.125.130.0-255,7156,11883,65,226039
13092,9.1e-05,172.31.40.0-255,66,11949,65,226039
13093,9.4e-05,74.125.130.0-255,1484,13433,65,226039
13094,9.7e-05,172.31.40.0-255,66,13499,65,226039
13095,0.000101,74.125.130.0-255,609,14108,65,226039
13096,0.000104,172.31.40.0-255,66,14174,65,226039
13097,0.000153,74.125.130.0-255,1484,15658,65,226039
13098,0.000155,172.31.40.0-255,66,15724,65,226039
13099,0.000159,74.125.130.0-255,1484,17208,65,226039
13100,0.000162,172.31.40.0-255,66,17274,65,226039
13101,0.000186,74.125.130.0-255,1484,18758,65,226039
13102,0.000189,172.31.40.0-255,66,18824,65,226039
13103,0.000196,74.125.130.0-255,5738,24562,65,226039
13104,0.000203,172.31.40.0-255,66,24628,65,226039
13105,0.000242,74.125.130.0-255,6797,31425,65,226039
13106,0.000245,172.31.40.0-255,66,31491,65,226039
13107,0.000338,74.125.130.0-255,1484,32975,65,226039
13108,0.000342,172.31.40.0-255,66,33041,65,226039
13109,0.000348,74.125.130.0-255,2902,35943,65,226039
13110,0.00035,172.31.40.0-255,66,36009,65,226039
13111,0.000356,74.125.130.0-255,4320,40329,65,226039
13112,0.000365,172.31.40.0-255,66,40395,65,226039
13113,0.000389,74.125.130.0-255,1484,41879,65,226039
13114,0.000391,172.31.40.0-255,66,41945,65,226039
13115,0.000396,74.125.130.0-255,2902,44847,65,226039
13116,0.000398,172.31.40.0-255,66,44913,65,226039
13117,0.000404,74.125.130.0-255,3961,48874,65,226039
13118,0.000406,172.31.40.0-255,66,48940,65,226039
13119,0.000436,172.31.40.0-255,66,49006,65,226039
13120,0.000484,172.31.40.0-255,66,49072,65,226039
13121,0.000497,74.125.130.0-255,361,49433,65,226039
13122,0.000782,74.125.130.0-255,1484,50917,65,226039
13123,0.000786,172.31.40.0-255,66,50983,65,226039
13124,0.000792,74.125.130.0-255,2902,53885,65,226039
13125,0.000794,172.31.40.0-255,66,53951,65,226039
13126,0.000797,74.125.130.0-255,1484,55435,65,226039
13127,0.00083,74.125.130.0-255,4320,59755,65,226039
13128,0.000833,172.31.40.0-255,66,59821,65,226039
13129,0.00085,172.31.40.0-255,66,59887,65,226039
13130,0.000864,172.31.40.0-255,66,59953,65,226039
13131,0.001636,74.125.130.0-255,1484,61437,65,226039
13132,0.001647,74.125.130.0-255,2902,64339,65,226039
13133,0.001651,172.31.40.0-255,66,64405,65,226039
13134,0.001659,74.125.130.0-255,5738,70143,65,226039
13135,0.001662,172.31.40.0-255,66,70209,65,226039
13136,0.001693,172.31.40.0-255,66,70275,65,226039
13137,0.001724,74.125.130.0-255,1484,71759,65,226039
13138,0.001737,172.31.40.0-255,66,71825,65,226039
13139,0.00174,74.125.130.0-255,766,72591,65,226039
13140,0.0019,74.125.130.0-255,1484,74075,65,226039
13141,0.001905,172.31.40.0-255,66,74141,65,226039
13142,0.00191,74.125.130.0-255,2902,77043,65,226039
13143,0.001912,172.31.40.0-255,66,77109,65,226039
13144,0.001917,74.125.130.0-255,2902,80011,65,226039
13145,0.001918,172.31.40.0-255,66,80077,65,226039
13146,0.001952,74.125.130.0-255,2902,82979,65,226039
13147,0.001954,172.31.40.0-255,66,83045,65,226039
13148,0.001967,172.31.40.0-255,66,83111,65,226039
13149,0.001976,172.31.40.0-255,66,83177,65,226039
13150,0.002024,74.125.130.0-255,2184,85361,65,226039
13151,0.002026,172.31.40.0-255,66,85427,65,226039
13152,0.00205,74.125.130.0-255,2902,88329,65,226039
13153,0.002052,172.31.40.0-255,66,88395,65,226039
13154,0.002079,74.125.130.0-255,4320,92715,65,226039
13155,0.002082,172.31.40.0-255,66,92781,65,226039
13156,0.002158,74.125.130.0-255,5020,97801,65,226039
13157,0.002193,74.125.130.0-255,2902,100703,65,226039
13158,0.002206,74.125.130.0-255,2902,103605,65,226039
13159,0.002212,74.125.130.0-255,5738,109343,65,226039
13160,0.002214,74.125.130.0-255,1484,110827,65,226039
13161,0.002231,74.125.130.0-255,5738,116565,65,226039
13162,0.002254,74.125.130.0-255,1484,118049,65,226039
13163,0.002289,74.125.130.0-255,766,118815,65,226039
13164,0.002313,74.125.130.0-255,4320,123135,65,226039
13165,0.002316,74.125.130.0-255,1484,124619,65,226039
13166,0.00233,74.125.130.0-255,4320,128939,65,226039
13167,0.002345,74.125.130.0-255,2902,131841,65,226039
13168,0.002364,74.125.130.0-255,7156,138997,65,226039
13169,0.002384,74.125.130.0-255,1484,140481,65,226039
13170,0.00241,74.125.130.0-255,2184,142665,65,226039
13171,0.002474,74.125.130.0-255,1484,144149,65,226039
13172,0.002478,74.125.130.0-255,1484,145633,65,226039
13173,0.00249,74.125.130.0-255,1484,147117,65,226039
13174,0.002494,74.125.130.0-255,2902,150019,65,226039
13175,0.002506,74.125.130.0-255,2902,152921,65,226039
13176,0.00251,74.125.130.0-255,2902,155823,65,226039
13177,0.002532,74.125.130.0-255,5738,161561,65,226039
13178,0.002537,74.125.130.0-255,4320,165881,65,226039
13179,0.002555,74.125.130.0-255,5738,171619,65,226039
13180,0.002557,74.125.130.0-255,1484,173103,65,226039
13181,0.002573,74.125.130.0-255,3602,176705,65,226039
13182,0.00262,74.125.130.0-255,4320,181025,65,226039
13183,0.002635,74.125.130.0-255,1484,182509,65,226039
13184,0.002639,74.125.130.0-255,2902,185411,65,226039
13185,0.002651,74.125.130.0-255,4320,189731,65,226039
13186,0.00267,74.125.130.0-255,5738,195469,65,226039
13187,0.002673,74.125.130.0-255,1484,196953,65,226039
13188,0.006695,172.31.40.0-255,66,197019,65,226039
13189,0.009341,74.125.130.0-255,5738,202757,65,226039
13190,0.009352,172.31.40.0-255,66,202823,65,226039
13191,0.011965,74.125.130.0-255,5738,208561,65,226039
13192,0.01197,172.31.40.0-255,66,208627,65,226039
13193,0.01461,74.125.130.0-255,5738,214365,65,226039
13194,0.014621,172.31.40.0-255,66,214431,65,226039
13195,0.017254,74.125.130.0-255,5738,220169,65,226039
13196,0.017272,172.31.40.0-255,66,220235,65,226039
13197,0.019932,74.125.130.0-255,5738,225973,65,226039
13198,0.01994,172.31.40.0-255,66,226039,65,226039
13199,0.0,172.253.118.0-255,149,149,65,104116
13200,1.5e-05,172.31.40.0-255,66,215,65,104116
13201,2.2e-05,172.253.118.0-255,1484,1699,65,104116
13202,2.6e-05,172.31.40.0-255,66,1765,65,104116
13203,3.1e-05,172.253.118.0-255,2902,4667,65,104116
13204,3.5e-05,172.31.40.0-255,66,4733,65,104116
13205,4.3e-05,172.253.118.0-255,7156,11889,65,104116
13206,4.5e-05,172.31.40.0-255,66,11955,65,104116
13207,4.9e-05,172.253.118.0-255,2039,13994,65,104116
13208,5.2e-05,172.31.40.0-255,66,14060,65,104116
13209,0.000202,172.253.118.0-255,1484,15544,65,104116
13210,0.000207,172.31.40.0-255,66,15610,65,104116
13211,0.000212,172.253.118.0-255,2902,18512,65,104116
13212,0.000214,172.31.40.0-255,66,18578,65,104116
13213,0.000219,172.253.118.0-255,2902,21480,65,104116
13214,0.000221,172.31.40.0-255,66,21546,65,104116
13215,0.00024,172.253.118.0-255,2902,24448,65,104116
13216,0.000242,172.31.40.0-255,66,24514,65,104116
13217,0.000249,172.253.118.0-255,6797,31311,65,104116
13218,0.000252,172.31.40.0-255,66,31377,65,104116
13219,0.000504,172.253.118.0-255,1484,32861,65,104116
13220,0.000509,172.31.40.0-255,66,32927,65,104116
13221,0.000514,172.253.118.0-255,2902,35829,65,104116
13222,0.000517,172.31.40.0-255,66,35895,65,104116
13223,0.000523,172.253.118.0-255,5738,41633,65,104116
13224,0.000525,172.31.40.0-255,66,41699,65,104116
13225,0.000551,172.253.118.0-255,4320,46019,65,104116
13226,0.000554,172.31.40.0-255,66,46085,65,104116
13227,0.000578,172.31.40.0-255,66,46151,65,104116
13228,0.0006,172.253.118.0-255,4320,50471,65,104116
13229,0.000603,172.31.40.0-255,66,50537,65,104116
13230,0.000618,172.253.118.0-255,6797,57334,65,104116
13231,0.000621,172.31.40.0-255,66,57400,65,104116
13232,0.002091,172.253.118.0-255,646,58046,65,104116
13233,0.002274,172.253.118.0-255,1484,59530,65,104116
13234,0.002279,172.31.40.0-255,66,59596,65,104116
13235,0.002875,172.253.118.0-255,2902,62498,65,104116
13236,0.002878,172.31.40.0-255,66,62564,65,104116
13237,0.004523,172.253.118.0-255,2902,65466,65,104116
13238,0.00453,172.31.40.0-255,66,65532,65,104116
13239,0.005124,172.253.118.0-255,2902,68434,65,104116
13240,0.005129,172.31.40.0-255,66,68500,65,104116
13241,0.006767,172.253.118.0-255,2902,71402,65,104116
13242,0.006771,172.31.40.0-255,66,71468,65,104116
13243,0.007362,172.253.118.0-255,2902,74370,65,104116
13244,0.007368,172.31.40.0-255,66,74436,65,104116
13245,0.009012,172.253.118.0-255,2902,77338,65,104116
13246,0.009019,172.31.40.0-255,66,77404,65,104116
13247,0.009624,172.253.118.0-255,2902,80306,65,104116
13248,0.009631,172.31.40.0-255,66,80372,65,104116
13249,0.011288,172.253.118.0-255,2902,83274,65,104116
13250,0.011295,172.31.40.0-255,66,83340,65,104116
13251,0.011917,172.253.118.0-255,2902,86242,65,104116
13252,0.011923,172.31.40.0-255,66,86308,65,104116
13253,0.013532,172.253.118.0-255,2902,89210,65,104116
13254,0.013539,172.31.40.0-255,66,89276,65,104116
13255,0.014171,172.253.118.0-255,2902,92178,65,104116
13256,0.014178,172.31.40.0-255,66,92244,65,104116
13257,0.015788,172.253.118.0-255,2902,95146,65,104116
13258,0.015796,172.31.40.0-255,66,95212,65,104116
13259,0.016432,172.253.118.0-255,2902,98114,65,104116
13260,0.016438,172.31.40.0-255,66,98180,65,104116
13261,0.018051,172.253.118.0-255,2902,101082,65,104116
13262,0.018058,172.31.40.0-255,66,101148,65,104116
13263,0.018681,172.253.118.0-255,2902,104050,65,104116
13264,0.018688,172.31.40.0-255,66,104116,65,104116
13265,0.0,74.125.24.0-255,153,153,65,190795
13266,2.3e-05,172.31.40.0-255,66,219,65,190795
13267,3.1e-05,74.125.24.0-255,1484,1703,65,190795
13268,3.5e-05,172.31.40.0-255,66,1769,65,190795
13269,5e-05,74.125.24.0-255,2902,4671,65,190795
13270,5.4e-05,172.31.40.0-255,66,4737,65,190795
13271,6.2e-05,74.125.24.0-255,7156,11893,65,190795
13272,6.5e-05,172.31.40.0-255,66,11959,65,190795
13273,6.9e-05,74.125.24.0-255,2028,13987,65,190795
13274,7.2e-05,172.31.40.0-255,66,14053,65,190795
13275,0.000139,74.125.24.0-255,1484,15537,65,190795
13276,0.000141,172.31.40.0-255,66,15603,65,190795
13277,0.000147,74.125.24.0-255,2902,18505,65,190795
13278,0.000149,172.31.40.0-255,66,18571,65,190795
13279,0.000154,74.125.24.0-255,2902,21473,65,190795
13280,0.000161,172.31.40.0-255,66,21539,65,190795
13281,0.000173,74.125.24.0-255,2902,24441,65,190795
13282,0.000176,172.31.40.0-255,66,24507,65,190795
13283,0.000184,74.125.24.0-255,6797,31304,65,190795
13284,0.000191,172.31.40.0-255,66,31370,65,190795
13285,0.000224,74.125.24.0-255,2902,34272,65,190795
13286,0.000226,172.31.40.0-255,66,34338,65,190795
13287,0.000269,172.31.40.0-255,66,34404,65,190795
13288,0.000272,74.125.24.0-255,1484,35888,65,190795
13289,0.000274,172.31.40.0-255,66,35954,65,190795
13290,0.000277,74.125.24.0-255,1125,37079,65,190795
13291,0.000279,172.31.40.0-255,66,37145,65,190795
13292,0.000359,74.125.24.0-255,1484,38629,65,190795
13293,0.000363,172.31.40.0-255,66,38695,65,190795
13294,0.000368,74.125.24.0-255,2902,41597,65,190795
13295,0.000371,172.31.40.0-255,66,41663,65,190795
13296,0.000399,74.125.24.0-255,5738,47401,65,190795
13297,0.000402,172.31.40.0-255,66,47467,65,190795
13298,0.000431,74.125.24.0-255,7144,54611,65,190795
13299,0.000433,172.31.40.0-255,66,54677,65,190795
13300,0.00046,74.125.24.0-255,331,55008,65,190795
13301,0.000547,74.125.24.0-255,1484,56492,65,190795
13302,0.000551,172.31.40.0-255,66,56558,65,190795
13303,0.000556,74.125.24.0-255,2902,59460,65,190795
13304,0.000559,172.31.40.0-255,66,59526,65,190795
13305,0.000562,74.125.24.0-255,1484,61010,65,190795
13306,0.000587,74.125.24.0-255,4320,65330,65,190795
13307,0.00059,172.31.40.0-255,66,65396,65,190795
13308,0.000596,74.125.24.0-255,5738,71134,65,190795
13309,0.000598,172.31.40.0-255,66,71200,65,190795
13310,0.000642,172.31.40.0-255,66,71266,65,190795
13311,0.000649,74.125.24.0-255,5738,77004,65,190795
13312,0.000651,172.31.40.0-255,66,77070,65,190795
13313,0.000672,74.125.24.0-255,2902,79972,65,190795
13314,0.000674,172.31.40.0-255,66,80038,65,190795
13315,0.000677,74.125.24.0-255,1125,81163,65,190795
13316,0.001431,172.31.40.0-255,66,81229,65,190795
13317,0.001574,74.125.24.0-255,1484,82713,65,190795
13318,0.001584,74.125.24.0-255,2902,85615,65,190795
13319,0.001588,172.31.40.0-255,66,85681,65,190795
13320,0.001596,74.125.24.0-255,5738,91419,65,190795
13321,0.001598,172.31.40.0-255,66,91485,65,190795
13322,0.001642,172.31.40.0-255,66,91551,65,190795
13323,0.00167,74.125.24.0-255,1484,93035,65,190795
13324,0.001715,74.125.24.0-255,7156,100191,65,190795
13325,0.001719,172.31.40.0-255,66,100257,65,190795
13326,0.001738,74.125.24.0-255,3602,103859,65,190795
13327,0.00174,172.31.40.0-255,66,103925,65,190795
13328,0.001952,74.125.24.0-255,1484,105409,65,190795
13329,0.00196,74.125.24.0-255,2902,108311,65,190795
13330,0.001964,172.31.40.0-255,66,108377,65,190795
13331,0.00197,74.125.24.0-255,4320,112697,65,190795
13332,0.001973,172.31.40.0-255,66,112763,65,190795
13333,0.002001,74.125.24.0-255,1484,114247,65,190795
13334,0.002008,74.125.24.0-255,4320,118567,65,190795
13335,0.002011,172.31.40.0-255,66,118633,65,190795
13336,0.002042,74.125.24.0-255,4320,122953,65,190795
13337,0.002045,172.31.40.0-255,66,123019,65,190795
13338,0.002075,74.125.24.0-255,7156,130175,65,190795
13339,0.002077,172.31.40.0-255,66,130241,65,190795
13340,0.002087,172.31.40.0-255,66,130307,65,190795
13341,0.002165,74.125.24.0-255,1484,131791,65,190795
13342,0.002183,74.125.24.0-255,2902,134693,65,190795
13343,0.002186,172.31.40.0-255,66,134759,65,190795
13344,0.002216,74.125.24.0-255,5738,140497,65,190795
13345,0.002218,172.31.40.0-255,66,140563,65,190795
13346,0.00223,172.31.40.0-255,66,140629,65,190795
13347,0.00224,74.125.24.0-255,1484,142113,65,190795
13348,0.002264,74.125.24.0-255,7156,149269,65,190795
13349,0.002266,172.31.40.0-255,66,149335,65,190795
13350,0.00229,74.125.24.0-255,4320,153655,65,190795
13351,0.002292,172.31.40.0-255,66,153721,65,190795
13352,0.002296,74.125.24.0-255,2184,155905,65,190795
13353,0.002299,172.31.40.0-255,66,155971,65,190795
13354,0.004879,74.125.24.0-255,5738,161709,65,190795
13355,0.004886,172.31.40.0-255,66,161775,65,190795
13356,0.007445,74.125.24.0-255,5738,167513,65,190795
13357,0.007452,172.31.40.0-255,66,167579,65,190795
13358,0.010015,74.125.24.0-255,5738,173317,65,190795
13359,0.010022,172.31.40.0-255,66,173383,65,190795
13360,0.012631,74.125.24.0-255,5738,179121,65,190795
13361,0.01264,172.31.40.0-255,66,179187,65,190795
13362,0.015216,74.125.24.0-255,5738,184925,65,190795
13363,0.015228,172.31.40.0-255,66,184991,65,190795
13364,0.017791,74.125.24.0-255,5738,190729,65,190795
13365,0.0178,172.31.40.0-255,66,190795,65,190795
13366,0.0,172.217.194.0-255,153,153,65,217482
13367,2.6e-05,172.31.40.0-255,66,219,65,217482
13368,3.3e-05,172.217.194.0-255,1484,1703,65,217482
13369,3.7e-05,172.31.40.0-255,66,1769,65,217482
13370,4.3e-05,172.217.194.0-255,2902,4671,65,217482
13371,4.7e-05,172.31.40.0-255,66,4737,65,217482
13372,5.4e-05,172.217.194.0-255,5738,10475,65,217482
13373,5.8e-05,172.31.40.0-255,66,10541,65,217482
13374,7.1e-05,172.31.40.0-255,66,10607,65,217482
13375,7.7e-05,172.217.194.0-255,5738,16345,65,217482
13376,8e-05,172.31.40.0-255,66,16411,65,217482
13377,0.000107,172.217.194.0-255,3961,20372,65,217482
13378,0.00011,172.31.40.0-255,66,20438,65,217482
13379,0.000129,172.217.194.0-255,1484,21922,65,217482
13380,0.000131,172.31.40.0-255,66,21988,65,217482
13381,0.000136,172.217.194.0-255,2902,24890,65,217482
13382,0.000139,172.31.40.0-255,66,24956,65,217482
13383,0.000141,172.217.194.0-255,1484,26440,65,217482
13384,0.000143,172.31.40.0-255,66,26506,65,217482
13385,0.000171,172.217.194.0-255,4320,30826,65,217482
13386,0.000174,172.31.40.0-255,66,30892,65,217482
13387,0.000184,172.31.40.0-255,66,30958,65,217482
13388,0.000203,172.217.194.0-255,1125,32083,65,217482
13389,0.000205,172.31.40.0-255,66,32149,65,217482
13390,0.000217,172.31.40.0-255,66,32215,65,217482
13391,0.00022,172.217.194.0-255,1125,33340,65,217482
13392,0.000222,172.31.40.0-255,66,33406,65,217482
13393,0.000292,172.217.194.0-255,646,34052,65,217482
13394,0.000295,172.31.40.0-255,66,34118,65,217482
13395,0.000484,172.217.194.0-255,1484,35602,65,217482
13396,0.000492,172.217.194.0-255,2902,38504,65,217482
13397,0.000497,172.31.40.0-255,66,38570,65,217482
13398,0.000525,172.217.194.0-255,5738,44308,65,217482
13399,0.000528,172.31.40.0-255,66,44374,65,217482
13400,0.000532,172.217.194.0-255,2902,47276,65,217482
13401,0.000534,172.31.40.0-255,66,47342,65,217482
13402,0.000542,172.217.194.0-255,7156,54498,65,217482
13403,0.000545,172.31.40.0-255,66,54564,65,217482
13404,0.000564,172.217.194.0-255,2902,57466,65,217482
13405,0.000567,172.31.40.0-255,66,57532,65,217482
13406,0.000569,172.217.194.0-255,1484,59016,65,217482
13407,0.00061,172.31.40.0-255,66,59082,65,217482
13408,0.001079,172.217.194.0-255,1484,60566,65,217482
13409,0.001086,172.217.194.0-255,2902,63468,65,217482
13410,0.001089,172.31.40.0-255,66,63534,65,217482
13411,0.001097,172.217.194.0-255,5738,69272,65,217482
13412,0.001099,172.31.40.0-255,66,69338,65,217482
13413,0.001126,172.217.194.0-255,4320,73658,65,217482
13414,0.001129,172.31.40.0-255,66,73724,65,217482
13415,0.001168,172.31.40.0-255,66,73790,65,217482
13416,0.001181,172.31.40.0-255,66,73856,65,217482
13417,0.001679,172.217.194.0-255,1484,75340,65,217482
13418,0.001685,172.217.194.0-255,2902,78242,65,217482
13419,0.001688,172.31.40.0-255,66,78308,65,217482
13420,0.001694,172.217.194.0-255,2902,81210,65,217482
13421,0.001696,172.31.40.0-255,66,81276,65,217482
13422,0.00171,172.217.194.0-255,2902,84178,65,217482
13423,0.001712,172.31.40.0-255,66,84244,65,217482
13424,0.001726,172.217.194.0-255,2902,87146,65,217482
13425,0.00173,172.31.40.0-255,66,87212,65,217482
13426,0.001747,172.31.40.0-255,66,87278,65,217482
13427,0.001753,172.217.194.0-255,4320,91598,65,217482
13428,0.001755,172.31.40.0-255,66,91664,65,217482
13429,0.001784,172.217.194.0-255,6438,98102,65,217482
13430,0.001787,172.31.40.0-255,66,98168,65,217482
13431,0.001857,172.217.194.0-255,1484,99652,65,217482
13432,0.001863,172.217.194.0-255,2902,102554,65,217482
13433,0.001866,172.31.40.0-255,66,102620,65,217482
13434,0.001892,172.217.194.0-255,5738,108358,65,217482
13435,0.001895,172.31.40.0-255,66,108424,65,217482
13436,0.001899,172.217.194.0-255,2902,111326,65,217482
13437,0.001902,172.31.40.0-255,66,111392,65,217482
13438,0.001923,172.31.40.0-255,66,111458,65,217482
13439,0.001948,172.217.194.0-255,4320,115778,65,217482
13440,0.00195,172.31.40.0-255,66,115844,65,217482
13441,0.001984,172.31.40.0-255,66,115910,65,217482
13442,0.002026,172.217.194.0-255,1484,117394,65,217482
13443,0.00203,172.217.194.0-255,2902,120296,65,217482
13444,0.002033,172.31.40.0-255,66,120362,65,217482
13445,0.002054,172.217.194.0-255,4320,124682,65,217482
13446,0.002057,172.31.40.0-255,66,124748,65,217482
13447,0.002081,172.217.194.0-255,1484,126232,65,217482
13448,0.002095,172.31.40.0-255,66,126298,65,217482
13449,0.002127,172.31.40.0-255,66,126364,65,217482
13450,0.002186,172.217.194.0-255,1484,127848,65,217482
13451,0.002201,172.217.194.0-255,2902,130750,65,217482
13452,0.002204,172.31.40.0-255,66,130816,65,217482
13453,0.002211,172.217.194.0-255,5738,136554,65,217482
13454,0.002214,172.31.40.0-255,66,136620,65,217482
13455,0.002233,172.217.194.0-255,4320,140940,65,217482
13456,0.002235,172.31.40.0-255,66,141006,65,217482
13457,0.002266,172.31.40.0-255,66,141072,65,217482
13458,0.002279,172.31.40.0-255,66,141138,65,217482
13459,0.002323,172.217.194.0-255,5738,146876,65,217482
13460,0.002325,172.31.40.0-255,66,146942,65,217482
13461,0.00236,172.31.40.0-255,66,147008,65,217482
13462,0.002373,172.31.40.0-255,66,147074,65,217482
13463,0.002389,172.217.194.0-255,5738,152812,65,217482
13464,0.002393,172.31.40.0-255,66,152878,65,217482
13465,0.002395,172.217.194.0-255,766,153644,65,217482
13466,0.002398,172.217.194.0-255,1484,155128,65,217482
13467,0.00241,172.217.194.0-255,1484,156612,65,217482
13468,0.002415,172.217.194.0-255,4320,160932,65,217482
13469,0.002421,172.217.194.0-255,4320,165252,65,217482
13470,0.002454,172.217.194.0-255,1484,166736,65,217482
13471,0.002479,172.217.194.0-255,4320,171056,65,217482
13472,0.002487,172.217.194.0-255,6438,177494,65,217482
13473,0.00249,172.217.194.0-255,1484,178978,65,217482
13474,0.002493,172.217.194.0-255,2902,181880,65,217482
13475,0.002498,172.217.194.0-255,2902,184782,65,217482
13476,0.002512,172.217.194.0-255,2902,187684,65,217482
13477,0.002517,172.217.194.0-255,4320,192004,65,217482
13478,0.00254,172.217.194.0-255,5738,197742,65,217482
13479,0.002556,172.217.194.0-255,5738,203480,65,217482
13480,0.002598,172.217.194.0-255,2184,205664,65,217482
13481,0.002606,172.217.194.0-255,5738,211402,65,217482
13482,0.002621,172.217.194.0-255,5738,217140,65,217482
13483,0.002663,172.217.194.0-255,105,217245,65,217482
13484,0.008417,172.31.40.0-255,66,217311,65,217482
13485,0.010375,172.31.40.0-255,105,217416,65,217482
13486,0.012614,172.217.194.0-255,66,217482,65,217482
13487,0.0,74.125.68.0-255,156,156,65,126229
13488,1.7e-05,172.31.40.0-255,66,222,65,126229
13489,2.4e-05,74.125.68.0-255,1484,1706,65,126229
13490,2.9e-05,172.31.40.0-255,66,1772,65,126229
13491,3.5e-05,74.125.68.0-255,2902,4674,65,126229
13492,3.9e-05,172.31.40.0-255,66,4740,65,126229
13493,4.2e-05,74.125.68.0-255,1484,6224,65,126229
13494,4.4e-05,172.31.40.0-255,66,6290,65,126229
13495,5.9e-05,74.125.68.0-255,1484,7774,65,126229
13496,6.1e-05,172.31.40.0-255,66,7840,65,126229
13497,8.4e-05,74.125.68.0-255,2902,10742,65,126229
13498,8.7e-05,172.31.40.0-255,66,10808,65,126229
13499,0.000118,74.125.68.0-255,1484,12292,65,126229
13500,0.00012,172.31.40.0-255,66,12358,65,126229
13501,0.000137,74.125.68.0-255,2072,14430,65,126229
13502,0.00014,172.31.40.0-255,66,14496,65,126229
13503,0.00033,74.125.68.0-255,1484,15980,65,126229
13504,0.000334,74.125.68.0-255,1484,17464,65,126229
13505,0.000339,172.31.40.0-255,66,17530,65,126229
13506,0.000349,172.31.40.0-255,66,17596,65,126229
13507,0.000352,74.125.68.0-255,1484,19080,65,126229
13508,0.000355,172.31.40.0-255,66,19146,65,126229
13509,0.000361,74.125.68.0-255,4320,23466,65,126229
13510,0.000363,172.31.40.0-255,66,23532,65,126229
13511,0.000387,74.125.68.0-255,5738,29270,65,126229
13512,0.00039,172.31.40.0-255,66,29336,65,126229
13513,0.000417,74.125.68.0-255,3961,33297,65,126229
13514,0.000421,172.31.40.0-255,66,33363,65,126229
13515,0.000426,74.125.68.0-255,4320,37683,65,126229
13516,0.000428,172.31.40.0-255,66,37749,65,126229
13517,0.000465,172.31.40.0-255,66,37815,65,126229
13518,0.000469,74.125.68.0-255,2902,40717,65,126229
13519,0.000472,172.31.40.0-255,66,40783,65,126229
13520,0.000493,74.125.68.0-255,2902,43685,65,126229
13521,0.000496,172.31.40.0-255,66,43751,65,126229
13522,0.000531,172.31.40.0-255,66,43817,65,126229
13523,0.000534,74.125.68.0-255,766,44583,65,126229
13524,0.000974,172.31.40.0-255,66,44649,65,126229
13525,0.001486,74.125.68.0-255,646,45295,65,126229
13526,0.001693,74.125.68.0-255,1484,46779,65,126229
13527,0.0017,172.31.40.0-255,66,46845,65,126229
13528,0.001707,74.125.68.0-255,2902,49747,65,126229
13529,0.001709,172.31.40.0-255,66,49813,65,126229
13530,0.001716,74.125.68.0-255,5738,55551,65,126229
13531,0.001718,172.31.40.0-255,66,55617,65,126229
13532,0.001723,74.125.68.0-255,4320,59937,65,126229
13533,0.001725,172.31.40.0-255,66,60003,65,126229
13534,0.001747,74.125.68.0-255,4320,64323,65,126229
13535,0.001749,172.31.40.0-255,66,64389,65,126229
13536,0.001766,74.125.68.0-255,1484,65873,65,126229
13537,0.001792,74.125.68.0-255,4320,70193,65,126229
13538,0.001795,172.31.40.0-255,66,70259,65,126229
13539,0.001818,74.125.68.0-255,5738,75997,65,126229
13540,0.00182,172.31.40.0-255,66,76063,65,126229
13541,0.001836,74.125.68.0-255,3602,79665,65,126229
13542,0.001838,172.31.40.0-255,66,79731,65,126229
13543,0.003872,74.125.68.0-255,1484,81215,65,126229
13544,0.003895,74.125.68.0-255,4320,85535,65,126229
13545,0.003899,172.31.40.0-255,66,85601,65,126229
13546,0.005954,74.125.68.0-255,5738,91339,65,126229
13547,0.005957,172.31.40.0-255,66,91405,65,126229
13548,0.00803,74.125.68.0-255,5738,97143,65,126229
13549,0.008036,172.31.40.0-255,66,97209,65,126229
13550,0.010106,74.125.68.0-255,5738,102947,65,126229
13551,0.010114,172.31.40.0-255,66,103013,65,126229
13552,0.012265,74.125.68.0-255,5738,108751,65,126229
13553,0.012273,172.31.40.0-255,66,108817,65,126229
13554,0.014348,74.125.68.0-255,5738,114555,65,126229
13555,0.014361,172.31.40.0-255,66,114621,65,126229
13556,0.016428,74.125.68.0-255,5738,120359,65,126229
13557,0.016437,172.31.40.0-255,66,120425,65,126229
13558,0.018511,74.125.68.0-255,5738,126163,65,126229
13559,0.01852,172.31.40.0-255,66,126229,65,126229
13560,0.0,74.125.24.0-255,146,146,65,177362
13561,2.5e-05,172.31.40.0-255,66,212,65,177362
13562,3.3e-05,74.125.24.0-255,1484,1696,65,177362
13563,3.8e-05,172.31.40.0-255,66,1762,65,177362
13564,4.4e-05,74.125.24.0-255,2902,4664,65,177362
13565,5.5e-05,172.31.40.0-255,66,4730,65,177362
13566,6.3e-05,74.125.24.0-255,7156,11886,65,177362
13567,6.6e-05,172.31.40.0-255,66,11952,65,177362
13568,7e-05,74.125.24.0-255,2101,14053,65,177362
13569,7.3e-05,172.31.40.0-255,66,14119,65,177362
13570,0.000171,74.125.24.0-255,1484,15603,65,177362
13571,0.000175,172.31.40.0-255,66,15669,65,177362
13572,0.000178,74.125.24.0-255,1484,17153,65,177362
13573,0.000181,172.31.40.0-255,66,17219,65,177362
13574,0.000202,74.125.24.0-255,1484,18703,65,177362
13575,0.000205,172.31.40.0-255,66,18769,65,177362
13576,0.000216,74.125.24.0-255,5738,24507,65,177362
13577,0.000219,172.31.40.0-255,66,24573,65,177362
13578,0.000251,74.125.24.0-255,5738,30311,65,177362
13579,0.000254,172.31.40.0-255,66,30377,65,177362
13580,0.000278,74.125.24.0-255,1125,31502,65,177362
13581,0.00028,172.31.40.0-255,66,31568,65,177362
13582,0.0003,74.125.24.0-255,5738,37306,65,177362
13583,0.000303,172.31.40.0-255,66,37372,65,177362
13584,0.00031,74.125.24.0-255,7156,44528,65,177362
13585,0.000313,172.31.40.0-255,66,44594,65,177362
13586,0.00035,74.125.24.0-255,3961,48555,65,177362
13587,0.000353,172.31.40.0-255,66,48621,65,177362
13588,0.000433,74.125.24.0-255,1484,50105,65,177362
13589,0.000436,172.31.40.0-255,66,50171,65,177362
13590,0.000441,74.125.24.0-255,2902,53073,65,177362
13591,0.000444,172.31.40.0-255,66,53139,65,177362
13592,0.000469,74.125.24.0-255,5738,58877,65,177362
13593,0.000476,172.31.40.0-255,66,58943,65,177362
13594,0.000504,74.125.24.0-255,7130,66073,65,177362
13595,0.000507,172.31.40.0-255,66,66139,65,177362
13596,0.001215,74.125.24.0-255,345,66484,65,177362
13597,0.001236,74.125.24.0-255,1484,67968,65,177362
13598,0.00124,172.31.40.0-255,66,68034,65,177362
13599,0.001245,74.125.24.0-255,1484,69518,65,177362
13600,0.001263,74.125.24.0-255,2902,72420,65,177362
13601,0.001266,172.31.40.0-255,66,72486,65,177362
13602,0.001272,74.125.24.0-255,4320,76806,65,177362
13603,0.001274,172.31.40.0-255,66,76872,65,177362
13604,0.001283,74.125.24.0-255,7156,84028,65,177362
13605,0.001285,172.31.40.0-255,66,84094,65,177362
13606,0.001312,74.125.24.0-255,2902,86996,65,177362
13607,0.001315,172.31.40.0-255,66,87062,65,177362
13608,0.001322,74.125.24.0-255,5738,92800,65,177362
13609,0.001324,172.31.40.0-255,66,92866,65,177362
13610,0.001363,172.31.40.0-255,66,92932,65,177362
13611,0.001368,74.125.24.0-255,2902,95834,65,177362
13612,0.00137,172.31.40.0-255,66,95900,65,177362
13613,0.001412,172.31.40.0-255,66,95966,65,177362
13614,0.001431,172.31.40.0-255,66,96032,65,177362
13615,0.001438,74.125.24.0-255,6438,102470,65,177362
13616,0.00144,172.31.40.0-255,66,102536,65,177362
13617,0.001477,172.31.40.0-255,66,102602,65,177362
13618,0.001509,172.31.40.0-255,66,102668,65,177362
13619,0.001521,172.31.40.0-255,66,102734,65,177362
13620,0.001523,74.125.24.0-255,1484,104218,65,177362
13621,0.001555,74.125.24.0-255,2902,107120,65,177362
13622,0.001558,172.31.40.0-255,66,107186,65,177362
13623,0.001565,74.125.24.0-255,5738,112924,65,177362
13624,0.001567,172.31.40.0-255,66,112990,65,177362
13625,0.001577,74.125.24.0-255,4320,117310,65,177362
13626,0.001579,172.31.40.0-255,66,117376,65,177362
13627,0.001612,172.31.40.0-255,66,117442,65,177362
13628,0.001645,172.31.40.0-255,66,117508,65,177362
13629,0.001904,74.125.24.0-255,1484,118992,65,177362
13630,0.001911,74.125.24.0-255,2902,121894,65,177362
13631,0.001915,172.31.40.0-255,66,121960,65,177362
13632,0.001923,74.125.24.0-255,4320,126280,65,177362
13633,0.001926,172.31.40.0-255,66,126346,65,177362
13634,0.001955,74.125.24.0-255,1484,127830,65,177362
13635,0.00196,74.125.24.0-255,2902,130732,65,177362
13636,0.001963,172.31.40.0-255,66,130798,65,177362
13637,0.001979,172.31.40.0-255,66,130864,65,177362
13638,0.002018,172.31.40.0-255,66,130930,65,177362
13639,0.004043,74.125.24.0-255,5738,136668,65,177362
13640,0.004052,172.31.40.0-255,66,136734,65,177362
13641,0.006067,74.125.24.0-255,5738,142472,65,177362
13642,0.006074,172.31.40.0-255,66,142538,65,177362
13643,0.008142,74.125.24.0-255,5738,148276,65,177362
13644,0.008158,172.31.40.0-255,66,148342,65,177362
13645,0.010185,74.125.24.0-255,5738,154080,65,177362
13646,0.010197,172.31.40.0-255,66,154146,65,177362
13647,0.012224,74.125.24.0-255,5738,159884,65,177362
13648,0.01223,172.31.40.0-255,66,159950,65,177362
13649,0.014277,74.125.24.0-255,5738,165688,65,177362
13650,0.014285,172.31.40.0-255,66,165754,65,177362
13651,0.016344,74.125.24.0-255,5738,171492,65,177362
13652,0.01636,172.31.40.0-255,66,171558,65,177362
13653,0.018396,74.125.24.0-255,5738,177296,65,177362
13654,0.018411,172.31.40.0-255,66,177362,65,177362
13655,0.0,172.31.40.0-255,105,105,65,459
13656,0.000226,172.31.40.0-255,90,195,65,459
13657,0.000238,172.31.40.0-255,66,261,65,459
13658,0.002454,74.125.68.0-255,66,327,65,459
13659,0.002477,74.125.68.0-255,66,393,65,459
13660,0.002492,172.31.40.0-255,66,459,65,459
13661,0.0,74.125.24.0-255,156,156,65,161919
13662,2.4e-05,172.31.40.0-255,66,222,65,161919
13663,3.1e-05,74.125.24.0-255,1484,1706,65,161919
13664,3.6e-05,172.31.40.0-255,66,1772,65,161919
13665,4.3e-05,74.125.24.0-255,2902,4674,65,161919
13666,5.5e-05,172.31.40.0-255,66,4740,65,161919
13667,6.2e-05,74.125.24.0-255,7156,11896,65,161919
13668,6.5e-05,172.31.40.0-255,66,11962,65,161919
13669,0.000121,172.31.40.0-255,66,12028,65,161919
13670,0.000126,74.125.24.0-255,2543,14571,65,161919
13671,0.000128,172.31.40.0-255,66,14637,65,161919
13672,0.000525,74.125.24.0-255,1484,16121,65,161919
13673,0.000531,172.31.40.0-255,66,16187,65,161919
13674,0.000537,74.125.24.0-255,2902,19089,65,161919
13675,0.00054,172.31.40.0-255,66,19155,65,161919
13676,0.000591,74.125.24.0-255,4320,23475,65,161919
13677,0.000594,172.31.40.0-255,66,23541,65,161919
13678,0.000626,74.125.24.0-255,5738,29279,65,161919
13679,0.000628,172.31.40.0-255,66,29345,65,161919
13680,0.000633,74.125.24.0-255,2543,31888,65,161919
13681,0.000636,172.31.40.0-255,66,31954,65,161919
13682,0.001567,74.125.24.0-255,1484,33438,65,161919
13683,0.001574,172.31.40.0-255,66,33504,65,161919
13684,0.001584,74.125.24.0-255,2902,36406,65,161919
13685,0.001586,172.31.40.0-255,66,36472,65,161919
13686,0.001617,74.125.24.0-255,4320,40792,65,161919
13687,0.00162,172.31.40.0-255,66,40858,65,161919
13688,0.001633,74.125.24.0-255,1484,42342,65,161919
13689,0.001635,172.31.40.0-255,66,42408,65,161919
13690,0.001672,172.31.40.0-255,66,42474,65,161919
13691,0.001675,74.125.24.0-255,1484,43958,65,161919
13692,0.001689,172.31.40.0-255,66,44024,65,161919
13693,0.001719,74.125.24.0-255,1484,45508,65,161919
13694,0.001737,172.31.40.0-255,66,45574,65,161919
13695,0.00174,74.125.24.0-255,646,46220,65,161919
13696,0.00179,74.125.24.0-255,1484,47704,65,161919
13697,0.001792,172.31.40.0-255,66,47770,65,161919
13698,0.001797,74.125.24.0-255,2902,50672,65,161919
13699,0.0018,172.31.40.0-255,66,50738,65,161919
13700,0.001804,74.125.24.0-255,2902,53640,65,161919
13701,0.001807,172.31.40.0-255,66,53706,65,161919
13702,0.001835,74.125.24.0-255,2902,56608,65,161919
13703,0.001838,172.31.40.0-255,66,56674,65,161919
13704,0.001843,74.125.24.0-255,2902,59576,65,161919
13705,0.001845,172.31.40.0-255,66,59642,65,161919
13706,0.001868,74.125.24.0-255,3297,62939,65,161919
13707,0.001871,172.31.40.0-255,66,63005,65,161919
13708,0.001944,74.125.24.0-255,1484,64489,65,161919
13709,0.001957,74.125.24.0-255,2902,67391,65,161919
13710,0.001959,172.31.40.0-255,66,67457,65,161919
13711,0.001962,74.125.24.0-255,1484,68941,65,161919
13712,0.001992,74.125.24.0-255,4320,73261,65,161919
13713,0.001995,172.31.40.0-255,66,73327,65,161919
13714,0.002016,172.31.40.0-255,66,73393,65,161919
13715,0.002088,74.125.24.0-255,1484,74877,65,161919
13716,0.002107,74.125.24.0-255,2902,77779,65,161919
13717,0.002109,172.31.40.0-255,66,77845,65,161919
13718,0.002114,74.125.24.0-255,2902,80747,65,161919
13719,0.002115,172.31.40.0-255,66,80813,65,161919
13720,0.002138,74.125.24.0-255,2902,83715,65,161919
13721,0.00214,172.31.40.0-255,66,83781,65,161919
13722,0.00215,74.125.24.0-255,4320,88101,65,161919
13723,0.002152,172.31.40.0-255,66,88167,65,161919
13724,0.002198,172.31.40.0-255,66,88233,65,161919
13725,0.002204,74.125.24.0-255,4320,92553,65,161919
13726,0.002206,172.31.40.0-255,66,92619,65,161919
13727,0.002213,74.125.24.0-255,6438,99057,65,161919
13728,0.002218,172.31.40.0-255,66,99123,65,161919
13729,0.002254,74.125.24.0-255,1484,100607,65,161919
13730,0.00228,74.125.24.0-255,4320,104927,65,161919
13731,0.002288,74.125.24.0-255,7156,112083,65,161919
13732,0.002295,74.125.24.0-255,7156,119239,65,161919
13733,0.002314,74.125.24.0-255,7156,126395,65,161919
13734,0.002321,74.125.24.0-255,6438,132833,65,161919
13735,0.006199,172.31.40.0-255,66,132899,65,161919
13736,0.008512,74.125.24.0-255,5738,138637,65,161919
13737,0.008518,172.31.40.0-255,66,138703,65,161919
13738,0.010851,74.125.24.0-255,5738,144441,65,161919
13739,0.010859,172.31.40.0-255,66,144507,65,161919
13740,0.01317,74.125.24.0-255,5738,150245,65,161919
13741,0.013177,172.31.40.0-255,66,150311,65,161919
13742,0.015494,74.125.24.0-255,5738,156049,65,161919
13743,0.015501,172.31.40.0-255,66,156115,65,161919
13744,0.017795,74.125.24.0-255,5738,161853,65,161919
13745,0.017802,172.31.40.0-255,66,161919,65,161919
13746,0.0,172.217.194.0-255,298,298,65,143887
13747,2e-05,172.31.40.0-255,66,364,65,143887
13748,2.7e-05,172.217.194.0-255,1484,1848,65,143887
13749,3.2e-05,172.31.40.0-255,66,1914,65,143887
13750,4e-05,172.217.194.0-255,4320,6234,65,143887
13751,4.3e-05,172.31.40.0-255,66,6300,65,143887
13752,4.9e-05,172.217.194.0-255,5738,12038,65,143887
13753,5.2e-05,172.31.40.0-255,66,12104,65,143887
13754,9.3e-05,172.217.194.0-255,1941,14045,65,143887
13755,9.6e-05,172.31.40.0-255,66,14111,65,143887
13756,0.000116,172.217.194.0-255,2902,17013,65,143887
13757,0.00012,172.31.40.0-255,66,17079,65,143887
13758,0.000138,172.217.194.0-255,4320,21399,65,143887
13759,0.000141,172.31.40.0-255,66,21465,65,143887
13760,0.000165,172.217.194.0-255,5738,27203,65,143887
13761,0.000168,172.31.40.0-255,66,27269,65,143887
13762,0.000186,172.217.194.0-255,2902,30171,65,143887
13763,0.00019,172.31.40.0-255,66,30237,65,143887
13764,0.000227,172.217.194.0-255,1125,31362,65,143887
13765,0.00023,172.31.40.0-255,66,31428,65,143887
13766,0.000427,172.217.194.0-255,1484,32912,65,143887
13767,0.000432,172.31.40.0-255,66,32978,65,143887
13768,0.000439,172.217.194.0-255,2902,35880,65,143887
13769,0.000442,172.31.40.0-255,66,35946,65,143887
13770,0.000445,172.217.194.0-255,1484,37430,65,143887
13771,0.000447,172.31.40.0-255,66,37496,65,143887
13772,0.000462,172.217.194.0-255,4320,41816,65,143887
13773,0.000465,172.31.40.0-255,66,41882,65,143887
13774,0.000501,172.217.194.0-255,4320,46202,65,143887
13775,0.000504,172.31.40.0-255,66,46268,65,143887
13776,0.000522,172.217.194.0-255,2543,48811,65,143887
13777,0.000525,172.31.40.0-255,66,48877,65,143887
13778,0.000564,172.217.194.0-255,7156,56033,65,143887
13779,0.000581,172.217.194.0-255,2902,58935,65,143887
13780,0.000586,172.31.40.0-255,66,59001,65,143887
13781,0.000591,172.31.40.0-255,66,59067,65,143887
13782,0.000639,172.217.194.0-255,4320,63387,65,143887
13783,0.000659,172.217.194.0-255,2543,65930,65,143887
13784,0.000666,172.31.40.0-255,66,65996,65,143887
13785,0.000893,172.217.194.0-255,646,66642,65,143887
13786,0.000966,172.217.194.0-255,1484,68126,65,143887
13787,0.000977,172.31.40.0-255,66,68192,65,143887
13788,0.000982,172.217.194.0-255,2902,71094,65,143887
13789,0.000985,172.217.194.0-255,1484,72578,65,143887
13790,0.000989,172.31.40.0-255,66,72644,65,143887
13791,0.001001,172.217.194.0-255,4320,76964,65,143887
13792,0.001027,172.31.40.0-255,66,77030,65,143887
13793,0.001043,172.217.194.0-255,2902,79932,65,143887
13794,0.001045,172.31.40.0-255,66,79998,65,143887
13795,0.001085,172.31.40.0-255,66,80064,65,143887
13796,0.001158,172.217.194.0-255,4320,84384,65,143887
13797,0.001164,172.31.40.0-255,66,84450,65,143887
13798,0.001187,172.217.194.0-255,6438,90888,65,143887
13799,0.001192,172.31.40.0-255,66,90954,65,143887
13800,0.001247,172.217.194.0-255,4320,95274,65,143887
13801,0.001268,172.31.40.0-255,66,95340,65,143887
13802,0.001288,172.217.194.0-255,4320,99660,65,143887
13803,0.001296,172.31.40.0-255,66,99726,65,143887
13804,0.001305,172.217.194.0-255,1484,101210,65,143887
13805,0.00136,172.217.194.0-255,4320,105530,65,143887
13806,0.001365,172.31.40.0-255,66,105596,65,143887
13807,0.001389,172.217.194.0-255,7156,112752,65,143887
13808,0.001394,172.31.40.0-255,66,112818,65,143887
13809,0.001436,172.217.194.0-255,5738,118556,65,143887
13810,0.001446,172.31.40.0-255,66,118622,65,143887
13811,0.001457,172.217.194.0-255,6438,125060,65,143887
13812,0.001462,172.31.40.0-255,66,125126,65,143887
13813,0.001565,172.31.40.0-255,66,125192,65,143887
13814,0.001589,172.31.40.0-255,66,125258,65,143887
13815,0.001782,172.31.40.0-255,66,125324,65,143887
13816,0.001881,172.217.194.0-255,5738,131062,65,143887
13817,0.001891,172.31.40.0-255,66,131128,65,143887
13818,0.001916,172.31.40.0-255,66,131194,65,143887
13819,0.002049,172.217.194.0-255,4320,135514,65,143887
13820,0.002075,172.31.40.0-255,66,135580,65,143887
13821,0.002093,172.31.40.0-255,66,135646,65,143887
13822,0.002148,172.217.194.0-255,7156,142802,65,143887
13823,0.002181,172.31.40.0-255,66,142868,65,143887
13824,0.002221,172.31.40.0-255,66,142934,65,143887
13825,0.002558,172.31.40.0-255,66,143000,65,143887
13826,0.012982,172.217.194.0-255,704,143704,65,143887
13827,0.013009,172.31.40.0-255,78,143782,65,143887
13828,0.019873,172.31.40.0-255,105,143887,65,143887
13829,0.0,74.125.68.0-255,160,160,65,234683
13830,2.3e-05,172.31.40.0-255,66,226,65,234683
13831,3.1e-05,74.125.68.0-255,1484,1710,65,234683
13832,3.7e-05,172.31.40.0-255,66,1776,65,234683
13833,4.2e-05,74.125.68.0-255,2902,4678,65,234683
13834,4.5e-05,172.31.40.0-255,66,4744,65,234683
13835,8.2e-05,74.125.68.0-255,5738,10482,65,234683
13836,8.6e-05,172.31.40.0-255,66,10548,65,234683
13837,8.9e-05,74.125.68.0-255,1484,12032,65,234683
13838,9.2e-05,172.31.40.0-255,66,12098,65,234683
13839,0.000124,74.125.68.0-255,1901,13999,65,234683
13840,0.000127,172.31.40.0-255,66,14065,65,234683
13841,0.000132,74.125.68.0-255,2902,16967,65,234683
13842,0.000135,172.31.40.0-255,66,17033,65,234683
13843,0.000168,74.125.68.0-255,7156,24189,65,234683
13844,0.000171,172.31.40.0-255,66,24255,65,234683
13845,0.000175,74.125.68.0-255,2902,27157,65,234683
13846,0.000178,172.31.40.0-255,66,27223,65,234683
13847,0.0002,74.125.68.0-255,2902,30125,65,234683
13848,0.000208,172.31.40.0-255,66,30191,65,234683
13849,0.000215,74.125.68.0-255,7156,37347,65,234683
13850,0.000217,172.31.40.0-255,66,37413,65,234683
13851,0.000244,74.125.68.0-255,1484,38897,65,234683
13852,0.000247,172.31.40.0-255,66,38963,65,234683
13853,0.000251,74.125.68.0-255,2902,41865,65,234683
13854,0.000254,172.31.40.0-255,66,41931,65,234683
13855,0.000278,74.125.68.0-255,5738,47669,65,234683
13856,0.000287,172.31.40.0-255,66,47735,65,234683
13857,0.00029,74.125.68.0-255,766,48501,65,234683
13858,0.000292,172.31.40.0-255,66,48567,65,234683
13859,0.00041,74.125.68.0-255,1484,50051,65,234683
13860,0.000415,172.31.40.0-255,66,50117,65,234683
13861,0.000419,74.125.68.0-255,1484,51601,65,234683
13862,0.000446,74.125.68.0-255,2902,54503,65,234683
13863,0.000449,172.31.40.0-255,66,54569,65,234683
13864,0.00048,74.125.68.0-255,5738,60307,65,234683
13865,0.000483,172.31.40.0-255,66,60373,65,234683
13866,0.000535,74.125.68.0-255,5379,65752,65,234683
13867,0.000538,172.31.40.0-255,66,65818,65,234683
13868,0.000968,74.125.68.0-255,1484,67302,65,234683
13869,0.000973,74.125.68.0-255,1484,68786,65,234683
13870,0.000977,172.31.40.0-255,66,68852,65,234683
13871,0.001005,74.125.68.0-255,1484,70336,65,234683
13872,0.001008,74.125.68.0-255,1484,71820,65,234683
13873,0.001012,74.125.68.0-255,2902,74722,65,234683
13874,0.001018,172.31.40.0-255,66,74788,65,234683
13875,0.00102,172.31.40.0-255,66,74854,65,234683
13876,0.001031,74.125.68.0-255,4320,79174,65,234683
13877,0.001034,172.31.40.0-255,66,79240,65,234683
13878,0.001059,74.125.68.0-255,1484,80724,65,234683
13879,0.001064,74.125.68.0-255,2902,83626,65,234683
13880,0.001066,172.31.40.0-255,66,83692,65,234683
13881,0.00107,74.125.68.0-255,1484,85176,65,234683
13882,0.001109,74.125.68.0-255,2902,88078,65,234683
13883,0.001112,172.31.40.0-255,66,88144,65,234683
13884,0.001117,74.125.68.0-255,2902,91046,65,234683
13885,0.001119,172.31.40.0-255,66,91112,65,234683
13886,0.001124,74.125.68.0-255,4320,95432,65,234683
13887,0.001127,172.31.40.0-255,66,95498,65,234683
13888,0.001153,74.125.68.0-255,5020,100518,65,234683
13889,0.001157,172.31.40.0-255,66,100584,65,234683
13890,0.00122,74.125.68.0-255,1484,102068,65,234683
13891,0.001227,74.125.68.0-255,2902,104970,65,234683
13892,0.001229,172.31.40.0-255,66,105036,65,234683
13893,0.001233,74.125.68.0-255,1484,106520,65,234683
13894,0.001256,74.125.68.0-255,1484,108004,65,234683
13895,0.001259,172.31.40.0-255,66,108070,65,234683
13896,0.001265,74.125.68.0-255,4320,112390,65,234683
13897,0.001267,172.31.40.0-255,66,112456,65,234683
13898,0.001306,172.31.40.0-255,66,112522,65,234683
13899,0.00131,74.125.68.0-255,1484,114006,65,234683
13900,0.001338,74.125.68.0-255,4320,118326,65,234683
13901,0.001341,172.31.40.0-255,66,118392,65,234683
13902,0.001378,74.125.68.0-255,7156,125548,65,234683
13903,0.001381,172.31.40.0-255,66,125614,65,234683
13904,0.001384,74.125.68.0-255,766,126380,65,234683
13905,0.001426,172.31.40.0-255,66,126446,65,234683
13906,0.001459,74.125.68.0-255,6783,133229,65,234683
13907,0.001462,172.31.40.0-255,66,133295,65,234683
13908,0.001637,74.125.68.0-255,1484,134779,65,234683
13909,0.001649,74.125.68.0-255,1484,136263,65,234683
13910,0.001652,172.31.40.0-255,66,136329,65,234683
13911,0.001681,74.125.68.0-255,1484,137813,65,234683
13912,0.001689,74.125.68.0-255,5738,143551,65,234683
13913,0.001691,172.31.40.0-255,66,143617,65,234683
13914,0.001734,172.31.40.0-255,66,143683,65,234683
13915,0.001808,172.31.40.0-255,66,143749,65,234683
13916,0.00183,74.125.68.0-255,766,144515,65,234683
13917,0.001994,74.125.68.0-255,1484,145999,65,234683
13918,0.001998,172.31.40.0-255,66,146065,65,234683
13919,0.002002,74.125.68.0-255,1484,147549,65,234683
13920,0.002017,74.125.68.0-255,1484,149033,65,234683
13921,0.002019,172.31.40.0-255,66,149099,65,234683
13922,0.002035,74.125.68.0-255,4320,153419,65,234683
13923,0.002041,172.31.40.0-255,66,153485,65,234683
13924,0.002054,74.125.68.0-255,1484,154969,65,234683
13925,0.002064,74.125.68.0-255,4320,159289,65,234683
13926,0.002067,172.31.40.0-255,66,159355,65,234683
13927,0.002095,74.125.68.0-255,7156,166511,65,234683
13928,0.002098,172.31.40.0-255,66,166577,65,234683
13929,0.002103,74.125.68.0-255,4320,170897,65,234683
13930,0.002106,172.31.40.0-255,66,170963,65,234683
13931,0.00214,172.31.40.0-255,66,171029,65,234683
13932,0.00217,74.125.68.0-255,2902,173931,65,234683
13933,0.002173,172.31.40.0-255,66,173997,65,234683
13934,0.002176,74.125.68.0-255,1484,175481,65,234683
13935,0.002202,74.125.68.0-255,2902,178383,65,234683
13936,0.002204,172.31.40.0-255,66,178449,65,234683
13937,0.002215,172.31.40.0-255,66,178515,65,234683
13938,0.002253,74.125.68.0-255,2902,181417,65,234683
13939,0.002262,172.31.40.0-255,66,181483,65,234683
13940,0.002267,74.125.68.0-255,2902,184385,65,234683
13941,0.002269,172.31.40.0-255,66,184451,65,234683
13942,0.0023,172.31.40.0-255,66,184517,65,234683
13943,0.00235,74.125.68.0-255,2184,186701,65,234683
13944,0.002353,172.31.40.0-255,66,186767,65,234683
13945,0.002357,74.125.68.0-255,1484,188251,65,234683
13946,0.002364,74.125.68.0-255,5738,193989,65,234683
13947,0.002367,172.31.40.0-255,66,194055,65,234683
13948,0.004687,74.125.68.0-255,5738,199793,65,234683
13949,0.004707,172.31.40.0-255,66,199859,65,234683
13950,0.007015,74.125.68.0-255,5738,205597,65,234683
13951,0.007034,172.31.40.0-255,66,205663,65,234683
13952,0.009342,74.125.68.0-255,5738,211401,65,234683
13953,0.009351,172.31.40.0-255,66,211467,65,234683
13954,0.011691,74.125.68.0-255,5738,217205,65,234683
13955,0.011709,172.31.40.0-255,66,217271,65,234683
13956,0.014019,74.125.68.0-255,5738,223009,65,234683
13957,0.014031,172.31.40.0-255,66,223075,65,234683
13958,0.016332,74.125.68.0-255,5738,228813,65,234683
13959,0.016339,172.31.40.0-255,66,228879,65,234683
13960,0.018647,74.125.68.0-255,5738,234617,65,234683
13961,0.018662,172.31.40.0-255,66,234683,65,234683
13962,0.0,74.125.24.0-255,153,153,65,163871
13963,2e-05,172.31.40.0-255,66,219,65,163871
13964,2.7e-05,74.125.24.0-255,1484,1703,65,163871
13965,3.1e-05,172.31.40.0-255,66,1769,65,163871
13966,3.5e-05,74.125.24.0-255,2902,4671,65,163871
13967,4.5e-05,172.31.40.0-255,66,4737,65,163871
13968,5.2e-05,74.125.24.0-255,7156,11893,65,163871
13969,5.5e-05,172.31.40.0-255,66,11959,65,163871
13970,7.2e-05,74.125.24.0-255,2020,13979,65,163871
13971,7.8e-05,172.31.40.0-255,66,14045,65,163871
13972,0.000224,74.125.24.0-255,1484,15529,65,163871
13973,0.000228,172.31.40.0-255,66,15595,65,163871
13974,0.000234,74.125.24.0-255,2902,18497,65,163871
13975,0.000236,172.31.40.0-255,66,18563,65,163871
13976,0.000239,74.125.24.0-255,1484,20047,65,163871
13977,0.000242,172.31.40.0-255,66,20113,65,163871
13978,0.000281,74.125.24.0-255,4320,24433,65,163871
13979,0.000284,172.31.40.0-255,66,24499,65,163871
13980,0.000292,74.125.24.0-255,6797,31296,65,163871
13981,0.000295,172.31.40.0-255,66,31362,65,163871
13982,0.000365,74.125.24.0-255,1484,32846,65,163871
13983,0.000368,172.31.40.0-255,66,32912,65,163871
13984,0.000371,74.125.24.0-255,1484,34396,65,163871
13985,0.000373,172.31.40.0-255,66,34462,65,163871
13986,0.00039,74.125.24.0-255,1484,35946,65,163871
13987,0.000392,172.31.40.0-255,66,36012,65,163871
13988,0.000399,74.125.24.0-255,5738,41750,65,163871
13989,0.000402,172.31.40.0-255,66,41816,65,163871
13990,0.00044,74.125.24.0-255,6797,48613,65,163871
13991,0.000444,172.31.40.0-255,66,48679,65,163871
13992,0.000451,74.125.24.0-255,7156,55835,65,163871
13993,0.000453,172.31.40.0-255,66,55901,65,163871
13994,0.000493,172.31.40.0-255,66,55967,65,163871
13995,0.000496,74.125.24.0-255,382,56349,65,163871
13996,0.000546,74.125.24.0-255,1484,57833,65,163871
13997,0.000549,172.31.40.0-255,66,57899,65,163871
13998,0.000555,74.125.24.0-255,4320,62219,65,163871
13999,0.000557,172.31.40.0-255,66,62285,65,163871
14000,0.000597,74.125.24.0-255,7156,69441,65,163871
14001,0.0006,172.31.40.0-255,66,69507,65,163871
14002,0.00061,172.31.40.0-255,66,69573,65,163871
14003,0.000655,172.31.40.0-255,66,69639,65,163871
14004,0.001704,74.125.24.0-255,1484,71123,65,163871
14005,0.001713,74.125.24.0-255,2902,74025,65,163871
14006,0.001717,172.31.40.0-255,66,74091,65,163871
14007,0.001724,74.125.24.0-255,5738,79829,65,163871
14008,0.001726,172.31.40.0-255,66,79895,65,163871
14009,0.001729,74.125.24.0-255,1484,81379,65,163871
14010,0.001757,74.125.24.0-255,5738,87117,65,163871
14011,0.001759,172.31.40.0-255,66,87183,65,163871
14012,0.001763,74.125.24.0-255,2902,90085,65,163871
14013,0.001765,172.31.40.0-255,66,90151,65,163871
14014,0.001817,172.31.40.0-255,66,90217,65,163871
14015,0.001822,74.125.24.0-255,2184,92401,65,163871
14016,0.001823,172.31.40.0-255,66,92467,65,163871
14017,0.001863,74.125.24.0-255,1484,93951,65,163871
14018,0.001867,74.125.24.0-255,2902,96853,65,163871
14019,0.001869,172.31.40.0-255,66,96919,65,163871
14020,0.001896,74.125.24.0-255,5738,102657,65,163871
14021,0.001898,172.31.40.0-255,66,102723,65,163871
14022,0.001901,74.125.24.0-255,1484,104207,65,163871
14023,0.00193,172.31.40.0-255,66,104273,65,163871
14024,0.001954,74.125.24.0-255,4320,108593,65,163871
14025,0.001956,172.31.40.0-255,66,108659,65,163871
14026,0.001967,172.31.40.0-255,66,108725,65,163871
14027,0.001973,74.125.24.0-255,7156,115881,65,163871
14028,0.001975,172.31.40.0-255,66,115947,65,163871
14029,0.002005,74.125.24.0-255,4320,120267,65,163871
14030,0.002007,172.31.40.0-255,66,120333,65,163871
14031,0.002013,74.125.24.0-255,5738,126071,65,163871
14032,0.002015,172.31.40.0-255,66,126137,65,163871
14033,0.002068,172.31.40.0-255,66,126203,65,163871
14034,0.00209,172.31.40.0-255,66,126269,65,163871
14035,0.002102,172.31.40.0-255,66,126335,65,163871
14036,0.002156,172.31.40.0-255,66,126401,65,163871
14037,0.002204,172.31.40.0-255,66,126467,65,163871
14038,0.002231,172.31.40.0-255,66,126533,65,163871
14039,0.002243,172.31.40.0-255,66,126599,65,163871
14040,0.002255,172.31.40.0-255,66,126665,65,163871
14041,0.002301,172.31.40.0-255,66,126731,65,163871
14042,0.002314,172.31.40.0-255,66,126797,65,163871
14043,0.002353,74.125.24.0-255,5738,132535,65,163871
14044,0.002373,74.125.24.0-255,3602,136137,65,163871
14045,0.007481,172.31.40.0-255,66,136203,65,163871
14046,0.00979,74.125.24.0-255,4320,140523,65,163871
14047,0.009796,172.31.40.0-255,66,140589,65,163871
14048,0.009829,74.125.24.0-255,1484,142073,65,163871
14049,0.012087,74.125.24.0-255,4320,146393,65,163871
14050,0.012096,172.31.40.0-255,66,146459,65,163871
14051,0.01439,74.125.24.0-255,5738,152197,65,163871
14052,0.014398,172.31.40.0-255,66,152263,65,163871
14053,0.016695,74.125.24.0-255,5738,158001,65,163871
14054,0.016705,172.31.40.0-255,66,158067,65,163871
14055,0.019006,74.125.24.0-255,5738,163805,65,163871
14056,0.019015,172.31.40.0-255,66,163871,65,163871
14057,0.0,74.125.130.0-255,150,150,65,261866
14058,2.4e-05,172.31.40.0-255,66,216,65,261866
14059,3.2e-05,74.125.130.0-255,1484,1700,65,261866
14060,3.6e-05,172.31.40.0-255,66,1766,65,261866
14061,5.9e-05,74.125.130.0-255,1484,3250,65,261866
14062,6.3e-05,172.31.40.0-255,66,3316,65,261866
14063,9.5e-05,74.125.130.0-255,1484,4800,65,261866
14064,9.8e-05,172.31.40.0-255,66,4866,65,261866
14065,0.000104,74.125.130.0-255,2902,7768,65,261866
14066,0.000106,172.31.40.0-255,66,7834,65,261866
14067,0.000112,74.125.130.0-255,4320,12154,65,261866
14068,0.000114,172.31.40.0-255,66,12220,65,261866
14069,0.000118,74.125.130.0-255,2038,14258,65,261866
14070,0.000121,172.31.40.0-255,66,14324,65,261866
14071,0.000125,74.125.130.0-255,1484,15808,65,261866
14072,0.000141,172.31.40.0-255,66,15874,65,261866
14073,0.000162,74.125.130.0-255,1484,17358,65,261866
14074,0.000165,172.31.40.0-255,66,17424,65,261866
14075,0.000171,74.125.130.0-255,4320,21744,65,261866
14076,0.000173,172.31.40.0-255,66,21810,65,261866
14077,0.000201,74.125.130.0-255,7156,28966,65,261866
14078,0.000205,172.31.40.0-255,66,29032,65,261866
14079,0.000219,74.125.130.0-255,1484,30516,65,261866
14080,0.000221,172.31.40.0-255,66,30582,65,261866
14081,0.000225,74.125.130.0-255,1125,31707,65,261866
14082,0.000227,172.31.40.0-255,66,31773,65,261866
14083,0.000314,74.125.130.0-255,1484,33257,65,261866
14084,0.000318,172.31.40.0-255,66,33323,65,261866
14085,0.000324,74.125.130.0-255,2902,36225,65,261866
14086,0.000326,172.31.40.0-255,66,36291,65,261866
14087,0.000329,74.125.130.0-255,1484,37775,65,261866
14088,0.000331,172.31.40.0-255,66,37841,65,261866
14089,0.000336,74.125.130.0-255,2902,40743,65,261866
14090,0.000355,74.125.130.0-255,2902,43645,65,261866
14091,0.000367,74.125.130.0-255,2902,46547,65,261866
14092,0.000385,74.125.130.0-255,5379,51926,65,261866
14093,0.000404,74.125.130.0-255,5738,57664,65,261866
14094,0.000468,74.125.130.0-255,376,58040,65,261866
14095,0.000756,74.125.130.0-255,1484,59524,65,261866
14096,0.000764,74.125.130.0-255,2902,62426,65,261866
14097,0.000789,74.125.130.0-255,5738,68164,65,261866
14098,0.000793,74.125.130.0-255,1484,69648,65,261866
14099,0.000804,74.125.130.0-255,1484,71132,65,261866
14100,0.000844,74.125.130.0-255,4320,75452,65,261866
14101,0.000866,74.125.130.0-255,6797,82249,65,261866
14102,0.000873,74.125.130.0-255,5738,87987,65,261866
14103,0.000901,74.125.130.0-255,4239,92226,65,261866
14104,0.000969,74.125.130.0-255,1484,93710,65,261866
14105,0.000975,74.125.130.0-255,2902,96612,65,261866
14106,0.001,74.125.130.0-255,4320,100932,65,261866
14107,0.001019,74.125.130.0-255,4320,105252,65,261866
14108,0.001039,74.125.130.0-255,1484,106736,65,261866
14109,0.001065,74.125.130.0-255,1484,108220,65,261866
14110,0.001071,74.125.130.0-255,4320,112540,65,261866
14111,0.001114,74.125.130.0-255,3602,116142,65,261866
14112,0.001155,74.125.130.0-255,2902,119044,65,261866
14113,0.001159,74.125.130.0-255,1484,120528,65,261866
14114,0.001195,74.125.130.0-255,2902,123430,65,261866
14115,0.001229,74.125.130.0-255,2902,126332,65,261866
14116,0.001232,74.125.130.0-255,1484,127816,65,261866
14117,0.001281,74.125.130.0-255,2184,130000,65,261866
14118,0.001339,74.125.130.0-255,1484,131484,65,261866
14119,0.001344,74.125.130.0-255,2902,134386,65,261866
14120,0.001367,74.125.130.0-255,2902,137288,65,261866
14121,0.001394,74.125.130.0-255,2902,140190,65,261866
14122,0.001401,74.125.130.0-255,7156,147346,65,261866
14123,0.001408,74.125.130.0-255,5738,153084,65,261866
14124,0.00143,74.125.130.0-255,7156,160240,65,261866
14125,0.00148,74.125.130.0-255,3602,163842,65,261866
14126,0.001562,172.31.40.0-255,66,163908,65,261866
14127,0.001875,74.125.130.0-255,1484,165392,65,261866
14128,0.001882,74.125.130.0-255,2902,168294,65,261866
14129,0.00189,172.31.40.0-255,66,168360,65,261866
14130,0.001917,74.125.130.0-255,5738,174098,65,261866
14131,0.001924,74.125.130.0-255,7156,181254,65,261866
14132,0.001928,74.125.130.0-255,2902,184156,65,261866
14133,0.001935,172.31.40.0-255,66,184222,65,261866
14134,0.001947,74.125.130.0-255,5738,189960,65,261866
14135,0.001975,74.125.130.0-255,5738,195698,65,261866
14136,0.00198,172.31.40.0-255,66,195764,65,261866
14137,0.001991,74.125.130.0-255,2184,197948,65,261866
14138,0.002011,172.31.40.0-255,66,198014,65,261866
14139,0.002027,74.125.130.0-255,1484,199498,65,261866
14140,0.00203,74.125.130.0-255,1484,200982,65,261866
14141,0.002047,172.31.40.0-255,66,201048,65,261866
14142,0.002051,74.125.130.0-255,1484,202532,65,261866
14143,0.002053,74.125.130.0-255,1484,204016,65,261866
14144,0.002058,172.31.40.0-255,66,204082,65,261866
14145,0.002067,74.125.130.0-255,2902,206984,65,261866
14146,0.002073,74.125.130.0-255,5738,212722,65,261866
14147,0.00209,172.31.40.0-255,66,212788,65,261866
14148,0.002098,74.125.130.0-255,1484,214272,65,261866
14149,0.002141,172.31.40.0-255,66,214338,65,261866
14150,0.002163,74.125.130.0-255,5738,220076,65,261866
14151,0.00217,172.31.40.0-255,66,220142,65,261866
14152,0.002179,74.125.130.0-255,2184,222326,65,261866
14153,0.002201,172.31.40.0-255,66,222392,65,261866
14154,0.002231,74.125.130.0-255,1484,223876,65,261866
14155,0.002236,74.125.130.0-255,2902,226778,65,261866
14156,0.002251,74.125.130.0-255,4320,231098,65,261866
14157,0.002258,172.31.40.0-255,66,231164,65,261866
14158,0.002275,74.125.130.0-255,1484,232648,65,261866
14159,0.002279,74.125.130.0-255,1484,234132,65,261866
14160,0.002282,74.125.130.0-255,2902,237034,65,261866
14161,0.00229,172.31.40.0-255,66,237100,65,261866
14162,0.004569,74.125.130.0-255,5738,242838,65,261866
14163,0.004575,172.31.40.0-255,66,242904,65,261866
14164,0.006832,74.125.130.0-255,4320,247224,65,261866
14165,0.006874,74.125.130.0-255,1484,248708,65,261866
14166,0.013866,74.125.130.0-255,1484,250192,65,261866
14167,0.013963,172.31.40.0-255,66,250258,65,261866
14168,0.016202,74.125.130.0-255,5738,255996,65,261866
14169,0.016209,172.31.40.0-255,66,256062,65,261866
14170,0.018452,74.125.130.0-255,5738,261800,65,261866
14171,0.01846,172.31.40.0-255,66,261866,65,261866
14172,0.0,74.125.200.0-255,146,146,65,254744
14173,1.3e-05,172.31.40.0-255,66,212,65,254744
14174,2e-05,74.125.200.0-255,1484,1696,65,254744
14175,2.4e-05,172.31.40.0-255,66,1762,65,254744
14176,2.7e-05,74.125.200.0-255,1484,3246,65,254744
14177,3e-05,172.31.40.0-255,66,3312,65,254744
14178,4.8e-05,74.125.200.0-255,2902,6214,65,254744
14179,5.3e-05,172.31.40.0-255,66,6280,65,254744
14180,6e-05,74.125.200.0-255,5738,12018,65,254744
14181,6.3e-05,172.31.40.0-255,66,12084,65,254744
14182,9.4e-05,74.125.200.0-255,2048,14132,65,254744
14183,9.7e-05,172.31.40.0-255,66,14198,65,254744
14184,0.000165,74.125.200.0-255,1484,15682,65,254744
14185,0.000169,172.31.40.0-255,66,15748,65,254744
14186,0.000172,74.125.200.0-255,1484,17232,65,254744
14187,0.000174,172.31.40.0-255,66,17298,65,254744
14188,0.000178,74.125.200.0-255,1484,18782,65,254744
14189,0.00018,172.31.40.0-255,66,18848,65,254744
14190,0.000216,74.125.200.0-255,1484,20332,65,254744
14191,0.000219,172.31.40.0-255,66,20398,65,254744
14192,0.000225,74.125.200.0-255,5738,26136,65,254744
14193,0.000228,172.31.40.0-255,66,26202,65,254744
14194,0.00024,74.125.200.0-255,7156,33358,65,254744
14195,0.000243,172.31.40.0-255,66,33424,65,254744
14196,0.000267,74.125.200.0-255,1125,34549,65,254744
14197,0.000269,172.31.40.0-255,66,34615,65,254744
14198,0.000285,172.31.40.0-255,66,34681,65,254744
14199,0.000299,172.31.40.0-255,66,34747,65,254744
14200,0.00034,74.125.200.0-255,7156,41903,65,254744
14201,0.000343,172.31.40.0-255,66,41969,65,254744
14202,0.000372,74.125.200.0-255,2184,44153,65,254744
14203,0.000375,172.31.40.0-255,66,44219,65,254744
14204,0.000378,74.125.200.0-255,358,44577,65,254744
14205,0.000451,74.125.200.0-255,387,44964,65,254744
14206,0.0006,74.125.200.0-255,1484,46448,65,254744
14207,0.000606,172.31.40.0-255,66,46514,65,254744
14208,0.000612,74.125.200.0-255,2902,49416,65,254744
14209,0.000614,172.31.40.0-255,66,49482,65,254744
14210,0.000654,74.125.200.0-255,5738,55220,65,254744
14211,0.000657,172.31.40.0-255,66,55286,65,254744
14212,0.000662,74.125.200.0-255,2902,58188,65,254744
14213,0.000664,172.31.40.0-255,66,58254,65,254744
14214,0.000669,74.125.200.0-255,4320,62574,65,254744
14215,0.000671,172.31.40.0-255,66,62640,65,254744
14216,0.000682,74.125.200.0-255,5738,68378,65,254744
14217,0.000685,172.31.40.0-255,66,68444,65,254744
14218,0.00071,74.125.200.0-255,2902,71346,65,254744
14219,0.000717,172.31.40.0-255,66,71412,65,254744
14220,0.000724,74.125.200.0-255,5738,77150,65,254744
14221,0.000726,172.31.40.0-255,66,77216,65,254744
14222,0.00073,74.125.200.0-255,2184,79400,65,254744
14223,0.000732,172.31.40.0-255,66,79466,65,254744
14224,0.001255,74.125.200.0-255,1484,80950,65,254744
14225,0.00126,74.125.200.0-255,2902,83852,65,254744
14226,0.001267,172.31.40.0-255,66,83918,65,254744
14227,0.001296,74.125.200.0-255,5738,89656,65,254744
14228,0.001298,172.31.40.0-255,66,89722,65,254744
14229,0.001306,74.125.200.0-255,7156,96878,65,254744
14230,0.001308,172.31.40.0-255,66,96944,65,254744
14231,0.001313,74.125.200.0-255,4320,101264,65,254744
14232,0.001315,172.31.40.0-255,66,101330,65,254744
14233,0.001348,74.125.200.0-255,4320,105650,65,254744
14234,0.001351,172.31.40.0-255,66,105716,65,254744
14235,0.001361,172.31.40.0-255,66,105782,65,254744
14236,0.001422,74.125.200.0-255,1484,107266,65,254744
14237,0.001426,74.125.200.0-255,1484,108750,65,254744
14238,0.001428,172.31.40.0-255,66,108816,65,254744
14239,0.001456,74.125.200.0-255,1484,110300,65,254744
14240,0.00146,74.125.200.0-255,1484,111784,65,254744
14241,0.001462,172.31.40.0-255,66,111850,65,254744
14242,0.001467,74.125.200.0-255,2902,114752,65,254744
14243,0.001469,172.31.40.0-255,66,114818,65,254744
14244,0.001479,74.125.200.0-255,5738,120556,65,254744
14245,0.001481,172.31.40.0-255,66,120622,65,254744
14246,0.001541,172.31.40.0-255,66,120688,65,254744
14247,0.001547,74.125.200.0-255,4320,125008,65,254744
14248,0.001549,172.31.40.0-255,66,125074,65,254744
14249,0.001567,74.125.200.0-255,2184,127258,65,254744
14250,0.001569,172.31.40.0-255,66,127324,65,254744
14251,0.001641,74.125.200.0-255,1484,128808,65,254744
14252,0.001657,74.125.200.0-255,2902,131710,65,254744
14253,0.001661,172.31.40.0-255,66,131776,65,254744
14254,0.001694,74.125.200.0-255,5738,137514,65,254744
14255,0.001697,172.31.40.0-255,66,137580,65,254744
14256,0.001705,74.125.200.0-255,7156,144736,65,254744
14257,0.001707,172.31.40.0-255,66,144802,65,254744
14258,0.001744,172.31.40.0-255,66,144868,65,254744
14259,0.001749,74.125.200.0-255,2902,147770,65,254744
14260,0.001751,172.31.40.0-255,66,147836,65,254744
14261,0.001796,74.125.200.0-255,5020,152856,65,254744
14262,0.001799,172.31.40.0-255,66,152922,65,254744
14263,0.001885,74.125.200.0-255,1484,154406,65,254744
14264,0.001901,74.125.200.0-255,2902,157308,65,254744
14265,0.001904,172.31.40.0-255,66,157374,65,254744
14266,0.001911,74.125.200.0-255,4320,161694,65,254744
14267,0.001913,172.31.40.0-255,66,161760,65,254744
14268,0.001948,172.31.40.0-255,66,161826,65,254744
14269,0.001959,172.31.40.0-255,66,161892,65,254744
14270,0.001985,74.125.200.0-255,2902,164794,65,254744
14271,0.001987,172.31.40.0-255,66,164860,65,254744
14272,0.002026,74.125.200.0-255,6438,171298,65,254744
14273,0.002029,172.31.40.0-255,66,171364,65,254744
14274,0.00204,74.125.200.0-255,5738,177102,65,254744
14275,0.002042,172.31.40.0-255,66,177168,65,254744
14276,0.002048,74.125.200.0-255,7156,184324,65,254744
14277,0.002055,172.31.40.0-255,66,184390,65,254744
14278,0.002109,172.31.40.0-255,66,184456,65,254744
14279,0.002114,74.125.200.0-255,2902,187358,65,254744
14280,0.002116,172.31.40.0-255,66,187424,65,254744
14281,0.002147,74.125.200.0-255,6438,193862,65,254744
14282,0.002151,172.31.40.0-255,66,193928,65,254744
14283,0.002163,172.31.40.0-255,66,193994,65,254744
14284,0.002173,172.31.40.0-255,66,194060,65,254744
14285,0.002185,172.31.40.0-255,66,194126,65,254744
14286,0.002219,74.125.200.0-255,3602,197728,65,254744
14287,0.002221,172.31.40.0-255,66,197794,65,254744
14288,0.002226,74.125.200.0-255,4320,202114,65,254744
14289,0.002228,172.31.40.0-255,66,202180,65,254744
14290,0.002264,172.31.40.0-255,66,202246,65,254744
14291,0.00227,74.125.200.0-255,5738,207984,65,254744
14292,0.002272,172.31.40.0-255,66,208050,65,254744
14293,0.002318,74.125.200.0-255,4320,212370,65,254744
14294,0.002321,172.31.40.0-255,66,212436,65,254744
14295,0.002364,172.31.40.0-255,66,212502,65,254744
14296,0.002382,172.31.40.0-255,66,212568,65,254744
14297,0.002387,74.125.200.0-255,4320,216888,65,254744
14298,0.00239,172.31.40.0-255,66,216954,65,254744
14299,0.004745,74.125.200.0-255,5738,222692,65,254744
14300,0.004761,172.31.40.0-255,66,222758,65,254744
14301,0.007126,74.125.200.0-255,5738,228496,65,254744
14302,0.00714,172.31.40.0-255,66,228562,65,254744
14303,0.009502,74.125.200.0-255,5738,234300,65,254744
14304,0.009511,172.31.40.0-255,66,234366,65,254744
14305,0.011854,74.125.200.0-255,5738,240104,65,254744
14306,0.01186,172.31.40.0-255,66,240170,65,254744
14307,0.014213,74.125.200.0-255,5738,245908,65,254744
14308,0.014221,172.31.40.0-255,66,245974,65,254744
14309,0.016568,74.125.200.0-255,5738,251712,65,254744
14310,0.016579,172.31.40.0-255,66,251778,65,254744
14311,0.018931,74.125.200.0-255,2795,254573,65,254744
14312,0.018945,172.31.40.0-255,66,254639,65,254744
14313,0.019988,172.31.40.0-255,105,254744,65,254744
14314,0.0,172.217.194.0-255,153,153,65,127082
14315,1.2e-05,172.31.40.0-255,66,219,65,127082
14316,1.7e-05,172.217.194.0-255,1484,1703,65,127082
14317,2e-05,172.31.40.0-255,66,1769,65,127082
14318,2.6e-05,172.217.194.0-255,2902,4671,65,127082
14319,3e-05,172.31.40.0-255,66,4737,65,127082
14320,4.3e-05,172.217.194.0-255,7156,11893,65,127082
14321,4.7e-05,172.31.40.0-255,66,11959,65,127082
14322,5.1e-05,172.217.194.0-255,1982,13941,65,127082
14323,5.4e-05,172.31.40.0-255,66,14007,65,127082
14324,7.4e-05,172.217.194.0-255,1484,15491,65,127082
14325,8.1e-05,172.31.40.0-255,66,15557,65,127082
14326,0.000114,172.31.40.0-255,66,15623,65,127082
14327,0.000125,172.31.40.0-255,66,15689,65,127082
14328,0.000151,172.217.194.0-255,5738,21427,65,127082
14329,0.000154,172.31.40.0-255,66,21493,65,127082
14330,0.000194,172.31.40.0-255,66,21559,65,127082
14331,0.000213,172.31.40.0-255,66,21625,65,127082
14332,0.000217,172.217.194.0-255,2834,24459,65,127082
14333,0.000219,172.31.40.0-255,66,24525,65,127082
14334,0.000223,172.217.194.0-255,365,24890,65,127082
14335,0.000225,172.31.40.0-255,66,24956,65,127082
14336,0.000344,172.217.194.0-255,1484,26440,65,127082
14337,0.000348,172.31.40.0-255,66,26506,65,127082
14338,0.000353,172.217.194.0-255,2902,29408,65,127082
14339,0.000356,172.31.40.0-255,66,29474,65,127082
14340,0.000381,172.217.194.0-255,5738,35212,65,127082
14341,0.000384,172.31.40.0-255,66,35278,65,127082
14342,0.000402,172.31.40.0-255,66,35344,65,127082
14343,0.00041,172.217.194.0-255,7156,42500,65,127082
14344,0.000412,172.31.40.0-255,66,42566,65,127082
14345,0.000452,172.217.194.0-255,3602,46168,65,127082
14346,0.000454,172.31.40.0-255,66,46234,65,127082
14347,0.000761,172.217.194.0-255,1484,47718,65,127082
14348,0.000769,172.217.194.0-255,2902,50620,65,127082
14349,0.000774,172.31.40.0-255,66,50686,65,127082
14350,0.000782,172.217.194.0-255,5738,56424,65,127082
14351,0.000784,172.31.40.0-255,66,56490,65,127082
14352,0.000814,172.217.194.0-255,1484,57974,65,127082
14353,0.000857,172.31.40.0-255,66,58040,65,127082
14354,0.00087,172.31.40.0-255,66,58106,65,127082
14355,0.000921,172.217.194.0-255,1484,59590,65,127082
14356,0.000925,172.217.194.0-255,1484,61074,65,127082
14357,0.000928,172.31.40.0-255,66,61140,65,127082
14358,0.000958,172.217.194.0-255,1484,62624,65,127082
14359,0.000965,172.217.194.0-255,5738,68362,65,127082
14360,0.000968,172.217.194.0-255,2902,71264,65,127082
14361,0.001,172.31.40.0-255,66,71330,65,127082
14362,0.001008,172.31.40.0-255,66,71396,65,127082
14363,0.001025,172.31.40.0-255,66,71462,65,127082
14364,0.001029,172.217.194.0-255,2902,74364,65,127082
14365,0.001031,172.31.40.0-255,66,74430,65,127082
14366,0.001082,172.31.40.0-255,66,74496,65,127082
14367,0.001201,172.217.194.0-255,1484,75980,65,127082
14368,0.00122,172.217.194.0-255,2902,78882,65,127082
14369,0.001224,172.31.40.0-255,66,78948,65,127082
14370,0.001231,172.217.194.0-255,5738,84686,65,127082
14371,0.001234,172.31.40.0-255,66,84752,65,127082
14372,0.001269,172.31.40.0-255,66,84818,65,127082
14373,0.001277,172.217.194.0-255,7156,91974,65,127082
14374,0.001279,172.31.40.0-255,66,92040,65,127082
14375,0.001292,172.217.194.0-255,3602,95642,65,127082
14376,0.001295,172.31.40.0-255,66,95708,65,127082
14377,0.001371,172.217.194.0-255,1484,97192,65,127082
14378,0.001375,172.217.194.0-255,1484,98676,65,127082
14379,0.001378,172.31.40.0-255,66,98742,65,127082
14380,0.001391,172.217.194.0-255,1484,100226,65,127082
14381,0.001408,172.217.194.0-255,5738,105964,65,127082
14382,0.00141,172.31.40.0-255,66,106030,65,127082
14383,0.001414,172.217.194.0-255,2902,108932,65,127082
14384,0.001416,172.31.40.0-255,66,108998,65,127082
14385,0.001463,172.31.40.0-255,66,109064,65,127082
14386,0.001467,172.217.194.0-255,2902,111966,65,127082
14387,0.00147,172.31.40.0-255,66,112032,65,127082
14388,0.001502,172.31.40.0-255,66,112098,65,127082
14389,0.001521,172.31.40.0-255,66,112164,65,127082
14390,0.001533,172.217.194.0-255,7156,119320,65,127082
14391,0.001535,172.31.40.0-255,66,119386,65,127082
14392,0.001564,172.217.194.0-255,7156,126542,65,127082
14393,0.001566,172.31.40.0-255,66,126608,65,127082
14394,0.001629,172.31.40.0-255,66,126674,65,127082
14395,0.001645,172.31.40.0-255,66,126740,65,127082
14396,0.001813,172.217.194.0-255,105,126845,65,127082
14397,0.001835,172.31.40.0-255,66,126911,65,127082
14398,0.00415,172.31.40.0-255,105,127016,65,127082
14399,0.006704,172.217.194.0-255,66,127082,65,127082
14400,0.0,74.125.68.0-255,153,153,65,131567
14401,2.2e-05,172.31.40.0-255,66,219,65,131567
14402,2.9e-05,74.125.68.0-255,1484,1703,65,131567
14403,3.4e-05,172.31.40.0-255,66,1769,65,131567
14404,3.9e-05,74.125.68.0-255,2902,4671,65,131567
14405,4.3e-05,172.31.40.0-255,66,4737,65,131567
14406,4.9e-05,74.125.68.0-255,4320,9057,65,131567
14407,5.2e-05,172.31.40.0-255,66,9123,65,131567
14408,9.1e-05,74.125.68.0-255,2902,12025,65,131567
14409,9.4e-05,172.31.40.0-255,66,12091,65,131567
14410,0.000105,172.31.40.0-255,66,12157,65,131567
14411,0.000111,74.125.68.0-255,5738,17895,65,131567
14412,0.000113,172.31.40.0-255,66,17961,65,131567
14413,0.000135,74.125.68.0-255,1484,19445,65,131567
14414,0.000138,172.31.40.0-255,66,19511,65,131567
14415,0.000173,74.125.68.0-255,3961,23472,65,131567
14416,0.000176,172.31.40.0-255,66,23538,65,131567
14417,0.00115,74.125.68.0-255,1484,25022,65,131567
14418,0.001157,172.31.40.0-255,66,25088,65,131567
14419,0.001168,74.125.68.0-255,2902,27990,65,131567
14420,0.001171,172.31.40.0-255,66,28056,65,131567
14421,0.001213,74.125.68.0-255,4320,32376,65,131567
14422,0.001216,172.31.40.0-255,66,32442,65,131567
14423,0.001236,74.125.68.0-255,5738,38180,65,131567
14424,0.001239,172.31.40.0-255,66,38246,65,131567
14425,0.001262,74.125.68.0-255,1484,39730,65,131567
14426,0.001265,172.31.40.0-255,66,39796,65,131567
14427,0.001287,74.125.68.0-255,5738,45534,65,131567
14428,0.00129,172.31.40.0-255,66,45600,65,131567
14429,0.001295,74.125.68.0-255,4320,49920,65,131567
14430,0.001297,172.31.40.0-255,66,49986,65,131567
14431,0.001351,74.125.68.0-255,5738,55724,65,131567
14432,0.001362,172.31.40.0-255,66,55790,65,131567
14433,0.001373,74.125.68.0-255,2184,57974,65,131567
14434,0.001394,172.31.40.0-255,66,58040,65,131567
14435,0.001513,74.125.68.0-255,647,58687,65,131567
14436,0.001536,74.125.68.0-255,1484,60171,65,131567
14437,0.001539,172.31.40.0-255,66,60237,65,131567
14438,0.001543,74.125.68.0-255,1484,61721,65,131567
14439,0.001565,74.125.68.0-255,1484,63205,65,131567
14440,0.001593,74.125.68.0-255,4320,67525,65,131567
14441,0.001609,74.125.68.0-255,1484,69009,65,131567
14442,0.001617,74.125.68.0-255,7156,76165,65,131567
14443,0.00163,172.31.40.0-255,66,76231,65,131567
14444,0.001667,172.31.40.0-255,66,76297,65,131567
14445,0.002158,74.125.68.0-255,1484,77781,65,131567
14446,0.002167,74.125.68.0-255,2902,80683,65,131567
14447,0.002171,172.31.40.0-255,66,80749,65,131567
14448,0.002175,74.125.68.0-255,1484,82233,65,131567
14449,0.002196,74.125.68.0-255,2902,85135,65,131567
14450,0.002201,74.125.68.0-255,5738,90873,65,131567
14451,0.002389,172.31.40.0-255,66,90939,65,131567
14452,0.004887,74.125.68.0-255,5738,96677,65,131567
14453,0.004893,172.31.40.0-255,66,96743,65,131567
14454,0.007391,74.125.68.0-255,5738,102481,65,131567
14455,0.007398,172.31.40.0-255,66,102547,65,131567
14456,0.009902,74.125.68.0-255,5738,108285,65,131567
14457,0.009911,172.31.40.0-255,66,108351,65,131567
14458,0.012411,74.125.68.0-255,5738,114089,65,131567
14459,0.01242,172.31.40.0-255,66,114155,65,131567
14460,0.014933,74.125.68.0-255,5738,119893,65,131567
14461,0.014942,172.31.40.0-255,66,119959,65,131567
14462,0.017448,74.125.68.0-255,5738,125697,65,131567
14463,0.017456,172.31.40.0-255,66,125763,65,131567
14464,0.019962,74.125.68.0-255,5738,131501,65,131567
14465,0.01997,172.31.40.0-255,66,131567,65,131567
14466,0.0,172.217.194.0-255,146,146,65,201306
14467,2.8e-05,172.31.40.0-255,66,212,65,201306
14468,4.5e-05,172.217.194.0-255,1484,1696,65,201306
14469,4.9e-05,172.31.40.0-255,66,1762,65,201306
14470,5.4e-05,172.217.194.0-255,2902,4664,65,201306
14471,6.3e-05,172.31.40.0-255,66,4730,65,201306
14472,7e-05,172.217.194.0-255,7156,11886,65,201306
14473,7.3e-05,172.31.40.0-255,66,11952,65,201306
14474,9.2e-05,172.217.194.0-255,2022,13974,65,201306
14475,9.8e-05,172.31.40.0-255,66,14040,65,201306
14476,0.000103,172.217.194.0-255,2902,16942,65,201306
14477,0.000105,172.31.40.0-255,66,17008,65,201306
14478,0.000109,172.217.194.0-255,2902,19910,65,201306
14479,0.00011,172.31.40.0-255,66,19976,65,201306
14480,0.000141,172.217.194.0-255,4320,24296,65,201306
14481,0.000145,172.31.40.0-255,66,24362,65,201306
14482,0.000152,172.217.194.0-255,6797,31159,65,201306
14483,0.000154,172.31.40.0-255,66,31225,65,201306
14484,0.000185,172.217.194.0-255,7156,38381,65,201306
14485,0.000188,172.31.40.0-255,66,38447,65,201306
14486,0.000195,172.217.194.0-255,5738,44185,65,201306
14487,0.000197,172.31.40.0-255,66,44251,65,201306
14488,0.000214,172.217.194.0-255,2902,47153,65,201306
14489,0.000216,172.31.40.0-255,66,47219,65,201306
14490,0.000242,172.217.194.0-255,1125,48344,65,201306
14491,0.000246,172.31.40.0-255,66,48410,65,201306
14492,0.000252,172.217.194.0-255,1484,49894,65,201306
14493,0.000253,172.31.40.0-255,66,49960,65,201306
14494,0.000274,172.217.194.0-255,4320,54280,65,201306
14495,0.000276,172.31.40.0-255,66,54346,65,201306
14496,0.000281,172.217.194.0-255,4320,58666,65,201306
14497,0.000283,172.31.40.0-255,66,58732,65,201306
14498,0.000305,172.217.194.0-255,5738,64470,65,201306
14499,0.000313,172.217.194.0-255,1399,65869,65,201306
14500,0.000314,172.31.40.0-255,66,65935,65,201306
14501,0.000333,172.217.194.0-255,434,66369,65,201306
14502,0.000337,172.31.40.0-255,66,66435,65,201306
14503,0.000494,172.217.194.0-255,1484,67919,65,201306
14504,0.000498,172.217.194.0-255,2902,70821,65,201306
14505,0.000501,172.217.194.0-255,1484,72305,65,201306
14506,0.000506,172.31.40.0-255,66,72371,65,201306
14507,0.000516,172.217.194.0-255,4320,76691,65,201306
14508,0.00052,172.31.40.0-255,66,76757,65,201306
14509,0.000574,172.31.40.0-255,66,76823,65,201306
14510,0.000598,172.217.194.0-255,1484,78307,65,201306
14511,0.00061,172.31.40.0-255,66,78373,65,201306
14512,0.000779,172.217.194.0-255,1484,79857,65,201306
14513,0.000784,172.217.194.0-255,2902,82759,65,201306
14514,0.000786,172.31.40.0-255,66,82825,65,201306
14515,0.000789,172.217.194.0-255,1484,84309,65,201306
14516,0.000815,172.217.194.0-255,4320,88629,65,201306
14517,0.000819,172.31.40.0-255,66,88695,65,201306
14518,0.00082,172.217.194.0-255,5738,94433,65,201306
14519,0.000835,172.31.40.0-255,66,94499,65,201306
14520,0.00087,172.217.194.0-255,5020,99519,65,201306
14521,0.000866,172.31.40.0-255,66,99585,65,201306
14522,0.000872,172.31.40.0-255,66,99651,65,201306
14523,0.000891,172.217.194.0-255,1484,101135,65,201306
14524,0.000918,172.217.194.0-255,4320,105455,65,201306
14525,0.000923,172.217.194.0-255,5738,111193,65,201306
14526,0.000924,172.31.40.0-255,66,111259,65,201306
14527,0.000928,172.31.40.0-255,66,111325,65,201306
14528,0.000975,172.217.194.0-255,7156,118481,65,201306
14529,0.00098,172.31.40.0-255,66,118547,65,201306
14530,0.000987,172.217.194.0-255,2184,120731,65,201306
14531,0.000993,172.31.40.0-255,66,120797,65,201306
14532,0.001007,172.217.194.0-255,5738,126535,65,201306
14533,0.001012,172.31.40.0-255,66,126601,65,201306
14534,0.001022,172.217.194.0-255,4320,130921,65,201306
14535,0.001026,172.31.40.0-255,66,130987,65,201306
14536,0.001038,172.31.40.0-255,66,131053,65,201306
14537,0.00109,172.31.40.0-255,66,131119,65,201306
14538,0.001112,172.31.40.0-255,66,131185,65,201306
14539,0.001123,172.217.194.0-255,4320,135505,65,201306
14540,0.001133,172.31.40.0-255,66,135571,65,201306
14541,0.001137,172.31.40.0-255,66,135637,65,201306
14542,0.001163,172.217.194.0-255,4320,139957,65,201306
14543,0.001169,172.217.194.0-255,5020,144977,65,201306
14544,0.00117,172.31.40.0-255,66,145043,65,201306
14545,0.001174,172.31.40.0-255,66,145109,65,201306
14546,0.001212,172.217.194.0-255,1484,146593,65,201306
14547,0.001216,172.217.194.0-255,2902,149495,65,201306
14548,0.00122,172.31.40.0-255,66,149561,65,201306
14549,0.001223,172.217.194.0-255,1484,151045,65,201306
14550,0.001247,172.217.194.0-255,4320,155365,65,201306
14551,0.001252,172.217.194.0-255,4320,159685,65,201306
14552,0.001254,172.31.40.0-255,66,159751,65,201306
14553,0.001258,172.31.40.0-255,66,159817,65,201306
14554,0.001276,172.217.194.0-255,7156,166973,65,201306
14555,0.001277,172.31.40.0-255,66,167039,65,201306
14556,0.001281,172.31.40.0-255,66,167105,65,201306
14557,0.0013,172.217.194.0-255,2902,170007,65,201306
14558,0.001311,172.31.40.0-255,66,170073,65,201306
14559,0.001349,172.217.194.0-255,1484,171557,65,201306
14560,0.001384,172.217.194.0-255,6438,177995,65,201306
14561,0.001387,172.31.40.0-255,66,178061,65,201306
14562,0.001398,172.31.40.0-255,66,178127,65,201306
14563,0.001418,172.31.40.0-255,66,178193,65,201306
14564,0.00144,172.217.194.0-255,4320,182513,65,201306
14565,0.001447,172.31.40.0-255,66,182579,65,201306
14566,0.001493,172.31.40.0-255,66,182645,65,201306
14567,0.001501,172.217.194.0-255,5738,188383,65,201306
14568,0.001506,172.31.40.0-255,66,188449,65,201306
14569,0.001546,172.31.40.0-255,66,188515,65,201306
14570,0.001559,172.31.40.0-255,66,188581,65,201306
14571,0.001584,172.217.194.0-255,4320,192901,65,201306
14572,0.001589,172.217.194.0-255,5738,198639,65,201306
14573,0.001589,172.31.40.0-255,66,198705,65,201306
14574,0.001601,172.31.40.0-255,66,198771,65,201306
14575,0.001601,172.217.194.0-255,1484,200255,65,201306
14576,0.001648,172.31.40.0-255,66,200321,65,201306
14577,0.001655,172.217.194.0-255,577,200898,65,201306
14578,0.00166,172.31.40.0-255,66,200964,65,201306
14579,0.001713,172.217.194.0-255,105,201069,65,201306
14580,0.003237,172.31.40.0-255,66,201135,65,201306
14581,0.00326,172.31.40.0-255,105,201240,65,201306
14582,0.005442,172.217.194.0-255,66,201306,65,201306
14583,0.0,74.125.68.0-255,153,153,65,173951
14584,1.7e-05,172.31.40.0-255,66,219,65,173951
14585,4.3e-05,74.125.68.0-255,1484,1703,65,173951
14586,4.8e-05,172.31.40.0-255,66,1769,65,173951
14587,5.5e-05,74.125.68.0-255,2902,4671,65,173951
14588,5.9e-05,172.31.40.0-255,66,4737,65,173951
14589,8.5e-05,74.125.68.0-255,2902,7639,65,173951
14590,8.8e-05,172.31.40.0-255,66,7705,65,173951
14591,0.000118,74.125.68.0-255,4320,12025,65,173951
14592,0.00012,172.31.40.0-255,66,12091,65,173951
14593,0.000166,74.125.68.0-255,2037,14128,65,173951
14594,0.00017,172.31.40.0-255,66,14194,65,173951
14595,0.000238,74.125.68.0-255,1484,15678,65,173951
14596,0.000241,172.31.40.0-255,66,15744,65,173951
14597,0.000272,74.125.68.0-255,2902,18646,65,173951
14598,0.000275,172.31.40.0-255,66,18712,65,173951
14599,0.000314,74.125.68.0-255,1484,20196,65,173951
14600,0.000316,172.31.40.0-255,66,20262,65,173951
14601,0.000334,74.125.68.0-255,1484,21746,65,173951
14602,0.000336,172.31.40.0-255,66,21812,65,173951
14603,0.000362,74.125.68.0-255,2902,24714,65,173951
14604,0.000365,172.31.40.0-255,66,24780,65,173951
14605,0.000394,74.125.68.0-255,5738,30518,65,173951
14606,0.000397,172.31.40.0-255,66,30584,65,173951
14607,0.0004,74.125.68.0-255,1125,31709,65,173951
14608,0.000402,172.31.40.0-255,66,31775,65,173951
14609,0.000438,74.125.68.0-255,1484,33259,65,173951
14610,0.000441,172.31.40.0-255,66,33325,65,173951
14611,0.000445,74.125.68.0-255,1484,34809,65,173951
14612,0.000447,172.31.40.0-255,66,34875,65,173951
14613,0.00047,74.125.68.0-255,1484,36359,65,173951
14614,0.000472,172.31.40.0-255,66,36425,65,173951
14615,0.000477,74.125.68.0-255,2902,39327,65,173951
14616,0.000479,172.31.40.0-255,66,39393,65,173951
14617,0.000509,74.125.68.0-255,2902,42295,65,173951
14618,0.000513,172.31.40.0-255,66,42361,65,173951
14619,0.000518,74.125.68.0-255,2902,45263,65,173951
14620,0.000525,74.125.68.0-255,3961,49224,65,173951
14621,0.00053,172.31.40.0-255,66,49290,65,173951
14622,0.000531,172.31.40.0-255,66,49356,65,173951
14623,0.000615,74.125.68.0-255,1484,50840,65,173951
14624,0.000647,74.125.68.0-255,1484,52324,65,173951
14625,0.000651,172.31.40.0-255,66,52390,65,173951
14626,0.000681,74.125.68.0-255,2902,55292,65,173951
14627,0.000685,172.31.40.0-255,66,55358,65,173951
14628,0.000716,74.125.68.0-255,1484,56842,65,173951
14629,0.000741,74.125.68.0-255,2902,59744,65,173951
14630,0.000745,172.31.40.0-255,66,59810,65,173951
14631,0.000749,74.125.68.0-255,1484,61294,65,173951
14632,0.000764,74.125.68.0-255,2902,64196,65,173951
14633,0.000767,172.31.40.0-255,66,64262,65,173951
14634,0.000809,74.125.68.0-255,2543,66805,65,173951
14635,0.000842,172.31.40.0-255,66,66871,65,173951
14636,0.001017,74.125.68.0-255,1484,68355,65,173951
14637,0.001037,74.125.68.0-255,1484,69839,65,173951
14638,0.00104,172.31.40.0-255,66,69905,65,173951
14639,0.001059,74.125.68.0-255,1484,71389,65,173951
14640,0.001079,74.125.68.0-255,1484,72873,65,173951
14641,0.001081,172.31.40.0-255,66,72939,65,173951
14642,0.00111,74.125.68.0-255,2902,75841,65,173951
14643,0.001113,172.31.40.0-255,66,75907,65,173951
14644,0.00113,74.125.68.0-255,1484,77391,65,173951
14645,0.001146,74.125.68.0-255,2902,80293,65,173951
14646,0.001149,172.31.40.0-255,66,80359,65,173951
14647,0.001179,74.125.68.0-255,4320,84679,65,173951
14648,0.001181,172.31.40.0-255,66,84745,65,173951
14649,0.001195,74.125.68.0-255,287,85032,65,173951
14650,0.001237,74.125.68.0-255,1484,86516,65,173951
14651,0.001239,172.31.40.0-255,66,86582,65,173951
14652,0.001269,74.125.68.0-255,4320,90902,65,173951
14653,0.001272,172.31.40.0-255,66,90968,65,173951
14654,0.0013,74.125.68.0-255,5738,96706,65,173951
14655,0.001304,172.31.40.0-255,66,96772,65,173951
14656,0.001328,74.125.68.0-255,1484,98256,65,173951
14657,0.001332,74.125.68.0-255,2902,101158,65,173951
14658,0.001335,172.31.40.0-255,66,101224,65,173951
14659,0.001358,74.125.68.0-255,1125,102349,65,173951
14660,0.00163,74.125.68.0-255,1484,103833,65,173951
14661,0.001635,172.31.40.0-255,66,103899,65,173951
14662,0.00166,74.125.68.0-255,2902,106801,65,173951
14663,0.001663,172.31.40.0-255,66,106867,65,173951
14664,0.001684,74.125.68.0-255,1484,108351,65,173951
14665,0.001702,74.125.68.0-255,4320,112671,65,173951
14666,0.001705,172.31.40.0-255,66,112737,65,173951
14667,0.001745,74.125.68.0-255,2902,115639,65,173951
14668,0.001748,172.31.40.0-255,66,115705,65,173951
14669,0.00177,74.125.68.0-255,1484,117189,65,173951
14670,0.001777,74.125.68.0-255,5738,122927,65,173951
14671,0.001779,172.31.40.0-255,66,122993,65,173951
14672,0.001806,74.125.68.0-255,2902,125895,65,173951
14673,0.001811,172.31.40.0-255,66,125961,65,173951
14674,0.001845,172.31.40.0-255,66,126027,65,173951
14675,0.001858,74.125.68.0-255,2184,128211,65,173951
14676,0.001864,172.31.40.0-255,66,128277,65,173951
14677,0.003898,74.125.68.0-255,2902,131179,65,173951
14678,0.003904,172.31.40.0-255,66,131245,65,173951
14679,0.003933,74.125.68.0-255,2902,134147,65,173951
14680,0.003936,172.31.40.0-255,66,134213,65,173951
14681,0.005969,74.125.68.0-255,2902,137115,65,173951
14682,0.005972,172.31.40.0-255,66,137181,65,173951
14683,0.00599,74.125.68.0-255,1484,138665,65,173951
14684,0.006005,74.125.68.0-255,1484,140149,65,173951
14685,0.006007,172.31.40.0-255,66,140215,65,173951
14686,0.008041,74.125.68.0-255,2902,143117,65,173951
14687,0.008047,172.31.40.0-255,66,143183,65,173951
14688,0.00808,74.125.68.0-255,2902,146085,65,173951
14689,0.008083,172.31.40.0-255,66,146151,65,173951
14690,0.010112,74.125.68.0-255,2902,149053,65,173951
14691,0.01012,172.31.40.0-255,66,149119,65,173951
14692,0.010145,74.125.68.0-255,2902,152021,65,173951
14693,0.010147,172.31.40.0-255,66,152087,65,173951
14694,0.012189,74.125.68.0-255,4320,156407,65,173951
14695,0.012198,172.31.40.0-255,66,156473,65,173951
14696,0.012227,74.125.68.0-255,1484,157957,65,173951
14697,0.014275,74.125.68.0-255,4320,162277,65,173951
14698,0.014283,172.31.40.0-255,66,162343,65,173951
14699,0.016348,74.125.68.0-255,5738,168081,65,173951
14700,0.016355,172.31.40.0-255,66,168147,65,173951
14701,0.018415,74.125.68.0-255,5738,173885,65,173951
14702,0.018421,172.31.40.0-255,66,173951,65,173951
14703,0.0,74.125.130.0-255,152,152,65,243908
14704,2e-05,172.31.40.0-255,66,218,65,243908
14705,2.9e-05,74.125.130.0-255,1484,1702,65,243908
14706,3.3e-05,172.31.40.0-255,66,1768,65,243908
14707,4.6e-05,74.125.130.0-255,2902,4670,65,243908
14708,4.9e-05,172.31.40.0-255,66,4736,65,243908
14709,5.7e-05,74.125.130.0-255,7156,11892,65,243908
14710,6.1e-05,172.31.40.0-255,66,11958,65,243908
14711,6.5e-05,74.125.130.0-255,2027,13985,65,243908
14712,6.7e-05,172.31.40.0-255,66,14051,65,243908
14713,0.000154,74.125.130.0-255,1484,15535,65,243908
14714,0.000157,172.31.40.0-255,66,15601,65,243908
14715,0.000161,74.125.130.0-255,1484,17085,65,243908
14716,0.000163,172.31.40.0-255,66,17151,65,243908
14717,0.000191,74.125.130.0-255,1484,18635,65,243908
14718,0.000194,172.31.40.0-255,66,18701,65,243908
14719,0.000201,74.125.130.0-255,5738,24439,65,243908
14720,0.000204,172.31.40.0-255,66,24505,65,243908
14721,0.000206,74.125.130.0-255,1484,25989,65,243908
14722,0.000208,172.31.40.0-255,66,26055,65,243908
14723,0.000229,74.125.130.0-255,1484,27539,65,243908
14724,0.000232,172.31.40.0-255,66,27605,65,243908
14725,0.000237,74.125.130.0-255,3961,31566,65,243908
14726,0.00024,172.31.40.0-255,66,31632,65,243908
14727,0.000283,74.125.130.0-255,2902,34534,65,243908
14728,0.000285,172.31.40.0-255,66,34600,65,243908
14729,0.00029,74.125.130.0-255,4320,38920,65,243908
14730,0.000293,172.31.40.0-255,66,38986,65,243908
14731,0.000303,172.31.40.0-255,66,39052,65,243908
14732,0.000306,74.125.130.0-255,1125,40177,65,243908
14733,0.000308,172.31.40.0-255,66,40243,65,243908
14734,0.000385,74.125.130.0-255,1484,41727,65,243908
14735,0.000392,74.125.130.0-255,2902,44629,65,243908
14736,0.00042,74.125.130.0-255,5738,50367,65,243908
14737,0.000432,74.125.130.0-255,1484,51851,65,243908
14738,0.000447,74.125.130.0-255,5379,57230,65,243908
14739,0.000517,74.125.130.0-255,648,57878,65,243908
14740,0.000544,172.31.40.0-255,66,57944,65,243908
14741,0.000562,74.125.130.0-255,1484,59428,65,243908
14742,0.000566,74.125.130.0-255,1484,60912,65,243908
14743,0.000576,74.125.130.0-255,1484,62396,65,243908
14744,0.000592,74.125.130.0-255,5738,68134,65,243908
14745,0.000618,172.31.40.0-255,66,68200,65,243908
14746,0.000624,74.125.130.0-255,4320,72520,65,243908
14747,0.000629,172.31.40.0-255,66,72586,65,243908
14748,0.00065,74.125.130.0-255,7156,79742,65,243908
14749,0.000653,74.125.130.0-255,1484,81226,65,243908
14750,0.000709,172.31.40.0-255,66,81292,65,243908
14751,0.000787,74.125.130.0-255,1484,82776,65,243908
14752,0.000838,74.125.130.0-255,2902,85678,65,243908
14753,0.000843,74.125.130.0-255,4320,89998,65,243908
14754,0.000849,74.125.130.0-255,5738,95736,65,243908
14755,0.000851,74.125.130.0-255,1484,97220,65,243908
14756,0.000865,172.31.40.0-255,66,97286,65,243908
14757,0.000892,74.125.130.0-255,4320,101606,65,243908
14758,0.000922,74.125.130.0-255,3602,105208,65,243908
14759,0.000927,172.31.40.0-255,66,105274,65,243908
14760,0.001004,74.125.130.0-255,1484,106758,65,243908
14761,0.001015,74.125.130.0-255,2902,109660,65,243908
14762,0.001036,74.125.130.0-255,2902,112562,65,243908
14763,0.001044,172.31.40.0-255,66,112628,65,243908
14764,0.001054,74.125.130.0-255,1484,114112,65,243908
14765,0.001062,74.125.130.0-255,1484,115596,65,243908
14766,0.001067,172.31.40.0-255,66,115662,65,243908
14767,0.001078,74.125.130.0-255,5738,121400,65,243908
14768,0.001093,74.125.130.0-255,1484,122884,65,243908
14769,0.001097,74.125.130.0-255,2902,125786,65,243908
14770,0.001104,74.125.130.0-255,4320,130106,65,243908
14771,0.001125,74.125.130.0-255,766,130872,65,243908
14772,0.001128,74.125.130.0-255,1484,132356,65,243908
14773,0.001142,172.31.40.0-255,66,132422,65,243908
14774,0.001149,74.125.130.0-255,4320,136742,65,243908
14775,0.001154,172.31.40.0-255,66,136808,65,243908
14776,0.001188,74.125.130.0-255,7156,143964,65,243908
14777,0.001206,172.31.40.0-255,66,144030,65,243908
14778,0.001233,74.125.130.0-255,7156,151186,65,243908
14779,0.001249,172.31.40.0-255,66,151252,65,243908
14780,0.001281,74.125.130.0-255,5020,156272,65,243908
14781,0.001299,172.31.40.0-255,66,156338,65,243908
14782,0.001637,74.125.130.0-255,1484,157822,65,243908
14783,0.001643,74.125.130.0-255,2902,160724,65,243908
14784,0.00165,172.31.40.0-255,66,160790,65,243908
14785,0.001659,74.125.130.0-255,2902,163692,65,243908
14786,0.001678,74.125.130.0-255,2902,166594,65,243908
14787,0.001684,74.125.130.0-255,4320,170914,65,243908
14788,0.001686,74.125.130.0-255,1484,172398,65,243908
14789,0.001701,74.125.130.0-255,4320,176718,65,243908
14790,0.00171,172.31.40.0-255,66,176784,65,243908
14791,0.001719,74.125.130.0-255,1484,178268,65,243908
14792,0.001754,74.125.130.0-255,2184,180452,65,243908
14793,0.001766,172.31.40.0-255,66,180518,65,243908
14794,0.001954,74.125.130.0-255,1484,182002,65,243908
14795,0.001959,74.125.130.0-255,2902,184904,65,243908
14796,0.001964,172.31.40.0-255,66,184970,65,243908
14797,0.001972,74.125.130.0-255,1484,186454,65,243908
14798,0.001996,74.125.130.0-255,4320,190774,65,243908
14799,0.002001,74.125.130.0-255,2902,193676,65,243908
14800,0.002011,74.125.130.0-255,4320,197996,65,243908
14801,0.002015,74.125.130.0-255,2902,200898,65,243908
14802,0.002034,74.125.130.0-255,5738,206636,65,243908
14803,0.002046,74.125.130.0-255,4320,210956,65,243908
14804,0.002049,172.31.40.0-255,66,211022,65,243908
14805,0.002054,172.31.40.0-255,66,211088,65,243908
14806,0.002063,74.125.130.0-255,3602,214690,65,243908
14807,0.002092,172.31.40.0-255,66,214756,65,243908
14808,0.004076,74.125.130.0-255,1484,216240,65,243908
14809,0.004106,74.125.130.0-255,4320,220560,65,243908
14810,0.00411,172.31.40.0-255,66,220626,65,243908
14811,0.006162,74.125.130.0-255,5738,226364,65,243908
14812,0.012912,172.31.40.0-255,66,226430,65,243908
14813,0.013487,74.125.130.0-255,1484,227914,65,243908
14814,0.01499,74.125.130.0-255,4320,232234,65,243908
14815,0.014999,172.31.40.0-255,66,232300,65,243908
14816,0.017041,74.125.130.0-255,5738,238038,65,243908
14817,0.017048,172.31.40.0-255,66,238104,65,243908
14818,0.019081,74.125.130.0-255,5738,243842,65,243908
14819,0.019088,172.31.40.0-255,66,243908,65,243908
14820,0.0,192.229.237.0-255,66,66,65,66
14821,0.0,74.125.24.0-255,153,153,65,202911
14822,1.4e-05,172.31.40.0-255,66,219,65,202911
14823,2.1e-05,74.125.24.0-255,1484,1703,65,202911
14824,2.5e-05,172.31.40.0-255,66,1769,65,202911
14825,3.1e-05,74.125.24.0-255,2902,4671,65,202911
14826,3.4e-05,172.31.40.0-255,66,4737,65,202911
14827,5.6e-05,74.125.24.0-255,4320,9057,65,202911
14828,6e-05,172.31.40.0-255,66,9123,65,202911
14829,0.000101,74.125.24.0-255,2902,12025,65,202911
14830,0.000104,172.31.40.0-255,66,12091,65,202911
14831,0.000117,74.125.24.0-255,2165,14256,65,202911
14832,0.00012,172.31.40.0-255,66,14322,65,202911
14833,0.000176,74.125.24.0-255,1484,15806,65,202911
14834,0.000178,172.31.40.0-255,66,15872,65,202911
14835,0.000183,74.125.24.0-255,2902,18774,65,202911
14836,0.000186,172.31.40.0-255,66,18840,65,202911
14837,0.000203,74.125.24.0-255,5738,24578,65,202911
14838,0.000206,172.31.40.0-255,66,24644,65,202911
14839,0.000273,74.125.24.0-255,2902,27546,65,202911
14840,0.000277,172.31.40.0-255,66,27612,65,202911
14841,0.000305,172.31.40.0-255,66,27678,65,202911
14842,0.000308,74.125.24.0-255,1484,29162,65,202911
14843,0.00031,172.31.40.0-255,66,29228,65,202911
14844,0.000341,172.31.40.0-255,66,29294,65,202911
14845,0.000344,74.125.24.0-255,1125,30419,65,202911
14846,0.000346,172.31.40.0-255,66,30485,65,202911
14847,0.000349,74.125.24.0-255,1484,31969,65,202911
14848,0.000351,172.31.40.0-255,66,32035,65,202911
14849,0.000356,74.125.24.0-255,4320,36355,65,202911
14850,0.00036,172.31.40.0-255,66,36421,65,202911
14851,0.000364,74.125.24.0-255,2902,39323,65,202911
14852,0.000367,172.31.40.0-255,66,39389,65,202911
14853,0.000396,74.125.24.0-255,1484,40873,65,202911
14854,0.000424,74.125.24.0-255,6797,47670,65,202911
14855,0.000427,172.31.40.0-255,66,47736,65,202911
14856,0.000444,74.125.24.0-255,394,48130,65,202911
14857,0.000487,74.125.24.0-255,348,48478,65,202911
14858,0.000616,74.125.24.0-255,1484,49962,65,202911
14859,0.000621,172.31.40.0-255,66,50028,65,202911
14860,0.000626,74.125.24.0-255,2902,52930,65,202911
14861,0.000629,172.31.40.0-255,66,52996,65,202911
14862,0.000632,74.125.24.0-255,1484,54480,65,202911
14863,0.00066,74.125.24.0-255,4320,58800,65,202911
14864,0.000663,172.31.40.0-255,66,58866,65,202911
14865,0.000675,172.31.40.0-255,66,58932,65,202911
14866,0.00072,74.125.24.0-255,4320,63252,65,202911
14867,0.000724,172.31.40.0-255,66,63318,65,202911
14868,0.000744,74.125.24.0-255,7156,70474,65,202911
14869,0.000747,172.31.40.0-255,66,70540,65,202911
14870,0.000766,74.125.24.0-255,2184,72724,65,202911
14871,0.000769,172.31.40.0-255,66,72790,65,202911
14872,0.001223,74.125.24.0-255,1484,74274,65,202911
14873,0.001231,74.125.24.0-255,2902,77176,65,202911
14874,0.001235,172.31.40.0-255,66,77242,65,202911
14875,0.00124,74.125.24.0-255,1484,78726,65,202911
14876,0.001254,74.125.24.0-255,4320,83046,65,202911
14877,0.001256,172.31.40.0-255,66,83112,65,202911
14878,0.001282,172.31.40.0-255,66,83178,65,202911
14879,0.001298,74.125.24.0-255,1484,84662,65,202911
14880,0.001314,74.125.24.0-255,2902,87564,65,202911
14881,0.001316,172.31.40.0-255,66,87630,65,202911
14882,0.00133,74.125.24.0-255,5738,93368,65,202911
14883,0.001333,172.31.40.0-255,66,93434,65,202911
14884,0.001347,74.125.24.0-255,3602,97036,65,202911
14885,0.00135,172.31.40.0-255,66,97102,65,202911
14886,0.002012,74.125.24.0-255,1484,98586,65,202911
14887,0.002017,74.125.24.0-255,1484,100070,65,202911
14888,0.002021,172.31.40.0-255,66,100136,65,202911
14889,0.002043,74.125.24.0-255,1484,101620,65,202911
14890,0.002049,74.125.24.0-255,5738,107358,65,202911
14891,0.002051,172.31.40.0-255,66,107424,65,202911
14892,0.002056,74.125.24.0-255,4320,111744,65,202911
14893,0.002058,172.31.40.0-255,66,111810,65,202911
14894,0.002083,172.31.40.0-255,66,111876,65,202911
14895,0.002094,172.31.40.0-255,66,111942,65,202911
14896,0.002115,74.125.24.0-255,1484,113426,65,202911
14897,0.002137,74.125.24.0-255,2902,116328,65,202911
14898,0.002139,172.31.40.0-255,66,116394,65,202911
14899,0.002161,74.125.24.0-255,2902,119296,65,202911
14900,0.002162,172.31.40.0-255,66,119362,65,202911
14901,0.002179,74.125.24.0-255,2902,122264,65,202911
14902,0.002181,172.31.40.0-255,66,122330,65,202911
14903,0.002185,74.125.24.0-255,2902,125232,65,202911
14904,0.002186,172.31.40.0-255,66,125298,65,202911
14905,0.002208,74.125.24.0-255,2902,128200,65,202911
14906,0.00221,172.31.40.0-255,66,128266,65,202911
14907,0.002212,74.125.24.0-255,1484,129750,65,202911
14908,0.00224,172.31.40.0-255,66,129816,65,202911
14909,0.002244,74.125.24.0-255,5020,134836,65,202911
14910,0.002246,172.31.40.0-255,66,134902,65,202911
14911,0.002377,74.125.24.0-255,1484,136386,65,202911
14912,0.002395,74.125.24.0-255,2902,139288,65,202911
14913,0.002397,172.31.40.0-255,66,139354,65,202911
14914,0.002402,74.125.24.0-255,5738,145092,65,202911
14915,0.002404,172.31.40.0-255,66,145158,65,202911
14916,0.002441,172.31.40.0-255,66,145224,65,202911
14917,0.002448,74.125.24.0-255,7156,152380,65,202911
14918,0.00245,172.31.40.0-255,66,152446,65,202911
14919,0.002479,74.125.24.0-255,1484,153930,65,202911
14920,0.002495,74.125.24.0-255,2184,156114,65,202911
14921,0.002497,172.31.40.0-255,66,156180,65,202911
14922,0.002502,74.125.24.0-255,4320,160500,65,202911
14923,0.002504,172.31.40.0-255,66,160566,65,202911
14924,0.002527,74.125.24.0-255,1484,162050,65,202911
14925,0.002546,74.125.24.0-255,5738,167788,65,202911
14926,0.002548,172.31.40.0-255,66,167854,65,202911
14927,0.002551,74.125.24.0-255,1484,169338,65,202911
14928,0.004684,172.31.40.0-255,101,169439,65,202911
14929,0.005062,74.125.24.0-255,4320,173759,65,202911
14930,0.005068,172.31.40.0-255,66,173825,65,202911
14931,0.007261,74.125.24.0-255,1484,175309,65,202911
14932,0.007601,74.125.24.0-255,4320,179629,65,202911
14933,0.007611,172.31.40.0-255,66,179695,65,202911
14934,0.010173,74.125.24.0-255,5738,185433,65,202911
14935,0.010187,172.31.40.0-255,66,185499,65,202911
14936,0.012734,74.125.24.0-255,5738,191237,65,202911
14937,0.012743,172.31.40.0-255,66,191303,65,202911
14938,0.015314,74.125.24.0-255,5738,197041,65,202911
14939,0.015322,172.31.40.0-255,66,197107,65,202911
14940,0.017867,74.125.24.0-255,5738,202845,65,202911
14941,0.017875,172.31.40.0-255,66,202911,65,202911
14942,0.0,172.31.40.0-255,105,105,65,459
14943,0.000231,172.31.40.0-255,90,195,65,459
14944,0.000242,172.31.40.0-255,66,261,65,459
14945,0.002594,172.217.194.0-255,66,327,65,459
14946,0.002616,172.217.194.0-255,66,393,65,459
14947,0.002631,172.31.40.0-255,66,459,65,459
14948,0.0,74.125.130.0-255,149,149,65,211944
14949,2.5e-05,172.31.40.0-255,66,215,65,211944
14950,3.2e-05,74.125.130.0-255,1484,1699,65,211944
14951,3.7e-05,172.31.40.0-255,66,1765,65,211944
14952,4.3e-05,74.125.130.0-255,2902,4667,65,211944
14953,4.5e-05,172.31.40.0-255,66,4733,65,211944
14954,4.9e-05,74.125.130.0-255,1484,6217,65,211944
14955,5.1e-05,172.31.40.0-255,66,6283,65,211944
14956,5.9e-05,74.125.130.0-255,2902,9185,65,211944
14957,6.4e-05,172.31.40.0-255,66,9251,65,211944
14958,8.8e-05,74.125.130.0-255,2902,12153,65,211944
14959,9e-05,172.31.40.0-255,66,12219,65,211944
14960,0.000119,74.125.130.0-255,3446,15665,65,211944
14961,0.000122,172.31.40.0-255,66,15731,65,211944
14962,0.000126,74.125.130.0-255,2902,18633,65,211944
14963,0.000129,172.31.40.0-255,66,18699,65,211944
14964,0.000134,74.125.130.0-255,4320,23019,65,211944
14965,0.000136,172.31.40.0-255,66,23085,65,211944
14966,0.000169,74.125.130.0-255,7156,30241,65,211944
14967,0.000172,172.31.40.0-255,66,30307,65,211944
14968,0.000184,74.125.130.0-255,1125,31432,65,211944
14969,0.000186,172.31.40.0-255,66,31498,65,211944
14970,0.000301,74.125.130.0-255,1484,32982,65,211944
14971,0.000305,172.31.40.0-255,66,33048,65,211944
14972,0.000309,74.125.130.0-255,1484,34532,65,211944
14973,0.000311,172.31.40.0-255,66,34598,65,211944
14974,0.000323,74.125.130.0-255,1484,36082,65,211944
14975,0.000325,172.31.40.0-255,66,36148,65,211944
14976,0.000328,74.125.130.0-255,1484,37632,65,211944
14977,0.000331,172.31.40.0-255,66,37698,65,211944
14978,0.000363,74.125.130.0-255,4320,42018,65,211944
14979,0.000366,172.31.40.0-255,66,42084,65,211944
14980,0.00037,74.125.130.0-255,2902,44986,65,211944
14981,0.000371,172.31.40.0-255,66,45052,65,211944
14982,0.000377,74.125.130.0-255,4320,49372,65,211944
14983,0.000379,172.31.40.0-255,66,49438,65,211944
14984,0.000418,74.125.130.0-255,5738,55176,65,211944
14985,0.000421,172.31.40.0-255,66,55242,65,211944
14986,0.000443,74.125.130.0-255,2902,58144,65,211944
14987,0.000445,172.31.40.0-255,66,58210,65,211944
14988,0.000449,74.125.130.0-255,2902,61112,65,211944
14989,0.000452,172.31.40.0-255,66,61178,65,211944
14990,0.000457,74.125.130.0-255,5333,66511,65,211944
14991,0.000459,172.31.40.0-255,66,66577,65,211944
14992,0.000662,74.125.130.0-255,364,66941,65,211944
14993,0.000867,74.125.130.0-255,1484,68425,65,211944
14994,0.000872,172.31.40.0-255,66,68491,65,211944
14995,0.000878,74.125.130.0-255,2902,71393,65,211944
14996,0.00088,172.31.40.0-255,66,71459,65,211944
14997,0.000894,74.125.130.0-255,1484,72943,65,211944
14998,0.000913,74.125.130.0-255,4320,77263,65,211944
14999,0.000915,172.31.40.0-255,66,77329,65,211944
15000,0.000923,74.125.130.0-255,7156,84485,65,211944
15001,0.000925,172.31.40.0-255,66,84551,65,211944
15002,0.00095,74.125.130.0-255,4320,88871,65,211944
15003,0.000952,172.31.40.0-255,66,88937,65,211944
15004,0.000975,172.31.40.0-255,66,89003,65,211944
15005,0.000997,74.125.130.0-255,1484,90487,65,211944
15006,0.001011,74.125.130.0-255,1635,92122,65,211944
15007,0.001015,172.31.40.0-255,66,92188,65,211944
15008,0.001258,74.125.130.0-255,1484,93672,65,211944
15009,0.001263,74.125.130.0-255,2902,96574,65,211944
15010,0.001273,172.31.40.0-255,66,96640,65,211944
15011,0.001296,74.125.130.0-255,5738,102378,65,211944
15012,0.001299,172.31.40.0-255,66,102444,65,211944
15013,0.001304,74.125.130.0-255,2902,105346,65,211944
15014,0.001306,172.31.40.0-255,66,105412,65,211944
15015,0.001321,74.125.130.0-255,4320,109732,65,211944
15016,0.001323,172.31.40.0-255,66,109798,65,211944
15017,0.001357,74.125.130.0-255,2902,112700,65,211944
15018,0.00136,172.31.40.0-255,66,112766,65,211944
15019,0.001384,74.125.130.0-255,5738,118504,65,211944
15020,0.001387,172.31.40.0-255,66,118570,65,211944
15021,0.001416,74.125.130.0-255,4320,122890,65,211944
15022,0.001418,172.31.40.0-255,66,122956,65,211944
15023,0.001439,74.125.130.0-255,3602,126558,65,211944
15024,0.001441,172.31.40.0-255,66,126624,65,211944
15025,0.001565,74.125.130.0-255,1484,128108,65,211944
15026,0.001569,74.125.130.0-255,1484,129592,65,211944
15027,0.001572,172.31.40.0-255,66,129658,65,211944
15028,0.001588,74.125.130.0-255,1484,131142,65,211944
15029,0.001611,74.125.130.0-255,5738,136880,65,211944
15030,0.001614,172.31.40.0-255,66,136946,65,211944
15031,0.00162,74.125.130.0-255,4320,141266,65,211944
15032,0.001622,172.31.40.0-255,66,141332,65,211944
15033,0.001643,74.125.130.0-255,4320,145652,65,211944
15034,0.001645,172.31.40.0-255,66,145718,65,211944
15035,0.001663,74.125.130.0-255,1484,147202,65,211944
15036,0.001669,74.125.130.0-255,5738,152940,65,211944
15037,0.001671,172.31.40.0-255,66,153006,65,211944
15038,0.001701,74.125.130.0-255,7156,160162,65,211944
15039,0.001705,172.31.40.0-255,66,160228,65,211944
15040,0.001708,74.125.130.0-255,766,160994,65,211944
15041,0.002241,172.31.40.0-255,66,161060,65,211944
15042,0.003694,74.125.130.0-255,4320,165380,65,211944
15043,0.003701,172.31.40.0-255,66,165446,65,211944
15044,0.004228,74.125.130.0-255,1484,166930,65,211944
15045,0.005691,74.125.130.0-255,4320,171250,65,211944
15046,0.005694,172.31.40.0-255,66,171316,65,211944
15047,0.007683,74.125.130.0-255,5738,177054,65,211944
15048,0.00769,172.31.40.0-255,66,177120,65,211944
15049,0.009693,74.125.130.0-255,5738,182858,65,211944
15050,0.0097,172.31.40.0-255,66,182924,65,211944
15051,0.011733,74.125.130.0-255,5738,188662,65,211944
15052,0.011741,172.31.40.0-255,66,188728,65,211944
15053,0.013743,74.125.130.0-255,5738,194466,65,211944
15054,0.013751,172.31.40.0-255,66,194532,65,211944
15055,0.015756,74.125.130.0-255,5738,200270,65,211944
15056,0.015767,172.31.40.0-255,66,200336,65,211944
15057,0.017765,74.125.130.0-255,5738,206074,65,211944
15058,0.017774,172.31.40.0-255,66,206140,65,211944
15059,0.019774,74.125.130.0-255,5738,211878,65,211944
15060,0.019788,172.31.40.0-255,66,211944,65,211944
15061,0.0,172.217.26.0-255,298,298,65,153056
15062,2.1e-05,172.31.40.0-255,66,364,65,153056
15063,2.7e-05,172.217.26.0-255,1484,1848,65,153056
15064,3.1e-05,172.31.40.0-255,66,1914,65,153056
15065,3.7e-05,172.217.26.0-255,4320,6234,65,153056
15066,3.9e-05,172.31.40.0-255,66,6300,65,153056
15067,5.6e-05,172.31.40.0-255,66,6366,65,153056
15068,6.4e-05,172.31.40.0-255,66,6432,65,153056
15069,0.000104,172.31.40.0-255,66,6498,65,153056
15070,0.000148,172.217.26.0-255,1484,7982,65,153056
15071,0.00015,172.31.40.0-255,66,8048,65,153056
15072,0.000155,172.217.26.0-255,2902,10950,65,153056
15073,0.000156,172.31.40.0-255,66,11016,65,153056
15074,0.000181,172.217.26.0-255,1484,12500,65,153056
15075,0.000183,172.31.40.0-255,66,12566,65,153056
15076,0.000186,172.217.26.0-255,1484,14050,65,153056
15077,0.000188,172.31.40.0-255,66,14116,65,153056
15078,0.000192,172.217.26.0-255,2902,17018,65,153056
15079,0.000194,172.31.40.0-255,66,17084,65,153056
15080,0.000198,172.217.26.0-255,4320,21404,65,153056
15081,0.000201,172.31.40.0-255,66,21470,65,153056
15082,0.000229,172.217.26.0-255,1484,22954,65,153056
15083,0.000231,172.31.40.0-255,66,23020,65,153056
15084,0.000234,172.217.26.0-255,1125,24145,65,153056
15085,0.000235,172.31.40.0-255,66,24211,65,153056
15086,0.000271,172.217.26.0-255,1484,25695,65,153056
15087,0.000273,172.31.40.0-255,66,25761,65,153056
15088,0.000289,172.217.26.0-255,2902,28663,65,153056
15089,0.000291,172.31.40.0-255,66,28729,65,153056
15090,0.000317,172.217.26.0-255,1484,30213,65,153056
15091,0.000324,172.217.26.0-255,5738,35951,65,153056
15092,0.000326,172.31.40.0-255,66,36017,65,153056
15093,0.000354,172.217.26.0-255,5379,41396,65,153056
15094,0.000357,172.31.40.0-255,66,41462,65,153056
15095,0.00037,172.217.26.0-255,354,41816,65,153056
15096,0.000971,172.31.40.0-255,66,41882,65,153056
15097,0.001129,172.217.26.0-255,388,42270,65,153056
15098,0.001232,172.217.26.0-255,1484,43754,65,153056
15099,0.001237,172.31.40.0-255,66,43820,65,153056
15100,0.001241,172.217.26.0-255,1484,45304,65,153056
15101,0.001275,172.217.26.0-255,2902,48206,65,153056
15102,0.001278,172.31.40.0-255,66,48272,65,153056
15103,0.001285,172.217.26.0-255,5738,54010,65,153056
15104,0.001287,172.31.40.0-255,66,54076,65,153056
15105,0.001313,172.217.26.0-255,5379,59455,65,153056
15106,0.001315,172.31.40.0-255,66,59521,65,153056
15107,0.001348,172.217.26.0-255,1484,61005,65,153056
15108,0.001365,172.217.26.0-255,2902,63907,65,153056
15109,0.001368,172.31.40.0-255,66,63973,65,153056
15110,0.001374,172.217.26.0-255,5738,69711,65,153056
15111,0.001376,172.31.40.0-255,66,69777,65,153056
15112,0.001424,172.217.26.0-255,6797,76574,65,153056
15113,0.001427,172.31.40.0-255,66,76640,65,153056
15114,0.00188,172.217.26.0-255,1484,78124,65,153056
15115,0.001888,172.217.26.0-255,2902,81026,65,153056
15116,0.001893,172.31.40.0-255,66,81092,65,153056
15117,0.0019,172.217.26.0-255,5738,86830,65,153056
15118,0.001902,172.31.40.0-255,66,86896,65,153056
15119,0.001905,172.217.26.0-255,1484,88380,65,153056
15120,0.001936,172.31.40.0-255,66,88446,65,153056
15121,0.001959,172.217.26.0-255,7156,95602,65,153056
15122,0.001961,172.31.40.0-255,66,95668,65,153056
15123,0.001983,172.217.26.0-255,6438,102106,65,153056
15124,0.001985,172.31.40.0-255,66,102172,65,153056
15125,0.003948,172.217.26.0-255,4320,106492,65,153056
15126,0.003955,172.31.40.0-255,66,106558,65,153056
15127,0.003979,172.217.26.0-255,1484,108042,65,153056
15128,0.00591,172.217.26.0-255,4320,112362,65,153056
15129,0.005913,172.31.40.0-255,66,112428,65,153056
15130,0.007887,172.217.26.0-255,5738,118166,65,153056
15131,0.007894,172.31.40.0-255,66,118232,65,153056
15132,0.009872,172.217.26.0-255,5738,123970,65,153056
15133,0.00988,172.31.40.0-255,66,124036,65,153056
15134,0.011852,172.217.26.0-255,5738,129774,65,153056
15135,0.011861,172.31.40.0-255,66,129840,65,153056
15136,0.013829,172.217.26.0-255,5738,135578,65,153056
15137,0.013836,172.31.40.0-255,66,135644,65,153056
15138,0.015809,172.217.26.0-255,5738,141382,65,153056
15139,0.015816,172.31.40.0-255,66,141448,65,153056
15140,0.01779,172.217.26.0-255,5738,147186,65,153056
15141,0.017796,172.31.40.0-255,66,147252,65,153056
15142,0.019765,172.217.26.0-255,5738,152990,65,153056
15143,0.019771,172.31.40.0-255,66,153056,65,153056
15144,0.0,74.125.130.0-255,156,156,65,154153
15145,2.2e-05,172.31.40.0-255,66,222,65,154153
15146,2.9e-05,74.125.130.0-255,1484,1706,65,154153
15147,3.4e-05,172.31.40.0-255,66,1772,65,154153
15148,4e-05,74.125.130.0-255,2902,4674,65,154153
15149,4.3e-05,172.31.40.0-255,66,4740,65,154153
15150,4.9e-05,74.125.130.0-255,5738,10478,65,154153
15151,5.2e-05,172.31.40.0-255,66,10544,65,154153
15152,8.4e-05,74.125.130.0-255,6192,16736,65,154153
15153,8.7e-05,172.31.40.0-255,66,16802,65,154153
15154,9.4e-05,74.125.130.0-255,5738,22540,65,154153
15155,9.6e-05,172.31.40.0-255,66,22606,65,154153
15156,0.000122,74.125.130.0-255,7156,29762,65,154153
15157,0.000125,172.31.40.0-255,66,29828,65,154153
15158,0.000128,74.125.130.0-255,1125,30953,65,154153
15159,0.00013,172.31.40.0-255,66,31019,65,154153
15160,0.000683,74.125.130.0-255,1484,32503,65,154153
15161,0.000689,172.31.40.0-255,66,32569,65,154153
15162,0.000695,74.125.130.0-255,2902,35471,65,154153
15163,0.000697,172.31.40.0-255,66,35537,65,154153
15164,0.000728,74.125.130.0-255,5738,41275,65,154153
15165,0.00073,172.31.40.0-255,66,41341,65,154153
15166,0.000756,74.125.130.0-255,6797,48138,65,154153
15167,0.00076,74.125.130.0-255,2902,51040,65,154153
15168,0.000764,172.31.40.0-255,66,51106,65,154153
15169,0.000767,172.31.40.0-255,66,51172,65,154153
15170,0.000778,74.125.130.0-255,4320,55492,65,154153
15171,0.00078,172.31.40.0-255,66,55558,65,154153
15172,0.000817,172.31.40.0-255,66,55624,65,154153
15173,0.000833,74.125.130.0-255,1413,57037,65,154153
15174,0.000835,172.31.40.0-255,66,57103,65,154153
15175,0.00116,74.125.130.0-255,100,57203,65,154153
15176,0.001203,74.125.130.0-255,1484,58687,65,154153
15177,0.001207,172.31.40.0-255,66,58753,65,154153
15178,0.001212,74.125.130.0-255,1484,60237,65,154153
15179,0.001227,74.125.130.0-255,1484,61721,65,154153
15180,0.001242,74.125.130.0-255,2902,64623,65,154153
15181,0.001257,74.125.130.0-255,4320,68943,65,154153
15182,0.001261,74.125.130.0-255,2902,71845,65,154153
15183,0.001306,74.125.130.0-255,2543,74388,65,154153
15184,0.001317,74.125.130.0-255,1484,75872,65,154153
15185,0.001326,74.125.130.0-255,1484,77356,65,154153
15186,0.001347,74.125.130.0-255,2902,80258,65,154153
15187,0.001365,74.125.130.0-255,4320,84578,65,154153
15188,0.001371,74.125.130.0-255,4320,88898,65,154153
15189,0.001397,74.125.130.0-255,2543,91441,65,154153
15190,0.001925,74.125.130.0-255,1484,92925,65,154153
15191,0.001934,74.125.130.0-255,2902,95827,65,154153
15192,0.001963,74.125.130.0-255,5738,101565,65,154153
15193,0.001969,74.125.130.0-255,2902,104467,65,154153
15194,0.001989,74.125.130.0-255,4320,108787,65,154153
15195,0.00201,74.125.130.0-255,2902,111689,65,154153
15196,0.002018,74.125.130.0-255,7156,118845,65,154153
15197,0.002033,74.125.130.0-255,4320,123165,65,154153
15198,0.002037,74.125.130.0-255,1902,125067,65,154153
15199,0.006737,172.31.40.0-255,66,125133,65,154153
15200,0.008759,74.125.130.0-255,5738,130871,65,154153
15201,0.008766,172.31.40.0-255,66,130937,65,154153
15202,0.010787,74.125.130.0-255,5738,136675,65,154153
15203,0.013824,172.31.40.0-255,66,136741,65,154153
15204,0.015831,74.125.130.0-255,5738,142479,65,154153
15205,0.015841,172.31.40.0-255,66,142545,65,154153
15206,0.017856,74.125.130.0-255,5738,148283,65,154153
15207,0.017864,172.31.40.0-255,66,148349,65,154153
15208,0.019878,74.125.130.0-255,5738,154087,65,154153
15209,0.019884,172.31.40.0-255,66,154153,65,154153
15210,0.0,172.217.194.0-255,147,147,65,138341
15211,2.2e-05,172.31.40.0-255,66,213,65,138341
15212,2.9e-05,172.217.194.0-255,1484,1697,65,138341
15213,3.3e-05,172.31.40.0-255,66,1763,65,138341
15214,3.9e-05,172.217.194.0-255,2902,4665,65,138341
15215,4.2e-05,172.31.40.0-255,66,4731,65,138341
15216,4.6e-05,172.217.194.0-255,2902,7633,65,138341
15217,4.9e-05,172.31.40.0-255,66,7699,65,138341
15218,9.1e-05,172.217.194.0-255,6420,14119,65,138341
15219,9.5e-05,172.31.40.0-255,66,14185,65,138341
15220,0.00055,172.217.194.0-255,1484,15669,65,138341
15221,0.000556,172.31.40.0-255,66,15735,65,138341
15222,0.000565,172.217.194.0-255,2902,18637,65,138341
15223,0.000567,172.31.40.0-255,66,18703,65,138341
15224,0.000575,172.217.194.0-255,5738,24441,65,138341
15225,0.000577,172.31.40.0-255,66,24507,65,138341
15226,0.000613,172.217.194.0-255,6797,31304,65,138341
15227,0.000617,172.31.40.0-255,66,31370,65,138341
15228,0.000751,172.217.194.0-255,1484,32854,65,138341
15229,0.000756,172.31.40.0-255,66,32920,65,138341
15230,0.000762,172.217.194.0-255,2902,35822,65,138341
15231,0.000764,172.31.40.0-255,66,35888,65,138341
15232,0.000781,172.217.194.0-255,1484,37372,65,138341
15233,0.000783,172.31.40.0-255,66,37438,65,138341
15234,0.000808,172.217.194.0-255,4320,41758,65,138341
15235,0.000811,172.31.40.0-255,66,41824,65,138341
15236,0.000815,172.217.194.0-255,2902,44726,65,138341
15237,0.000818,172.31.40.0-255,66,44792,65,138341
15238,0.000823,172.217.194.0-255,3961,48753,65,138341
15239,0.000825,172.31.40.0-255,66,48819,65,138341
15240,0.000835,172.31.40.0-255,66,48885,65,138341
15241,0.000838,172.217.194.0-255,1484,50369,65,138341
15242,0.000866,172.217.194.0-255,6797,57166,65,138341
15243,0.000868,172.31.40.0-255,66,57232,65,138341
15244,0.000871,172.217.194.0-255,360,57592,65,138341
15245,0.001081,172.217.194.0-255,383,57975,65,138341
15246,0.001362,172.217.194.0-255,1484,59459,65,138341
15247,0.00137,172.31.40.0-255,66,59525,65,138341
15248,0.001376,172.217.194.0-255,2902,62427,65,138341
15249,0.001379,172.31.40.0-255,66,62493,65,138341
15250,0.001385,172.217.194.0-255,5738,68231,65,138341
15251,0.001387,172.31.40.0-255,66,68297,65,138341
15252,0.001424,172.31.40.0-255,66,68363,65,138341
15253,0.001467,172.217.194.0-255,5738,74101,65,138341
15254,0.00147,172.31.40.0-255,66,74167,65,138341
15255,0.001492,172.31.40.0-255,66,74233,65,138341
15256,0.001658,172.217.194.0-255,1484,75717,65,138341
15257,0.001664,172.217.194.0-255,2902,78619,65,138341
15258,0.001668,172.31.40.0-255,66,78685,65,138341
15259,0.001673,172.217.194.0-255,1484,80169,65,138341
15260,0.001693,172.217.194.0-255,4320,84489,65,138341
15261,0.001696,172.31.40.0-255,66,84555,65,138341
15262,0.00174,172.217.194.0-255,7156,91711,65,138341
15263,0.001743,172.31.40.0-255,66,91777,65,138341
15264,0.001754,172.31.40.0-255,66,91843,65,138341
15265,0.001765,172.31.40.0-255,66,91909,65,138341
15266,0.003799,172.217.194.0-255,5738,97647,65,138341
15267,0.003805,172.31.40.0-255,66,97713,65,138341
15268,0.005817,172.217.194.0-255,5738,103451,65,138341
15269,0.005824,172.31.40.0-255,66,103517,65,138341
15270,0.007875,172.217.194.0-255,5738,109255,65,138341
15271,0.007885,172.31.40.0-255,66,109321,65,138341
15272,0.009908,172.217.194.0-255,5738,115059,65,138341
15273,0.009916,172.31.40.0-255,66,115125,65,138341
15274,0.011914,172.217.194.0-255,5738,120863,65,138341
15275,0.011923,172.31.40.0-255,66,120929,65,138341
15276,0.013972,172.217.194.0-255,5738,126667,65,138341
15277,0.013981,172.31.40.0-255,66,126733,65,138341
15278,0.016014,172.217.194.0-255,5738,132471,65,138341
15279,0.016023,172.31.40.0-255,66,132537,65,138341
15280,0.01812,172.217.194.0-255,5738,138275,65,138341
15281,0.018127,172.31.40.0-255,66,138341,65,138341
15282,0.0,216.58.221.0-255,152,152,65,134800
15283,2.1e-05,172.31.40.0-255,66,218,65,134800
15284,2.7e-05,216.58.221.0-255,1484,1702,65,134800
15285,3.2e-05,172.31.40.0-255,66,1768,65,134800
15286,3.7e-05,216.58.221.0-255,2902,4670,65,134800
15287,4.6e-05,172.31.40.0-255,66,4736,65,134800
15288,5.2e-05,216.58.221.0-255,5738,10474,65,134800
15289,5.4e-05,172.31.40.0-255,66,10540,65,134800
15290,8.4e-05,216.58.221.0-255,3533,14073,65,134800
15291,8.7e-05,172.31.40.0-255,66,14139,65,134800
15292,0.000196,216.58.221.0-255,1484,15623,65,134800
15293,0.0002,172.31.40.0-255,66,15689,65,134800
15294,0.000205,216.58.221.0-255,2902,18591,65,134800
15295,0.000207,172.31.40.0-255,66,18657,65,134800
15296,0.000231,216.58.221.0-255,5738,24395,65,134800
15297,0.000234,172.31.40.0-255,66,24461,65,134800
15298,0.00024,216.58.221.0-255,6797,31258,65,134800
15299,0.000242,172.31.40.0-255,66,31324,65,134800
15300,0.000341,216.58.221.0-255,1484,32808,65,134800
15301,0.000344,172.31.40.0-255,66,32874,65,134800
15302,0.000348,216.58.221.0-255,1484,34358,65,134800
15303,0.000349,172.31.40.0-255,66,34424,65,134800
15304,0.000382,216.58.221.0-255,1484,35908,65,134800
15305,0.000384,172.31.40.0-255,66,35974,65,134800
15306,0.00039,216.58.221.0-255,5738,41712,65,134800
15307,0.000392,172.31.40.0-255,66,41778,65,134800
15308,0.000401,216.58.221.0-255,5738,47516,65,134800
15309,0.000403,172.31.40.0-255,66,47582,65,134800
15310,0.000429,216.58.221.0-255,1125,48707,65,134800
15311,0.000431,172.31.40.0-255,66,48773,65,134800
15312,0.000471,216.58.221.0-255,1484,50257,65,134800
15313,0.000474,172.31.40.0-255,66,50323,65,134800
15314,0.000491,216.58.221.0-255,2902,53225,65,134800
15315,0.000494,172.31.40.0-255,66,53291,65,134800
15316,0.000499,216.58.221.0-255,4320,57611,65,134800
15317,0.000501,172.31.40.0-255,66,57677,65,134800
15318,0.000517,216.58.221.0-255,1484,59161,65,134800
15319,0.000541,216.58.221.0-255,6797,65958,65,134800
15320,0.000544,172.31.40.0-255,66,66024,65,134800
15321,0.000567,216.58.221.0-255,395,66419,65,134800
15322,0.001042,172.31.40.0-255,66,66485,65,134800
15323,0.001808,216.58.221.0-255,114,66599,65,134800
15324,0.001916,216.58.221.0-255,1484,68083,65,134800
15325,0.00192,172.31.40.0-255,66,68149,65,134800
15326,0.001926,216.58.221.0-255,2902,71051,65,134800
15327,0.001927,172.31.40.0-255,66,71117,65,134800
15328,0.001949,216.58.221.0-255,5738,76855,65,134800
15329,0.001954,172.31.40.0-255,66,76921,65,134800
15330,0.001959,216.58.221.0-255,4320,81241,65,134800
15331,0.001961,172.31.40.0-255,66,81307,65,134800
15332,0.001965,216.58.221.0-255,2543,83850,65,134800
15333,0.001967,172.31.40.0-255,66,83916,65,134800
15334,0.003892,216.58.221.0-255,4320,88236,65,134800
15335,0.003896,172.31.40.0-255,66,88302,65,134800
15336,0.003922,216.58.221.0-255,1484,89786,65,134800
15337,0.005853,216.58.221.0-255,4320,94106,65,134800
15338,0.005856,172.31.40.0-255,66,94172,65,134800
15339,0.007805,216.58.221.0-255,5738,99910,65,134800
15340,0.007812,172.31.40.0-255,66,99976,65,134800
15341,0.009756,216.58.221.0-255,5738,105714,65,134800
15342,0.009764,172.31.40.0-255,66,105780,65,134800
15343,0.011722,216.58.221.0-255,5738,111518,65,134800
15344,0.011729,172.31.40.0-255,66,111584,65,134800
15345,0.013679,216.58.221.0-255,5738,117322,65,134800
15346,0.013687,172.31.40.0-255,66,117388,65,134800
15347,0.015631,216.58.221.0-255,5738,123126,65,134800
15348,0.015638,172.31.40.0-255,66,123192,65,134800
15349,0.017583,216.58.221.0-255,5738,128930,65,134800
15350,0.01759,172.31.40.0-255,66,128996,65,134800
15351,0.019543,216.58.221.0-255,5738,134734,65,134800
15352,0.01955,172.31.40.0-255,66,134800,65,134800
15353,0.0,74.125.24.0-255,299,299,65,203032
15354,1.9e-05,172.31.40.0-255,66,365,65,203032
15355,2.6e-05,74.125.24.0-255,1484,1849,65,203032
15356,3e-05,172.31.40.0-255,66,1915,65,203032
15357,3.6e-05,74.125.24.0-255,2902,4817,65,203032
15358,4.7e-05,172.31.40.0-255,66,4883,65,203032
15359,5.5e-05,74.125.24.0-255,5738,10621,65,203032
15360,5.8e-05,172.31.40.0-255,66,10687,65,203032
15361,6.1e-05,74.125.24.0-255,1484,12171,65,203032
15362,6.3e-05,172.31.40.0-255,66,12237,65,203032
15363,0.000105,172.31.40.0-255,66,12303,65,203032
15364,0.000113,74.125.24.0-255,6797,19100,65,203032
15365,0.000116,172.31.40.0-255,66,19166,65,203032
15366,0.000156,74.125.24.0-255,1484,20650,65,203032
15367,0.000158,172.31.40.0-255,66,20716,65,203032
15368,0.000195,74.125.24.0-255,2902,23618,65,203032
15369,0.000198,172.31.40.0-255,66,23684,65,203032
15370,0.000201,74.125.24.0-255,1484,25168,65,203032
15371,0.000202,172.31.40.0-255,66,25234,65,203032
15372,0.000205,74.125.24.0-255,1484,26718,65,203032
15373,0.000208,172.31.40.0-255,66,26784,65,203032
15374,0.000239,74.125.24.0-255,4320,31104,65,203032
15375,0.000242,172.31.40.0-255,66,31170,65,203032
15376,0.000248,74.125.24.0-255,5379,36549,65,203032
15377,0.000251,172.31.40.0-255,66,36615,65,203032
15378,0.000722,74.125.24.0-255,1484,38099,65,203032
15379,0.000728,172.31.40.0-255,66,38165,65,203032
15380,0.000735,74.125.24.0-255,2902,41067,65,203032
15381,0.000737,172.31.40.0-255,66,41133,65,203032
15382,0.000746,74.125.24.0-255,1484,42617,65,203032
15383,0.000748,172.31.40.0-255,66,42683,65,203032
15384,0.000755,74.125.24.0-255,5738,48421,65,203032
15385,0.000757,172.31.40.0-255,66,48487,65,203032
15386,0.000781,74.125.24.0-255,1484,49971,65,203032
15387,0.000806,74.125.24.0-255,6797,56768,65,203032
15388,0.000809,172.31.40.0-255,66,56834,65,203032
15389,0.00082,172.31.40.0-255,66,56900,65,203032
15390,0.000874,74.125.24.0-255,5959,62859,65,203032
15391,0.000877,172.31.40.0-255,66,62925,65,203032
15392,0.000898,74.125.24.0-255,1484,64409,65,203032
15393,0.000919,74.125.24.0-255,2902,67311,65,203032
15394,0.000928,172.31.40.0-255,66,67377,65,203032
15395,0.000931,74.125.24.0-255,1484,68861,65,203032
15396,0.000955,74.125.24.0-255,4320,73181,65,203032
15397,0.000958,172.31.40.0-255,66,73247,65,203032
15398,0.000964,74.125.24.0-255,4320,77567,65,203032
15399,0.000966,172.31.40.0-255,66,77633,65,203032
15400,0.000988,74.125.24.0-255,2543,80176,65,203032
15401,0.00099,172.31.40.0-255,66,80242,65,203032
15402,0.001184,74.125.24.0-255,1484,81726,65,203032
15403,0.001199,74.125.24.0-255,2902,84628,65,203032
15404,0.001203,172.31.40.0-255,66,84694,65,203032
15405,0.001238,74.125.24.0-255,5738,90432,65,203032
15406,0.001241,172.31.40.0-255,66,90498,65,203032
15407,0.001245,74.125.24.0-255,2902,93400,65,203032
15408,0.001248,172.31.40.0-255,66,93466,65,203032
15409,0.001304,172.31.40.0-255,66,93532,65,203032
15410,0.001327,172.31.40.0-255,66,93598,65,203032
15411,0.00135,74.125.24.0-255,2184,95782,65,203032
15412,0.001353,172.31.40.0-255,66,95848,65,203032
15413,0.001508,74.125.24.0-255,1484,97332,65,203032
15414,0.001514,74.125.24.0-255,2902,100234,65,203032
15415,0.001517,172.31.40.0-255,66,100300,65,203032
15416,0.001544,74.125.24.0-255,5738,106038,65,203032
15417,0.001546,172.31.40.0-255,66,106104,65,203032
15418,0.001552,74.125.24.0-255,4320,110424,65,203032
15419,0.001554,172.31.40.0-255,66,110490,65,203032
15420,0.001619,74.125.24.0-255,1484,111974,65,203032
15421,0.001634,74.125.24.0-255,4320,116294,65,203032
15422,0.001637,172.31.40.0-255,66,116360,65,203032
15423,0.001665,74.125.24.0-255,4320,120680,65,203032
15424,0.001668,172.31.40.0-255,66,120746,65,203032
15425,0.001671,74.125.24.0-255,1484,122230,65,203032
15426,0.001697,74.125.24.0-255,4320,126550,65,203032
15427,0.0017,172.31.40.0-255,66,126616,65,203032
15428,0.001719,74.125.24.0-255,3602,130218,65,203032
15429,0.001725,172.31.40.0-255,66,130284,65,203032
15430,0.001852,74.125.24.0-255,1484,131768,65,203032
15431,0.001865,74.125.24.0-255,2902,134670,65,203032
15432,0.001868,172.31.40.0-255,66,134736,65,203032
15433,0.001897,74.125.24.0-255,5738,140474,65,203032
15434,0.0019,172.31.40.0-255,66,140540,65,203032
15435,0.001935,74.125.24.0-255,4320,144860,65,203032
15436,0.001938,172.31.40.0-255,66,144926,65,203032
15437,0.001946,74.125.24.0-255,7156,152082,65,203032
15438,0.001949,172.31.40.0-255,66,152148,65,203032
15439,0.001977,74.125.24.0-255,4320,156468,65,203032
15440,0.00198,172.31.40.0-255,66,156534,65,203032
15441,0.002005,172.31.40.0-255,66,156600,65,203032
15442,0.004032,74.125.24.0-255,5738,162338,65,203032
15443,0.004041,172.31.40.0-255,66,162404,65,203032
15444,0.006065,74.125.24.0-255,5738,168142,65,203032
15445,0.00607,172.31.40.0-255,66,168208,65,203032
15446,0.008087,74.125.24.0-255,5738,173946,65,203032
15447,0.008094,172.31.40.0-255,66,174012,65,203032
15448,0.01013,74.125.24.0-255,5738,179750,65,203032
15449,0.010136,172.31.40.0-255,66,179816,65,203032
15450,0.012192,74.125.24.0-255,5738,185554,65,203032
15451,0.012201,172.31.40.0-255,66,185620,65,203032
15452,0.014243,74.125.24.0-255,5738,191358,65,203032
15453,0.014251,172.31.40.0-255,66,191424,65,203032
15454,0.016291,74.125.24.0-255,5738,197162,65,203032
15455,0.016297,172.31.40.0-255,66,197228,65,203032
15456,0.018307,74.125.24.0-255,5738,202966,65,203032
15457,0.018313,172.31.40.0-255,66,203032,65,203032
15458,0.0,172.31.40.0-255,105,105,65,459
15459,0.000245,172.31.40.0-255,90,195,65,459
15460,0.000254,172.31.40.0-255,66,261,65,459
15461,0.002294,172.217.194.0-255,66,327,65,459
15462,0.002317,172.217.194.0-255,66,393,65,459
15463,0.002335,172.31.40.0-255,66,459,65,459
15464,0.0,172.31.40.0-255,105,105,65,459
15465,0.000243,172.31.40.0-255,90,195,65,459
15466,0.000254,172.31.40.0-255,66,261,65,459
15467,0.002545,74.125.68.0-255,66,327,65,459
15468,0.002576,74.125.68.0-255,66,393,65,459
15469,0.002599,172.31.40.0-255,66,459,65,459
15470,0.0,74.125.68.0-255,160,160,65,182611
15471,2.7e-05,172.31.40.0-255,66,226,65,182611
15472,3.5e-05,74.125.68.0-255,1484,1710,65,182611
15473,4e-05,172.31.40.0-255,66,1776,65,182611
15474,4.5e-05,74.125.68.0-255,2902,4678,65,182611
15475,4.8e-05,172.31.40.0-255,66,4744,65,182611
15476,5.4e-05,74.125.68.0-255,4320,9064,65,182611
15477,5.7e-05,172.31.40.0-255,66,9130,65,182611
15478,8.3e-05,74.125.68.0-255,4747,13877,65,182611
15479,8.7e-05,172.31.40.0-255,66,13943,65,182611
15480,0.000136,74.125.68.0-255,1484,15427,65,182611
15481,0.000138,172.31.40.0-255,66,15493,65,182611
15482,0.000157,74.125.68.0-255,2902,18395,65,182611
15483,0.000159,172.31.40.0-255,66,18461,65,182611
15484,0.000173,74.125.68.0-255,2902,21363,65,182611
15485,0.000175,172.31.40.0-255,66,21429,65,182611
15486,0.000189,74.125.68.0-255,2902,24331,65,182611
15487,0.000191,172.31.40.0-255,66,24397,65,182611
15488,0.000196,74.125.68.0-255,2902,27299,65,182611
15489,0.000198,172.31.40.0-255,66,27365,65,182611
15490,0.000218,74.125.68.0-255,3961,31326,65,182611
15491,0.000221,172.31.40.0-255,66,31392,65,182611
15492,0.000384,74.125.68.0-255,1484,32876,65,182611
15493,0.000389,172.31.40.0-255,66,32942,65,182611
15494,0.000392,74.125.68.0-255,1484,34426,65,182611
15495,0.000394,172.31.40.0-255,66,34492,65,182611
15496,0.00041,74.125.68.0-255,1484,35976,65,182611
15497,0.000413,172.31.40.0-255,66,36042,65,182611
15498,0.000429,74.125.68.0-255,1484,37526,65,182611
15499,0.000432,172.31.40.0-255,66,37592,65,182611
15500,0.000449,74.125.68.0-255,4320,41912,65,182611
15501,0.000452,172.31.40.0-255,66,41978,65,182611
15502,0.000456,74.125.68.0-255,2902,44880,65,182611
15503,0.000458,172.31.40.0-255,66,44946,65,182611
15504,0.000478,74.125.68.0-255,3961,48907,65,182611
15505,0.00048,172.31.40.0-255,66,48973,65,182611
15506,0.000485,74.125.68.0-255,2902,51875,65,182611
15507,0.000487,172.31.40.0-255,66,51941,65,182611
15508,0.000518,74.125.68.0-255,1484,53425,65,182611
15509,0.000527,74.125.68.0-255,5738,59163,65,182611
15510,0.000529,172.31.40.0-255,66,59229,65,182611
15511,0.000548,74.125.68.0-255,7110,66339,65,182611
15512,0.00055,172.31.40.0-255,66,66405,65,182611
15513,0.000553,74.125.68.0-255,110,66515,65,182611
15514,0.000588,74.125.68.0-255,330,66845,65,182611
15515,0.000864,74.125.68.0-255,1484,68329,65,182611
15516,0.000869,74.125.68.0-255,2902,71231,65,182611
15517,0.000874,172.31.40.0-255,66,71297,65,182611
15518,0.000882,172.31.40.0-255,66,71363,65,182611
15519,0.00089,74.125.68.0-255,5738,77101,65,182611
15520,0.000893,172.31.40.0-255,66,77167,65,182611
15521,0.000931,74.125.68.0-255,7156,84323,65,182611
15522,0.000934,172.31.40.0-255,66,84389,65,182611
15523,0.000949,74.125.68.0-255,4320,88709,65,182611
15524,0.000951,172.31.40.0-255,66,88775,65,182611
15525,0.000964,74.125.68.0-255,1484,90259,65,182611
15526,0.000973,74.125.68.0-255,7156,97415,65,182611
15527,0.000975,172.31.40.0-255,66,97481,65,182611
15528,0.000993,74.125.68.0-255,3602,101083,65,182611
15529,0.000996,172.31.40.0-255,66,101149,65,182611
15530,0.001979,74.125.68.0-255,1484,102633,65,182611
15531,0.001991,74.125.68.0-255,2902,105535,65,182611
15532,0.001995,172.31.40.0-255,66,105601,65,182611
15533,0.00202,74.125.68.0-255,2902,108503,65,182611
15534,0.002023,172.31.40.0-255,66,108569,65,182611
15535,0.002029,74.125.68.0-255,4320,112889,65,182611
15536,0.002031,172.31.40.0-255,66,112955,65,182611
15537,0.002057,172.31.40.0-255,66,113021,65,182611
15538,0.002063,74.125.68.0-255,4320,117341,65,182611
15539,0.002064,172.31.40.0-255,66,117407,65,182611
15540,0.002067,74.125.68.0-255,1484,118891,65,182611
15541,0.002088,74.125.68.0-255,4320,123211,65,182611
15542,0.002091,172.31.40.0-255,66,123277,65,182611
15543,0.002109,74.125.68.0-255,3602,126879,65,182611
15544,0.002111,172.31.40.0-255,66,126945,65,182611
15545,0.002191,74.125.68.0-255,1484,128429,65,182611
15546,0.002196,74.125.68.0-255,1484,129913,65,182611
15547,0.002199,172.31.40.0-255,66,129979,65,182611
15548,0.002219,74.125.68.0-255,1484,131463,65,182611
15549,0.002224,74.125.68.0-255,2902,134365,65,182611
15550,0.002226,172.31.40.0-255,66,134431,65,182611
15551,0.00223,74.125.68.0-255,1484,135915,65,182611
15552,0.002249,74.125.68.0-255,5738,141653,65,182611
15553,0.002251,172.31.40.0-255,66,141719,65,182611
15554,0.00228,172.31.40.0-255,66,141785,65,182611
15555,0.002284,74.125.68.0-255,1484,143269,65,182611
15556,0.00453,74.125.68.0-255,4320,147589,65,182611
15557,0.00454,172.31.40.0-255,66,147655,65,182611
15558,0.006779,74.125.68.0-255,2902,150557,65,182611
15559,0.006784,172.31.40.0-255,66,150623,65,182611
15560,0.006803,74.125.68.0-255,2902,153525,65,182611
15561,0.006806,172.31.40.0-255,66,153591,65,182611
15562,0.009052,74.125.68.0-255,5738,159329,65,182611
15563,0.009072,172.31.40.0-255,66,159395,65,182611
15564,0.011342,74.125.68.0-255,5738,165133,65,182611
15565,0.011365,172.31.40.0-255,66,165199,65,182611
15566,0.013632,74.125.68.0-255,5738,170937,65,182611
15567,0.01365,172.31.40.0-255,66,171003,65,182611
15568,0.015916,74.125.68.0-255,5738,176741,65,182611
15569,0.015936,172.31.40.0-255,66,176807,65,182611
15570,0.018194,74.125.68.0-255,5738,182545,65,182611
15571,0.018214,172.31.40.0-255,66,182611,65,182611
15572,0.0,74.125.200.0-255,151,151,65,273149
15573,3.1e-05,172.31.40.0-255,66,217,65,273149
15574,3.8e-05,74.125.200.0-255,1484,1701,65,273149
15575,4.2e-05,172.31.40.0-255,66,1767,65,273149
15576,6.7e-05,74.125.200.0-255,2902,4669,65,273149
15577,7.1e-05,172.31.40.0-255,66,4735,65,273149
15578,7.6e-05,74.125.200.0-255,4320,9055,65,273149
15579,7.8e-05,172.31.40.0-255,66,9121,65,273149
15580,0.000112,172.31.40.0-255,66,9187,65,273149
15581,0.000118,74.125.200.0-255,4320,13507,65,273149
15582,0.00012,172.31.40.0-255,66,13573,65,273149
15583,0.000172,74.125.200.0-255,7156,20729,65,273149
15584,0.000176,172.31.40.0-255,66,20795,65,273149
15585,0.000205,74.125.200.0-255,1125,21920,65,273149
15586,0.000208,172.31.40.0-255,66,21986,65,273149
15587,0.000234,74.125.200.0-255,1484,23470,65,273149
15588,0.000236,172.31.40.0-255,66,23536,65,273149
15589,0.000239,74.125.200.0-255,1484,25020,65,273149
15590,0.000241,172.31.40.0-255,66,25086,65,273149
15591,0.000261,74.125.200.0-255,1484,26570,65,273149
15592,0.000264,172.31.40.0-255,66,26636,65,273149
15593,0.000276,74.125.200.0-255,2902,29538,65,273149
15594,0.000279,172.31.40.0-255,66,29604,65,273149
15595,0.000285,74.125.200.0-255,4320,33924,65,273149
15596,0.000288,172.31.40.0-255,66,33990,65,273149
15597,0.00029,74.125.200.0-255,1484,35474,65,273149
15598,0.000293,172.31.40.0-255,66,35540,65,273149
15599,0.000308,74.125.200.0-255,5738,41278,65,273149
15600,0.000311,172.31.40.0-255,66,41344,65,273149
15601,0.00033,74.125.200.0-255,1484,42828,65,273149
15602,0.000333,172.31.40.0-255,66,42894,65,273149
15603,0.000341,74.125.200.0-255,7156,50050,65,273149
15604,0.000344,172.31.40.0-255,66,50116,65,273149
15605,0.000375,74.125.200.0-255,6804,56920,65,273149
15606,0.000378,172.31.40.0-255,66,56986,65,273149
15607,0.000536,74.125.200.0-255,1484,58470,65,273149
15608,0.000557,74.125.200.0-255,2902,61372,65,273149
15609,0.000561,172.31.40.0-255,66,61438,65,273149
15610,0.000593,74.125.200.0-255,4320,65758,65,273149
15611,0.000596,172.31.40.0-255,66,65824,65,273149
15612,0.000604,74.125.200.0-255,7156,72980,65,273149
15613,0.000606,172.31.40.0-255,66,73046,65,273149
15614,0.00063,74.125.200.0-255,1484,74530,65,273149
15615,0.000636,74.125.200.0-255,4320,78850,65,273149
15616,0.000639,172.31.40.0-255,66,78916,65,273149
15617,0.000663,74.125.200.0-255,4320,83236,65,273149
15618,0.00067,172.31.40.0-255,66,83302,65,273149
15619,0.00071,172.31.40.0-255,66,83368,65,273149
15620,0.000712,74.125.200.0-255,342,83710,65,273149
15621,0.000733,74.125.200.0-255,1484,85194,65,273149
15622,0.000736,172.31.40.0-255,66,85260,65,273149
15623,0.000741,74.125.200.0-255,2902,88162,65,273149
15624,0.000743,172.31.40.0-255,66,88228,65,273149
15625,0.000762,74.125.200.0-255,1484,89712,65,273149
15626,0.000767,74.125.200.0-255,2902,92614,65,273149
15627,0.00077,172.31.40.0-255,66,92680,65,273149
15628,0.000775,74.125.200.0-255,4320,97000,65,273149
15629,0.000777,172.31.40.0-255,66,97066,65,273149
15630,0.0008,74.125.200.0-255,1484,98550,65,273149
15631,0.000824,74.125.200.0-255,7156,105706,65,273149
15632,0.000828,172.31.40.0-255,66,105772,65,273149
15633,0.000831,74.125.200.0-255,1484,107256,65,273149
15634,0.000866,172.31.40.0-255,66,107322,65,273149
15635,0.000871,74.125.200.0-255,2184,109506,65,273149
15636,0.000873,172.31.40.0-255,66,109572,65,273149
15637,0.000976,74.125.200.0-255,1484,111056,65,273149
15638,0.000982,74.125.200.0-255,2902,113958,65,273149
15639,0.000985,172.31.40.0-255,66,114024,65,273149
15640,0.001045,74.125.200.0-255,5738,119762,65,273149
15641,0.001049,172.31.40.0-255,66,119828,65,273149
15642,0.001052,74.125.200.0-255,1484,121312,65,273149
15643,0.001066,172.31.40.0-255,66,121378,65,273149
15644,0.001074,74.125.200.0-255,7156,128534,65,273149
15645,0.001076,172.31.40.0-255,66,128600,65,273149
15646,0.001111,74.125.200.0-255,6438,135038,65,273149
15647,0.001114,172.31.40.0-255,66,135104,65,273149
15648,0.001278,74.125.200.0-255,1484,136588,65,273149
15649,0.001291,74.125.200.0-255,2902,139490,65,273149
15650,0.001294,172.31.40.0-255,66,139556,65,273149
15651,0.001326,74.125.200.0-255,5738,145294,65,273149
15652,0.001329,172.31.40.0-255,66,145360,65,273149
15653,0.001336,74.125.200.0-255,7156,152516,65,273149
15654,0.001338,172.31.40.0-255,66,152582,65,273149
15655,0.001377,172.31.40.0-255,66,152648,65,273149
15656,0.001403,74.125.200.0-255,2902,155550,65,273149
15657,0.001407,172.31.40.0-255,66,155616,65,273149
15658,0.001414,74.125.200.0-255,7156,162772,65,273149
15659,0.001418,172.31.40.0-255,66,162838,65,273149
15660,0.001447,172.31.40.0-255,66,162904,65,273149
15661,0.001454,74.125.200.0-255,5738,168642,65,273149
15662,0.001456,172.31.40.0-255,66,168708,65,273149
15663,0.001494,172.31.40.0-255,66,168774,65,273149
15664,0.00152,74.125.200.0-255,3602,172376,65,273149
15665,0.001523,172.31.40.0-255,66,172442,65,273149
15666,0.001531,74.125.200.0-255,7156,179598,65,273149
15667,0.001533,172.31.40.0-255,66,179664,65,273149
15668,0.001555,74.125.200.0-255,1484,181148,65,273149
15669,0.001572,74.125.200.0-255,1484,182632,65,273149
15670,0.001573,172.31.40.0-255,66,182698,65,273149
15671,0.001585,74.125.200.0-255,4320,187018,65,273149
15672,0.001588,172.31.40.0-255,66,187084,65,273149
15673,0.001599,74.125.200.0-255,5738,192822,65,273149
15674,0.001601,172.31.40.0-255,66,192888,65,273149
15675,0.001621,74.125.200.0-255,1484,194372,65,273149
15676,0.001624,74.125.200.0-255,1484,195856,65,273149
15677,0.001627,172.31.40.0-255,66,195922,65,273149
15678,0.001652,74.125.200.0-255,3602,199524,65,273149
15679,0.001657,172.31.40.0-255,66,199590,65,273149
15680,0.001663,74.125.200.0-255,5738,205328,65,273149
15681,0.001666,172.31.40.0-255,66,205394,65,273149
15682,0.00167,74.125.200.0-255,1484,206878,65,273149
15683,0.001704,172.31.40.0-255,66,206944,65,273149
15684,0.00171,74.125.200.0-255,4320,211264,65,273149
15685,0.001712,172.31.40.0-255,66,211330,65,273149
15686,0.001741,74.125.200.0-255,4320,215650,65,273149
15687,0.001745,172.31.40.0-255,66,215716,65,273149
15688,0.001789,172.31.40.0-255,66,215782,65,273149
15689,0.001837,172.31.40.0-255,66,215848,65,273149
15690,0.001862,74.125.200.0-255,5738,221586,65,273149
15691,0.001865,172.31.40.0-255,66,221652,65,273149
15692,0.001868,74.125.200.0-255,1484,223136,65,273149
15693,0.001873,74.125.200.0-255,2902,226038,65,273149
15694,0.001875,172.31.40.0-255,66,226104,65,273149
15695,0.001877,74.125.200.0-255,766,226870,65,273149
15696,0.00188,74.125.200.0-255,1484,228354,65,273149
15697,0.001883,172.31.40.0-255,66,228420,65,273149
15698,0.001884,74.125.200.0-255,4320,232740,65,273149
15699,0.001887,172.31.40.0-255,66,232806,65,273149
15700,0.001893,74.125.200.0-255,5738,238544,65,273149
15701,0.001895,172.31.40.0-255,66,238610,65,273149
15702,0.001924,74.125.200.0-255,4320,242930,65,273149
15703,0.001928,172.31.40.0-255,66,242996,65,273149
15704,0.001933,74.125.200.0-255,4320,247316,65,273149
15705,0.001935,172.31.40.0-255,66,247382,65,273149
15706,0.001966,74.125.200.0-255,1484,248866,65,273149
15707,0.001995,172.31.40.0-255,66,248932,65,273149
15708,0.001998,74.125.200.0-255,1484,250416,65,273149
15709,0.002019,74.125.200.0-255,2902,253318,65,273149
15710,0.002021,172.31.40.0-255,66,253384,65,273149
15711,0.002024,74.125.200.0-255,1484,254868,65,273149
15712,0.002049,74.125.200.0-255,4320,259188,65,273149
15713,0.002052,172.31.40.0-255,66,259254,65,273149
15714,0.002059,74.125.200.0-255,5738,264992,65,273149
15715,0.002061,172.31.40.0-255,66,265058,65,273149
15716,0.002094,74.125.200.0-255,1484,266542,65,273149
15717,0.002105,172.31.40.0-255,66,266608,65,273149
15718,0.002112,74.125.200.0-255,6133,272741,65,273149
15719,0.002114,172.31.40.0-255,66,272807,65,273149
15720,0.002153,74.125.200.0-255,105,272912,65,273149
15721,0.003395,172.31.40.0-255,66,272978,65,273149
15722,0.003421,172.31.40.0-255,105,273083,65,273149
15723,0.005693,74.125.200.0-255,66,273149,65,273149
15724,0.0,172.217.194.0-255,151,151,65,122566
15725,1.6e-05,172.31.40.0-255,66,217,65,122566
15726,2.3e-05,172.217.194.0-255,1484,1701,65,122566
15727,2.9e-05,172.31.40.0-255,66,1767,65,122566
15728,3.4e-05,172.217.194.0-255,2902,4669,65,122566
15729,4.6e-05,172.31.40.0-255,66,4735,65,122566
15730,5.4e-05,172.217.194.0-255,7156,11891,65,122566
15731,5.7e-05,172.31.40.0-255,66,11957,65,122566
15732,8.3e-05,172.217.194.0-255,1984,13941,65,122566
15733,8.6e-05,172.31.40.0-255,66,14007,65,122566
15734,9.1e-05,172.217.194.0-255,2902,16909,65,122566
15735,9.3e-05,172.31.40.0-255,66,16975,65,122566
15736,0.000139,172.217.194.0-255,7156,24131,65,122566
15737,0.000142,172.31.40.0-255,66,24197,65,122566
15738,0.000148,172.217.194.0-255,4320,28517,65,122566
15739,0.00015,172.31.40.0-255,66,28583,65,122566
15740,0.00018,172.217.194.0-255,7156,35739,65,122566
15741,0.000187,172.31.40.0-255,66,35805,65,122566
15742,0.0002,172.31.40.0-255,66,35871,65,122566
15743,0.000247,172.217.194.0-255,5738,41609,65,122566
15744,0.00025,172.31.40.0-255,66,41675,65,122566
15745,0.000257,172.217.194.0-255,7156,48831,65,122566
15746,0.00026,172.31.40.0-255,66,48897,65,122566
15747,0.000293,172.217.194.0-255,3961,52858,65,122566
15748,0.000298,172.31.40.0-255,66,52924,65,122566
15749,0.000463,172.217.194.0-255,646,53570,65,122566
15750,0.000467,172.31.40.0-255,66,53636,65,122566
15751,0.001215,172.217.194.0-255,1484,55120,65,122566
15752,0.001221,172.31.40.0-255,66,55186,65,122566
15753,0.00123,172.217.194.0-255,2902,58088,65,122566
15754,0.001232,172.31.40.0-255,66,58154,65,122566
15755,0.001244,172.217.194.0-255,5738,63892,65,122566
15756,0.001246,172.31.40.0-255,66,63958,65,122566
15757,0.001254,172.217.194.0-255,5738,69696,65,122566
15758,0.001256,172.31.40.0-255,66,69762,65,122566
15759,0.001289,172.217.194.0-255,7156,76918,65,122566
15760,0.0013,172.217.194.0-255,4320,81238,65,122566
15761,0.001315,172.217.194.0-255,6438,87676,65,122566
15762,0.004076,172.31.40.0-255,66,87742,65,122566
15763,0.006376,172.217.194.0-255,5738,93480,65,122566
15764,0.006383,172.31.40.0-255,66,93546,65,122566
15765,0.00863,172.217.194.0-255,5738,99284,65,122566
15766,0.008636,172.31.40.0-255,66,99350,65,122566
15767,0.01093,172.217.194.0-255,5738,105088,65,122566
15768,0.010937,172.31.40.0-255,66,105154,65,122566
15769,0.013184,172.217.194.0-255,5738,110892,65,122566
15770,0.013192,172.31.40.0-255,66,110958,65,122566
15771,0.015467,172.217.194.0-255,5738,116696,65,122566
15772,0.015477,172.31.40.0-255,66,116762,65,122566
15773,0.017758,172.217.194.0-255,5738,122500,65,122566
15774,0.017771,172.31.40.0-255,66,122566,65,122566
15775,0.0,172.217.194.0-255,153,153,65,183749
15776,2.2e-05,172.31.40.0-255,66,219,65,183749
15777,2.9e-05,172.217.194.0-255,1484,1703,65,183749
15778,3.5e-05,172.31.40.0-255,66,1769,65,183749
15779,4.1e-05,172.217.194.0-255,2902,4671,65,183749
15780,5.2e-05,172.31.40.0-255,66,4737,65,183749
15781,5.6e-05,172.217.194.0-255,1484,6221,65,183749
15782,5.9e-05,172.31.40.0-255,66,6287,65,183749
15783,6.4e-05,172.217.194.0-255,2902,9189,65,183749
15784,6.7e-05,172.31.40.0-255,66,9255,65,183749
15785,7.4e-05,172.217.194.0-255,6289,15544,65,183749
15786,7.7e-05,172.31.40.0-255,66,15610,65,183749
15787,8.9e-05,172.31.40.0-255,66,15676,65,183749
15788,0.000132,172.217.194.0-255,4320,19996,65,183749
15789,0.000135,172.31.40.0-255,66,20062,65,183749
15790,0.000157,172.217.194.0-255,2543,22605,65,183749
15791,0.00016,172.31.40.0-255,66,22671,65,183749
15792,0.000184,172.217.194.0-255,1484,24155,65,183749
15793,0.000186,172.31.40.0-255,66,24221,65,183749
15794,0.000206,172.217.194.0-255,2902,27123,65,183749
15795,0.000209,172.31.40.0-255,66,27189,65,183749
15796,0.000215,172.217.194.0-255,5738,32927,65,183749
15797,0.000217,172.31.40.0-255,66,32993,65,183749
15798,0.000247,172.217.194.0-255,4320,37313,65,183749
15799,0.000249,172.31.40.0-255,66,37379,65,183749
15800,0.000288,172.217.194.0-255,7156,44535,65,183749
15801,0.000291,172.31.40.0-255,66,44601,65,183749
15802,0.00031,172.217.194.0-255,3961,48562,65,183749
15803,0.000313,172.31.40.0-255,66,48628,65,183749
15804,0.000347,172.217.194.0-255,4320,52948,65,183749
15805,0.00035,172.31.40.0-255,66,53014,65,183749
15806,0.00037,172.217.194.0-255,4219,57233,65,183749
15807,0.000372,172.31.40.0-255,66,57299,65,183749
15808,0.000375,172.217.194.0-255,115,57414,65,183749
15809,0.000501,172.217.194.0-255,379,57793,65,183749
15810,0.000599,172.217.194.0-255,1484,59277,65,183749
15811,0.000605,172.31.40.0-255,66,59343,65,183749
15812,0.00061,172.217.194.0-255,2902,62245,65,183749
15813,0.000612,172.31.40.0-255,66,62311,65,183749
15814,0.000646,172.217.194.0-255,5738,68049,65,183749
15815,0.000649,172.31.40.0-255,66,68115,65,183749
15816,0.000657,172.217.194.0-255,6797,74912,65,183749
15817,0.000659,172.31.40.0-255,66,74978,65,183749
15818,0.000717,172.217.194.0-255,1484,76462,65,183749
15819,0.000722,172.217.194.0-255,2902,79364,65,183749
15820,0.000727,172.31.40.0-255,66,79430,65,183749
15821,0.000737,172.217.194.0-255,2902,82332,65,183749
15822,0.000744,172.31.40.0-255,66,82398,65,183749
15823,0.000771,172.217.194.0-255,2902,85300,65,183749
15824,0.000774,172.31.40.0-255,66,85366,65,183749
15825,0.000799,172.217.194.0-255,2902,88268,65,183749
15826,0.000802,172.31.40.0-255,66,88334,65,183749
15827,0.000831,172.217.194.0-255,3961,92295,65,183749
15828,0.000834,172.31.40.0-255,66,92361,65,183749
15829,0.001621,172.217.194.0-255,1484,93845,65,183749
15830,0.001628,172.217.194.0-255,2902,96747,65,183749
15831,0.001632,172.31.40.0-255,66,96813,65,183749
15832,0.001663,172.217.194.0-255,5738,102551,65,183749
15833,0.001665,172.217.194.0-255,1484,104035,65,183749
15834,0.001668,172.31.40.0-255,66,104101,65,183749
15835,0.0017,172.217.194.0-255,5738,109839,65,183749
15836,0.001703,172.31.40.0-255,66,109905,65,183749
15837,0.001722,172.31.40.0-255,66,109971,65,183749
15838,0.001726,172.217.194.0-255,2184,112155,65,183749
15839,0.001728,172.31.40.0-255,66,112221,65,183749
15840,0.001756,172.217.194.0-255,2902,115123,65,183749
15841,0.001764,172.31.40.0-255,66,115189,65,183749
15842,0.001788,172.217.194.0-255,2902,118091,65,183749
15843,0.001791,172.31.40.0-255,66,118157,65,183749
15844,0.001819,172.217.194.0-255,1484,119641,65,183749
15845,0.00183,172.31.40.0-255,66,119707,65,183749
15846,0.001853,172.31.40.0-255,66,119773,65,183749
15847,0.002168,172.217.194.0-255,1484,121257,65,183749
15848,0.002175,172.217.194.0-255,2902,124159,65,183749
15849,0.002179,172.31.40.0-255,66,124225,65,183749
15850,0.002186,172.217.194.0-255,5738,129963,65,183749
15851,0.002188,172.31.40.0-255,66,130029,65,183749
15852,0.002195,172.217.194.0-255,5738,135767,65,183749
15853,0.002202,172.31.40.0-255,66,135833,65,183749
15854,0.002233,172.217.194.0-255,7156,142989,65,183749
15855,0.002236,172.31.40.0-255,66,143055,65,183749
15856,0.002253,172.31.40.0-255,66,143121,65,183749
15857,0.004608,172.217.194.0-255,5738,148859,65,183749
15858,0.004615,172.31.40.0-255,66,148925,65,183749
15859,0.00697,172.217.194.0-255,5738,154663,65,183749
15860,0.006976,172.31.40.0-255,66,154729,65,183749
15861,0.009306,172.217.194.0-255,5738,160467,65,183749
15862,0.009313,172.31.40.0-255,66,160533,65,183749
15863,0.011635,172.217.194.0-255,5738,166271,65,183749
15864,0.011643,172.31.40.0-255,66,166337,65,183749
15865,0.013954,172.217.194.0-255,5738,172075,65,183749
15866,0.013961,172.31.40.0-255,66,172141,65,183749
15867,0.016306,172.217.194.0-255,5738,177879,65,183749
15868,0.016317,172.31.40.0-255,66,177945,65,183749
15869,0.018631,172.217.194.0-255,5738,183683,65,183749
15870,0.01864,172.31.40.0-255,66,183749,65,183749
15871,0.0,172.217.194.0-255,147,147,65,214490
15872,1.9e-05,172.31.40.0-255,66,213,65,214490
15873,2.7e-05,172.217.194.0-255,1484,1697,65,214490
15874,3.1e-05,172.31.40.0-255,66,1763,65,214490
15875,4.5e-05,172.217.194.0-255,2902,4665,65,214490
15876,5e-05,172.31.40.0-255,66,4731,65,214490
15877,5.8e-05,172.217.194.0-255,7156,11887,65,214490
15878,6.1e-05,172.31.40.0-255,66,11953,65,214490
15879,6.6e-05,172.217.194.0-255,2133,14086,65,214490
15880,6.9e-05,172.31.40.0-255,66,14152,65,214490
15881,8.3e-05,172.31.40.0-255,66,14218,65,214490
15882,0.000105,172.217.194.0-255,1484,15702,65,214490
15883,0.000108,172.31.40.0-255,66,15768,65,214490
15884,0.000119,172.217.194.0-255,5379,21147,65,214490
15885,0.000122,172.31.40.0-255,66,21213,65,214490
15886,0.000159,172.217.194.0-255,1484,22697,65,214490
15887,0.000162,172.31.40.0-255,66,22763,65,214490
15888,0.000165,172.217.194.0-255,1484,24247,65,214490
15889,0.000167,172.31.40.0-255,66,24313,65,214490
15890,0.000191,172.217.194.0-255,1484,25797,65,214490
15891,0.000198,172.31.40.0-255,66,25863,65,214490
15892,0.000205,172.217.194.0-255,5738,31601,65,214490
15893,0.000207,172.31.40.0-255,66,31667,65,214490
15894,0.000214,172.217.194.0-255,4320,35987,65,214490
15895,0.000216,172.31.40.0-255,66,36053,65,214490
15896,0.000242,172.217.194.0-255,2543,38596,65,214490
15897,0.000245,172.31.40.0-255,66,38662,65,214490
15898,0.00026,172.31.40.0-255,66,38728,65,214490
15899,0.000268,172.217.194.0-255,2800,41528,65,214490
15900,0.00027,172.31.40.0-255,66,41594,65,214490
15901,0.000273,172.217.194.0-255,115,41709,65,214490
15902,0.000348,172.217.194.0-255,1484,43193,65,214490
15903,0.000363,172.217.194.0-255,2902,46095,65,214490
15904,0.000378,172.217.194.0-255,5738,51833,65,214490
15905,0.000429,172.217.194.0-255,2543,54376,65,214490
15906,0.000483,172.217.194.0-255,1484,55860,65,214490
15907,0.000495,172.217.194.0-255,2902,58762,65,214490
15908,0.000524,172.217.194.0-255,5738,64500,65,214490
15909,0.000561,172.217.194.0-255,4320,68820,65,214490
15910,0.000606,172.217.194.0-255,2902,71722,65,214490
15911,0.000627,172.217.194.0-255,7156,78878,65,214490
15912,0.000656,172.217.194.0-255,5738,84616,65,214490
15913,0.000668,172.217.194.0-255,1125,85741,65,214490
15914,0.000686,172.31.40.0-255,66,85807,65,214490
15915,0.000708,172.217.194.0-255,5738,91545,65,214490
15916,0.000723,172.217.194.0-255,1484,93029,65,214490
15917,0.000726,172.217.194.0-255,1484,94513,65,214490
15918,0.000743,172.31.40.0-255,66,94579,65,214490
15919,0.000788,172.31.40.0-255,66,94645,65,214490
15920,0.000863,172.217.194.0-255,1484,96129,65,214490
15921,0.000868,172.217.194.0-255,1484,97613,65,214490
15922,0.000881,172.31.40.0-255,66,97679,65,214490
15923,0.000885,172.217.194.0-255,1484,99163,65,214490
15924,0.000891,172.217.194.0-255,5738,104901,65,214490
15925,0.00094,172.31.40.0-255,66,104967,65,214490
15926,0.000965,172.217.194.0-255,5738,110705,65,214490
15927,0.000986,172.217.194.0-255,5379,116084,65,214490
15928,0.000996,172.31.40.0-255,66,116150,65,214490
15929,0.001049,172.217.194.0-255,1484,117634,65,214490
15930,0.001063,172.217.194.0-255,2902,120536,65,214490
15931,0.001084,172.217.194.0-255,5738,126274,65,214490
15932,0.00109,172.31.40.0-255,66,126340,65,214490
15933,0.001121,172.217.194.0-255,6797,133137,65,214490
15934,0.001129,172.31.40.0-255,66,133203,65,214490
15935,0.001162,172.217.194.0-255,7156,140359,65,214490
15936,0.001175,172.31.40.0-255,66,140425,65,214490
15937,0.001184,172.217.194.0-255,4320,144745,65,214490
15938,0.00119,172.31.40.0-255,66,144811,65,214490
15939,0.001232,172.217.194.0-255,766,145577,65,214490
15940,0.001238,172.31.40.0-255,66,145643,65,214490
15941,0.001343,172.217.194.0-255,1484,147127,65,214490
15942,0.001353,172.217.194.0-255,2902,150029,65,214490
15943,0.001359,172.31.40.0-255,66,150095,65,214490
15944,0.001374,172.217.194.0-255,5738,155833,65,214490
15945,0.001413,172.217.194.0-255,4320,160153,65,214490
15946,0.00142,172.217.194.0-255,7156,167309,65,214490
15947,0.001438,172.217.194.0-255,3602,170911,65,214490
15948,0.001444,172.31.40.0-255,66,170977,65,214490
15949,0.001601,172.217.194.0-255,1484,172461,65,214490
15950,0.001605,172.217.194.0-255,1484,173945,65,214490
15951,0.001615,172.31.40.0-255,66,174011,65,214490
15952,0.001646,172.217.194.0-255,1484,175495,65,214490
15953,0.001653,172.217.194.0-255,5738,181233,65,214490
15954,0.001666,172.31.40.0-255,66,181299,65,214490
15955,0.00168,172.217.194.0-255,6797,188096,65,214490
15956,0.001685,172.31.40.0-255,66,188162,65,214490
15957,0.001726,172.217.194.0-255,7156,195318,65,214490
15958,0.001762,172.217.194.0-255,1484,196802,65,214490
15959,0.001776,172.217.194.0-255,2902,199704,65,214490
15960,0.001805,172.217.194.0-255,2902,202606,65,214490
15961,0.001908,172.217.194.0-255,2902,205508,65,214490
15962,0.001954,172.217.194.0-255,4320,209828,65,214490
15963,0.001973,172.217.194.0-255,4320,214148,65,214490
15964,0.002004,172.217.194.0-255,105,214253,65,214490
15965,0.009772,172.31.40.0-255,66,214319,65,214490
15966,0.01246,172.31.40.0-255,105,214424,65,214490
15967,0.015042,172.217.194.0-255,66,214490,65,214490
15968,0.0,74.125.24.0-255,296,296,65,187791
15969,2.3e-05,172.31.40.0-255,66,362,65,187791
15970,3e-05,74.125.24.0-255,1484,1846,65,187791
15971,3.4e-05,172.31.40.0-255,66,1912,65,187791
15972,4e-05,74.125.24.0-255,4320,6232,65,187791
15973,4.3e-05,172.31.40.0-255,66,6298,65,187791
15974,4.6e-05,74.125.24.0-255,1484,7782,65,187791
15975,4.9e-05,172.31.40.0-255,66,7848,65,187791
15976,7e-05,74.125.24.0-255,6095,13943,65,187791
15977,7.3e-05,172.31.40.0-255,66,14009,65,187791
15978,8.2e-05,74.125.24.0-255,7156,21165,65,187791
15979,8.4e-05,172.31.40.0-255,66,21231,65,187791
15980,9.7e-05,74.125.24.0-255,1484,22715,65,187791
15981,0.0001,172.31.40.0-255,66,22781,65,187791
15982,0.000111,172.31.40.0-255,66,22847,65,187791
15983,0.000204,74.125.24.0-255,1484,24331,65,187791
15984,0.000207,172.31.40.0-255,66,24397,65,187791
15985,0.000212,74.125.24.0-255,2902,27299,65,187791
15986,0.000214,172.31.40.0-255,66,27365,65,187791
15987,0.000219,74.125.24.0-255,2902,30267,65,187791
15988,0.000221,172.31.40.0-255,66,30333,65,187791
15989,0.000246,74.125.24.0-255,2902,33235,65,187791
15990,0.000249,172.31.40.0-255,66,33301,65,187791
15991,0.000257,74.125.24.0-255,7156,40457,65,187791
15992,0.000259,172.31.40.0-255,66,40523,65,187791
15993,0.000286,74.125.24.0-255,6797,47320,65,187791
15994,0.000289,172.31.40.0-255,66,47386,65,187791
15995,0.000295,74.125.24.0-255,5738,53124,65,187791
15996,0.000296,172.31.40.0-255,66,53190,65,187791
15997,0.000317,74.125.24.0-255,4316,57506,65,187791
15998,0.000319,172.31.40.0-255,66,57572,65,187791
15999,0.000353,74.125.24.0-255,331,57903,65,187791
16000,0.000587,74.125.24.0-255,1484,59387,65,187791
16001,0.000593,172.31.40.0-255,66,59453,65,187791
16002,0.000599,74.125.24.0-255,2902,62355,65,187791
16003,0.000601,172.31.40.0-255,66,62421,65,187791
16004,0.000625,74.125.24.0-255,5738,68159,65,187791
16005,0.000628,172.31.40.0-255,66,68225,65,187791
16006,0.000634,74.125.24.0-255,4320,72545,65,187791
16007,0.000635,172.31.40.0-255,66,72611,65,187791
16008,0.000654,74.125.24.0-255,4320,76931,65,187791
16009,0.000656,172.31.40.0-255,66,76997,65,187791
16010,0.000686,74.125.24.0-255,7156,84153,65,187791
16011,0.000688,172.31.40.0-255,66,84219,65,187791
16012,0.0007,172.31.40.0-255,66,84285,65,187791
16013,0.000839,74.125.24.0-255,1484,85769,65,187791
16014,0.000861,74.125.24.0-255,2902,88671,65,187791
16015,0.000868,74.125.24.0-255,5738,94409,65,187791
16016,0.000873,172.31.40.0-255,66,94475,65,187791
16017,0.000881,172.31.40.0-255,66,94541,65,187791
16018,0.000886,74.125.24.0-255,2902,97443,65,187791
16019,0.000889,172.31.40.0-255,66,97509,65,187791
16020,0.000921,172.31.40.0-255,66,97575,65,187791
16021,0.000924,74.125.24.0-255,1484,99059,65,187791
16022,0.000942,74.125.24.0-255,4320,103379,65,187791
16023,0.000947,172.31.40.0-255,66,103445,65,187791
16024,0.00096,74.125.24.0-255,5020,108465,65,187791
16025,0.000963,172.31.40.0-255,66,108531,65,187791
16026,0.001094,74.125.24.0-255,1484,110015,65,187791
16027,0.0011,74.125.24.0-255,2902,112917,65,187791
16028,0.001103,172.31.40.0-255,66,112983,65,187791
16029,0.00116,74.125.24.0-255,5738,118721,65,187791
16030,0.001162,172.31.40.0-255,66,118787,65,187791
16031,0.001176,172.31.40.0-255,66,118853,65,187791
16032,0.001187,172.31.40.0-255,66,118919,65,187791
16033,0.001191,74.125.24.0-255,2184,121103,65,187791
16034,0.001193,172.31.40.0-255,66,121169,65,187791
16035,0.002146,74.125.24.0-255,1484,122653,65,187791
16036,0.002173,74.125.24.0-255,2902,125555,65,187791
16037,0.002177,172.31.40.0-255,66,125621,65,187791
16038,0.002185,74.125.24.0-255,5738,131359,65,187791
16039,0.002187,172.31.40.0-255,66,131425,65,187791
16040,0.00222,172.31.40.0-255,66,131491,65,187791
16041,0.002225,74.125.24.0-255,2902,134393,65,187791
16042,0.002227,172.31.40.0-255,66,134459,65,187791
16043,0.002249,74.125.24.0-255,7156,141615,65,187791
16044,0.002251,172.31.40.0-255,66,141681,65,187791
16045,0.002256,74.125.24.0-255,2902,144583,65,187791
16046,0.002258,172.31.40.0-255,66,144649,65,187791
16047,0.002279,74.125.24.0-255,2184,146833,65,187791
16048,0.002281,172.31.40.0-255,66,146899,65,187791
16049,0.00448,74.125.24.0-255,2902,149801,65,187791
16050,0.004487,172.31.40.0-255,66,149867,65,187791
16051,0.004518,74.125.24.0-255,2902,152769,65,187791
16052,0.004521,172.31.40.0-255,66,152835,65,187791
16053,0.006725,74.125.24.0-255,2902,155737,65,187791
16054,0.006728,172.31.40.0-255,66,155803,65,187791
16055,0.006747,74.125.24.0-255,2902,158705,65,187791
16056,0.006749,172.31.40.0-255,66,158771,65,187791
16057,0.009021,74.125.24.0-255,5738,164509,65,187791
16058,0.009028,172.31.40.0-255,66,164575,65,187791
16059,0.011287,74.125.24.0-255,5738,170313,65,187791
16060,0.011294,172.31.40.0-255,66,170379,65,187791
16061,0.013606,74.125.24.0-255,5738,176117,65,187791
16062,0.013611,172.31.40.0-255,66,176183,65,187791
16063,0.015864,74.125.24.0-255,5738,181921,65,187791
16064,0.015874,172.31.40.0-255,66,181987,65,187791
16065,0.018113,74.125.24.0-255,5738,187725,65,187791
16066,0.018121,172.31.40.0-255,66,187791,65,187791
16067,0.0,74.125.200.0-255,148,148,65,198745
16068,2.2e-05,172.31.40.0-255,66,214,65,198745
16069,3e-05,74.125.200.0-255,1484,1698,65,198745
16070,3.4e-05,172.31.40.0-255,66,1764,65,198745
16071,4.6e-05,74.125.200.0-255,2902,4666,65,198745
16072,5e-05,172.31.40.0-255,66,4732,65,198745
16073,9.1e-05,74.125.200.0-255,7156,11888,65,198745
16074,9.5e-05,172.31.40.0-255,66,11954,65,198745
16075,0.000132,74.125.200.0-255,1484,13438,65,198745
16076,0.000135,172.31.40.0-255,66,13504,65,198745
16077,0.000168,74.125.200.0-255,6362,19866,65,198745
16078,0.00017,172.31.40.0-255,66,19932,65,198745
16079,0.000177,74.125.200.0-255,5738,25670,65,198745
16080,0.000179,172.31.40.0-255,66,25736,65,198745
16081,0.00019,74.125.200.0-255,5379,31115,65,198745
16082,0.000192,172.31.40.0-255,66,31181,65,198745
16083,0.000243,74.125.200.0-255,1484,32665,65,198745
16084,0.000246,172.31.40.0-255,66,32731,65,198745
16085,0.000249,74.125.200.0-255,1484,34215,65,198745
16086,0.000251,172.31.40.0-255,66,34281,65,198745
16087,0.000267,74.125.200.0-255,1484,35765,65,198745
16088,0.00027,172.31.40.0-255,66,35831,65,198745
16089,0.000277,74.125.200.0-255,1484,37315,65,198745
16090,0.000279,172.31.40.0-255,66,37381,65,198745
16091,0.000282,74.125.200.0-255,1484,38865,65,198745
16092,0.000284,172.31.40.0-255,66,38931,65,198745
16093,0.000313,74.125.200.0-255,1484,40415,65,198745
16094,0.000315,172.31.40.0-255,66,40481,65,198745
16095,0.000322,74.125.200.0-255,5738,46219,65,198745
16096,0.000324,172.31.40.0-255,66,46285,65,198745
16097,0.000356,74.125.200.0-255,7156,53441,65,198745
16098,0.000359,172.31.40.0-255,66,53507,65,198745
16099,0.000377,74.125.200.0-255,2902,56409,65,198745
16100,0.00038,172.31.40.0-255,66,56475,65,198745
16101,0.00039,74.125.200.0-255,1484,57959,65,198745
16102,0.000413,74.125.200.0-255,2902,60861,65,198745
16103,0.000416,172.31.40.0-255,66,60927,65,198745
16104,0.000444,74.125.200.0-255,5020,65947,65,198745
16105,0.000446,172.31.40.0-255,66,66013,65,198745
16106,0.000449,74.125.200.0-255,366,66379,65,198745
16107,0.000489,74.125.200.0-255,130,66509,65,198745
16108,0.000531,74.125.200.0-255,1484,67993,65,198745
16109,0.000535,172.31.40.0-255,66,68059,65,198745
16110,0.000553,74.125.200.0-255,2902,70961,65,198745
16111,0.000556,172.31.40.0-255,66,71027,65,198745
16112,0.000592,74.125.200.0-255,7156,78183,65,198745
16113,0.000595,172.31.40.0-255,66,78249,65,198745
16114,0.000606,172.31.40.0-255,66,78315,65,198745
16115,0.000631,74.125.200.0-255,5738,84053,65,198745
16116,0.000634,172.31.40.0-255,66,84119,65,198745
16117,0.000681,172.31.40.0-255,66,84185,65,198745
16118,0.000684,74.125.200.0-255,344,84529,65,198745
16119,0.000814,74.125.200.0-255,1484,86013,65,198745
16120,0.000818,172.31.40.0-255,66,86079,65,198745
16121,0.00083,74.125.200.0-255,2902,88981,65,198745
16122,0.000837,172.31.40.0-255,66,89047,65,198745
16123,0.00089,74.125.200.0-255,5738,94785,65,198745
16124,0.000894,172.31.40.0-255,66,94851,65,198745
16125,0.000932,74.125.200.0-255,2902,97753,65,198745
16126,0.000936,172.31.40.0-255,66,97819,65,198745
16127,0.000976,74.125.200.0-255,4320,102139,65,198745
16128,0.00098,172.31.40.0-255,66,102205,65,198745
16129,0.001034,74.125.200.0-255,4320,106525,65,198745
16130,0.001038,172.31.40.0-255,66,106591,65,198745
16131,0.001066,74.125.200.0-255,5738,112329,65,198745
16132,0.001069,172.31.40.0-255,66,112395,65,198745
16133,0.001093,74.125.200.0-255,2902,115297,65,198745
16134,0.001096,172.31.40.0-255,66,115363,65,198745
16135,0.001124,74.125.200.0-255,3602,118965,65,198745
16136,0.001127,172.31.40.0-255,66,119031,65,198745
16137,0.001394,74.125.200.0-255,1484,120515,65,198745
16138,0.001399,74.125.200.0-255,1484,121999,65,198745
16139,0.001403,172.31.40.0-255,66,122065,65,198745
16140,0.001419,74.125.200.0-255,1484,123549,65,198745
16141,0.001427,74.125.200.0-255,5738,129287,65,198745
16142,0.001429,172.31.40.0-255,66,129353,65,198745
16143,0.001458,74.125.200.0-255,4320,133673,65,198745
16144,0.001461,172.31.40.0-255,66,133739,65,198745
16145,0.001467,74.125.200.0-255,5738,139477,65,198745
16146,0.001469,172.31.40.0-255,66,139543,65,198745
16147,0.001519,172.31.40.0-255,66,139609,65,198745
16148,0.001556,74.125.200.0-255,5020,144629,65,198745
16149,0.001559,172.31.40.0-255,66,144695,65,198745
16150,0.002272,74.125.200.0-255,1484,146179,65,198745
16151,0.002295,74.125.200.0-255,2902,149081,65,198745
16152,0.002299,172.31.40.0-255,66,149147,65,198745
16153,0.002303,74.125.200.0-255,1484,150631,65,198745
16154,0.002327,74.125.200.0-255,2902,153533,65,198745
16155,0.00233,172.31.40.0-255,66,153599,65,198745
16156,0.002333,74.125.200.0-255,1484,155083,65,198745
16157,0.00236,74.125.200.0-255,2902,157985,65,198745
16158,0.002363,172.31.40.0-255,66,158051,65,198745
16159,0.004633,74.125.200.0-255,1484,159535,65,198745
16160,0.004662,74.125.200.0-255,4320,163855,65,198745
16161,0.004667,172.31.40.0-255,66,163921,65,198745
16162,0.007012,74.125.200.0-255,5738,169659,65,198745
16163,0.007021,172.31.40.0-255,66,169725,65,198745
16164,0.00932,74.125.200.0-255,5738,175463,65,198745
16165,0.009325,172.31.40.0-255,66,175529,65,198745
16166,0.011632,74.125.200.0-255,5738,181267,65,198745
16167,0.011641,172.31.40.0-255,66,181333,65,198745
16168,0.013949,74.125.200.0-255,5738,187071,65,198745
16169,0.013959,172.31.40.0-255,66,187137,65,198745
16170,0.016282,74.125.200.0-255,5738,192875,65,198745
16171,0.016295,172.31.40.0-255,66,192941,65,198745
16172,0.018606,74.125.200.0-255,5738,198679,65,198745
16173,0.018618,172.31.40.0-255,66,198745,65,198745
16174,0.0,172.217.194.0-255,475,475,65,203751
16175,2.1e-05,172.31.40.0-255,66,541,65,203751
16176,2.8e-05,172.217.194.0-255,1484,2025,65,203751
16177,3.2e-05,172.31.40.0-255,66,2091,65,203751
16178,3.8e-05,172.217.194.0-255,4320,6411,65,203751
16179,4e-05,172.31.40.0-255,66,6477,65,203751
16180,5.1e-05,172.31.40.0-255,66,6543,65,203751
16181,5.7e-05,172.217.194.0-255,5738,12281,65,203751
16182,6e-05,172.31.40.0-255,66,12347,65,203751
16183,8.1e-05,172.217.194.0-255,4320,16667,65,203751
16184,8.3e-05,172.31.40.0-255,66,16733,65,203751
16185,8.9e-05,172.217.194.0-255,5379,22112,65,203751
16186,9.1e-05,172.31.40.0-255,66,22178,65,203751
16187,0.000155,172.217.194.0-255,1484,23662,65,203751
16188,0.000157,172.31.40.0-255,66,23728,65,203751
16189,0.000162,172.217.194.0-255,2902,26630,65,203751
16190,0.000164,172.31.40.0-255,66,26696,65,203751
16191,0.000169,172.217.194.0-255,5738,32434,65,203751
16192,0.000171,172.31.40.0-255,66,32500,65,203751
16193,0.000194,172.217.194.0-255,2902,35402,65,203751
16194,0.000196,172.31.40.0-255,66,35468,65,203751
16195,0.000218,172.217.194.0-255,3961,39429,65,203751
16196,0.00022,172.31.40.0-255,66,39495,65,203751
16197,0.000226,172.217.194.0-255,7156,46651,65,203751
16198,0.000228,172.31.40.0-255,66,46717,65,203751
16199,0.000243,172.217.194.0-255,5738,52455,65,203751
16200,0.000245,172.31.40.0-255,66,52521,65,203751
16201,0.000269,172.217.194.0-255,4215,56736,65,203751
16202,0.000272,172.31.40.0-255,66,56802,65,203751
16203,0.000288,172.217.194.0-255,120,56922,65,203751
16204,0.000291,172.31.40.0-255,66,56988,65,203751
16205,0.000306,172.217.194.0-255,379,57367,65,203751
16206,0.00049,172.217.194.0-255,1484,58851,65,203751
16207,0.000495,172.31.40.0-255,66,58917,65,203751
16208,0.0005,172.217.194.0-255,2902,61819,65,203751
16209,0.000502,172.31.40.0-255,66,61885,65,203751
16210,0.000524,172.217.194.0-255,5738,67623,65,203751
16211,0.000527,172.31.40.0-255,66,67689,65,203751
16212,0.000532,172.217.194.0-255,5738,73427,65,203751
16213,0.000534,172.31.40.0-255,66,73493,65,203751
16214,0.00056,172.217.194.0-255,7156,80649,65,203751
16215,0.000572,172.31.40.0-255,66,80715,65,203751
16216,0.000575,172.31.40.0-255,66,80781,65,203751
16217,0.000584,172.217.194.0-255,766,81547,65,203751
16218,0.000872,172.217.194.0-255,1484,83031,65,203751
16219,0.000876,172.31.40.0-255,66,83097,65,203751
16220,0.000881,172.217.194.0-255,2902,85999,65,203751
16221,0.000883,172.31.40.0-255,66,86065,65,203751
16222,0.000893,172.217.194.0-255,1484,87549,65,203751
16223,0.000912,172.217.194.0-255,4320,91869,65,203751
16224,0.000915,172.31.40.0-255,66,91935,65,203751
16225,0.000922,172.217.194.0-255,7156,99091,65,203751
16226,0.000924,172.31.40.0-255,66,99157,65,203751
16227,0.000926,172.217.194.0-255,1484,100641,65,203751
16228,0.000965,172.31.40.0-255,66,100707,65,203751
16229,0.000969,172.217.194.0-255,2184,102891,65,203751
16230,0.000971,172.31.40.0-255,66,102957,65,203751
16231,0.001674,172.217.194.0-255,1484,104441,65,203751
16232,0.001684,172.217.194.0-255,2902,107343,65,203751
16233,0.001688,172.31.40.0-255,66,107409,65,203751
16234,0.001696,172.217.194.0-255,5738,113147,65,203751
16235,0.001699,172.31.40.0-255,66,113213,65,203751
16236,0.001741,172.31.40.0-255,66,113279,65,203751
16237,0.001746,172.217.194.0-255,2902,116181,65,203751
16238,0.001748,172.31.40.0-255,66,116247,65,203751
16239,0.001773,172.31.40.0-255,66,116313,65,203751
16240,0.001852,172.31.40.0-255,66,116379,65,203751
16241,0.001868,172.31.40.0-255,66,116445,65,203751
16242,0.001875,172.217.194.0-255,6438,122883,65,203751
16243,0.001877,172.31.40.0-255,66,122949,65,203751
16244,0.00188,172.217.194.0-255,1484,124433,65,203751
16245,0.001885,172.217.194.0-255,2902,127335,65,203751
16246,0.001888,172.31.40.0-255,66,127401,65,203751
16247,0.001894,172.217.194.0-255,5738,133139,65,203751
16248,0.001896,172.31.40.0-255,66,133205,65,203751
16249,0.001916,172.217.194.0-255,2902,136107,65,203751
16250,0.001919,172.31.40.0-255,66,136173,65,203751
16251,0.001946,172.217.194.0-255,1484,137657,65,203751
16252,0.001953,172.217.194.0-255,5738,143395,65,203751
16253,0.001955,172.31.40.0-255,66,143461,65,203751
16254,0.001963,172.217.194.0-255,7156,150617,65,203751
16255,0.001966,172.31.40.0-255,66,150683,65,203751
16256,0.001985,172.217.194.0-255,4320,155003,65,203751
16257,0.001987,172.31.40.0-255,66,155069,65,203751
16258,0.001992,172.217.194.0-255,2184,157253,65,203751
16259,0.001993,172.31.40.0-255,66,157319,65,203751
16260,0.004067,172.217.194.0-255,5738,163057,65,203751
16261,0.004075,172.31.40.0-255,66,163123,65,203751
16262,0.006108,172.217.194.0-255,5738,168861,65,203751
16263,0.006116,172.31.40.0-255,66,168927,65,203751
16264,0.008165,172.217.194.0-255,5738,174665,65,203751
16265,0.008172,172.31.40.0-255,66,174731,65,203751
16266,0.010188,172.217.194.0-255,5738,180469,65,203751
16267,0.010193,172.31.40.0-255,66,180535,65,203751
16268,0.012248,172.217.194.0-255,5738,186273,65,203751
16269,0.012256,172.31.40.0-255,66,186339,65,203751
16270,0.014321,172.217.194.0-255,5738,192077,65,203751
16271,0.01433,172.31.40.0-255,66,192143,65,203751
16272,0.016344,172.217.194.0-255,5738,197881,65,203751
16273,0.016352,172.31.40.0-255,66,197947,65,203751
16274,0.01841,172.217.194.0-255,5738,203685,65,203751
16275,0.018418,172.31.40.0-255,66,203751,65,203751
16276,0.0,74.125.68.0-255,158,158,65,168985
16277,2.4e-05,172.31.40.0-255,66,224,65,168985
16278,3.2e-05,74.125.68.0-255,1484,1708,65,168985
16279,3.7e-05,172.31.40.0-255,66,1774,65,168985
16280,4.4e-05,74.125.68.0-255,2902,4676,65,168985
16281,4.8e-05,172.31.40.0-255,66,4742,65,168985
16282,5.6e-05,74.125.68.0-255,7156,11898,65,168985
16283,5.9e-05,172.31.40.0-255,66,11964,65,168985
16284,6.2e-05,74.125.68.0-255,1484,13448,65,168985
16285,6.6e-05,172.31.40.0-255,66,13514,65,168985
16286,8.7e-05,74.125.68.0-255,728,14242,65,168985
16287,8.9e-05,172.31.40.0-255,66,14308,65,168985
16288,0.000184,74.125.68.0-255,1484,15792,65,168985
16289,0.000187,172.31.40.0-255,66,15858,65,168985
16290,0.000193,74.125.68.0-255,2902,18760,65,168985
16291,0.000195,172.31.40.0-255,66,18826,65,168985
16292,0.000221,74.125.68.0-255,4320,23146,65,168985
16293,0.000224,172.31.40.0-255,66,23212,65,168985
16294,0.000255,74.125.68.0-255,2902,26114,65,168985
16295,0.000258,172.31.40.0-255,66,26180,65,168985
16296,0.000285,74.125.68.0-255,5379,31559,65,168985
16297,0.000288,172.31.40.0-255,66,31625,65,168985
16298,0.000294,74.125.68.0-255,5738,37363,65,168985
16299,0.000296,172.31.40.0-255,66,37429,65,168985
16300,0.000315,74.125.68.0-255,2902,40331,65,168985
16301,0.000318,172.31.40.0-255,66,40397,65,168985
16302,0.000363,74.125.68.0-255,7156,47553,65,168985
16303,0.000367,172.31.40.0-255,66,47619,65,168985
16304,0.000385,74.125.68.0-255,1125,48744,65,168985
16305,0.000387,172.31.40.0-255,66,48810,65,168985
16306,0.000845,74.125.68.0-255,1484,50294,65,168985
16307,0.00085,74.125.68.0-255,1484,51778,65,168985
16308,0.000855,172.31.40.0-255,66,51844,65,168985
16309,0.000871,74.125.68.0-255,2902,54746,65,168985
16310,0.000874,172.31.40.0-255,66,54812,65,168985
16311,0.000881,74.125.68.0-255,5738,60550,65,168985
16312,0.000883,172.31.40.0-255,66,60616,65,168985
16313,0.00091,74.125.68.0-255,5379,65995,65,168985
16314,0.000913,172.31.40.0-255,66,66061,65,168985
16315,0.000974,74.125.68.0-255,646,66707,65,168985
16316,0.001083,172.31.40.0-255,66,66773,65,168985
16317,0.001294,74.125.68.0-255,1484,68257,65,168985
16318,0.001304,74.125.68.0-255,2902,71159,65,168985
16319,0.001308,172.31.40.0-255,66,71225,65,168985
16320,0.001335,74.125.68.0-255,4320,75545,65,168985
16321,0.001338,172.31.40.0-255,66,75611,65,168985
16322,0.001341,74.125.68.0-255,1484,77095,65,168985
16323,0.001368,74.125.68.0-255,7156,84251,65,168985
16324,0.00137,172.31.40.0-255,66,84317,65,168985
16325,0.001386,74.125.68.0-255,5738,90055,65,168985
16326,0.001389,172.31.40.0-255,66,90121,65,168985
16327,0.001426,74.125.68.0-255,7156,97277,65,168985
16328,0.001429,172.31.40.0-255,66,97343,65,168985
16329,0.001434,74.125.68.0-255,3602,100945,65,168985
16330,0.001437,172.31.40.0-255,66,101011,65,168985
16331,0.002188,74.125.68.0-255,1484,102495,65,168985
16332,0.00221,74.125.68.0-255,2902,105397,65,168985
16333,0.002215,172.31.40.0-255,66,105463,65,168985
16334,0.002229,74.125.68.0-255,1484,106947,65,168985
16335,0.002243,74.125.68.0-255,2902,109849,65,168985
16336,0.002246,172.31.40.0-255,66,109915,65,168985
16337,0.00227,74.125.68.0-255,2902,112817,65,168985
16338,0.002272,172.31.40.0-255,66,112883,65,168985
16339,0.002316,74.125.68.0-255,4320,117203,65,168985
16340,0.00232,172.31.40.0-255,66,117269,65,168985
16341,0.002326,74.125.68.0-255,4320,121589,65,168985
16342,0.002328,172.31.40.0-255,66,121655,65,168985
16343,0.002373,74.125.68.0-255,2902,124557,65,168985
16344,0.002376,172.31.40.0-255,66,124623,65,168985
16345,0.002393,74.125.68.0-255,2902,127525,65,168985
16346,0.002396,172.31.40.0-255,66,127591,65,168985
16347,0.002403,74.125.68.0-255,7156,134747,65,168985
16348,0.002406,172.31.40.0-255,66,134813,65,168985
16349,0.002409,74.125.68.0-255,766,135579,65,168985
16350,0.004884,74.125.68.0-255,4320,139899,65,168985
16351,0.004889,172.31.40.0-255,66,139965,65,168985
16352,0.007384,74.125.68.0-255,5738,145703,65,168985
16353,0.007396,172.31.40.0-255,66,145769,65,168985
16354,0.009909,74.125.68.0-255,5738,151507,65,168985
16355,0.009927,172.31.40.0-255,66,151573,65,168985
16356,0.012457,74.125.68.0-255,5738,157311,65,168985
16357,0.012476,172.31.40.0-255,66,157377,65,168985
16358,0.015006,74.125.68.0-255,5738,163115,65,168985
16359,0.015021,172.31.40.0-255,66,163181,65,168985
16360,0.017573,74.125.68.0-255,5738,168919,65,168985
16361,0.017594,172.31.40.0-255,66,168985,65,168985
16362,0.0,216.58.221.0-255,146,146,65,106644
16363,2.2e-05,172.31.40.0-255,66,212,65,106644
16364,2.9e-05,216.58.221.0-255,1484,1696,65,106644
16365,3.4e-05,172.31.40.0-255,66,1762,65,106644
16366,3.9e-05,216.58.221.0-255,2902,4664,65,106644
16367,4.2e-05,172.31.40.0-255,66,4730,65,106644
16368,6.5e-05,216.58.221.0-255,7156,11886,65,106644
16369,6.9e-05,172.31.40.0-255,66,11952,65,106644
16370,0.000165,216.58.221.0-255,1981,13933,65,106644
16371,0.000168,172.31.40.0-255,66,13999,65,106644
16372,0.000188,216.58.221.0-255,5738,19737,65,106644
16373,0.00019,172.31.40.0-255,66,19803,65,106644
16374,0.000282,216.58.221.0-255,5738,25541,65,106644
16375,0.000286,172.31.40.0-255,66,25607,65,106644
16376,0.000305,216.58.221.0-255,4320,29927,65,106644
16377,0.000307,172.31.40.0-255,66,29993,65,106644
16378,0.000419,216.58.221.0-255,1125,31118,65,106644
16379,0.000423,172.31.40.0-255,66,31184,65,106644
16380,0.000468,216.58.221.0-255,1484,32668,65,106644
16381,0.000471,172.31.40.0-255,66,32734,65,106644
16382,0.000475,216.58.221.0-255,1484,34218,65,106644
16383,0.000477,172.31.40.0-255,66,34284,65,106644
16384,0.000488,216.58.221.0-255,1484,35768,65,106644
16385,0.00049,172.31.40.0-255,66,35834,65,106644
16386,0.000519,216.58.221.0-255,5738,41572,65,106644
16387,0.000522,172.31.40.0-255,66,41638,65,106644
16388,0.000606,216.58.221.0-255,4320,45958,65,106644
16389,0.000609,172.31.40.0-255,66,46024,65,106644
16390,0.000621,216.58.221.0-255,1484,47508,65,106644
16391,0.000623,172.31.40.0-255,66,47574,65,106644
16392,0.000682,216.58.221.0-255,1125,48699,65,106644
16393,0.000686,172.31.40.0-255,66,48765,65,106644
16394,0.001156,216.58.221.0-255,1484,50249,65,106644
16395,0.001178,216.58.221.0-255,1484,51733,65,106644
16396,0.001182,172.31.40.0-255,66,51799,65,106644
16397,0.001189,216.58.221.0-255,2902,54701,65,106644
16398,0.001192,172.31.40.0-255,66,54767,65,106644
16399,0.001242,216.58.221.0-255,5738,60505,65,106644
16400,0.001245,172.31.40.0-255,66,60571,65,106644
16401,0.001309,216.58.221.0-255,5379,65950,65,106644
16402,0.004685,172.31.40.0-255,66,66016,65,106644
16403,0.006588,216.58.221.0-255,5738,71754,65,106644
16404,0.006594,172.31.40.0-255,66,71820,65,106644
16405,0.008495,216.58.221.0-255,5738,77558,65,106644
16406,0.008503,172.31.40.0-255,66,77624,65,106644
16407,0.010422,216.58.221.0-255,5738,83362,65,106644
16408,0.010432,172.31.40.0-255,66,83428,65,106644
16409,0.01233,216.58.221.0-255,5738,89166,65,106644
16410,0.012395,172.31.40.0-255,66,89232,65,106644
16411,0.014295,216.58.221.0-255,5738,94970,65,106644
16412,0.014304,172.31.40.0-255,66,95036,65,106644
16413,0.016212,216.58.221.0-255,5738,100774,65,106644
16414,0.016233,172.31.40.0-255,66,100840,65,106644
16415,0.018139,216.58.221.0-255,5738,106578,65,106644
16416,0.018148,172.31.40.0-255,66,106644,65,106644
16417,0.0,172.217.194.0-255,154,154,65,94278
16418,1.6e-05,172.31.40.0-255,66,220,65,94278
16419,2.3e-05,172.217.194.0-255,1484,1704,65,94278
16420,2.7e-05,172.31.40.0-255,66,1770,65,94278
16421,3.3e-05,172.217.194.0-255,2902,4672,65,94278
16422,3.7e-05,172.31.40.0-255,66,4738,65,94278
16423,7e-05,172.217.194.0-255,7156,11894,65,94278
16424,7.3e-05,172.31.40.0-255,66,11960,65,94278
16425,0.000161,172.217.194.0-255,2039,13999,65,94278
16426,0.000165,172.31.40.0-255,66,14065,65,94278
16427,0.000184,172.217.194.0-255,1484,15549,65,94278
16428,0.000186,172.31.40.0-255,66,15615,65,94278
16429,0.000213,172.31.40.0-255,66,15681,65,94278
16430,0.000338,172.31.40.0-255,66,15747,65,94278
16431,0.000459,172.31.40.0-255,66,15813,65,94278
16432,0.000576,172.31.40.0-255,66,15879,65,94278
16433,0.000606,172.31.40.0-255,66,15945,65,94278
16434,0.00083,172.217.194.0-255,5681,21626,65,94278
16435,0.000833,172.31.40.0-255,66,21692,65,94278
16436,0.000882,172.217.194.0-255,376,22068,65,94278
16437,0.000885,172.31.40.0-255,66,22134,65,94278
16438,0.001033,172.217.194.0-255,1484,23618,65,94278
16439,0.001037,172.31.40.0-255,66,23684,65,94278
16440,0.001044,172.217.194.0-255,2902,26586,65,94278
16441,0.001046,172.31.40.0-255,66,26652,65,94278
16442,0.001082,172.217.194.0-255,4320,30972,65,94278
16443,0.001084,172.31.40.0-255,66,31038,65,94278
16444,0.0011,172.217.194.0-255,1484,32522,65,94278
16445,0.001182,172.217.194.0-255,4320,36842,65,94278
16446,0.001353,172.217.194.0-255,7156,43998,65,94278
16447,0.001446,172.217.194.0-255,3602,47600,65,94278
16448,0.001506,172.217.194.0-255,4320,51920,65,94278
16449,0.001563,172.217.194.0-255,7156,59076,65,94278
16450,0.001581,172.217.194.0-255,2902,61978,65,94278
16451,0.001983,172.217.194.0-255,5738,67716,65,94278
16452,0.002276,172.31.40.0-255,66,67782,65,94278
16453,0.002308,172.31.40.0-255,66,67848,65,94278
16454,0.00233,172.217.194.0-255,6438,74286,65,94278
16455,0.002363,172.31.40.0-255,66,74352,65,94278
16456,0.002853,172.217.194.0-255,6438,80790,65,94278
16457,0.002872,172.31.40.0-255,66,80856,65,94278
16458,0.002944,172.31.40.0-255,66,80922,65,94278
16459,0.002988,172.31.40.0-255,66,80988,65,94278
16460,0.003079,172.31.40.0-255,66,81054,65,94278
16461,0.003896,172.31.40.0-255,66,81120,65,94278
16462,0.003942,172.31.40.0-255,66,81186,65,94278
16463,0.003981,172.31.40.0-255,66,81252,65,94278
16464,0.006293,172.217.194.0-255,5738,86990,65,94278
16465,0.006307,172.31.40.0-255,66,87056,65,94278
16466,0.008634,172.217.194.0-255,5738,92794,65,94278
16467,0.015013,172.217.194.0-255,1484,94278,65,94278
16468,0.0,74.125.24.0-255,153,153,65,187586
16469,2.2e-05,172.31.40.0-255,66,219,65,187586
16470,2.8e-05,74.125.24.0-255,1484,1703,65,187586
16471,3.2e-05,172.31.40.0-255,66,1769,65,187586
16472,3.8e-05,74.125.24.0-255,2902,4671,65,187586
16473,4e-05,172.31.40.0-255,66,4737,65,187586
16474,5.2e-05,74.125.24.0-255,4320,9057,65,187586
16475,5.5e-05,172.31.40.0-255,66,9123,65,187586
16476,5.8e-05,74.125.24.0-255,1484,10607,65,187586
16477,6e-05,172.31.40.0-255,66,10673,65,187586
16478,9.5e-05,74.125.24.0-255,3348,14021,65,187586
16479,0.000101,172.31.40.0-255,66,14087,65,187586
16480,0.000175,74.125.24.0-255,1484,15571,65,187586
16481,0.000178,172.31.40.0-255,66,15637,65,187586
16482,0.000182,74.125.24.0-255,2902,18539,65,187586
16483,0.000184,172.31.40.0-255,66,18605,65,187586
16484,0.000222,74.125.24.0-255,5738,24343,65,187586
16485,0.000224,172.31.40.0-255,66,24409,65,187586
16486,0.000227,74.125.24.0-255,1484,25893,65,187586
16487,0.000228,172.31.40.0-255,66,25959,65,187586
16488,0.000251,74.125.24.0-255,2902,28861,65,187586
16489,0.000253,172.31.40.0-255,66,28927,65,187586
16490,0.000275,74.125.24.0-255,3961,32888,65,187586
16491,0.000277,172.31.40.0-255,66,32954,65,187586
16492,0.000283,74.125.24.0-255,5738,38692,65,187586
16493,0.000285,172.31.40.0-255,66,38758,65,187586
16494,0.000303,74.125.24.0-255,2902,41660,65,187586
16495,0.000305,172.31.40.0-255,66,41726,65,187586
16496,0.000316,74.125.24.0-255,7156,48882,65,187586
16497,0.000318,172.31.40.0-255,66,48948,65,187586
16498,0.000354,172.31.40.0-255,66,49014,65,187586
16499,0.000361,74.125.24.0-255,6786,55800,65,187586
16500,0.000363,172.31.40.0-255,66,55866,65,187586
16501,0.000365,74.125.24.0-255,330,56196,65,187586
16502,0.000893,74.125.24.0-255,1484,57680,65,187586
16503,0.000899,172.31.40.0-255,66,57746,65,187586
16504,0.000923,74.125.24.0-255,2902,60648,65,187586
16505,0.000925,172.31.40.0-255,66,60714,65,187586
16506,0.000937,74.125.24.0-255,5738,66452,65,187586
16507,0.000939,172.31.40.0-255,66,66518,65,187586
16508,0.000951,172.31.40.0-255,66,66584,65,187586
16509,0.000975,74.125.24.0-255,1484,68068,65,187586
16510,0.001013,172.31.40.0-255,66,68134,65,187586
16511,0.001365,74.125.24.0-255,1484,69618,65,187586
16512,0.001385,74.125.24.0-255,2902,72520,65,187586
16513,0.001391,74.125.24.0-255,5738,78258,65,187586
16514,0.0014,172.31.40.0-255,66,78324,65,187586
16515,0.001404,172.31.40.0-255,66,78390,65,187586
16516,0.001411,74.125.24.0-255,5738,84128,65,187586
16517,0.001413,172.31.40.0-255,66,84194,65,187586
16518,0.00145,74.125.24.0-255,7156,91350,65,187586
16519,0.001453,172.31.40.0-255,66,91416,65,187586
16520,0.001465,172.31.40.0-255,66,91482,65,187586
16521,0.001639,74.125.24.0-255,1484,92966,65,187586
16522,0.001646,74.125.24.0-255,2902,95868,65,187586
16523,0.001649,172.31.40.0-255,66,95934,65,187586
16524,0.001656,74.125.24.0-255,5738,101672,65,187586
16525,0.001658,172.31.40.0-255,66,101738,65,187586
16526,0.001676,74.125.24.0-255,1484,103222,65,187586
16527,0.001716,74.125.24.0-255,7156,110378,65,187586
16528,0.001721,172.31.40.0-255,66,110444,65,187586
16529,0.001724,172.31.40.0-255,66,110510,65,187586
16530,0.001738,74.125.24.0-255,3602,114112,65,187586
16531,0.001745,172.31.40.0-255,66,114178,65,187586
16532,0.001806,74.125.24.0-255,1484,115662,65,187586
16533,0.001811,74.125.24.0-255,2902,118564,65,187586
16534,0.001814,172.31.40.0-255,66,118630,65,187586
16535,0.001821,74.125.24.0-255,5738,124368,65,187586
16536,0.001823,172.31.40.0-255,66,124434,65,187586
16537,0.001867,172.31.40.0-255,66,124500,65,187586
16538,0.001907,74.125.24.0-255,2902,127402,65,187586
16539,0.00191,172.31.40.0-255,66,127468,65,187586
16540,0.001935,172.31.40.0-255,66,127534,65,187586
16541,0.002049,74.125.24.0-255,1484,129018,65,187586
16542,0.002063,74.125.24.0-255,2902,131920,65,187586
16543,0.002067,172.31.40.0-255,66,131986,65,187586
16544,0.002073,74.125.24.0-255,4320,136306,65,187586
16545,0.002075,172.31.40.0-255,66,136372,65,187586
16546,0.00212,74.125.24.0-255,1484,137856,65,187586
16547,0.002124,74.125.24.0-255,2902,140758,65,187586
16548,0.002127,172.31.40.0-255,66,140824,65,187586
16549,0.002143,172.31.40.0-255,66,140890,65,187586
16550,0.002193,172.31.40.0-255,66,140956,65,187586
16551,0.004243,74.125.24.0-255,2902,143858,65,187586
16552,0.004249,172.31.40.0-255,66,143924,65,187586
16553,0.004276,74.125.24.0-255,2902,146826,65,187586
16554,0.004278,172.31.40.0-255,66,146892,65,187586
16555,0.006294,74.125.24.0-255,1484,148376,65,187586
16556,0.006309,74.125.24.0-255,4320,152696,65,187586
16557,0.006312,172.31.40.0-255,66,152762,65,187586
16558,0.00842,74.125.24.0-255,5738,158500,65,187586
16559,0.008426,172.31.40.0-255,66,158566,65,187586
16560,0.010539,74.125.24.0-255,5738,164304,65,187586
16561,0.010556,172.31.40.0-255,66,164370,65,187586
16562,0.012619,74.125.24.0-255,5738,170108,65,187586
16563,0.012634,172.31.40.0-255,66,170174,65,187586
16564,0.014709,74.125.24.0-255,5738,175912,65,187586
16565,0.014722,172.31.40.0-255,66,175978,65,187586
16566,0.016754,74.125.24.0-255,5738,181716,65,187586
16567,0.016762,172.31.40.0-255,66,181782,65,187586
16568,0.018804,74.125.24.0-255,5738,187520,65,187586
16569,0.018811,172.31.40.0-255,66,187586,65,187586
16570,0.0,172.217.194.0-255,302,302,65,170100
16571,2.3e-05,172.31.40.0-255,66,368,65,170100
16572,3e-05,172.217.194.0-255,1484,1852,65,170100
16573,3.4e-05,172.31.40.0-255,66,1918,65,170100
16574,4.1e-05,172.217.194.0-255,4320,6238,65,170100
16575,4.4e-05,172.31.40.0-255,66,6304,65,170100
16576,5.2e-05,172.217.194.0-255,7156,13460,65,170100
16577,5.5e-05,172.31.40.0-255,66,13526,65,170100
16578,9e-05,172.217.194.0-255,1786,15312,65,170100
16579,9.3e-05,172.31.40.0-255,66,15378,65,170100
16580,0.000106,172.31.40.0-255,66,15444,65,170100
16581,0.000113,172.217.194.0-255,7156,22600,65,170100
16582,0.000115,172.31.40.0-255,66,22666,65,170100
16583,0.000157,172.31.40.0-255,66,22732,65,170100
16584,0.000159,172.217.194.0-255,766,23498,65,170100
16585,0.000161,172.31.40.0-255,66,23564,65,170100
16586,0.000175,172.217.194.0-255,1484,25048,65,170100
16587,0.000177,172.31.40.0-255,66,25114,65,170100
16588,0.00021,172.31.40.0-255,66,25180,65,170100
16589,0.000229,172.217.194.0-255,1415,26595,65,170100
16590,0.000232,172.31.40.0-255,66,26661,65,170100
16591,0.000374,172.217.194.0-255,100,26761,65,170100
16592,0.000378,172.31.40.0-255,66,26827,65,170100
16593,0.000502,172.217.194.0-255,1484,28311,65,170100
16594,0.000507,172.31.40.0-255,66,28377,65,170100
16595,0.000513,172.217.194.0-255,2902,31279,65,170100
16596,0.000516,172.31.40.0-255,66,31345,65,170100
16597,0.00052,172.217.194.0-255,2902,34247,65,170100
16598,0.000522,172.31.40.0-255,66,34313,65,170100
16599,0.000548,172.217.194.0-255,2902,37215,65,170100
16600,0.00055,172.31.40.0-255,66,37281,65,170100
16601,0.000563,172.31.40.0-255,66,37347,65,170100
16602,0.000583,172.217.194.0-255,5379,42726,65,170100
16603,0.000586,172.31.40.0-255,66,42792,65,170100
16604,0.000597,172.31.40.0-255,66,42858,65,170100
16605,0.001503,172.217.194.0-255,1484,44342,65,170100
16606,0.001513,172.217.194.0-255,2902,47244,65,170100
16607,0.001517,172.31.40.0-255,66,47310,65,170100
16608,0.001525,172.217.194.0-255,5738,53048,65,170100
16609,0.001527,172.31.40.0-255,66,53114,65,170100
16610,0.00153,172.217.194.0-255,1484,54598,65,170100
16611,0.001561,172.31.40.0-255,66,54664,65,170100
16612,0.001601,172.217.194.0-255,7156,61820,65,170100
16613,0.001603,172.31.40.0-255,66,61886,65,170100
16614,0.001622,172.217.194.0-255,3602,65488,65,170100
16615,0.001624,172.31.40.0-255,66,65554,65,170100
16616,0.0017,172.217.194.0-255,1484,67038,65,170100
16617,0.001718,172.217.194.0-255,2902,69940,65,170100
16618,0.001721,172.31.40.0-255,66,70006,65,170100
16619,0.001727,172.217.194.0-255,5738,75744,65,170100
16620,0.001729,172.31.40.0-255,66,75810,65,170100
16621,0.001769,172.31.40.0-255,66,75876,65,170100
16622,0.001779,172.217.194.0-255,1484,77360,65,170100
16623,0.001811,172.31.40.0-255,66,77426,65,170100
16624,0.001821,172.31.40.0-255,66,77492,65,170100
16625,0.001847,172.217.194.0-255,7156,84648,65,170100
16626,0.00185,172.31.40.0-255,66,84714,65,170100
16627,0.00188,172.217.194.0-255,4320,89034,65,170100
16628,0.001882,172.31.40.0-255,66,89100,65,170100
16629,0.001901,172.31.40.0-255,66,89166,65,170100
16630,0.00193,172.217.194.0-255,1484,90650,65,170100
16631,0.001943,172.217.194.0-255,2902,93552,65,170100
16632,0.001945,172.31.40.0-255,66,93618,65,170100
16633,0.001948,172.217.194.0-255,1484,95102,65,170100
16634,0.001969,172.217.194.0-255,4320,99422,65,170100
16635,0.001975,172.217.194.0-255,7156,106578,65,170100
16636,0.001979,172.31.40.0-255,66,106644,65,170100
16637,0.001982,172.31.40.0-255,66,106710,65,170100
16638,0.00199,172.217.194.0-255,2902,109612,65,170100
16639,0.001992,172.31.40.0-255,66,109678,65,170100
16640,0.002011,172.217.194.0-255,5738,115416,65,170100
16641,0.002013,172.31.40.0-255,66,115482,65,170100
16642,0.002041,172.217.194.0-255,5738,121220,65,170100
16643,0.002044,172.31.40.0-255,66,121286,65,170100
16644,0.002048,172.217.194.0-255,2184,123470,65,170100
16645,0.00205,172.31.40.0-255,66,123536,65,170100
16646,0.004109,172.217.194.0-255,5738,129274,65,170100
16647,0.004117,172.31.40.0-255,66,129340,65,170100
16648,0.006164,172.217.194.0-255,5738,135078,65,170100
16649,0.006168,172.31.40.0-255,66,135144,65,170100
16650,0.00822,172.217.194.0-255,2902,138046,65,170100
16651,0.008224,172.31.40.0-255,66,138112,65,170100
16652,0.00824,172.217.194.0-255,2902,141014,65,170100
16653,0.008242,172.31.40.0-255,66,141080,65,170100
16654,0.010296,172.217.194.0-255,5738,146818,65,170100
16655,0.010303,172.31.40.0-255,66,146884,65,170100
16656,0.01237,172.217.194.0-255,5738,152622,65,170100
16657,0.012378,172.31.40.0-255,66,152688,65,170100
16658,0.014442,172.217.194.0-255,5738,158426,65,170100
16659,0.014449,172.31.40.0-255,66,158492,65,170100
16660,0.016526,172.217.194.0-255,5738,164230,65,170100
16661,0.016536,172.31.40.0-255,66,164296,65,170100
16662,0.018615,172.217.194.0-255,5738,170034,65,170100
16663,0.018625,172.31.40.0-255,66,170100,65,170100
16664,0.0,172.217.194.0-255,156,156,65,181511
16665,2.3e-05,172.31.40.0-255,66,222,65,181511
16666,3.1e-05,172.217.194.0-255,1484,1706,65,181511
16667,3.7e-05,172.31.40.0-255,66,1772,65,181511
16668,5.2e-05,172.217.194.0-255,2902,4674,65,181511
16669,5.6e-05,172.31.40.0-255,66,4740,65,181511
16670,6.2e-05,172.217.194.0-255,4320,9060,65,181511
16671,6.5e-05,172.31.40.0-255,66,9126,65,181511
16672,7e-05,172.217.194.0-255,2902,12028,65,181511
16673,7.3e-05,172.31.40.0-255,66,12094,65,181511
16674,0.000116,172.217.194.0-255,6282,18376,65,181511
16675,0.00012,172.31.40.0-255,66,18442,65,181511
16676,0.000131,172.31.40.0-255,66,18508,65,181511
16677,0.000135,172.217.194.0-255,2543,21051,65,181511
16678,0.000137,172.31.40.0-255,66,21117,65,181511
16679,0.000142,172.217.194.0-255,2902,24019,65,181511
16680,0.000144,172.31.40.0-255,66,24085,65,181511
16681,0.000149,172.217.194.0-255,4320,28405,65,181511
16682,0.000152,172.31.40.0-255,66,28471,65,181511
16683,0.000192,172.217.194.0-255,2902,31373,65,181511
16684,0.000195,172.31.40.0-255,66,31439,65,181511
16685,0.000201,172.217.194.0-255,6797,38236,65,181511
16686,0.000204,172.31.40.0-255,66,38302,65,181511
16687,0.000211,172.217.194.0-255,7156,45458,65,181511
16688,0.000214,172.31.40.0-255,66,45524,65,181511
16689,0.00025,172.31.40.0-255,66,45590,65,181511
16690,0.000252,172.217.194.0-255,399,45989,65,181511
16691,0.000255,172.31.40.0-255,66,46055,65,181511
16692,0.000464,172.217.194.0-255,1484,47539,65,181511
16693,0.000469,172.31.40.0-255,66,47605,65,181511
16694,0.000475,172.217.194.0-255,2902,50507,65,181511
16695,0.000478,172.31.40.0-255,66,50573,65,181511
16696,0.000487,172.217.194.0-255,2902,53475,65,181511
16697,0.000489,172.31.40.0-255,66,53541,65,181511
16698,0.000522,172.217.194.0-255,2902,56443,65,181511
16699,0.000526,172.31.40.0-255,66,56509,65,181511
16700,0.000539,172.31.40.0-255,66,56575,65,181511
16701,0.000553,172.31.40.0-255,66,56641,65,181511
16702,0.001044,172.217.194.0-255,1484,58125,65,181511
16703,0.001052,172.217.194.0-255,2902,61027,65,181511
16704,0.001055,172.31.40.0-255,66,61093,65,181511
16705,0.001063,172.217.194.0-255,5738,66831,65,181511
16706,0.001065,172.31.40.0-255,66,66897,65,181511
16707,0.001096,172.217.194.0-255,7156,74053,65,181511
16708,0.001098,172.31.40.0-255,66,74119,65,181511
16709,0.00113,172.217.194.0-255,2902,77021,65,181511
16710,0.001133,172.31.40.0-255,66,77087,65,181511
16711,0.00115,172.31.40.0-255,66,77153,65,181511
16712,0.001154,172.217.194.0-255,2184,79337,65,181511
16713,0.001156,172.31.40.0-255,66,79403,65,181511
16714,0.001193,172.217.194.0-255,1484,80887,65,181511
16715,0.001197,172.217.194.0-255,1484,82371,65,181511
16716,0.001199,172.31.40.0-255,66,82437,65,181511
16717,0.001224,172.217.194.0-255,1484,83921,65,181511
16718,0.001231,172.217.194.0-255,5738,89659,65,181511
16719,0.001233,172.31.40.0-255,66,89725,65,181511
16720,0.001237,172.217.194.0-255,1484,91209,65,181511
16721,0.001278,172.31.40.0-255,66,91275,65,181511
16722,0.001304,172.217.194.0-255,7156,98431,65,181511
16723,0.00131,172.31.40.0-255,66,98497,65,181511
16724,0.001331,172.217.194.0-255,3602,102099,65,181511
16725,0.001334,172.31.40.0-255,66,102165,65,181511
16726,0.00136,172.217.194.0-255,1484,103649,65,181511
16727,0.001372,172.217.194.0-255,2902,106551,65,181511
16728,0.001374,172.31.40.0-255,66,106617,65,181511
16729,0.001403,172.217.194.0-255,5738,112355,65,181511
16730,0.001405,172.31.40.0-255,66,112421,65,181511
16731,0.001409,172.217.194.0-255,1484,113905,65,181511
16732,0.001413,172.217.194.0-255,4320,118225,65,181511
16733,0.001415,172.31.40.0-255,66,118291,65,181511
16734,0.001442,172.217.194.0-255,4320,122611,65,181511
16735,0.001444,172.31.40.0-255,66,122677,65,181511
16736,0.001451,172.217.194.0-255,7156,129833,65,181511
16737,0.001453,172.31.40.0-255,66,129899,65,181511
16738,0.001474,172.217.194.0-255,6438,136337,65,181511
16739,0.00148,172.31.40.0-255,66,136403,65,181511
16740,0.001707,172.217.194.0-255,1484,137887,65,181511
16741,0.001725,172.217.194.0-255,2902,140789,65,181511
16742,0.001731,172.31.40.0-255,66,140855,65,181511
16743,0.001753,172.217.194.0-255,5738,146593,65,181511
16744,0.001755,172.31.40.0-255,66,146659,65,181511
16745,0.001759,172.217.194.0-255,1484,148143,65,181511
16746,0.00177,172.31.40.0-255,66,148209,65,181511
16747,0.001809,172.217.194.0-255,1484,149693,65,181511
16748,0.001837,172.31.40.0-255,66,149759,65,181511
16749,0.001865,172.217.194.0-255,3602,153361,65,181511
16750,0.001868,172.31.40.0-255,66,153427,65,181511
16751,0.001961,172.217.194.0-255,1484,154911,65,181511
16752,0.001966,172.217.194.0-255,2902,157813,65,181511
16753,0.001969,172.31.40.0-255,66,157879,65,181511
16754,0.001996,172.217.194.0-255,5738,163617,65,181511
16755,0.001999,172.31.40.0-255,66,163683,65,181511
16756,0.002005,172.217.194.0-255,4320,168003,65,181511
16757,0.002007,172.31.40.0-255,66,168069,65,181511
16758,0.002041,172.217.194.0-255,2902,170971,65,181511
16759,0.002044,172.31.40.0-255,66,171037,65,181511
16760,0.002055,172.31.40.0-255,66,171103,65,181511
16761,0.002079,172.217.194.0-255,5738,176841,65,181511
16762,0.002082,172.31.40.0-255,66,176907,65,181511
16763,0.002086,172.217.194.0-255,2184,179091,65,181511
16764,0.002088,172.31.40.0-255,66,179157,65,181511
16765,0.002137,172.31.40.0-255,66,179223,65,181511
16766,0.002149,172.31.40.0-255,66,179289,65,181511
16767,0.002234,172.31.40.0-255,66,179355,65,181511
16768,0.002255,172.31.40.0-255,66,179421,65,181511
16769,0.002258,172.217.194.0-255,1484,180905,65,181511
16770,0.002272,172.31.40.0-255,66,180971,65,181511
16771,0.002309,172.31.40.0-255,66,181037,65,181511
16772,0.002321,172.31.40.0-255,66,181103,65,181511
16773,0.002388,172.31.40.0-255,66,181169,65,181511
16774,0.004654,172.217.194.0-255,105,181274,65,181511
16775,0.013428,172.31.40.0-255,66,181340,65,181511
16776,0.013493,172.31.40.0-255,105,181445,65,181511
16777,0.015752,172.217.194.0-255,66,181511,65,181511
16778,0.0,74.125.130.0-255,150,150,65,354534
16779,2.1e-05,172.31.40.0-255,66,216,65,354534
16780,2.9e-05,74.125.130.0-255,1484,1700,65,354534
16781,3.3e-05,172.31.40.0-255,66,1766,65,354534
16782,3.9e-05,74.125.130.0-255,2902,4668,65,354534
16783,4.3e-05,172.31.40.0-255,66,4734,65,354534
16784,7e-05,74.125.130.0-255,7156,11890,65,354534
16785,7.3e-05,172.31.40.0-255,66,11956,65,354534
16786,0.0001,74.125.130.0-255,2044,14000,65,354534
16787,0.000102,172.31.40.0-255,66,14066,65,354534
16788,0.000349,74.125.130.0-255,1484,15550,65,354534
16789,0.000354,172.31.40.0-255,66,15616,65,354534
16790,0.000359,74.125.130.0-255,1484,17100,65,354534
16791,0.000361,172.31.40.0-255,66,17166,65,354534
16792,0.000373,74.125.130.0-255,1484,18650,65,354534
16793,0.000375,172.31.40.0-255,66,18716,65,354534
16794,0.0004,74.125.130.0-255,1484,20200,65,354534
16795,0.000403,172.31.40.0-255,66,20266,65,354534
16796,0.000426,74.125.130.0-255,4320,24586,65,354534
16797,0.000429,172.31.40.0-255,66,24652,65,354534
16798,0.000432,74.125.130.0-255,1484,26136,65,354534
16799,0.000434,172.31.40.0-255,66,26202,65,354534
16800,0.000438,74.125.130.0-255,2902,29104,65,354534
16801,0.000441,172.31.40.0-255,66,29170,65,354534
16802,0.000456,74.125.130.0-255,2543,31713,65,354534
16803,0.000459,172.31.40.0-255,66,31779,65,354534
16804,0.000478,74.125.130.0-255,2902,34681,65,354534
16805,0.000481,172.31.40.0-255,66,34747,65,354534
16806,0.000514,74.125.130.0-255,7156,41903,65,354534
16807,0.000517,172.31.40.0-255,66,41969,65,354534
16808,0.000522,74.125.130.0-255,2902,44871,65,354534
16809,0.000524,172.31.40.0-255,66,44937,65,354534
16810,0.000565,74.125.130.0-255,3961,48898,65,354534
16811,0.000568,172.31.40.0-255,66,48964,65,354534
16812,0.001172,74.125.130.0-255,1484,50448,65,354534
16813,0.001196,74.125.130.0-255,2902,53350,65,354534
16814,0.0012,172.31.40.0-255,66,53416,65,354534
16815,0.001224,74.125.130.0-255,4320,57736,65,354534
16816,0.001227,172.31.40.0-255,66,57802,65,354534
16817,0.001261,74.125.130.0-255,2902,60704,65,354534
16818,0.001263,172.31.40.0-255,66,60770,65,354534
16819,0.001278,74.125.130.0-255,2902,63672,65,354534
16820,0.001281,172.31.40.0-255,66,63738,65,354534
16821,0.001285,74.125.130.0-255,2543,66281,65,354534
16822,0.001287,172.31.40.0-255,66,66347,65,354534
16823,0.001383,74.125.130.0-255,1484,67831,65,354534
16824,0.001399,74.125.130.0-255,2902,70733,65,354534
16825,0.001402,172.31.40.0-255,66,70799,65,354534
16826,0.001416,74.125.130.0-255,1484,72283,65,354534
16827,0.001435,74.125.130.0-255,4320,76603,65,354534
16828,0.001437,172.31.40.0-255,66,76669,65,354534
16829,0.001445,74.125.130.0-255,6797,83466,65,354534
16830,0.001447,172.31.40.0-255,66,83532,65,354534
16831,0.00147,74.125.130.0-255,2902,86434,65,354534
16832,0.001472,172.31.40.0-255,66,86500,65,354534
16833,0.001493,74.125.130.0-255,4320,90820,65,354534
16834,0.001495,172.31.40.0-255,66,90886,65,354534
16835,0.001503,74.125.130.0-255,7156,98042,65,354534
16836,0.001504,172.31.40.0-255,66,98108,65,354534
16837,0.001526,74.125.130.0-255,1484,99592,65,354534
16838,0.00153,74.125.130.0-255,1705,101297,65,354534
16839,0.001533,172.31.40.0-255,66,101363,65,354534
16840,0.002079,74.125.130.0-255,1484,102847,65,354534
16841,0.002099,74.125.130.0-255,2902,105749,65,354534
16842,0.002105,172.31.40.0-255,66,105815,65,354534
16843,0.002112,74.125.130.0-255,5738,111553,65,354534
16844,0.002115,172.31.40.0-255,66,111619,65,354534
16845,0.002152,172.31.40.0-255,66,111685,65,354534
16846,0.002176,172.31.40.0-255,66,111751,65,354534
16847,0.002192,74.125.130.0-255,1484,113235,65,354534
16848,0.002199,74.125.130.0-255,5020,118255,65,354534
16849,0.002201,172.31.40.0-255,66,118321,65,354534
16850,0.002262,74.125.130.0-255,1484,119805,65,354534
16851,0.002285,74.125.130.0-255,1484,121289,65,354534
16852,0.002288,172.31.40.0-255,66,121355,65,354534
16853,0.002301,74.125.130.0-255,2902,124257,65,354534
16854,0.002304,172.31.40.0-255,66,124323,65,354534
16855,0.002318,74.125.130.0-255,1484,125807,65,354534
16856,0.002328,74.125.130.0-255,1484,127291,65,354534
16857,0.00233,172.31.40.0-255,66,127357,65,354534
16858,0.002346,74.125.130.0-255,5738,133095,65,354534
16859,0.002349,172.31.40.0-255,66,133161,65,354534
16860,0.002352,74.125.130.0-255,1484,134645,65,354534
16861,0.002355,74.125.130.0-255,1484,136129,65,354534
16862,0.002357,172.31.40.0-255,66,136195,65,354534
16863,0.002389,74.125.130.0-255,2902,139097,65,354534
16864,0.002392,172.31.40.0-255,66,139163,65,354534
16865,0.002419,172.31.40.0-255,66,139229,65,354534
16866,0.002422,74.125.130.0-255,1484,140713,65,354534
16867,0.002443,74.125.130.0-255,3602,144315,65,354534
16868,0.002446,172.31.40.0-255,66,144381,65,354534
16869,0.002774,74.125.130.0-255,1484,145865,65,354534
16870,0.002792,74.125.130.0-255,2902,148767,65,354534
16871,0.002796,172.31.40.0-255,66,148833,65,354534
16872,0.00281,74.125.130.0-255,4320,153153,65,354534
16873,0.002812,172.31.40.0-255,66,153219,65,354534
16874,0.002843,74.125.130.0-255,5738,158957,65,354534
16875,0.002846,172.31.40.0-255,66,159023,65,354534
16876,0.002866,74.125.130.0-255,4320,163343,65,354534
16877,0.002869,172.31.40.0-255,66,163409,65,354534
16878,0.002882,172.31.40.0-255,66,163475,65,354534
16879,0.002905,74.125.130.0-255,3602,167077,65,354534
16880,0.002942,172.31.40.0-255,66,167143,65,354534
16881,0.002962,74.125.130.0-255,1484,168627,65,354534
16882,0.002966,74.125.130.0-255,1484,170111,65,354534
16883,0.002968,172.31.40.0-255,66,170177,65,354534
16884,0.002988,74.125.130.0-255,1484,171661,65,354534
16885,0.002992,74.125.130.0-255,2902,174563,65,354534
16886,0.002994,172.31.40.0-255,66,174629,65,354534
16887,0.003013,74.125.130.0-255,2902,177531,65,354534
16888,0.003016,172.31.40.0-255,66,177597,65,354534
16889,0.003022,74.125.130.0-255,5738,183335,65,354534
16890,0.003024,172.31.40.0-255,66,183401,65,354534
16891,0.003036,74.125.130.0-255,1484,184885,65,354534
16892,0.003076,172.31.40.0-255,66,184951,65,354534
16893,0.003094,74.125.130.0-255,1484,186435,65,354534
16894,0.003097,74.125.130.0-255,1484,187919,65,354534
16895,0.003101,172.31.40.0-255,66,187985,65,354534
16896,0.00312,74.125.130.0-255,2184,190169,65,354534
16897,0.003122,172.31.40.0-255,66,190235,65,354534
16898,0.003142,74.125.130.0-255,4320,194555,65,354534
16899,0.003145,172.31.40.0-255,66,194621,65,354534
16900,0.00317,74.125.130.0-255,5738,200359,65,354534
16901,0.003173,172.31.40.0-255,66,200425,65,354534
16902,0.003198,74.125.130.0-255,4320,204745,65,354534
16903,0.003201,172.31.40.0-255,66,204811,65,354534
16904,0.003237,74.125.130.0-255,7156,211967,65,354534
16905,0.003241,172.31.40.0-255,66,212033,65,354534
16906,0.003247,74.125.130.0-255,4320,216353,65,354534
16907,0.003249,172.31.40.0-255,66,216419,65,354534
16908,0.003256,74.125.130.0-255,7156,223575,65,354534
16909,0.00326,172.31.40.0-255,66,223641,65,354534
16910,0.003282,74.125.130.0-255,766,224407,65,354534
16911,0.003539,74.125.130.0-255,1484,225891,65,354534
16912,0.003544,172.31.40.0-255,66,225957,65,354534
16913,0.003549,74.125.130.0-255,1484,227441,65,354534
16914,0.003566,74.125.130.0-255,2902,230343,65,354534
16915,0.003569,172.31.40.0-255,66,230409,65,354534
16916,0.003575,74.125.130.0-255,4320,234729,65,354534
16917,0.003577,172.31.40.0-255,66,234795,65,354534
16918,0.003589,74.125.130.0-255,1484,236279,65,354534
16919,0.003592,74.125.130.0-255,1484,237763,65,354534
16920,0.003595,172.31.40.0-255,66,237829,65,354534
16921,0.003626,74.125.130.0-255,7156,244985,65,354534
16922,0.003628,172.31.40.0-255,66,245051,65,354534
16923,0.003633,74.125.130.0-255,2902,247953,65,354534
16924,0.003635,172.31.40.0-255,66,248019,65,354534
16925,0.003654,74.125.130.0-255,7156,255175,65,354534
16926,0.003656,172.31.40.0-255,66,255241,65,354534
16927,0.003673,74.125.130.0-255,1484,256725,65,354534
16928,0.003686,74.125.130.0-255,2184,258909,65,354534
16929,0.003689,172.31.40.0-255,66,258975,65,354534
16930,0.003862,74.125.130.0-255,1484,260459,65,354534
16931,0.003882,74.125.130.0-255,1484,261943,65,354534
16932,0.003886,172.31.40.0-255,66,262009,65,354534
16933,0.003908,74.125.130.0-255,1484,263493,65,354534
16934,0.003915,74.125.130.0-255,5738,269231,65,354534
16935,0.003917,172.31.40.0-255,66,269297,65,354534
16936,0.003922,74.125.130.0-255,2902,272199,65,354534
16937,0.003924,172.31.40.0-255,66,272265,65,354534
16938,0.003929,74.125.130.0-255,4320,276585,65,354534
16939,0.003931,172.31.40.0-255,66,276651,65,354534
16940,0.003953,74.125.130.0-255,5738,282389,65,354534
16941,0.003956,172.31.40.0-255,66,282455,65,354534
16942,0.003981,74.125.130.0-255,2902,285357,65,354534
16943,0.003983,172.31.40.0-255,66,285423,65,354534
16944,0.003989,74.125.130.0-255,4320,289743,65,354534
16945,0.003991,172.31.40.0-255,66,289809,65,354534
16946,0.004017,74.125.130.0-255,5020,294829,65,354534
16947,0.004021,172.31.40.0-255,66,294895,65,354534
16948,0.004025,74.125.130.0-255,2902,297797,65,354534
16949,0.004027,172.31.40.0-255,66,297863,65,354534
16950,0.004032,74.125.130.0-255,4320,302183,65,354534
16951,0.004034,172.31.40.0-255,66,302249,65,354534
16952,0.004064,172.31.40.0-255,66,302315,65,354534
16953,0.004068,74.125.130.0-255,2902,305217,65,354534
16954,0.00407,172.31.40.0-255,66,305283,65,354534
16955,0.004085,74.125.130.0-255,4320,309603,65,354534
16956,0.004088,172.31.40.0-255,66,309669,65,354534
16957,0.004106,74.125.130.0-255,1484,311153,65,354534
16958,0.004129,74.125.130.0-255,5738,316891,65,354534
16959,0.004132,172.31.40.0-255,66,316957,65,354534
16960,0.004151,74.125.130.0-255,1484,318441,65,354534
16961,0.004162,74.125.130.0-255,766,319207,65,354534
16962,0.004165,172.31.40.0-255,66,319273,65,354534
16963,0.004266,74.125.130.0-255,1484,320757,65,354534
16964,0.004283,74.125.130.0-255,2902,323659,65,354534
16965,0.004286,172.31.40.0-255,66,323725,65,354534
16966,0.004309,74.125.130.0-255,5738,329463,65,354534
16967,0.004312,172.31.40.0-255,66,329529,65,354534
16968,0.004315,74.125.130.0-255,1484,331013,65,354534
16969,0.004333,74.125.130.0-255,1484,332497,65,354534
16970,0.004336,172.31.40.0-255,66,332563,65,354534
16971,0.004341,74.125.130.0-255,4320,336883,65,354534
16972,0.004343,172.31.40.0-255,66,336949,65,354534
16973,0.004394,74.125.130.0-255,7156,344105,65,354534
16974,0.004396,74.125.130.0-255,1484,345589,65,354534
16975,0.0044,74.125.130.0-255,2902,348491,65,354534
16976,0.004403,172.31.40.0-255,66,348557,65,354534
16977,0.004408,172.31.40.0-255,66,348623,65,354534
16978,0.004426,74.125.130.0-255,5020,353643,65,354534
16979,0.004429,172.31.40.0-255,66,353709,65,354534
16980,0.004564,74.125.130.0-255,386,354095,65,354534
16981,0.004577,74.125.130.0-255,97,354192,65,354534
16982,0.004686,74.125.130.0-255,105,354297,65,354534
16983,0.006052,172.31.40.0-255,66,354363,65,354534
16984,0.006089,172.31.40.0-255,105,354468,65,354534
16985,0.00832,74.125.130.0-255,66,354534,65,354534
16986,0.0,172.217.194.0-255,152,152,65,124445
16987,2.3e-05,172.31.40.0-255,66,218,65,124445
16988,3e-05,172.217.194.0-255,1484,1702,65,124445
16989,3.5e-05,172.31.40.0-255,66,1768,65,124445
16990,4.1e-05,172.217.194.0-255,2902,4670,65,124445
16991,5.4e-05,172.31.40.0-255,66,4736,65,124445
16992,6.1e-05,172.217.194.0-255,7156,11892,65,124445
16993,6.5e-05,172.31.40.0-255,66,11958,65,124445
16994,7.1e-05,172.217.194.0-255,4320,16278,65,124445
16995,7.4e-05,172.31.40.0-255,66,16344,65,124445
16996,0.000108,172.217.194.0-255,4853,21197,65,124445
16997,0.000112,172.31.40.0-255,66,21263,65,124445
16998,0.000117,172.217.194.0-255,2902,24165,65,124445
16999,0.000119,172.31.40.0-255,66,24231,65,124445
17000,0.000155,172.217.194.0-255,6797,31028,65,124445
17001,0.000158,172.31.40.0-255,66,31094,65,124445
17002,0.000165,172.217.194.0-255,5738,36832,65,124445
17003,0.000167,172.31.40.0-255,66,36898,65,124445
17004,0.000194,172.217.194.0-255,4320,41218,65,124445
17005,0.000196,172.31.40.0-255,66,41284,65,124445
17006,0.000232,172.217.194.0-255,6797,48081,65,124445
17007,0.000235,172.31.40.0-255,66,48147,65,124445
17008,0.000312,172.217.194.0-255,1484,49631,65,124445
17009,0.000315,172.31.40.0-255,66,49697,65,124445
17010,0.000321,172.217.194.0-255,2902,52599,65,124445
17011,0.000324,172.31.40.0-255,66,52665,65,124445
17012,0.000334,172.217.194.0-255,5738,58403,65,124445
17013,0.000337,172.31.40.0-255,66,58469,65,124445
17014,0.000408,172.217.194.0-255,4320,62789,65,124445
17015,0.000411,172.31.40.0-255,66,62855,65,124445
17016,0.000434,172.217.194.0-255,2837,65692,65,124445
17017,0.000438,172.31.40.0-255,66,65758,65,124445
17018,0.002367,172.217.194.0-255,383,66141,65,124445
17019,0.002398,172.217.194.0-255,1484,67625,65,124445
17020,0.002403,172.31.40.0-255,66,67691,65,124445
17021,0.00241,172.217.194.0-255,2902,70593,65,124445
17022,0.002412,172.31.40.0-255,66,70659,65,124445
17023,0.002442,172.217.194.0-255,1484,72143,65,124445
17024,0.002449,172.217.194.0-255,5738,77881,65,124445
17025,0.002451,172.31.40.0-255,66,77947,65,124445
17026,0.002459,172.217.194.0-255,7156,85103,65,124445
17027,0.002461,172.31.40.0-255,66,85169,65,124445
17028,0.002499,172.217.194.0-255,4320,89489,65,124445
17029,0.002501,172.31.40.0-255,66,89555,65,124445
17030,0.002519,172.31.40.0-255,66,89621,65,124445
17031,0.005108,172.217.194.0-255,5738,95359,65,124445
17032,0.005113,172.31.40.0-255,66,95425,65,124445
17033,0.007681,172.217.194.0-255,5738,101163,65,124445
17034,0.007685,172.31.40.0-255,66,101229,65,124445
17035,0.010272,172.217.194.0-255,5738,106967,65,124445
17036,0.010281,172.31.40.0-255,66,107033,65,124445
17037,0.0129,172.217.194.0-255,5738,112771,65,124445
17038,0.012908,172.31.40.0-255,66,112837,65,124445
17039,0.015501,172.217.194.0-255,5738,118575,65,124445
17040,0.01551,172.31.40.0-255,66,118641,65,124445
17041,0.018096,172.217.194.0-255,5738,124379,65,124445
17042,0.018105,172.31.40.0-255,66,124445,65,124445
17043,0.0,74.125.68.0-255,155,155,65,213866
17044,2.2e-05,172.31.40.0-255,66,221,65,213866
17045,2.9e-05,74.125.68.0-255,1484,1705,65,213866
17046,3.4e-05,172.31.40.0-255,66,1771,65,213866
17047,3.9e-05,74.125.68.0-255,2902,4673,65,213866
17048,4.2e-05,172.31.40.0-255,66,4739,65,213866
17049,7.6e-05,74.125.68.0-255,5738,10477,65,213866
17050,8e-05,172.31.40.0-255,66,10543,65,213866
17051,0.000117,74.125.68.0-255,4838,15381,65,213866
17052,0.000121,172.31.40.0-255,66,15447,65,213866
17053,0.000124,74.125.68.0-255,1484,16931,65,213866
17054,0.000126,172.31.40.0-255,66,16997,65,213866
17055,0.000145,74.125.68.0-255,4320,21317,65,213866
17056,0.000148,172.31.40.0-255,66,21383,65,213866
17057,0.00016,74.125.68.0-255,2902,24285,65,213866
17058,0.000163,172.31.40.0-255,66,24351,65,213866
17059,0.000188,74.125.68.0-255,4320,28671,65,213866
17060,0.00019,172.31.40.0-255,66,28737,65,213866
17061,0.000197,74.125.68.0-255,4320,33057,65,213866
17062,0.000199,172.31.40.0-255,66,33123,65,213866
17063,0.00022,74.125.68.0-255,4320,37443,65,213866
17064,0.000223,172.31.40.0-255,66,37509,65,213866
17065,0.000227,74.125.68.0-255,2902,40411,65,213866
17066,0.00023,172.31.40.0-255,66,40477,65,213866
17067,0.000277,74.125.68.0-255,4320,44797,65,213866
17068,0.00028,172.31.40.0-255,66,44863,65,213866
17069,0.000295,74.125.68.0-255,3602,48465,65,213866
17070,0.000297,172.31.40.0-255,66,48531,65,213866
17071,0.000355,74.125.68.0-255,1484,50015,65,213866
17072,0.000357,172.31.40.0-255,66,50081,65,213866
17073,0.000374,74.125.68.0-255,2902,52983,65,213866
17074,0.000377,172.31.40.0-255,66,53049,65,213866
17075,0.000382,74.125.68.0-255,2902,55951,65,213866
17076,0.000404,74.125.68.0-255,2902,58853,65,213866
17077,0.000428,74.125.68.0-255,4320,63173,65,213866
17078,0.000444,74.125.68.0-255,2866,66039,65,213866
17079,0.00052,74.125.68.0-255,1484,67523,65,213866
17080,0.00054,74.125.68.0-255,2902,70425,65,213866
17081,0.000568,74.125.68.0-255,4320,74745,65,213866
17082,0.000581,74.125.68.0-255,1484,76229,65,213866
17083,0.000585,74.125.68.0-255,1484,77713,65,213866
17084,0.000588,74.125.68.0-255,1484,79197,65,213866
17085,0.000603,74.125.68.0-255,1484,80681,65,213866
17086,0.00061,74.125.68.0-255,5738,86419,65,213866
17087,0.000627,74.125.68.0-255,2902,89321,65,213866
17088,0.000651,74.125.68.0-255,7156,96477,65,213866
17089,0.000664,74.125.68.0-255,2902,99379,65,213866
17090,0.000667,74.125.68.0-255,766,100145,65,213866
17091,0.000716,74.125.68.0-255,1750,101895,65,213866
17092,0.00073,74.125.68.0-255,2902,104797,65,213866
17093,0.000754,74.125.68.0-255,7156,111953,65,213866
17094,0.000769,74.125.68.0-255,1484,113437,65,213866
17095,0.000791,74.125.68.0-255,3292,116729,65,213866
17096,0.001033,74.125.68.0-255,1484,118213,65,213866
17097,0.001047,74.125.68.0-255,2902,121115,65,213866
17098,0.001062,74.125.68.0-255,1484,122599,65,213866
17099,0.001086,74.125.68.0-255,4320,126919,65,213866
17100,0.001091,74.125.68.0-255,2902,129821,65,213866
17101,0.001097,74.125.68.0-255,4320,134141,65,213866
17102,0.001111,74.125.68.0-255,407,134548,65,213866
17103,0.001165,74.125.68.0-255,1484,136032,65,213866
17104,0.001178,74.125.68.0-255,2902,138934,65,213866
17105,0.001195,74.125.68.0-255,1484,140418,65,213866
17106,0.00121,74.125.68.0-255,4320,144738,65,213866
17107,0.001226,74.125.68.0-255,5738,150476,65,213866
17108,0.001247,74.125.68.0-255,2902,153378,65,213866
17109,0.001252,74.125.68.0-255,4320,157698,65,213866
17110,0.001272,74.125.68.0-255,5738,163436,65,213866
17111,0.001274,74.125.68.0-255,1484,164920,65,213866
17112,0.00129,74.125.68.0-255,3602,168522,65,213866
17113,0.002257,74.125.68.0-255,1484,170006,65,213866
17114,0.002269,74.125.68.0-255,1484,171490,65,213866
17115,0.002285,74.125.68.0-255,1484,172974,65,213866
17116,0.002288,74.125.68.0-255,1484,174458,65,213866
17117,0.002458,172.31.40.0-255,66,174524,65,213866
17118,0.004773,74.125.68.0-255,5738,180262,65,213866
17119,0.004781,172.31.40.0-255,66,180328,65,213866
17120,0.007051,74.125.68.0-255,1484,181812,65,213866
17121,0.00707,74.125.68.0-255,4320,186132,65,213866
17122,0.008495,172.31.40.0-255,66,186198,65,213866
17123,0.010776,74.125.68.0-255,5738,191936,65,213866
17124,0.010783,172.31.40.0-255,66,192002,65,213866
17125,0.013049,74.125.68.0-255,4320,196322,65,213866
17126,0.013058,172.31.40.0-255,66,196388,65,213866
17127,0.013076,74.125.68.0-255,1484,197872,65,213866
17128,0.01533,74.125.68.0-255,4320,202192,65,213866
17129,0.015339,172.31.40.0-255,66,202258,65,213866
17130,0.017638,74.125.68.0-255,5738,207996,65,213866
17131,0.017701,172.31.40.0-255,66,208062,65,213866
17132,0.019989,74.125.68.0-255,5738,213800,65,213866
17133,0.019998,172.31.40.0-255,66,213866,65,213866
17134,0.0,172.217.26.0-255,158,158,65,188714
17135,2e-05,172.31.40.0-255,66,224,65,188714
17136,2.7e-05,172.217.26.0-255,1484,1708,65,188714
17137,3e-05,172.31.40.0-255,66,1774,65,188714
17138,3.5e-05,172.217.26.0-255,2902,4676,65,188714
17139,3.7e-05,172.31.40.0-255,66,4742,65,188714
17140,5e-05,172.217.26.0-255,5738,10480,65,188714
17141,5.3e-05,172.31.40.0-255,66,10546,65,188714
17142,5.7e-05,172.217.26.0-255,3448,13994,65,188714
17143,6e-05,172.31.40.0-255,66,14060,65,188714
17144,0.0001,172.217.26.0-255,4320,18380,65,188714
17145,0.000103,172.31.40.0-255,66,18446,65,188714
17146,0.000108,172.217.26.0-255,4320,22766,65,188714
17147,0.000111,172.31.40.0-255,66,22832,65,188714
17148,0.000139,172.217.26.0-255,5738,28570,65,188714
17149,0.000141,172.31.40.0-255,66,28636,65,188714
17150,0.000152,172.217.26.0-255,2543,31179,65,188714
17151,0.000157,172.31.40.0-255,66,31245,65,188714
17152,0.000221,172.217.26.0-255,1484,32729,65,188714
17153,0.000223,172.31.40.0-255,66,32795,65,188714
17154,0.000228,172.217.26.0-255,2902,35697,65,188714
17155,0.000229,172.31.40.0-255,66,35763,65,188714
17156,0.000232,172.217.26.0-255,1484,37247,65,188714
17157,0.000233,172.31.40.0-255,66,37313,65,188714
17158,0.000261,172.217.26.0-255,4320,41633,65,188714
17159,0.000264,172.31.40.0-255,66,41699,65,188714
17160,0.00027,172.217.26.0-255,6797,48496,65,188714
17161,0.000272,172.31.40.0-255,66,48562,65,188714
17162,0.000279,172.217.26.0-255,7156,55718,65,188714
17163,0.000281,172.31.40.0-255,66,55784,65,188714
17164,0.000317,172.217.26.0-255,4320,60104,65,188714
17165,0.000319,172.31.40.0-255,66,60170,65,188714
17166,0.000344,172.217.26.0-255,5379,65549,65,188714
17167,0.000347,172.31.40.0-255,66,65615,65,188714
17168,0.00035,172.217.26.0-255,396,66011,65,188714
17169,0.000885,172.217.26.0-255,115,66126,65,188714
17170,0.000991,172.31.40.0-255,66,66192,65,188714
17171,0.001036,172.217.26.0-255,1484,67676,65,188714
17172,0.001053,172.217.26.0-255,2902,70578,65,188714
17173,0.001056,172.31.40.0-255,66,70644,65,188714
17174,0.001062,172.217.26.0-255,5738,76382,65,188714
17175,0.001064,172.31.40.0-255,66,76448,65,188714
17176,0.001067,172.217.26.0-255,1484,77932,65,188714
17177,0.001091,172.217.26.0-255,4320,82252,65,188714
17178,0.001093,172.31.40.0-255,66,82318,65,188714
17179,0.0011,172.217.26.0-255,6797,89115,65,188714
17180,0.001102,172.31.40.0-255,66,89181,65,188714
17181,0.001125,172.217.26.0-255,1484,90665,65,188714
17182,0.001158,172.31.40.0-255,66,90731,65,188714
17183,0.001161,172.217.26.0-255,329,91060,65,188714
17184,0.001434,172.217.26.0-255,1484,92544,65,188714
17185,0.001439,172.31.40.0-255,66,92610,65,188714
17186,0.001445,172.217.26.0-255,2902,95512,65,188714
17187,0.001446,172.31.40.0-255,66,95578,65,188714
17188,0.001475,172.217.26.0-255,2902,98480,65,188714
17189,0.001477,172.31.40.0-255,66,98546,65,188714
17190,0.001502,172.217.26.0-255,2902,101448,65,188714
17191,0.001504,172.31.40.0-255,66,101514,65,188714
17192,0.001517,172.31.40.0-255,66,101580,65,188714
17193,0.001569,172.31.40.0-255,66,101646,65,188714
17194,0.001742,172.217.26.0-255,1484,103130,65,188714
17195,0.001759,172.217.26.0-255,2902,106032,65,188714
17196,0.001764,172.31.40.0-255,66,106098,65,188714
17197,0.001776,172.217.26.0-255,5738,111836,65,188714
17198,0.001784,172.31.40.0-255,66,111902,65,188714
17199,0.001795,172.217.26.0-255,4320,116222,65,188714
17200,0.001801,172.31.40.0-255,66,116288,65,188714
17201,0.001808,172.217.26.0-255,5738,122026,65,188714
17202,0.001811,172.31.40.0-255,66,122092,65,188714
17203,0.001843,172.217.26.0-255,4320,126412,65,188714
17204,0.001848,172.31.40.0-255,66,126478,65,188714
17205,0.00187,172.217.26.0-255,7156,133634,65,188714
17206,0.001873,172.31.40.0-255,66,133700,65,188714
17207,0.001896,172.217.26.0-255,2184,135884,65,188714
17208,0.0019,172.31.40.0-255,66,135950,65,188714
17209,0.003751,172.217.26.0-255,2902,138852,65,188714
17210,0.003758,172.31.40.0-255,66,138918,65,188714
17211,0.003797,172.217.26.0-255,2902,141820,65,188714
17212,0.0038,172.31.40.0-255,66,141886,65,188714
17213,0.005641,172.217.26.0-255,2902,144788,65,188714
17214,0.005646,172.31.40.0-255,66,144854,65,188714
17215,0.005676,172.217.26.0-255,2902,147756,65,188714
17216,0.005678,172.31.40.0-255,66,147822,65,188714
17217,0.007532,172.217.26.0-255,2902,150724,65,188714
17218,0.007538,172.31.40.0-255,66,150790,65,188714
17219,0.007576,172.217.26.0-255,2902,153692,65,188714
17220,0.007579,172.31.40.0-255,66,153758,65,188714
17221,0.009421,172.217.26.0-255,2902,156660,65,188714
17222,0.009428,172.31.40.0-255,66,156726,65,188714
17223,0.009457,172.217.26.0-255,2902,159628,65,188714
17224,0.00946,172.31.40.0-255,66,159694,65,188714
17225,0.011343,172.217.26.0-255,5738,165432,65,188714
17226,0.011351,172.31.40.0-255,66,165498,65,188714
17227,0.013248,172.217.26.0-255,5738,171236,65,188714
17228,0.013255,172.31.40.0-255,66,171302,65,188714
17229,0.015148,172.217.26.0-255,5738,177040,65,188714
17230,0.015156,172.31.40.0-255,66,177106,65,188714
17231,0.017051,172.217.26.0-255,5738,182844,65,188714
17232,0.017058,172.31.40.0-255,66,182910,65,188714
17233,0.018955,172.217.26.0-255,5738,188648,65,188714
17234,0.018964,172.31.40.0-255,66,188714,65,188714
17235,0.0,172.217.194.0-255,150,150,65,202227
17236,2.2e-05,172.31.40.0-255,66,216,65,202227
17237,2.9e-05,172.217.194.0-255,1484,1700,65,202227
17238,3.3e-05,172.31.40.0-255,66,1766,65,202227
17239,3.9e-05,172.217.194.0-255,2902,4668,65,202227
17240,4.2e-05,172.31.40.0-255,66,4734,65,202227
17241,5e-05,172.217.194.0-255,7156,11890,65,202227
17242,5.3e-05,172.31.40.0-255,66,11956,65,202227
17243,5.6e-05,172.217.194.0-255,1484,13440,65,202227
17244,5.9e-05,172.31.40.0-255,66,13506,65,202227
17245,6.8e-05,172.217.194.0-255,7156,20662,65,202227
17246,7.2e-05,172.31.40.0-255,66,20728,65,202227
17247,0.000106,172.217.194.0-255,3401,24129,65,202227
17248,0.000109,172.31.40.0-255,66,24195,65,202227
17249,0.000117,172.217.194.0-255,6797,30992,65,202227
17250,0.00012,172.31.40.0-255,66,31058,65,202227
17251,0.000153,172.217.194.0-255,1484,32542,65,202227
17252,0.000156,172.31.40.0-255,66,32608,65,202227
17253,0.00017,172.217.194.0-255,2902,35510,65,202227
17254,0.000172,172.31.40.0-255,66,35576,65,202227
17255,0.000175,172.217.194.0-255,1484,37060,65,202227
17256,0.000177,172.31.40.0-255,66,37126,65,202227
17257,0.000199,172.217.194.0-255,4320,41446,65,202227
17258,0.000202,172.31.40.0-255,66,41512,65,202227
17259,0.000204,172.217.194.0-255,1484,42996,65,202227
17260,0.000206,172.31.40.0-255,66,43062,65,202227
17261,0.000229,172.217.194.0-255,5738,48800,65,202227
17262,0.000232,172.31.40.0-255,66,48866,65,202227
17263,0.000262,172.31.40.0-255,66,48932,65,202227
17264,0.000274,172.31.40.0-255,66,48998,65,202227
17265,0.00069,172.217.194.0-255,645,49643,65,202227
17266,0.000933,172.217.194.0-255,1484,51127,65,202227
17267,0.000938,172.31.40.0-255,66,51193,65,202227
17268,0.000943,172.217.194.0-255,2902,54095,65,202227
17269,0.000945,172.31.40.0-255,66,54161,65,202227
17270,0.000966,172.217.194.0-255,5738,59899,65,202227
17271,0.000968,172.31.40.0-255,66,59965,65,202227
17272,0.000985,172.217.194.0-255,2902,62867,65,202227
17273,0.000988,172.31.40.0-255,66,62933,65,202227
17274,0.001014,172.31.40.0-255,66,62999,65,202227
17275,0.001027,172.31.40.0-255,66,63065,65,202227
17276,0.001088,172.217.194.0-255,1484,64549,65,202227
17277,0.001093,172.217.194.0-255,2902,67451,65,202227
17278,0.001096,172.31.40.0-255,66,67517,65,202227
17279,0.001102,172.217.194.0-255,4320,71837,65,202227
17280,0.001104,172.31.40.0-255,66,71903,65,202227
17281,0.001126,172.217.194.0-255,1484,73387,65,202227
17282,0.001139,172.31.40.0-255,66,73453,65,202227
17283,0.001166,172.217.194.0-255,2902,76355,65,202227
17284,0.00118,172.31.40.0-255,66,76421,65,202227
17285,0.001183,172.31.40.0-255,66,76487,65,202227
17286,0.00127,172.217.194.0-255,1484,77971,65,202227
17287,0.001275,172.217.194.0-255,2902,80873,65,202227
17288,0.001278,172.31.40.0-255,66,80939,65,202227
17289,0.001282,172.217.194.0-255,1484,82423,65,202227
17290,0.001312,172.217.194.0-255,4320,86743,65,202227
17291,0.001316,172.31.40.0-255,66,86809,65,202227
17292,0.001322,172.217.194.0-255,5738,92547,65,202227
17293,0.001324,172.31.40.0-255,66,92613,65,202227
17294,0.001338,172.31.40.0-255,66,92679,65,202227
17295,0.001354,172.217.194.0-255,2902,95581,65,202227
17296,0.001357,172.31.40.0-255,66,95647,65,202227
17297,0.001363,172.217.194.0-255,5020,100667,65,202227
17298,0.001365,172.31.40.0-255,66,100733,65,202227
17299,0.001544,172.217.194.0-255,1484,102217,65,202227
17300,0.001551,172.217.194.0-255,2902,105119,65,202227
17301,0.001554,172.31.40.0-255,66,105185,65,202227
17302,0.001557,172.217.194.0-255,1484,106669,65,202227
17303,0.001593,172.217.194.0-255,4320,110989,65,202227
17304,0.001596,172.31.40.0-255,66,111055,65,202227
17305,0.001603,172.217.194.0-255,7156,118211,65,202227
17306,0.001606,172.31.40.0-255,66,118277,65,202227
17307,0.001623,172.217.194.0-255,5738,124015,65,202227
17308,0.001625,172.31.40.0-255,66,124081,65,202227
17309,0.001636,172.31.40.0-255,66,124147,65,202227
17310,0.001664,172.217.194.0-255,2184,126331,65,202227
17311,0.001667,172.31.40.0-255,66,126397,65,202227
17312,0.001702,172.217.194.0-255,2902,129299,65,202227
17313,0.001704,172.31.40.0-255,66,129365,65,202227
17314,0.001712,172.217.194.0-255,7156,136521,65,202227
17315,0.001714,172.31.40.0-255,66,136587,65,202227
17316,0.001719,172.217.194.0-255,4320,140907,65,202227
17317,0.001722,172.31.40.0-255,66,140973,65,202227
17318,0.001748,172.217.194.0-255,5738,146711,65,202227
17319,0.001752,172.31.40.0-255,66,146777,65,202227
17320,0.001778,172.217.194.0-255,7156,153933,65,202227
17321,0.001781,172.31.40.0-255,66,153999,65,202227
17322,0.001787,172.217.194.0-255,6438,160437,65,202227
17323,0.00179,172.31.40.0-255,66,160503,65,202227
17324,0.002001,172.217.194.0-255,1484,161987,65,202227
17325,0.002023,172.217.194.0-255,2902,164889,65,202227
17326,0.002026,172.31.40.0-255,66,164955,65,202227
17327,0.002034,172.217.194.0-255,5738,170693,65,202227
17328,0.002036,172.31.40.0-255,66,170759,65,202227
17329,0.002106,172.31.40.0-255,66,170825,65,202227
17330,0.002115,172.217.194.0-255,2184,173009,65,202227
17331,0.002291,172.217.194.0-255,1484,174493,65,202227
17332,0.007853,172.31.40.0-255,66,174559,65,202227
17333,0.007858,172.31.40.0-255,66,174625,65,202227
17334,0.010133,172.217.194.0-255,4320,178945,65,202227
17335,0.010141,172.31.40.0-255,66,179011,65,202227
17336,0.012466,172.217.194.0-255,5738,184749,65,202227
17337,0.012475,172.31.40.0-255,66,184815,65,202227
17338,0.014792,172.217.194.0-255,5738,190553,65,202227
17339,0.0148,172.31.40.0-255,66,190619,65,202227
17340,0.017083,172.217.194.0-255,5738,196357,65,202227
17341,0.01709,172.31.40.0-255,66,196423,65,202227
17342,0.019357,172.217.194.0-255,5738,202161,65,202227
17343,0.019366,172.31.40.0-255,66,202227,65,202227
17344,0.0,172.31.40.0-255,105,105,65,459
17345,0.000301,172.31.40.0-255,90,195,65,459
17346,0.000311,172.31.40.0-255,66,261,65,459
17347,0.002291,172.217.194.0-255,66,327,65,459
17348,0.002311,172.217.194.0-255,66,393,65,459
17349,0.002326,172.31.40.0-255,66,459,65,459
17350,0.0,172.253.118.0-255,153,153,65,152996
17351,2.3e-05,172.31.40.0-255,66,219,65,152996
17352,3e-05,172.253.118.0-255,1484,1703,65,152996
17353,3.4e-05,172.31.40.0-255,66,1769,65,152996
17354,4e-05,172.253.118.0-255,2902,4671,65,152996
17355,4.3e-05,172.31.40.0-255,66,4737,65,152996
17356,5.1e-05,172.253.118.0-255,7156,11893,65,152996
17357,5.4e-05,172.31.40.0-255,66,11959,65,152996
17358,5.9e-05,172.253.118.0-255,2129,14088,65,152996
17359,6.1e-05,172.31.40.0-255,66,14154,65,152996
17360,0.000217,172.253.118.0-255,1484,15638,65,152996
17361,0.000222,172.31.40.0-255,66,15704,65,152996
17362,0.000228,172.253.118.0-255,2902,18606,65,152996
17363,0.000231,172.31.40.0-255,66,18672,65,152996
17364,0.000233,172.253.118.0-255,1484,20156,65,152996
17365,0.000235,172.31.40.0-255,66,20222,65,152996
17366,0.000261,172.253.118.0-255,4320,24542,65,152996
17367,0.000264,172.31.40.0-255,66,24608,65,152996
17368,0.000268,172.253.118.0-255,2902,27510,65,152996
17369,0.00027,172.31.40.0-255,66,27576,65,152996
17370,0.000286,172.253.118.0-255,3961,31537,65,152996
17371,0.000289,172.31.40.0-255,66,31603,65,152996
17372,0.000448,172.253.118.0-255,1484,33087,65,152996
17373,0.000453,172.31.40.0-255,66,33153,65,152996
17374,0.000458,172.253.118.0-255,2902,36055,65,152996
17375,0.000461,172.31.40.0-255,66,36121,65,152996
17376,0.000468,172.253.118.0-255,5738,41859,65,152996
17377,0.000471,172.31.40.0-255,66,41925,65,152996
17378,0.000474,172.253.118.0-255,1484,43409,65,152996
17379,0.000475,172.31.40.0-255,66,43475,65,152996
17380,0.000506,172.253.118.0-255,5379,48854,65,152996
17381,0.000509,172.31.40.0-255,66,48920,65,152996
17382,0.000588,172.253.118.0-255,1484,50404,65,152996
17383,0.000594,172.253.118.0-255,2902,53306,65,152996
17384,0.000597,172.31.40.0-255,66,53372,65,152996
17385,0.000602,172.253.118.0-255,2902,56274,65,152996
17386,0.000604,172.31.40.0-255,66,56340,65,152996
17387,0.000618,172.253.118.0-255,2902,59242,65,152996
17388,0.000621,172.31.40.0-255,66,59308,65,152996
17389,0.000628,172.253.118.0-255,6797,66105,65,152996
17390,0.000631,172.31.40.0-255,66,66171,65,152996
17391,0.001405,172.253.118.0-255,647,66818,65,152996
17392,0.001606,172.253.118.0-255,1484,68302,65,152996
17393,0.001613,172.31.40.0-255,66,68368,65,152996
17394,0.00162,172.253.118.0-255,2902,71270,65,152996
17395,0.001623,172.31.40.0-255,66,71336,65,152996
17396,0.001626,172.253.118.0-255,1484,72820,65,152996
17397,0.001651,172.253.118.0-255,4320,77140,65,152996
17398,0.001653,172.31.40.0-255,66,77206,65,152996
17399,0.00168,172.253.118.0-255,5738,82944,65,152996
17400,0.001682,172.31.40.0-255,66,83010,65,152996
17401,0.001711,172.253.118.0-255,1484,84494,65,152996
17402,0.001725,172.31.40.0-255,66,84560,65,152996
17403,0.00173,172.253.118.0-255,2184,86744,65,152996
17404,0.001731,172.31.40.0-255,66,86810,65,152996
17405,0.002228,172.253.118.0-255,1484,88294,65,152996
17406,0.002236,172.253.118.0-255,2902,91196,65,152996
17407,0.00224,172.31.40.0-255,66,91262,65,152996
17408,0.002247,172.253.118.0-255,5738,97000,65,152996
17409,0.002249,172.31.40.0-255,66,97066,65,152996
17410,0.002282,172.253.118.0-255,4320,101386,65,152996
17411,0.002284,172.31.40.0-255,66,101452,65,152996
17412,0.002305,172.31.40.0-255,66,101518,65,152996
17413,0.002309,172.253.118.0-255,1484,103002,65,152996
17414,0.002333,172.253.118.0-255,5738,108740,65,152996
17415,0.002335,172.31.40.0-255,66,108806,65,152996
17416,0.002339,172.253.118.0-255,2902,111708,65,152996
17417,0.002343,172.31.40.0-255,66,111774,65,152996
17418,0.004569,172.253.118.0-255,2902,114676,65,152996
17419,0.004574,172.31.40.0-255,66,114742,65,152996
17420,0.004615,172.253.118.0-255,1484,116226,65,152996
17421,0.004627,172.253.118.0-255,1484,117710,65,152996
17422,0.004629,172.31.40.0-255,66,117776,65,152996
17423,0.006833,172.253.118.0-255,2902,120678,65,152996
17424,0.00684,172.31.40.0-255,66,120744,65,152996
17425,0.006883,172.253.118.0-255,1484,122228,65,152996
17426,0.006896,172.253.118.0-255,1484,123712,65,152996
17427,0.006899,172.31.40.0-255,66,123778,65,152996
17428,0.009119,172.253.118.0-255,2902,126680,65,152996
17429,0.009126,172.31.40.0-255,66,126746,65,152996
17430,0.009174,172.253.118.0-255,1484,128230,65,152996
17431,0.009191,172.253.118.0-255,1484,129714,65,152996
17432,0.009194,172.31.40.0-255,66,129780,65,152996
17433,0.01145,172.253.118.0-255,5738,135518,65,152996
17434,0.011458,172.31.40.0-255,66,135584,65,152996
17435,0.013742,172.253.118.0-255,5738,141322,65,152996
17436,0.01375,172.31.40.0-255,66,141388,65,152996
17437,0.016038,172.253.118.0-255,5738,147126,65,152996
17438,0.016049,172.31.40.0-255,66,147192,65,152996
17439,0.018347,172.253.118.0-255,5738,152930,65,152996
17440,0.018357,172.31.40.0-255,66,152996,65,152996
17441,0.0,74.125.24.0-255,150,150,65,299922
17442,2e-05,172.31.40.0-255,66,216,65,299922
17443,2.6e-05,74.125.24.0-255,1484,1700,65,299922
17444,3.1e-05,172.31.40.0-255,66,1766,65,299922
17445,3.7e-05,74.125.24.0-255,2902,4668,65,299922
17446,4.1e-05,172.31.40.0-255,66,4734,65,299922
17447,4.8e-05,74.125.24.0-255,5738,10472,65,299922
17448,5.1e-05,172.31.40.0-255,66,10538,65,299922
17449,9.4e-05,74.125.24.0-255,3556,14094,65,299922
17450,9.8e-05,172.31.40.0-255,66,14160,65,299922
17451,0.000186,74.125.24.0-255,1484,15644,65,299922
17452,0.000192,172.31.40.0-255,66,15710,65,299922
17453,0.000198,74.125.24.0-255,2902,18612,65,299922
17454,0.000201,172.31.40.0-255,66,18678,65,299922
17455,0.000236,74.125.24.0-255,5738,24416,65,299922
17456,0.00024,172.31.40.0-255,66,24482,65,299922
17457,0.000256,74.125.24.0-255,4320,28802,65,299922
17458,0.000259,172.31.40.0-255,66,28868,65,299922
17459,0.000277,74.125.24.0-255,2543,31411,65,299922
17460,0.000281,172.31.40.0-255,66,31477,65,299922
17461,0.000569,74.125.24.0-255,1484,32961,65,299922
17462,0.000575,172.31.40.0-255,66,33027,65,299922
17463,0.000583,74.125.24.0-255,2902,35929,65,299922
17464,0.000586,172.31.40.0-255,66,35995,65,299922
17465,0.000589,74.125.24.0-255,1484,37479,65,299922
17466,0.000591,172.31.40.0-255,66,37545,65,299922
17467,0.000614,74.125.24.0-255,4320,41865,65,299922
17468,0.000617,172.31.40.0-255,66,41931,65,299922
17469,0.000622,74.125.24.0-255,4320,46251,65,299922
17470,0.000625,172.31.40.0-255,66,46317,65,299922
17471,0.000653,74.125.24.0-255,2543,48860,65,299922
17472,0.000663,172.31.40.0-255,66,48926,65,299922
17473,0.000682,74.125.24.0-255,2902,51828,65,299922
17474,0.000685,172.31.40.0-255,66,51894,65,299922
17475,0.000698,74.125.24.0-255,1484,53378,65,299922
17476,0.000718,74.125.24.0-255,5738,59116,65,299922
17477,0.000721,172.31.40.0-255,66,59182,65,299922
17478,0.000774,172.31.40.0-255,66,59248,65,299922
17479,0.001125,74.125.24.0-255,346,59594,65,299922
17480,0.001242,74.125.24.0-255,1484,61078,65,299922
17481,0.001248,172.31.40.0-255,66,61144,65,299922
17482,0.001253,74.125.24.0-255,2902,64046,65,299922
17483,0.001256,172.31.40.0-255,66,64112,65,299922
17484,0.001259,74.125.24.0-255,1484,65596,65,299922
17485,0.001287,74.125.24.0-255,4320,69916,65,299922
17486,0.00129,172.31.40.0-255,66,69982,65,299922
17487,0.001313,74.125.24.0-255,4320,74302,65,299922
17488,0.001315,172.31.40.0-255,66,74368,65,299922
17489,0.001333,74.125.24.0-255,2543,76911,65,299922
17490,0.001336,172.31.40.0-255,66,76977,65,299922
17491,0.001344,74.125.24.0-255,5738,82715,65,299922
17492,0.001346,172.31.40.0-255,66,82781,65,299922
17493,0.001365,74.125.24.0-255,1484,84265,65,299922
17494,0.001372,74.125.24.0-255,7156,91421,65,299922
17495,0.001375,172.31.40.0-255,66,91487,65,299922
17496,0.001397,74.125.24.0-255,2543,94030,65,299922
17497,0.0014,172.31.40.0-255,66,94096,65,299922
17498,0.002664,74.125.24.0-255,1484,95580,65,299922
17499,0.002675,74.125.24.0-255,2902,98482,65,299922
17500,0.002681,172.31.40.0-255,66,98548,65,299922
17501,0.002689,74.125.24.0-255,5738,104286,65,299922
17502,0.002691,172.31.40.0-255,66,104352,65,299922
17503,0.00271,74.125.24.0-255,1484,105836,65,299922
17504,0.002739,172.31.40.0-255,66,105902,65,299922
17505,0.002759,74.125.24.0-255,1484,107386,65,299922
17506,0.002766,74.125.24.0-255,7156,114542,65,299922
17507,0.002768,172.31.40.0-255,66,114608,65,299922
17508,0.002773,74.125.24.0-255,2184,116792,65,299922
17509,0.002776,172.31.40.0-255,66,116858,65,299922
17510,0.002822,74.125.24.0-255,2902,119760,65,299922
17511,0.002825,172.31.40.0-255,66,119826,65,299922
17512,0.002828,74.125.24.0-255,1484,121310,65,299922
17513,0.002847,74.125.24.0-255,4320,125630,65,299922
17514,0.00285,172.31.40.0-255,66,125696,65,299922
17515,0.002855,74.125.24.0-255,2902,128598,65,299922
17516,0.002857,172.31.40.0-255,66,128664,65,299922
17517,0.002878,74.125.24.0-255,4320,132984,65,299922
17518,0.00288,172.31.40.0-255,66,133050,65,299922
17519,0.002918,74.125.24.0-255,4320,137370,65,299922
17520,0.002921,172.31.40.0-255,66,137436,65,299922
17521,0.00295,172.31.40.0-255,66,137502,65,299922
17522,0.002955,74.125.24.0-255,3602,141104,65,299922
17523,0.002957,172.31.40.0-255,66,141170,65,299922
17524,0.00296,74.125.24.0-255,1484,142654,65,299922
17525,0.002963,74.125.24.0-255,1484,144138,65,299922
17526,0.002965,172.31.40.0-255,66,144204,65,299922
17527,0.002983,74.125.24.0-255,1484,145688,65,299922
17528,0.002989,74.125.24.0-255,4320,150008,65,299922
17529,0.002991,172.31.40.0-255,66,150074,65,299922
17530,0.003013,74.125.24.0-255,1484,151558,65,299922
17531,0.003021,74.125.24.0-255,7156,158714,65,299922
17532,0.003025,172.31.40.0-255,66,158780,65,299922
17533,0.003029,74.125.24.0-255,2902,161682,65,299922
17534,0.003032,172.31.40.0-255,66,161748,65,299922
17535,0.00308,172.31.40.0-255,66,161814,65,299922
17536,0.003084,74.125.24.0-255,2184,163998,65,299922
17537,0.003088,172.31.40.0-255,66,164064,65,299922
17538,0.003218,74.125.24.0-255,1484,165548,65,299922
17539,0.003236,74.125.24.0-255,1484,167032,65,299922
17540,0.003239,172.31.40.0-255,66,167098,65,299922
17541,0.003246,74.125.24.0-255,4320,171418,65,299922
17542,0.003248,172.31.40.0-255,66,171484,65,299922
17543,0.003252,74.125.24.0-255,2902,174386,65,299922
17544,0.003255,172.31.40.0-255,66,174452,65,299922
17545,0.003277,74.125.24.0-255,4320,178772,65,299922
17546,0.003279,172.31.40.0-255,66,178838,65,299922
17547,0.003282,74.125.24.0-255,1484,180322,65,299922
17548,0.003293,74.125.24.0-255,1484,181806,65,299922
17549,0.003295,172.31.40.0-255,66,181872,65,299922
17550,0.003317,172.31.40.0-255,66,181938,65,299922
17551,0.003342,74.125.24.0-255,1484,183422,65,299922
17552,0.003345,74.125.24.0-255,1484,184906,65,299922
17553,0.003347,172.31.40.0-255,66,184972,65,299922
17554,0.003353,74.125.24.0-255,3602,188574,65,299922
17555,0.003355,172.31.40.0-255,66,188640,65,299922
17556,0.003391,74.125.24.0-255,1484,190124,65,299922
17557,0.003395,74.125.24.0-255,2902,193026,65,299922
17558,0.003398,172.31.40.0-255,66,193092,65,299922
17559,0.00342,74.125.24.0-255,5738,198830,65,299922
17560,0.003423,172.31.40.0-255,66,198896,65,299922
17561,0.00345,74.125.24.0-255,1484,200380,65,299922
17562,0.003486,74.125.24.0-255,7156,207536,65,299922
17563,0.003488,172.31.40.0-255,66,207602,65,299922
17564,0.003509,74.125.24.0-255,2902,210504,65,299922
17565,0.003512,172.31.40.0-255,66,210570,65,299922
17566,0.003526,172.31.40.0-255,66,210636,65,299922
17567,0.003529,74.125.24.0-255,1484,212120,65,299922
17568,0.003556,74.125.24.0-255,2902,215022,65,299922
17569,0.003559,172.31.40.0-255,66,215088,65,299922
17570,0.003566,74.125.24.0-255,5738,220826,65,299922
17571,0.003568,172.31.40.0-255,66,220892,65,299922
17572,0.003592,74.125.24.0-255,1484,222376,65,299922
17573,0.003624,172.31.40.0-255,66,222442,65,299922
17574,0.003631,74.125.24.0-255,7156,229598,65,299922
17575,0.003634,172.31.40.0-255,66,229664,65,299922
17576,0.00365,74.125.24.0-255,1484,231148,65,299922
17577,0.003654,74.125.24.0-255,2184,233332,65,299922
17578,0.0037,74.125.24.0-255,2902,236234,65,299922
17579,0.00372,74.125.24.0-255,4320,240554,65,299922
17580,0.003724,74.125.24.0-255,2902,243456,65,299922
17581,0.003751,74.125.24.0-255,5738,249194,65,299922
17582,0.003758,74.125.24.0-255,5738,254932,65,299922
17583,0.003789,74.125.24.0-255,2184,257116,65,299922
17584,0.003857,74.125.24.0-255,1484,258600,65,299922
17585,0.00387,74.125.24.0-255,2902,261502,65,299922
17586,0.003893,74.125.24.0-255,5738,267240,65,299922
17587,0.003905,74.125.24.0-255,2902,270142,65,299922
17588,0.003923,74.125.24.0-255,2902,273044,65,299922
17589,0.003926,74.125.24.0-255,1484,274528,65,299922
17590,0.003965,74.125.24.0-255,2902,277430,65,299922
17591,0.003982,74.125.24.0-255,2184,279614,65,299922
17592,0.003985,74.125.24.0-255,1484,281098,65,299922
17593,0.003999,74.125.24.0-255,4320,285418,65,299922
17594,0.004005,74.125.24.0-255,4320,289738,65,299922
17595,0.004025,74.125.24.0-255,4320,294058,65,299922
17596,0.004028,74.125.24.0-255,1484,295542,65,299922
17597,0.004069,74.125.24.0-255,3318,298860,65,299922
17598,0.004104,74.125.24.0-255,105,298965,65,299922
17599,0.004145,74.125.24.0-255,129,299094,65,299922
17600,0.011253,172.31.40.0-255,66,299160,65,299922
17601,0.013774,172.31.40.0-255,105,299265,65,299922
17602,0.013826,172.31.40.0-255,105,299370,65,299922
17603,0.014128,172.31.40.0-255,90,299460,65,299922
17604,0.014146,172.31.40.0-255,66,299526,65,299922
17605,0.016299,74.125.24.0-255,66,299592,65,299922
17606,0.016317,74.125.24.0-255,66,299658,65,299922
17607,0.016607,74.125.24.0-255,66,299724,65,299922
17608,0.016637,74.125.24.0-255,66,299790,65,299922
17609,0.016648,172.31.40.0-255,66,299856,65,299922
17610,0.016653,74.125.24.0-255,66,299922,65,299922
17611,0.0,172.217.194.0-255,146,146,65,220498
17612,2.4e-05,172.31.40.0-255,66,212,65,220498
17613,3.1e-05,172.217.194.0-255,1484,1696,65,220498
17614,3.5e-05,172.31.40.0-255,66,1762,65,220498
17615,4.2e-05,172.217.194.0-255,2902,4664,65,220498
17616,5.4e-05,172.31.40.0-255,66,4730,65,220498
17617,6.2e-05,172.217.194.0-255,7156,11886,65,220498
17618,6.6e-05,172.31.40.0-255,66,11952,65,220498
17619,0.00011,172.31.40.0-255,66,12018,65,220498
17620,0.000118,172.217.194.0-255,6797,18815,65,220498
17621,0.00012,172.31.40.0-255,66,18881,65,220498
17622,0.000771,172.217.194.0-255,1484,20365,65,220498
17623,0.000778,172.31.40.0-255,66,20431,65,220498
17624,0.000787,172.217.194.0-255,2902,23333,65,220498
17625,0.000789,172.31.40.0-255,66,23399,65,220498
17626,0.000801,172.217.194.0-255,4320,27719,65,220498
17627,0.000804,172.31.40.0-255,66,27785,65,220498
17628,0.00083,172.217.194.0-255,1484,29269,65,220498
17629,0.000833,172.31.40.0-255,66,29335,65,220498
17630,0.00084,172.217.194.0-255,4320,33655,65,220498
17631,0.000842,172.31.40.0-255,66,33721,65,220498
17632,0.000847,172.217.194.0-255,4320,38041,65,220498
17633,0.00085,172.31.40.0-255,66,38107,65,220498
17634,0.000895,172.31.40.0-255,66,38173,65,220498
17635,0.000902,172.217.194.0-255,5738,43911,65,220498
17636,0.000905,172.31.40.0-255,66,43977,65,220498
17637,0.000935,172.217.194.0-255,1714,45691,65,220498
17638,0.000938,172.31.40.0-255,66,45757,65,220498
17639,0.00102,172.217.194.0-255,1484,47241,65,220498
17640,0.001024,172.31.40.0-255,66,47307,65,220498
17641,0.00103,172.217.194.0-255,2902,50209,65,220498
17642,0.001033,172.31.40.0-255,66,50275,65,220498
17643,0.001064,172.217.194.0-255,5738,56013,65,220498
17644,0.001067,172.31.40.0-255,66,56079,65,220498
17645,0.001074,172.217.194.0-255,5738,61817,65,220498
17646,0.001076,172.31.40.0-255,66,61883,65,220498
17647,0.001104,172.217.194.0-255,5738,67621,65,220498
17648,0.001107,172.31.40.0-255,66,67687,65,220498
17649,0.001134,172.31.40.0-255,66,67753,65,220498
17650,0.001139,172.217.194.0-255,3961,71714,65,220498
17651,0.001141,172.31.40.0-255,66,71780,65,220498
17652,0.001416,172.217.194.0-255,1484,73264,65,220498
17653,0.001435,172.217.194.0-255,2902,76166,65,220498
17654,0.001441,172.31.40.0-255,66,76232,65,220498
17655,0.001447,172.217.194.0-255,4320,80552,65,220498
17656,0.00145,172.31.40.0-255,66,80618,65,220498
17657,0.001479,172.217.194.0-255,1484,82102,65,220498
17658,0.001482,172.217.194.0-255,1484,83586,65,220498
17659,0.001485,172.31.40.0-255,66,83652,65,220498
17660,0.00152,172.31.40.0-255,66,83718,65,220498
17661,0.001523,172.217.194.0-255,1484,85202,65,220498
17662,0.001558,172.31.40.0-255,66,85268,65,220498
17663,0.001621,172.217.194.0-255,4320,89588,65,220498
17664,0.001624,172.31.40.0-255,66,89654,65,220498
17665,0.00163,172.217.194.0-255,5738,95392,65,220498
17666,0.001633,172.31.40.0-255,66,95458,65,220498
17667,0.001677,172.31.40.0-255,66,95524,65,220498
17668,0.001683,172.217.194.0-255,5738,101262,65,220498
17669,0.001685,172.31.40.0-255,66,101328,65,220498
17670,0.001722,172.217.194.0-255,1484,102812,65,220498
17671,0.001736,172.217.194.0-255,2902,105714,65,220498
17672,0.001739,172.31.40.0-255,66,105780,65,220498
17673,0.001759,172.217.194.0-255,2184,107964,65,220498
17674,0.001762,172.31.40.0-255,66,108030,65,220498
17675,0.001901,172.217.194.0-255,1484,109514,65,220498
17676,0.001921,172.217.194.0-255,2902,112416,65,220498
17677,0.001925,172.31.40.0-255,66,112482,65,220498
17678,0.001932,172.217.194.0-255,5738,118220,65,220498
17679,0.001935,172.31.40.0-255,66,118286,65,220498
17680,0.002,172.217.194.0-255,7156,125442,65,220498
17681,0.002004,172.31.40.0-255,66,125508,65,220498
17682,0.002019,172.31.40.0-255,66,125574,65,220498
17683,0.002037,172.217.194.0-255,1484,127058,65,220498
17684,0.002056,172.217.194.0-255,4320,131378,65,220498
17685,0.002058,172.31.40.0-255,66,131444,65,220498
17686,0.002077,172.217.194.0-255,2184,133628,65,220498
17687,0.00208,172.31.40.0-255,66,133694,65,220498
17688,0.002196,172.217.194.0-255,1484,135178,65,220498
17689,0.002213,172.217.194.0-255,2902,138080,65,220498
17690,0.002217,172.31.40.0-255,66,138146,65,220498
17691,0.002251,172.217.194.0-255,1484,139630,65,220498
17692,0.002268,172.217.194.0-255,2902,142532,65,220498
17693,0.002271,172.31.40.0-255,66,142598,65,220498
17694,0.002277,172.217.194.0-255,5738,148336,65,220498
17695,0.002279,172.31.40.0-255,66,148402,65,220498
17696,0.0023,172.217.194.0-255,1484,149886,65,220498
17697,0.002315,172.217.194.0-255,5738,155624,65,220498
17698,0.002318,172.31.40.0-255,66,155690,65,220498
17699,0.002345,172.217.194.0-255,4320,160010,65,220498
17700,0.002348,172.31.40.0-255,66,160076,65,220498
17701,0.002351,172.217.194.0-255,1484,161560,65,220498
17702,0.002378,172.217.194.0-255,6438,167998,65,220498
17703,0.00238,172.31.40.0-255,66,168064,65,220498
17704,0.002383,172.217.194.0-255,1484,169548,65,220498
17705,0.002408,172.217.194.0-255,7156,176704,65,220498
17706,0.00241,172.31.40.0-255,66,176770,65,220498
17707,0.002414,172.217.194.0-255,2902,179672,65,220498
17708,0.002416,172.31.40.0-255,66,179738,65,220498
17709,0.002449,172.31.40.0-255,66,179804,65,220498
17710,0.002462,172.31.40.0-255,66,179870,65,220498
17711,0.004791,172.217.194.0-255,5738,185608,65,220498
17712,0.0048,172.31.40.0-255,66,185674,65,220498
17713,0.007142,172.217.194.0-255,5738,191412,65,220498
17714,0.007162,172.31.40.0-255,66,191478,65,220498
17715,0.009504,172.217.194.0-255,5738,197216,65,220498
17716,0.009511,172.31.40.0-255,66,197282,65,220498
17717,0.011838,172.217.194.0-255,5738,203020,65,220498
17718,0.011846,172.31.40.0-255,66,203086,65,220498
17719,0.01418,172.217.194.0-255,5738,208824,65,220498
17720,0.014195,172.31.40.0-255,66,208890,65,220498
17721,0.016543,172.217.194.0-255,5738,214628,65,220498
17722,0.016556,172.31.40.0-255,66,214694,65,220498
17723,0.018896,172.217.194.0-255,5738,220432,65,220498
17724,0.018911,172.31.40.0-255,66,220498,65,220498
17725,0.0,74.125.68.0-255,146,146,65,229369
17726,2.3e-05,172.31.40.0-255,66,212,65,229369
17727,3e-05,74.125.68.0-255,1484,1696,65,229369
17728,3.4e-05,172.31.40.0-255,66,1762,65,229369
17729,4.8e-05,74.125.68.0-255,2902,4664,65,229369
17730,5.1e-05,172.31.40.0-255,66,4730,65,229369
17731,5.7e-05,74.125.68.0-255,4320,9050,65,229369
17732,5.9e-05,172.31.40.0-255,66,9116,65,229369
17733,9.4e-05,74.125.68.0-255,4876,13992,65,229369
17734,9.7e-05,172.31.40.0-255,66,14058,65,229369
17735,0.000129,74.125.68.0-255,5738,19796,65,229369
17736,0.000131,172.31.40.0-255,66,19862,65,229369
17737,0.000157,74.125.68.0-255,1484,21346,65,229369
17738,0.000159,172.31.40.0-255,66,21412,65,229369
17739,0.000164,74.125.68.0-255,2902,24314,65,229369
17740,0.000166,172.31.40.0-255,66,24380,65,229369
17741,0.000196,74.125.68.0-255,5738,30118,65,229369
17742,0.000198,172.31.40.0-255,66,30184,65,229369
17743,0.000237,74.125.68.0-255,1125,31309,65,229369
17744,0.000239,172.31.40.0-255,66,31375,65,229369
17745,0.000325,74.125.68.0-255,1484,32859,65,229369
17746,0.000329,172.31.40.0-255,66,32925,65,229369
17747,0.000333,74.125.68.0-255,1484,34409,65,229369
17748,0.000335,172.31.40.0-255,66,34475,65,229369
17749,0.00034,74.125.68.0-255,2902,37377,65,229369
17750,0.000348,172.31.40.0-255,66,37443,65,229369
17751,0.000351,74.125.68.0-255,1484,38927,65,229369
17752,0.000353,172.31.40.0-255,66,38993,65,229369
17753,0.000382,74.125.68.0-255,4320,43313,65,229369
17754,0.000385,172.31.40.0-255,66,43379,65,229369
17755,0.000396,172.31.40.0-255,66,43445,65,229369
17756,0.000424,74.125.68.0-255,1484,44929,65,229369
17757,0.000437,74.125.68.0-255,2902,47831,65,229369
17758,0.00044,172.31.40.0-255,66,47897,65,229369
17759,0.000474,74.125.68.0-255,7156,55053,65,229369
17760,0.000477,172.31.40.0-255,66,55119,65,229369
17761,0.000479,74.125.68.0-255,766,55885,65,229369
17762,0.000482,74.125.68.0-255,425,56310,65,229369
17763,0.000689,74.125.68.0-255,1484,57794,65,229369
17764,0.000694,172.31.40.0-255,66,57860,65,229369
17765,0.0007,74.125.68.0-255,2902,60762,65,229369
17766,0.000703,172.31.40.0-255,66,60828,65,229369
17767,0.000724,74.125.68.0-255,4320,65148,65,229369
17768,0.000726,172.31.40.0-255,66,65214,65,229369
17769,0.000746,74.125.68.0-255,1484,66698,65,229369
17770,0.000749,74.125.68.0-255,1484,68182,65,229369
17771,0.000751,172.31.40.0-255,66,68248,65,229369
17772,0.000782,74.125.68.0-255,2902,71150,65,229369
17773,0.000786,172.31.40.0-255,66,71216,65,229369
17774,0.00079,74.125.68.0-255,2902,74118,65,229369
17775,0.000792,172.31.40.0-255,66,74184,65,229369
17776,0.000814,74.125.68.0-255,1484,75668,65,229369
17777,0.000824,74.125.68.0-255,5738,81406,65,229369
17778,0.000827,172.31.40.0-255,66,81472,65,229369
17779,0.000859,172.31.40.0-255,66,81538,65,229369
17780,0.000865,74.125.68.0-255,5738,87276,65,229369
17781,0.000867,172.31.40.0-255,66,87342,65,229369
17782,0.000894,74.125.68.0-255,4320,91662,65,229369
17783,0.000897,172.31.40.0-255,66,91728,65,229369
17784,0.000903,74.125.68.0-255,6797,98525,65,229369
17785,0.000906,172.31.40.0-255,66,98591,65,229369
17786,0.000991,74.125.68.0-255,1484,100075,65,229369
17787,0.001003,74.125.68.0-255,1484,101559,65,229369
17788,0.001006,172.31.40.0-255,66,101625,65,229369
17789,0.001009,74.125.68.0-255,1484,103109,65,229369
17790,0.001032,74.125.68.0-255,1484,104593,65,229369
17791,0.001038,74.125.68.0-255,5738,110331,65,229369
17792,0.001073,74.125.68.0-255,1484,111815,65,229369
17793,0.001081,172.31.40.0-255,66,111881,65,229369
17794,0.001083,172.31.40.0-255,66,111947,65,229369
17795,0.001104,172.31.40.0-255,66,112013,65,229369
17796,0.001109,74.125.68.0-255,4320,116333,65,229369
17797,0.001111,172.31.40.0-255,66,116399,65,229369
17798,0.001117,74.125.68.0-255,5738,122137,65,229369
17799,0.00112,172.31.40.0-255,66,122203,65,229369
17800,0.001146,74.125.68.0-255,2184,124387,65,229369
17801,0.001148,172.31.40.0-255,66,124453,65,229369
17802,0.001229,74.125.68.0-255,1484,125937,65,229369
17803,0.001233,74.125.68.0-255,1484,127421,65,229369
17804,0.001235,172.31.40.0-255,66,127487,65,229369
17805,0.001262,74.125.68.0-255,2902,130389,65,229369
17806,0.001265,172.31.40.0-255,66,130455,65,229369
17807,0.001272,74.125.68.0-255,5738,136193,65,229369
17808,0.001275,172.31.40.0-255,66,136259,65,229369
17809,0.001309,172.31.40.0-255,66,136325,65,229369
17810,0.001365,172.31.40.0-255,66,136391,65,229369
17811,0.001397,74.125.68.0-255,4320,140711,65,229369
17812,0.00142,74.125.68.0-255,5738,146449,65,229369
17813,0.001425,172.31.40.0-255,66,146515,65,229369
17814,0.001433,74.125.68.0-255,1484,147999,65,229369
17815,0.001468,74.125.68.0-255,4320,152319,65,229369
17816,0.001501,74.125.68.0-255,1484,153803,65,229369
17817,0.001506,172.31.40.0-255,66,153869,65,229369
17818,0.001542,74.125.68.0-255,6438,160307,65,229369
17819,0.001549,172.31.40.0-255,66,160373,65,229369
17820,0.00225,74.125.68.0-255,1484,161857,65,229369
17821,0.002258,74.125.68.0-255,2902,164759,65,229369
17822,0.002262,172.31.40.0-255,66,164825,65,229369
17823,0.00227,74.125.68.0-255,4320,169145,65,229369
17824,0.002301,74.125.68.0-255,4320,173465,65,229369
17825,0.002315,74.125.68.0-255,4320,177785,65,229369
17826,0.002323,74.125.68.0-255,7156,184941,65,229369
17827,0.00234,74.125.68.0-255,766,185707,65,229369
17828,0.002448,74.125.68.0-255,1484,187191,65,229369
17829,0.002453,74.125.68.0-255,1484,188675,65,229369
17830,0.002464,74.125.68.0-255,1484,190159,65,229369
17831,0.002482,74.125.68.0-255,2902,193061,65,229369
17832,0.002505,74.125.68.0-255,2902,195963,65,229369
17833,0.002528,74.125.68.0-255,5738,201701,65,229369
17834,0.002547,74.125.68.0-255,2902,204603,65,229369
17835,0.00256,74.125.68.0-255,1484,206087,65,229369
17836,0.009735,172.31.40.0-255,66,206153,65,229369
17837,0.012297,74.125.68.0-255,5738,211891,65,229369
17838,0.012308,172.31.40.0-255,66,211957,65,229369
17839,0.014842,74.125.68.0-255,5738,217695,65,229369
17840,0.014857,172.31.40.0-255,66,217761,65,229369
17841,0.017381,74.125.68.0-255,5738,223499,65,229369
17842,0.01739,172.31.40.0-255,66,223565,65,229369
17843,0.019921,74.125.68.0-255,5738,229303,65,229369
17844,0.019928,172.31.40.0-255,66,229369,65,229369
17845,0.0,172.217.194.0-255,155,155,65,193746
17846,2.1e-05,172.31.40.0-255,66,221,65,193746
17847,2.9e-05,172.217.194.0-255,1484,1705,65,193746
17848,3.3e-05,172.31.40.0-255,66,1771,65,193746
17849,3.9e-05,172.217.194.0-255,2902,4673,65,193746
17850,4.3e-05,172.31.40.0-255,66,4739,65,193746
17851,4.8e-05,172.217.194.0-255,2902,7641,65,193746
17852,5.1e-05,172.31.40.0-255,66,7707,65,193746
17853,0.000102,172.217.194.0-255,6218,13925,65,193746
17854,0.000106,172.31.40.0-255,66,13991,65,193746
17855,0.000135,172.217.194.0-255,7156,21147,65,193746
17856,0.000137,172.31.40.0-255,66,21213,65,193746
17857,0.000181,172.31.40.0-255,66,21279,65,193746
17858,0.000514,172.217.194.0-255,1484,22763,65,193746
17859,0.00052,172.31.40.0-255,66,22829,65,193746
17860,0.000526,172.217.194.0-255,2902,25731,65,193746
17861,0.000528,172.31.40.0-255,66,25797,65,193746
17862,0.000535,172.217.194.0-255,4320,30117,65,193746
17863,0.000538,172.31.40.0-255,66,30183,65,193746
17864,0.000558,172.217.194.0-255,1484,31667,65,193746
17865,0.00056,172.31.40.0-255,66,31733,65,193746
17866,0.000568,172.217.194.0-255,6797,38530,65,193746
17867,0.000571,172.31.40.0-255,66,38596,65,193746
17868,0.000608,172.31.40.0-255,66,38662,65,193746
17869,0.000628,172.217.194.0-255,1484,40146,65,193746
17870,0.00063,172.31.40.0-255,66,40212,65,193746
17871,0.000651,172.217.194.0-255,3961,44173,65,193746
17872,0.000654,172.31.40.0-255,66,44239,65,193746
17873,0.001651,172.217.194.0-255,647,44886,65,193746
17874,0.001658,172.31.40.0-255,66,44952,65,193746
17875,0.001782,172.217.194.0-255,1484,46436,65,193746
17876,0.001787,172.217.194.0-255,1484,47920,65,193746
17877,0.001789,172.31.40.0-255,66,47986,65,193746
17878,0.00181,172.217.194.0-255,1484,49470,65,193746
17879,0.001816,172.217.194.0-255,5738,55208,65,193746
17880,0.001818,172.31.40.0-255,66,55274,65,193746
17881,0.001825,172.217.194.0-255,7156,62430,65,193746
17882,0.001827,172.31.40.0-255,66,62496,65,193746
17883,0.001849,172.217.194.0-255,1484,63980,65,193746
17884,0.001881,172.31.40.0-255,66,64046,65,193746
17885,0.001885,172.217.194.0-255,2184,66230,65,193746
17886,0.001887,172.31.40.0-255,66,66296,65,193746
17887,0.002512,172.217.194.0-255,1484,67780,65,193746
17888,0.002525,172.217.194.0-255,2902,70682,65,193746
17889,0.002528,172.31.40.0-255,66,70748,65,193746
17890,0.002531,172.217.194.0-255,1484,72232,65,193746
17891,0.002551,172.217.194.0-255,4320,76552,65,193746
17892,0.002553,172.31.40.0-255,66,76618,65,193746
17893,0.002559,172.217.194.0-255,4320,80938,65,193746
17894,0.002561,172.31.40.0-255,66,81004,65,193746
17895,0.002584,172.31.40.0-255,66,81070,65,193746
17896,0.002595,172.31.40.0-255,66,81136,65,193746
17897,0.002616,172.217.194.0-255,2184,83320,65,193746
17898,0.002619,172.31.40.0-255,66,83386,65,193746
17899,0.002641,172.217.194.0-255,2902,86288,65,193746
17900,0.002644,172.31.40.0-255,66,86354,65,193746
17901,0.002681,172.31.40.0-255,66,86420,65,193746
17902,0.002686,172.217.194.0-255,4320,90740,65,193746
17903,0.002689,172.31.40.0-255,66,90806,65,193746
17904,0.002723,172.31.40.0-255,66,90872,65,193746
17905,0.002824,172.217.194.0-255,1484,92356,65,193746
17906,0.002829,172.217.194.0-255,2902,95258,65,193746
17907,0.002831,172.31.40.0-255,66,95324,65,193746
17908,0.002851,172.217.194.0-255,2902,98226,65,193746
17909,0.002854,172.31.40.0-255,66,98292,65,193746
17910,0.002859,172.217.194.0-255,4320,102612,65,193746
17911,0.002862,172.31.40.0-255,66,102678,65,193746
17912,0.002884,172.217.194.0-255,4320,106998,65,193746
17913,0.002887,172.31.40.0-255,66,107064,65,193746
17914,0.002889,172.217.194.0-255,1484,108548,65,193746
17915,0.002892,172.217.194.0-255,1484,110032,65,193746
17916,0.002894,172.31.40.0-255,66,110098,65,193746
17917,0.002898,172.217.194.0-255,1484,111582,65,193746
17918,0.002923,172.217.194.0-255,4320,115902,65,193746
17919,0.002926,172.31.40.0-255,66,115968,65,193746
17920,0.002943,172.217.194.0-255,1484,117452,65,193746
17921,0.002946,172.31.40.0-255,78,117530,65,193746
17922,0.002982,172.217.194.0-255,4320,121850,65,193746
17923,0.002984,172.31.40.0-255,78,121928,65,193746
17924,0.003003,172.31.40.0-255,66,121994,65,193746
17925,0.003009,172.217.194.0-255,5738,127732,65,193746
17926,0.003011,172.31.40.0-255,66,127798,65,193746
17927,0.003022,172.31.40.0-255,66,127864,65,193746
17928,0.003062,172.217.194.0-255,4320,132184,65,193746
17929,0.003065,172.217.194.0-255,1484,133668,65,193746
17930,0.00308,172.217.194.0-255,2902,136570,65,193746
17931,0.003089,172.217.194.0-255,1484,138054,65,193746
17932,0.003132,172.217.194.0-255,1484,139538,65,193746
17933,0.003143,172.217.194.0-255,766,140304,65,193746
17934,0.003185,172.217.194.0-255,1484,141788,65,193746
17935,0.003189,172.217.194.0-255,2902,144690,65,193746
17936,0.003194,172.217.194.0-255,4320,149010,65,193746
17937,0.003204,172.217.194.0-255,1484,150494,65,193746
17938,0.003231,172.217.194.0-255,1484,151978,65,193746
17939,0.003259,172.217.194.0-255,1484,153462,65,193746
17940,0.003314,172.217.194.0-255,5738,159200,65,193746
17941,0.003362,172.217.194.0-255,2902,162102,65,193746
17942,0.003395,172.217.194.0-255,2184,164286,65,193746
17943,0.003402,172.217.194.0-255,5738,170024,65,193746
17944,0.003408,172.217.194.0-255,4320,174344,65,193746
17945,0.003453,172.217.194.0-255,2902,177246,65,193746
17946,0.003483,172.217.194.0-255,4320,181566,65,193746
17947,0.00354,172.217.194.0-255,5020,186586,65,193746
17948,0.003546,172.217.194.0-255,4320,190906,65,193746
17949,0.003564,172.217.194.0-255,2381,193287,65,193746
17950,0.003568,172.217.194.0-255,105,193392,65,193746
17951,0.012468,172.217.194.0-255,105,193497,65,193746
17952,0.012488,172.31.40.0-255,78,193575,65,193746
17953,0.015926,172.31.40.0-255,105,193680,65,193746
17954,0.018213,172.217.194.0-255,66,193746,65,193746
17955,0.0,74.125.24.0-255,147,147,65,155431
17956,2.3e-05,172.31.40.0-255,66,213,65,155431
17957,3e-05,74.125.24.0-255,1484,1697,65,155431
17958,3.4e-05,172.31.40.0-255,66,1763,65,155431
17959,4e-05,74.125.24.0-255,2902,4665,65,155431
17960,4.4e-05,172.31.40.0-255,66,4731,65,155431
17961,5e-05,74.125.24.0-255,5738,10469,65,155431
17962,5.3e-05,172.31.40.0-255,66,10535,65,155431
17963,8.5e-05,172.31.40.0-255,66,10601,65,155431
17964,0.000131,172.31.40.0-255,66,10667,65,155431
17965,0.000143,172.31.40.0-255,66,10733,65,155431
17966,0.00016,74.125.24.0-255,5020,15753,65,155431
17967,0.000162,172.31.40.0-255,66,15819,65,155431
17968,0.00018,74.125.24.0-255,1484,17303,65,155431
17969,0.000182,172.31.40.0-255,66,17369,65,155431
17970,0.000185,74.125.24.0-255,1484,18853,65,155431
17971,0.000187,172.31.40.0-255,66,18919,65,155431
17972,0.000215,74.125.24.0-255,1484,20403,65,155431
17973,0.000217,172.31.40.0-255,66,20469,65,155431
17974,0.000225,74.125.24.0-255,5738,26207,65,155431
17975,0.000227,172.31.40.0-255,66,26273,65,155431
17976,0.000235,74.125.24.0-255,6797,33070,65,155431
17977,0.000237,172.31.40.0-255,66,33136,65,155431
17978,0.000876,74.125.24.0-255,645,33781,65,155431
17979,0.000881,172.31.40.0-255,66,33847,65,155431
17980,0.001088,74.125.24.0-255,1484,35331,65,155431
17981,0.001093,172.31.40.0-255,66,35397,65,155431
17982,0.001127,74.125.24.0-255,2902,38299,65,155431
17983,0.001131,172.31.40.0-255,66,38365,65,155431
17984,0.001152,74.125.24.0-255,4320,42685,65,155431
17985,0.001177,74.125.24.0-255,7156,49841,65,155431
17986,0.001194,74.125.24.0-255,1484,51325,65,155431
17987,0.001201,74.125.24.0-255,7156,58481,65,155431
17988,0.001245,74.125.24.0-255,7156,65637,65,155431
17989,0.001264,74.125.24.0-255,2184,67821,65,155431
17990,0.001911,74.125.24.0-255,1484,69305,65,155431
17991,0.001919,74.125.24.0-255,2902,72207,65,155431
17992,0.001934,74.125.24.0-255,1484,73691,65,155431
17993,0.001951,74.125.24.0-255,4320,78011,65,155431
17994,0.001958,74.125.24.0-255,5738,83749,65,155431
17995,0.002023,74.125.24.0-255,5020,88769,65,155431
17996,0.002052,74.125.24.0-255,1484,90253,65,155431
17997,0.002069,74.125.24.0-255,2902,93155,65,155431
17998,0.002074,74.125.24.0-255,2902,96057,65,155431
17999,0.002091,74.125.24.0-255,2902,98959,65,155431
18000,0.002094,74.125.24.0-255,1484,100443,65,155431
18001,0.002162,74.125.24.0-255,3602,104045,65,155431
18002,0.002169,74.125.24.0-255,5738,109783,65,155431
18003,0.002187,74.125.24.0-255,2902,112685,65,155431
18004,0.002225,74.125.24.0-255,5738,118423,65,155431
18005,0.00223,74.125.24.0-255,3602,122025,65,155431
18006,0.002279,74.125.24.0-255,4320,126345,65,155431
18007,0.005939,172.31.40.0-255,66,126411,65,155431
18008,0.008195,74.125.24.0-255,5738,132149,65,155431
18009,0.008202,172.31.40.0-255,66,132215,65,155431
18010,0.010473,74.125.24.0-255,5738,137953,65,155431
18011,0.010479,172.31.40.0-255,66,138019,65,155431
18012,0.012726,74.125.24.0-255,5738,143757,65,155431
18013,0.012733,172.31.40.0-255,66,143823,65,155431
18014,0.015013,74.125.24.0-255,5738,149561,65,155431
18015,0.015021,172.31.40.0-255,66,149627,65,155431
18016,0.017283,74.125.24.0-255,5738,155365,65,155431
18017,0.018388,172.31.40.0-255,66,155431,65,155431
18018,0.0,74.125.130.0-255,153,153,65,253963
18019,1.5e-05,172.31.40.0-255,66,219,65,253963
18020,2.2e-05,74.125.130.0-255,1484,1703,65,253963
18021,2.7e-05,172.31.40.0-255,66,1769,65,253963
18022,3e-05,74.125.130.0-255,1484,3253,65,253963
18023,3.2e-05,172.31.40.0-255,66,3319,65,253963
18024,4.5e-05,74.125.130.0-255,2902,6221,65,253963
18025,4.8e-05,172.31.40.0-255,66,6287,65,253963
18026,5.3e-05,74.125.130.0-255,2902,9189,65,253963
18027,5.7e-05,172.31.40.0-255,66,9255,65,253963
18028,9e-05,74.125.130.0-255,2902,12157,65,253963
18029,9.2e-05,172.31.40.0-255,66,12223,65,253963
18030,9.7e-05,74.125.130.0-255,2031,14254,65,253963
18031,0.0001,172.31.40.0-255,66,14320,65,253963
18032,0.000138,74.125.130.0-255,1484,15804,65,253963
18033,0.00014,172.31.40.0-255,66,15870,65,253963
18034,0.000167,74.125.130.0-255,2902,18772,65,253963
18035,0.00017,172.31.40.0-255,66,18838,65,253963
18036,0.000176,74.125.130.0-255,5738,24576,65,253963
18037,0.000179,172.31.40.0-255,66,24642,65,253963
18038,0.000228,74.125.130.0-255,6797,31439,65,253963
18039,0.00023,172.31.40.0-255,66,31505,65,253963
18040,0.00034,74.125.130.0-255,1484,32989,65,253963
18041,0.000344,172.31.40.0-255,66,33055,65,253963
18042,0.000348,74.125.130.0-255,1484,34539,65,253963
18043,0.00035,172.31.40.0-255,66,34605,65,253963
18044,0.000386,74.125.130.0-255,1484,36089,65,253963
18045,0.000389,172.31.40.0-255,66,36155,65,253963
18046,0.000396,74.125.130.0-255,5738,41893,65,253963
18047,0.000398,172.31.40.0-255,66,41959,65,253963
18048,0.000403,74.125.130.0-255,2902,44861,65,253963
18049,0.000405,172.31.40.0-255,66,44927,65,253963
18050,0.00041,74.125.130.0-255,3961,48888,65,253963
18051,0.000413,172.31.40.0-255,66,48954,65,253963
18052,0.000446,172.31.40.0-255,66,49020,65,253963
18053,0.00045,74.125.130.0-255,2902,51922,65,253963
18054,0.000452,172.31.40.0-255,66,51988,65,253963
18055,0.000497,74.125.130.0-255,5379,57367,65,253963
18056,0.0005,172.31.40.0-255,66,57433,65,253963
18057,0.000547,74.125.130.0-255,358,57791,65,253963
18058,0.000566,74.125.130.0-255,385,58176,65,253963
18059,0.000804,74.125.130.0-255,1484,59660,65,253963
18060,0.000811,172.31.40.0-255,66,59726,65,253963
18061,0.000822,74.125.130.0-255,2902,62628,65,253963
18062,0.000824,172.31.40.0-255,66,62694,65,253963
18063,0.000831,74.125.130.0-255,1484,64178,65,253963
18064,0.000858,74.125.130.0-255,4320,68498,65,253963
18065,0.00086,172.31.40.0-255,66,68564,65,253963
18066,0.000868,74.125.130.0-255,7156,75720,65,253963
18067,0.00087,172.31.40.0-255,66,75786,65,253963
18068,0.000894,74.125.130.0-255,5738,81524,65,253963
18069,0.000897,172.31.40.0-255,66,81590,65,253963
18070,0.000925,74.125.130.0-255,7156,88746,65,253963
18071,0.000928,172.31.40.0-255,66,88812,65,253963
18072,0.000931,74.125.130.0-255,1484,90296,65,253963
18073,0.000957,74.125.130.0-255,2184,92480,65,253963
18074,0.000961,172.31.40.0-255,66,92546,65,253963
18075,0.001102,74.125.130.0-255,1484,94030,65,253963
18076,0.00112,74.125.130.0-255,2902,96932,65,253963
18077,0.001124,172.31.40.0-255,66,96998,65,253963
18078,0.001154,74.125.130.0-255,4320,101318,65,253963
18079,0.001158,172.31.40.0-255,66,101384,65,253963
18080,0.001175,74.125.130.0-255,4320,105704,65,253963
18081,0.001182,172.31.40.0-255,66,105770,65,253963
18082,0.001207,74.125.130.0-255,1484,107254,65,253963
18083,0.001214,74.125.130.0-255,4320,111574,65,253963
18084,0.001216,172.31.40.0-255,66,111640,65,253963
18085,0.001221,74.125.130.0-255,2902,114542,65,253963
18086,0.001223,172.31.40.0-255,66,114608,65,253963
18087,0.001245,74.125.130.0-255,2902,117510,65,253963
18088,0.001247,172.31.40.0-255,66,117576,65,253963
18089,0.001253,74.125.130.0-255,4320,121896,65,253963
18090,0.001255,172.31.40.0-255,66,121962,65,253963
18091,0.001287,74.125.130.0-255,5020,126982,65,253963
18092,0.00129,172.31.40.0-255,66,127048,65,253963
18093,0.001413,74.125.130.0-255,1484,128532,65,253963
18094,0.001418,74.125.130.0-255,1484,130016,65,253963
18095,0.001421,172.31.40.0-255,66,130082,65,253963
18096,0.001444,74.125.130.0-255,1484,131566,65,253963
18097,0.00145,74.125.130.0-255,4320,135886,65,253963
18098,0.001452,172.31.40.0-255,66,135952,65,253963
18099,0.001471,74.125.130.0-255,4320,140272,65,253963
18100,0.001477,172.31.40.0-255,66,140338,65,253963
18101,0.001501,74.125.130.0-255,1484,141822,65,253963
18102,0.001513,172.31.40.0-255,66,141888,65,253963
18103,0.00153,74.125.130.0-255,1484,143372,65,253963
18104,0.001559,172.31.40.0-255,66,143438,65,253963
18105,0.001598,172.31.40.0-255,66,143504,65,253963
18106,0.001604,74.125.130.0-255,5738,149242,65,253963
18107,0.001606,172.31.40.0-255,66,149308,65,253963
18108,0.001613,74.125.130.0-255,7156,156464,65,253963
18109,0.001619,172.31.40.0-255,66,156530,65,253963
18110,0.001664,74.125.130.0-255,3602,160132,65,253963
18111,0.001668,172.31.40.0-255,66,160198,65,253963
18112,0.001771,74.125.130.0-255,1484,161682,65,253963
18113,0.001806,74.125.130.0-255,1484,163166,65,253963
18114,0.001809,172.31.40.0-255,66,163232,65,253963
18115,0.001834,74.125.130.0-255,1484,164716,65,253963
18116,0.00184,74.125.130.0-255,5738,170454,65,253963
18117,0.001842,172.31.40.0-255,66,170520,65,253963
18118,0.001848,74.125.130.0-255,4320,174840,65,253963
18119,0.00185,172.31.40.0-255,66,174906,65,253963
18120,0.001872,74.125.130.0-255,2902,177808,65,253963
18121,0.001875,172.31.40.0-255,66,177874,65,253963
18122,0.00189,172.31.40.0-255,66,177940,65,253963
18123,0.001915,74.125.130.0-255,2902,180842,65,253963
18124,0.001918,172.31.40.0-255,66,180908,65,253963
18125,0.001923,74.125.130.0-255,3602,184510,65,253963
18126,0.001925,172.31.40.0-255,66,184576,65,253963
18127,0.001952,74.125.130.0-255,2902,187478,65,253963
18128,0.001955,172.31.40.0-255,66,187544,65,253963
18129,0.00196,74.125.130.0-255,4320,191864,65,253963
18130,0.001963,172.31.40.0-255,66,191930,65,253963
18131,0.002001,172.31.40.0-255,66,191996,65,253963
18132,0.002005,74.125.130.0-255,2902,194898,65,253963
18133,0.002007,172.31.40.0-255,66,194964,65,253963
18134,0.002037,74.125.130.0-255,5738,200702,65,253963
18135,0.002042,172.31.40.0-255,66,200768,65,253963
18136,0.002062,74.125.130.0-255,7156,207924,65,253963
18137,0.002065,172.31.40.0-255,66,207990,65,253963
18138,0.002068,74.125.130.0-255,1484,209474,65,253963
18139,0.004078,74.125.130.0-255,4320,213794,65,253963
18140,0.004085,172.31.40.0-255,66,213860,65,253963
18141,0.006111,74.125.130.0-255,2902,216762,65,253963
18142,0.006114,172.31.40.0-255,66,216828,65,253963
18143,0.006144,74.125.130.0-255,2902,219730,65,253963
18144,0.006147,172.31.40.0-255,66,219796,65,253963
18145,0.007496,172.31.40.0-255,101,219897,65,253963
18146,0.008124,74.125.130.0-255,2902,222799,65,253963
18147,0.00813,172.31.40.0-255,66,222865,65,253963
18148,0.008164,74.125.130.0-255,2902,225767,65,253963
18149,0.008167,172.31.40.0-255,66,225833,65,253963
18150,0.009482,74.125.130.0-255,66,225899,65,253963
18151,0.010148,74.125.130.0-255,2902,228801,65,253963
18152,0.010155,172.31.40.0-255,66,228867,65,253963
18153,0.010189,74.125.130.0-255,2902,231769,65,253963
18154,0.010192,172.31.40.0-255,66,231835,65,253963
18155,0.012195,74.125.130.0-255,2902,234737,65,253963
18156,0.012203,172.31.40.0-255,66,234803,65,253963
18157,0.01223,74.125.130.0-255,2902,237705,65,253963
18158,0.012233,172.31.40.0-255,66,237771,65,253963
18159,0.014231,74.125.130.0-255,2902,240673,65,253963
18160,0.014238,172.31.40.0-255,66,240739,65,253963
18161,0.014269,74.125.130.0-255,2902,243641,65,253963
18162,0.014273,172.31.40.0-255,66,243707,65,253963
18163,0.016273,74.125.130.0-255,4320,248027,65,253963
18164,0.016282,172.31.40.0-255,66,248093,65,253963
18165,0.016308,74.125.130.0-255,1484,249577,65,253963
18166,0.018313,74.125.130.0-255,4320,253897,65,253963
18167,0.018321,172.31.40.0-255,66,253963,65,253963
18168,0.0,172.217.194.0-255,153,153,65,246352
18169,4.9e-05,172.31.40.0-255,66,219,65,246352
18170,5.7e-05,172.217.194.0-255,1484,1703,65,246352
18171,6.1e-05,172.31.40.0-255,66,1769,65,246352
18172,6.6e-05,172.217.194.0-255,2902,4671,65,246352
18173,7.6e-05,172.31.40.0-255,66,4737,65,246352
18174,8.3e-05,172.217.194.0-255,5738,10475,65,246352
18175,8.5e-05,172.31.40.0-255,66,10541,65,246352
18176,9e-05,172.217.194.0-255,3482,14023,65,246352
18177,9.3e-05,172.31.40.0-255,66,14089,65,246352
18178,9.8e-05,172.217.194.0-255,4320,18409,65,246352
18179,0.000101,172.31.40.0-255,66,18475,65,246352
18180,0.000148,172.31.40.0-255,66,18541,65,246352
18181,0.000178,172.217.194.0-255,2543,21084,65,246352
18182,0.000181,172.31.40.0-255,66,21150,65,246352
18183,0.000214,172.217.194.0-255,2902,24052,65,246352
18184,0.000217,172.31.40.0-255,66,24118,65,246352
18185,0.000245,172.217.194.0-255,2902,27020,65,246352
18186,0.000248,172.31.40.0-255,66,27086,65,246352
18187,0.000256,172.217.194.0-255,7156,34242,65,246352
18188,0.000258,172.31.40.0-255,66,34308,65,246352
18189,0.000285,172.217.194.0-255,3961,38269,65,246352
18190,0.000288,172.31.40.0-255,66,38335,65,246352
18191,0.000531,172.217.194.0-255,1484,39819,65,246352
18192,0.000535,172.31.40.0-255,66,39885,65,246352
18193,0.000542,172.217.194.0-255,2902,42787,65,246352
18194,0.000544,172.31.40.0-255,66,42853,65,246352
18195,0.000557,172.217.194.0-255,5738,48591,65,246352
18196,0.000559,172.31.40.0-255,66,48657,65,246352
18197,0.000591,172.217.194.0-255,6797,55454,65,246352
18198,0.000594,172.31.40.0-255,66,55520,65,246352
18199,0.000669,172.217.194.0-255,1484,57004,65,246352
18200,0.000674,172.217.194.0-255,1484,58488,65,246352
18201,0.000677,172.31.40.0-255,66,58554,65,246352
18202,0.000703,172.217.194.0-255,1484,60038,65,246352
18203,0.000711,172.217.194.0-255,5738,65776,65,246352
18204,0.000713,172.31.40.0-255,66,65842,65,246352
18205,0.000744,172.217.194.0-255,4320,70162,65,246352
18206,0.000747,172.31.40.0-255,66,70228,65,246352
18207,0.000776,172.217.194.0-255,3123,73351,65,246352
18208,0.000779,172.31.40.0-255,66,73417,65,246352
18209,0.000862,172.217.194.0-255,1484,74901,65,246352
18210,0.000876,172.217.194.0-255,2902,77803,65,246352
18211,0.000879,172.31.40.0-255,66,77869,65,246352
18212,0.000885,172.217.194.0-255,5738,83607,65,246352
18213,0.000887,172.31.40.0-255,66,83673,65,246352
18214,0.000936,172.217.194.0-255,1484,85157,65,246352
18215,0.000952,172.217.194.0-255,5379,90536,65,246352
18216,0.000956,172.31.40.0-255,66,90602,65,246352
18217,0.001307,172.217.194.0-255,1484,92086,65,246352
18218,0.001317,172.217.194.0-255,2902,94988,65,246352
18219,0.001321,172.31.40.0-255,66,95054,65,246352
18220,0.001327,172.217.194.0-255,2902,97956,65,246352
18221,0.00133,172.31.40.0-255,66,98022,65,246352
18222,0.001354,172.217.194.0-255,2902,100924,65,246352
18223,0.001362,172.31.40.0-255,66,100990,65,246352
18224,0.001374,172.31.40.0-255,66,101056,65,246352
18225,0.001445,172.31.40.0-255,66,101122,65,246352
18226,0.001472,172.217.194.0-255,2184,103306,65,246352
18227,0.001474,172.31.40.0-255,66,103372,65,246352
18228,0.001516,172.31.40.0-255,66,103438,65,246352
18229,0.001547,172.31.40.0-255,66,103504,65,246352
18230,0.001551,172.217.194.0-255,2902,106406,65,246352
18231,0.001553,172.31.40.0-255,66,106472,65,246352
18232,0.001602,172.217.194.0-255,5738,112210,65,246352
18233,0.001607,172.31.40.0-255,66,112276,65,246352
18234,0.001632,172.217.194.0-255,766,113042,65,246352
18235,0.001639,172.217.194.0-255,7156,120198,65,246352
18236,0.001643,172.31.40.0-255,66,120264,65,246352
18237,0.001674,172.31.40.0-255,66,120330,65,246352
18238,0.001694,172.217.194.0-255,4320,124650,65,246352
18239,0.001698,172.31.40.0-255,66,124716,65,246352
18240,0.001702,172.217.194.0-255,2902,127618,65,246352
18241,0.001704,172.31.40.0-255,66,127684,65,246352
18242,0.001752,172.31.40.0-255,66,127750,65,246352
18243,0.001756,172.217.194.0-255,2902,130652,65,246352
18244,0.001758,172.31.40.0-255,66,130718,65,246352
18245,0.001793,172.217.194.0-255,4320,135038,65,246352
18246,0.001795,172.31.40.0-255,66,135104,65,246352
18247,0.001806,172.31.40.0-255,66,135170,65,246352
18248,0.001852,172.217.194.0-255,5738,140908,65,246352
18249,0.001855,172.31.40.0-255,66,140974,65,246352
18250,0.001861,172.217.194.0-255,5738,146712,65,246352
18251,0.001863,172.31.40.0-255,66,146778,65,246352
18252,0.001877,172.217.194.0-255,1484,148262,65,246352
18253,0.001906,172.217.194.0-255,5020,153282,65,246352
18254,0.001908,172.31.40.0-255,66,153348,65,246352
18255,0.001931,172.217.194.0-255,1484,154832,65,246352
18256,0.001948,172.217.194.0-255,4320,159152,65,246352
18257,0.00195,172.31.40.0-255,66,159218,65,246352
18258,0.00198,172.217.194.0-255,5738,164956,65,246352
18259,0.001982,172.31.40.0-255,66,165022,65,246352
18260,0.001987,172.217.194.0-255,4320,169342,65,246352
18261,0.001989,172.31.40.0-255,66,169408,65,246352
18262,0.002025,172.31.40.0-255,66,169474,65,246352
18263,0.002037,172.31.40.0-255,66,169540,65,246352
18264,0.002065,172.217.194.0-255,2902,172442,65,246352
18265,0.002067,172.31.40.0-255,66,172508,65,246352
18266,0.002072,172.217.194.0-255,4320,176828,65,246352
18267,0.002074,172.31.40.0-255,66,176894,65,246352
18268,0.002145,172.31.40.0-255,66,176960,65,246352
18269,0.002156,172.31.40.0-255,66,177026,65,246352
18270,0.002165,172.217.194.0-255,4320,181346,65,246352
18271,0.002167,172.31.40.0-255,66,181412,65,246352
18272,0.002192,172.217.194.0-255,2184,183596,65,246352
18273,0.002194,172.31.40.0-255,66,183662,65,246352
18274,0.002227,172.217.194.0-255,1484,185146,65,246352
18275,0.002261,172.217.194.0-255,2902,188048,65,246352
18276,0.002265,172.31.40.0-255,66,188114,65,246352
18277,0.00227,172.217.194.0-255,4320,192434,65,246352
18278,0.002272,172.31.40.0-255,66,192500,65,246352
18279,0.002277,172.217.194.0-255,2902,195402,65,246352
18280,0.002284,172.31.40.0-255,66,195468,65,246352
18281,0.00232,172.217.194.0-255,5738,201206,65,246352
18282,0.002323,172.31.40.0-255,66,201272,65,246352
18283,0.002335,172.31.40.0-255,66,201338,65,246352
18284,0.002345,172.217.194.0-255,4320,205658,65,246352
18285,0.002348,172.31.40.0-255,66,205724,65,246352
18286,0.004627,172.217.194.0-255,5738,211462,65,246352
18287,0.00465,172.31.40.0-255,66,211528,65,246352
18288,0.006952,172.217.194.0-255,5738,217266,65,246352
18289,0.006966,172.31.40.0-255,66,217332,65,246352
18290,0.009238,172.217.194.0-255,5738,223070,65,246352
18291,0.009241,172.31.40.0-255,66,223136,65,246352
18292,0.011495,172.217.194.0-255,5738,228874,65,246352
18293,0.011509,172.31.40.0-255,66,228940,65,246352
18294,0.013789,172.217.194.0-255,5738,234678,65,246352
18295,0.0138,172.31.40.0-255,66,234744,65,246352
18296,0.016068,172.217.194.0-255,5738,240482,65,246352
18297,0.016081,172.31.40.0-255,66,240548,65,246352
18298,0.018361,172.217.194.0-255,5738,246286,65,246352
18299,0.018369,172.31.40.0-255,66,246352,65,246352
18300,0.0,172.217.24.0-255,150,150,65,190603
18301,1.7e-05,172.31.40.0-255,66,216,65,190603
18302,2.3e-05,172.217.24.0-255,1484,1700,65,190603
18303,2.7e-05,172.31.40.0-255,66,1766,65,190603
18304,3.2e-05,172.217.24.0-255,2902,4668,65,190603
18305,4.1e-05,172.31.40.0-255,66,4734,65,190603
18306,4.6e-05,172.217.24.0-255,4320,9054,65,190603
18307,4.8e-05,172.31.40.0-255,66,9120,65,190603
18308,9e-05,172.31.40.0-255,66,9186,65,190603
18309,9.3e-05,172.217.24.0-255,1484,10670,65,190603
18310,9.5e-05,172.31.40.0-255,66,10736,65,190603
18311,9.9e-05,172.217.24.0-255,2902,13638,65,190603
18312,0.0001,172.31.40.0-255,66,13704,65,190603
18313,0.000109,172.217.24.0-255,4320,18024,65,190603
18314,0.000111,172.31.40.0-255,66,18090,65,190603
18315,0.000142,172.217.24.0-255,3961,22051,65,190603
18316,0.000144,172.31.40.0-255,66,22117,65,190603
18317,0.000176,172.217.24.0-255,1484,23601,65,190603
18318,0.000179,172.31.40.0-255,66,23667,65,190603
18319,0.000204,172.217.24.0-255,2902,26569,65,190603
18320,0.000205,172.31.40.0-255,66,26635,65,190603
18321,0.000211,172.217.24.0-255,5738,32373,65,190603
18322,0.000213,172.31.40.0-255,66,32439,65,190603
18323,0.000244,172.217.24.0-255,6797,39236,65,190603
18324,0.000246,172.31.40.0-255,66,39302,65,190603
18325,0.000331,172.217.24.0-255,1484,40786,65,190603
18326,0.000334,172.31.40.0-255,66,40852,65,190603
18327,0.000338,172.217.24.0-255,2902,43754,65,190603
18328,0.00034,172.31.40.0-255,66,43820,65,190603
18329,0.000343,172.217.24.0-255,1484,45304,65,190603
18330,0.000344,172.31.40.0-255,66,45370,65,190603
18331,0.000403,172.217.24.0-255,4320,49690,65,190603
18332,0.000406,172.31.40.0-255,66,49756,65,190603
18333,0.000413,172.217.24.0-255,7088,56844,65,190603
18334,0.000415,172.31.40.0-255,66,56910,65,190603
18335,0.001091,172.217.24.0-255,137,57047,65,190603
18336,0.00128,172.217.24.0-255,1484,58531,65,190603
18337,0.001286,172.31.40.0-255,66,58597,65,190603
18338,0.001293,172.217.24.0-255,2902,61499,65,190603
18339,0.001295,172.31.40.0-255,66,61565,65,190603
18340,0.0013,172.217.24.0-255,2902,64467,65,190603
18341,0.001302,172.31.40.0-255,66,64533,65,190603
18342,0.001333,172.217.24.0-255,2902,67435,65,190603
18343,0.001335,172.31.40.0-255,66,67501,65,190603
18344,0.001345,172.217.24.0-255,4320,71821,65,190603
18345,0.001347,172.31.40.0-255,66,71887,65,190603
18346,0.001353,172.217.24.0-255,5379,77266,65,190603
18347,0.001355,172.31.40.0-255,66,77332,65,190603
18348,0.001367,172.31.40.0-255,66,77398,65,190603
18349,0.001372,172.217.24.0-255,2543,79941,65,190603
18350,0.001374,172.31.40.0-255,66,80007,65,190603
18351,0.001449,172.217.24.0-255,1484,81491,65,190603
18352,0.001453,172.217.24.0-255,1484,82975,65,190603
18353,0.001456,172.31.40.0-255,66,83041,65,190603
18354,0.001488,172.217.24.0-255,1484,84525,65,190603
18355,0.001495,172.217.24.0-255,5738,90263,65,190603
18356,0.001497,172.31.40.0-255,66,90329,65,190603
18357,0.001527,172.31.40.0-255,66,90395,65,190603
18358,0.001537,172.31.40.0-255,66,90461,65,190603
18359,0.001559,172.217.24.0-255,2184,92645,65,190603
18360,0.001561,172.31.40.0-255,66,92711,65,190603
18361,0.001582,172.217.24.0-255,2902,95613,65,190603
18362,0.001585,172.31.40.0-255,66,95679,65,190603
18363,0.00159,172.217.24.0-255,2902,98581,65,190603
18364,0.001592,172.31.40.0-255,66,98647,65,190603
18365,0.001616,172.217.24.0-255,4320,102967,65,190603
18366,0.001619,172.31.40.0-255,66,103033,65,190603
18367,0.001625,172.217.24.0-255,5738,108771,65,190603
18368,0.001627,172.31.40.0-255,66,108837,65,190603
18369,0.001663,172.217.24.0-255,2902,111739,65,190603
18370,0.001666,172.31.40.0-255,66,111805,65,190603
18371,0.001678,172.31.40.0-255,66,111871,65,190603
18372,0.001685,172.217.24.0-255,5020,116891,65,190603
18373,0.001687,172.31.40.0-255,66,116957,65,190603
18374,0.001786,172.217.24.0-255,1484,118441,65,190603
18375,0.001792,172.217.24.0-255,2902,121343,65,190603
18376,0.001795,172.31.40.0-255,66,121409,65,190603
18377,0.001803,172.217.24.0-255,5738,127147,65,190603
18378,0.001806,172.31.40.0-255,66,127213,65,190603
18379,0.001816,172.217.24.0-255,4320,131533,65,190603
18380,0.001818,172.31.40.0-255,66,131599,65,190603
18381,0.001859,172.31.40.0-255,66,131665,65,190603
18382,0.001866,172.217.24.0-255,7156,138821,65,190603
18383,0.001868,172.31.40.0-255,66,138887,65,190603
18384,0.001895,172.217.24.0-255,766,139653,65,190603
18385,0.003796,172.217.24.0-255,4320,143973,65,190603
18386,0.003801,172.31.40.0-255,66,144039,65,190603
18387,0.005749,172.217.24.0-255,5738,149777,65,190603
18388,0.005759,172.31.40.0-255,66,149843,65,190603
18389,0.007731,172.217.24.0-255,5738,155581,65,190603
18390,0.007738,172.31.40.0-255,66,155647,65,190603
18391,0.009678,172.217.24.0-255,5738,161385,65,190603
18392,0.009684,172.31.40.0-255,66,161451,65,190603
18393,0.011621,172.217.24.0-255,5738,167189,65,190603
18394,0.011628,172.31.40.0-255,66,167255,65,190603
18395,0.013586,172.217.24.0-255,5738,172993,65,190603
18396,0.01359,172.31.40.0-255,66,173059,65,190603
18397,0.015524,172.217.24.0-255,5738,178797,65,190603
18398,0.015531,172.31.40.0-255,66,178863,65,190603
18399,0.017495,172.217.24.0-255,5738,184601,65,190603
18400,0.017502,172.31.40.0-255,66,184667,65,190603
18401,0.01945,172.217.24.0-255,2902,187569,65,190603
18402,0.019457,172.31.40.0-255,66,187635,65,190603
18403,0.019504,172.217.24.0-255,2902,190537,65,190603
18404,0.019507,172.31.40.0-255,66,190603,65,190603
18405,0.0,172.217.194.0-255,296,296,65,106722
18406,2.3e-05,172.31.40.0-255,66,362,65,106722
18407,3e-05,172.217.194.0-255,1484,1846,65,106722
18408,3.5e-05,172.31.40.0-255,66,1912,65,106722
18409,4.2e-05,172.217.194.0-255,4320,6232,65,106722
18410,4.6e-05,172.31.40.0-255,66,6298,65,106722
18411,4.9e-05,172.217.194.0-255,1484,7782,65,106722
18412,5.1e-05,172.31.40.0-255,66,7848,65,106722
18413,8.2e-05,172.217.194.0-255,5738,13586,65,106722
18414,8.5e-05,172.31.40.0-255,66,13652,65,106722
18415,9.1e-05,172.217.194.0-255,4320,17972,65,106722
18416,9.4e-05,172.31.40.0-255,66,18038,65,106722
18417,0.000112,172.217.194.0-255,449,18487,65,106722
18418,0.000115,172.31.40.0-255,66,18553,65,106722
18419,0.000122,172.217.194.0-255,5738,24291,65,106722
18420,0.000124,172.31.40.0-255,66,24357,65,106722
18421,0.000143,172.217.194.0-255,5738,30095,65,106722
18422,0.000146,172.31.40.0-255,66,30161,65,106722
18423,0.000166,172.217.194.0-255,7156,37317,65,106722
18424,0.000169,172.31.40.0-255,66,37383,65,106722
18425,0.000203,172.217.194.0-255,4320,41703,65,106722
18426,0.000206,172.31.40.0-255,66,41769,65,106722
18427,0.000232,172.217.194.0-255,6438,48207,65,106722
18428,0.000235,172.31.40.0-255,66,48273,65,106722
18429,0.001676,172.217.194.0-255,1484,49757,65,106722
18430,0.001683,172.31.40.0-255,66,49823,65,106722
18431,0.001693,172.217.194.0-255,2902,52725,65,106722
18432,0.001696,172.31.40.0-255,66,52791,65,106722
18433,0.001702,172.217.194.0-255,4320,57111,65,106722
18434,0.001704,172.31.40.0-255,66,57177,65,106722
18435,0.001745,172.217.194.0-255,1484,58661,65,106722
18436,0.001748,172.31.40.0-255,66,58727,65,106722
18437,0.001754,172.217.194.0-255,2902,61629,65,106722
18438,0.001756,172.31.40.0-255,66,61695,65,106722
18439,0.001762,172.217.194.0-255,4267,65962,65,106722
18440,0.001764,172.31.40.0-255,66,66028,65,106722
18441,0.004046,172.217.194.0-255,1484,67512,65,106722
18442,0.004089,172.217.194.0-255,4320,71832,65,106722
18443,0.004094,172.31.40.0-255,66,71898,65,106722
18444,0.006424,172.217.194.0-255,5738,77636,65,106722
18445,0.006431,172.31.40.0-255,66,77702,65,106722
18446,0.008748,172.217.194.0-255,5738,83440,65,106722
18447,0.008756,172.31.40.0-255,66,83506,65,106722
18448,0.01106,172.217.194.0-255,5738,89244,65,106722
18449,0.011069,172.31.40.0-255,66,89310,65,106722
18450,0.013379,172.217.194.0-255,5738,95048,65,106722
18451,0.013387,172.31.40.0-255,66,95114,65,106722
18452,0.015727,172.217.194.0-255,5738,100852,65,106722
18453,0.015737,172.31.40.0-255,66,100918,65,106722
18454,0.01807,172.217.194.0-255,5738,106656,65,106722
18455,0.018079,172.31.40.0-255,66,106722,65,106722
18456,0.0,74.125.68.0-255,146,146,65,248483
18457,1.4e-05,172.31.40.0-255,66,212,65,248483
18458,2.1e-05,74.125.68.0-255,1484,1696,65,248483
18459,2.5e-05,172.31.40.0-255,66,1762,65,248483
18460,3.1e-05,74.125.68.0-255,2902,4664,65,248483
18461,4.3e-05,172.31.40.0-255,66,4730,65,248483
18462,5.2e-05,74.125.68.0-255,7156,11886,65,248483
18463,5.5e-05,172.31.40.0-255,66,11952,65,248483
18464,0.000101,74.125.68.0-255,2066,14018,65,248483
18465,0.000104,172.31.40.0-255,66,14084,65,248483
18466,0.000135,74.125.68.0-255,2902,16986,65,248483
18467,0.000138,172.31.40.0-255,66,17052,65,248483
18468,0.000145,74.125.68.0-255,5738,22790,65,248483
18469,0.000148,172.31.40.0-255,66,22856,65,248483
18470,0.000168,74.125.68.0-255,1484,24340,65,248483
18471,0.00017,172.31.40.0-255,66,24406,65,248483
18472,0.000208,74.125.68.0-255,5738,30144,65,248483
18473,0.00021,172.31.40.0-255,66,30210,65,248483
18474,0.000234,74.125.68.0-255,1125,31335,65,248483
18475,0.000236,172.31.40.0-255,66,31401,65,248483
18476,0.000277,74.125.68.0-255,1484,32885,65,248483
18477,0.00028,172.31.40.0-255,66,32951,65,248483
18478,0.000284,74.125.68.0-255,2902,35853,65,248483
18479,0.000286,172.31.40.0-255,66,35919,65,248483
18480,0.00031,74.125.68.0-255,2902,38821,65,248483
18481,0.000313,172.31.40.0-255,66,38887,65,248483
18482,0.000317,74.125.68.0-255,2902,41789,65,248483
18483,0.00032,172.31.40.0-255,66,41855,65,248483
18484,0.000344,74.125.68.0-255,1484,43339,65,248483
18485,0.000346,172.31.40.0-255,66,43405,65,248483
18486,0.000355,74.125.68.0-255,6797,50202,65,248483
18487,0.000358,172.31.40.0-255,66,50268,65,248483
18488,0.000364,74.125.68.0-255,5738,56006,65,248483
18489,0.000367,172.31.40.0-255,66,56072,65,248483
18490,0.00039,74.125.68.0-255,1484,57556,65,248483
18491,0.000396,74.125.68.0-255,2902,60458,65,248483
18492,0.000399,172.31.40.0-255,66,60524,65,248483
18493,0.000427,74.125.68.0-255,5379,65903,65,248483
18494,0.000431,172.31.40.0-255,66,65969,65,248483
18495,0.000556,74.125.68.0-255,646,66615,65,248483
18496,0.000949,74.125.68.0-255,1484,68099,65,248483
18497,0.000954,172.31.40.0-255,66,68165,65,248483
18498,0.00096,74.125.68.0-255,2902,71067,65,248483
18499,0.000962,172.31.40.0-255,66,71133,65,248483
18500,0.000966,74.125.68.0-255,1484,72617,65,248483
18501,0.000993,74.125.68.0-255,4320,76937,65,248483
18502,0.000995,172.31.40.0-255,66,77003,65,248483
18503,0.000998,74.125.68.0-255,1484,78487,65,248483
18504,0.001032,172.31.40.0-255,66,78553,65,248483
18505,0.001039,74.125.68.0-255,7156,85709,65,248483
18506,0.001041,172.31.40.0-255,66,85775,65,248483
18507,0.001069,74.125.68.0-255,3602,89377,65,248483
18508,0.001072,172.31.40.0-255,66,89443,65,248483
18509,0.001225,74.125.68.0-255,1484,90927,65,248483
18510,0.001246,74.125.68.0-255,2902,93829,65,248483
18511,0.001249,172.31.40.0-255,66,93895,65,248483
18512,0.001278,74.125.68.0-255,4320,98215,65,248483
18513,0.001281,172.31.40.0-255,66,98281,65,248483
18514,0.001287,74.125.68.0-255,4320,102601,65,248483
18515,0.001289,172.31.40.0-255,66,102667,65,248483
18516,0.001312,74.125.68.0-255,1484,104151,65,248483
18517,0.00134,172.31.40.0-255,66,104217,65,248483
18518,0.001361,74.125.68.0-255,4320,108537,65,248483
18519,0.001363,172.31.40.0-255,66,108603,65,248483
18520,0.001394,74.125.68.0-255,5738,114341,65,248483
18521,0.001397,172.31.40.0-255,66,114407,65,248483
18522,0.0014,74.125.68.0-255,766,115173,65,248483
18523,0.001543,74.125.68.0-255,1484,116657,65,248483
18524,0.001548,172.31.40.0-255,66,116723,65,248483
18525,0.001575,74.125.68.0-255,1484,118207,65,248483
18526,0.00158,74.125.68.0-255,2902,121109,65,248483
18527,0.001585,172.31.40.0-255,66,121175,65,248483
18528,0.00161,74.125.68.0-255,5738,126913,65,248483
18529,0.001613,172.31.40.0-255,66,126979,65,248483
18530,0.001647,74.125.68.0-255,7156,134135,65,248483
18531,0.00165,172.31.40.0-255,66,134201,65,248483
18532,0.001661,172.31.40.0-255,66,134267,65,248483
18533,0.001688,74.125.68.0-255,6438,140705,65,248483
18534,0.001691,172.31.40.0-255,66,140771,65,248483
18535,0.001739,74.125.68.0-255,1484,142255,65,248483
18536,0.001744,74.125.68.0-255,2902,145157,65,248483
18537,0.001746,172.31.40.0-255,66,145223,65,248483
18538,0.001759,74.125.68.0-255,2902,148125,65,248483
18539,0.001761,172.31.40.0-255,66,148191,65,248483
18540,0.001775,74.125.68.0-255,2902,151093,65,248483
18541,0.001777,172.31.40.0-255,66,151159,65,248483
18542,0.001787,74.125.68.0-255,4320,155479,65,248483
18543,0.001789,172.31.40.0-255,66,155545,65,248483
18544,0.001795,74.125.68.0-255,5738,161283,65,248483
18545,0.001797,172.31.40.0-255,66,161349,65,248483
18546,0.001821,74.125.68.0-255,5738,167087,65,248483
18547,0.001823,172.31.40.0-255,66,167153,65,248483
18548,0.001855,74.125.68.0-255,5738,172891,65,248483
18549,0.001859,172.31.40.0-255,66,172957,65,248483
18550,0.001863,74.125.68.0-255,2184,175141,65,248483
18551,0.001865,172.31.40.0-255,66,175207,65,248483
18552,0.001904,74.125.68.0-255,1484,176691,65,248483
18553,0.001917,74.125.68.0-255,2902,179593,65,248483
18554,0.00192,172.31.40.0-255,66,179659,65,248483
18555,0.001923,74.125.68.0-255,1484,181143,65,248483
18556,0.001942,74.125.68.0-255,2902,184045,65,248483
18557,0.001944,172.31.40.0-255,66,184111,65,248483
18558,0.001947,74.125.68.0-255,1484,185595,65,248483
18559,0.001968,74.125.68.0-255,4320,189915,65,248483
18560,0.001971,172.31.40.0-255,66,189981,65,248483
18561,0.002035,172.31.40.0-255,66,190047,65,248483
18562,0.002064,172.31.40.0-255,66,190113,65,248483
18563,0.002091,74.125.68.0-255,1484,191597,65,248483
18564,0.002114,74.125.68.0-255,2902,194499,65,248483
18565,0.002117,172.31.40.0-255,66,194565,65,248483
18566,0.002151,74.125.68.0-255,5738,200303,65,248483
18567,0.002155,172.31.40.0-255,66,200369,65,248483
18568,0.002159,74.125.68.0-255,2902,203271,65,248483
18569,0.002161,172.31.40.0-255,66,203337,65,248483
18570,0.002171,74.125.68.0-255,4320,207657,65,248483
18571,0.002173,172.31.40.0-255,66,207723,65,248483
18572,0.002189,172.31.40.0-255,66,207789,65,248483
18573,0.0022,172.31.40.0-255,66,207855,65,248483
18574,0.004477,74.125.68.0-255,5738,213593,65,248483
18575,0.004484,172.31.40.0-255,66,213659,65,248483
18576,0.006771,74.125.68.0-255,5738,219397,65,248483
18577,0.006778,172.31.40.0-255,66,219463,65,248483
18578,0.009064,74.125.68.0-255,5738,225201,65,248483
18579,0.009071,172.31.40.0-255,66,225267,65,248483
18580,0.011357,74.125.68.0-255,5738,231005,65,248483
18581,0.011364,172.31.40.0-255,66,231071,65,248483
18582,0.013653,74.125.68.0-255,5738,236809,65,248483
18583,0.013661,172.31.40.0-255,66,236875,65,248483
18584,0.015947,74.125.68.0-255,5738,242613,65,248483
18585,0.015957,172.31.40.0-255,66,242679,65,248483
18586,0.018271,74.125.68.0-255,5738,248417,65,248483
18587,0.018277,172.31.40.0-255,66,248483,65,248483
18588,0.0,172.31.40.0-255,105,105,65,459
18589,0.000221,172.31.40.0-255,90,195,65,459
18590,0.000232,172.31.40.0-255,66,261,65,459
18591,0.002812,74.125.68.0-255,66,327,65,459
18592,0.002834,74.125.68.0-255,66,393,65,459
18593,0.00285,172.31.40.0-255,66,459,65,459
18594,0.0,172.31.40.0-255,105,105,65,459
18595,0.000271,172.31.40.0-255,90,195,65,459
18596,0.000283,172.31.40.0-255,66,261,65,459
18597,0.002513,74.125.68.0-255,66,327,65,459
18598,0.002544,74.125.68.0-255,66,393,65,459
18599,0.002569,172.31.40.0-255,66,459,65,459
18600,0.0,172.217.194.0-255,150,150,65,113866
18601,1.6e-05,172.31.40.0-255,66,216,65,113866
18602,2.2e-05,172.217.194.0-255,1484,1700,65,113866
18603,2.6e-05,172.31.40.0-255,66,1766,65,113866
18604,5.1e-05,172.217.194.0-255,2902,4668,65,113866
18605,5.4e-05,172.31.40.0-255,66,4734,65,113866
18606,6.5e-05,172.217.194.0-255,7156,11890,65,113866
18607,6.7e-05,172.31.40.0-255,66,11956,65,113866
18608,7.1e-05,172.217.194.0-255,1984,13940,65,113866
18609,7.4e-05,172.31.40.0-255,66,14006,65,113866
18610,0.000678,172.217.194.0-255,1484,15490,65,113866
18611,0.000684,172.31.40.0-255,66,15556,65,113866
18612,0.000692,172.217.194.0-255,2902,18458,65,113866
18613,0.000694,172.31.40.0-255,66,18524,65,113866
18614,0.000705,172.217.194.0-255,5738,24262,65,113866
18615,0.000707,172.31.40.0-255,66,24328,65,113866
18616,0.000756,172.217.194.0-255,6797,31125,65,113866
18617,0.000759,172.31.40.0-255,66,31191,65,113866
18618,0.001008,172.217.194.0-255,1484,32675,65,113866
18619,0.001013,172.31.40.0-255,66,32741,65,113866
18620,0.001019,172.217.194.0-255,2902,35643,65,113866
18621,0.001021,172.31.40.0-255,66,35709,65,113866
18622,0.001027,172.217.194.0-255,5738,41447,65,113866
18623,0.001034,172.31.40.0-255,66,41513,65,113866
18624,0.001036,172.217.194.0-255,1484,42997,65,113866
18625,0.001038,172.31.40.0-255,66,43063,65,113866
18626,0.001079,172.217.194.0-255,4320,47383,65,113866
18627,0.001082,172.31.40.0-255,66,47449,65,113866
18628,0.001113,172.217.194.0-255,5379,52828,65,113866
18629,0.001115,172.31.40.0-255,66,52894,65,113866
18630,0.001125,172.31.40.0-255,66,52960,65,113866
18631,0.001153,172.217.194.0-255,3961,56921,65,113866
18632,0.001155,172.31.40.0-255,66,56987,65,113866
18633,0.001902,172.217.194.0-255,645,57632,65,113866
18634,0.001933,172.217.194.0-255,1484,59116,65,113866
18635,0.001936,172.31.40.0-255,66,59182,65,113866
18636,0.001942,172.217.194.0-255,2902,62084,65,113866
18637,0.001944,172.31.40.0-255,66,62150,65,113866
18638,0.001966,172.217.194.0-255,1484,63634,65,113866
18639,0.001983,172.31.40.0-255,66,63700,65,113866
18640,0.002022,172.217.194.0-255,7156,70856,65,113866
18641,0.002025,172.31.40.0-255,66,70922,65,113866
18642,0.002049,172.31.40.0-255,66,70988,65,113866
18643,0.002053,172.217.194.0-255,2184,73172,65,113866
18644,0.002056,172.31.40.0-255,66,73238,65,113866
18645,0.004419,172.217.194.0-255,5738,78976,65,113866
18646,0.004426,172.31.40.0-255,66,79042,65,113866
18647,0.006815,172.217.194.0-255,5738,84780,65,113866
18648,0.006823,172.31.40.0-255,66,84846,65,113866
18649,0.00921,172.217.194.0-255,5738,90584,65,113866
18650,0.009217,172.31.40.0-255,66,90650,65,113866
18651,0.011595,172.217.194.0-255,5738,96388,65,113866
18652,0.011602,172.31.40.0-255,66,96454,65,113866
18653,0.014008,172.217.194.0-255,5738,102192,65,113866
18654,0.014018,172.31.40.0-255,66,102258,65,113866
18655,0.016367,172.217.194.0-255,5738,107996,65,113866
18656,0.016376,172.31.40.0-255,66,108062,65,113866
18657,0.018758,172.217.194.0-255,5738,113800,65,113866
18658,0.018765,172.31.40.0-255,66,113866,65,113866
18659,0.0,172.217.194.0-255,66,66,65,66
18660,0.0,172.217.194.0-255,150,150,65,117688
18661,2.1e-05,172.31.40.0-255,66,216,65,117688
18662,2.8e-05,172.217.194.0-255,1484,1700,65,117688
18663,3.3e-05,172.31.40.0-255,66,1766,65,117688
18664,3.9e-05,172.217.194.0-255,2902,4668,65,117688
18665,4.2e-05,172.31.40.0-255,66,4734,65,117688
18666,4.7e-05,172.217.194.0-255,2902,7636,65,117688
18667,5e-05,172.31.40.0-255,66,7702,65,117688
18668,5.6e-05,172.217.194.0-255,4320,12022,65,117688
18669,5.9e-05,172.31.40.0-255,66,12088,65,117688
18670,9.7e-05,172.31.40.0-255,66,12154,65,117688
18671,0.000106,172.31.40.0-255,66,12220,65,117688
18672,0.000129,172.217.194.0-255,1125,13345,65,117688
18673,0.000131,172.31.40.0-255,66,13411,65,117688
18674,0.000149,172.217.194.0-255,1484,14895,65,117688
18675,0.000151,172.31.40.0-255,66,14961,65,117688
18676,0.000171,172.217.194.0-255,1484,16445,65,117688
18677,0.000173,172.31.40.0-255,66,16511,65,117688
18678,0.000188,172.217.194.0-255,2902,19413,65,117688
18679,0.000191,172.31.40.0-255,66,19479,65,117688
18680,0.000203,172.31.40.0-255,66,19545,65,117688
18681,0.000206,172.217.194.0-255,1125,20670,65,117688
18682,0.000208,172.31.40.0-255,66,20736,65,117688
18683,0.000533,172.217.194.0-255,1484,22220,65,117688
18684,0.000539,172.31.40.0-255,66,22286,65,117688
18685,0.000545,172.217.194.0-255,2902,25188,65,117688
18686,0.000547,172.31.40.0-255,66,25254,65,117688
18687,0.000553,172.217.194.0-255,4320,29574,65,117688
18688,0.000555,172.31.40.0-255,66,29640,65,117688
18689,0.000574,172.217.194.0-255,1484,31124,65,117688
18690,0.000608,172.217.194.0-255,5738,36862,65,117688
18691,0.000611,172.31.40.0-255,66,36928,65,117688
18692,0.000626,172.217.194.0-255,1705,38633,65,117688
18693,0.000629,172.31.40.0-255,66,38699,65,117688
18694,0.000654,172.217.194.0-255,1484,40183,65,117688
18695,0.000658,172.217.194.0-255,2902,43085,65,117688
18696,0.000661,172.31.40.0-255,66,43151,65,117688
18697,0.00068,172.217.194.0-255,5738,48889,65,117688
18698,0.000683,172.31.40.0-255,66,48955,65,117688
18699,0.000708,172.31.40.0-255,66,49021,65,117688
18700,0.000721,172.217.194.0-255,1125,50146,65,117688
18701,0.00074,172.31.40.0-255,66,50212,65,117688
18702,0.000744,172.217.194.0-255,1484,51696,65,117688
18703,0.000777,172.31.40.0-255,66,51762,65,117688
18704,0.000794,172.217.194.0-255,1484,53246,65,117688
18705,0.000797,172.217.194.0-255,203,53449,65,117688
18706,0.000799,172.31.40.0-255,66,53515,65,117688
18707,0.000836,172.217.194.0-255,1484,54999,65,117688
18708,0.000842,172.217.194.0-255,2902,57901,65,117688
18709,0.000844,172.31.40.0-255,66,57967,65,117688
18710,0.000871,172.217.194.0-255,5738,63705,65,117688
18711,0.000873,172.31.40.0-255,66,63771,65,117688
18712,0.000879,172.217.194.0-255,4320,68091,65,117688
18713,0.000881,172.31.40.0-255,66,68157,65,117688
18714,0.000913,172.31.40.0-255,66,68223,65,117688
18715,0.000926,172.31.40.0-255,66,68289,65,117688
18716,0.001102,172.217.194.0-255,1484,69773,65,117688
18717,0.001108,172.217.194.0-255,2902,72675,65,117688
18718,0.001111,172.31.40.0-255,66,72741,65,117688
18719,0.001116,172.217.194.0-255,2902,75643,65,117688
18720,0.001118,172.31.40.0-255,66,75709,65,117688
18721,0.001133,172.217.194.0-255,2902,78611,65,117688
18722,0.001135,172.31.40.0-255,66,78677,65,117688
18723,0.001138,172.217.194.0-255,1484,80161,65,117688
18724,0.001173,172.31.40.0-255,66,80227,65,117688
18725,0.0012,172.31.40.0-255,66,80293,65,117688
18726,0.001221,172.217.194.0-255,2184,82477,65,117688
18727,0.001223,172.31.40.0-255,66,82543,65,117688
18728,0.00175,172.217.194.0-255,1484,84027,65,117688
18729,0.001763,172.217.194.0-255,2902,86929,65,117688
18730,0.001766,172.31.40.0-255,66,86995,65,117688
18731,0.001789,172.217.194.0-255,5738,92733,65,117688
18732,0.001792,172.31.40.0-255,66,92799,65,117688
18733,0.001802,172.217.194.0-255,1484,94283,65,117688
18734,0.001827,172.31.40.0-255,66,94349,65,117688
18735,0.001833,172.217.194.0-255,5738,100087,65,117688
18736,0.001835,172.31.40.0-255,66,100153,65,117688
18737,0.001868,172.217.194.0-255,2902,103055,65,117688
18738,0.001871,172.31.40.0-255,66,103121,65,117688
18739,0.001889,172.217.194.0-255,2184,105305,65,117688
18740,0.001891,172.31.40.0-255,66,105371,65,117688
18741,0.001982,172.217.194.0-255,1484,106855,65,117688
18742,0.001986,172.217.194.0-255,1484,108339,65,117688
18743,0.001989,172.31.40.0-255,66,108405,65,117688
18744,0.002009,172.217.194.0-255,1484,109889,65,117688
18745,0.002015,172.217.194.0-255,5738,115627,65,117688
18746,0.002018,172.31.40.0-255,66,115693,65,117688
18747,0.002053,172.31.40.0-255,66,115759,65,117688
18748,0.00216,172.31.40.0-255,66,115825,65,117688
18749,0.002362,172.217.194.0-255,105,115930,65,117688
18750,0.002364,172.217.194.0-255,129,116059,65,117688
18751,0.011071,172.217.194.0-255,129,116188,65,117688
18752,0.011598,172.31.40.0-255,66,116254,65,117688
18753,0.011606,172.31.40.0-255,66,116320,65,117688
18754,0.011611,172.31.40.0-255,66,116386,65,117688
18755,0.011622,172.31.40.0-255,66,116452,65,117688
18756,0.011625,172.31.40.0-255,66,116518,65,117688
18757,0.011629,172.31.40.0-255,66,116584,65,117688
18758,0.011632,172.31.40.0-255,66,116650,65,117688
18759,0.011635,172.31.40.0-255,66,116716,65,117688
18760,0.011638,172.31.40.0-255,66,116782,65,117688
18761,0.011641,172.31.40.0-255,66,116848,65,117688
18762,0.011645,172.31.40.0-255,66,116914,65,117688
18763,0.011652,172.31.40.0-255,78,116992,65,117688
18764,0.014191,172.31.40.0-255,105,117097,65,117688
18765,0.014233,172.31.40.0-255,105,117202,65,117688
18766,0.014436,172.31.40.0-255,90,117292,65,117688
18767,0.014445,172.31.40.0-255,66,117358,65,117688
18768,0.01651,172.217.194.0-255,66,117424,65,117688
18769,0.016533,172.217.194.0-255,66,117490,65,117688
18770,0.016728,172.217.194.0-255,66,117556,65,117688
18771,0.016762,172.217.194.0-255,66,117622,65,117688
18772,0.016769,172.31.40.0-255,66,117688,65,117688
18773,0.0,172.217.194.0-255,153,153,65,179637
18774,2.4e-05,172.31.40.0-255,66,219,65,179637
18775,3.1e-05,172.217.194.0-255,1484,1703,65,179637
18776,3.6e-05,172.31.40.0-255,66,1769,65,179637
18777,4.2e-05,172.217.194.0-255,2902,4671,65,179637
18778,4.5e-05,172.31.40.0-255,66,4737,65,179637
18779,5.3e-05,172.217.194.0-255,7156,11893,65,179637
18780,5.7e-05,172.31.40.0-255,66,11959,65,179637
18781,8.3e-05,172.217.194.0-255,2127,14086,65,179637
18782,8.6e-05,172.31.40.0-255,66,14152,65,179637
18783,9.9e-05,172.217.194.0-255,2902,17054,65,179637
18784,0.000102,172.31.40.0-255,66,17120,65,179637
18785,0.000106,172.217.194.0-255,1484,18604,65,179637
18786,0.000108,172.31.40.0-255,66,18670,65,179637
18787,0.000135,172.217.194.0-255,5738,24408,65,179637
18788,0.000137,172.31.40.0-255,66,24474,65,179637
18789,0.000144,172.217.194.0-255,6797,31271,65,179637
18790,0.000146,172.31.40.0-255,66,31337,65,179637
18791,0.000183,172.217.194.0-255,5738,37075,65,179637
18792,0.000186,172.31.40.0-255,66,37141,65,179637
18793,0.000214,172.31.40.0-255,66,37207,65,179637
18794,0.000232,172.217.194.0-255,2543,39750,65,179637
18795,0.000234,172.31.40.0-255,66,39816,65,179637
18796,0.000372,172.217.194.0-255,2902,42718,65,179637
18797,0.000376,172.31.40.0-255,66,42784,65,179637
18798,0.000383,172.217.194.0-255,7156,49940,65,179637
18799,0.000386,172.31.40.0-255,66,50006,65,179637
18800,0.000397,172.31.40.0-255,66,50072,65,179637
18801,0.000427,172.217.194.0-255,7156,57228,65,179637
18802,0.00043,172.31.40.0-255,66,57294,65,179637
18803,0.000442,172.31.40.0-255,66,57360,65,179637
18804,0.000444,172.217.194.0-255,575,57935,65,179637
18805,0.000916,172.217.194.0-255,1484,59419,65,179637
18806,0.000922,172.31.40.0-255,66,59485,65,179637
18807,0.000928,172.217.194.0-255,2902,62387,65,179637
18808,0.000931,172.31.40.0-255,66,62453,65,179637
18809,0.000937,172.217.194.0-255,4320,66773,65,179637
18810,0.000938,172.31.40.0-255,66,66839,65,179637
18811,0.000961,172.217.194.0-255,1484,68323,65,179637
18812,0.001026,172.217.194.0-255,5738,74061,65,179637
18813,0.00103,172.31.40.0-255,66,74127,65,179637
18814,0.001057,172.217.194.0-255,7156,81283,65,179637
18815,0.001059,172.31.40.0-255,66,81349,65,179637
18816,0.001072,172.31.40.0-255,66,81415,65,179637
18817,0.001118,172.31.40.0-255,66,81481,65,179637
18818,0.001149,172.31.40.0-255,66,81547,65,179637
18819,0.001158,172.31.40.0-255,66,81613,65,179637
18820,0.001279,172.217.194.0-255,1484,83097,65,179637
18821,0.001285,172.217.194.0-255,2902,85999,65,179637
18822,0.001288,172.31.40.0-255,66,86065,65,179637
18823,0.001291,172.217.194.0-255,1484,87549,65,179637
18824,0.001315,172.217.194.0-255,4320,91869,65,179637
18825,0.001317,172.31.40.0-255,66,91935,65,179637
18826,0.001327,172.31.40.0-255,66,92001,65,179637
18827,0.001344,172.217.194.0-255,4320,96321,65,179637
18828,0.001347,172.31.40.0-255,66,96387,65,179637
18829,0.001349,172.217.194.0-255,1484,97871,65,179637
18830,0.001387,172.31.40.0-255,66,97937,65,179637
18831,0.001496,172.217.194.0-255,1484,99421,65,179637
18832,0.001502,172.217.194.0-255,2902,102323,65,179637
18833,0.001509,172.217.194.0-255,5738,108061,65,179637
18834,0.001516,172.31.40.0-255,66,108127,65,179637
18835,0.001575,172.31.40.0-255,66,108193,65,179637
18836,0.001587,172.217.194.0-255,766,108959,65,179637
18837,0.001609,172.31.40.0-255,66,109025,65,179637
18838,0.001618,172.217.194.0-255,1484,110509,65,179637
18839,0.001623,172.217.194.0-255,2902,113411,65,179637
18840,0.001634,172.217.194.0-255,1484,114895,65,179637
18841,0.001638,172.217.194.0-255,1484,116379,65,179637
18842,0.001676,172.31.40.0-255,66,116445,65,179637
18843,0.001733,172.31.40.0-255,66,116511,65,179637
18844,0.001736,172.217.194.0-255,1484,117995,65,179637
18845,0.001771,172.217.194.0-255,5738,123733,65,179637
18846,0.001778,172.31.40.0-255,66,123799,65,179637
18847,0.001808,172.217.194.0-255,2902,126701,65,179637
18848,0.001812,172.31.40.0-255,66,126767,65,179637
18849,0.001834,172.217.194.0-255,6438,133205,65,179637
18850,0.001843,172.31.40.0-255,66,133271,65,179637
18851,0.00411,172.217.194.0-255,5738,139009,65,179637
18852,0.004117,172.31.40.0-255,66,139075,65,179637
18853,0.006368,172.217.194.0-255,5738,144813,65,179637
18854,0.006372,172.31.40.0-255,66,144879,65,179637
18855,0.008608,172.217.194.0-255,5738,150617,65,179637
18856,0.008615,172.31.40.0-255,66,150683,65,179637
18857,0.010891,172.217.194.0-255,5738,156421,65,179637
18858,0.010908,172.31.40.0-255,66,156487,65,179637
18859,0.013207,172.217.194.0-255,5738,162225,65,179637
18860,0.013217,172.31.40.0-255,66,162291,65,179637
18861,0.015446,172.217.194.0-255,5738,168029,65,179637
18862,0.015455,172.31.40.0-255,66,168095,65,179637
18863,0.01772,172.217.194.0-255,5738,173833,65,179637
18864,0.017736,172.31.40.0-255,66,173899,65,179637
18865,0.019985,172.217.194.0-255,5738,179637,65,179637
18866,0.0,74.125.24.0-255,153,153,65,191234
18867,1.6e-05,172.31.40.0-255,66,219,65,191234
18868,2.3e-05,74.125.24.0-255,1484,1703,65,191234
18869,2.7e-05,172.31.40.0-255,66,1769,65,191234
18870,3.3e-05,74.125.24.0-255,2902,4671,65,191234
18871,3.6e-05,172.31.40.0-255,66,4737,65,191234
18872,5.3e-05,74.125.24.0-255,7156,11893,65,191234
18873,5.8e-05,172.31.40.0-255,66,11959,65,191234
18874,6.5e-05,74.125.24.0-255,6293,18252,65,191234
18875,6.8e-05,172.31.40.0-255,66,18318,65,191234
18876,0.00012,172.31.40.0-255,66,18384,65,191234
18877,0.000149,74.125.24.0-255,2543,20927,65,191234
18878,0.000152,172.31.40.0-255,66,20993,65,191234
18879,0.000179,74.125.24.0-255,1484,22477,65,191234
18880,0.000182,172.31.40.0-255,66,22543,65,191234
18881,0.000187,74.125.24.0-255,2902,25445,65,191234
18882,0.000189,172.31.40.0-255,66,25511,65,191234
18883,0.000195,74.125.24.0-255,5738,31249,65,191234
18884,0.000198,172.31.40.0-255,66,31315,65,191234
18885,0.000201,74.125.24.0-255,1484,32799,65,191234
18886,0.000203,172.31.40.0-255,66,32865,65,191234
18887,0.000243,74.125.24.0-255,5379,38244,65,191234
18888,0.000246,172.31.40.0-255,66,38310,65,191234
18889,0.000261,172.31.40.0-255,66,38376,65,191234
18890,0.000265,74.125.24.0-255,2543,40919,65,191234
18891,0.000267,172.31.40.0-255,66,40985,65,191234
18892,0.000294,74.125.24.0-255,361,41346,65,191234
18893,0.000297,172.31.40.0-255,66,41412,65,191234
18894,0.000362,74.125.24.0-255,1484,42896,65,191234
18895,0.000365,172.31.40.0-255,66,42962,65,191234
18896,0.00037,74.125.24.0-255,2902,45864,65,191234
18897,0.000373,172.31.40.0-255,66,45930,65,191234
18898,0.000376,74.125.24.0-255,1484,47414,65,191234
18899,0.000399,74.125.24.0-255,4320,51734,65,191234
18900,0.000401,172.31.40.0-255,66,51800,65,191234
18901,0.000409,74.125.24.0-255,7112,58912,65,191234
18902,0.000411,172.31.40.0-255,66,58978,65,191234
18903,0.000459,74.125.24.0-255,1484,60462,65,191234
18904,0.000476,74.125.24.0-255,2902,63364,65,191234
18905,0.000478,172.31.40.0-255,66,63430,65,191234
18906,0.000484,74.125.24.0-255,4320,67750,65,191234
18907,0.000487,172.31.40.0-255,66,67816,65,191234
18908,0.000501,74.125.24.0-255,1484,69300,65,191234
18909,0.000512,74.125.24.0-255,6797,76097,65,191234
18910,0.000514,172.31.40.0-255,66,76163,65,191234
18911,0.000542,74.125.24.0-255,4320,80483,65,191234
18912,0.000545,172.31.40.0-255,66,80549,65,191234
18913,0.000574,172.31.40.0-255,66,80615,65,191234
18914,0.000578,74.125.24.0-255,1877,82492,65,191234
18915,0.00058,172.31.40.0-255,66,82558,65,191234
18916,0.001149,74.125.24.0-255,1484,84042,65,191234
18917,0.001156,74.125.24.0-255,2902,86944,65,191234
18918,0.001159,172.31.40.0-255,66,87010,65,191234
18919,0.001167,74.125.24.0-255,5738,92748,65,191234
18920,0.001169,172.31.40.0-255,66,92814,65,191234
18921,0.001212,172.31.40.0-255,66,92880,65,191234
18922,0.001217,74.125.24.0-255,2902,95782,65,191234
18923,0.001219,172.31.40.0-255,66,95848,65,191234
18924,0.001255,172.31.40.0-255,66,95914,65,191234
18925,0.001884,74.125.24.0-255,1484,97398,65,191234
18926,0.00189,74.125.24.0-255,2902,100300,65,191234
18927,0.001894,172.31.40.0-255,66,100366,65,191234
18928,0.001923,74.125.24.0-255,5738,106104,65,191234
18929,0.001926,172.31.40.0-255,66,106170,65,191234
18930,0.001936,172.31.40.0-255,66,106236,65,191234
18931,0.001982,74.125.24.0-255,5738,111974,65,191234
18932,0.001985,172.31.40.0-255,66,112040,65,191234
18933,0.002012,172.31.40.0-255,66,112106,65,191234
18934,0.002049,74.125.24.0-255,1484,113590,65,191234
18935,0.002053,74.125.24.0-255,1484,115074,65,191234
18936,0.002055,172.31.40.0-255,66,115140,65,191234
18937,0.002083,74.125.24.0-255,1484,116624,65,191234
18938,0.002089,74.125.24.0-255,5738,122362,65,191234
18939,0.002092,172.31.40.0-255,66,122428,65,191234
18940,0.002099,74.125.24.0-255,7156,129584,65,191234
18941,0.002101,172.31.40.0-255,66,129650,65,191234
18942,0.002168,172.31.40.0-255,66,129716,65,191234
18943,0.002172,74.125.24.0-255,2184,131900,65,191234
18944,0.002174,172.31.40.0-255,66,131966,65,191234
18945,0.002188,172.31.40.0-255,66,132032,65,191234
18946,0.002228,74.125.24.0-255,4320,136352,65,191234
18947,0.002232,172.31.40.0-255,66,136418,65,191234
18948,0.002246,172.31.40.0-255,66,136484,65,191234
18949,0.002264,172.31.40.0-255,66,136550,65,191234
18950,0.002304,172.31.40.0-255,66,136616,65,191234
18951,0.002317,172.31.40.0-255,66,136682,65,191234
18952,0.00232,74.125.24.0-255,1484,138166,65,191234
18953,0.002365,172.31.40.0-255,66,138232,65,191234
18954,0.002372,74.125.24.0-255,7156,145388,65,191234
18955,0.002375,172.31.40.0-255,66,145454,65,191234
18956,0.002385,172.31.40.0-255,66,145520,65,191234
18957,0.00241,74.125.24.0-255,5020,150540,65,191234
18958,0.002413,172.31.40.0-255,66,150606,65,191234
18959,0.004789,74.125.24.0-255,5738,156344,65,191234
18960,0.004797,172.31.40.0-255,66,156410,65,191234
18961,0.007165,74.125.24.0-255,5738,162148,65,191234
18962,0.007172,172.31.40.0-255,66,162214,65,191234
18963,0.009533,74.125.24.0-255,5738,167952,65,191234
18964,0.00954,172.31.40.0-255,66,168018,65,191234
18965,0.011906,74.125.24.0-255,5738,173756,65,191234
18966,0.011914,172.31.40.0-255,66,173822,65,191234
18967,0.014276,74.125.24.0-255,5738,179560,65,191234
18968,0.014284,172.31.40.0-255,66,179626,65,191234
18969,0.016647,74.125.24.0-255,5738,185364,65,191234
18970,0.016655,172.31.40.0-255,66,185430,65,191234
18971,0.019038,74.125.24.0-255,5738,191168,65,191234
18972,0.019048,172.31.40.0-255,66,191234,65,191234
18973,0.0,74.125.24.0-255,153,153,65,146035
18974,2.2e-05,172.31.40.0-255,66,219,65,146035
18975,3e-05,74.125.24.0-255,1484,1703,65,146035
18976,3.3e-05,172.31.40.0-255,66,1769,65,146035
18977,3.8e-05,74.125.24.0-255,2902,4671,65,146035
18978,4e-05,172.31.40.0-255,66,4737,65,146035
18979,5.5e-05,74.125.24.0-255,7156,11893,65,146035
18980,5.7e-05,172.31.40.0-255,66,11959,65,146035
18981,6.1e-05,74.125.24.0-255,1991,13950,65,146035
18982,6.4e-05,172.31.40.0-255,66,14016,65,146035
18983,0.000366,74.125.24.0-255,1484,15500,65,146035
18984,0.000371,172.31.40.0-255,66,15566,65,146035
18985,0.000377,74.125.24.0-255,2902,18468,65,146035
18986,0.000379,172.31.40.0-255,66,18534,65,146035
18987,0.0004,74.125.24.0-255,4320,22854,65,146035
18988,0.000402,172.31.40.0-255,66,22920,65,146035
18989,0.000442,74.125.24.0-255,1484,24404,65,146035
18990,0.000445,172.31.40.0-255,66,24470,65,146035
18991,0.000474,74.125.24.0-255,6797,31267,65,146035
18992,0.000476,172.31.40.0-255,66,31333,65,146035
18993,0.000521,74.125.24.0-255,1484,32817,65,146035
18994,0.000524,172.31.40.0-255,66,32883,65,146035
18995,0.000528,74.125.24.0-255,2902,35785,65,146035
18996,0.00053,172.31.40.0-255,66,35851,65,146035
18997,0.000554,74.125.24.0-255,5738,41589,65,146035
18998,0.000556,172.31.40.0-255,66,41655,65,146035
18999,0.000563,74.125.24.0-255,6797,48452,65,146035
19000,0.000565,172.31.40.0-255,66,48518,65,146035
19001,0.000596,172.31.40.0-255,66,48584,65,146035
19002,0.000618,74.125.24.0-255,4320,52904,65,146035
19003,0.00062,172.31.40.0-255,66,52970,65,146035
19004,0.000624,74.125.24.0-255,2854,55824,65,146035
19005,0.000626,172.31.40.0-255,66,55890,65,146035
19006,0.000759,74.125.24.0-255,109,55999,65,146035
19007,0.000896,74.125.24.0-255,1484,57483,65,146035
19008,0.0009,172.31.40.0-255,66,57549,65,146035
19009,0.000904,74.125.24.0-255,2902,60451,65,146035
19010,0.000906,172.31.40.0-255,66,60517,65,146035
19011,0.000927,74.125.24.0-255,5738,66255,65,146035
19012,0.000933,172.31.40.0-255,66,66321,65,146035
19013,0.00095,74.125.24.0-255,5738,72059,65,146035
19014,0.000952,172.31.40.0-255,66,72125,65,146035
19015,0.001003,172.31.40.0-255,66,72191,65,146035
19016,0.001014,172.31.40.0-255,66,72257,65,146035
19017,0.001701,74.125.24.0-255,1484,73741,65,146035
19018,0.001712,74.125.24.0-255,2902,76643,65,146035
19019,0.001716,172.31.40.0-255,66,76709,65,146035
19020,0.001724,74.125.24.0-255,5738,82447,65,146035
19021,0.001726,172.31.40.0-255,66,82513,65,146035
19022,0.001743,172.31.40.0-255,66,82579,65,146035
19023,0.001788,74.125.24.0-255,7156,89735,65,146035
19024,0.00179,172.31.40.0-255,66,89801,65,146035
19025,0.001817,74.125.24.0-255,6438,96239,65,146035
19026,0.001819,172.31.40.0-255,66,96305,65,146035
19027,0.00226,74.125.24.0-255,1484,97789,65,146035
19028,0.002268,74.125.24.0-255,2902,100691,65,146035
19029,0.002272,172.31.40.0-255,66,100757,65,146035
19030,0.002277,74.125.24.0-255,1484,102241,65,146035
19031,0.002305,74.125.24.0-255,5738,107979,65,146035
19032,0.002308,172.31.40.0-255,66,108045,65,146035
19033,0.00232,172.31.40.0-255,66,108111,65,146035
19034,0.002355,74.125.24.0-255,4320,112431,65,146035
19035,0.002357,172.31.40.0-255,66,112497,65,146035
19036,0.002373,172.31.40.0-255,66,112563,65,146035
19037,0.004928,74.125.24.0-255,5738,118301,65,146035
19038,0.004935,172.31.40.0-255,66,118367,65,146035
19039,0.007508,74.125.24.0-255,4320,122687,65,146035
19040,0.007512,172.31.40.0-255,66,122753,65,146035
19041,0.007539,74.125.24.0-255,1484,124237,65,146035
19042,0.010057,74.125.24.0-255,4320,128557,65,146035
19043,0.010065,172.31.40.0-255,66,128623,65,146035
19044,0.012628,74.125.24.0-255,5738,134361,65,146035
19045,0.012639,172.31.40.0-255,66,134427,65,146035
19046,0.015224,74.125.24.0-255,5738,140165,65,146035
19047,0.015233,172.31.40.0-255,66,140231,65,146035
19048,0.017817,74.125.24.0-255,5738,145969,65,146035
19049,0.017826,172.31.40.0-255,66,146035,65,146035
19050,0.0,74.125.200.0-255,296,296,65,227917
19051,1.9e-05,172.31.40.0-255,66,362,65,227917
19052,2.6e-05,74.125.200.0-255,1484,1846,65,227917
19053,3.1e-05,172.31.40.0-255,66,1912,65,227917
19054,3.4e-05,74.125.200.0-255,1484,3396,65,227917
19055,3.6e-05,172.31.40.0-255,66,3462,65,227917
19056,4e-05,74.125.200.0-255,1484,4946,65,227917
19057,4.3e-05,172.31.40.0-255,66,5012,65,227917
19058,6.4e-05,74.125.200.0-255,1484,6496,65,227917
19059,6.6e-05,172.31.40.0-255,66,6562,65,227917
19060,9.9e-05,74.125.200.0-255,5738,12300,65,227917
19061,0.000102,172.31.40.0-255,66,12366,65,227917
19062,0.000106,74.125.200.0-255,1956,14322,65,227917
19063,0.000108,172.31.40.0-255,66,14388,65,227917
19064,0.000114,74.125.200.0-255,2902,17290,65,227917
19065,0.000116,172.31.40.0-255,66,17356,65,227917
19066,0.00012,74.125.200.0-255,2902,20258,65,227917
19067,0.000123,172.31.40.0-255,66,20324,65,227917
19068,0.000149,74.125.200.0-255,4320,24644,65,227917
19069,0.000152,172.31.40.0-255,66,24710,65,227917
19070,0.000156,74.125.200.0-255,2902,27612,65,227917
19071,0.000158,172.31.40.0-255,66,27678,65,227917
19072,0.000163,74.125.200.0-255,3961,31639,65,227917
19073,0.000165,172.31.40.0-255,66,31705,65,227917
19074,0.000263,74.125.200.0-255,1484,33189,65,227917
19075,0.000267,172.31.40.0-255,66,33255,65,227917
19076,0.000272,74.125.200.0-255,2902,36157,65,227917
19077,0.000275,172.31.40.0-255,66,36223,65,227917
19078,0.000289,74.125.200.0-255,1484,37707,65,227917
19079,0.000291,172.31.40.0-255,66,37773,65,227917
19080,0.000313,74.125.200.0-255,1484,39257,65,227917
19081,0.000316,172.31.40.0-255,66,39323,65,227917
19082,0.000321,74.125.200.0-255,4320,43643,65,227917
19083,0.00035,74.125.200.0-255,2902,46545,65,227917
19084,0.000363,74.125.200.0-255,5738,52283,65,227917
19085,0.000399,74.125.200.0-255,7156,59439,65,227917
19086,0.000416,74.125.200.0-255,2902,62341,65,227917
19087,0.000455,74.125.200.0-255,3897,66238,65,227917
19088,0.000523,172.31.40.0-255,66,66304,65,227917
19089,0.00064,74.125.200.0-255,133,66437,65,227917
19090,0.000807,74.125.200.0-255,1484,67921,65,227917
19091,0.000811,74.125.200.0-255,1484,69405,65,227917
19092,0.000815,172.31.40.0-255,66,69471,65,227917
19093,0.000824,74.125.200.0-255,1484,70955,65,227917
19094,0.000849,74.125.200.0-255,5738,76693,65,227917
19095,0.000854,74.125.200.0-255,4320,81013,65,227917
19096,0.000866,172.31.40.0-255,66,81079,65,227917
19097,0.000869,74.125.200.0-255,1484,82563,65,227917
19098,0.000893,74.125.200.0-255,7156,89719,65,227917
19099,0.000921,172.31.40.0-255,66,89785,65,227917
19100,0.000965,172.31.40.0-255,66,89851,65,227917
19101,0.001464,74.125.200.0-255,1484,91335,65,227917
19102,0.001481,74.125.200.0-255,1484,92819,65,227917
19103,0.001484,172.31.40.0-255,66,92885,65,227917
19104,0.001501,74.125.200.0-255,1484,94369,65,227917
19105,0.001504,74.125.200.0-255,1484,95853,65,227917
19106,0.001525,74.125.200.0-255,4320,100173,65,227917
19107,0.001529,74.125.200.0-255,2902,103075,65,227917
19108,0.00154,74.125.200.0-255,2902,105977,65,227917
19109,0.001554,74.125.200.0-255,1484,107461,65,227917
19110,0.001566,172.31.40.0-255,66,107527,65,227917
19111,0.001589,74.125.200.0-255,2902,110429,65,227917
19112,0.001592,74.125.200.0-255,1484,111913,65,227917
19113,0.001612,74.125.200.0-255,2902,114815,65,227917
19114,0.001614,74.125.200.0-255,766,115581,65,227917
19115,0.001628,172.31.40.0-255,66,115647,65,227917
19116,0.001785,74.125.200.0-255,1484,117131,65,227917
19117,0.001799,74.125.200.0-255,2902,120033,65,227917
19118,0.001803,172.31.40.0-255,66,120099,65,227917
19119,0.001806,74.125.200.0-255,1484,121583,65,227917
19120,0.001825,74.125.200.0-255,4320,125903,65,227917
19121,0.001829,74.125.200.0-255,4320,130223,65,227917
19122,0.001833,172.31.40.0-255,66,130289,65,227917
19123,0.001843,74.125.200.0-255,2902,133191,65,227917
19124,0.001855,74.125.200.0-255,2902,136093,65,227917
19125,0.001866,74.125.200.0-255,1484,137577,65,227917
19126,0.001876,172.31.40.0-255,66,137643,65,227917
19127,0.001898,74.125.200.0-255,2184,139827,65,227917
19128,0.001921,172.31.40.0-255,66,139893,65,227917
19129,0.002059,74.125.200.0-255,1484,141377,65,227917
19130,0.002066,74.125.200.0-255,2902,144279,65,227917
19131,0.002069,172.31.40.0-255,66,144345,65,227917
19132,0.002082,74.125.200.0-255,1484,145829,65,227917
19133,0.002087,74.125.200.0-255,2902,148731,65,227917
19134,0.00211,172.31.40.0-255,66,148797,65,227917
19135,0.002117,74.125.200.0-255,5738,154535,65,227917
19136,0.002122,172.31.40.0-255,66,154601,65,227917
19137,0.002129,74.125.200.0-255,1484,156085,65,227917
19138,0.002143,74.125.200.0-255,4320,160405,65,227917
19139,0.002147,74.125.200.0-255,2902,163307,65,227917
19140,0.002158,74.125.200.0-255,1484,164791,65,227917
19141,0.002176,74.125.200.0-255,2902,167693,65,227917
19142,0.002181,172.31.40.0-255,66,167759,65,227917
19143,0.002212,74.125.200.0-255,5738,173497,65,227917
19144,0.002227,74.125.200.0-255,766,174263,65,227917
19145,0.002232,172.31.40.0-255,66,174329,65,227917
19146,0.002272,74.125.200.0-255,1484,175813,65,227917
19147,0.002291,74.125.200.0-255,2902,178715,65,227917
19148,0.002302,172.31.40.0-255,66,178781,65,227917
19149,0.002316,74.125.200.0-255,5738,184519,65,227917
19150,0.002375,74.125.200.0-255,7156,191675,65,227917
19151,0.002383,74.125.200.0-255,7156,198831,65,227917
19152,0.006819,172.31.40.0-255,66,198897,65,227917
19153,0.009178,74.125.200.0-255,5738,204635,65,227917
19154,0.009187,172.31.40.0-255,66,204701,65,227917
19155,0.011538,74.125.200.0-255,5738,210439,65,227917
19156,0.011546,172.31.40.0-255,66,210505,65,227917
19157,0.013903,74.125.200.0-255,5738,216243,65,227917
19158,0.013911,172.31.40.0-255,66,216309,65,227917
19159,0.01627,74.125.200.0-255,5738,222047,65,227917
19160,0.016279,172.31.40.0-255,66,222113,65,227917
19161,0.018633,74.125.200.0-255,5738,227851,65,227917
19162,0.01864,172.31.40.0-255,66,227917,65,227917
19163,0.0,172.217.194.0-255,156,156,65,192676
19164,1.7e-05,172.31.40.0-255,66,222,65,192676
19165,2.4e-05,172.217.194.0-255,1484,1706,65,192676
19166,2.8e-05,172.31.40.0-255,66,1772,65,192676
19167,3.5e-05,172.217.194.0-255,2902,4674,65,192676
19168,3.8e-05,172.31.40.0-255,66,4740,65,192676
19169,4.6e-05,172.217.194.0-255,7156,11896,65,192676
19170,4.9e-05,172.31.40.0-255,66,11962,65,192676
19171,5.4e-05,172.217.194.0-255,3517,15479,65,192676
19172,5.7e-05,172.31.40.0-255,66,15545,65,192676
19173,8.1e-05,172.217.194.0-255,1484,17029,65,192676
19174,8.4e-05,172.31.40.0-255,66,17095,65,192676
19175,0.000115,172.31.40.0-255,66,17161,65,192676
19176,0.000119,172.217.194.0-255,2543,19704,65,192676
19177,0.000121,172.31.40.0-255,66,19770,65,192676
19178,0.000182,172.217.194.0-255,1484,21254,65,192676
19179,0.000186,172.31.40.0-255,66,21320,65,192676
19180,0.000207,172.217.194.0-255,2902,24222,65,192676
19181,0.00021,172.31.40.0-255,66,24288,65,192676
19182,0.000217,172.217.194.0-255,5738,30026,65,192676
19183,0.000219,172.31.40.0-255,66,30092,65,192676
19184,0.000267,172.217.194.0-255,4320,34412,65,192676
19185,0.000271,172.31.40.0-255,66,34478,65,192676
19186,0.000288,172.217.194.0-255,2543,37021,65,192676
19187,0.00029,172.31.40.0-255,66,37087,65,192676
19188,0.000304,172.217.194.0-255,1484,38571,65,192676
19189,0.000306,172.31.40.0-255,66,38637,65,192676
19190,0.000332,172.217.194.0-255,5738,44375,65,192676
19191,0.000335,172.31.40.0-255,66,44441,65,192676
19192,0.000342,172.217.194.0-255,7156,51597,65,192676
19193,0.000344,172.31.40.0-255,66,51663,65,192676
19194,0.000368,172.217.194.0-255,2854,54517,65,192676
19195,0.000371,172.31.40.0-255,66,54583,65,192676
19196,0.000383,172.217.194.0-255,1484,56067,65,192676
19197,0.000403,172.217.194.0-255,1517,57584,65,192676
19198,0.000406,172.31.40.0-255,66,57650,65,192676
19199,0.000414,172.217.194.0-255,7156,64806,65,192676
19200,0.000416,172.31.40.0-255,66,64872,65,192676
19201,0.00042,172.217.194.0-255,2902,67774,65,192676
19202,0.000422,172.31.40.0-255,66,67840,65,192676
19203,0.000454,172.217.194.0-255,1484,69324,65,192676
19204,0.00047,172.217.194.0-255,2902,72226,65,192676
19205,0.000473,172.31.40.0-255,66,72292,65,192676
19206,0.000498,172.217.194.0-255,2543,74835,65,192676
19207,0.0005,172.31.40.0-255,66,74901,65,192676
19208,0.000507,172.217.194.0-255,5738,80639,65,192676
19209,0.000509,172.31.40.0-255,66,80705,65,192676
19210,0.000526,172.217.194.0-255,5738,86443,65,192676
19211,0.000529,172.31.40.0-255,66,86509,65,192676
19212,0.000547,172.217.194.0-255,2819,89328,65,192676
19213,0.000549,172.31.40.0-255,66,89394,65,192676
19214,0.000656,172.217.194.0-255,1484,90878,65,192676
19215,0.000687,172.217.194.0-255,2902,93780,65,192676
19216,0.000691,172.31.40.0-255,66,93846,65,192676
19217,0.000698,172.217.194.0-255,5738,99584,65,192676
19218,0.0007,172.31.40.0-255,66,99650,65,192676
19219,0.000733,172.217.194.0-255,5738,105388,65,192676
19220,0.000737,172.31.40.0-255,66,105454,65,192676
19221,0.000773,172.217.194.0-255,7156,112610,65,192676
19222,0.000777,172.31.40.0-255,66,112676,65,192676
19223,0.000789,172.31.40.0-255,66,112742,65,192676
19224,0.000791,172.217.194.0-255,766,113508,65,192676
19225,0.000981,172.217.194.0-255,1484,114992,65,192676
19226,0.000985,172.31.40.0-255,66,115058,65,192676
19227,0.00099,172.217.194.0-255,2902,117960,65,192676
19228,0.000993,172.31.40.0-255,66,118026,65,192676
19229,0.000998,172.217.194.0-255,2902,120928,65,192676
19230,0.001,172.31.40.0-255,66,120994,65,192676
19231,0.001012,172.217.194.0-255,2902,123896,65,192676
19232,0.001015,172.31.40.0-255,66,123962,65,192676
19233,0.00106,172.217.194.0-255,5738,129700,65,192676
19234,0.001063,172.31.40.0-255,66,129766,65,192676
19235,0.00109,172.217.194.0-255,7156,136922,65,192676
19236,0.001093,172.31.40.0-255,66,136988,65,192676
19237,0.001104,172.31.40.0-255,66,137054,65,192676
19238,0.001128,172.31.40.0-255,66,137120,65,192676
19239,0.001168,172.31.40.0-255,66,137186,65,192676
19240,0.001604,172.217.194.0-255,1484,138670,65,192676
19241,0.001611,172.217.194.0-255,2902,141572,65,192676
19242,0.001615,172.31.40.0-255,66,141638,65,192676
19243,0.001638,172.217.194.0-255,5738,147376,65,192676
19244,0.001641,172.31.40.0-255,66,147442,65,192676
19245,0.001658,172.217.194.0-255,1484,148926,65,192676
19246,0.001686,172.217.194.0-255,7156,156082,65,192676
19247,0.001689,172.31.40.0-255,66,156148,65,192676
19248,0.001701,172.31.40.0-255,66,156214,65,192676
19249,0.001705,172.217.194.0-255,1484,157698,65,192676
19250,0.00173,172.217.194.0-255,3602,161300,65,192676
19251,0.001733,172.31.40.0-255,66,161366,65,192676
19252,0.001797,172.217.194.0-255,1484,162850,65,192676
19253,0.001803,172.217.194.0-255,2902,165752,65,192676
19254,0.001806,172.31.40.0-255,66,165818,65,192676
19255,0.001809,172.217.194.0-255,1484,167302,65,192676
19256,0.00183,172.217.194.0-255,4320,171622,65,192676
19257,0.001832,172.31.40.0-255,66,171688,65,192676
19258,0.001871,172.31.40.0-255,66,171754,65,192676
19259,0.001884,172.31.40.0-255,66,171820,65,192676
19260,0.001927,172.217.194.0-255,5738,177558,65,192676
19261,0.001931,172.31.40.0-255,66,177624,65,192676
19262,0.001977,172.31.40.0-255,66,177690,65,192676
19263,0.002006,172.217.194.0-255,7156,184846,65,192676
19264,0.00201,172.31.40.0-255,66,184912,65,192676
19265,0.002046,172.31.40.0-255,66,184978,65,192676
19266,0.002064,172.31.40.0-255,66,185044,65,192676
19267,0.00207,172.217.194.0-255,5020,190064,65,192676
19268,0.002073,172.31.40.0-255,66,190130,65,192676
19269,0.002108,172.217.194.0-255,1484,191614,65,192676
19270,0.002152,172.31.40.0-255,66,191680,65,192676
19271,0.00219,172.217.194.0-255,105,191785,65,192676
19272,0.002212,172.31.40.0-255,66,191851,65,192676
19273,0.002227,172.217.194.0-255,129,191980,65,192676
19274,0.012624,172.31.40.0-255,105,192085,65,192676
19275,0.012674,172.31.40.0-255,105,192190,65,192676
19276,0.012902,172.31.40.0-255,90,192280,65,192676
19277,0.012912,172.31.40.0-255,66,192346,65,192676
19278,0.014889,172.217.194.0-255,66,192412,65,192676
19279,0.014919,172.217.194.0-255,66,192478,65,192676
19280,0.01513,172.217.194.0-255,66,192544,65,192676
19281,0.015159,172.217.194.0-255,66,192610,65,192676
19282,0.01517,172.31.40.0-255,66,192676,65,192676
19283,0.0,172.31.40.0-255,66,66,65,66
19284,0.0,172.217.194.0-255,156,156,65,250786
19285,1.5e-05,172.31.40.0-255,66,222,65,250786
19286,2.2e-05,172.217.194.0-255,1484,1706,65,250786
19287,2.6e-05,172.31.40.0-255,66,1772,65,250786
19288,3.2e-05,172.217.194.0-255,2902,4674,65,250786
19289,4.4e-05,172.31.40.0-255,66,4740,65,250786
19290,5.2e-05,172.217.194.0-255,7156,11896,65,250786
19291,5.7e-05,172.31.40.0-255,66,11962,65,250786
19292,6.2e-05,172.217.194.0-255,2029,13991,65,250786
19293,6.5e-05,172.31.40.0-255,66,14057,65,250786
19294,0.000126,172.217.194.0-255,1484,15541,65,250786
19295,0.000129,172.31.40.0-255,66,15607,65,250786
19296,0.000147,172.217.194.0-255,1484,17091,65,250786
19297,0.00015,172.31.40.0-255,66,17157,65,250786
19298,0.000154,172.217.194.0-255,2902,20059,65,250786
19299,0.000156,172.31.40.0-255,66,20125,65,250786
19300,0.000159,172.217.194.0-255,1484,21609,65,250786
19301,0.000161,172.31.40.0-255,66,21675,65,250786
19302,0.000198,172.217.194.0-255,4320,25995,65,250786
19303,0.000201,172.31.40.0-255,66,26061,65,250786
19304,0.000207,172.217.194.0-255,5379,31440,65,250786
19305,0.00021,172.31.40.0-255,66,31506,65,250786
19306,0.000243,172.217.194.0-255,5738,37244,65,250786
19307,0.000246,172.31.40.0-255,66,37310,65,250786
19308,0.000253,172.217.194.0-255,7156,44466,65,250786
19309,0.000255,172.31.40.0-255,66,44532,65,250786
19310,0.000281,172.217.194.0-255,3961,48493,65,250786
19311,0.000284,172.31.40.0-255,66,48559,65,250786
19312,0.000329,172.217.194.0-255,1484,50043,65,250786
19313,0.000331,172.31.40.0-255,66,50109,65,250786
19314,0.000335,172.217.194.0-255,1484,51593,65,250786
19315,0.000337,172.31.40.0-255,66,51659,65,250786
19316,0.000366,172.217.194.0-255,1484,53143,65,250786
19317,0.000374,172.217.194.0-255,5738,58881,65,250786
19318,0.000376,172.31.40.0-255,66,58947,65,250786
19319,0.000405,172.217.194.0-255,6797,65744,65,250786
19320,0.000408,172.31.40.0-255,66,65810,65,250786
19321,0.00045,172.217.194.0-255,645,66455,65,250786
19322,0.000597,172.217.194.0-255,1484,67939,65,250786
19323,0.000602,172.31.40.0-255,66,68005,65,250786
19324,0.000608,172.217.194.0-255,2902,70907,65,250786
19325,0.000611,172.31.40.0-255,66,70973,65,250786
19326,0.000613,172.217.194.0-255,1484,72457,65,250786
19327,0.000642,172.217.194.0-255,1484,73941,65,250786
19328,0.000644,172.31.40.0-255,66,74007,65,250786
19329,0.000677,172.217.194.0-255,2902,76909,65,250786
19330,0.00068,172.31.40.0-255,66,76975,65,250786
19331,0.000704,172.217.194.0-255,4320,81295,65,250786
19332,0.000708,172.31.40.0-255,66,81361,65,250786
19333,0.000742,172.31.40.0-255,66,81427,65,250786
19334,0.000765,172.217.194.0-255,5738,87165,65,250786
19335,0.000767,172.31.40.0-255,66,87231,65,250786
19336,0.0008,172.217.194.0-255,2902,90133,65,250786
19337,0.000804,172.31.40.0-255,66,90199,65,250786
19338,0.000831,172.217.194.0-255,2184,92383,65,250786
19339,0.000834,172.31.40.0-255,66,92449,65,250786
19340,0.000837,172.217.194.0-255,1484,93933,65,250786
19341,0.000842,172.217.194.0-255,2902,96835,65,250786
19342,0.000844,172.31.40.0-255,66,96901,65,250786
19343,0.000879,172.217.194.0-255,4320,101221,65,250786
19344,0.000885,172.217.194.0-255,5738,106959,65,250786
19345,0.000898,172.31.40.0-255,66,107025,65,250786
19346,0.000901,172.31.40.0-255,66,107091,65,250786
19347,0.000904,172.31.40.0-255,66,107157,65,250786
19348,0.000925,172.217.194.0-255,1484,108641,65,250786
19349,0.000937,172.31.40.0-255,66,108707,65,250786
19350,0.000948,172.31.40.0-255,66,108773,65,250786
19351,0.000955,172.217.194.0-255,7156,115929,65,250786
19352,0.000957,172.31.40.0-255,66,115995,65,250786
19353,0.000983,172.217.194.0-255,1484,117479,65,250786
19354,0.001026,172.31.40.0-255,66,117545,65,250786
19355,0.001056,172.217.194.0-255,7156,124701,65,250786
19356,0.001059,172.31.40.0-255,66,124767,65,250786
19357,0.001101,172.31.40.0-255,66,124833,65,250786
19358,0.001113,172.31.40.0-255,66,124899,65,250786
19359,0.001125,172.217.194.0-255,2902,127801,65,250786
19360,0.001128,172.31.40.0-255,66,127867,65,250786
19361,0.001164,172.217.194.0-255,6438,134305,65,250786
19362,0.001168,172.31.40.0-255,66,134371,65,250786
19363,0.001179,172.31.40.0-255,66,134437,65,250786
19364,0.001193,172.31.40.0-255,66,134503,65,250786
19365,0.001198,172.217.194.0-255,5020,139523,65,250786
19366,0.001225,172.31.40.0-255,66,139589,65,250786
19367,0.001249,172.217.194.0-255,1484,141073,65,250786
19368,0.001264,172.217.194.0-255,2902,143975,65,250786
19369,0.001289,172.217.194.0-255,4320,148295,65,250786
19370,0.001294,172.31.40.0-255,66,148361,65,250786
19371,0.001303,172.217.194.0-255,1484,149845,65,250786
19372,0.00132,172.217.194.0-255,7156,157001,65,250786
19373,0.001326,172.31.40.0-255,66,157067,65,250786
19374,0.001347,172.217.194.0-255,1484,158551,65,250786
19375,0.001403,172.217.194.0-255,7156,165707,65,250786
19376,0.001409,172.31.40.0-255,66,165773,65,250786
19377,0.00143,172.217.194.0-255,5738,171511,65,250786
19378,0.001432,172.31.40.0-255,66,171577,65,250786
19379,0.001436,172.217.194.0-255,2184,173761,65,250786
19380,0.001457,172.217.194.0-255,1484,175245,65,250786
19381,0.001461,172.217.194.0-255,2902,178147,65,250786
19382,0.001514,172.217.194.0-255,5738,183885,65,250786
19383,0.001545,172.217.194.0-255,2902,186787,65,250786
19384,0.001585,172.217.194.0-255,1484,188271,65,250786
19385,0.0016,172.217.194.0-255,2902,191173,65,250786
19386,0.001633,172.217.194.0-255,4320,195493,65,250786
19387,0.001644,172.217.194.0-255,1484,196977,65,250786
19388,0.00165,172.217.194.0-255,5738,202715,65,250786
19389,0.001668,172.217.194.0-255,1484,204199,65,250786
19390,0.001675,172.217.194.0-255,7156,211355,65,250786
19391,0.001702,172.217.194.0-255,7156,218511,65,250786
19392,0.001708,172.217.194.0-255,5020,223531,65,250786
19393,0.001735,172.217.194.0-255,2902,226433,65,250786
19394,0.001758,172.217.194.0-255,7156,233589,65,250786
19395,0.001786,172.217.194.0-255,7156,240745,65,250786
19396,0.001805,172.217.194.0-255,2184,242929,65,250786
19397,0.001825,172.217.194.0-255,2902,245831,65,250786
19398,0.001901,172.217.194.0-255,3655,249486,65,250786
19399,0.001904,172.217.194.0-255,97,249583,65,250786
19400,0.001906,172.217.194.0-255,105,249688,65,250786
19401,0.001921,172.217.194.0-255,129,249817,65,250786
19402,0.00955,172.31.40.0-255,66,249883,65,250786
19403,0.010687,172.217.194.0-255,129,250012,65,250786
19404,0.010699,172.31.40.0-255,78,250090,65,250786
19405,0.01254,172.31.40.0-255,105,250195,65,250786
19406,0.01257,172.31.40.0-255,105,250300,65,250786
19407,0.012826,172.31.40.0-255,90,250390,65,250786
19408,0.012835,172.31.40.0-255,66,250456,65,250786
19409,0.014599,172.217.194.0-255,66,250522,65,250786
19410,0.01461,172.217.194.0-255,66,250588,65,250786
19411,0.014854,172.217.194.0-255,66,250654,65,250786
19412,0.014877,172.217.194.0-255,66,250720,65,250786
19413,0.014886,172.31.40.0-255,66,250786,65,250786
19414,0.0,74.125.130.0-255,148,148,65,260995
19415,1.5e-05,172.31.40.0-255,66,214,65,260995
19416,2.3e-05,74.125.130.0-255,1484,1698,65,260995
19417,2.7e-05,172.31.40.0-255,66,1764,65,260995
19418,4.8e-05,74.125.130.0-255,1484,3248,65,260995
19419,5.1e-05,172.31.40.0-255,66,3314,65,260995
19420,8.5e-05,74.125.130.0-255,2902,6216,65,260995
19421,8.8e-05,172.31.40.0-255,66,6282,65,260995
19422,0.000107,74.125.130.0-255,1484,7766,65,260995
19423,0.000109,172.31.40.0-255,66,7832,65,260995
19424,0.000126,74.125.130.0-255,2902,10734,65,260995
19425,0.000128,172.31.40.0-255,66,10800,65,260995
19426,0.000145,74.125.130.0-255,1484,12284,65,260995
19427,0.000147,172.31.40.0-255,66,12350,65,260995
19428,0.000158,74.125.130.0-255,2136,14486,65,260995
19429,0.00016,172.31.40.0-255,66,14552,65,260995
19430,0.000306,74.125.130.0-255,1484,16036,65,260995
19431,0.000311,172.31.40.0-255,66,16102,65,260995
19432,0.000334,74.125.130.0-255,2902,19004,65,260995
19433,0.000338,172.31.40.0-255,66,19070,65,260995
19434,0.000341,74.125.130.0-255,1484,20554,65,260995
19435,0.000342,172.31.40.0-255,66,20620,65,260995
19436,0.000369,74.125.130.0-255,2902,23522,65,260995
19437,0.000372,172.31.40.0-255,66,23588,65,260995
19438,0.000378,74.125.130.0-255,4320,27908,65,260995
19439,0.00038,172.31.40.0-255,66,27974,65,260995
19440,0.000392,74.125.130.0-255,1484,29458,65,260995
19441,0.000394,172.31.40.0-255,66,29524,65,260995
19442,0.000399,74.125.130.0-255,2543,32067,65,260995
19443,0.000403,172.31.40.0-255,66,32133,65,260995
19444,0.000422,74.125.130.0-255,1484,33617,65,260995
19445,0.000425,172.31.40.0-255,66,33683,65,260995
19446,0.000443,74.125.130.0-255,1484,35167,65,260995
19447,0.00046,74.125.130.0-255,1484,36651,65,260995
19448,0.000462,172.31.40.0-255,66,36717,65,260995
19449,0.000485,74.125.130.0-255,5738,42455,65,260995
19450,0.000488,172.31.40.0-255,66,42521,65,260995
19451,0.00051,74.125.130.0-255,4320,46841,65,260995
19452,0.000512,172.31.40.0-255,66,46907,65,260995
19453,0.000529,74.125.130.0-255,2543,49450,65,260995
19454,0.000532,172.31.40.0-255,66,49516,65,260995
19455,0.000564,74.125.130.0-255,1484,51000,65,260995
19456,0.00058,74.125.130.0-255,2902,53902,65,260995
19457,0.000583,172.31.40.0-255,66,53968,65,260995
19458,0.000603,74.125.130.0-255,2902,56870,65,260995
19459,0.000605,172.31.40.0-255,66,56936,65,260995
19460,0.000625,74.125.130.0-255,2902,59838,65,260995
19461,0.000628,172.31.40.0-255,66,59904,65,260995
19462,0.000635,74.125.130.0-255,6797,66701,65,260995
19463,0.000638,172.31.40.0-255,66,66767,65,260995
19464,0.000656,74.125.130.0-255,646,67413,65,260995
19465,0.000769,74.125.130.0-255,1484,68897,65,260995
19466,0.000774,172.31.40.0-255,66,68963,65,260995
19467,0.000797,74.125.130.0-255,2902,71865,65,260995
19468,0.0008,172.31.40.0-255,66,71931,65,260995
19469,0.000806,74.125.130.0-255,4320,76251,65,260995
19470,0.000808,172.31.40.0-255,66,76317,65,260995
19471,0.000823,74.125.130.0-255,1484,77801,65,260995
19472,0.00083,74.125.130.0-255,6797,84598,65,260995
19473,0.000833,172.31.40.0-255,66,84664,65,260995
19474,0.000886,172.31.40.0-255,66,84730,65,260995
19475,0.000906,74.125.130.0-255,5738,90468,65,260995
19476,0.000908,172.31.40.0-255,66,90534,65,260995
19477,0.000919,74.125.130.0-255,1125,91659,65,260995
19478,0.000982,74.125.130.0-255,1484,93143,65,260995
19479,0.000986,172.31.40.0-255,66,93209,65,260995
19480,0.001019,74.125.130.0-255,2902,96111,65,260995
19481,0.001022,172.31.40.0-255,66,96177,65,260995
19482,0.001026,74.125.130.0-255,1484,97661,65,260995
19483,0.001049,74.125.130.0-255,2902,100563,65,260995
19484,0.001051,172.31.40.0-255,66,100629,65,260995
19485,0.001078,74.125.130.0-255,7156,107785,65,260995
19486,0.001082,172.31.40.0-255,66,107851,65,260995
19487,0.001096,74.125.130.0-255,5738,113589,65,260995
19488,0.001101,172.31.40.0-255,66,113655,65,260995
19489,0.00111,74.125.130.0-255,2902,116557,65,260995
19490,0.001112,172.31.40.0-255,66,116623,65,260995
19491,0.001115,74.125.130.0-255,1484,118107,65,260995
19492,0.001119,74.125.130.0-255,2902,121009,65,260995
19493,0.001122,172.31.40.0-255,66,121075,65,260995
19494,0.001171,74.125.130.0-255,5020,126095,65,260995
19495,0.001173,172.31.40.0-255,66,126161,65,260995
19496,0.001225,74.125.130.0-255,1484,127645,65,260995
19497,0.001243,74.125.130.0-255,2902,130547,65,260995
19498,0.001247,172.31.40.0-255,66,130613,65,260995
19499,0.001271,74.125.130.0-255,5738,136351,65,260995
19500,0.001274,172.31.40.0-255,66,136417,65,260995
19501,0.001277,74.125.130.0-255,1484,137901,65,260995
19502,0.0013,74.125.130.0-255,5738,143639,65,260995
19503,0.001303,172.31.40.0-255,66,143705,65,260995
19504,0.001327,74.125.130.0-255,7156,150861,65,260995
19505,0.00133,172.31.40.0-255,66,150927,65,260995
19506,0.001344,74.125.130.0-255,5738,156665,65,260995
19507,0.001347,172.31.40.0-255,66,156731,65,260995
19508,0.001368,74.125.130.0-255,3602,160333,65,260995
19509,0.001371,172.31.40.0-255,66,160399,65,260995
19510,0.001434,74.125.130.0-255,1484,161883,65,260995
19511,0.001458,74.125.130.0-255,2902,164785,65,260995
19512,0.001462,172.31.40.0-255,66,164851,65,260995
19513,0.001466,74.125.130.0-255,1484,166335,65,260995
19514,0.001497,74.125.130.0-255,1484,167819,65,260995
19515,0.0015,172.31.40.0-255,66,167885,65,260995
19516,0.001506,74.125.130.0-255,4320,172205,65,260995
19517,0.001508,172.31.40.0-255,66,172271,65,260995
19518,0.001526,74.125.130.0-255,7156,179427,65,260995
19519,0.001529,172.31.40.0-255,66,179493,65,260995
19520,0.001562,172.31.40.0-255,66,179559,65,260995
19521,0.001569,74.125.130.0-255,6438,185997,65,260995
19522,0.001571,172.31.40.0-255,66,186063,65,260995
19523,0.001675,74.125.130.0-255,1484,187547,65,260995
19524,0.001695,74.125.130.0-255,2902,190449,65,260995
19525,0.001698,172.31.40.0-255,66,190515,65,260995
19526,0.00172,74.125.130.0-255,5738,196253,65,260995
19527,0.001724,74.125.130.0-255,2902,199155,65,260995
19528,0.001727,172.31.40.0-255,66,199221,65,260995
19529,0.001729,172.31.40.0-255,66,199287,65,260995
19530,0.001748,74.125.130.0-255,2902,202189,65,260995
19531,0.00175,172.31.40.0-255,66,202255,65,260995
19532,0.001779,74.125.130.0-255,7156,209411,65,260995
19533,0.001782,172.31.40.0-255,66,209477,65,260995
19534,0.001787,74.125.130.0-255,5738,215215,65,260995
19535,0.001789,172.31.40.0-255,66,215281,65,260995
19536,0.00183,74.125.130.0-255,5020,220301,65,260995
19537,0.001833,172.31.40.0-255,66,220367,65,260995
19538,0.004211,74.125.130.0-255,5738,226105,65,260995
19539,0.004218,172.31.40.0-255,66,226171,65,260995
19540,0.006595,74.125.130.0-255,5738,231909,65,260995
19541,0.0066,172.31.40.0-255,66,231975,65,260995
19542,0.008984,74.125.130.0-255,5738,237713,65,260995
19543,0.008991,172.31.40.0-255,66,237779,65,260995
19544,0.011377,74.125.130.0-255,5738,243517,65,260995
19545,0.011395,172.31.40.0-255,66,243583,65,260995
19546,0.013785,74.125.130.0-255,5738,249321,65,260995
19547,0.013798,172.31.40.0-255,66,249387,65,260995
19548,0.016195,74.125.130.0-255,5738,255125,65,260995
19549,0.016213,172.31.40.0-255,66,255191,65,260995
19550,0.018602,74.125.130.0-255,5738,260929,65,260995
19551,0.018619,172.31.40.0-255,66,260995,65,260995
19552,0.0,74.125.200.0-255,153,153,65,216115
19553,2.3e-05,172.31.40.0-255,66,219,65,216115
19554,3e-05,74.125.200.0-255,1484,1703,65,216115
19555,3.6e-05,172.31.40.0-255,66,1769,65,216115
19556,4.2e-05,74.125.200.0-255,2902,4671,65,216115
19557,4.5e-05,172.31.40.0-255,66,4737,65,216115
19558,7e-05,74.125.200.0-255,1484,6221,65,216115
19559,7.2e-05,172.31.40.0-255,66,6287,65,216115
19560,0.0001,74.125.200.0-255,1484,7771,65,216115
19561,0.000102,172.31.40.0-255,66,7837,65,216115
19562,0.000121,74.125.200.0-255,1484,9321,65,216115
19563,0.000123,172.31.40.0-255,66,9387,65,216115
19564,0.000131,74.125.200.0-255,6383,15770,65,216115
19565,0.000133,172.31.40.0-255,66,15836,65,216115
19566,0.00014,74.125.200.0-255,5738,21574,65,216115
19567,0.000143,172.31.40.0-255,66,21640,65,216115
19568,0.000165,74.125.200.0-255,7156,28796,65,216115
19569,0.000168,172.31.40.0-255,66,28862,65,216115
19570,0.000173,74.125.200.0-255,2543,31405,65,216115
19571,0.000175,172.31.40.0-255,66,31471,65,216115
19572,0.00028,74.125.200.0-255,1484,32955,65,216115
19573,0.000284,172.31.40.0-255,66,33021,65,216115
19574,0.000302,74.125.200.0-255,2902,35923,65,216115
19575,0.000305,172.31.40.0-255,66,35989,65,216115
19576,0.000326,74.125.200.0-255,2902,38891,65,216115
19577,0.000328,172.31.40.0-255,66,38957,65,216115
19578,0.000348,74.125.200.0-255,4320,43277,65,216115
19579,0.00035,172.31.40.0-255,66,43343,65,216115
19580,0.000381,74.125.200.0-255,5379,48722,65,216115
19581,0.000384,172.31.40.0-255,66,48788,65,216115
19582,0.000388,74.125.200.0-255,2902,51690,65,216115
19583,0.00039,172.31.40.0-255,66,51756,65,216115
19584,0.000406,74.125.200.0-255,2902,54658,65,216115
19585,0.000408,172.31.40.0-255,66,54724,65,216115
19586,0.000427,74.125.200.0-255,4320,59044,65,216115
19587,0.000429,172.31.40.0-255,66,59110,65,216115
19588,0.000432,74.125.200.0-255,1484,60594,65,216115
19589,0.000459,74.125.200.0-255,4320,64914,65,216115
19590,0.000462,172.31.40.0-255,66,64980,65,216115
19591,0.000465,74.125.200.0-255,1400,66380,65,216115
19592,0.000499,74.125.200.0-255,131,66511,65,216115
19593,0.000545,74.125.200.0-255,1484,67995,65,216115
19594,0.000549,172.31.40.0-255,66,68061,65,216115
19595,0.00057,74.125.200.0-255,2902,70963,65,216115
19596,0.000573,172.31.40.0-255,66,71029,65,216115
19597,0.000578,74.125.200.0-255,4320,75349,65,216115
19598,0.00058,172.31.40.0-255,66,75415,65,216115
19599,0.000599,74.125.200.0-255,4320,79735,65,216115
19600,0.000601,172.31.40.0-255,66,79801,65,216115
19601,0.00062,74.125.200.0-255,1484,81285,65,216115
19602,0.000626,74.125.200.0-255,2243,83528,65,216115
19603,0.000628,172.31.40.0-255,66,83594,65,216115
19604,0.000829,74.125.200.0-255,1484,85078,65,216115
19605,0.000855,74.125.200.0-255,2902,87980,65,216115
19606,0.000859,172.31.40.0-255,66,88046,65,216115
19607,0.000866,74.125.200.0-255,5738,93784,65,216115
19608,0.000869,172.31.40.0-255,66,93850,65,216115
19609,0.000892,74.125.200.0-255,7156,101006,65,216115
19610,0.000895,172.31.40.0-255,66,101072,65,216115
19611,0.000912,74.125.200.0-255,1484,102556,65,216115
19612,0.00092,74.125.200.0-255,7156,109712,65,216115
19613,0.000922,172.31.40.0-255,66,109778,65,216115
19614,0.000945,74.125.200.0-255,2902,112680,65,216115
19615,0.000948,172.31.40.0-255,66,112746,65,216115
19616,0.000954,74.125.200.0-255,5020,117766,65,216115
19617,0.000956,172.31.40.0-255,66,117832,65,216115
19618,0.001508,74.125.200.0-255,1484,119316,65,216115
19619,0.00153,74.125.200.0-255,1484,120800,65,216115
19620,0.001533,172.31.40.0-255,66,120866,65,216115
19621,0.001554,74.125.200.0-255,2902,123768,65,216115
19622,0.001557,172.31.40.0-255,66,123834,65,216115
19623,0.001585,74.125.200.0-255,4320,128154,65,216115
19624,0.001588,172.31.40.0-255,66,128220,65,216115
19625,0.001606,74.125.200.0-255,5738,133958,65,216115
19626,0.001609,172.31.40.0-255,66,134024,65,216115
19627,0.001633,74.125.200.0-255,2902,136926,65,216115
19628,0.001637,172.31.40.0-255,66,136992,65,216115
19629,0.001655,74.125.200.0-255,2902,139894,65,216115
19630,0.001658,172.31.40.0-255,66,139960,65,216115
19631,0.001674,74.125.200.0-255,1484,141444,65,216115
19632,0.001684,74.125.200.0-255,1484,142928,65,216115
19633,0.001686,172.31.40.0-255,66,142994,65,216115
19634,0.001743,74.125.200.0-255,1484,144478,65,216115
19635,0.001758,74.125.200.0-255,2902,147380,65,216115
19636,0.001761,172.31.40.0-255,66,147446,65,216115
19637,0.001794,74.125.200.0-255,2902,150348,65,216115
19638,0.001797,172.31.40.0-255,66,150414,65,216115
19639,0.001814,74.125.200.0-255,2184,152598,65,216115
19640,0.001817,172.31.40.0-255,66,152664,65,216115
19641,0.001941,74.125.200.0-255,1484,154148,65,216115
19642,0.001945,74.125.200.0-255,1484,155632,65,216115
19643,0.001948,172.31.40.0-255,66,155698,65,216115
19644,0.001968,74.125.200.0-255,1484,157182,65,216115
19645,0.001975,74.125.200.0-255,5738,162920,65,216115
19646,0.001977,172.31.40.0-255,66,162986,65,216115
19647,0.001997,74.125.200.0-255,1484,164470,65,216115
19648,0.002028,74.125.200.0-255,2902,167372,65,216115
19649,0.002032,172.31.40.0-255,66,167438,65,216115
19650,0.002035,74.125.200.0-255,1484,168922,65,216115
19651,0.002051,74.125.200.0-255,1484,170406,65,216115
19652,0.002054,172.31.40.0-255,66,170472,65,216115
19653,0.002155,172.31.40.0-255,101,170573,65,216115
19654,0.00406,74.125.200.0-255,2902,173475,65,216115
19655,0.004067,172.31.40.0-255,66,173541,65,216115
19656,0.00409,74.125.200.0-255,2902,176443,65,216115
19657,0.004093,172.31.40.0-255,66,176509,65,216115
19658,0.004149,74.125.200.0-255,66,176575,65,216115
19659,0.006084,74.125.200.0-255,2902,179477,65,216115
19660,0.006087,172.31.40.0-255,66,179543,65,216115
19661,0.006107,74.125.200.0-255,2902,182445,65,216115
19662,0.006109,172.31.40.0-255,66,182511,65,216115
19663,0.008112,74.125.200.0-255,2902,185413,65,216115
19664,0.008119,172.31.40.0-255,66,185479,65,216115
19665,0.00814,74.125.200.0-255,2902,188381,65,216115
19666,0.008143,172.31.40.0-255,66,188447,65,216115
19667,0.010191,74.125.200.0-255,4320,192767,65,216115
19668,0.010199,172.31.40.0-255,66,192833,65,216115
19669,0.010218,74.125.200.0-255,1484,194317,65,216115
19670,0.01224,74.125.200.0-255,4320,198637,65,216115
19671,0.012249,172.31.40.0-255,66,198703,65,216115
19672,0.014287,74.125.200.0-255,5738,204441,65,216115
19673,0.014296,172.31.40.0-255,66,204507,65,216115
19674,0.016344,74.125.200.0-255,5738,210245,65,216115
19675,0.016355,172.31.40.0-255,66,210311,65,216115
19676,0.018393,74.125.200.0-255,5738,216049,65,216115
19677,0.018399,172.31.40.0-255,66,216115,65,216115
19678,0.0,74.125.200.0-255,158,158,65,233561
19679,2.3e-05,172.31.40.0-255,66,224,65,233561
19680,3e-05,74.125.200.0-255,1484,1708,65,233561
19681,3.5e-05,172.31.40.0-255,66,1774,65,233561
19682,3.8e-05,74.125.200.0-255,1484,3258,65,233561
19683,4e-05,172.31.40.0-255,66,3324,65,233561
19684,5.3e-05,74.125.200.0-255,2902,6226,65,233561
19685,5.7e-05,172.31.40.0-255,66,6292,65,233561
19686,9.5e-05,74.125.200.0-255,5738,12030,65,233561
19687,9.9e-05,172.31.40.0-255,66,12096,65,233561
19688,0.000126,74.125.200.0-255,6400,18496,65,233561
19689,0.000129,172.31.40.0-255,66,18562,65,233561
19690,0.000132,74.125.200.0-255,1484,20046,65,233561
19691,0.000134,172.31.40.0-255,66,20112,65,233561
19692,0.000137,74.125.200.0-255,1484,21596,65,233561
19693,0.000139,172.31.40.0-255,66,21662,65,233561
19694,0.000164,74.125.200.0-255,1484,23146,65,233561
19695,0.000166,172.31.40.0-255,66,23212,65,233561
19696,0.000172,74.125.200.0-255,5738,28950,65,233561
19697,0.000175,172.31.40.0-255,66,29016,65,233561
19698,0.000179,74.125.200.0-255,2543,31559,65,233561
19699,0.000181,172.31.40.0-255,66,31625,65,233561
19700,0.000449,74.125.200.0-255,1484,33109,65,233561
19701,0.000455,172.31.40.0-255,66,33175,65,233561
19702,0.000461,74.125.200.0-255,2902,36077,65,233561
19703,0.000464,172.31.40.0-255,66,36143,65,233561
19704,0.000491,74.125.200.0-255,5738,41881,65,233561
19705,0.000494,172.31.40.0-255,66,41947,65,233561
19706,0.000523,74.125.200.0-255,4320,46267,65,233561
19707,0.000526,172.31.40.0-255,66,46333,65,233561
19708,0.00053,74.125.200.0-255,2902,49235,65,233561
19709,0.000532,172.31.40.0-255,66,49301,65,233561
19710,0.00057,74.125.200.0-255,2543,51844,65,233561
19711,0.000574,172.31.40.0-255,66,51910,65,233561
19712,0.00058,74.125.200.0-255,5738,57648,65,233561
19713,0.000583,172.31.40.0-255,66,57714,65,233561
19714,0.00062,74.125.200.0-255,7156,64870,65,233561
19715,0.000623,172.31.40.0-255,66,64936,65,233561
19716,0.000626,74.125.200.0-255,1400,66336,65,233561
19717,0.000756,74.125.200.0-255,131,66467,65,233561
19718,0.001097,74.125.200.0-255,1484,67951,65,233561
19719,0.001102,172.31.40.0-255,66,68017,65,233561
19720,0.001107,74.125.200.0-255,2902,70919,65,233561
19721,0.001109,172.31.40.0-255,66,70985,65,233561
19722,0.001139,74.125.200.0-255,5738,76723,65,233561
19723,0.001142,74.125.200.0-255,1484,78207,65,233561
19724,0.001146,172.31.40.0-255,66,78273,65,233561
19725,0.001183,172.31.40.0-255,66,78339,65,233561
19726,0.00119,74.125.200.0-255,7156,85495,65,233561
19727,0.001192,172.31.40.0-255,66,85561,65,233561
19728,0.001223,74.125.200.0-255,5020,90581,65,233561
19729,0.001228,172.31.40.0-255,66,90647,65,233561
19730,0.001515,74.125.200.0-255,1484,92131,65,233561
19731,0.001531,74.125.200.0-255,2902,95033,65,233561
19732,0.001535,172.31.40.0-255,66,95099,65,233561
19733,0.001539,74.125.200.0-255,2902,98001,65,233561
19734,0.001541,172.31.40.0-255,66,98067,65,233561
19735,0.001574,74.125.200.0-255,2902,100969,65,233561
19736,0.001577,172.31.40.0-255,66,101035,65,233561
19737,0.001585,74.125.200.0-255,7156,108191,65,233561
19738,0.001587,172.31.40.0-255,66,108257,65,233561
19739,0.00163,172.31.40.0-255,66,108323,65,233561
19740,0.001666,74.125.200.0-255,2902,111225,65,233561
19741,0.001668,172.31.40.0-255,66,111291,65,233561
19742,0.001705,172.31.40.0-255,66,111357,65,233561
19743,0.001744,172.31.40.0-255,66,111423,65,233561
19744,0.001766,74.125.200.0-255,4320,115743,65,233561
19745,0.001768,172.31.40.0-255,66,115809,65,233561
19746,0.001774,74.125.200.0-255,4320,120129,65,233561
19747,0.001777,172.31.40.0-255,66,120195,65,233561
19748,0.001782,74.125.200.0-255,3602,123797,65,233561
19749,0.001784,172.31.40.0-255,66,123863,65,233561
19750,0.001902,74.125.200.0-255,1484,125347,65,233561
19751,0.001918,74.125.200.0-255,2902,128249,65,233561
19752,0.001921,172.31.40.0-255,66,128315,65,233561
19753,0.001926,74.125.200.0-255,2902,131217,65,233561
19754,0.001928,172.31.40.0-255,66,131283,65,233561
19755,0.001957,74.125.200.0-255,2902,134185,65,233561
19756,0.001959,172.31.40.0-255,66,134251,65,233561
19757,0.001965,74.125.200.0-255,4320,138571,65,233561
19758,0.001967,172.31.40.0-255,66,138637,65,233561
19759,0.002002,74.125.200.0-255,4320,142957,65,233561
19760,0.002006,172.31.40.0-255,66,143023,65,233561
19761,0.002017,172.31.40.0-255,66,143089,65,233561
19762,0.002023,74.125.200.0-255,5020,148109,65,233561
19763,0.002025,172.31.40.0-255,66,148175,65,233561
19764,0.002098,74.125.200.0-255,1484,149659,65,233561
19765,0.002116,74.125.200.0-255,2902,152561,65,233561
19766,0.00212,172.31.40.0-255,66,152627,65,233561
19767,0.002151,74.125.200.0-255,5738,158365,65,233561
19768,0.002155,172.31.40.0-255,66,158431,65,233561
19769,0.002162,74.125.200.0-255,7156,165587,65,233561
19770,0.002165,172.31.40.0-255,66,165653,65,233561
19771,0.002202,74.125.200.0-255,5738,171391,65,233561
19772,0.002204,172.31.40.0-255,66,171457,65,233561
19773,0.002211,74.125.200.0-255,5738,177195,65,233561
19774,0.002213,172.31.40.0-255,66,177261,65,233561
19775,0.002217,74.125.200.0-255,1484,178745,65,233561
19776,0.002262,172.31.40.0-255,66,178811,65,233561
19777,0.002274,74.125.200.0-255,7156,185967,65,233561
19778,0.002277,172.31.40.0-255,66,186033,65,233561
19779,0.002321,172.31.40.0-255,66,186099,65,233561
19780,0.002325,74.125.200.0-255,2184,188283,65,233561
19781,0.002328,172.31.40.0-255,66,188349,65,233561
19782,0.002335,74.125.200.0-255,5738,194087,65,233561
19783,0.002338,172.31.40.0-255,66,194153,65,233561
19784,0.00238,172.31.40.0-255,66,194219,65,233561
19785,0.002394,172.31.40.0-255,66,194285,65,233561
19786,0.00473,74.125.200.0-255,5738,200023,65,233561
19787,0.004738,172.31.40.0-255,66,200089,65,233561
19788,0.007075,74.125.200.0-255,5738,205827,65,233561
19789,0.007087,172.31.40.0-255,66,205893,65,233561
19790,0.009446,74.125.200.0-255,5738,211631,65,233561
19791,0.009463,172.31.40.0-255,66,211697,65,233561
19792,0.011838,74.125.200.0-255,4320,216017,65,233561
19793,0.011846,172.31.40.0-255,66,216083,65,233561
19794,0.011874,74.125.200.0-255,1484,217567,65,233561
19795,0.014217,74.125.200.0-255,4320,221887,65,233561
19796,0.014222,172.31.40.0-255,66,221953,65,233561
19797,0.016573,74.125.200.0-255,5738,227691,65,233561
19798,0.016586,172.31.40.0-255,66,227757,65,233561
19799,0.018936,74.125.200.0-255,5738,233495,65,233561
19800,0.018946,172.31.40.0-255,66,233561,65,233561
19801,0.0,172.217.194.0-255,292,292,65,121173
19802,3e-05,172.31.40.0-255,66,358,65,121173
19803,3.5e-05,172.217.194.0-255,1484,1842,65,121173
19804,3.9e-05,172.31.40.0-255,66,1908,65,121173
19805,5.3e-05,172.217.194.0-255,4320,6228,65,121173
19806,5.6e-05,172.31.40.0-255,66,6294,65,121173
19807,9.4e-05,172.217.194.0-255,4320,10614,65,121173
19808,9.7e-05,172.31.40.0-255,66,10680,65,121173
19809,0.000121,172.217.194.0-255,3551,14231,65,121173
19810,0.000123,172.31.40.0-255,66,14297,65,121173
19811,0.000126,172.217.194.0-255,1484,15781,65,121173
19812,0.000128,172.31.40.0-255,66,15847,65,121173
19813,0.000132,172.217.194.0-255,2902,18749,65,121173
19814,0.000138,172.31.40.0-255,66,18815,65,121173
19815,0.000174,172.217.194.0-255,5738,24553,65,121173
19816,0.000177,172.31.40.0-255,66,24619,65,121173
19817,0.000194,172.217.194.0-255,4320,28939,65,121173
19818,0.000196,172.31.40.0-255,66,29005,65,121173
19819,0.00022,172.217.194.0-255,2543,31548,65,121173
19820,0.000222,172.31.40.0-255,66,31614,65,121173
19821,0.000228,172.217.194.0-255,7156,38770,65,121173
19822,0.00023,172.31.40.0-255,66,38836,65,121173
19823,0.000233,172.217.194.0-255,1484,40320,65,121173
19824,0.000234,172.31.40.0-255,66,40386,65,121173
19825,0.000283,172.217.194.0-255,5738,46124,65,121173
19826,0.000288,172.31.40.0-255,66,46190,65,121173
19827,0.000316,172.217.194.0-255,5379,51569,65,121173
19828,0.000319,172.31.40.0-255,66,51635,65,121173
19829,0.000334,172.31.40.0-255,66,51701,65,121173
19830,0.000338,172.217.194.0-255,2543,54244,65,121173
19831,0.00034,172.31.40.0-255,66,54310,65,121173
19832,0.000604,172.217.194.0-255,366,54676,65,121173
19833,0.000732,172.31.40.0-255,66,54742,65,121173
19834,0.001037,172.217.194.0-255,377,55119,65,121173
19835,0.001074,172.31.40.0-255,66,55185,65,121173
19836,0.001312,172.217.194.0-255,1484,56669,65,121173
19837,0.001322,172.217.194.0-255,2902,59571,65,121173
19838,0.001327,172.31.40.0-255,66,59637,65,121173
19839,0.001336,172.217.194.0-255,5738,65375,65,121173
19840,0.001338,172.31.40.0-255,66,65441,65,121173
19841,0.001349,172.217.194.0-255,2902,68343,65,121173
19842,0.001351,172.31.40.0-255,66,68409,65,121173
19843,0.001379,172.31.40.0-255,66,68475,65,121173
19844,0.001418,172.31.40.0-255,66,68541,65,121173
19845,0.002063,172.217.194.0-255,1484,70025,65,121173
19846,0.0021,172.217.194.0-255,2902,72927,65,121173
19847,0.002104,172.31.40.0-255,66,72993,65,121173
19848,0.00211,172.217.194.0-255,5738,78731,65,121173
19849,0.002112,172.31.40.0-255,66,78797,65,121173
19850,0.002115,172.217.194.0-255,2902,81699,65,121173
19851,0.002122,172.31.40.0-255,66,81765,65,121173
19852,0.002134,172.31.40.0-255,66,81831,65,121173
19853,0.002187,172.31.40.0-255,66,81897,65,121173
19854,0.004464,172.217.194.0-255,4320,86217,65,121173
19855,0.004469,172.31.40.0-255,66,86283,65,121173
19856,0.004494,172.217.194.0-255,1484,87767,65,121173
19857,0.006765,172.217.194.0-255,4320,92087,65,121173
19858,0.006773,172.31.40.0-255,66,92153,65,121173
19859,0.009124,172.217.194.0-255,5738,97891,65,121173
19860,0.009132,172.31.40.0-255,66,97957,65,121173
19861,0.011435,172.217.194.0-255,5738,103695,65,121173
19862,0.011443,172.31.40.0-255,66,103761,65,121173
19863,0.013757,172.217.194.0-255,5738,109499,65,121173
19864,0.013768,172.31.40.0-255,66,109565,65,121173
19865,0.016113,172.217.194.0-255,5738,115303,65,121173
19866,0.016121,172.31.40.0-255,66,115369,65,121173
19867,0.018389,172.217.194.0-255,5738,121107,65,121173
19868,0.018396,172.31.40.0-255,66,121173,65,121173
19869,0.0,74.125.24.0-255,153,153,65,220292
19870,2e-05,172.31.40.0-255,66,219,65,220292
19871,2.6e-05,74.125.24.0-255,1484,1703,65,220292
19872,3e-05,172.31.40.0-255,66,1769,65,220292
19873,3.6e-05,74.125.24.0-255,2902,4671,65,220292
19874,3.9e-05,172.31.40.0-255,66,4737,65,220292
19875,4.6e-05,74.125.24.0-255,7156,11893,65,220292
19876,4.9e-05,172.31.40.0-255,66,11959,65,220292
19877,7.3e-05,74.125.24.0-255,2068,14027,65,220292
19878,7.7e-05,172.31.40.0-255,66,14093,65,220292
19879,8.1e-05,74.125.24.0-255,2902,16995,65,220292
19880,8.4e-05,172.31.40.0-255,66,17061,65,220292
19881,0.000115,74.125.24.0-255,7156,24217,65,220292
19882,0.000118,172.31.40.0-255,66,24283,65,220292
19883,0.000125,74.125.24.0-255,6797,31080,65,220292
19884,0.000127,172.31.40.0-255,66,31146,65,220292
19885,0.000193,74.125.24.0-255,1484,32630,65,220292
19886,0.000196,172.31.40.0-255,66,32696,65,220292
19887,0.000201,74.125.24.0-255,2902,35598,65,220292
19888,0.000202,172.31.40.0-255,66,35664,65,220292
19889,0.000215,74.125.24.0-255,2902,38566,65,220292
19890,0.000218,172.31.40.0-255,66,38632,65,220292
19891,0.000241,74.125.24.0-255,2902,41534,65,220292
19892,0.000244,172.31.40.0-255,66,41600,65,220292
19893,0.000247,74.125.24.0-255,1484,43084,65,220292
19894,0.000249,172.31.40.0-255,66,43150,65,220292
19895,0.000275,172.31.40.0-255,66,43216,65,220292
19896,0.000282,74.125.24.0-255,7156,50372,65,220292
19897,0.000285,172.31.40.0-255,66,50438,65,220292
19898,0.000317,74.125.24.0-255,1484,51922,65,220292
19899,0.000319,172.31.40.0-255,66,51988,65,220292
19900,0.000337,74.125.24.0-255,4236,56224,65,220292
19901,0.000349,74.125.24.0-255,130,56354,65,220292
19902,0.00047,172.31.40.0-255,66,56420,65,220292
19903,0.000719,74.125.24.0-255,348,56768,65,220292
19904,0.001022,172.31.40.0-255,66,56834,65,220292
19905,0.001056,74.125.24.0-255,1484,58318,65,220292
19906,0.001061,74.125.24.0-255,2902,61220,65,220292
19907,0.001064,172.31.40.0-255,66,61286,65,220292
19908,0.00107,74.125.24.0-255,5738,67024,65,220292
19909,0.001072,172.31.40.0-255,66,67090,65,220292
19910,0.001087,74.125.24.0-255,1484,68574,65,220292
19911,0.001112,172.31.40.0-255,66,68640,65,220292
19912,0.001161,172.31.40.0-255,66,68706,65,220292
19913,0.001528,74.125.24.0-255,1484,70190,65,220292
19914,0.001535,74.125.24.0-255,2902,73092,65,220292
19915,0.001539,172.31.40.0-255,66,73158,65,220292
19916,0.001546,74.125.24.0-255,4320,77478,65,220292
19917,0.001548,172.31.40.0-255,66,77544,65,220292
19918,0.001566,74.125.24.0-255,1484,79028,65,220292
19919,0.001573,74.125.24.0-255,7156,86184,65,220292
19920,0.001575,172.31.40.0-255,66,86250,65,220292
19921,0.001595,74.125.24.0-255,5738,91988,65,220292
19922,0.001597,172.31.40.0-255,66,92054,65,220292
19923,0.001607,172.31.40.0-255,66,92120,65,220292
19924,0.001629,74.125.24.0-255,2184,94304,65,220292
19925,0.001631,172.31.40.0-255,66,94370,65,220292
19926,0.001678,74.125.24.0-255,2902,97272,65,220292
19927,0.001681,172.31.40.0-255,66,97338,65,220292
19928,0.001697,74.125.24.0-255,4320,101658,65,220292
19929,0.0017,172.31.40.0-255,66,101724,65,220292
19930,0.001705,74.125.24.0-255,2902,104626,65,220292
19931,0.001707,172.31.40.0-255,66,104692,65,220292
19932,0.001731,74.125.24.0-255,5738,110430,65,220292
19933,0.001789,74.125.24.0-255,6438,116868,65,220292
19934,0.001882,74.125.24.0-255,1484,118352,65,220292
19935,0.001895,74.125.24.0-255,2902,121254,65,220292
19936,0.001902,74.125.24.0-255,2902,124156,65,220292
19937,0.001914,74.125.24.0-255,2902,127058,65,220292
19938,0.001929,74.125.24.0-255,5738,132796,65,220292
19939,0.001953,74.125.24.0-255,7156,139952,65,220292
19940,0.001959,74.125.24.0-255,5738,145690,65,220292
19941,0.001997,74.125.24.0-255,5020,150710,65,220292
19942,0.002118,74.125.24.0-255,1484,152194,65,220292
19943,0.002122,74.125.24.0-255,1484,153678,65,220292
19944,0.002135,74.125.24.0-255,1484,155162,65,220292
19945,0.00214,74.125.24.0-255,4320,159482,65,220292
19946,0.00215,74.125.24.0-255,1484,160966,65,220292
19947,0.002171,74.125.24.0-255,7156,168122,65,220292
19948,0.002193,74.125.24.0-255,5738,173860,65,220292
19949,0.002198,74.125.24.0-255,2902,176762,65,220292
19950,0.002252,74.125.24.0-255,5738,182500,65,220292
19951,0.002306,74.125.24.0-255,5738,188238,65,220292
19952,0.00238,74.125.24.0-255,4320,192558,65,220292
19953,0.007783,172.31.40.0-255,66,192624,65,220292
19954,0.010118,74.125.24.0-255,5738,198362,65,220292
19955,0.010131,172.31.40.0-255,66,198428,65,220292
19956,0.012436,74.125.24.0-255,5738,204166,65,220292
19957,0.012444,172.31.40.0-255,66,204232,65,220292
19958,0.014742,74.125.24.0-255,4320,208552,65,220292
19959,0.014745,172.31.40.0-255,66,208618,65,220292
19960,0.014763,74.125.24.0-255,1484,210102,65,220292
19961,0.017069,74.125.24.0-255,4320,214422,65,220292
19962,0.017087,172.31.40.0-255,66,214488,65,220292
19963,0.019413,74.125.24.0-255,5738,220226,65,220292
19964,0.019432,172.31.40.0-255,66,220292,65,220292
19965,0.0,172.217.194.0-255,152,152,65,136900
19966,2.2e-05,172.31.40.0-255,66,218,65,136900
19967,2.8e-05,172.217.194.0-255,1484,1702,65,136900
19968,3.2e-05,172.31.40.0-255,66,1768,65,136900
19969,3.7e-05,172.217.194.0-255,2902,4670,65,136900
19970,3.9e-05,172.31.40.0-255,66,4736,65,136900
19971,4.4e-05,172.217.194.0-255,4320,9056,65,136900
19972,4.6e-05,172.31.40.0-255,66,9122,65,136900
19973,5.6e-05,172.31.40.0-255,66,9188,65,136900
19974,6.3e-05,172.217.194.0-255,5738,14926,65,136900
19975,6.5e-05,172.31.40.0-255,66,14992,65,136900
19976,8.7e-05,172.217.194.0-255,2902,17894,65,136900
19977,9e-05,172.31.40.0-255,66,17960,65,136900
19978,0.000114,172.217.194.0-255,3961,21921,65,136900
19979,0.000117,172.31.40.0-255,66,21987,65,136900
19980,0.000161,172.217.194.0-255,2902,24889,65,136900
19981,0.000163,172.31.40.0-255,66,24955,65,136900
19982,0.000169,172.217.194.0-255,4320,29275,65,136900
19983,0.000171,172.31.40.0-255,66,29341,65,136900
19984,0.000193,172.217.194.0-255,4320,33661,65,136900
19985,0.000195,172.31.40.0-255,66,33727,65,136900
19986,0.000215,172.217.194.0-255,4320,38047,65,136900
19987,0.000217,172.31.40.0-255,66,38113,65,136900
19988,0.00027,172.31.40.0-255,66,38179,65,136900
19989,0.000273,172.217.194.0-255,99,38278,65,136900
19990,0.000275,172.31.40.0-255,66,38344,65,136900
19991,0.000326,172.217.194.0-255,1484,39828,65,136900
19992,0.000329,172.31.40.0-255,66,39894,65,136900
19993,0.000334,172.217.194.0-255,2902,42796,65,136900
19994,0.000336,172.31.40.0-255,66,42862,65,136900
19995,0.000342,172.217.194.0-255,5738,48600,65,136900
19996,0.000344,172.31.40.0-255,66,48666,65,136900
19997,0.000377,172.217.194.0-255,1484,50150,65,136900
19998,0.000385,172.217.194.0-255,5094,55244,65,136900
19999,0.000387,172.31.40.0-255,66,55310,65,136900
20000,0.000435,172.217.194.0-255,2902,58212,65,136900
20001,0.000438,172.31.40.0-255,66,58278,65,136900
20002,0.000443,172.217.194.0-255,4320,62598,65,136900
20003,0.000445,172.31.40.0-255,66,62664,65,136900
20004,0.000455,172.31.40.0-255,66,62730,65,136900
20005,0.000458,172.217.194.0-255,1125,63855,65,136900
20006,0.000597,172.217.194.0-255,1484,65339,65,136900
20007,0.000601,172.31.40.0-255,66,65405,65,136900
20008,0.000606,172.217.194.0-255,2902,68307,65,136900
20009,0.000607,172.31.40.0-255,66,68373,65,136900
20010,0.000628,172.217.194.0-255,5738,74111,65,136900
20011,0.000633,172.217.194.0-255,4320,78431,65,136900
20012,0.000637,172.31.40.0-255,66,78497,65,136900
20013,0.000641,172.31.40.0-255,66,78563,65,136900
20014,0.000662,172.31.40.0-255,66,78629,65,136900
20015,0.000678,172.217.194.0-255,1484,80113,65,136900
20016,0.000707,172.31.40.0-255,66,80179,65,136900
20017,0.000722,172.217.194.0-255,4320,84499,65,136900
20018,0.000725,172.31.40.0-255,66,84565,65,136900
20019,0.00073,172.217.194.0-255,4320,88885,65,136900
20020,0.000732,172.31.40.0-255,66,88951,65,136900
20021,0.000757,172.217.194.0-255,1484,90435,65,136900
20022,0.00077,172.31.40.0-255,66,90501,65,136900
20023,0.000807,172.31.40.0-255,66,90567,65,136900
20024,0.000855,172.217.194.0-255,1484,92051,65,136900
20025,0.000883,172.217.194.0-255,2902,94953,65,136900
20026,0.000886,172.31.40.0-255,66,95019,65,136900
20027,0.000893,172.217.194.0-255,5738,100757,65,136900
20028,0.000895,172.31.40.0-255,66,100823,65,136900
20029,0.000899,172.217.194.0-255,2902,103725,65,136900
20030,0.000901,172.31.40.0-255,66,103791,65,136900
20031,0.000954,172.31.40.0-255,66,103857,65,136900
20032,0.000967,172.31.40.0-255,66,103923,65,136900
20033,0.000998,172.217.194.0-255,1484,105407,65,136900
20034,0.001002,172.217.194.0-255,2902,108309,65,136900
20035,0.001004,172.31.40.0-255,66,108375,65,136900
20036,0.001035,172.217.194.0-255,5738,114113,65,136900
20037,0.001039,172.31.40.0-255,66,114179,65,136900
20038,0.001046,172.217.194.0-255,7156,121335,65,136900
20039,0.001048,172.31.40.0-255,66,121401,65,136900
20040,0.001064,172.217.194.0-255,1484,122885,65,136900
20041,0.001094,172.31.40.0-255,66,122951,65,136900
20042,0.001101,172.217.194.0-255,5020,127971,65,136900
20043,0.001103,172.31.40.0-255,66,128037,65,136900
20044,0.00119,172.31.40.0-255,66,128103,65,136900
20045,0.001203,172.31.40.0-255,66,128169,65,136900
20046,0.001216,172.31.40.0-255,66,128235,65,136900
20047,0.001226,172.31.40.0-255,66,128301,65,136900
20048,0.001264,172.217.194.0-255,5738,134039,65,136900
20049,0.001267,172.31.40.0-255,66,134105,65,136900
20050,0.001279,172.31.40.0-255,66,134171,65,136900
20051,0.00129,172.31.40.0-255,66,134237,65,136900
20052,0.001293,172.217.194.0-255,1484,135721,65,136900
20053,0.001344,172.31.40.0-255,66,135787,65,136900
20054,0.001356,172.31.40.0-255,66,135853,65,136900
20055,0.001395,172.31.40.0-255,66,135919,65,136900
20056,0.001442,172.31.40.0-255,66,135985,65,136900
20057,0.001455,172.31.40.0-255,66,136051,65,136900
20058,0.001478,172.31.40.0-255,66,136117,65,136900
20059,0.001481,172.217.194.0-255,105,136222,65,136900
20060,0.001484,172.217.194.0-255,129,136351,65,136900
20061,0.010969,172.217.194.0-255,129,136480,65,136900
20062,0.010989,172.31.40.0-255,78,136558,65,136900
20063,0.01206,172.31.40.0-255,105,136663,65,136900
20064,0.012092,172.31.40.0-255,105,136768,65,136900
20065,0.014355,172.217.194.0-255,66,136834,65,136900
20066,0.014381,172.217.194.0-255,66,136900,65,136900
20067,0.0,74.125.68.0-255,153,153,65,174599
20068,1.7e-05,172.31.40.0-255,66,219,65,174599
20069,2.4e-05,74.125.68.0-255,1484,1703,65,174599
20070,2.9e-05,172.31.40.0-255,66,1769,65,174599
20071,3.5e-05,74.125.68.0-255,2902,4671,65,174599
20072,3.8e-05,172.31.40.0-255,66,4737,65,174599
20073,4.1e-05,74.125.68.0-255,1484,6221,65,174599
20074,4.4e-05,172.31.40.0-255,66,6287,65,174599
20075,7.1e-05,74.125.68.0-255,4320,10607,65,174599
20076,7.4e-05,172.31.40.0-255,66,10673,65,174599
20077,8e-05,74.125.68.0-255,3455,14128,65,174599
20078,8.2e-05,172.31.40.0-255,66,14194,65,174599
20079,0.000521,74.125.68.0-255,1484,15678,65,174599
20080,0.000527,172.31.40.0-255,66,15744,65,174599
20081,0.000535,74.125.68.0-255,2902,18646,65,174599
20082,0.000537,172.31.40.0-255,66,18712,65,174599
20083,0.000544,74.125.68.0-255,5738,24450,65,174599
20084,0.000547,172.31.40.0-255,66,24516,65,174599
20085,0.000583,74.125.68.0-255,4320,28836,65,174599
20086,0.000586,172.31.40.0-255,66,28902,65,174599
20087,0.000605,74.125.68.0-255,2543,31445,65,174599
20088,0.000607,172.31.40.0-255,66,31511,65,174599
20089,0.00071,74.125.68.0-255,1484,32995,65,174599
20090,0.000714,172.31.40.0-255,66,33061,65,174599
20091,0.00072,74.125.68.0-255,2902,35963,65,174599
20092,0.000723,172.31.40.0-255,66,36029,65,174599
20093,0.000728,74.125.68.0-255,2902,38931,65,174599
20094,0.00073,172.31.40.0-255,66,38997,65,174599
20095,0.000757,74.125.68.0-255,1484,40481,65,174599
20096,0.00076,172.31.40.0-255,66,40547,65,174599
20097,0.000767,74.125.68.0-255,5738,46285,65,174599
20098,0.00077,172.31.40.0-255,66,46351,65,174599
20099,0.000772,74.125.68.0-255,1484,47835,65,174599
20100,0.000791,74.125.68.0-255,3961,51796,65,174599
20101,0.000794,172.31.40.0-255,66,51862,65,174599
20102,0.0008,74.125.68.0-255,5738,57600,65,174599
20103,0.000802,172.31.40.0-255,66,57666,65,174599
20104,0.000824,74.125.68.0-255,1484,59150,65,174599
20105,0.000851,74.125.68.0-255,6797,65947,65,174599
20106,0.000855,172.31.40.0-255,66,66013,65,174599
20107,0.000858,74.125.68.0-255,391,66404,65,174599
20108,0.001171,74.125.68.0-255,351,66755,65,174599
20109,0.001214,74.125.68.0-255,1484,68239,65,174599
20110,0.001219,172.31.40.0-255,66,68305,65,174599
20111,0.001227,74.125.68.0-255,4320,72625,65,174599
20112,0.00123,172.31.40.0-255,66,72691,65,174599
20113,0.001255,74.125.68.0-255,2902,75593,65,174599
20114,0.001258,172.31.40.0-255,66,75659,65,174599
20115,0.001264,74.125.68.0-255,4320,79979,65,174599
20116,0.001267,172.31.40.0-255,66,80045,65,174599
20117,0.001295,74.125.68.0-255,2902,82947,65,174599
20118,0.001298,172.31.40.0-255,66,83013,65,174599
20119,0.00131,74.125.68.0-255,2902,85915,65,174599
20120,0.001314,172.31.40.0-255,66,85981,65,174599
20121,0.001321,74.125.68.0-255,7156,93137,65,174599
20122,0.001323,172.31.40.0-255,66,93203,65,174599
20123,0.001357,172.31.40.0-255,66,93269,65,174599
20124,0.001516,74.125.68.0-255,1484,94753,65,174599
20125,0.001524,74.125.68.0-255,2902,97655,65,174599
20126,0.001527,172.31.40.0-255,66,97721,65,174599
20127,0.001552,74.125.68.0-255,1484,99205,65,174599
20128,0.001566,74.125.68.0-255,2902,102107,65,174599
20129,0.001569,172.31.40.0-255,66,102173,65,174599
20130,0.001586,74.125.68.0-255,1484,103657,65,174599
20131,0.001589,74.125.68.0-255,1484,105141,65,174599
20132,0.001591,172.31.40.0-255,66,105207,65,174599
20133,0.001602,172.31.40.0-255,66,105273,65,174599
20134,0.001607,74.125.68.0-255,4320,109593,65,174599
20135,0.00161,172.31.40.0-255,66,109659,65,174599
20136,0.001651,74.125.68.0-255,1484,111143,65,174599
20137,0.001672,172.31.40.0-255,66,111209,65,174599
20138,0.002147,74.125.68.0-255,1484,112693,65,174599
20139,0.002162,74.125.68.0-255,2902,115595,65,174599
20140,0.002166,172.31.40.0-255,66,115661,65,174599
20141,0.002187,74.125.68.0-255,5738,121399,65,174599
20142,0.002189,172.31.40.0-255,66,121465,65,174599
20143,0.002237,74.125.68.0-255,2902,124367,65,174599
20144,0.00224,172.31.40.0-255,66,124433,65,174599
20145,0.00226,74.125.68.0-255,7156,131589,65,174599
20146,0.002263,172.31.40.0-255,66,131655,65,174599
20147,0.002276,172.31.40.0-255,66,131721,65,174599
20148,0.00228,74.125.68.0-255,2184,133905,65,174599
20149,0.002283,172.31.40.0-255,66,133971,65,174599
20150,0.004603,74.125.68.0-255,5738,139709,65,174599
20151,0.004611,172.31.40.0-255,66,139775,65,174599
20152,0.006954,74.125.68.0-255,5738,145513,65,174599
20153,0.006961,172.31.40.0-255,66,145579,65,174599
20154,0.009328,74.125.68.0-255,5738,151317,65,174599
20155,0.009336,172.31.40.0-255,66,151383,65,174599
20156,0.011675,74.125.68.0-255,5738,157121,65,174599
20157,0.011682,172.31.40.0-255,66,157187,65,174599
20158,0.014008,74.125.68.0-255,5738,162925,65,174599
20159,0.014015,172.31.40.0-255,66,162991,65,174599
20160,0.016352,74.125.68.0-255,5738,168729,65,174599
20161,0.01636,172.31.40.0-255,66,168795,65,174599
20162,0.018693,74.125.68.0-255,5738,174533,65,174599
20163,0.018701,172.31.40.0-255,66,174599,65,174599
20164,0.0,172.217.194.0-255,153,153,65,108437
20165,2.3e-05,172.31.40.0-255,66,219,65,108437
20166,3e-05,172.217.194.0-255,1484,1703,65,108437
20167,3.4e-05,172.31.40.0-255,66,1769,65,108437
20168,4.1e-05,172.217.194.0-255,2902,4671,65,108437
20169,4.4e-05,172.31.40.0-255,66,4737,65,108437
20170,5.1e-05,172.217.194.0-255,5738,10475,65,108437
20171,5.4e-05,172.31.40.0-255,66,10541,65,108437
20172,8.2e-05,172.217.194.0-255,1484,12025,65,108437
20173,8.4e-05,172.31.40.0-255,66,12091,65,108437
20174,8.9e-05,172.217.194.0-255,2133,14224,65,108437
20175,9.1e-05,172.31.40.0-255,66,14290,65,108437
20176,9.8e-05,172.217.194.0-255,7156,21446,65,108437
20177,0.000101,172.31.40.0-255,66,21512,65,108437
20178,0.000139,172.217.194.0-255,4320,25832,65,108437
20179,0.000141,172.31.40.0-255,66,25898,65,108437
20180,0.000161,172.31.40.0-255,66,25964,65,108437
20181,0.000164,172.217.194.0-255,766,26730,65,108437
20182,0.000166,172.31.40.0-255,66,26796,65,108437
20183,0.000297,172.217.194.0-255,1484,28280,65,108437
20184,0.000301,172.31.40.0-255,66,28346,65,108437
20185,0.000307,172.217.194.0-255,2902,31248,65,108437
20186,0.000309,172.31.40.0-255,66,31314,65,108437
20187,0.000315,172.217.194.0-255,5738,37052,65,108437
20188,0.000317,172.31.40.0-255,66,37118,65,108437
20189,0.000373,172.217.194.0-255,2902,40020,65,108437
20190,0.000377,172.31.40.0-255,66,40086,65,108437
20191,0.000396,172.217.194.0-255,4273,44359,65,108437
20192,0.000399,172.31.40.0-255,66,44425,65,108437
20193,0.000497,172.217.194.0-255,1484,45909,65,108437
20194,0.000502,172.217.194.0-255,2902,48811,65,108437
20195,0.000504,172.217.194.0-255,1484,50295,65,108437
20196,0.000509,172.31.40.0-255,66,50361,65,108437
20197,0.000513,172.31.40.0-255,66,50427,65,108437
20198,0.000543,172.217.194.0-255,4320,54747,65,108437
20199,0.000546,172.31.40.0-255,66,54813,65,108437
20200,0.000552,172.217.194.0-255,4320,59133,65,108437
20201,0.000554,172.31.40.0-255,66,59199,65,108437
20202,0.000567,172.31.40.0-255,66,59265,65,108437
20203,0.000573,172.217.194.0-255,5738,65003,65,108437
20204,0.000576,172.31.40.0-255,66,65069,65,108437
20205,0.000598,172.217.194.0-255,2184,67253,65,108437
20206,0.000601,172.31.40.0-255,66,67319,65,108437
20207,0.000634,172.217.194.0-255,1484,68803,65,108437
20208,0.000638,172.217.194.0-255,1484,70287,65,108437
20209,0.00064,172.31.40.0-255,66,70353,65,108437
20210,0.000663,172.217.194.0-255,1484,71837,65,108437
20211,0.00067,172.217.194.0-255,5738,77575,65,108437
20212,0.000673,172.31.40.0-255,66,77641,65,108437
20213,0.000685,172.31.40.0-255,66,77707,65,108437
20214,0.000726,172.31.40.0-255,66,77773,65,108437
20215,0.000748,172.217.194.0-255,3602,81375,65,108437
20216,0.000751,172.31.40.0-255,66,81441,65,108437
20217,0.000764,172.31.40.0-255,66,81507,65,108437
20218,0.000811,172.31.40.0-255,66,81573,65,108437
20219,0.000889,172.31.40.0-255,66,81639,65,108437
20220,0.000893,172.217.194.0-255,2902,84541,65,108437
20221,0.000895,172.31.40.0-255,66,84607,65,108437
20222,0.00097,172.31.40.0-255,66,84673,65,108437
20223,0.000974,172.31.40.0-255,66,84739,65,108437
20224,0.000977,172.31.40.0-255,66,84805,65,108437
20225,0.000983,172.217.194.0-255,4320,89125,65,108437
20226,0.000986,172.31.40.0-255,66,89191,65,108437
20227,0.001021,172.217.194.0-255,4320,93511,65,108437
20228,0.001025,172.31.40.0-255,66,93577,65,108437
20229,0.001027,172.31.40.0-255,66,93643,65,108437
20230,0.001066,172.31.40.0-255,66,93709,65,108437
20231,0.001078,172.31.40.0-255,66,93775,65,108437
20232,0.001103,172.217.194.0-255,2902,96677,65,108437
20233,0.001105,172.31.40.0-255,66,96743,65,108437
20234,0.001152,172.31.40.0-255,66,96809,65,108437
20235,0.001181,172.217.194.0-255,4320,101129,65,108437
20236,0.001184,172.31.40.0-255,66,101195,65,108437
20237,0.001213,172.31.40.0-255,66,101261,65,108437
20238,0.00124,172.31.40.0-255,66,101327,65,108437
20239,0.001277,172.217.194.0-255,2902,104229,65,108437
20240,0.00128,172.31.40.0-255,66,104295,65,108437
20241,0.001323,172.31.40.0-255,66,104361,65,108437
20242,0.001339,172.217.194.0-255,3602,107963,65,108437
20243,0.001342,172.31.40.0-255,66,108029,65,108437
20244,0.001356,172.31.40.0-255,66,108095,65,108437
20245,0.001358,172.217.194.0-255,105,108200,65,108437
20246,0.003934,172.31.40.0-255,66,108266,65,108437
20247,0.003972,172.31.40.0-255,105,108371,65,108437
20248,0.006678,172.217.194.0-255,66,108437,65,108437
20249,0.0,74.125.130.0-255,143,143,65,332317
20250,1.7e-05,172.31.40.0-255,66,209,65,332317
20251,2.4e-05,74.125.130.0-255,1484,1693,65,332317
20252,2.9e-05,172.31.40.0-255,66,1759,65,332317
20253,3.5e-05,74.125.130.0-255,2902,4661,65,332317
20254,4.7e-05,172.31.40.0-255,66,4727,65,332317
20255,5e-05,74.125.130.0-255,1484,6211,65,332317
20256,5.3e-05,172.31.40.0-255,66,6277,65,332317
20257,8.5e-05,74.125.130.0-255,5738,12015,65,332317
20258,8.8e-05,172.31.40.0-255,66,12081,65,332317
20259,9.3e-05,74.125.130.0-255,2067,14148,65,332317
20260,9.5e-05,172.31.40.0-255,66,14214,65,332317
20261,0.00029,74.125.130.0-255,1484,15698,65,332317
20262,0.000295,172.31.40.0-255,66,15764,65,332317
20263,0.0003,74.125.130.0-255,2902,18666,65,332317
20264,0.000303,172.31.40.0-255,66,18732,65,332317
20265,0.00033,74.125.130.0-255,2902,21634,65,332317
20266,0.000333,172.31.40.0-255,66,21700,65,332317
20267,0.000338,74.125.130.0-255,4320,26020,65,332317
20268,0.000341,172.31.40.0-255,66,26086,65,332317
20269,0.000374,74.125.130.0-255,5379,31465,65,332317
20270,0.000377,172.31.40.0-255,66,31531,65,332317
20271,0.000693,74.125.130.0-255,1484,33015,65,332317
20272,0.000698,172.31.40.0-255,66,33081,65,332317
20273,0.000702,74.125.130.0-255,1484,34565,65,332317
20274,0.000704,172.31.40.0-255,66,34631,65,332317
20275,0.000729,74.125.130.0-255,1484,36115,65,332317
20276,0.000732,172.31.40.0-255,66,36181,65,332317
20277,0.000747,74.125.130.0-255,4320,40501,65,332317
20278,0.000749,172.31.40.0-255,66,40567,65,332317
20279,0.000755,74.125.130.0-255,5738,46305,65,332317
20280,0.000758,172.31.40.0-255,66,46371,65,332317
20281,0.000786,74.125.130.0-255,2543,48914,65,332317
20282,0.000789,172.31.40.0-255,66,48980,65,332317
20283,0.000794,74.125.130.0-255,2902,51882,65,332317
20284,0.000799,172.31.40.0-255,66,51948,65,332317
20285,0.000823,74.125.130.0-255,7156,59104,65,332317
20286,0.000826,172.31.40.0-255,66,59170,65,332317
20287,0.000831,74.125.130.0-255,4320,63490,65,332317
20288,0.000833,172.31.40.0-255,66,63556,65,332317
20289,0.000876,74.125.130.0-255,2543,66099,65,332317
20290,0.000879,172.31.40.0-255,66,66165,65,332317
20291,0.000913,74.125.130.0-255,338,66503,65,332317
20292,0.001571,74.125.130.0-255,1484,67987,65,332317
20293,0.001578,172.31.40.0-255,66,68053,65,332317
20294,0.001585,74.125.130.0-255,2902,70955,65,332317
20295,0.001587,172.31.40.0-255,66,71021,65,332317
20296,0.001593,74.125.130.0-255,4320,75341,65,332317
20297,0.001595,172.31.40.0-255,66,75407,65,332317
20298,0.00163,74.125.130.0-255,2902,78309,65,332317
20299,0.001633,172.31.40.0-255,66,78375,65,332317
20300,0.001665,74.125.130.0-255,6828,85203,65,332317
20301,0.001668,172.31.40.0-255,66,85269,65,332317
20302,0.00168,172.31.40.0-255,66,85335,65,332317
20303,0.00169,74.125.130.0-255,5379,90714,65,332317
20304,0.001693,172.31.40.0-255,66,90780,65,332317
20305,0.001869,74.125.130.0-255,1484,92264,65,332317
20306,0.001882,74.125.130.0-255,1484,93748,65,332317
20307,0.001885,172.31.40.0-255,66,93814,65,332317
20308,0.001904,74.125.130.0-255,2902,96716,65,332317
20309,0.001908,172.31.40.0-255,66,96782,65,332317
20310,0.001913,74.125.130.0-255,2902,99684,65,332317
20311,0.001914,172.31.40.0-255,66,99750,65,332317
20312,0.001938,74.125.130.0-255,2902,102652,65,332317
20313,0.001941,172.31.40.0-255,66,102718,65,332317
20314,0.001949,74.125.130.0-255,4320,107038,65,332317
20315,0.001951,172.31.40.0-255,66,107104,65,332317
20316,0.001958,74.125.130.0-255,5738,112842,65,332317
20317,0.00196,172.31.40.0-255,66,112908,65,332317
20318,0.001995,74.125.130.0-255,5738,118646,65,332317
20319,0.002003,172.31.40.0-255,66,118712,65,332317
20320,0.002029,74.125.130.0-255,4320,123032,65,332317
20321,0.002032,172.31.40.0-255,66,123098,65,332317
20322,0.002036,74.125.130.0-255,2184,125282,65,332317
20323,0.002038,172.31.40.0-255,66,125348,65,332317
20324,0.00246,74.125.130.0-255,1484,126832,65,332317
20325,0.002478,74.125.130.0-255,2902,129734,65,332317
20326,0.002481,172.31.40.0-255,66,129800,65,332317
20327,0.002488,74.125.130.0-255,4320,134120,65,332317
20328,0.00249,172.31.40.0-255,66,134186,65,332317
20329,0.002521,74.125.130.0-255,1484,135670,65,332317
20330,0.002529,74.125.130.0-255,7156,142826,65,332317
20331,0.002531,172.31.40.0-255,66,142892,65,332317
20332,0.002536,74.125.130.0-255,2902,145794,65,332317
20333,0.002538,172.31.40.0-255,66,145860,65,332317
20334,0.00257,74.125.130.0-255,1484,147344,65,332317
20335,0.002573,74.125.130.0-255,1484,148828,65,332317
20336,0.002575,172.31.40.0-255,66,148894,65,332317
20337,0.002581,74.125.130.0-255,4320,153214,65,332317
20338,0.002583,172.31.40.0-255,66,153280,65,332317
20339,0.002586,74.125.130.0-255,1484,154764,65,332317
20340,0.002614,74.125.130.0-255,1484,156248,65,332317
20341,0.002616,172.31.40.0-255,66,156314,65,332317
20342,0.002621,74.125.130.0-255,2902,159216,65,332317
20343,0.002623,172.31.40.0-255,66,159282,65,332317
20344,0.002655,74.125.130.0-255,766,160048,65,332317
20345,0.002936,74.125.130.0-255,1484,161532,65,332317
20346,0.002941,172.31.40.0-255,66,161598,65,332317
20347,0.002945,74.125.130.0-255,1484,163082,65,332317
20348,0.002968,74.125.130.0-255,2902,165984,65,332317
20349,0.00297,172.31.40.0-255,66,166050,65,332317
20350,0.002976,74.125.130.0-255,4320,170370,65,332317
20351,0.002977,172.31.40.0-255,66,170436,65,332317
20352,0.003001,74.125.130.0-255,1484,171920,65,332317
20353,0.003012,172.31.40.0-255,66,171986,65,332317
20354,0.003043,74.125.130.0-255,1484,173470,65,332317
20355,0.003056,172.31.40.0-255,66,173536,65,332317
20356,0.003059,74.125.130.0-255,766,174302,65,332317
20357,0.003079,74.125.130.0-255,1484,175786,65,332317
20358,0.003081,172.31.40.0-255,66,175852,65,332317
20359,0.003112,74.125.130.0-255,4320,180172,65,332317
20360,0.003115,172.31.40.0-255,66,180238,65,332317
20361,0.003119,74.125.130.0-255,2902,183140,65,332317
20362,0.003121,172.31.40.0-255,66,183206,65,332317
20363,0.003127,74.125.130.0-255,4320,187526,65,332317
20364,0.003129,172.31.40.0-255,66,187592,65,332317
20365,0.003175,172.31.40.0-255,66,187658,65,332317
20366,0.003181,74.125.130.0-255,5738,193396,65,332317
20367,0.003183,172.31.40.0-255,66,193462,65,332317
20368,0.00319,74.125.130.0-255,6438,199900,65,332317
20369,0.003192,172.31.40.0-255,66,199966,65,332317
20370,0.003424,74.125.130.0-255,1484,201450,65,332317
20371,0.003438,74.125.130.0-255,2902,204352,65,332317
20372,0.003447,172.31.40.0-255,66,204418,65,332317
20373,0.003451,74.125.130.0-255,1484,205902,65,332317
20374,0.003473,74.125.130.0-255,2902,208804,65,332317
20375,0.003475,172.31.40.0-255,66,208870,65,332317
20376,0.00348,74.125.130.0-255,2902,211772,65,332317
20377,0.003486,172.31.40.0-255,66,211838,65,332317
20378,0.003505,74.125.130.0-255,2902,214740,65,332317
20379,0.003506,172.31.40.0-255,66,214806,65,332317
20380,0.003513,74.125.130.0-255,7156,221962,65,332317
20381,0.003515,172.31.40.0-255,66,222028,65,332317
20382,0.003545,172.31.40.0-255,66,222094,65,332317
20383,0.003548,74.125.130.0-255,1484,223578,65,332317
20384,0.003572,74.125.130.0-255,2184,225762,65,332317
20385,0.003574,172.31.40.0-255,66,225828,65,332317
20386,0.003646,74.125.130.0-255,1484,227312,65,332317
20387,0.003662,74.125.130.0-255,2902,230214,65,332317
20388,0.003664,172.31.40.0-255,66,230280,65,332317
20389,0.003692,74.125.130.0-255,5738,236018,65,332317
20390,0.003694,172.31.40.0-255,66,236084,65,332317
20391,0.003719,172.31.40.0-255,66,236150,65,332317
20392,0.003777,172.31.40.0-255,66,236216,65,332317
20393,0.003781,74.125.130.0-255,2184,238400,65,332317
20394,0.003783,172.31.40.0-255,66,238466,65,332317
20395,0.003786,74.125.130.0-255,2902,241368,65,332317
20396,0.003788,172.31.40.0-255,66,241434,65,332317
20397,0.003812,74.125.130.0-255,4320,245754,65,332317
20398,0.003814,172.31.40.0-255,66,245820,65,332317
20399,0.003837,74.125.130.0-255,2902,248722,65,332317
20400,0.003839,172.31.40.0-255,66,248788,65,332317
20401,0.003844,74.125.130.0-255,4320,253108,65,332317
20402,0.003847,172.31.40.0-255,66,253174,65,332317
20403,0.003869,74.125.130.0-255,4320,257494,65,332317
20404,0.003872,172.31.40.0-255,66,257560,65,332317
20405,0.003878,74.125.130.0-255,7156,264716,65,332317
20406,0.00388,172.31.40.0-255,66,264782,65,332317
20407,0.00392,172.31.40.0-255,66,264848,65,332317
20408,0.003923,74.125.130.0-255,1484,266332,65,332317
20409,0.003947,74.125.130.0-255,2902,269234,65,332317
20410,0.00395,172.31.40.0-255,66,269300,65,332317
20411,0.003953,74.125.130.0-255,1484,270784,65,332317
20412,0.003981,74.125.130.0-255,4320,275104,65,332317
20413,0.003987,74.125.130.0-255,7156,282260,65,332317
20414,0.004015,74.125.130.0-255,7156,289416,65,332317
20415,0.004029,74.125.130.0-255,4320,293736,65,332317
20416,0.004065,74.125.130.0-255,4320,298056,65,332317
20417,0.004081,74.125.130.0-255,6438,304494,65,332317
20418,0.004084,74.125.130.0-255,1484,305978,65,332317
20419,0.004122,74.125.130.0-255,5738,311716,65,332317
20420,0.004138,74.125.130.0-255,1484,313200,65,332317
20421,0.00414,74.125.130.0-255,1484,314684,65,332317
20422,0.004152,74.125.130.0-255,4320,319004,65,332317
20423,0.004167,74.125.130.0-255,1484,320488,65,332317
20424,0.004171,74.125.130.0-255,1484,321972,65,332317
20425,0.004175,74.125.130.0-255,2902,324874,65,332317
20426,0.004225,74.125.130.0-255,6680,331554,65,332317
20427,0.004229,74.125.130.0-255,97,331651,65,332317
20428,0.004258,74.125.130.0-255,105,331756,65,332317
20429,0.004354,74.125.130.0-255,129,331885,65,332317
20430,0.010676,172.31.40.0-255,66,331951,65,332317
20431,0.017706,172.31.40.0-255,105,332056,65,332317
20432,0.018288,172.31.40.0-255,105,332161,65,332317
20433,0.018539,172.31.40.0-255,90,332251,65,332317
20434,0.01855,172.31.40.0-255,66,332317,65,332317
20435,0.0,74.125.24.0-255,153,153,65,168816
20436,2.2e-05,172.31.40.0-255,66,219,65,168816
20437,2.9e-05,74.125.24.0-255,1484,1703,65,168816
20438,3.3e-05,172.31.40.0-255,66,1769,65,168816
20439,3.8e-05,74.125.24.0-255,2902,4671,65,168816
20440,4e-05,172.31.40.0-255,66,4737,65,168816
20441,5.3e-05,74.125.24.0-255,5738,10475,65,168816
20442,5.6e-05,172.31.40.0-255,66,10541,65,168816
20443,7.6e-05,74.125.24.0-255,1484,12025,65,168816
20444,7.8e-05,172.31.40.0-255,66,12091,65,168816
20445,8.8e-05,74.125.24.0-255,4872,16963,65,168816
20446,9e-05,172.31.40.0-255,66,17029,65,168816
20447,9.3e-05,74.125.24.0-255,1484,18513,65,168816
20448,9.4e-05,172.31.40.0-255,66,18579,65,168816
20449,0.000125,74.125.24.0-255,4320,22899,65,168816
20450,0.000127,172.31.40.0-255,66,22965,65,168816
20451,0.00014,172.31.40.0-255,66,23031,65,168816
20452,0.00028,74.125.24.0-255,1484,24515,65,168816
20453,0.000284,172.31.40.0-255,66,24581,65,168816
20454,0.000291,74.125.24.0-255,2902,27483,65,168816
20455,0.000293,172.31.40.0-255,66,27549,65,168816
20456,0.000295,74.125.24.0-255,1484,29033,65,168816
20457,0.000297,172.31.40.0-255,66,29099,65,168816
20458,0.000311,74.125.24.0-255,4320,33419,65,168816
20459,0.000314,172.31.40.0-255,66,33485,65,168816
20460,0.000343,74.125.24.0-255,7156,40641,65,168816
20461,0.000345,172.31.40.0-255,66,40707,65,168816
20462,0.000365,74.125.24.0-255,7156,47863,65,168816
20463,0.000367,172.31.40.0-255,66,47929,65,168816
20464,0.000391,74.125.24.0-255,7156,55085,65,168816
20465,0.000394,172.31.40.0-255,66,55151,65,168816
20466,0.000397,74.125.24.0-255,2480,57631,65,168816
20467,0.000399,172.31.40.0-255,66,57697,65,168816
20468,0.000641,74.125.24.0-255,1484,59181,65,168816
20469,0.000658,74.125.24.0-255,2902,62083,65,168816
20470,0.000661,172.31.40.0-255,66,62149,65,168816
20471,0.000666,74.125.24.0-255,2902,65051,65,168816
20472,0.000668,172.31.40.0-255,66,65117,65,168816
20473,0.000694,74.125.24.0-255,2902,68019,65,168816
20474,0.000696,172.31.40.0-255,66,68085,65,168816
20475,0.000707,172.31.40.0-255,66,68151,65,168816
20476,0.000732,74.125.24.0-255,4320,72471,65,168816
20477,0.000734,172.31.40.0-255,66,72537,65,168816
20478,0.00078,172.31.40.0-255,66,72603,65,168816
20479,0.000792,172.31.40.0-255,66,72669,65,168816
20480,0.000797,74.125.24.0-255,4320,76989,65,168816
20481,0.000799,172.31.40.0-255,66,77055,65,168816
20482,0.000839,172.31.40.0-255,66,77121,65,168816
20483,0.001068,74.125.24.0-255,1484,78605,65,168816
20484,0.001087,74.125.24.0-255,2902,81507,65,168816
20485,0.001091,172.31.40.0-255,66,81573,65,168816
20486,0.001094,74.125.24.0-255,1484,83057,65,168816
20487,0.001123,74.125.24.0-255,4320,87377,65,168816
20488,0.001125,172.31.40.0-255,66,87443,65,168816
20489,0.001128,74.125.24.0-255,1484,88927,65,168816
20490,0.001157,172.31.40.0-255,66,88993,65,168816
20491,0.001185,74.125.24.0-255,2902,91895,65,168816
20492,0.001187,172.31.40.0-255,66,91961,65,168816
20493,0.001216,172.31.40.0-255,66,92027,65,168816
20494,0.001333,74.125.24.0-255,1484,93511,65,168816
20495,0.001345,74.125.24.0-255,2902,96413,65,168816
20496,0.001348,172.31.40.0-255,66,96479,65,168816
20497,0.001353,74.125.24.0-255,4320,100799,65,168816
20498,0.001355,172.31.40.0-255,66,100865,65,168816
20499,0.001373,74.125.24.0-255,1484,102349,65,168816
20500,0.001411,172.31.40.0-255,66,102415,65,168816
20501,0.001422,172.31.40.0-255,66,102481,65,168816
20502,0.001467,74.125.24.0-255,4320,106801,65,168816
20503,0.001469,172.31.40.0-255,66,106867,65,168816
20504,0.001502,172.31.40.0-255,66,106933,65,168816
20505,0.001505,74.125.24.0-255,1484,108417,65,168816
20506,0.001535,74.125.24.0-255,7156,115573,65,168816
20507,0.001538,172.31.40.0-255,66,115639,65,168816
20508,0.001552,172.31.40.0-255,66,115705,65,168816
20509,0.001593,172.31.40.0-255,66,115771,65,168816
20510,0.001597,74.125.24.0-255,2902,118673,65,168816
20511,0.0016,172.31.40.0-255,66,118739,65,168816
20512,0.001605,74.125.24.0-255,4320,123059,65,168816
20513,0.001607,172.31.40.0-255,66,123125,65,168816
20514,0.001642,74.125.24.0-255,3602,126727,65,168816
20515,0.00167,74.125.24.0-255,5738,132465,65,168816
20516,0.001679,172.31.40.0-255,66,132531,65,168816
20517,0.001683,172.31.40.0-255,66,132597,65,168816
20518,0.001685,172.31.40.0-255,66,132663,65,168816
20519,0.001688,172.31.40.0-255,66,132729,65,168816
20520,0.001739,172.31.40.0-255,66,132795,65,168816
20521,0.00174,172.31.40.0-255,66,132861,65,168816
20522,0.001762,172.31.40.0-255,66,132927,65,168816
20523,0.001768,74.125.24.0-255,5020,137947,65,168816
20524,0.00177,172.31.40.0-255,66,138013,65,168816
20525,0.001805,74.125.24.0-255,1484,139497,65,168816
20526,0.001838,172.31.40.0-255,66,139563,65,168816
20527,0.00184,74.125.24.0-255,1484,141047,65,168816
20528,0.001865,74.125.24.0-255,2902,143949,65,168816
20529,0.001867,172.31.40.0-255,66,144015,65,168816
20530,0.001873,74.125.24.0-255,5738,149753,65,168816
20531,0.001875,172.31.40.0-255,66,149819,65,168816
20532,0.001882,74.125.24.0-255,5738,155557,65,168816
20533,0.001884,172.31.40.0-255,66,155623,65,168816
20534,0.001918,74.125.24.0-255,4320,159943,65,168816
20535,0.001921,172.31.40.0-255,66,160009,65,168816
20536,0.001959,172.31.40.0-255,66,160075,65,168816
20537,0.001976,74.125.24.0-255,3602,163677,65,168816
20538,0.001981,74.125.24.0-255,2902,166579,65,168816
20539,0.002013,74.125.24.0-255,1895,168474,65,168816
20540,0.002015,74.125.24.0-255,105,168579,65,168816
20541,0.00202,172.31.40.0-255,66,168645,65,168816
20542,0.004247,172.31.40.0-255,105,168750,65,168816
20543,0.006594,74.125.24.0-255,66,168816,65,168816
20544,0.0,172.217.194.0-255,155,155,65,183109
20545,2.2e-05,172.31.40.0-255,66,221,65,183109
20546,2.9e-05,172.217.194.0-255,1484,1705,65,183109
20547,3.4e-05,172.31.40.0-255,66,1771,65,183109
20548,4.8e-05,172.217.194.0-255,2902,4673,65,183109
20549,5.3e-05,172.31.40.0-255,66,4739,65,183109
20550,5.8e-05,172.217.194.0-255,2902,7641,65,183109
20551,6e-05,172.31.40.0-255,66,7707,65,183109
20552,6.5e-05,172.217.194.0-255,2902,10609,65,183109
20553,6.8e-05,172.31.40.0-255,66,10675,65,183109
20554,0.000112,172.217.194.0-255,4937,15612,65,183109
20555,0.000115,172.31.40.0-255,66,15678,65,183109
20556,0.000126,172.31.40.0-255,66,15744,65,183109
20557,0.000131,172.217.194.0-255,2902,18646,65,183109
20558,0.000133,172.31.40.0-255,66,18712,65,183109
20559,0.000162,172.217.194.0-255,3961,22673,65,183109
20560,0.000165,172.31.40.0-255,66,22739,65,183109
20561,0.000206,172.217.194.0-255,1484,24223,65,183109
20562,0.000208,172.31.40.0-255,66,24289,65,183109
20563,0.000236,172.217.194.0-255,2902,27191,65,183109
20564,0.000239,172.31.40.0-255,66,27257,65,183109
20565,0.000246,172.217.194.0-255,5738,32995,65,183109
20566,0.000249,172.31.40.0-255,66,33061,65,183109
20567,0.000275,172.217.194.0-255,6797,39858,65,183109
20568,0.000278,172.31.40.0-255,66,39924,65,183109
20569,0.000292,172.217.194.0-255,4320,44244,65,183109
20570,0.000294,172.31.40.0-255,66,44310,65,183109
20571,0.000323,172.217.194.0-255,5738,50048,65,183109
20572,0.000325,172.31.40.0-255,66,50114,65,183109
20573,0.000343,172.217.194.0-255,7119,57233,65,183109
20574,0.000346,172.31.40.0-255,66,57299,65,183109
20575,0.000374,172.217.194.0-255,366,57665,65,183109
20576,0.000523,172.217.194.0-255,1484,59149,65,183109
20577,0.000527,172.31.40.0-255,66,59215,65,183109
20578,0.000533,172.217.194.0-255,2902,62117,65,183109
20579,0.000537,172.31.40.0-255,66,62183,65,183109
20580,0.000542,172.217.194.0-255,4320,66503,65,183109
20581,0.000549,172.31.40.0-255,66,66569,65,183109
20582,0.000578,172.217.194.0-255,1484,68053,65,183109
20583,0.000593,172.31.40.0-255,66,68119,65,183109
20584,0.0006,172.217.194.0-255,5738,73857,65,183109
20585,0.000602,172.31.40.0-255,66,73923,65,183109
20586,0.000634,172.217.194.0-255,5020,78943,65,183109
20587,0.000637,172.31.40.0-255,66,79009,65,183109
20588,0.00165,172.217.194.0-255,1484,80493,65,183109
20589,0.00166,172.217.194.0-255,2902,83395,65,183109
20590,0.001664,172.31.40.0-255,66,83461,65,183109
20591,0.001672,172.217.194.0-255,5738,89199,65,183109
20592,0.001675,172.31.40.0-255,66,89265,65,183109
20593,0.001721,172.31.40.0-255,66,89331,65,183109
20594,0.001734,172.31.40.0-255,66,89397,65,183109
20595,0.001756,172.217.194.0-255,1484,90881,65,183109
20596,0.001762,172.217.194.0-255,2902,93783,65,183109
20597,0.001764,172.31.40.0-255,66,93849,65,183109
20598,0.001769,172.217.194.0-255,2902,96751,65,183109
20599,0.001771,172.31.40.0-255,66,96817,65,183109
20600,0.001807,172.217.194.0-255,2902,99719,65,183109
20601,0.00181,172.31.40.0-255,66,99785,65,183109
20602,0.001824,172.31.40.0-255,66,99851,65,183109
20603,0.001836,172.31.40.0-255,66,99917,65,183109
20604,0.001888,172.217.194.0-255,1484,101401,65,183109
20605,0.001892,172.217.194.0-255,1484,102885,65,183109
20606,0.001894,172.31.40.0-255,66,102951,65,183109
20607,0.001924,172.217.194.0-255,1484,104435,65,183109
20608,0.001931,172.217.194.0-255,5738,110173,65,183109
20609,0.001933,172.31.40.0-255,66,110239,65,183109
20610,0.001952,172.31.40.0-255,66,110305,65,183109
20611,0.001997,172.31.40.0-255,66,110371,65,183109
20612,0.002218,172.217.194.0-255,1484,111855,65,183109
20613,0.002226,172.217.194.0-255,2902,114757,65,183109
20614,0.00223,172.31.40.0-255,66,114823,65,183109
20615,0.002236,172.217.194.0-255,2902,117725,65,183109
20616,0.002239,172.31.40.0-255,66,117791,65,183109
20617,0.002268,172.217.194.0-255,2902,120693,65,183109
20618,0.002271,172.31.40.0-255,66,120759,65,183109
20619,0.002289,172.31.40.0-255,66,120825,65,183109
20620,0.0023,172.31.40.0-255,66,120891,65,183109
20621,0.002302,172.217.194.0-255,766,121657,65,183109
20622,0.002443,172.217.194.0-255,1484,123141,65,183109
20623,0.002448,172.31.40.0-255,66,123207,65,183109
20624,0.002454,172.217.194.0-255,2902,126109,65,183109
20625,0.002456,172.31.40.0-255,66,126175,65,183109
20626,0.002466,172.217.194.0-255,5738,131913,65,183109
20627,0.002469,172.31.40.0-255,66,131979,65,183109
20628,0.0025,172.217.194.0-255,7156,139135,65,183109
20629,0.002503,172.31.40.0-255,66,139201,65,183109
20630,0.002526,172.217.194.0-255,2902,142103,65,183109
20631,0.00254,172.31.40.0-255,66,142169,65,183109
20632,0.002557,172.31.40.0-255,66,142235,65,183109
20633,0.002604,172.217.194.0-255,5020,147255,65,183109
20634,0.002606,172.31.40.0-255,66,147321,65,183109
20635,0.002627,172.31.40.0-255,66,147387,65,183109
20636,0.002631,172.217.194.0-255,2184,149571,65,183109
20637,0.002633,172.31.40.0-255,66,149637,65,183109
20638,0.005151,172.217.194.0-255,4320,153957,65,183109
20639,0.005156,172.31.40.0-255,66,154023,65,183109
20640,0.005173,172.217.194.0-255,1484,155507,65,183109
20641,0.007675,172.217.194.0-255,4320,159827,65,183109
20642,0.007689,172.31.40.0-255,66,159893,65,183109
20643,0.010234,172.217.194.0-255,5738,165631,65,183109
20644,0.010252,172.31.40.0-255,66,165697,65,183109
20645,0.01279,172.217.194.0-255,5738,171435,65,183109
20646,0.012798,172.31.40.0-255,66,171501,65,183109
20647,0.015327,172.217.194.0-255,5738,177239,65,183109
20648,0.015343,172.31.40.0-255,66,177305,65,183109
20649,0.017901,172.217.194.0-255,5738,183043,65,183109
20650,0.017916,172.31.40.0-255,66,183109,65,183109
20651,0.0,74.125.24.0-255,153,153,65,139337
20652,2.4e-05,172.31.40.0-255,66,219,65,139337
20653,3.1e-05,74.125.24.0-255,1484,1703,65,139337
20654,3.5e-05,172.31.40.0-255,66,1769,65,139337
20655,4e-05,74.125.24.0-255,2902,4671,65,139337
20656,4.3e-05,172.31.40.0-255,66,4737,65,139337
20657,4.7e-05,74.125.24.0-255,2902,7639,65,139337
20658,5e-05,172.31.40.0-255,66,7705,65,139337
20659,9.8e-05,74.125.24.0-255,6255,13960,65,139337
20660,0.000102,172.31.40.0-255,66,14026,65,139337
20661,0.000258,74.125.24.0-255,1484,15510,65,139337
20662,0.000264,172.31.40.0-255,66,15576,65,139337
20663,0.000271,74.125.24.0-255,2902,18478,65,139337
20664,0.000274,172.31.40.0-255,66,18544,65,139337
20665,0.000281,74.125.24.0-255,5738,24282,65,139337
20666,0.000283,172.31.40.0-255,66,24348,65,139337
20667,0.000318,172.31.40.0-255,66,24414,65,139337
20668,0.00034,74.125.24.0-255,5738,30152,65,139337
20669,0.000343,172.31.40.0-255,66,30218,65,139337
20670,0.000373,172.31.40.0-255,66,30284,65,139337
20671,0.000379,74.125.24.0-255,4320,34604,65,139337
20672,0.000381,172.31.40.0-255,66,34670,65,139337
20673,0.000416,172.31.40.0-255,66,34736,65,139337
20674,0.000454,74.125.24.0-255,398,35134,65,139337
20675,0.000458,172.31.40.0-255,66,35200,65,139337
20676,0.000486,74.125.24.0-255,108,35308,65,139337
20677,0.000489,172.31.40.0-255,66,35374,65,139337
20678,0.000567,74.125.24.0-255,333,35707,65,139337
20679,0.000571,172.31.40.0-255,66,35773,65,139337
20680,0.001177,74.125.24.0-255,1484,37257,65,139337
20681,0.001187,74.125.24.0-255,2902,40159,65,139337
20682,0.001191,172.31.40.0-255,66,40225,65,139337
20683,0.001199,74.125.24.0-255,5738,45963,65,139337
20684,0.001202,172.31.40.0-255,66,46029,65,139337
20685,0.00123,74.125.24.0-255,4320,50349,65,139337
20686,0.001233,172.31.40.0-255,66,50415,65,139337
20687,0.00124,74.125.24.0-255,7156,57571,65,139337
20688,0.001243,172.31.40.0-255,66,57637,65,139337
20689,0.001269,74.125.24.0-255,4320,61957,65,139337
20690,0.001272,172.31.40.0-255,66,62023,65,139337
20691,0.001313,74.125.24.0-255,4320,66343,65,139337
20692,0.001317,172.31.40.0-255,66,66409,65,139337
20693,0.001336,74.125.24.0-255,3602,70011,65,139337
20694,0.001338,172.31.40.0-255,66,70077,65,139337
20695,0.002032,74.125.24.0-255,1484,71561,65,139337
20696,0.002054,74.125.24.0-255,2902,74463,65,139337
20697,0.002059,172.31.40.0-255,66,74529,65,139337
20698,0.002067,74.125.24.0-255,5738,80267,65,139337
20699,0.002086,172.31.40.0-255,66,80333,65,139337
20700,0.002124,74.125.24.0-255,5738,86071,65,139337
20701,0.002127,172.31.40.0-255,66,86137,65,139337
20702,0.002152,74.125.24.0-255,7156,93293,65,139337
20703,0.002155,172.31.40.0-255,66,93359,65,139337
20704,0.002166,172.31.40.0-255,66,93425,65,139337
20705,0.002168,74.125.24.0-255,766,94191,65,139337
20706,0.003432,172.31.40.0-255,66,94257,65,139337
20707,0.004319,74.125.24.0-255,4320,98577,65,139337
20708,0.004326,172.31.40.0-255,66,98643,65,139337
20709,0.005542,74.125.24.0-255,1484,100127,65,139337
20710,0.006397,74.125.24.0-255,4320,104447,65,139337
20711,0.0064,172.31.40.0-255,66,104513,65,139337
20712,0.008502,74.125.24.0-255,5738,110251,65,139337
20713,0.008505,172.31.40.0-255,66,110317,65,139337
20714,0.010586,74.125.24.0-255,5738,116055,65,139337
20715,0.010594,172.31.40.0-255,66,116121,65,139337
20716,0.012721,74.125.24.0-255,5738,121859,65,139337
20717,0.012729,172.31.40.0-255,66,121925,65,139337
20718,0.01486,74.125.24.0-255,5738,127663,65,139337
20719,0.014868,172.31.40.0-255,66,127729,65,139337
20720,0.016988,74.125.24.0-255,5738,133467,65,139337
20721,0.016995,172.31.40.0-255,66,133533,65,139337
20722,0.019111,74.125.24.0-255,5738,139271,65,139337
20723,0.019119,172.31.40.0-255,66,139337,65,139337
20724,0.0,74.125.68.0-255,146,146,65,229559
20725,2.3e-05,172.31.40.0-255,66,212,65,229559
20726,3.1e-05,74.125.68.0-255,1484,1696,65,229559
20727,3.6e-05,172.31.40.0-255,66,1762,65,229559
20728,4e-05,74.125.68.0-255,1484,3246,65,229559
20729,4.2e-05,172.31.40.0-255,66,3312,65,229559
20730,4.8e-05,74.125.68.0-255,2902,6214,65,229559
20731,5.1e-05,172.31.40.0-255,66,6280,65,229559
20732,5.8e-05,74.125.68.0-255,5738,12018,65,229559
20733,6.2e-05,172.31.40.0-255,66,12084,65,229559
20734,8.4e-05,74.125.68.0-255,2126,14210,65,229559
20735,8.7e-05,172.31.40.0-255,66,14276,65,229559
20736,0.000243,74.125.68.0-255,1484,15760,65,229559
20737,0.000249,172.31.40.0-255,66,15826,65,229559
20738,0.000254,74.125.68.0-255,2902,18728,65,229559
20739,0.000257,172.31.40.0-255,66,18794,65,229559
20740,0.00029,74.125.68.0-255,5738,24532,65,229559
20741,0.000293,172.31.40.0-255,66,24598,65,229559
20742,0.000298,74.125.68.0-255,2902,27500,65,229559
20743,0.0003,172.31.40.0-255,66,27566,65,229559
20744,0.000305,74.125.68.0-255,3961,31527,65,229559
20745,0.000308,172.31.40.0-255,66,31593,65,229559
20746,0.000349,74.125.68.0-255,5738,37331,65,229559
20747,0.000353,172.31.40.0-255,66,37397,65,229559
20748,0.00038,74.125.68.0-255,2902,40299,65,229559
20749,0.000382,172.31.40.0-255,66,40365,65,229559
20750,0.000394,172.31.40.0-255,66,40431,65,229559
20751,0.000401,74.125.68.0-255,7156,47587,65,229559
20752,0.000404,172.31.40.0-255,66,47653,65,229559
20753,0.000412,74.125.68.0-255,7156,54809,65,229559
20754,0.000414,172.31.40.0-255,66,54875,65,229559
20755,0.000439,74.125.68.0-255,766,55641,65,229559
20756,0.000442,74.125.68.0-255,395,56036,65,229559
20757,0.000756,74.125.68.0-255,115,56151,65,229559
20758,0.000897,74.125.68.0-255,1484,57635,65,229559
20759,0.000901,172.31.40.0-255,66,57701,65,229559
20760,0.000907,74.125.68.0-255,2902,60603,65,229559
20761,0.000909,172.31.40.0-255,66,60669,65,229559
20762,0.000936,74.125.68.0-255,5738,66407,65,229559
20763,0.000939,172.31.40.0-255,66,66473,65,229559
20764,0.000944,74.125.68.0-255,2902,69375,65,229559
20765,0.000946,172.31.40.0-255,66,69441,65,229559
20766,0.000981,172.31.40.0-255,66,69507,65,229559
20767,0.001012,172.31.40.0-255,66,69573,65,229559
20768,0.001048,74.125.68.0-255,2184,71757,65,229559
20769,0.001051,172.31.40.0-255,66,71823,65,229559
20770,0.001481,74.125.68.0-255,1484,73307,65,229559
20771,0.001491,74.125.68.0-255,2902,76209,65,229559
20772,0.001495,172.31.40.0-255,66,76275,65,229559
20773,0.001501,74.125.68.0-255,2902,79177,65,229559
20774,0.001503,172.31.40.0-255,66,79243,65,229559
20775,0.001515,74.125.68.0-255,1484,80727,65,229559
20776,0.001521,74.125.68.0-255,4320,85047,65,229559
20777,0.001524,172.31.40.0-255,66,85113,65,229559
20778,0.001542,74.125.68.0-255,1484,86597,65,229559
20779,0.001569,172.31.40.0-255,66,86663,65,229559
20780,0.001587,74.125.68.0-255,1484,88147,65,229559
20781,0.001593,74.125.68.0-255,4320,92467,65,229559
20782,0.001595,172.31.40.0-255,66,92533,65,229559
20783,0.001614,74.125.68.0-255,3602,96135,65,229559
20784,0.001617,172.31.40.0-255,66,96201,65,229559
20785,0.001872,74.125.68.0-255,1484,97685,65,229559
20786,0.001889,74.125.68.0-255,2902,100587,65,229559
20787,0.001893,172.31.40.0-255,66,100653,65,229559
20788,0.001898,74.125.68.0-255,2902,103555,65,229559
20789,0.0019,172.31.40.0-255,66,103621,65,229559
20790,0.001916,74.125.68.0-255,2902,106523,65,229559
20791,0.001918,172.31.40.0-255,66,106589,65,229559
20792,0.001924,74.125.68.0-255,4320,110909,65,229559
20793,0.001926,172.31.40.0-255,66,110975,65,229559
20794,0.001932,74.125.68.0-255,5738,116713,65,229559
20795,0.001934,172.31.40.0-255,66,116779,65,229559
20796,0.00198,74.125.68.0-255,5738,122517,65,229559
20797,0.001983,172.31.40.0-255,66,122583,65,229559
20798,0.001999,74.125.68.0-255,1484,124067,65,229559
20799,0.002005,74.125.68.0-255,4320,128387,65,229559
20800,0.002007,172.31.40.0-255,66,128453,65,229559
20801,0.002031,74.125.68.0-255,3602,132055,65,229559
20802,0.002033,172.31.40.0-255,66,132121,65,229559
20803,0.002038,74.125.68.0-255,4320,136441,65,229559
20804,0.00204,172.31.40.0-255,66,136507,65,229559
20805,0.002063,74.125.68.0-255,1484,137991,65,229559
20806,0.002084,74.125.68.0-255,2902,140893,65,229559
20807,0.002087,172.31.40.0-255,66,140959,65,229559
20808,0.002105,74.125.68.0-255,5738,146697,65,229559
20809,0.002108,172.31.40.0-255,66,146763,65,229559
20810,0.002125,74.125.68.0-255,1484,148247,65,229559
20811,0.002128,74.125.68.0-255,1484,149731,65,229559
20812,0.002129,172.31.40.0-255,66,149797,65,229559
20813,0.002146,74.125.68.0-255,1484,151281,65,229559
20814,0.002152,74.125.68.0-255,5738,157019,65,229559
20815,0.002155,172.31.40.0-255,66,157085,65,229559
20816,0.002172,74.125.68.0-255,4320,161405,65,229559
20817,0.002175,172.31.40.0-255,66,161471,65,229559
20818,0.002187,74.125.68.0-255,3602,165073,65,229559
20819,0.00219,172.31.40.0-255,66,165139,65,229559
20820,0.002209,74.125.68.0-255,2902,168041,65,229559
20821,0.002211,172.31.40.0-255,66,168107,65,229559
20822,0.002228,74.125.68.0-255,5738,173845,65,229559
20823,0.00223,172.31.40.0-255,66,173911,65,229559
20824,0.002234,74.125.68.0-255,2902,176813,65,229559
20825,0.002235,172.31.40.0-255,66,176879,65,229559
20826,0.002282,172.31.40.0-255,66,176945,65,229559
20827,0.002293,74.125.68.0-255,1484,178429,65,229559
20828,0.002298,74.125.68.0-255,4320,182749,65,229559
20829,0.0023,172.31.40.0-255,66,182815,65,229559
20830,0.002337,74.125.68.0-255,2902,185717,65,229559
20831,0.002339,172.31.40.0-255,66,185783,65,229559
20832,0.002357,74.125.68.0-255,2184,187967,65,229559
20833,0.002359,172.31.40.0-255,66,188033,65,229559
20834,0.002415,74.125.68.0-255,1484,189517,65,229559
20835,0.002428,74.125.68.0-255,2902,192419,65,229559
20836,0.002431,172.31.40.0-255,66,192485,65,229559
20837,0.002453,74.125.68.0-255,4320,196805,65,229559
20838,0.002456,172.31.40.0-255,66,196871,65,229559
20839,0.002495,74.125.68.0-255,5738,202609,65,229559
20840,0.00252,74.125.68.0-255,2902,205511,65,229559
20841,0.002532,74.125.68.0-255,2902,208413,65,229559
20842,0.002543,74.125.68.0-255,2902,211315,65,229559
20843,0.002546,74.125.68.0-255,766,212081,65,229559
20844,0.010149,172.31.40.0-255,66,212147,65,229559
20845,0.012706,74.125.68.0-255,5738,217885,65,229559
20846,0.012723,172.31.40.0-255,66,217951,65,229559
20847,0.015266,74.125.68.0-255,5738,223689,65,229559
20848,0.015276,172.31.40.0-255,66,223755,65,229559
20849,0.017835,74.125.68.0-255,5738,229493,65,229559
20850,0.017844,172.31.40.0-255,66,229559,65,229559
20851,0.0,172.217.194.0-255,150,150,65,173423
20852,2.1e-05,172.31.40.0-255,66,216,65,173423
20853,2.8e-05,172.217.194.0-255,1484,1700,65,173423
20854,3.2e-05,172.31.40.0-255,66,1766,65,173423
20855,3.7e-05,172.217.194.0-255,2902,4668,65,173423
20856,4.7e-05,172.31.40.0-255,66,4734,65,173423
20857,5.5e-05,172.217.194.0-255,7156,11890,65,173423
20858,5.7e-05,172.31.40.0-255,66,11956,65,173423
20859,9.4e-05,172.31.40.0-255,66,12022,65,173423
20860,0.000122,172.217.194.0-255,4873,16895,65,173423
20861,0.000125,172.31.40.0-255,66,16961,65,173423
20862,0.000129,172.217.194.0-255,2543,19504,65,173423
20863,0.000131,172.31.40.0-255,66,19570,65,173423
20864,0.000219,172.217.194.0-255,1484,21054,65,173423
20865,0.000223,172.31.40.0-255,66,21120,65,173423
20866,0.000246,172.217.194.0-255,2902,24022,65,173423
20867,0.000249,172.31.40.0-255,66,24088,65,173423
20868,0.000255,172.217.194.0-255,5738,29826,65,173423
20869,0.000257,172.31.40.0-255,66,29892,65,173423
20870,0.000301,172.31.40.0-255,66,29958,65,173423
20871,0.000306,172.217.194.0-255,4320,34278,65,173423
20872,0.000308,172.31.40.0-255,66,34344,65,173423
20873,0.000335,172.217.194.0-255,5738,40082,65,173423
20874,0.000342,172.31.40.0-255,66,40148,65,173423
20875,0.000347,172.217.194.0-255,4249,44397,65,173423
20876,0.000349,172.31.40.0-255,66,44463,65,173423
20877,0.00045,172.217.194.0-255,366,44829,65,173423
20878,0.000454,172.31.40.0-255,66,44895,65,173423
20879,0.000482,172.217.194.0-255,1484,46379,65,173423
20880,0.000486,172.31.40.0-255,66,46445,65,173423
20881,0.000516,172.217.194.0-255,1484,47929,65,173423
20882,0.000537,172.217.194.0-255,2902,50831,65,173423
20883,0.000565,172.217.194.0-255,5738,56569,65,173423
20884,0.000607,172.217.194.0-255,1484,58053,65,173423
20885,0.00061,172.31.40.0-255,66,58119,65,173423
20886,0.000639,172.217.194.0-255,3961,62080,65,173423
20887,0.000646,172.217.194.0-255,5738,67818,65,173423
20888,0.00065,172.217.194.0-255,2902,70720,65,173423
20889,0.000674,172.31.40.0-255,66,70786,65,173423
20890,0.000702,172.217.194.0-255,1484,72270,65,173423
20891,0.000729,172.217.194.0-255,6797,79067,65,173423
20892,0.000735,172.31.40.0-255,66,79133,65,173423
20893,0.000784,172.217.194.0-255,1484,80617,65,173423
20894,0.00079,172.217.194.0-255,2902,83519,65,173423
20895,0.000793,172.217.194.0-255,1484,85003,65,173423
20896,0.0008,172.31.40.0-255,66,85069,65,173423
20897,0.00082,172.217.194.0-255,4320,89389,65,173423
20898,0.000823,172.217.194.0-255,1484,90873,65,173423
20899,0.000836,172.31.40.0-255,66,90939,65,173423
20900,0.000869,172.217.194.0-255,2902,93841,65,173423
20901,0.00088,172.31.40.0-255,66,93907,65,173423
20902,0.000903,172.31.40.0-255,66,93973,65,173423
20903,0.000989,172.217.194.0-255,1484,95457,65,173423
20904,0.001007,172.217.194.0-255,2902,98359,65,173423
20905,0.001023,172.217.194.0-255,1484,99843,65,173423
20906,0.001029,172.31.40.0-255,66,99909,65,173423
20907,0.001061,172.217.194.0-255,4320,104229,65,173423
20908,0.001137,172.31.40.0-255,66,104295,65,173423
20909,0.001578,172.217.194.0-255,1484,105779,65,173423
20910,0.001585,172.217.194.0-255,2902,108681,65,173423
20911,0.001589,172.31.40.0-255,66,108747,65,173423
20912,0.001618,172.217.194.0-255,1484,110231,65,173423
20913,0.001641,172.217.194.0-255,4320,114551,65,173423
20914,0.001648,172.217.194.0-255,7156,121707,65,173423
20915,0.001671,172.217.194.0-255,4320,126027,65,173423
20916,0.001679,172.31.40.0-255,66,126093,65,173423
20917,0.001715,172.217.194.0-255,2184,128277,65,173423
20918,0.001734,172.31.40.0-255,66,128343,65,173423
20919,0.003805,172.217.194.0-255,5738,134081,65,173423
20920,0.003812,172.31.40.0-255,66,134147,65,173423
20921,0.005895,172.217.194.0-255,4320,138467,65,173423
20922,0.005901,172.31.40.0-255,66,138533,65,173423
20923,0.005927,172.217.194.0-255,1484,140017,65,173423
20924,0.00797,172.217.194.0-255,4320,144337,65,173423
20925,0.007975,172.31.40.0-255,66,144403,65,173423
20926,0.010046,172.217.194.0-255,5738,150141,65,173423
20927,0.010053,172.31.40.0-255,66,150207,65,173423
20928,0.012148,172.217.194.0-255,5738,155945,65,173423
20929,0.012156,172.31.40.0-255,66,156011,65,173423
20930,0.014275,172.217.194.0-255,5738,161749,65,173423
20931,0.014285,172.31.40.0-255,66,161815,65,173423
20932,0.016346,172.217.194.0-255,5738,167553,65,173423
20933,0.016356,172.31.40.0-255,66,167619,65,173423
20934,0.018432,172.217.194.0-255,5738,173357,65,173423
20935,0.018439,172.31.40.0-255,66,173423,65,173423
20936,0.0,74.125.24.0-255,150,150,65,108937
20937,1.9e-05,172.31.40.0-255,66,216,65,108937
20938,2.6e-05,74.125.24.0-255,1484,1700,65,108937
20939,3.1e-05,172.31.40.0-255,66,1766,65,108937
20940,3.6e-05,74.125.24.0-255,2902,4668,65,108937
20941,4.8e-05,172.31.40.0-255,66,4734,65,108937
20942,5.7e-05,74.125.24.0-255,7156,11890,65,108937
20943,6e-05,172.31.40.0-255,66,11956,65,108937
20944,9.1e-05,172.31.40.0-255,66,12022,65,108937
20945,0.000108,172.31.40.0-255,66,12088,65,108937
20946,0.000156,172.31.40.0-255,66,12154,65,108937
20947,0.000186,74.125.24.0-255,3602,15756,65,108937
20948,0.000189,172.31.40.0-255,66,15822,65,108937
20949,0.000223,74.125.24.0-255,1484,17306,65,108937
20950,0.000226,172.31.40.0-255,66,17372,65,108937
20951,0.000231,74.125.24.0-255,2902,20274,65,108937
20952,0.000233,172.31.40.0-255,66,20340,65,108937
20953,0.000272,74.125.24.0-255,5738,26078,65,108937
20954,0.000275,172.31.40.0-255,66,26144,65,108937
20955,0.000304,74.125.24.0-255,7071,33215,65,108937
20956,0.000307,172.31.40.0-255,66,33281,65,108937
20957,0.000956,74.125.24.0-255,130,33411,65,108937
20958,0.000962,172.31.40.0-255,66,33477,65,108937
20959,0.001197,74.125.24.0-255,1484,34961,65,108937
20960,0.001202,172.31.40.0-255,66,35027,65,108937
20961,0.001211,74.125.24.0-255,2902,37929,65,108937
20962,0.001214,172.31.40.0-255,66,37995,65,108937
20963,0.001225,74.125.24.0-255,5738,43733,65,108937
20964,0.001227,172.31.40.0-255,66,43799,65,108937
20965,0.001232,74.125.24.0-255,2902,46701,65,108937
20966,0.001235,172.31.40.0-255,66,46767,65,108937
20967,0.001283,172.31.40.0-255,66,46833,65,108937
20968,0.001295,172.31.40.0-255,66,46899,65,108937
20969,0.002208,74.125.24.0-255,1484,48383,65,108937
20970,0.00222,74.125.24.0-255,2902,51285,65,108937
20971,0.002225,172.31.40.0-255,66,51351,65,108937
20972,0.002233,74.125.24.0-255,5738,57089,65,108937
20973,0.002235,172.31.40.0-255,66,57155,65,108937
20974,0.002262,74.125.24.0-255,7156,64311,65,108937
20975,0.002265,172.31.40.0-255,66,64377,65,108937
20976,0.002273,74.125.24.0-255,2902,67279,65,108937
20977,0.002275,172.31.40.0-255,66,67345,65,108937
20978,0.002316,172.31.40.0-255,66,67411,65,108937
20979,0.002321,74.125.24.0-255,2184,69595,65,108937
20980,0.002323,172.31.40.0-255,66,69661,65,108937
20981,0.004634,74.125.24.0-255,5738,75399,65,108937
20982,0.004639,172.31.40.0-255,66,75465,65,108937
20983,0.006948,74.125.24.0-255,5738,81203,65,108937
20984,0.006953,172.31.40.0-255,66,81269,65,108937
20985,0.009309,74.125.24.0-255,5738,87007,65,108937
20986,0.009317,172.31.40.0-255,66,87073,65,108937
20987,0.01165,74.125.24.0-255,5738,92811,65,108937
20988,0.011658,172.31.40.0-255,66,92877,65,108937
20989,0.014014,74.125.24.0-255,4320,97197,65,108937
20990,0.014022,172.31.40.0-255,66,97263,65,108937
20991,0.014051,74.125.24.0-255,1484,98747,65,108937
20992,0.016336,74.125.24.0-255,4320,103067,65,108937
20993,0.016343,172.31.40.0-255,66,103133,65,108937
20994,0.018671,74.125.24.0-255,5738,108871,65,108937
20995,0.018676,172.31.40.0-255,66,108937,65,108937
20996,0.0,74.125.200.0-255,153,153,65,202128
20997,3.9e-05,172.31.40.0-255,66,219,65,202128
20998,4.7e-05,74.125.200.0-255,1484,1703,65,202128
20999,5.2e-05,172.31.40.0-255,66,1769,65,202128
21000,6.4e-05,74.125.200.0-255,2902,4671,65,202128
21001,6.7e-05,172.31.40.0-255,66,4737,65,202128
21002,7.1e-05,74.125.200.0-255,2902,7639,65,202128
21003,7.5e-05,172.31.40.0-255,66,7705,65,202128
21004,8.1e-05,74.125.200.0-255,4320,12025,65,202128
21005,8.3e-05,172.31.40.0-255,66,12091,65,202128
21006,8.8e-05,74.125.200.0-255,2100,14191,65,202128
21007,9.1e-05,172.31.40.0-255,66,14257,65,202128
21008,0.00014,74.125.200.0-255,1484,15741,65,202128
21009,0.000143,172.31.40.0-255,66,15807,65,202128
21010,0.000148,74.125.200.0-255,2902,18709,65,202128
21011,0.000151,172.31.40.0-255,66,18775,65,202128
21012,0.000186,74.125.200.0-255,5738,24513,65,202128
21013,0.000193,172.31.40.0-255,66,24579,65,202128
21014,0.0002,74.125.200.0-255,5738,30317,65,202128
21015,0.000203,172.31.40.0-255,66,30383,65,202128
21016,0.000243,74.125.200.0-255,6797,37180,65,202128
21017,0.000246,172.31.40.0-255,66,37246,65,202128
21018,0.000252,74.125.200.0-255,5738,42984,65,202128
21019,0.000255,172.31.40.0-255,66,43050,65,202128
21020,0.000293,74.125.200.0-255,5379,48429,65,202128
21021,0.000297,172.31.40.0-255,66,48495,65,202128
21022,0.000351,74.125.200.0-255,1484,49979,65,202128
21023,0.000355,172.31.40.0-255,66,50045,65,202128
21024,0.00036,74.125.200.0-255,2902,52947,65,202128
21025,0.000363,172.31.40.0-255,66,53013,65,202128
21026,0.000392,74.125.200.0-255,5738,58751,65,202128
21027,0.000401,172.31.40.0-255,66,58817,65,202128
21028,0.000407,74.125.200.0-255,4320,63137,65,202128
21029,0.000423,172.31.40.0-255,66,63203,65,202128
21030,0.000439,74.125.200.0-255,2875,66078,65,202128
21031,0.000444,172.31.40.0-255,66,66144,65,202128
21032,0.00047,74.125.200.0-255,112,66256,65,202128
21033,0.000615,74.125.200.0-255,330,66586,65,202128
21034,0.000833,74.125.200.0-255,1484,68070,65,202128
21035,0.000838,172.31.40.0-255,66,68136,65,202128
21036,0.000843,74.125.200.0-255,1484,69620,65,202128
21037,0.000871,74.125.200.0-255,1484,71104,65,202128
21038,0.000875,172.31.40.0-255,66,71170,65,202128
21039,0.000883,74.125.200.0-255,5738,76908,65,202128
21040,0.000885,172.31.40.0-255,66,76974,65,202128
21041,0.000897,74.125.200.0-255,4320,81294,65,202128
21042,0.0009,172.31.40.0-255,66,81360,65,202128
21043,0.000961,74.125.200.0-255,2543,83903,65,202128
21044,0.000964,74.125.200.0-255,1484,85387,65,202128
21045,0.000966,172.31.40.0-255,66,85453,65,202128
21046,0.000999,74.125.200.0-255,1484,86937,65,202128
21047,0.001003,172.31.40.0-255,66,87003,65,202128
21048,0.001009,74.125.200.0-255,4320,91323,65,202128
21049,0.001011,172.31.40.0-255,66,91389,65,202128
21050,0.001021,74.125.200.0-255,4320,95709,65,202128
21051,0.001024,172.31.40.0-255,66,95775,65,202128
21052,0.00105,74.125.200.0-255,1484,97259,65,202128
21053,0.001061,74.125.200.0-255,3961,101220,65,202128
21054,0.001064,172.31.40.0-255,66,101286,65,202128
21055,0.001622,74.125.200.0-255,1484,102770,65,202128
21056,0.001648,74.125.200.0-255,2902,105672,65,202128
21057,0.001653,172.31.40.0-255,66,105738,65,202128
21058,0.001658,74.125.200.0-255,1484,107222,65,202128
21059,0.001662,74.125.200.0-255,2902,110124,65,202128
21060,0.001665,172.31.40.0-255,66,110190,65,202128
21061,0.001674,74.125.200.0-255,1484,111674,65,202128
21062,0.0017,74.125.200.0-255,4320,115994,65,202128
21063,0.001703,172.31.40.0-255,66,116060,65,202128
21064,0.00173,74.125.200.0-255,2902,118962,65,202128
21065,0.001734,172.31.40.0-255,66,119028,65,202128
21066,0.001762,172.31.40.0-255,66,119094,65,202128
21067,0.001789,74.125.200.0-255,1484,120578,65,202128
21068,0.001808,74.125.200.0-255,2902,123480,65,202128
21069,0.001811,172.31.40.0-255,66,123546,65,202128
21070,0.00184,74.125.200.0-255,2184,125730,65,202128
21071,0.001843,172.31.40.0-255,66,125796,65,202128
21072,0.0019,74.125.200.0-255,1484,127280,65,202128
21073,0.001907,74.125.200.0-255,2902,130182,65,202128
21074,0.00191,172.31.40.0-255,66,130248,65,202128
21075,0.001915,74.125.200.0-255,2902,133150,65,202128
21076,0.001917,172.31.40.0-255,66,133216,65,202128
21077,0.001941,74.125.200.0-255,2902,136118,65,202128
21078,0.001948,172.31.40.0-255,66,136184,65,202128
21079,0.001955,74.125.200.0-255,4320,140504,65,202128
21080,0.001957,172.31.40.0-255,66,140570,65,202128
21081,0.002012,172.31.40.0-255,66,140636,65,202128
21082,0.002019,74.125.200.0-255,5738,146374,65,202128
21083,0.002086,74.125.200.0-255,5020,151394,65,202128
21084,0.002094,74.125.200.0-255,5738,157132,65,202128
21085,0.00212,74.125.200.0-255,6438,163570,65,202128
21086,0.002431,74.125.200.0-255,1484,165054,65,202128
21087,0.002438,74.125.200.0-255,2902,167956,65,202128
21088,0.002471,74.125.200.0-255,5738,173694,65,202128
21089,0.002477,74.125.200.0-255,2902,176596,65,202128
21090,0.002496,74.125.200.0-255,4320,180916,65,202128
21091,0.002513,74.125.200.0-255,1484,182400,65,202128
21092,0.002563,74.125.200.0-255,2184,184584,65,202128
21093,0.010947,172.31.40.0-255,66,184650,65,202128
21094,0.012376,74.125.200.0-255,1484,186134,65,202128
21095,0.013493,74.125.200.0-255,4320,190454,65,202128
21096,0.013501,172.31.40.0-255,66,190520,65,202128
21097,0.016038,74.125.200.0-255,5738,196258,65,202128
21098,0.016046,172.31.40.0-255,66,196324,65,202128
21099,0.018606,74.125.200.0-255,5738,202062,65,202128
21100,0.018626,172.31.40.0-255,66,202128,65,202128
21101,0.0,172.31.40.0-255,105,105,65,102687
21102,0.000233,172.31.40.0-255,90,195,65,102687
21103,0.000245,172.31.40.0-255,66,261,65,102687
21104,0.00256,74.125.68.0-255,66,327,65,102687
21105,0.002589,74.125.68.0-255,66,393,65,102687
21106,0.002612,172.31.40.0-255,66,459,65,102687
21107,0.00636,74.125.130.0-255,147,606,65,102687
21108,0.006369,172.31.40.0-255,66,672,65,102687
21109,0.006399,74.125.130.0-255,1484,2156,65,102687
21110,0.006403,172.31.40.0-255,66,2222,65,102687
21111,0.006424,74.125.130.0-255,2902,5124,65,102687
21112,0.006428,172.31.40.0-255,66,5190,65,102687
21113,0.006458,74.125.130.0-255,5738,10928,65,102687
21114,0.006461,172.31.40.0-255,66,10994,65,102687
21115,0.006511,74.125.130.0-255,2902,13896,65,102687
21116,0.006514,172.31.40.0-255,66,13962,65,102687
21117,0.006549,74.125.130.0-255,2165,16127,65,102687
21118,0.006552,172.31.40.0-255,66,16193,65,102687
21119,0.006558,74.125.130.0-255,5738,21931,65,102687
21120,0.006561,172.31.40.0-255,66,21997,65,102687
21121,0.006574,172.31.40.0-255,66,22063,65,102687
21122,0.006579,74.125.130.0-255,2902,24965,65,102687
21123,0.006581,172.31.40.0-255,66,25031,65,102687
21124,0.006623,172.31.40.0-255,66,25097,65,102687
21125,0.00663,74.125.130.0-255,5020,30117,65,102687
21126,0.006632,172.31.40.0-255,66,30183,65,102687
21127,0.006924,74.125.130.0-255,1484,31667,65,102687
21128,0.006931,172.31.40.0-255,66,31733,65,102687
21129,0.006937,74.125.130.0-255,2902,34635,65,102687
21130,0.006939,172.31.40.0-255,66,34701,65,102687
21131,0.006968,74.125.130.0-255,2902,37603,65,102687
21132,0.006971,172.31.40.0-255,66,37669,65,102687
21133,0.006975,74.125.130.0-255,2902,40571,65,102687
21134,0.006978,172.31.40.0-255,66,40637,65,102687
21135,0.006997,74.125.130.0-255,1484,42121,65,102687
21136,0.007,172.31.40.0-255,66,42187,65,102687
21137,0.007036,74.125.130.0-255,5630,47817,65,102687
21138,0.00704,172.31.40.0-255,66,47883,65,102687
21139,0.007043,74.125.130.0-255,120,48003,65,102687
21140,0.007628,172.31.40.0-255,66,48069,65,102687
21141,0.008167,74.125.130.0-255,1484,49553,65,102687
21142,0.008178,74.125.130.0-255,2902,52455,65,102687
21143,0.008182,172.31.40.0-255,66,52521,65,102687
21144,0.00819,74.125.130.0-255,4320,56841,65,102687
21145,0.008192,172.31.40.0-255,66,56907,65,102687
21146,0.008227,172.31.40.0-255,66,56973,65,102687
21147,0.008232,74.125.130.0-255,4320,61293,65,102687
21148,0.008234,172.31.40.0-255,66,61359,65,102687
21149,0.008241,74.125.130.0-255,5738,67097,65,102687
21150,0.008243,172.31.40.0-255,66,67163,65,102687
21151,0.008294,74.125.130.0-255,6438,73601,65,102687
21152,0.008296,172.31.40.0-255,66,73667,65,102687
21153,0.010548,74.125.130.0-255,5738,79405,65,102687
21154,0.010551,172.31.40.0-255,66,79471,65,102687
21155,0.012803,74.125.130.0-255,5738,85209,65,102687
21156,0.012809,172.31.40.0-255,66,85275,65,102687
21157,0.015069,74.125.130.0-255,5738,91013,65,102687
21158,0.015078,172.31.40.0-255,66,91079,65,102687
21159,0.01735,74.125.130.0-255,5738,96817,65,102687
21160,0.017358,172.31.40.0-255,66,96883,65,102687
21161,0.01962,74.125.130.0-255,5738,102621,65,102687
21162,0.019628,172.31.40.0-255,66,102687,65,102687
21163,0.0,172.253.118.0-255,151,151,65,151470
21164,1.5e-05,172.31.40.0-255,66,217,65,151470
21165,2.2e-05,172.253.118.0-255,1484,1701,65,151470
21166,2.7e-05,172.31.40.0-255,66,1767,65,151470
21167,3.3e-05,172.253.118.0-255,2902,4669,65,151470
21168,4.3e-05,172.31.40.0-255,66,4735,65,151470
21169,6e-05,172.253.118.0-255,7156,11891,65,151470
21170,6.4e-05,172.31.40.0-255,66,11957,65,151470
21171,6.8e-05,172.253.118.0-255,1985,13942,65,151470
21172,7.1e-05,172.31.40.0-255,66,14008,65,151470
21173,8.5e-05,172.31.40.0-255,66,14074,65,151470
21174,9.1e-05,172.253.118.0-255,5379,19453,65,151470
21175,9.4e-05,172.31.40.0-255,66,19519,65,151470
21176,0.000541,172.253.118.0-255,1484,21003,65,151470
21177,0.000547,172.31.40.0-255,66,21069,65,151470
21178,0.000553,172.253.118.0-255,2902,23971,65,151470
21179,0.000555,172.31.40.0-255,66,24037,65,151470
21180,0.000588,172.253.118.0-255,5738,29775,65,151470
21181,0.00059,172.31.40.0-255,66,29841,65,151470
21182,0.000597,172.253.118.0-255,4320,34161,65,151470
21183,0.000598,172.31.40.0-255,66,34227,65,151470
21184,0.000622,172.253.118.0-255,2543,36770,65,151470
21185,0.000624,172.31.40.0-255,66,36836,65,151470
21186,0.000642,172.253.118.0-255,1484,38320,65,151470
21187,0.000644,172.31.40.0-255,66,38386,65,151470
21188,0.000668,172.253.118.0-255,5738,44124,65,151470
21189,0.000671,172.31.40.0-255,66,44190,65,151470
21190,0.000684,172.31.40.0-255,66,44256,65,151470
21191,0.000687,172.253.118.0-255,1125,45381,65,151470
21192,0.000689,172.31.40.0-255,66,45447,65,151470
21193,0.000945,172.253.118.0-255,645,46092,65,151470
21194,0.00101,172.31.40.0-255,66,46158,65,151470
21195,0.001065,172.253.118.0-255,1484,47642,65,151470
21196,0.00107,172.253.118.0-255,1484,49126,65,151470
21197,0.001072,172.31.40.0-255,66,49192,65,151470
21198,0.001105,172.253.118.0-255,1484,50676,65,151470
21199,0.001112,172.253.118.0-255,5738,56414,65,151470
21200,0.001114,172.31.40.0-255,66,56480,65,151470
21201,0.00112,172.253.118.0-255,4320,60800,65,151470
21202,0.001122,172.31.40.0-255,66,60866,65,151470
21203,0.001154,172.31.40.0-255,66,60932,65,151470
21204,0.001197,172.253.118.0-255,2543,63475,65,151470
21205,0.0012,172.31.40.0-255,66,63541,65,151470
21206,0.001207,172.253.118.0-255,6797,70338,65,151470
21207,0.001209,172.31.40.0-255,66,70404,65,151470
21208,0.001716,172.253.118.0-255,1484,71888,65,151470
21209,0.001725,172.253.118.0-255,2902,74790,65,151470
21210,0.00173,172.31.40.0-255,66,74856,65,151470
21211,0.001738,172.253.118.0-255,5738,80594,65,151470
21212,0.00174,172.31.40.0-255,66,80660,65,151470
21213,0.001789,172.31.40.0-255,66,80726,65,151470
21214,0.001828,172.31.40.0-255,66,80792,65,151470
21215,0.001866,172.31.40.0-255,66,80858,65,151470
21216,0.001873,172.253.118.0-255,5738,86596,65,151470
21217,0.001875,172.31.40.0-255,66,86662,65,151470
21218,0.001964,172.31.40.0-255,66,86728,65,151470
21219,0.001979,172.253.118.0-255,3602,90330,65,151470
21220,0.001986,172.31.40.0-255,66,90396,65,151470
21221,0.001989,172.253.118.0-255,1484,91880,65,151470
21222,0.001994,172.253.118.0-255,2902,94782,65,151470
21223,0.001996,172.31.40.0-255,66,94848,65,151470
21224,0.002001,172.253.118.0-255,4320,99168,65,151470
21225,0.002003,172.31.40.0-255,66,99234,65,151470
21226,0.003966,172.253.118.0-255,5738,104972,65,151470
21227,0.003973,172.31.40.0-255,66,105038,65,151470
21228,0.005938,172.253.118.0-255,5738,110776,65,151470
21229,0.005943,172.31.40.0-255,66,110842,65,151470
21230,0.007939,172.253.118.0-255,5738,116580,65,151470
21231,0.007946,172.31.40.0-255,66,116646,65,151470
21232,0.009918,172.253.118.0-255,5738,122384,65,151470
21233,0.009925,172.31.40.0-255,66,122450,65,151470
21234,0.011905,172.253.118.0-255,5738,128188,65,151470
21235,0.011912,172.31.40.0-255,66,128254,65,151470
21236,0.0139,172.253.118.0-255,5738,133992,65,151470
21237,0.013908,172.31.40.0-255,66,134058,65,151470
21238,0.015886,172.253.118.0-255,5738,139796,65,151470
21239,0.015894,172.31.40.0-255,66,139862,65,151470
21240,0.017883,172.253.118.0-255,5738,145600,65,151470
21241,0.017893,172.31.40.0-255,66,145666,65,151470
21242,0.019889,172.253.118.0-255,5738,151404,65,151470
21243,0.019896,172.31.40.0-255,66,151470,65,151470
21244,0.0,74.125.68.0-255,153,153,65,196559
21245,1.9e-05,172.31.40.0-255,66,219,65,196559
21246,5.4e-05,74.125.68.0-255,1484,1703,65,196559
21247,5.8e-05,172.31.40.0-255,66,1769,65,196559
21248,6.3e-05,74.125.68.0-255,2902,4671,65,196559
21249,6.7e-05,172.31.40.0-255,66,4737,65,196559
21250,7.4e-05,74.125.68.0-255,5738,10475,65,196559
21251,7.7e-05,172.31.40.0-255,66,10541,65,196559
21252,8.2e-05,74.125.68.0-255,3401,13942,65,196559
21253,8.5e-05,172.31.40.0-255,66,14008,65,196559
21254,8.8e-05,74.125.68.0-255,1484,15492,65,196559
21255,9.2e-05,172.31.40.0-255,66,15558,65,196559
21256,0.00012,74.125.68.0-255,2902,18460,65,196559
21257,0.000124,172.31.40.0-255,66,18526,65,196559
21258,0.000141,74.125.68.0-255,5738,24264,65,196559
21259,0.000144,172.31.40.0-255,66,24330,65,196559
21260,0.000166,74.125.68.0-255,4320,28650,65,196559
21261,0.000168,172.31.40.0-255,66,28716,65,196559
21262,0.000173,74.125.68.0-255,2543,31259,65,196559
21263,0.000175,172.31.40.0-255,66,31325,65,196559
21264,0.000242,74.125.68.0-255,1484,32809,65,196559
21265,0.000245,172.31.40.0-255,66,32875,65,196559
21266,0.000269,74.125.68.0-255,2902,35777,65,196559
21267,0.000272,172.31.40.0-255,66,35843,65,196559
21268,0.000278,74.125.68.0-255,4320,40163,65,196559
21269,0.00028,172.31.40.0-255,66,40229,65,196559
21270,0.000302,74.125.68.0-255,1484,41713,65,196559
21271,0.000304,172.31.40.0-255,66,41779,65,196559
21272,0.00031,74.125.68.0-255,4320,46099,65,196559
21273,0.000315,172.31.40.0-255,66,46165,65,196559
21274,0.000332,74.125.68.0-255,2543,48708,65,196559
21275,0.000334,172.31.40.0-255,66,48774,65,196559
21276,0.00045,74.125.68.0-255,1484,50258,65,196559
21277,0.000468,74.125.68.0-255,2902,53160,65,196559
21278,0.000471,172.31.40.0-255,66,53226,65,196559
21279,0.000501,74.125.68.0-255,5738,58964,65,196559
21280,0.000504,172.31.40.0-255,66,59030,65,196559
21281,0.000511,74.125.68.0-255,6797,65827,65,196559
21282,0.000514,172.31.40.0-255,66,65893,65,196559
21283,0.000594,74.125.68.0-255,1484,67377,65,196559
21284,0.000611,74.125.68.0-255,2902,70279,65,196559
21285,0.000614,172.31.40.0-255,66,70345,65,196559
21286,0.000631,74.125.68.0-255,1484,71829,65,196559
21287,0.00065,74.125.68.0-255,4320,76149,65,196559
21288,0.000653,172.31.40.0-255,66,76215,65,196559
21289,0.000657,74.125.68.0-255,2902,79117,65,196559
21290,0.00066,172.31.40.0-255,66,79183,65,196559
21291,0.000664,74.125.68.0-255,3961,83144,65,196559
21292,0.00067,172.31.40.0-255,66,83210,65,196559
21293,0.000701,74.125.68.0-255,7156,90366,65,196559
21294,0.000704,172.31.40.0-255,66,90432,65,196559
21295,0.000732,74.125.68.0-255,5738,96170,65,196559
21296,0.000735,172.31.40.0-255,66,96236,65,196559
21297,0.000761,74.125.68.0-255,2902,99138,65,196559
21298,0.000764,172.31.40.0-255,66,99204,65,196559
21299,0.000768,74.125.68.0-255,1705,100909,65,196559
21300,0.00077,172.31.40.0-255,66,100975,65,196559
21301,0.001436,74.125.68.0-255,1484,102459,65,196559
21302,0.001455,74.125.68.0-255,2902,105361,65,196559
21303,0.00146,172.31.40.0-255,66,105427,65,196559
21304,0.001466,74.125.68.0-255,2902,108329,65,196559
21305,0.001468,172.31.40.0-255,66,108395,65,196559
21306,0.001489,74.125.68.0-255,2902,111297,65,196559
21307,0.001491,172.31.40.0-255,66,111363,65,196559
21308,0.0015,74.125.68.0-255,2902,114265,65,196559
21309,0.001502,172.31.40.0-255,66,114331,65,196559
21310,0.001531,74.125.68.0-255,4320,118651,65,196559
21311,0.001534,172.31.40.0-255,66,118717,65,196559
21312,0.001545,172.31.40.0-255,66,118783,65,196559
21313,0.00155,74.125.68.0-255,2902,121685,65,196559
21314,0.001556,172.31.40.0-255,66,121751,65,196559
21315,0.001575,74.125.68.0-255,5020,126771,65,196559
21316,0.001578,172.31.40.0-255,66,126837,65,196559
21317,0.001782,74.125.68.0-255,1484,128321,65,196559
21318,0.001828,74.125.68.0-255,1484,129805,65,196559
21319,0.001832,172.31.40.0-255,66,129871,65,196559
21320,0.001857,74.125.68.0-255,1484,131355,65,196559
21321,0.001863,74.125.68.0-255,2902,134257,65,196559
21322,0.001865,172.31.40.0-255,66,134323,65,196559
21323,0.001892,74.125.68.0-255,4320,138643,65,196559
21324,0.001895,172.31.40.0-255,66,138709,65,196559
21325,0.001902,74.125.68.0-255,5738,144447,65,196559
21326,0.001904,172.31.40.0-255,66,144513,65,196559
21327,0.001933,74.125.68.0-255,2902,147415,65,196559
21328,0.001936,172.31.40.0-255,66,147481,65,196559
21329,0.001956,74.125.68.0-255,2902,150383,65,196559
21330,0.001958,172.31.40.0-255,66,150449,65,196559
21331,0.001983,74.125.68.0-255,1484,151933,65,196559
21332,0.001995,172.31.40.0-255,66,151999,65,196559
21333,0.002022,74.125.68.0-255,766,152765,65,196559
21334,0.002875,172.31.40.0-255,66,152831,65,196559
21335,0.004042,74.125.68.0-255,4320,157151,65,196559
21336,0.004049,172.31.40.0-255,66,157217,65,196559
21337,0.004966,74.125.68.0-255,1484,158701,65,196559
21338,0.006097,74.125.68.0-255,2902,161603,65,196559
21339,0.0061,172.31.40.0-255,66,161669,65,196559
21340,0.006122,74.125.68.0-255,1484,163153,65,196559
21341,0.008152,74.125.68.0-255,4320,167473,65,196559
21342,0.008157,172.31.40.0-255,66,167539,65,196559
21343,0.010241,74.125.68.0-255,5738,173277,65,196559
21344,0.010248,172.31.40.0-255,66,173343,65,196559
21345,0.012311,74.125.68.0-255,5738,179081,65,196559
21346,0.012319,172.31.40.0-255,66,179147,65,196559
21347,0.014389,74.125.68.0-255,5738,184885,65,196559
21348,0.014397,172.31.40.0-255,66,184951,65,196559
21349,0.016458,74.125.68.0-255,5738,190689,65,196559
21350,0.016466,172.31.40.0-255,66,190755,65,196559
21351,0.018565,74.125.68.0-255,5738,196493,65,196559
21352,0.018573,172.31.40.0-255,66,196559,65,196559
21353,0.0,172.217.194.0-255,66,66,65,66
21354,0.0,172.217.194.0-255,150,150,65,181433
21355,2.3e-05,172.31.40.0-255,66,216,65,181433
21356,3e-05,172.217.194.0-255,1484,1700,65,181433
21357,3.5e-05,172.31.40.0-255,66,1766,65,181433
21358,4.1e-05,172.217.194.0-255,2902,4668,65,181433
21359,4.5e-05,172.31.40.0-255,66,4734,65,181433
21360,5.2e-05,172.217.194.0-255,7156,11890,65,181433
21361,5.5e-05,172.31.40.0-255,66,11956,65,181433
21362,5.9e-05,172.217.194.0-255,2030,13986,65,181433
21363,6.2e-05,172.31.40.0-255,66,14052,65,181433
21364,9.8e-05,172.31.40.0-255,66,14118,65,181433
21365,0.000105,172.217.194.0-255,5379,19497,65,181433
21366,0.000107,172.31.40.0-255,66,19563,65,181433
21367,0.000156,172.217.194.0-255,1484,21047,65,181433
21368,0.000159,172.31.40.0-255,66,21113,65,181433
21369,0.000163,172.217.194.0-255,2902,24015,65,181433
21370,0.000165,172.31.40.0-255,66,24081,65,181433
21371,0.000169,172.217.194.0-255,1484,25565,65,181433
21372,0.000171,172.31.40.0-255,66,25631,65,181433
21373,0.000195,172.217.194.0-255,4320,29951,65,181433
21374,0.000199,172.217.194.0-255,2902,32853,65,181433
21375,0.000203,172.31.40.0-255,66,32919,65,181433
21376,0.000205,172.31.40.0-255,66,32985,65,181433
21377,0.000226,172.31.40.0-255,66,33051,65,181433
21378,0.000283,172.31.40.0-255,66,33117,65,181433
21379,0.000377,172.217.194.0-255,646,33763,65,181433
21380,0.000381,172.31.40.0-255,66,33829,65,181433
21381,0.000519,172.217.194.0-255,1484,35313,65,181433
21382,0.000523,172.31.40.0-255,66,35379,65,181433
21383,0.000528,172.217.194.0-255,2902,38281,65,181433
21384,0.00053,172.31.40.0-255,66,38347,65,181433
21385,0.000562,172.217.194.0-255,5738,44085,65,181433
21386,0.000564,172.217.194.0-255,1484,45569,65,181433
21387,0.00057,172.31.40.0-255,66,45635,65,181433
21388,0.000602,172.31.40.0-255,66,45701,65,181433
21389,0.000607,172.217.194.0-255,4320,50021,65,181433
21390,0.000609,172.31.40.0-255,66,50087,65,181433
21391,0.00063,172.31.40.0-255,66,50153,65,181433
21392,0.000662,172.217.194.0-255,1484,51637,65,181433
21393,0.000693,172.217.194.0-255,2902,54539,65,181433
21394,0.000696,172.31.40.0-255,66,54605,65,181433
21395,0.000702,172.217.194.0-255,5738,60343,65,181433
21396,0.000704,172.31.40.0-255,66,60409,65,181433
21397,0.00071,172.217.194.0-255,7156,67565,65,181433
21398,0.000712,172.31.40.0-255,66,67631,65,181433
21399,0.000726,172.217.194.0-255,2902,70533,65,181433
21400,0.000729,172.31.40.0-255,66,70599,65,181433
21401,0.00074,172.31.40.0-255,66,70665,65,181433
21402,0.000775,172.31.40.0-255,66,70731,65,181433
21403,0.000784,172.31.40.0-255,66,70797,65,181433
21404,0.000809,172.217.194.0-255,7156,77953,65,181433
21405,0.000812,172.31.40.0-255,66,78019,65,181433
21406,0.000839,172.31.40.0-255,66,78085,65,181433
21407,0.000841,172.217.194.0-255,766,78851,65,181433
21408,0.000899,172.217.194.0-255,1484,80335,65,181433
21409,0.000902,172.31.40.0-255,66,80401,65,181433
21410,0.000906,172.217.194.0-255,2902,83303,65,181433
21411,0.000908,172.31.40.0-255,66,83369,65,181433
21412,0.000928,172.217.194.0-255,5738,89107,65,181433
21413,0.000931,172.31.40.0-255,66,89173,65,181433
21414,0.000936,172.217.194.0-255,4320,93493,65,181433
21415,0.000938,172.31.40.0-255,66,93559,65,181433
21416,0.000965,172.31.40.0-255,66,93625,65,181433
21417,0.00097,172.217.194.0-255,2902,96527,65,181433
21418,0.000971,172.31.40.0-255,66,96593,65,181433
21419,0.000999,172.31.40.0-255,66,96659,65,181433
21420,0.001022,172.217.194.0-255,4320,100979,65,181433
21421,0.001024,172.31.40.0-255,66,101045,65,181433
21422,0.001039,172.217.194.0-255,7156,108201,65,181433
21423,0.001042,172.31.40.0-255,66,108267,65,181433
21424,0.001053,172.31.40.0-255,66,108333,65,181433
21425,0.001091,172.217.194.0-255,2902,111235,65,181433
21426,0.001096,172.31.40.0-255,66,111301,65,181433
21427,0.001109,172.217.194.0-255,6438,117739,65,181433
21428,0.001111,172.31.40.0-255,66,117805,65,181433
21429,0.001154,172.217.194.0-255,1484,119289,65,181433
21430,0.001158,172.217.194.0-255,2902,122191,65,181433
21431,0.001159,172.31.40.0-255,66,122257,65,181433
21432,0.001162,172.217.194.0-255,1484,123741,65,181433
21433,0.001182,172.217.194.0-255,4320,128061,65,181433
21434,0.001184,172.31.40.0-255,66,128127,65,181433
21435,0.00119,172.217.194.0-255,5738,133865,65,181433
21436,0.001191,172.31.40.0-255,66,133931,65,181433
21437,0.001207,172.217.194.0-255,1484,135415,65,181433
21438,0.00123,172.31.40.0-255,66,135481,65,181433
21439,0.001235,172.217.194.0-255,5020,140501,65,181433
21440,0.001237,172.31.40.0-255,66,140567,65,181433
21441,0.001332,172.217.194.0-255,1484,142051,65,181433
21442,0.001336,172.217.194.0-255,2902,144953,65,181433
21443,0.001339,172.31.40.0-255,66,145019,65,181433
21444,0.001364,172.217.194.0-255,5738,150757,65,181433
21445,0.001367,172.31.40.0-255,66,150823,65,181433
21446,0.001371,172.217.194.0-255,4320,155143,65,181433
21447,0.001373,172.31.40.0-255,66,155209,65,181433
21448,0.001397,172.31.40.0-255,66,155275,65,181433
21449,0.001409,172.31.40.0-255,66,155341,65,181433
21450,0.001436,172.217.194.0-255,1484,156825,65,181433
21451,0.00144,172.217.194.0-255,2902,159727,65,181433
21452,0.001444,172.31.40.0-255,66,159793,65,181433
21453,0.001458,172.217.194.0-255,5738,165531,65,181433
21454,0.00146,172.31.40.0-255,66,165597,65,181433
21455,0.001492,172.31.40.0-255,66,165663,65,181433
21456,0.001517,172.217.194.0-255,2902,168565,65,181433
21457,0.00152,172.31.40.0-255,66,168631,65,181433
21458,0.001532,172.31.40.0-255,66,168697,65,181433
21459,0.001574,172.31.40.0-255,66,168763,65,181433
21460,0.001599,172.217.194.0-255,5738,174501,65,181433
21461,0.001601,172.31.40.0-255,66,174567,65,181433
21462,0.001615,172.31.40.0-255,66,174633,65,181433
21463,0.001621,172.217.194.0-255,5738,180371,65,181433
21464,0.001623,172.31.40.0-255,66,180437,65,181433
21465,0.001676,172.31.40.0-255,66,180503,65,181433
21466,0.00168,172.217.194.0-255,105,180608,65,181433
21467,0.001682,172.217.194.0-255,129,180737,65,181433
21468,0.004089,172.31.40.0-255,105,180842,65,181433
21469,0.004122,172.31.40.0-255,105,180947,65,181433
21470,0.004356,172.31.40.0-255,90,181037,65,181433
21471,0.004366,172.31.40.0-255,66,181103,65,181433
21472,0.006268,172.217.194.0-255,66,181169,65,181433
21473,0.006283,172.217.194.0-255,66,181235,65,181433
21474,0.006518,172.217.194.0-255,66,181301,65,181433
21475,0.006543,172.217.194.0-255,66,181367,65,181433
21476,0.006554,172.31.40.0-255,66,181433,65,181433
21477,0.0,74.125.200.0-255,150,150,65,262820
21478,2.2e-05,172.31.40.0-255,66,216,65,262820
21479,2.9e-05,74.125.200.0-255,1484,1700,65,262820
21480,3.3e-05,172.31.40.0-255,66,1766,65,262820
21481,4e-05,74.125.200.0-255,2902,4668,65,262820
21482,5.3e-05,172.31.40.0-255,66,4734,65,262820
21483,5.6e-05,74.125.200.0-255,1484,6218,65,262820
21484,5.9e-05,172.31.40.0-255,66,6284,65,262820
21485,6.5e-05,74.125.200.0-255,2902,9186,65,262820
21486,6.9e-05,172.31.40.0-255,66,9252,65,262820
21487,0.000107,74.125.200.0-255,4862,14114,65,262820
21488,0.000114,172.31.40.0-255,66,14180,65,262820
21489,0.000229,74.125.200.0-255,1484,15664,65,262820
21490,0.000233,172.31.40.0-255,66,15730,65,262820
21491,0.000265,74.125.200.0-255,2902,18632,65,262820
21492,0.000268,172.31.40.0-255,66,18698,65,262820
21493,0.000272,74.125.200.0-255,1484,20182,65,262820
21494,0.000274,172.31.40.0-255,66,20248,65,262820
21495,0.00031,74.125.200.0-255,4320,24568,65,262820
21496,0.000313,172.31.40.0-255,66,24634,65,262820
21497,0.00032,74.125.200.0-255,6797,31431,65,262820
21498,0.000323,172.31.40.0-255,66,31497,65,262820
21499,0.00033,74.125.200.0-255,1484,32981,65,262820
21500,0.000332,172.31.40.0-255,66,33047,65,262820
21501,0.000361,74.125.200.0-255,2902,35949,65,262820
21502,0.000368,172.31.40.0-255,66,36015,65,262820
21503,0.000373,74.125.200.0-255,2902,38917,65,262820
21504,0.000375,172.31.40.0-255,66,38983,65,262820
21505,0.000406,74.125.200.0-255,2902,41885,65,262820
21506,0.000409,172.31.40.0-255,66,41951,65,262820
21507,0.000417,74.125.200.0-255,7156,49107,65,262820
21508,0.000419,172.31.40.0-255,66,49173,65,262820
21509,0.000435,74.125.200.0-255,1484,50657,65,262820
21510,0.000456,74.125.200.0-255,2902,53559,65,262820
21511,0.000458,172.31.40.0-255,66,53625,65,262820
21512,0.000465,74.125.200.0-255,5738,59363,65,262820
21513,0.000468,172.31.40.0-255,66,59429,65,262820
21514,0.000504,74.125.200.0-255,6438,65867,65,262820
21515,0.000511,172.31.40.0-255,66,65933,65,262820
21516,0.000536,74.125.200.0-255,365,66298,65,262820
21517,0.000548,74.125.200.0-255,126,66424,65,262820
21518,0.000655,74.125.200.0-255,1484,67908,65,262820
21519,0.00066,172.31.40.0-255,66,67974,65,262820
21520,0.000665,74.125.200.0-255,2902,70876,65,262820
21521,0.000667,172.31.40.0-255,66,70942,65,262820
21522,0.000694,74.125.200.0-255,5738,76680,65,262820
21523,0.000696,172.31.40.0-255,66,76746,65,262820
21524,0.000703,74.125.200.0-255,5738,82484,65,262820
21525,0.000705,172.31.40.0-255,66,82550,65,262820
21526,0.000722,74.125.200.0-255,1484,84034,65,262820
21527,0.000742,74.125.200.0-255,7156,91190,65,262820
21528,0.000745,172.31.40.0-255,66,91256,65,262820
21529,0.000778,74.125.200.0-255,7156,98412,65,262820
21530,0.000781,172.31.40.0-255,66,98478,65,262820
21531,0.000786,74.125.200.0-255,2184,100662,65,262820
21532,0.000788,172.31.40.0-255,66,100728,65,262820
21533,0.000821,74.125.200.0-255,3184,103912,65,262820
21534,0.000823,172.31.40.0-255,66,103978,65,262820
21535,0.000853,74.125.200.0-255,4320,108298,65,262820
21536,0.000856,172.31.40.0-255,66,108364,65,262820
21537,0.000863,74.125.200.0-255,5738,114102,65,262820
21538,0.000865,172.31.40.0-255,66,114168,65,262820
21539,0.000908,172.31.40.0-255,66,114234,65,262820
21540,0.000914,74.125.200.0-255,4320,118554,65,262820
21541,0.000915,172.31.40.0-255,66,118620,65,262820
21542,0.000948,74.125.200.0-255,2902,121522,65,262820
21543,0.000951,172.31.40.0-255,66,121588,65,262820
21544,0.000978,74.125.200.0-255,2184,123772,65,262820
21545,0.000981,172.31.40.0-255,66,123838,65,262820
21546,0.001024,74.125.200.0-255,1484,125322,65,262820
21547,0.001037,74.125.200.0-255,1484,126806,65,262820
21548,0.001039,172.31.40.0-255,66,126872,65,262820
21549,0.001064,74.125.200.0-255,2902,129774,65,262820
21550,0.001067,172.31.40.0-255,66,129840,65,262820
21551,0.001098,74.125.200.0-255,5738,135578,65,262820
21552,0.001101,172.31.40.0-255,66,135644,65,262820
21553,0.001104,74.125.200.0-255,1484,137128,65,262820
21554,0.001132,74.125.200.0-255,1484,138612,65,262820
21555,0.001134,172.31.40.0-255,66,138678,65,262820
21556,0.001139,74.125.200.0-255,4320,142998,65,262820
21557,0.001141,172.31.40.0-255,66,143064,65,262820
21558,0.001146,74.125.200.0-255,4320,147384,65,262820
21559,0.001148,172.31.40.0-255,66,147450,65,262820
21560,0.001168,74.125.200.0-255,2902,150352,65,262820
21561,0.001171,172.31.40.0-255,66,150418,65,262820
21562,0.001179,74.125.200.0-255,4320,154738,65,262820
21563,0.001182,172.31.40.0-255,66,154804,65,262820
21564,0.001209,74.125.200.0-255,3602,158406,65,262820
21565,0.001211,172.31.40.0-255,66,158472,65,262820
21566,0.00129,74.125.200.0-255,1484,159956,65,262820
21567,0.001311,74.125.200.0-255,2902,162858,65,262820
21568,0.001314,172.31.40.0-255,66,162924,65,262820
21569,0.001345,74.125.200.0-255,5738,168662,65,262820
21570,0.001348,172.31.40.0-255,66,168728,65,262820
21571,0.001352,74.125.200.0-255,2902,171630,65,262820
21572,0.001354,172.31.40.0-255,66,171696,65,262820
21573,0.00138,74.125.200.0-255,4320,176016,65,262820
21574,0.001386,172.31.40.0-255,66,176082,65,262820
21575,0.001422,74.125.200.0-255,4320,180402,65,262820
21576,0.001424,172.31.40.0-255,66,180468,65,262820
21577,0.001458,74.125.200.0-255,4320,184788,65,262820
21578,0.001461,172.31.40.0-255,66,184854,65,262820
21579,0.001466,74.125.200.0-255,4320,189174,65,262820
21580,0.001468,172.31.40.0-255,66,189240,65,262820
21581,0.001472,74.125.200.0-255,3602,192842,65,262820
21582,0.001478,172.31.40.0-255,66,192908,65,262820
21583,0.001871,74.125.200.0-255,1484,194392,65,262820
21584,0.001878,74.125.200.0-255,2902,197294,65,262820
21585,0.001881,172.31.40.0-255,66,197360,65,262820
21586,0.001906,74.125.200.0-255,5738,203098,65,262820
21587,0.001909,172.31.40.0-255,66,203164,65,262820
21588,0.001914,74.125.200.0-255,2902,206066,65,262820
21589,0.001915,172.31.40.0-255,66,206132,65,262820
21590,0.001954,74.125.200.0-255,4320,210452,65,262820
21591,0.001957,172.31.40.0-255,66,210518,65,262820
21592,0.001968,172.31.40.0-255,66,210584,65,262820
21593,0.003871,74.125.200.0-255,5738,216322,65,262820
21594,0.003878,172.31.40.0-255,66,216388,65,262820
21595,0.005794,74.125.200.0-255,5738,222126,65,262820
21596,0.005798,172.31.40.0-255,66,222192,65,262820
21597,0.007713,74.125.200.0-255,5738,227930,65,262820
21598,0.007722,172.31.40.0-255,66,227996,65,262820
21599,0.009636,74.125.200.0-255,5738,233734,65,262820
21600,0.009645,172.31.40.0-255,66,233800,65,262820
21601,0.011588,74.125.200.0-255,5738,239538,65,262820
21602,0.011602,172.31.40.0-255,66,239604,65,262820
21603,0.013519,74.125.200.0-255,5738,245342,65,262820
21604,0.013529,172.31.40.0-255,66,245408,65,262820
21605,0.015459,74.125.200.0-255,5738,251146,65,262820
21606,0.015467,172.31.40.0-255,66,251212,65,262820
21607,0.017379,74.125.200.0-255,5738,256950,65,262820
21608,0.017387,172.31.40.0-255,66,257016,65,262820
21609,0.019319,74.125.200.0-255,5738,262754,65,262820
21610,0.019327,172.31.40.0-255,66,262820,65,262820
21611,0.0,74.125.130.0-255,153,153,65,294383
21612,2.2e-05,172.31.40.0-255,66,219,65,294383
21613,2.8e-05,74.125.130.0-255,1484,1703,65,294383
21614,3.3e-05,172.31.40.0-255,66,1769,65,294383
21615,3.6e-05,74.125.130.0-255,1484,3253,65,294383
21616,3.8e-05,172.31.40.0-255,66,3319,65,294383
21617,6.7e-05,74.125.130.0-255,1484,4803,65,294383
21618,7e-05,172.31.40.0-255,66,4869,65,294383
21619,7.5e-05,74.125.130.0-255,2902,7771,65,294383
21620,7.7e-05,172.31.40.0-255,66,7837,65,294383
21621,8.2e-05,74.125.130.0-255,4320,12157,65,294383
21622,8.4e-05,172.31.40.0-255,66,12223,65,294383
21623,0.000121,172.31.40.0-255,66,12289,65,294383
21624,0.000156,172.31.40.0-255,66,12355,65,294383
21625,0.000329,74.125.130.0-255,1484,13839,65,294383
21626,0.000332,172.31.40.0-255,66,13905,65,294383
21627,0.000338,74.125.130.0-255,2902,16807,65,294383
21628,0.00034,172.31.40.0-255,66,16873,65,294383
21629,0.000356,74.125.130.0-255,2902,19775,65,294383
21630,0.000358,172.31.40.0-255,66,19841,65,294383
21631,0.000361,74.125.130.0-255,1484,21325,65,294383
21632,0.000363,172.31.40.0-255,66,21391,65,294383
21633,0.000384,74.125.130.0-255,2902,24293,65,294383
21634,0.000386,172.31.40.0-255,66,24359,65,294383
21635,0.000405,74.125.130.0-255,5738,30097,65,294383
21636,0.000408,172.31.40.0-255,66,30163,65,294383
21637,0.000428,74.125.130.0-255,3961,34124,65,294383
21638,0.00043,172.31.40.0-255,66,34190,65,294383
21639,0.000437,74.125.130.0-255,7156,41346,65,294383
21640,0.00044,172.31.40.0-255,66,41412,65,294383
21641,0.000459,74.125.130.0-255,2902,44314,65,294383
21642,0.000462,172.31.40.0-255,66,44380,65,294383
21643,0.000466,74.125.130.0-255,2833,47213,65,294383
21644,0.000468,172.31.40.0-255,66,47279,65,294383
21645,0.000488,74.125.130.0-255,98,47377,65,294383
21646,0.000615,74.125.130.0-255,1484,48861,65,294383
21647,0.000619,172.31.40.0-255,66,48927,65,294383
21648,0.000625,74.125.130.0-255,2902,51829,65,294383
21649,0.000627,172.31.40.0-255,66,51895,65,294383
21650,0.000646,74.125.130.0-255,5738,57633,65,294383
21651,0.000648,172.31.40.0-255,66,57699,65,294383
21652,0.000675,74.125.130.0-255,5738,63437,65,294383
21653,0.000677,172.31.40.0-255,66,63503,65,294383
21654,0.000684,74.125.130.0-255,7156,70659,65,294383
21655,0.000686,172.31.40.0-255,66,70725,65,294383
21656,0.000718,74.125.130.0-255,5738,76463,65,294383
21657,0.00072,172.31.40.0-255,66,76529,65,294383
21658,0.000739,74.125.130.0-255,5020,81549,65,294383
21659,0.000743,172.31.40.0-255,66,81615,65,294383
21660,0.00092,74.125.130.0-255,1484,83099,65,294383
21661,0.000933,74.125.130.0-255,1484,84583,65,294383
21662,0.000936,172.31.40.0-255,66,84649,65,294383
21663,0.000955,74.125.130.0-255,1484,86133,65,294383
21664,0.000961,74.125.130.0-255,5738,91871,65,294383
21665,0.000963,172.31.40.0-255,66,91937,65,294383
21666,0.000967,74.125.130.0-255,2902,94839,65,294383
21667,0.000969,172.31.40.0-255,66,94905,65,294383
21668,0.000988,74.125.130.0-255,1484,96389,65,294383
21669,0.001018,172.31.40.0-255,66,96455,65,294383
21670,0.001022,74.125.130.0-255,2902,99357,65,294383
21671,0.001024,172.31.40.0-255,66,99423,65,294383
21672,0.001042,74.125.130.0-255,5738,105161,65,294383
21673,0.001044,172.31.40.0-255,66,105227,65,294383
21674,0.001067,74.125.130.0-255,2184,107411,65,294383
21675,0.001069,172.31.40.0-255,66,107477,65,294383
21676,0.001108,74.125.130.0-255,2902,110379,65,294383
21677,0.001111,172.31.40.0-255,66,110445,65,294383
21678,0.001128,74.125.130.0-255,2902,113347,65,294383
21679,0.001131,172.31.40.0-255,66,113413,65,294383
21680,0.001144,74.125.130.0-255,1484,114897,65,294383
21681,0.001147,74.125.130.0-255,1484,116381,65,294383
21682,0.001149,172.31.40.0-255,66,116447,65,294383
21683,0.001177,74.125.130.0-255,7156,123603,65,294383
21684,0.00118,172.31.40.0-255,66,123669,65,294383
21685,0.001185,74.125.130.0-255,4320,127989,65,294383
21686,0.001187,172.31.40.0-255,66,128055,65,294383
21687,0.001192,74.125.130.0-255,5738,133793,65,294383
21688,0.001194,172.31.40.0-255,66,133859,65,294383
21689,0.001248,172.31.40.0-255,66,133925,65,294383
21690,0.00146,74.125.130.0-255,1484,135409,65,294383
21691,0.001466,74.125.130.0-255,2902,138311,65,294383
21692,0.001469,172.31.40.0-255,66,138377,65,294383
21693,0.001492,74.125.130.0-255,4320,142697,65,294383
21694,0.001494,172.31.40.0-255,66,142763,65,294383
21695,0.00151,74.125.130.0-255,2902,145665,65,294383
21696,0.001512,172.31.40.0-255,66,145731,65,294383
21697,0.001541,74.125.130.0-255,5738,151469,65,294383
21698,0.001544,172.31.40.0-255,66,151535,65,294383
21699,0.001549,74.125.130.0-255,4320,155855,65,294383
21700,0.001551,172.31.40.0-255,66,155921,65,294383
21701,0.001557,74.125.130.0-255,5738,161659,65,294383
21702,0.001559,172.31.40.0-255,66,161725,65,294383
21703,0.001573,74.125.130.0-255,2902,164627,65,294383
21704,0.001576,172.31.40.0-255,66,164693,65,294383
21705,0.001589,74.125.130.0-255,3602,168295,65,294383
21706,0.001592,172.31.40.0-255,66,168361,65,294383
21707,0.001598,74.125.130.0-255,5738,174099,65,294383
21708,0.0016,172.31.40.0-255,66,174165,65,294383
21709,0.001621,74.125.130.0-255,1484,175649,65,294383
21710,0.001627,74.125.130.0-255,4320,179969,65,294383
21711,0.001629,172.31.40.0-255,66,180035,65,294383
21712,0.001657,74.125.130.0-255,5738,185773,65,294383
21713,0.00166,172.31.40.0-255,66,185839,65,294383
21714,0.001663,74.125.130.0-255,1484,187323,65,294383
21715,0.0017,172.31.40.0-255,66,187389,65,294383
21716,0.001705,74.125.130.0-255,4320,191709,65,294383
21717,0.001708,172.31.40.0-255,66,191775,65,294383
21718,0.001739,74.125.130.0-255,766,192541,65,294383
21719,0.001789,74.125.130.0-255,1484,194025,65,294383
21720,0.001793,172.31.40.0-255,66,194091,65,294383
21721,0.001798,74.125.130.0-255,2902,196993,65,294383
21722,0.0018,172.31.40.0-255,66,197059,65,294383
21723,0.001804,74.125.130.0-255,2902,199961,65,294383
21724,0.001806,172.31.40.0-255,66,200027,65,294383
21725,0.001834,74.125.130.0-255,2902,202929,65,294383
21726,0.001837,172.31.40.0-255,66,202995,65,294383
21727,0.001849,74.125.130.0-255,7156,210151,65,294383
21728,0.001851,172.31.40.0-255,66,210217,65,294383
21729,0.001863,172.31.40.0-255,66,210283,65,294383
21730,0.001883,74.125.130.0-255,1484,211767,65,294383
21731,0.001904,74.125.130.0-255,4320,216087,65,294383
21732,0.001906,172.31.40.0-255,66,216153,65,294383
21733,0.001924,74.125.130.0-255,2184,218337,65,294383
21734,0.001926,172.31.40.0-255,66,218403,65,294383
21735,0.001968,74.125.130.0-255,1484,219887,65,294383
21736,0.001974,74.125.130.0-255,2902,222789,65,294383
21737,0.001976,172.31.40.0-255,66,222855,65,294383
21738,0.001982,74.125.130.0-255,4320,227175,65,294383
21739,0.001984,172.31.40.0-255,66,227241,65,294383
21740,0.002002,74.125.130.0-255,5738,232979,65,294383
21741,0.002005,172.31.40.0-255,66,233045,65,294383
21742,0.002026,74.125.130.0-255,4320,237365,65,294383
21743,0.002029,172.31.40.0-255,66,237431,65,294383
21744,0.002051,74.125.130.0-255,7156,244587,65,294383
21745,0.002054,172.31.40.0-255,66,244653,65,294383
21746,0.00206,74.125.130.0-255,2902,247555,65,294383
21747,0.002062,172.31.40.0-255,66,247621,65,294383
21748,0.002065,74.125.130.0-255,1484,249105,65,294383
21749,0.004073,74.125.130.0-255,1484,250589,65,294383
21750,0.00408,172.31.40.0-255,66,250655,65,294383
21751,0.0041,74.125.130.0-255,2902,253557,65,294383
21752,0.004102,172.31.40.0-255,66,253623,65,294383
21753,0.006097,74.125.130.0-255,2902,256525,65,294383
21754,0.0061,172.31.40.0-255,66,256591,65,294383
21755,0.006116,74.125.130.0-255,2902,259493,65,294383
21756,0.006118,172.31.40.0-255,66,259559,65,294383
21757,0.008135,74.125.130.0-255,5738,265297,65,294383
21758,0.008141,172.31.40.0-255,66,265363,65,294383
21759,0.010171,74.125.130.0-255,5738,271101,65,294383
21760,0.010177,172.31.40.0-255,66,271167,65,294383
21761,0.01221,74.125.130.0-255,5738,276905,65,294383
21762,0.012218,172.31.40.0-255,66,276971,65,294383
21763,0.01424,74.125.130.0-255,5738,282709,65,294383
21764,0.014248,172.31.40.0-255,66,282775,65,294383
21765,0.01628,74.125.130.0-255,5738,288513,65,294383
21766,0.016289,172.31.40.0-255,66,288579,65,294383
21767,0.018352,74.125.130.0-255,5738,294317,65,294383
21768,0.01836,172.31.40.0-255,66,294383,65,294383
21769,0.0,172.217.194.0-255,152,152,65,185858
21770,2.1e-05,172.31.40.0-255,66,218,65,185858
21771,2.8e-05,172.217.194.0-255,1484,1702,65,185858
21772,3.3e-05,172.31.40.0-255,66,1768,65,185858
21773,4.5e-05,172.217.194.0-255,2902,4670,65,185858
21774,4.7e-05,172.31.40.0-255,66,4736,65,185858
21775,5.5e-05,172.217.194.0-255,7156,11892,65,185858
21776,5.7e-05,172.31.40.0-255,66,11958,65,185858
21777,6.2e-05,172.217.194.0-255,2067,14025,65,185858
21778,6.5e-05,172.31.40.0-255,66,14091,65,185858
21779,0.000122,172.217.194.0-255,1484,15575,65,185858
21780,0.000125,172.31.40.0-255,66,15641,65,185858
21781,0.000131,172.217.194.0-255,2902,18543,65,185858
21782,0.000133,172.31.40.0-255,66,18609,65,185858
21783,0.000139,172.217.194.0-255,5738,24347,65,185858
21784,0.000149,172.31.40.0-255,66,24413,65,185858
21785,0.000174,172.217.194.0-255,6797,31210,65,185858
21786,0.000177,172.31.40.0-255,66,31276,65,185858
21787,0.000312,172.217.194.0-255,1484,32760,65,185858
21788,0.000317,172.217.194.0-255,2902,35662,65,185858
21789,0.000322,172.31.40.0-255,66,35728,65,185858
21790,0.00033,172.31.40.0-255,66,35794,65,185858
21791,0.000336,172.217.194.0-255,5738,41532,65,185858
21792,0.000339,172.31.40.0-255,66,41598,65,185858
21793,0.000375,172.217.194.0-255,6797,48395,65,185858
21794,0.000378,172.31.40.0-255,66,48461,65,185858
21795,0.000468,172.217.194.0-255,1484,49945,65,185858
21796,0.000471,172.31.40.0-255,66,50011,65,185858
21797,0.000478,172.217.194.0-255,2902,52913,65,185858
21798,0.00048,172.31.40.0-255,66,52979,65,185858
21799,0.000486,172.217.194.0-255,4320,57299,65,185858
21800,0.000493,172.31.40.0-255,66,57365,65,185858
21801,0.00052,172.217.194.0-255,1484,58849,65,185858
21802,0.000542,172.217.194.0-255,5738,64587,65,185858
21803,0.000559,172.217.194.0-255,1421,66008,65,185858
21804,0.000562,172.217.194.0-255,381,66389,65,185858
21805,0.000654,172.31.40.0-255,66,66455,65,185858
21806,0.000747,172.217.194.0-255,1484,67939,65,185858
21807,0.000771,172.217.194.0-255,2902,70841,65,185858
21808,0.000776,172.217.194.0-255,2902,73743,65,185858
21809,0.000779,172.217.194.0-255,1484,75227,65,185858
21810,0.000799,172.217.194.0-255,5738,80965,65,185858
21811,0.000802,172.31.40.0-255,66,81031,65,185858
21812,0.000816,172.31.40.0-255,66,81097,65,185858
21813,0.000821,172.217.194.0-255,2543,83640,65,185858
21814,0.000854,172.31.40.0-255,66,83706,65,185858
21815,0.000896,172.217.194.0-255,1484,85190,65,185858
21816,0.000901,172.217.194.0-255,2902,88092,65,185858
21817,0.000918,172.217.194.0-255,4320,92412,65,185858
21818,0.000927,172.31.40.0-255,66,92478,65,185858
21819,0.000939,172.217.194.0-255,1484,93962,65,185858
21820,0.000951,172.217.194.0-255,6797,100759,65,185858
21821,0.000968,172.31.40.0-255,66,100825,65,185858
21822,0.001127,172.217.194.0-255,1484,102309,65,185858
21823,0.001132,172.217.194.0-255,2902,105211,65,185858
21824,0.001145,172.31.40.0-255,66,105277,65,185858
21825,0.001151,172.217.194.0-255,5738,111015,65,185858
21826,0.001156,172.31.40.0-255,66,111081,65,185858
21827,0.001198,172.217.194.0-255,5738,116819,65,185858
21828,0.001203,172.31.40.0-255,66,116885,65,185858
21829,0.001241,172.217.194.0-255,4320,121205,65,185858
21830,0.001261,172.217.194.0-255,2184,123389,65,185858
21831,0.001268,172.217.194.0-255,7156,130545,65,185858
21832,0.001271,172.217.194.0-255,1484,132029,65,185858
21833,0.001276,172.31.40.0-255,66,132095,65,185858
21834,0.001382,172.31.40.0-255,66,132161,65,185858
21835,0.001532,172.217.194.0-255,1484,133645,65,185858
21836,0.001538,172.217.194.0-255,2902,136547,65,185858
21837,0.001558,172.217.194.0-255,5738,142285,65,185858
21838,0.001562,172.31.40.0-255,66,142351,65,185858
21839,0.001575,172.217.194.0-255,2902,145253,65,185858
21840,0.001621,172.31.40.0-255,66,145319,65,185858
21841,0.001633,172.217.194.0-255,766,146085,65,185858
21842,0.00193,172.31.40.0-255,101,146186,65,185858
21843,0.002089,172.217.194.0-255,1484,147670,65,185858
21844,0.002096,172.217.194.0-255,2902,150572,65,185858
21845,0.002099,172.31.40.0-255,66,150638,65,185858
21846,0.002104,172.217.194.0-255,2902,153540,65,185858
21847,0.002114,172.31.40.0-255,66,153606,65,185858
21848,0.002136,172.217.194.0-255,2902,156508,65,185858
21849,0.002156,172.31.40.0-255,66,156574,65,185858
21850,0.002184,172.217.194.0-255,2902,159476,65,185858
21851,0.0022,172.31.40.0-255,66,159542,65,185858
21852,0.003978,172.217.194.0-255,66,159608,65,185858
21853,0.004271,172.217.194.0-255,2902,162510,65,185858
21854,0.004275,172.31.40.0-255,66,162576,65,185858
21855,0.004304,172.217.194.0-255,2902,165478,65,185858
21856,0.006369,172.217.194.0-255,2902,168380,65,185858
21857,0.006785,172.31.40.0-255,66,168446,65,185858
21858,0.0089,172.217.194.0-255,5738,174184,65,185858
21859,0.008907,172.31.40.0-255,66,174250,65,185858
21860,0.011064,172.217.194.0-255,5738,179988,65,185858
21861,0.011071,172.31.40.0-255,66,180054,65,185858
21862,0.013267,172.217.194.0-255,5738,185792,65,185858
21863,0.019202,172.31.40.0-255,66,185858,65,185858
21864,0.0,74.125.24.0-255,298,298,65,188417
21865,1.5e-05,172.31.40.0-255,66,364,65,188417
21866,2.2e-05,74.125.24.0-255,1484,1848,65,188417
21867,2.6e-05,172.31.40.0-255,66,1914,65,188417
21868,3.3e-05,74.125.24.0-255,4320,6234,65,188417
21869,4.2e-05,172.31.40.0-255,66,6300,65,188417
21870,4.7e-05,74.125.24.0-255,4320,10620,65,188417
21871,5e-05,172.31.40.0-255,66,10686,65,188417
21872,8.2e-05,74.125.24.0-255,3204,13890,65,188417
21873,8.5e-05,172.31.40.0-255,66,13956,65,188417
21874,0.000127,74.125.24.0-255,1484,15440,65,188417
21875,0.00013,172.31.40.0-255,66,15506,65,188417
21876,0.000135,74.125.24.0-255,2902,18408,65,188417
21877,0.000138,172.31.40.0-255,66,18474,65,188417
21878,0.000141,74.125.24.0-255,1484,19958,65,188417
21879,0.000147,172.31.40.0-255,66,20024,65,188417
21880,0.000186,74.125.24.0-255,4320,24344,65,188417
21881,0.000189,172.31.40.0-255,66,24410,65,188417
21882,0.000197,74.125.24.0-255,6797,31207,65,188417
21883,0.000199,172.31.40.0-255,66,31273,65,188417
21884,0.000228,74.125.24.0-255,5738,37011,65,188417
21885,0.00023,172.31.40.0-255,66,37077,65,188417
21886,0.000263,74.125.24.0-255,7156,44233,65,188417
21887,0.000265,172.31.40.0-255,66,44299,65,188417
21888,0.000268,74.125.24.0-255,1484,45783,65,188417
21889,0.00027,172.31.40.0-255,66,45849,65,188417
21890,0.000293,74.125.24.0-255,2543,48392,65,188417
21891,0.000295,172.31.40.0-255,66,48458,65,188417
21892,0.000343,74.125.24.0-255,1484,49942,65,188417
21893,0.000346,172.31.40.0-255,66,50008,65,188417
21894,0.000349,74.125.24.0-255,1484,51492,65,188417
21895,0.000352,172.31.40.0-255,66,51558,65,188417
21896,0.000371,74.125.24.0-255,1484,53042,65,188417
21897,0.000384,74.125.24.0-255,5738,58780,65,188417
21898,0.000387,172.31.40.0-255,66,58846,65,188417
21899,0.000394,74.125.24.0-255,6797,65643,65,188417
21900,0.000397,172.31.40.0-255,66,65709,65,188417
21901,0.000399,74.125.24.0-255,410,66119,65,188417
21902,0.000449,74.125.24.0-255,332,66451,65,188417
21903,0.000849,74.125.24.0-255,1484,67935,65,188417
21904,0.000854,172.31.40.0-255,66,68001,65,188417
21905,0.00086,74.125.24.0-255,2902,70903,65,188417
21906,0.000863,172.31.40.0-255,66,70969,65,188417
21907,0.000867,74.125.24.0-255,2902,73871,65,188417
21908,0.000874,172.31.40.0-255,66,73937,65,188417
21909,0.000909,74.125.24.0-255,2902,76839,65,188417
21910,0.000912,172.31.40.0-255,66,76905,65,188417
21911,0.000923,172.31.40.0-255,66,76971,65,188417
21912,0.000948,74.125.24.0-255,7156,84127,65,188417
21913,0.000952,172.31.40.0-255,66,84193,65,188417
21914,0.000986,172.31.40.0-255,66,84259,65,188417
21915,0.001333,74.125.24.0-255,1484,85743,65,188417
21916,0.001341,74.125.24.0-255,2902,88645,65,188417
21917,0.001345,172.31.40.0-255,66,88711,65,188417
21918,0.001351,74.125.24.0-255,2902,91613,65,188417
21919,0.001353,172.31.40.0-255,66,91679,65,188417
21920,0.001379,74.125.24.0-255,2902,94581,65,188417
21921,0.001382,172.31.40.0-255,66,94647,65,188417
21922,0.0014,172.31.40.0-255,66,94713,65,188417
21923,0.001413,172.31.40.0-255,66,94779,65,188417
21924,0.001518,74.125.24.0-255,1484,96263,65,188417
21925,0.001535,74.125.24.0-255,2902,99165,65,188417
21926,0.001539,172.31.40.0-255,66,99231,65,188417
21927,0.001545,74.125.24.0-255,5738,104969,65,188417
21928,0.001548,172.31.40.0-255,66,105035,65,188417
21929,0.001557,74.125.24.0-255,4320,109355,65,188417
21930,0.00156,172.31.40.0-255,66,109421,65,188417
21931,0.001566,74.125.24.0-255,4320,113741,65,188417
21932,0.001568,172.31.40.0-255,66,113807,65,188417
21933,0.001599,74.125.24.0-255,7156,120963,65,188417
21934,0.001603,172.31.40.0-255,66,121029,65,188417
21935,0.001618,172.31.40.0-255,66,121095,65,188417
21936,0.001802,74.125.24.0-255,1484,122579,65,188417
21937,0.001818,74.125.24.0-255,2902,125481,65,188417
21938,0.001822,172.31.40.0-255,66,125547,65,188417
21939,0.001829,74.125.24.0-255,4320,129867,65,188417
21940,0.001832,172.31.40.0-255,66,129933,65,188417
21941,0.001863,74.125.24.0-255,1484,131417,65,188417
21942,0.001879,172.31.40.0-255,66,131483,65,188417
21943,0.00192,74.125.24.0-255,4320,135803,65,188417
21944,0.001924,172.31.40.0-255,66,135869,65,188417
21945,0.001957,74.125.24.0-255,6438,142307,65,188417
21946,0.00196,172.31.40.0-255,66,142373,65,188417
21947,0.001967,74.125.24.0-255,5738,148111,65,188417
21948,0.001969,172.31.40.0-255,66,148177,65,188417
21949,0.001986,74.125.24.0-255,1484,149661,65,188417
21950,0.002002,172.31.40.0-255,66,149727,65,188417
21951,0.002019,172.31.40.0-255,66,149793,65,188417
21952,0.002022,74.125.24.0-255,766,150559,65,188417
21953,0.004307,74.125.24.0-255,4320,154879,65,188417
21954,0.004315,172.31.40.0-255,66,154945,65,188417
21955,0.006583,74.125.24.0-255,5738,160683,65,188417
21956,0.006591,172.31.40.0-255,66,160749,65,188417
21957,0.008852,74.125.24.0-255,4320,165069,65,188417
21958,0.008857,172.31.40.0-255,66,165135,65,188417
21959,0.008883,74.125.24.0-255,1484,166619,65,188417
21960,0.011122,74.125.24.0-255,4320,170939,65,188417
21961,0.011129,172.31.40.0-255,66,171005,65,188417
21962,0.013426,74.125.24.0-255,5738,176743,65,188417
21963,0.013434,172.31.40.0-255,66,176809,65,188417
21964,0.01575,74.125.24.0-255,5738,182547,65,188417
21965,0.015759,172.31.40.0-255,66,182613,65,188417
21966,0.018036,74.125.24.0-255,5738,188351,65,188417
21967,0.01805,172.31.40.0-255,66,188417,65,188417
21968,0.0,74.125.68.0-255,153,153,65,256674
21969,2.2e-05,172.31.40.0-255,66,219,65,256674
21970,2.9e-05,74.125.68.0-255,1484,1703,65,256674
21971,3.3e-05,172.31.40.0-255,66,1769,65,256674
21972,3.9e-05,74.125.68.0-255,2902,4671,65,256674
21973,4.2e-05,172.31.40.0-255,66,4737,65,256674
21974,4.7e-05,74.125.68.0-255,4320,9057,65,256674
21975,5e-05,172.31.40.0-255,66,9123,65,256674
21976,8.9e-05,172.31.40.0-255,66,9189,65,256674
21977,9.4e-05,74.125.68.0-255,4320,13509,65,256674
21978,9.7e-05,172.31.40.0-255,66,13575,65,256674
21979,0.000137,172.31.40.0-255,66,13641,65,256674
21980,0.000197,74.125.68.0-255,1484,15125,65,256674
21981,0.0002,172.31.40.0-255,66,15191,65,256674
21982,0.000226,74.125.68.0-255,1484,16675,65,256674
21983,0.000228,172.31.40.0-255,66,16741,65,256674
21984,0.000232,74.125.68.0-255,1484,18225,65,256674
21985,0.000234,172.31.40.0-255,66,18291,65,256674
21986,0.000248,74.125.68.0-255,1484,19775,65,256674
21987,0.00025,172.31.40.0-255,66,19841,65,256674
21988,0.000253,74.125.68.0-255,1484,21325,65,256674
21989,0.000256,172.31.40.0-255,66,21391,65,256674
21990,0.000278,74.125.68.0-255,4320,25711,65,256674
21991,0.000281,172.31.40.0-255,66,25777,65,256674
21992,0.000287,74.125.68.0-255,4320,30097,65,256674
21993,0.000289,172.31.40.0-255,66,30163,65,256674
21994,0.000292,74.125.68.0-255,1484,31647,65,256674
21995,0.000294,172.31.40.0-255,66,31713,65,256674
21996,0.000317,74.125.68.0-255,3961,35674,65,256674
21997,0.00032,172.31.40.0-255,66,35740,65,256674
21998,0.000323,74.125.68.0-255,1484,37224,65,256674
21999,0.00035,172.31.40.0-255,66,37290,65,256674
22000,0.000381,74.125.68.0-255,2882,40172,65,256674
22001,0.000384,172.31.40.0-255,66,40238,65,256674
22002,0.000403,74.125.68.0-255,348,40586,65,256674
22003,0.000499,74.125.68.0-255,1484,42070,65,256674
22004,0.000503,172.31.40.0-255,66,42136,65,256674
22005,0.000508,74.125.68.0-255,2902,45038,65,256674
22006,0.000511,172.31.40.0-255,66,45104,65,256674
22007,0.000543,74.125.68.0-255,5738,50842,65,256674
22008,0.000545,172.31.40.0-255,66,50908,65,256674
22009,0.00055,74.125.68.0-255,2902,53810,65,256674
22010,0.000552,172.31.40.0-255,66,53876,65,256674
22011,0.000564,172.31.40.0-255,66,53942,65,256674
22012,0.000576,74.125.68.0-255,1484,55426,65,256674
22013,0.000579,74.125.68.0-255,1484,56910,65,256674
22014,0.000582,172.31.40.0-255,66,56976,65,256674
22015,0.000623,172.31.40.0-255,66,57042,65,256674
22016,0.00066,74.125.68.0-255,1484,58526,65,256674
22017,0.000664,74.125.68.0-255,1484,60010,65,256674
22018,0.000668,172.31.40.0-255,66,60076,65,256674
22019,0.000676,74.125.68.0-255,1484,61560,65,256674
22020,0.000682,74.125.68.0-255,2902,64462,65,256674
22021,0.000684,74.125.68.0-255,1484,65946,65,256674
22022,0.000705,74.125.68.0-255,2902,68848,65,256674
22023,0.000713,172.31.40.0-255,66,68914,65,256674
22024,0.000739,74.125.68.0-255,5738,74652,65,256674
22025,0.000742,74.125.68.0-255,1484,76136,65,256674
22026,0.000756,74.125.68.0-255,5738,81874,65,256674
22027,0.000776,172.31.40.0-255,66,81940,65,256674
22028,0.000788,74.125.68.0-255,766,82706,65,256674
22029,0.000859,74.125.68.0-255,1484,84190,65,256674
22030,0.000878,74.125.68.0-255,2902,87092,65,256674
22031,0.000881,74.125.68.0-255,1484,88576,65,256674
22032,0.000885,74.125.68.0-255,2902,91478,65,256674
22033,0.000899,172.31.40.0-255,66,91544,65,256674
22034,0.000913,74.125.68.0-255,5738,97282,65,256674
22035,0.000957,172.31.40.0-255,66,97348,65,256674
22036,0.001011,74.125.68.0-255,766,98114,65,256674
22037,0.001016,172.31.40.0-255,66,98180,65,256674
22038,0.001033,74.125.68.0-255,1484,99664,65,256674
22039,0.001038,74.125.68.0-255,2902,102566,65,256674
22040,0.001061,74.125.68.0-255,5738,108304,65,256674
22041,0.001067,172.31.40.0-255,66,108370,65,256674
22042,0.001104,74.125.68.0-255,4320,112690,65,256674
22043,0.001119,74.125.68.0-255,2902,115592,65,256674
22044,0.001122,74.125.68.0-255,1484,117076,65,256674
22045,0.001129,172.31.40.0-255,66,117142,65,256674
22046,0.001152,74.125.68.0-255,7156,124298,65,256674
22047,0.001156,74.125.68.0-255,2902,127200,65,256674
22048,0.001174,172.31.40.0-255,66,127266,65,256674
22049,0.001204,172.31.40.0-255,66,127332,65,256674
22050,0.001221,74.125.68.0-255,5020,132352,65,256674
22051,0.001236,172.31.40.0-255,66,132418,65,256674
22052,0.001277,172.31.40.0-255,66,132484,65,256674
22053,0.001311,172.31.40.0-255,66,132550,65,256674
22054,0.001316,74.125.68.0-255,3602,136152,65,256674
22055,0.001321,172.31.40.0-255,66,136218,65,256674
22056,0.001427,74.125.68.0-255,1484,137702,65,256674
22057,0.001432,74.125.68.0-255,1484,139186,65,256674
22058,0.001443,172.31.40.0-255,66,139252,65,256674
22059,0.001453,74.125.68.0-255,2902,142154,65,256674
22060,0.001467,74.125.68.0-255,5738,147892,65,256674
22061,0.001491,172.31.40.0-255,66,147958,65,256674
22062,0.001544,74.125.68.0-255,1484,149442,65,256674
22063,0.001563,74.125.68.0-255,766,150208,65,256674
22064,0.001566,172.31.40.0-255,66,150274,65,256674
22065,0.001589,172.31.40.0-255,66,150340,65,256674
22066,0.001726,74.125.68.0-255,1484,151824,65,256674
22067,0.00174,74.125.68.0-255,2902,154726,65,256674
22068,0.001742,74.125.68.0-255,1484,156210,65,256674
22069,0.001765,172.31.40.0-255,66,156276,65,256674
22070,0.001771,74.125.68.0-255,2902,159178,65,256674
22071,0.001776,172.31.40.0-255,66,159244,65,256674
22072,0.001794,74.125.68.0-255,2902,162146,65,256674
22073,0.001805,172.31.40.0-255,66,162212,65,256674
22074,0.001814,74.125.68.0-255,1484,163696,65,256674
22075,0.00182,74.125.68.0-255,5738,169434,65,256674
22076,0.001841,74.125.68.0-255,2902,172336,65,256674
22077,0.001851,172.31.40.0-255,66,172402,65,256674
22078,0.00187,74.125.68.0-255,3602,176004,65,256674
22079,0.001876,172.31.40.0-255,66,176070,65,256674
22080,0.001907,74.125.68.0-255,1484,177554,65,256674
22081,0.001933,74.125.68.0-255,2902,180456,65,256674
22082,0.001945,172.31.40.0-255,66,180522,65,256674
22083,0.001958,74.125.68.0-255,5738,186260,65,256674
22084,0.001975,172.31.40.0-255,66,186326,65,256674
22085,0.001993,74.125.68.0-255,7156,193482,65,256674
22086,0.001999,172.31.40.0-255,66,193548,65,256674
22087,0.002015,74.125.68.0-255,7156,200704,65,256674
22088,0.00203,74.125.68.0-255,2902,203606,65,256674
22089,0.002032,172.31.40.0-255,66,203672,65,256674
22090,0.002036,172.31.40.0-255,66,203738,65,256674
22091,0.002055,74.125.68.0-255,6438,210176,65,256674
22092,0.002074,172.31.40.0-255,66,210242,65,256674
22093,0.004095,74.125.68.0-255,5738,215980,65,256674
22094,0.004101,172.31.40.0-255,66,216046,65,256674
22095,0.006143,74.125.68.0-255,5738,221784,65,256674
22096,0.00616,172.31.40.0-255,66,221850,65,256674
22097,0.008198,74.125.68.0-255,5738,227588,65,256674
22098,0.008212,172.31.40.0-255,66,227654,65,256674
22099,0.01024,74.125.68.0-255,5738,233392,65,256674
22100,0.010253,172.31.40.0-255,66,233458,65,256674
22101,0.01228,74.125.68.0-255,5738,239196,65,256674
22102,0.012293,172.31.40.0-255,66,239262,65,256674
22103,0.014327,74.125.68.0-255,5738,245000,65,256674
22104,0.014334,172.31.40.0-255,66,245066,65,256674
22105,0.016358,74.125.68.0-255,5738,250804,65,256674
22106,0.016365,172.31.40.0-255,66,250870,65,256674
22107,0.018396,74.125.68.0-255,5738,256608,65,256674
22108,0.018403,172.31.40.0-255,66,256674,65,256674
22109,0.0,74.125.24.0-255,146,146,65,270058
22110,1.7e-05,172.31.40.0-255,66,212,65,270058
22111,2.4e-05,74.125.24.0-255,1484,1696,65,270058
22112,2.8e-05,172.31.40.0-255,66,1762,65,270058
22113,3.4e-05,74.125.24.0-255,2902,4664,65,270058
22114,3.8e-05,172.31.40.0-255,66,4730,65,270058
22115,4.5e-05,74.125.24.0-255,7156,11886,65,270058
22116,4.9e-05,172.31.40.0-255,66,11952,65,270058
22117,5.3e-05,74.125.24.0-255,2039,13991,65,270058
22118,5.5e-05,172.31.40.0-255,66,14057,65,270058
22119,7.9e-05,74.125.24.0-255,4320,18377,65,270058
22120,8.3e-05,172.31.40.0-255,66,18443,65,270058
22121,8.8e-05,74.125.24.0-255,4320,22763,65,270058
22122,9.1e-05,172.31.40.0-255,66,22829,65,270058
22123,0.000105,74.125.24.0-255,1484,24313,65,270058
22124,0.000107,172.31.40.0-255,66,24379,65,270058
22125,0.000138,74.125.24.0-255,1484,25863,65,270058
22126,0.00014,172.31.40.0-255,66,25929,65,270058
22127,0.000161,74.125.24.0-255,5379,31308,65,270058
22128,0.000164,172.31.40.0-255,66,31374,65,270058
22129,0.000192,74.125.24.0-255,1484,32858,65,270058
22130,0.000195,172.31.40.0-255,66,32924,65,270058
22131,0.0002,74.125.24.0-255,2902,35826,65,270058
22132,0.000202,172.31.40.0-255,66,35892,65,270058
22133,0.00023,74.125.24.0-255,5738,41630,65,270058
22134,0.000233,172.31.40.0-255,66,41696,65,270058
22135,0.000237,74.125.24.0-255,2902,44598,65,270058
22136,0.000239,172.31.40.0-255,66,44664,65,270058
22137,0.000295,74.125.24.0-255,4320,48984,65,270058
22138,0.000298,172.31.40.0-255,66,49050,65,270058
22139,0.00032,74.125.24.0-255,6797,55847,65,270058
22140,0.000323,172.31.40.0-255,66,55913,65,270058
22141,0.000335,172.31.40.0-255,66,55979,65,270058
22142,0.000338,74.125.24.0-255,412,56391,65,270058
22143,0.000579,74.125.24.0-255,1484,57875,65,270058
22144,0.000584,172.31.40.0-255,66,57941,65,270058
22145,0.000591,74.125.24.0-255,2902,60843,65,270058
22146,0.000593,172.31.40.0-255,66,60909,65,270058
22147,0.000596,74.125.24.0-255,1484,62393,65,270058
22148,0.000618,74.125.24.0-255,4320,66713,65,270058
22149,0.000621,172.31.40.0-255,66,66779,65,270058
22150,0.000659,172.31.40.0-255,66,66845,65,270058
22151,0.000667,74.125.24.0-255,7156,74001,65,270058
22152,0.000669,172.31.40.0-255,66,74067,65,270058
22153,0.000692,74.125.24.0-255,3602,77669,65,270058
22154,0.000696,172.31.40.0-255,66,77735,65,270058
22155,0.00108,74.125.24.0-255,1484,79219,65,270058
22156,0.001087,74.125.24.0-255,2902,82121,65,270058
22157,0.00109,172.31.40.0-255,66,82187,65,270058
22158,0.001096,74.125.24.0-255,2902,85089,65,270058
22159,0.001098,172.31.40.0-255,66,85155,65,270058
22160,0.001113,74.125.24.0-255,2902,88057,65,270058
22161,0.001115,172.31.40.0-255,66,88123,65,270058
22162,0.001118,74.125.24.0-255,1484,89607,65,270058
22163,0.001122,74.125.24.0-255,2902,92509,65,270058
22164,0.001124,172.31.40.0-255,66,92575,65,270058
22165,0.001148,74.125.24.0-255,5738,98313,65,270058
22166,0.001151,172.31.40.0-255,66,98379,65,270058
22167,0.001158,74.125.24.0-255,5738,104117,65,270058
22168,0.00116,172.31.40.0-255,66,104183,65,270058
22169,0.001178,74.125.24.0-255,5738,109921,65,270058
22170,0.001182,172.31.40.0-255,66,109987,65,270058
22171,0.0012,74.125.24.0-255,2184,112171,65,270058
22172,0.001203,172.31.40.0-255,66,112237,65,270058
22173,0.00125,74.125.24.0-255,2902,115139,65,270058
22174,0.001253,172.31.40.0-255,66,115205,65,270058
22175,0.001276,74.125.24.0-255,4320,119525,65,270058
22176,0.001279,172.31.40.0-255,66,119591,65,270058
22177,0.001284,74.125.24.0-255,2902,122493,65,270058
22178,0.001285,172.31.40.0-255,66,122559,65,270058
22179,0.001302,74.125.24.0-255,5738,128297,65,270058
22180,0.001305,172.31.40.0-255,66,128363,65,270058
22181,0.00135,172.31.40.0-255,66,128429,65,270058
22182,0.001371,74.125.24.0-255,3602,132031,65,270058
22183,0.001374,172.31.40.0-255,66,132097,65,270058
22184,0.001427,74.125.24.0-255,1484,133581,65,270058
22185,0.001443,74.125.24.0-255,2902,136483,65,270058
22186,0.001447,172.31.40.0-255,66,136549,65,270058
22187,0.00145,74.125.24.0-255,1484,138033,65,270058
22188,0.00147,74.125.24.0-255,4320,142353,65,270058
22189,0.001475,74.125.24.0-255,4320,146673,65,270058
22190,0.001479,172.31.40.0-255,66,146739,65,270058
22191,0.001482,172.31.40.0-255,66,146805,65,270058
22192,0.001494,74.125.24.0-255,5738,152543,65,270058
22193,0.001496,172.31.40.0-255,66,152609,65,270058
22194,0.001528,74.125.24.0-255,5738,158347,65,270058
22195,0.001531,172.31.40.0-255,66,158413,65,270058
22196,0.001543,172.31.40.0-255,66,158479,65,270058
22197,0.001665,74.125.24.0-255,1484,159963,65,270058
22198,0.001686,74.125.24.0-255,2902,162865,65,270058
22199,0.00169,172.31.40.0-255,66,162931,65,270058
22200,0.001696,74.125.24.0-255,4320,167251,65,270058
22201,0.001699,172.31.40.0-255,66,167317,65,270058
22202,0.001721,74.125.24.0-255,1484,168801,65,270058
22203,0.001728,74.125.24.0-255,7156,175957,65,270058
22204,0.001731,172.31.40.0-255,66,176023,65,270058
22205,0.001754,74.125.24.0-255,4320,180343,65,270058
22206,0.001756,172.31.40.0-255,66,180409,65,270058
22207,0.001789,172.31.40.0-255,66,180475,65,270058
22208,0.001793,74.125.24.0-255,2184,182659,65,270058
22209,0.001795,172.31.40.0-255,66,182725,65,270058
22210,0.001917,74.125.24.0-255,1484,184209,65,270058
22211,0.001922,74.125.24.0-255,2902,187111,65,270058
22212,0.001925,172.31.40.0-255,66,187177,65,270058
22213,0.001947,74.125.24.0-255,5738,192915,65,270058
22214,0.00195,172.31.40.0-255,66,192981,65,270058
22215,0.001983,172.31.40.0-255,66,193047,65,270058
22216,0.002002,74.125.24.0-255,2902,195949,65,270058
22217,0.002005,172.31.40.0-255,66,196015,65,270058
22218,0.002011,74.125.24.0-255,7156,203171,65,270058
22219,0.002013,172.31.40.0-255,66,203237,65,270058
22220,0.002053,172.31.40.0-255,66,203303,65,270058
22221,0.002078,74.125.24.0-255,6438,209741,65,270058
22222,0.00208,172.31.40.0-255,66,209807,65,270058
22223,0.002094,172.31.40.0-255,66,209873,65,270058
22224,0.002098,74.125.24.0-255,2902,212775,65,270058
22225,0.0021,172.31.40.0-255,66,212841,65,270058
22226,0.002121,172.31.40.0-255,66,212907,65,270058
22227,0.002142,74.125.24.0-255,7156,220063,65,270058
22228,0.002144,172.31.40.0-255,66,220129,65,270058
22229,0.002157,74.125.24.0-255,2902,223031,65,270058
22230,0.002159,172.31.40.0-255,66,223097,65,270058
22231,0.002165,74.125.24.0-255,5738,228835,65,270058
22232,0.002167,172.31.40.0-255,66,228901,65,270058
22233,0.002212,172.31.40.0-255,66,228967,65,270058
22234,0.002225,172.31.40.0-255,66,229033,65,270058
22235,0.002373,74.125.24.0-255,4320,233353,65,270058
22236,0.002377,172.31.40.0-255,66,233419,65,270058
22237,0.002397,74.125.24.0-255,5020,238439,65,270058
22238,0.002399,172.31.40.0-255,66,238505,65,270058
22239,0.00472,74.125.24.0-255,5738,244243,65,270058
22240,0.004727,172.31.40.0-255,66,244309,65,270058
22241,0.00704,74.125.24.0-255,5738,250047,65,270058
22242,0.007045,172.31.40.0-255,66,250113,65,270058
22243,0.009371,74.125.24.0-255,5738,255851,65,270058
22244,0.009377,172.31.40.0-255,66,255917,65,270058
22245,0.011713,74.125.24.0-255,5738,261655,65,270058
22246,0.011719,172.31.40.0-255,66,261721,65,270058
22247,0.01404,74.125.24.0-255,5738,267459,65,270058
22248,0.014047,172.31.40.0-255,66,267525,65,270058
22249,0.016353,74.125.24.0-255,2296,269821,65,270058
22250,0.016361,172.31.40.0-255,66,269887,65,270058
22251,0.016526,172.31.40.0-255,105,269992,65,270058
22252,0.018806,74.125.24.0-255,66,270058,65,270058
22253,0.0,74.125.68.0-255,152,152,65,175257
22254,2.3e-05,172.31.40.0-255,66,218,65,175257
22255,3e-05,74.125.68.0-255,1484,1702,65,175257
22256,3.5e-05,172.31.40.0-255,66,1768,65,175257
22257,5.5e-05,74.125.68.0-255,2902,4670,65,175257
22258,5.9e-05,172.31.40.0-255,66,4736,65,175257
22259,6.6e-05,74.125.68.0-255,4320,9056,65,175257
22260,7e-05,172.31.40.0-255,66,9122,65,175257
22261,9.1e-05,74.125.68.0-255,1484,10606,65,175257
22262,9.4e-05,172.31.40.0-255,66,10672,65,175257
22263,9.9e-05,74.125.68.0-255,3545,14217,65,175257
22264,0.000102,172.31.40.0-255,66,14283,65,175257
22265,0.000608,74.125.68.0-255,1484,15767,65,175257
22266,0.000614,172.31.40.0-255,66,15833,65,175257
22267,0.000623,74.125.68.0-255,2902,18735,65,175257
22268,0.000626,172.31.40.0-255,66,18801,65,175257
22269,0.00063,74.125.68.0-255,1484,20285,65,175257
22270,0.000632,172.31.40.0-255,66,20351,65,175257
22271,0.000665,74.125.68.0-255,4320,24671,65,175257
22272,0.000668,172.31.40.0-255,66,24737,65,175257
22273,0.000676,74.125.68.0-255,6797,31534,65,175257
22274,0.000678,172.31.40.0-255,66,31600,65,175257
22275,0.000681,74.125.68.0-255,1484,33084,65,175257
22276,0.000683,172.31.40.0-255,66,33150,65,175257
22277,0.00071,74.125.68.0-255,7156,40306,65,175257
22278,0.000714,172.31.40.0-255,66,40372,65,175257
22279,0.000726,172.31.40.0-255,66,40438,65,175257
22280,0.00073,74.125.68.0-255,1484,41922,65,175257
22281,0.000732,172.31.40.0-255,66,41988,65,175257
22282,0.000774,172.31.40.0-255,66,42054,65,175257
22283,0.000778,74.125.68.0-255,1484,43538,65,175257
22284,0.000796,74.125.68.0-255,2184,45722,65,175257
22285,0.000799,172.31.40.0-255,66,45788,65,175257
22286,0.000817,74.125.68.0-255,444,46232,65,175257
22287,0.000935,74.125.68.0-255,1484,47716,65,175257
22288,0.00094,172.31.40.0-255,66,47782,65,175257
22289,0.000946,74.125.68.0-255,2902,50684,65,175257
22290,0.000949,172.31.40.0-255,66,50750,65,175257
22291,0.000978,74.125.68.0-255,5738,56488,65,175257
22292,0.000981,172.31.40.0-255,66,56554,65,175257
22293,0.000984,74.125.68.0-255,1484,58038,65,175257
22294,0.001004,74.125.68.0-255,4320,62358,65,175257
22295,0.001006,172.31.40.0-255,66,62424,65,175257
22296,0.001009,74.125.68.0-255,1484,63908,65,175257
22297,0.001027,74.125.68.0-255,4320,68228,65,175257
22298,0.00103,172.31.40.0-255,66,68294,65,175257
22299,0.001046,74.125.68.0-255,1484,69778,65,175257
22300,0.001074,172.31.40.0-255,66,69844,65,175257
22301,0.00153,74.125.68.0-255,1484,71328,65,175257
22302,0.001544,74.125.68.0-255,1484,72812,65,175257
22303,0.001549,172.31.40.0-255,66,72878,65,175257
22304,0.001554,74.125.68.0-255,2902,75780,65,175257
22305,0.001557,172.31.40.0-255,66,75846,65,175257
22306,0.001602,74.125.68.0-255,5738,81584,65,175257
22307,0.001605,172.31.40.0-255,66,81650,65,175257
22308,0.00161,74.125.68.0-255,4320,85970,65,175257
22309,0.001612,172.31.40.0-255,66,86036,65,175257
22310,0.001618,74.125.68.0-255,5738,91774,65,175257
22311,0.001621,172.31.40.0-255,66,91840,65,175257
22312,0.00164,74.125.68.0-255,5738,97578,65,175257
22313,0.001643,172.31.40.0-255,66,97644,65,175257
22314,0.001669,74.125.68.0-255,5738,103382,65,175257
22315,0.001672,172.31.40.0-255,66,103448,65,175257
22316,0.001675,74.125.68.0-255,766,104214,65,175257
22317,0.001754,74.125.68.0-255,1484,105698,65,175257
22318,0.001756,172.31.40.0-255,66,105764,65,175257
22319,0.00176,74.125.68.0-255,1484,107248,65,175257
22320,0.001774,74.125.68.0-255,1484,108732,65,175257
22321,0.001776,172.31.40.0-255,66,108798,65,175257
22322,0.001804,74.125.68.0-255,5738,114536,65,175257
22323,0.001806,172.31.40.0-255,66,114602,65,175257
22324,0.001811,74.125.68.0-255,2902,117504,65,175257
22325,0.001813,172.31.40.0-255,66,117570,65,175257
22326,0.001819,74.125.68.0-255,4320,121890,65,175257
22327,0.001821,172.31.40.0-255,66,121956,65,175257
22328,0.001845,172.31.40.0-255,66,122022,65,175257
22329,0.001848,74.125.68.0-255,1484,123506,65,175257
22330,0.001869,74.125.68.0-255,5738,129244,65,175257
22331,0.001873,172.31.40.0-255,66,129310,65,175257
22332,0.00189,74.125.68.0-255,766,130076,65,175257
22333,0.004123,74.125.68.0-255,4320,134396,65,175257
22334,0.00413,172.31.40.0-255,66,134462,65,175257
22335,0.004817,172.31.40.0-255,101,134563,65,175257
22336,0.006391,74.125.68.0-255,5738,140301,65,175257
22337,0.006398,172.31.40.0-255,66,140367,65,175257
22338,0.007035,74.125.68.0-255,66,140433,65,175257
22339,0.008651,74.125.68.0-255,5738,146171,65,175257
22340,0.008658,172.31.40.0-255,66,146237,65,175257
22341,0.010907,74.125.68.0-255,5738,151975,65,175257
22342,0.010915,172.31.40.0-255,66,152041,65,175257
22343,0.013175,74.125.68.0-255,5738,157779,65,175257
22344,0.013183,172.31.40.0-255,66,157845,65,175257
22345,0.015439,74.125.68.0-255,5738,163583,65,175257
22346,0.015446,172.31.40.0-255,66,163649,65,175257
22347,0.017708,74.125.68.0-255,5738,169387,65,175257
22348,0.017719,172.31.40.0-255,66,169453,65,175257
22349,0.019981,74.125.68.0-255,5738,175191,65,175257
22350,0.019994,172.31.40.0-255,66,175257,65,175257
22351,0.0,172.31.40.0-255,105,105,65,459
22352,0.000227,172.31.40.0-255,90,195,65,459
22353,0.000245,172.31.40.0-255,66,261,65,459
22354,0.00232,74.125.24.0-255,66,327,65,459
22355,0.002351,74.125.24.0-255,66,393,65,459
22356,0.002374,172.31.40.0-255,66,459,65,459
22357,0.0,172.217.160.0-255,155,155,65,104330
22358,1.4e-05,172.31.40.0-255,66,221,65,104330
22359,2e-05,172.217.160.0-255,1484,1705,65,104330
22360,2.4e-05,172.31.40.0-255,66,1771,65,104330
22361,3.8e-05,172.217.160.0-255,2902,4673,65,104330
22362,4.2e-05,172.31.40.0-255,66,4739,65,104330
22363,7.7e-05,172.217.160.0-255,7156,11895,65,104330
22364,8e-05,172.31.40.0-255,66,11961,65,104330
22365,0.000217,172.217.160.0-255,2049,14010,65,104330
22366,0.000221,172.31.40.0-255,66,14076,65,104330
22367,0.000251,172.217.160.0-255,5738,19814,65,104330
22368,0.000254,172.31.40.0-255,66,19880,65,104330
22369,0.000281,172.217.160.0-255,5738,25618,65,104330
22370,0.000283,172.31.40.0-255,66,25684,65,104330
22371,0.000493,172.217.160.0-255,2902,28586,65,104330
22372,0.000498,172.31.40.0-255,66,28652,65,104330
22373,0.000526,172.217.160.0-255,2543,31195,65,104330
22374,0.00053,172.31.40.0-255,66,31261,65,104330
22375,0.000596,172.217.160.0-255,5738,36999,65,104330
22376,0.000601,172.31.40.0-255,66,37065,65,104330
22377,0.000714,172.217.160.0-255,7156,44221,65,104330
22378,0.000718,172.31.40.0-255,66,44287,65,104330
22379,0.000746,172.217.160.0-255,5379,49666,65,104330
22380,0.000749,172.31.40.0-255,66,49732,65,104330
22381,0.000976,172.31.40.0-255,66,49798,65,104330
22382,0.001006,172.217.160.0-255,4234,54032,65,104330
22383,0.001009,172.31.40.0-255,66,54098,65,104330
22384,0.001314,172.31.40.0-255,66,54164,65,104330
22385,0.001352,172.31.40.0-255,66,54230,65,104330
22386,0.00164,172.217.160.0-255,3602,57832,65,104330
22387,0.00416,172.31.40.0-255,66,57898,65,104330
22388,0.005772,172.217.160.0-255,5738,63636,65,104330
22389,0.005778,172.31.40.0-255,66,63702,65,104330
22390,0.007386,172.217.160.0-255,5738,69440,65,104330
22391,0.00819,172.31.40.0-255,66,69506,65,104330
22392,0.009802,172.217.160.0-255,5738,75244,65,104330
22393,0.00981,172.31.40.0-255,66,75310,65,104330
22394,0.011426,172.217.160.0-255,5738,81048,65,104330
22395,0.013213,172.31.40.0-255,66,81114,65,104330
22396,0.014837,172.217.160.0-255,5738,86852,65,104330
22397,0.014846,172.31.40.0-255,66,86918,65,104330
22398,0.016477,172.217.160.0-255,5738,92656,65,104330
22399,0.016485,172.31.40.0-255,66,92722,65,104330
22400,0.018094,172.217.160.0-255,5738,98460,65,104330
22401,0.018101,172.31.40.0-255,66,98526,65,104330
22402,0.019709,172.217.160.0-255,5738,104264,65,104330
22403,0.019716,172.31.40.0-255,66,104330,65,104330
22404,0.0,172.31.40.0-255,105,105,65,459
22405,0.000261,172.31.40.0-255,90,195,65,459
22406,0.000282,172.31.40.0-255,66,261,65,459
22407,0.002617,74.125.24.0-255,66,327,65,459
22408,0.002653,74.125.24.0-255,66,393,65,459
22409,0.002679,172.31.40.0-255,66,459,65,459
22410,0.0,172.217.194.0-255,150,150,65,194076
22411,3.6e-05,172.31.40.0-255,66,216,65,194076
22412,4.4e-05,172.217.194.0-255,1484,1700,65,194076
22413,4.8e-05,172.31.40.0-255,66,1766,65,194076
22414,5.5e-05,172.217.194.0-255,2902,4668,65,194076
22415,5.9e-05,172.31.40.0-255,66,4734,65,194076
22416,6.6e-05,172.217.194.0-255,7156,11890,65,194076
22417,6.9e-05,172.31.40.0-255,66,11956,65,194076
22418,7.2e-05,172.217.194.0-255,2110,14066,65,194076
22419,7.5e-05,172.31.40.0-255,66,14132,65,194076
22420,0.000208,172.217.194.0-255,1484,15616,65,194076
22421,0.000212,172.31.40.0-255,66,15682,65,194076
22422,0.000218,172.217.194.0-255,2902,18584,65,194076
22423,0.000221,172.31.40.0-255,66,18650,65,194076
22424,0.000227,172.217.194.0-255,5738,24388,65,194076
22425,0.000229,172.31.40.0-255,66,24454,65,194076
22426,0.000264,172.217.194.0-255,6797,31251,65,194076
22427,0.000267,172.31.40.0-255,66,31317,65,194076
22428,0.000556,172.217.194.0-255,1484,32801,65,194076
22429,0.000562,172.31.40.0-255,66,32867,65,194076
22430,0.000569,172.217.194.0-255,2902,35769,65,194076
22431,0.000571,172.31.40.0-255,66,35835,65,194076
22432,0.000576,172.217.194.0-255,2902,38737,65,194076
22433,0.000579,172.31.40.0-255,66,38803,65,194076
22434,0.000599,172.217.194.0-255,2902,41705,65,194076
22435,0.000603,172.31.40.0-255,66,41771,65,194076
22436,0.000609,172.217.194.0-255,5738,47509,65,194076
22437,0.000611,172.31.40.0-255,66,47575,65,194076
22438,0.000638,172.31.40.0-255,66,47641,65,194076
22439,0.000662,172.217.194.0-255,7156,54797,65,194076
22440,0.000667,172.31.40.0-255,66,54863,65,194076
22441,0.000675,172.217.194.0-255,2543,57406,65,194076
22442,0.000678,172.31.40.0-255,66,57472,65,194076
22443,0.000689,172.217.194.0-255,648,58120,65,194076
22444,0.000833,172.217.194.0-255,1484,59604,65,194076
22445,0.000839,172.31.40.0-255,66,59670,65,194076
22446,0.000849,172.217.194.0-255,2902,62572,65,194076
22447,0.000851,172.31.40.0-255,66,62638,65,194076
22448,0.000877,172.217.194.0-255,2902,65540,65,194076
22449,0.000879,172.31.40.0-255,66,65606,65,194076
22450,0.0009,172.217.194.0-255,2902,68508,65,194076
22451,0.000903,172.31.40.0-255,66,68574,65,194076
22452,0.000933,172.31.40.0-255,66,68640,65,194076
22453,0.000936,172.217.194.0-255,1484,70124,65,194076
22454,0.000962,172.31.40.0-255,66,70190,65,194076
22455,0.001182,172.217.194.0-255,1484,71674,65,194076
22456,0.001188,172.217.194.0-255,2902,74576,65,194076
22457,0.001191,172.31.40.0-255,66,74642,65,194076
22458,0.001195,172.217.194.0-255,1484,76126,65,194076
22459,0.001217,172.217.194.0-255,4320,80446,65,194076
22460,0.001221,172.31.40.0-255,66,80512,65,194076
22461,0.001253,172.31.40.0-255,66,80578,65,194076
22462,0.001256,172.217.194.0-255,1484,82062,65,194076
22463,0.001286,172.31.40.0-255,66,82128,65,194076
22464,0.001336,172.217.194.0-255,1484,83612,65,194076
22465,0.00134,172.217.194.0-255,2902,86514,65,194076
22466,0.001343,172.31.40.0-255,66,86580,65,194076
22467,0.001349,172.217.194.0-255,5738,92318,65,194076
22468,0.001351,172.31.40.0-255,66,92384,65,194076
22469,0.001354,172.217.194.0-255,1484,93868,65,194076
22470,0.001378,172.217.194.0-255,7156,101024,65,194076
22471,0.001381,172.31.40.0-255,66,101090,65,194076
22472,0.001426,172.217.194.0-255,2902,103992,65,194076
22473,0.00143,172.31.40.0-255,66,104058,65,194076
22474,0.001456,172.31.40.0-255,66,104124,65,194076
22475,0.00148,172.217.194.0-255,2184,106308,65,194076
22476,0.001482,172.217.194.0-255,1484,107792,65,194076
22477,0.001485,172.217.194.0-255,2902,110694,65,194076
22478,0.00149,172.31.40.0-255,66,110760,65,194076
22479,0.001493,172.31.40.0-255,66,110826,65,194076
22480,0.001514,172.217.194.0-255,5738,116564,65,194076
22481,0.001517,172.31.40.0-255,66,116630,65,194076
22482,0.00153,172.31.40.0-255,66,116696,65,194076
22483,0.001536,172.217.194.0-255,5738,122434,65,194076
22484,0.001538,172.31.40.0-255,66,122500,65,194076
22485,0.001566,172.217.194.0-255,5020,127520,65,194076
22486,0.00157,172.31.40.0-255,66,127586,65,194076
22487,0.001573,172.217.194.0-255,1484,129070,65,194076
22488,0.001576,172.217.194.0-255,1484,130554,65,194076
22489,0.001578,172.31.40.0-255,66,130620,65,194076
22490,0.001593,172.217.194.0-255,1484,132104,65,194076
22491,0.001614,172.217.194.0-255,5738,137842,65,194076
22492,0.001618,172.31.40.0-255,66,137908,65,194076
22493,0.001624,172.217.194.0-255,4320,142228,65,194076
22494,0.001626,172.31.40.0-255,66,142294,65,194076
22495,0.00165,172.31.40.0-255,66,142360,65,194076
22496,0.001699,172.31.40.0-255,66,142426,65,194076
22497,0.001726,172.217.194.0-255,5020,147446,65,194076
22498,0.00173,172.31.40.0-255,66,147512,65,194076
22499,0.001749,172.31.40.0-255,66,147578,65,194076
22500,0.001761,172.31.40.0-255,66,147644,65,194076
22501,0.003766,172.217.194.0-255,5738,153382,65,194076
22502,0.003773,172.31.40.0-255,66,153448,65,194076
22503,0.005825,172.217.194.0-255,5738,159186,65,194076
22504,0.005841,172.31.40.0-255,66,159252,65,194076
22505,0.007889,172.217.194.0-255,5738,164990,65,194076
22506,0.007905,172.31.40.0-255,66,165056,65,194076
22507,0.009937,172.217.194.0-255,5738,170794,65,194076
22508,0.009947,172.31.40.0-255,66,170860,65,194076
22509,0.011979,172.217.194.0-255,5738,176598,65,194076
22510,0.011982,172.31.40.0-255,66,176664,65,194076
22511,0.014013,172.217.194.0-255,5738,182402,65,194076
22512,0.014029,172.31.40.0-255,66,182468,65,194076
22513,0.016077,172.217.194.0-255,5738,188206,65,194076
22514,0.016088,172.31.40.0-255,66,188272,65,194076
22515,0.018126,172.217.194.0-255,5738,194010,65,194076
22516,0.018139,172.31.40.0-255,66,194076,65,194076
22517,0.0,74.125.68.0-255,146,146,65,184860
22518,2.3e-05,172.31.40.0-255,66,212,65,184860
22519,3e-05,74.125.68.0-255,1484,1696,65,184860
22520,3.5e-05,172.31.40.0-255,66,1762,65,184860
22521,4.2e-05,74.125.68.0-255,2902,4664,65,184860
22522,4.5e-05,172.31.40.0-255,66,4730,65,184860
22523,5e-05,74.125.68.0-255,2902,7632,65,184860
22524,5.3e-05,172.31.40.0-255,66,7698,65,184860
22525,5.9e-05,74.125.68.0-255,4320,12018,65,184860
22526,6.2e-05,172.31.40.0-255,66,12084,65,184860
22527,6.6e-05,74.125.68.0-255,2076,14160,65,184860
22528,6.9e-05,172.31.40.0-255,66,14226,65,184860
22529,7.4e-05,74.125.68.0-255,2902,17128,65,184860
22530,7.6e-05,172.31.40.0-255,66,17194,65,184860
22531,8.4e-05,74.125.68.0-255,7156,24350,65,184860
22532,8.6e-05,172.31.40.0-255,66,24416,65,184860
22533,0.000109,74.125.68.0-255,4320,28736,65,184860
22534,0.000112,172.31.40.0-255,66,28802,65,184860
22535,0.000118,74.125.68.0-255,5738,34540,65,184860
22536,0.000121,172.31.40.0-255,66,34606,65,184860
22537,0.000133,172.31.40.0-255,66,34672,65,184860
22538,0.000154,74.125.68.0-255,1484,36156,65,184860
22539,0.000156,172.31.40.0-255,66,36222,65,184860
22540,0.000161,74.125.68.0-255,2184,38406,65,184860
22541,0.000163,172.31.40.0-255,66,38472,65,184860
22542,0.000246,74.125.68.0-255,1484,39956,65,184860
22543,0.000249,172.31.40.0-255,66,40022,65,184860
22544,0.000254,74.125.68.0-255,2902,42924,65,184860
22545,0.000256,172.31.40.0-255,66,42990,65,184860
22546,0.00028,74.125.68.0-255,4320,47310,65,184860
22547,0.000283,172.31.40.0-255,66,47376,65,184860
22548,0.000302,74.125.68.0-255,1484,48860,65,184860
22549,0.000304,172.31.40.0-255,66,48926,65,184860
22550,0.000313,74.125.68.0-255,7068,55994,65,184860
22551,0.000316,172.31.40.0-255,66,56060,65,184860
22552,0.000369,74.125.68.0-255,132,56192,65,184860
22553,0.000372,172.31.40.0-255,66,56258,65,184860
22554,0.000495,74.125.68.0-255,1484,57742,65,184860
22555,0.0005,172.31.40.0-255,66,57808,65,184860
22556,0.000506,74.125.68.0-255,2902,60710,65,184860
22557,0.000509,172.31.40.0-255,66,60776,65,184860
22558,0.00054,74.125.68.0-255,5738,66514,65,184860
22559,0.000543,172.31.40.0-255,66,66580,65,184860
22560,0.000546,74.125.68.0-255,1484,68064,65,184860
22561,0.000548,172.31.40.0-255,66,68130,65,184860
22562,0.000568,74.125.68.0-255,5738,73868,65,184860
22563,0.000571,172.31.40.0-255,66,73934,65,184860
22564,0.000598,74.125.68.0-255,3961,77895,65,184860
22565,0.000604,74.125.68.0-255,5738,83633,65,184860
22566,0.000609,172.31.40.0-255,66,83699,65,184860
22567,0.000612,172.31.40.0-255,66,83765,65,184860
22568,0.00062,74.125.68.0-255,1484,85249,65,184860
22569,0.000622,172.31.40.0-255,66,85315,65,184860
22570,0.000643,74.125.68.0-255,5379,90694,65,184860
22571,0.000646,172.31.40.0-255,66,90760,65,184860
22572,0.001688,74.125.68.0-255,1484,92244,65,184860
22573,0.001694,172.31.40.0-255,66,92310,65,184860
22574,0.001713,74.125.68.0-255,2902,95212,65,184860
22575,0.001716,172.31.40.0-255,66,95278,65,184860
22576,0.001746,74.125.68.0-255,4320,99598,65,184860
22577,0.001748,172.31.40.0-255,66,99664,65,184860
22578,0.00176,74.125.68.0-255,2902,102566,65,184860
22579,0.001763,172.31.40.0-255,66,102632,65,184860
22580,0.001778,74.125.68.0-255,4320,106952,65,184860
22581,0.00178,172.31.40.0-255,66,107018,65,184860
22582,0.001784,74.125.68.0-255,1484,108502,65,184860
22583,0.001786,172.31.40.0-255,66,108568,65,184860
22584,0.00181,74.125.68.0-255,7156,115724,65,184860
22585,0.001813,172.31.40.0-255,66,115790,65,184860
22586,0.001818,74.125.68.0-255,4320,120110,65,184860
22587,0.00182,172.31.40.0-255,66,120176,65,184860
22588,0.001839,74.125.68.0-255,4320,124496,65,184860
22589,0.001842,172.31.40.0-255,66,124562,65,184860
22590,0.001844,74.125.68.0-255,766,125328,65,184860
22591,0.001846,172.31.40.0-255,66,125394,65,184860
22592,0.001884,74.125.68.0-255,1484,126878,65,184860
22593,0.001887,172.31.40.0-255,66,126944,65,184860
22594,0.001892,74.125.68.0-255,2902,129846,65,184860
22595,0.001893,172.31.40.0-255,66,129912,65,184860
22596,0.001908,74.125.68.0-255,1484,131396,65,184860
22597,0.00191,172.31.40.0-255,66,131462,65,184860
22598,0.001913,74.125.68.0-255,1484,132946,65,184860
22599,0.001932,74.125.68.0-255,4320,137266,65,184860
22600,0.001938,74.125.68.0-255,4320,141586,65,184860
22601,0.001952,74.125.68.0-255,2902,144488,65,184860
22602,0.001972,74.125.68.0-255,2902,147390,65,184860
22603,0.002038,74.125.68.0-255,2184,149574,65,184860
22604,0.00349,172.31.40.0-255,66,149640,65,184860
22605,0.005878,74.125.68.0-255,4320,153960,65,184860
22606,0.005884,172.31.40.0-255,66,154026,65,184860
22607,0.0059,74.125.68.0-255,1484,155510,65,184860
22608,0.005903,172.31.40.0-255,66,155576,65,184860
22609,0.008283,74.125.68.0-255,4320,159896,65,184860
22610,0.008289,172.31.40.0-255,66,159962,65,184860
22611,0.008309,74.125.68.0-255,1484,161446,65,184860
22612,0.008312,172.31.40.0-255,66,161512,65,184860
22613,0.010687,74.125.68.0-255,4320,165832,65,184860
22614,0.010696,172.31.40.0-255,66,165898,65,184860
22615,0.010717,74.125.68.0-255,1484,167382,65,184860
22616,0.01072,172.31.40.0-255,66,167448,65,184860
22617,0.01311,74.125.68.0-255,5738,173186,65,184860
22618,0.013118,172.31.40.0-255,66,173252,65,184860
22619,0.015522,74.125.68.0-255,5738,178990,65,184860
22620,0.015534,172.31.40.0-255,66,179056,65,184860
22621,0.017929,74.125.68.0-255,5738,184794,65,184860
22622,0.017937,172.31.40.0-255,66,184860,65,184860
22623,0.0,172.217.194.0-255,154,154,65,88296
22624,1.5e-05,172.31.40.0-255,66,220,65,88296
22625,2.2e-05,172.217.194.0-255,1484,1704,65,88296
22626,2.7e-05,172.31.40.0-255,66,1770,65,88296
22627,3.3e-05,172.217.194.0-255,2902,4672,65,88296
22628,3.7e-05,172.31.40.0-255,66,4738,65,88296
22629,6.7e-05,172.217.194.0-255,4320,9058,65,88296
22630,7e-05,172.31.40.0-255,66,9124,65,88296
22631,9.1e-05,172.217.194.0-255,2902,12026,65,88296
22632,9.4e-05,172.31.40.0-255,66,12092,65,88296
22633,0.000168,172.217.194.0-255,2067,14159,65,88296
22634,0.000172,172.31.40.0-255,66,14225,65,88296
22635,0.000209,172.217.194.0-255,5738,19963,65,88296
22636,0.000213,172.31.40.0-255,66,20029,65,88296
22637,0.000236,172.217.194.0-255,5738,25767,65,88296
22638,0.000239,172.31.40.0-255,66,25833,65,88296
22639,0.000389,172.217.194.0-255,5379,31212,65,88296
22640,0.000394,172.31.40.0-255,66,31278,65,88296
22641,0.000471,172.217.194.0-255,4320,35598,65,88296
22642,0.000477,172.31.40.0-255,66,35664,65,88296
22643,0.00051,172.31.40.0-255,66,35730,65,88296
22644,0.000727,172.217.194.0-255,2902,38632,65,88296
22645,0.000731,172.31.40.0-255,66,38698,65,88296
22646,0.000767,172.31.40.0-255,66,38764,65,88296
22647,0.001006,172.217.194.0-255,2902,41666,65,88296
22648,0.001011,172.31.40.0-255,66,41732,65,88296
22649,0.001046,172.31.40.0-255,66,41798,65,88296
22650,0.001243,172.217.194.0-255,5738,47536,65,88296
22651,0.001248,172.31.40.0-255,66,47602,65,88296
22652,0.003419,172.31.40.0-255,66,47668,65,88296
22653,0.005707,172.217.194.0-255,5738,53406,65,88296
22654,0.005713,172.31.40.0-255,66,53472,65,88296
22655,0.007994,172.217.194.0-255,5738,59210,65,88296
22656,0.008,172.31.40.0-255,66,59276,65,88296
22657,0.010301,172.217.194.0-255,5738,65014,65,88296
22658,0.010309,172.31.40.0-255,66,65080,65,88296
22659,0.012629,172.217.194.0-255,5738,70818,65,88296
22660,0.012637,172.31.40.0-255,66,70884,65,88296
22661,0.0149,172.217.194.0-255,5738,76622,65,88296
22662,0.014911,172.31.40.0-255,66,76688,65,88296
22663,0.01719,172.217.194.0-255,5738,82426,65,88296
22664,0.017201,172.31.40.0-255,66,82492,65,88296
22665,0.019493,172.217.194.0-255,5738,88230,65,88296
22666,0.019501,172.31.40.0-255,66,88296,65,88296
22667,0.0,172.31.40.0-255,105,105,65,459
22668,0.000225,172.31.40.0-255,90,195,65,459
22669,0.000234,172.31.40.0-255,66,261,65,459
22670,0.003552,74.125.24.0-255,66,327,65,459
22671,0.004032,74.125.24.0-255,66,393,65,459
22672,0.004055,172.31.40.0-255,66,459,65,459
22673,0.0,74.125.200.0-255,150,150,65,240820
22674,2.5e-05,172.31.40.0-255,66,216,65,240820
22675,3.2e-05,74.125.200.0-255,1484,1700,65,240820
22676,3.8e-05,172.31.40.0-255,66,1766,65,240820
22677,5.3e-05,74.125.200.0-255,2902,4668,65,240820
22678,5.6e-05,172.31.40.0-255,66,4734,65,240820
22679,6.4e-05,74.125.200.0-255,7156,11890,65,240820
22680,6.7e-05,172.31.40.0-255,66,11956,65,240820
22681,0.000105,74.125.200.0-255,2133,14089,65,240820
22682,0.000108,172.31.40.0-255,66,14155,65,240820
22683,0.000215,74.125.200.0-255,1484,15639,65,240820
22684,0.000218,172.31.40.0-255,66,15705,65,240820
22685,0.00025,74.125.200.0-255,1484,17189,65,240820
22686,0.000254,172.31.40.0-255,66,17255,65,240820
22687,0.000259,74.125.200.0-255,2902,20157,65,240820
22688,0.000261,172.31.40.0-255,66,20223,65,240820
22689,0.000294,74.125.200.0-255,5738,25961,65,240820
22690,0.000296,172.31.40.0-255,66,26027,65,240820
22691,0.000338,74.125.200.0-255,5379,31406,65,240820
22692,0.000341,172.31.40.0-255,66,31472,65,240820
22693,0.000344,74.125.200.0-255,1484,32956,65,240820
22694,0.000346,172.31.40.0-255,66,33022,65,240820
22695,0.00037,74.125.200.0-255,4320,37342,65,240820
22696,0.000372,172.31.40.0-255,66,37408,65,240820
22697,0.000378,74.125.200.0-255,4320,41728,65,240820
22698,0.000388,74.125.200.0-255,5738,47466,65,240820
22699,0.000392,74.125.200.0-255,1125,48591,65,240820
22700,0.000397,172.31.40.0-255,66,48657,65,240820
22701,0.000399,172.31.40.0-255,66,48723,65,240820
22702,0.0004,172.31.40.0-255,66,48789,65,240820
22703,0.000421,74.125.200.0-255,1484,50273,65,240820
22704,0.000424,172.31.40.0-255,66,50339,65,240820
22705,0.000427,74.125.200.0-255,1484,51823,65,240820
22706,0.000456,74.125.200.0-255,2902,54725,65,240820
22707,0.000459,172.31.40.0-255,66,54791,65,240820
22708,0.000466,74.125.200.0-255,5738,60529,65,240820
22709,0.000468,172.31.40.0-255,66,60595,65,240820
22710,0.000511,74.125.200.0-255,5379,65974,65,240820
22711,0.000514,172.31.40.0-255,66,66040,65,240820
22712,0.000517,74.125.200.0-255,396,66436,65,240820
22713,0.000601,74.125.200.0-255,1484,67920,65,240820
22714,0.000604,172.31.40.0-255,66,67986,65,240820
22715,0.000608,74.125.200.0-255,1484,69470,65,240820
22716,0.000629,74.125.200.0-255,1484,70954,65,240820
22717,0.000632,172.31.40.0-255,66,71020,65,240820
22718,0.000639,74.125.200.0-255,5738,76758,65,240820
22719,0.000641,172.31.40.0-255,66,76824,65,240820
22720,0.00065,74.125.200.0-255,2902,79726,65,240820
22721,0.000665,172.31.40.0-255,66,79792,65,240820
22722,0.000704,74.125.200.0-255,3961,83753,65,240820
22723,0.000707,172.31.40.0-255,66,83819,65,240820
22724,0.000711,74.125.200.0-255,2902,86721,65,240820
22725,0.000713,172.31.40.0-255,66,86787,65,240820
22726,0.00074,74.125.200.0-255,1484,88271,65,240820
22727,0.000758,74.125.200.0-255,4320,92591,65,240820
22728,0.00076,172.31.40.0-255,66,92657,65,240820
22729,0.000767,74.125.200.0-255,5738,98395,65,240820
22730,0.000769,172.31.40.0-255,66,98461,65,240820
22731,0.000786,74.125.200.0-255,2244,100705,65,240820
22732,0.000788,172.31.40.0-255,66,100771,65,240820
22733,0.001006,74.125.200.0-255,1484,102255,65,240820
22734,0.001023,74.125.200.0-255,2902,105157,65,240820
22735,0.001028,172.31.40.0-255,66,105223,65,240820
22736,0.001032,74.125.200.0-255,1484,106707,65,240820
22737,0.001065,74.125.200.0-255,4320,111027,65,240820
22738,0.001068,172.31.40.0-255,66,111093,65,240820
22739,0.001072,74.125.200.0-255,2902,113995,65,240820
22740,0.001074,172.31.40.0-255,66,114061,65,240820
22741,0.001084,74.125.200.0-255,4320,118381,65,240820
22742,0.001087,172.31.40.0-255,66,118447,65,240820
22743,0.001118,74.125.200.0-255,2902,121349,65,240820
22744,0.001121,172.31.40.0-255,66,121415,65,240820
22745,0.001147,74.125.200.0-255,5738,127153,65,240820
22746,0.00115,172.31.40.0-255,66,127219,65,240820
22747,0.001156,74.125.200.0-255,7156,134375,65,240820
22748,0.001158,172.31.40.0-255,66,134441,65,240820
22749,0.001164,74.125.200.0-255,5020,139461,65,240820
22750,0.001167,172.31.40.0-255,66,139527,65,240820
22751,0.001187,74.125.200.0-255,2902,142429,65,240820
22752,0.00119,172.31.40.0-255,66,142495,65,240820
22753,0.001213,74.125.200.0-255,2902,145397,65,240820
22754,0.001216,172.31.40.0-255,66,145463,65,240820
22755,0.00122,74.125.200.0-255,2902,148365,65,240820
22756,0.001223,172.31.40.0-255,66,148431,65,240820
22757,0.001251,74.125.200.0-255,3961,152392,65,240820
22758,0.001254,172.31.40.0-255,66,152458,65,240820
22759,0.001267,74.125.200.0-255,1484,153942,65,240820
22760,0.00127,74.125.200.0-255,1484,155426,65,240820
22761,0.001277,172.31.40.0-255,66,155492,65,240820
22762,0.001293,74.125.200.0-255,1484,156976,65,240820
22763,0.001296,74.125.200.0-255,1484,158460,65,240820
22764,0.001298,172.31.40.0-255,66,158526,65,240820
22765,0.001317,74.125.200.0-255,2902,161428,65,240820
22766,0.00132,172.31.40.0-255,66,161494,65,240820
22767,0.001326,74.125.200.0-255,5738,167232,65,240820
22768,0.001328,172.31.40.0-255,66,167298,65,240820
22769,0.001363,172.31.40.0-255,66,167364,65,240820
22770,0.001369,74.125.200.0-255,4320,171684,65,240820
22771,0.001371,172.31.40.0-255,66,171750,65,240820
22772,0.001398,74.125.200.0-255,1484,173234,65,240820
22773,0.001402,74.125.200.0-255,2184,175418,65,240820
22774,0.001404,172.31.40.0-255,66,175484,65,240820
22775,0.001627,74.125.200.0-255,1484,176968,65,240820
22776,0.001634,74.125.200.0-255,2902,179870,65,240820
22777,0.001637,172.31.40.0-255,66,179936,65,240820
22778,0.001642,74.125.200.0-255,2902,182838,65,240820
22779,0.001644,172.31.40.0-255,66,182904,65,240820
22780,0.001676,74.125.200.0-255,2902,185806,65,240820
22781,0.001679,172.31.40.0-255,66,185872,65,240820
22782,0.001684,74.125.200.0-255,2902,188774,65,240820
22783,0.001686,172.31.40.0-255,66,188840,65,240820
22784,0.001698,172.31.40.0-255,66,188906,65,240820
22785,0.001702,74.125.200.0-255,1484,190390,65,240820
22786,0.001742,74.125.200.0-255,766,191156,65,240820
22787,0.001747,172.31.40.0-255,66,191222,65,240820
22788,0.003048,172.31.40.0-255,66,191288,65,240820
22789,0.003741,74.125.200.0-255,4320,195608,65,240820
22790,0.003748,172.31.40.0-255,66,195674,65,240820
22791,0.005012,74.125.200.0-255,1484,197158,65,240820
22792,0.005732,74.125.200.0-255,4320,201478,65,240820
22793,0.005736,172.31.40.0-255,66,201544,65,240820
22794,0.007704,74.125.200.0-255,4320,205864,65,240820
22795,0.007708,172.31.40.0-255,66,205930,65,240820
22796,0.007733,74.125.200.0-255,1484,207414,65,240820
22797,0.009688,74.125.200.0-255,4320,211734,65,240820
22798,0.009695,172.31.40.0-255,66,211800,65,240820
22799,0.011673,74.125.200.0-255,5738,217538,65,240820
22800,0.011682,172.31.40.0-255,66,217604,65,240820
22801,0.013664,74.125.200.0-255,5738,223342,65,240820
22802,0.013673,172.31.40.0-255,66,223408,65,240820
22803,0.01567,74.125.200.0-255,5738,229146,65,240820
22804,0.015685,172.31.40.0-255,66,229212,65,240820
22805,0.017674,74.125.200.0-255,5738,234950,65,240820
22806,0.017689,172.31.40.0-255,66,235016,65,240820
22807,0.019676,74.125.200.0-255,5738,240754,65,240820
22808,0.01969,172.31.40.0-255,66,240820,65,240820
22809,0.0,172.217.194.0-255,153,153,65,183835
22810,1.8e-05,172.31.40.0-255,66,219,65,183835
22811,2.4e-05,172.217.194.0-255,1484,1703,65,183835
22812,2.9e-05,172.31.40.0-255,66,1769,65,183835
22813,3.4e-05,172.217.194.0-255,2902,4671,65,183835
22814,3.7e-05,172.31.40.0-255,66,4737,65,183835
22815,4.3e-05,172.217.194.0-255,7156,11893,65,183835
22816,4.6e-05,172.31.40.0-255,66,11959,65,183835
22817,4.9e-05,172.217.194.0-255,2000,13959,65,183835
22818,5.1e-05,172.31.40.0-255,66,14025,65,183835
22819,0.000116,172.217.194.0-255,1484,15509,65,183835
22820,0.000119,172.31.40.0-255,66,15575,65,183835
22821,0.000123,172.217.194.0-255,2902,18477,65,183835
22822,0.000126,172.31.40.0-255,66,18543,65,183835
22823,0.000139,172.217.194.0-255,1484,20027,65,183835
22824,0.000141,172.31.40.0-255,66,20093,65,183835
22825,0.000155,172.217.194.0-255,4320,24413,65,183835
22826,0.000157,172.31.40.0-255,66,24479,65,183835
22827,0.000178,172.217.194.0-255,1484,25963,65,183835
22828,0.00018,172.31.40.0-255,66,26029,65,183835
22829,0.000196,172.217.194.0-255,1484,27513,65,183835
22830,0.000198,172.31.40.0-255,66,27579,65,183835
22831,0.000227,172.31.40.0-255,66,27645,65,183835
22832,0.000256,172.217.194.0-255,4320,31965,65,183835
22833,0.000259,172.31.40.0-255,66,32031,65,183835
22834,0.000283,172.217.194.0-255,6797,38828,65,183835
22835,0.000286,172.31.40.0-255,66,38894,65,183835
22836,0.000433,172.217.194.0-255,1484,40378,65,183835
22837,0.000437,172.31.40.0-255,66,40444,65,183835
22838,0.000442,172.217.194.0-255,2902,43346,65,183835
22839,0.000444,172.31.40.0-255,66,43412,65,183835
22840,0.000447,172.217.194.0-255,1484,44896,65,183835
22841,0.000472,172.217.194.0-255,4320,49216,65,183835
22842,0.000477,172.31.40.0-255,66,49282,65,183835
22843,0.000496,172.217.194.0-255,2902,52184,65,183835
22844,0.000505,172.217.194.0-255,1484,53668,65,183835
22845,0.000507,172.31.40.0-255,66,53734,65,183835
22846,0.00052,172.217.194.0-255,3122,56856,65,183835
22847,0.000535,172.31.40.0-255,66,56922,65,183835
22848,0.001073,172.217.194.0-255,1484,58406,65,183835
22849,0.001084,172.217.194.0-255,2902,61308,65,183835
22850,0.001088,172.31.40.0-255,66,61374,65,183835
22851,0.001094,172.217.194.0-255,2902,64276,65,183835
22852,0.001096,172.31.40.0-255,66,64342,65,183835
22853,0.001109,172.217.194.0-255,2902,67244,65,183835
22854,0.001111,172.31.40.0-255,66,67310,65,183835
22855,0.001115,172.217.194.0-255,1484,68794,65,183835
22856,0.001148,172.217.194.0-255,5738,74532,65,183835
22857,0.001151,172.31.40.0-255,66,74598,65,183835
22858,0.001168,172.217.194.0-255,2184,76782,65,183835
22859,0.001221,172.217.194.0-255,1484,78266,65,183835
22860,0.001238,172.217.194.0-255,2902,81168,65,183835
22861,0.00125,172.217.194.0-255,1484,82652,65,183835
22862,0.001291,172.217.194.0-255,7156,89808,65,183835
22863,0.001383,172.217.194.0-255,1484,91292,65,183835
22864,0.001418,172.217.194.0-255,1484,92776,65,183835
22865,0.001439,172.217.194.0-255,4320,97096,65,183835
22866,0.001472,172.217.194.0-255,4320,101416,65,183835
22867,0.001479,172.217.194.0-255,5738,107154,65,183835
22868,0.001494,172.217.194.0-255,1484,108638,65,183835
22869,0.001514,172.217.194.0-255,1484,110122,65,183835
22870,0.001552,172.217.194.0-255,766,110888,65,183835
22871,0.001619,172.217.194.0-255,1484,112372,65,183835
22872,0.001623,172.217.194.0-255,1484,113856,65,183835
22873,0.001642,172.217.194.0-255,1484,115340,65,183835
22874,0.001648,172.217.194.0-255,5738,121078,65,183835
22875,0.001655,172.217.194.0-255,4320,125398,65,183835
22876,0.00174,172.217.194.0-255,2902,128300,65,183835
22877,0.001761,172.217.194.0-255,6438,134738,65,183835
22878,0.001766,172.217.194.0-255,2902,137640,65,183835
22879,0.001786,172.217.194.0-255,7156,144796,65,183835
22880,0.001817,172.217.194.0-255,3602,148398,65,183835
22881,0.001836,172.217.194.0-255,4320,152718,65,183835
22882,0.001859,172.217.194.0-255,7156,159874,65,183835
22883,0.002316,172.217.194.0-255,1484,161358,65,183835
22884,0.002324,172.217.194.0-255,2902,164260,65,183835
22885,0.00234,172.217.194.0-255,4320,168580,65,183835
22886,0.002355,172.217.194.0-255,1484,170064,65,183835
22887,0.002361,172.217.194.0-255,4320,174384,65,183835
22888,0.002393,172.217.194.0-255,2902,177286,65,183835
22889,0.002415,172.217.194.0-255,6141,183427,65,183835
22890,0.00685,172.31.40.0-255,66,183493,65,183835
22891,0.009216,172.217.194.0-255,105,183598,65,183835
22892,0.009246,172.31.40.0-255,66,183664,65,183835
22893,0.00928,172.31.40.0-255,105,183769,65,183835
22894,0.011565,172.217.194.0-255,66,183835,65,183835
22895,0.0,74.125.24.0-255,146,146,65,203193
22896,2.3e-05,172.31.40.0-255,66,212,65,203193
22897,3.1e-05,74.125.24.0-255,1484,1696,65,203193
22898,3.6e-05,172.31.40.0-255,66,1762,65,203193
22899,5e-05,74.125.24.0-255,2902,4664,65,203193
22900,5.4e-05,172.31.40.0-255,66,4730,65,203193
22901,6.3e-05,74.125.24.0-255,7156,11886,65,203193
22902,6.6e-05,172.31.40.0-255,66,11952,65,203193
22903,8.3e-05,172.31.40.0-255,66,12018,65,203193
22904,8.6e-05,74.125.24.0-255,1484,13502,65,203193
22905,8.9e-05,172.31.40.0-255,66,13568,65,203193
22906,0.000118,74.125.24.0-255,1125,14693,65,203193
22907,0.000121,172.31.40.0-255,66,14759,65,203193
22908,0.00017,74.125.24.0-255,1484,16243,65,203193
22909,0.000173,172.31.40.0-255,66,16309,65,203193
22910,0.000179,74.125.24.0-255,4320,20629,65,203193
22911,0.000181,172.31.40.0-255,66,20695,65,203193
22912,0.000217,74.125.24.0-255,7156,27851,65,203193
22913,0.00022,172.31.40.0-255,66,27917,65,203193
22914,0.000235,172.31.40.0-255,66,27983,65,203193
22915,0.000264,74.125.24.0-255,1125,29108,65,203193
22916,0.000267,172.31.40.0-255,66,29174,65,203193
22917,0.000273,74.125.24.0-255,3961,33135,65,203193
22918,0.000275,172.31.40.0-255,66,33201,65,203193
22919,0.000342,74.125.24.0-255,648,33849,65,203193
22920,0.000345,172.31.40.0-255,66,33915,65,203193
22921,0.000479,74.125.24.0-255,1484,35399,65,203193
22922,0.000484,172.31.40.0-255,66,35465,65,203193
22923,0.000491,74.125.24.0-255,2902,38367,65,203193
22924,0.000494,172.31.40.0-255,66,38433,65,203193
22925,0.000519,74.125.24.0-255,5738,44171,65,203193
22926,0.000522,172.31.40.0-255,66,44237,65,203193
22927,0.000536,172.31.40.0-255,66,44303,65,203193
22928,0.000543,74.125.24.0-255,7156,51459,65,203193
22929,0.000545,172.31.40.0-255,66,51525,65,203193
22930,0.000576,74.125.24.0-255,3602,55127,65,203193
22931,0.000579,172.31.40.0-255,66,55193,65,203193
22932,0.000764,74.125.24.0-255,1484,56677,65,203193
22933,0.000771,74.125.24.0-255,2902,59579,65,203193
22934,0.000774,172.31.40.0-255,66,59645,65,203193
22935,0.00078,74.125.24.0-255,5738,65383,65,203193
22936,0.000781,172.31.40.0-255,66,65449,65,203193
22937,0.000811,172.31.40.0-255,66,65515,65,203193
22938,0.000832,74.125.24.0-255,7156,72671,65,203193
22939,0.000834,172.31.40.0-255,66,72737,65,203193
22940,0.000861,74.125.24.0-255,3602,76339,65,203193
22941,0.000863,172.31.40.0-255,66,76405,65,203193
22942,0.001583,74.125.24.0-255,1484,77889,65,203193
22943,0.001606,74.125.24.0-255,2902,80791,65,203193
22944,0.00161,172.31.40.0-255,66,80857,65,203193
22945,0.001616,74.125.24.0-255,5738,86595,65,203193
22946,0.001617,172.31.40.0-255,66,86661,65,203193
22947,0.001649,172.31.40.0-255,66,86727,65,203193
22948,0.001667,74.125.24.0-255,2902,89629,65,203193
22949,0.001672,172.31.40.0-255,66,89695,65,203193
22950,0.001683,172.31.40.0-255,66,89761,65,203193
22951,0.001856,74.125.24.0-255,1484,91245,65,203193
22952,0.001862,74.125.24.0-255,2902,94147,65,203193
22953,0.001865,172.31.40.0-255,66,94213,65,203193
22954,0.001869,74.125.24.0-255,2902,97115,65,203193
22955,0.001871,172.31.40.0-255,66,97181,65,203193
22956,0.001892,74.125.24.0-255,2902,100083,65,203193
22957,0.001894,172.31.40.0-255,66,100149,65,203193
22958,0.001904,74.125.24.0-255,7156,107305,65,203193
22959,0.001906,172.31.40.0-255,66,107371,65,203193
22960,0.00191,74.125.24.0-255,2902,110273,65,203193
22961,0.001912,172.31.40.0-255,66,110339,65,203193
22962,0.001956,172.31.40.0-255,66,110405,65,203193
22963,0.001963,74.125.24.0-255,6438,116843,65,203193
22964,0.001964,172.31.40.0-255,66,116909,65,203193
22965,0.00197,74.125.24.0-255,7156,124065,65,203193
22966,0.001972,172.31.40.0-255,66,124131,65,203193
22967,0.002012,172.31.40.0-255,66,124197,65,203193
22968,0.002048,74.125.24.0-255,5738,129935,65,203193
22969,0.00205,172.31.40.0-255,66,130001,65,203193
22970,0.002057,74.125.24.0-255,6438,136439,65,203193
22971,0.002059,172.31.40.0-255,66,136505,65,203193
22972,0.002085,172.31.40.0-255,66,136571,65,203193
22973,0.002095,172.31.40.0-255,66,136637,65,203193
22974,0.002169,74.125.24.0-255,1484,138121,65,203193
22975,0.002173,74.125.24.0-255,2902,141023,65,203193
22976,0.002178,172.31.40.0-255,66,141089,65,203193
22977,0.002204,74.125.24.0-255,5738,146827,65,203193
22978,0.002206,172.31.40.0-255,66,146893,65,203193
22979,0.002212,74.125.24.0-255,5738,152631,65,203193
22980,0.002214,172.31.40.0-255,66,152697,65,203193
22981,0.002245,74.125.24.0-255,1484,154181,65,203193
22982,0.00226,74.125.24.0-255,3602,157783,65,203193
22983,0.002264,172.31.40.0-255,66,157849,65,203193
22984,0.002272,172.31.40.0-255,66,157915,65,203193
22985,0.002302,172.31.40.0-255,66,157981,65,203193
22986,0.002323,74.125.24.0-255,4320,162301,65,203193
22987,0.002325,172.31.40.0-255,66,162367,65,203193
22988,0.004564,74.125.24.0-255,1484,163851,65,203193
22989,0.004614,74.125.24.0-255,1484,165335,65,203193
22990,0.004618,172.31.40.0-255,66,165401,65,203193
22991,0.004636,74.125.24.0-255,2902,168303,65,203193
22992,0.004638,172.31.40.0-255,66,168369,65,203193
22993,0.006898,74.125.24.0-255,5738,174107,65,203193
22994,0.006904,172.31.40.0-255,66,174173,65,203193
22995,0.009181,74.125.24.0-255,5738,179911,65,203193
22996,0.009203,172.31.40.0-255,66,179977,65,203193
22997,0.011505,74.125.24.0-255,5738,185715,65,203193
22998,0.011522,172.31.40.0-255,66,185781,65,203193
22999,0.013806,74.125.24.0-255,5738,191519,65,203193
23000,0.013819,172.31.40.0-255,66,191585,65,203193
23001,0.016112,74.125.24.0-255,5738,197323,65,203193
23002,0.016118,172.31.40.0-255,66,197389,65,203193
23003,0.018383,74.125.24.0-255,5738,203127,65,203193
23004,0.018393,172.31.40.0-255,66,203193,65,203193
23005,0.0,74.125.200.0-255,150,150,65,283599
23006,2.3e-05,172.31.40.0-255,66,216,65,283599
23007,3.1e-05,74.125.200.0-255,1484,1700,65,283599
23008,3.5e-05,172.31.40.0-255,66,1766,65,283599
23009,4.1e-05,74.125.200.0-255,2902,4668,65,283599
23010,4.6e-05,172.31.40.0-255,66,4734,65,283599
23011,5.3e-05,74.125.200.0-255,5738,10472,65,283599
23012,5.6e-05,172.31.40.0-255,66,10538,65,283599
23013,9.3e-05,74.125.200.0-255,3458,13996,65,283599
23014,9.6e-05,172.31.40.0-255,66,14062,65,283599
23015,0.00014,74.125.200.0-255,4320,18382,65,283599
23016,0.000143,172.31.40.0-255,66,18448,65,283599
23017,0.000165,74.125.200.0-255,5738,24186,65,283599
23018,0.000168,172.31.40.0-255,66,24252,65,283599
23019,0.000201,74.125.200.0-255,2902,27154,65,283599
23020,0.000203,172.31.40.0-255,66,27220,65,283599
23021,0.000224,74.125.200.0-255,3961,31181,65,283599
23022,0.000227,172.31.40.0-255,66,31247,65,283599
23023,0.000234,74.125.200.0-255,7156,38403,65,283599
23024,0.000237,172.31.40.0-255,66,38469,65,283599
23025,0.000302,74.125.200.0-255,4320,42789,65,283599
23026,0.000305,172.31.40.0-255,66,42855,65,283599
23027,0.000326,74.125.200.0-255,5379,48234,65,283599
23028,0.000329,172.31.40.0-255,66,48300,65,283599
23029,0.000359,74.125.200.0-255,1484,49784,65,283599
23030,0.000362,172.31.40.0-255,66,49850,65,283599
23031,0.000382,74.125.200.0-255,2902,52752,65,283599
23032,0.000385,172.31.40.0-255,66,52818,65,283599
23033,0.000388,74.125.200.0-255,1484,54302,65,283599
23034,0.000389,172.31.40.0-255,66,54368,65,283599
23035,0.000394,74.125.200.0-255,2902,57270,65,283599
23036,0.000398,172.31.40.0-255,66,57336,65,283599
23037,0.000401,74.125.200.0-255,1484,58820,65,283599
23038,0.000426,74.125.200.0-255,4320,63140,65,283599
23039,0.000429,172.31.40.0-255,66,63206,65,283599
23040,0.000434,74.125.200.0-255,3124,66330,65,283599
23041,0.000437,172.31.40.0-255,66,66396,65,283599
23042,0.000512,74.125.200.0-255,1484,67880,65,283599
23043,0.000529,74.125.200.0-255,2902,70782,65,283599
23044,0.000533,172.31.40.0-255,66,70848,65,283599
23045,0.000536,74.125.200.0-255,1484,72332,65,283599
23046,0.000554,74.125.200.0-255,2902,75234,65,283599
23047,0.000556,172.31.40.0-255,66,75300,65,283599
23048,0.000596,172.31.40.0-255,66,75366,65,283599
23049,0.000608,74.125.200.0-255,4320,79686,65,283599
23050,0.000611,172.31.40.0-255,66,79752,65,283599
23051,0.00064,74.125.200.0-255,1484,81236,65,283599
23052,0.000678,172.31.40.0-255,66,81302,65,283599
23053,0.000712,74.125.200.0-255,1484,82786,65,283599
23054,0.000731,74.125.200.0-255,2902,85688,65,283599
23055,0.000735,172.31.40.0-255,66,85754,65,283599
23056,0.000756,74.125.200.0-255,4320,90074,65,283599
23057,0.000759,172.31.40.0-255,66,90140,65,283599
23058,0.000763,74.125.200.0-255,1484,91624,65,283599
23059,0.000789,74.125.200.0-255,7156,98780,65,283599
23060,0.000792,172.31.40.0-255,66,98846,65,283599
23061,0.000799,74.125.200.0-255,5738,104584,65,283599
23062,0.000801,172.31.40.0-255,66,104650,65,283599
23063,0.000816,74.125.200.0-255,4320,108970,65,283599
23064,0.00082,172.31.40.0-255,66,109036,65,283599
23065,0.000859,74.125.200.0-255,6438,115474,65,283599
23066,0.000863,172.31.40.0-255,66,115540,65,283599
23067,0.000896,74.125.200.0-255,1484,117024,65,283599
23068,0.000901,74.125.200.0-255,2902,119926,65,283599
23069,0.000903,172.31.40.0-255,66,119992,65,283599
23070,0.000924,74.125.200.0-255,2902,122894,65,283599
23071,0.000926,172.31.40.0-255,66,122960,65,283599
23072,0.000944,74.125.200.0-255,2902,125862,65,283599
23073,0.000947,172.31.40.0-255,66,125928,65,283599
23074,0.000954,74.125.200.0-255,5738,131666,65,283599
23075,0.000956,172.31.40.0-255,66,131732,65,283599
23076,0.000961,74.125.200.0-255,4320,136052,65,283599
23077,0.000963,172.31.40.0-255,66,136118,65,283599
23078,0.000978,74.125.200.0-255,2902,139020,65,283599
23079,0.00098,172.31.40.0-255,66,139086,65,283599
23080,0.001023,74.125.200.0-255,1484,140570,65,283599
23081,0.001055,74.125.200.0-255,2902,143472,65,283599
23082,0.001058,172.31.40.0-255,66,143538,65,283599
23083,0.001065,74.125.200.0-255,5738,149276,65,283599
23084,0.001068,172.31.40.0-255,66,149342,65,283599
23085,0.001071,74.125.200.0-255,766,150108,65,283599
23086,0.001075,74.125.200.0-255,2902,153010,65,283599
23087,0.001077,172.31.40.0-255,66,153076,65,283599
23088,0.001105,74.125.200.0-255,5738,158814,65,283599
23089,0.001108,172.31.40.0-255,66,158880,65,283599
23090,0.001115,74.125.200.0-255,5738,164618,65,283599
23091,0.001117,172.31.40.0-255,66,164684,65,283599
23092,0.001129,74.125.200.0-255,1484,166168,65,283599
23093,0.001167,74.125.200.0-255,5738,171906,65,283599
23094,0.001171,172.31.40.0-255,66,171972,65,283599
23095,0.001192,74.125.200.0-255,2902,174874,65,283599
23096,0.001195,172.31.40.0-255,66,174940,65,283599
23097,0.001199,74.125.200.0-255,2902,177842,65,283599
23098,0.001201,172.31.40.0-255,66,177908,65,283599
23099,0.001232,74.125.200.0-255,6438,184346,65,283599
23100,0.001234,172.31.40.0-255,66,184412,65,283599
23101,0.001237,74.125.200.0-255,1484,185896,65,283599
23102,0.001285,172.31.40.0-255,66,185962,65,283599
23103,0.001388,74.125.200.0-255,5738,191700,65,283599
23104,0.001392,172.31.40.0-255,66,191766,65,283599
23105,0.001418,172.31.40.0-255,66,191832,65,283599
23106,0.001433,74.125.200.0-255,5738,197570,65,283599
23107,0.001436,172.31.40.0-255,66,197636,65,283599
23108,0.001463,172.31.40.0-255,66,197702,65,283599
23109,0.001501,74.125.200.0-255,4320,202022,65,283599
23110,0.001504,172.31.40.0-255,66,202088,65,283599
23111,0.001536,172.31.40.0-255,66,202154,65,283599
23112,0.001586,74.125.200.0-255,3602,205756,65,283599
23113,0.00159,172.31.40.0-255,66,205822,65,283599
23114,0.001595,74.125.200.0-255,4320,210142,65,283599
23115,0.001598,172.31.40.0-255,66,210208,65,283599
23116,0.001619,74.125.200.0-255,5738,215946,65,283599
23117,0.001622,172.31.40.0-255,66,216012,65,283599
23118,0.001644,74.125.200.0-255,5738,221750,65,283599
23119,0.001647,172.31.40.0-255,66,221816,65,283599
23120,0.001682,74.125.200.0-255,5738,227554,65,283599
23121,0.001686,172.31.40.0-255,66,227620,65,283599
23122,0.001708,74.125.200.0-255,7156,234776,65,283599
23123,0.00171,172.31.40.0-255,66,234842,65,283599
23124,0.001729,74.125.200.0-255,4320,239162,65,283599
23125,0.001731,172.31.40.0-255,66,239228,65,283599
23126,0.001742,74.125.200.0-255,766,239994,65,283599
23127,0.001859,74.125.200.0-255,1484,241478,65,283599
23128,0.001863,172.31.40.0-255,66,241544,65,283599
23129,0.001886,74.125.200.0-255,2902,244446,65,283599
23130,0.001889,172.31.40.0-255,66,244512,65,283599
23131,0.001895,74.125.200.0-255,5738,250250,65,283599
23132,0.001897,172.31.40.0-255,66,250316,65,283599
23133,0.001914,74.125.200.0-255,5738,256054,65,283599
23134,0.001916,172.31.40.0-255,66,256120,65,283599
23135,0.001931,74.125.200.0-255,1484,257604,65,283599
23136,0.001948,74.125.200.0-255,4320,261924,65,283599
23137,0.001951,172.31.40.0-255,66,261990,65,283599
23138,0.001976,172.31.40.0-255,66,262056,65,283599
23139,0.002019,74.125.200.0-255,2902,264958,65,283599
23140,0.002022,172.31.40.0-255,66,265024,65,283599
23141,0.002062,172.31.40.0-255,66,265090,65,283599
23142,0.002089,74.125.200.0-255,1484,266574,65,283599
23143,0.002123,172.31.40.0-255,66,266640,65,283599
23144,0.002176,74.125.200.0-255,4320,270960,65,283599
23145,0.002179,172.31.40.0-255,66,271026,65,283599
23146,0.002196,74.125.200.0-255,766,271792,65,283599
23147,0.002198,74.125.200.0-255,1484,273276,65,283599
23148,0.002204,172.31.40.0-255,66,273342,65,283599
23149,0.002232,172.31.40.0-255,66,273408,65,283599
23150,0.002268,172.31.40.0-255,66,273474,65,283599
23151,0.002324,74.125.200.0-255,4320,277794,65,283599
23152,0.002333,172.31.40.0-255,66,277860,65,283599
23153,0.00234,74.125.200.0-255,4809,282669,65,283599
23154,0.002343,172.31.40.0-255,66,282735,65,283599
23155,0.002346,74.125.200.0-255,168,282903,65,283599
23156,0.004737,172.31.40.0-255,105,283008,65,283599
23157,0.004771,172.31.40.0-255,105,283113,65,283599
23158,0.005027,172.31.40.0-255,90,283203,65,283599
23159,0.005037,172.31.40.0-255,66,283269,65,283599
23160,0.006971,74.125.200.0-255,66,283335,65,283599
23161,0.006991,74.125.200.0-255,66,283401,65,283599
23162,0.007244,74.125.200.0-255,66,283467,65,283599
23163,0.007287,74.125.200.0-255,66,283533,65,283599
23164,0.007293,172.31.40.0-255,66,283599,65,283599
23165,0.0,172.217.194.0-255,153,153,65,211919
23166,1.4e-05,172.31.40.0-255,66,219,65,211919
23167,2.1e-05,172.217.194.0-255,1484,1703,65,211919
23168,2.6e-05,172.31.40.0-255,66,1769,65,211919
23169,3.2e-05,172.217.194.0-255,2902,4671,65,211919
23170,4.5e-05,172.31.40.0-255,66,4737,65,211919
23171,7.1e-05,172.217.194.0-255,1484,6221,65,211919
23172,7.5e-05,172.31.40.0-255,66,6287,65,211919
23173,9.9e-05,172.217.194.0-255,5738,12025,65,211919
23174,0.000102,172.31.40.0-255,66,12091,65,211919
23175,0.000106,172.217.194.0-255,2003,14094,65,211919
23176,0.000108,172.31.40.0-255,66,14160,65,211919
23177,0.000152,172.217.194.0-255,2902,17062,65,211919
23178,0.000155,172.31.40.0-255,66,17128,65,211919
23179,0.00016,172.217.194.0-255,4320,21448,65,211919
23180,0.000162,172.31.40.0-255,66,21514,65,211919
23181,0.000197,172.31.40.0-255,66,21580,65,211919
23182,0.000202,172.217.194.0-255,2902,24482,65,211919
23183,0.000204,172.31.40.0-255,66,24548,65,211919
23184,0.000254,172.31.40.0-255,66,24614,65,211919
23185,0.000258,172.217.194.0-255,2543,27157,65,211919
23186,0.00026,172.31.40.0-255,66,27223,65,211919
23187,0.001026,172.217.194.0-255,1484,28707,65,211919
23188,0.001032,172.31.40.0-255,66,28773,65,211919
23189,0.001042,172.217.194.0-255,2902,31675,65,211919
23190,0.001044,172.31.40.0-255,66,31741,65,211919
23191,0.001057,172.217.194.0-255,5738,37479,65,211919
23192,0.001059,172.31.40.0-255,66,37545,65,211919
23193,0.001088,172.217.194.0-255,6797,44342,65,211919
23194,0.001095,172.31.40.0-255,66,44408,65,211919
23195,0.001099,172.217.194.0-255,1484,45892,65,211919
23196,0.001136,172.31.40.0-255,66,45958,65,211919
23197,0.001141,172.217.194.0-255,2543,48501,65,211919
23198,0.001143,172.31.40.0-255,66,48567,65,211919
23199,0.001241,172.217.194.0-255,1484,50051,65,211919
23200,0.001248,172.217.194.0-255,2902,52953,65,211919
23201,0.001251,172.31.40.0-255,66,53019,65,211919
23202,0.001274,172.217.194.0-255,5738,58757,65,211919
23203,0.00128,172.217.194.0-255,5738,64495,65,211919
23204,0.001315,172.217.194.0-255,1125,65620,65,211919
23205,0.001367,172.217.194.0-255,1484,67104,65,211919
23206,0.001372,172.217.194.0-255,2902,70006,65,211919
23207,0.0014,172.217.194.0-255,2902,72908,65,211919
23208,0.001413,172.217.194.0-255,2902,75810,65,211919
23209,0.001416,172.217.194.0-255,1484,77294,65,211919
23210,0.001439,172.217.194.0-255,5365,82659,65,211919
23211,0.001541,172.217.194.0-255,1484,84143,65,211919
23212,0.001547,172.217.194.0-255,2902,87045,65,211919
23213,0.001553,172.217.194.0-255,5738,92783,65,211919
23214,0.001556,172.217.194.0-255,1484,94267,65,211919
23215,0.00159,172.217.194.0-255,2902,97169,65,211919
23216,0.001919,172.217.194.0-255,1484,98653,65,211919
23217,0.001927,172.217.194.0-255,2902,101555,65,211919
23218,0.00193,172.217.194.0-255,1484,103039,65,211919
23219,0.00195,172.217.194.0-255,4320,107359,65,211919
23220,0.001968,172.217.194.0-255,5738,113097,65,211919
23221,0.001995,172.217.194.0-255,7156,120253,65,211919
23222,0.002001,172.217.194.0-255,5738,125991,65,211919
23223,0.002033,172.217.194.0-255,5020,131011,65,211919
23224,0.002063,172.217.194.0-255,5738,136749,65,211919
23225,0.002131,172.217.194.0-255,7156,143905,65,211919
23226,0.00215,172.217.194.0-255,6438,150343,65,211919
23227,0.00218,172.217.194.0-255,2902,153245,65,211919
23228,0.002211,172.217.194.0-255,4320,157565,65,211919
23229,0.002217,172.217.194.0-255,5738,163303,65,211919
23230,0.002246,172.217.194.0-255,1484,164787,65,211919
23231,0.002253,172.217.194.0-255,6438,171225,65,211919
23232,0.00271,172.31.40.0-255,66,171291,65,211919
23233,0.005008,172.217.194.0-255,5738,177029,65,211919
23234,0.005027,172.31.40.0-255,66,177095,65,211919
23235,0.007278,172.217.194.0-255,5738,182833,65,211919
23236,0.007299,172.31.40.0-255,66,182899,65,211919
23237,0.009571,172.217.194.0-255,5738,188637,65,211919
23238,0.009586,172.31.40.0-255,66,188703,65,211919
23239,0.011832,172.217.194.0-255,5738,194441,65,211919
23240,0.011845,172.31.40.0-255,66,194507,65,211919
23241,0.014108,172.217.194.0-255,5738,200245,65,211919
23242,0.014124,172.31.40.0-255,66,200311,65,211919
23243,0.016388,172.217.194.0-255,5738,206049,65,211919
23244,0.016393,172.31.40.0-255,66,206115,65,211919
23245,0.018635,172.217.194.0-255,5738,211853,65,211919
23246,0.018652,172.31.40.0-255,66,211919,65,211919
23247,0.0,74.125.68.0-255,431,431,65,132761
23248,1.4e-05,74.125.68.0-255,1484,1915,65,132761
23249,2e-05,172.31.40.0-255,66,1981,65,132761
23250,2.6e-05,74.125.68.0-255,1484,3465,65,132761
23251,4.3e-05,74.125.68.0-255,1484,4949,65,132761
23252,4.6e-05,172.31.40.0-255,66,5015,65,132761
23253,5.3e-05,74.125.68.0-255,5738,10753,65,132761
23254,5.6e-05,172.31.40.0-255,66,10819,65,132761
23255,0.000284,74.125.68.0-255,2902,13721,65,132761
23256,0.000289,172.31.40.0-255,66,13787,65,132761
23257,0.000398,74.125.68.0-255,3449,17236,65,132761
23258,0.000403,172.31.40.0-255,66,17302,65,132761
23259,0.000563,172.31.40.0-255,66,17368,65,132761
23260,0.000944,74.125.68.0-255,4320,21688,65,132761
23261,0.000966,172.31.40.0-255,66,21754,65,132761
23262,0.002557,74.125.68.0-255,5738,27492,65,132761
23263,0.002564,172.31.40.0-255,66,27558,65,132761
23264,0.002681,74.125.68.0-255,5738,33296,65,132761
23265,0.002705,74.125.68.0-255,7156,40452,65,132761
23266,0.003251,74.125.68.0-255,4320,44772,65,132761
23267,0.004069,74.125.68.0-255,5738,50510,65,132761
23268,0.004104,74.125.68.0-255,1484,51994,65,132761
23269,0.004787,74.125.68.0-255,2902,54896,65,132761
23270,0.004801,74.125.68.0-255,4320,59216,65,132761
23271,0.005117,74.125.68.0-255,7156,66372,65,132761
23272,0.005136,74.125.68.0-255,4320,70692,65,132761
23273,0.005763,172.31.40.0-255,66,70758,65,132761
23274,0.006291,172.31.40.0-255,66,70824,65,132761
23275,0.008312,172.31.40.0-255,66,70890,65,132761
23276,0.008338,74.125.68.0-255,7156,78046,65,132761
23277,0.008364,172.31.40.0-255,66,78112,65,132761
23278,0.008428,74.125.68.0-255,4320,82432,65,132761
23279,0.008432,172.31.40.0-255,66,82498,65,132761
23280,0.008469,172.31.40.0-255,66,82564,65,132761
23281,0.008729,74.125.68.0-255,4286,86850,65,132761
23282,0.008734,172.31.40.0-255,66,86916,65,132761
23283,0.008856,74.125.68.0-255,5738,92654,65,132761
23284,0.008862,172.31.40.0-255,66,92720,65,132761
23285,0.008889,172.31.40.0-255,66,92786,65,132761
23286,0.009049,172.31.40.0-255,66,92852,65,132761
23287,0.009072,74.125.68.0-255,5738,98590,65,132761
23288,0.009075,172.31.40.0-255,66,98656,65,132761
23289,0.009336,74.125.68.0-255,5738,104394,65,132761
23290,0.009341,172.31.40.0-255,66,104460,65,132761
23291,0.009371,172.31.40.0-255,66,104526,65,132761
23292,0.009651,172.31.40.0-255,66,104592,65,132761
23293,0.010854,172.31.40.0-255,66,104658,65,132761
23294,0.010951,74.125.68.0-255,2902,107560,65,132761
23295,0.010955,172.31.40.0-255,66,107626,65,132761
23296,0.01098,172.31.40.0-255,66,107692,65,132761
23297,0.011212,74.125.68.0-255,5738,113430,65,132761
23298,0.011217,172.31.40.0-255,66,113496,65,132761
23299,0.011263,172.31.40.0-255,66,113562,65,132761
23300,0.011749,74.125.68.0-255,7156,120718,65,132761
23301,0.011754,172.31.40.0-255,66,120784,65,132761
23302,0.011821,172.31.40.0-255,66,120850,65,132761
23303,0.012333,74.125.68.0-255,5738,126588,65,132761
23304,0.012338,172.31.40.0-255,66,126654,65,132761
23305,0.012381,172.31.40.0-255,66,126720,65,132761
23306,0.012914,74.125.68.0-255,5738,132458,65,132761
23307,0.012919,172.31.40.0-255,66,132524,65,132761
23308,0.015008,172.31.40.0-255,66,132590,65,132761
23309,0.016125,172.31.40.0-255,105,132695,65,132761
23310,0.018616,74.125.68.0-255,66,132761,65,132761
23311,0.0,172.217.194.0-255,146,146,65,198311
23312,2e-05,172.31.40.0-255,66,212,65,198311
23313,2.7e-05,172.217.194.0-255,1484,1696,65,198311
23314,3.2e-05,172.31.40.0-255,66,1762,65,198311
23315,3.8e-05,172.217.194.0-255,2902,4664,65,198311
23316,4.1e-05,172.31.40.0-255,66,4730,65,198311
23317,4.6e-05,172.217.194.0-255,4320,9050,65,198311
23318,5e-05,172.31.40.0-255,66,9116,65,198311
23319,9.4e-05,172.217.194.0-255,4865,13981,65,198311
23320,9.8e-05,172.31.40.0-255,66,14047,65,198311
23321,0.000119,172.217.194.0-255,4320,18367,65,198311
23322,0.000122,172.31.40.0-255,66,18433,65,198311
23323,0.00014,172.217.194.0-255,1484,19917,65,198311
23324,0.000142,172.31.40.0-255,66,19983,65,198311
23325,0.00015,172.217.194.0-255,7156,27139,65,198311
23326,0.000153,172.31.40.0-255,66,27205,65,198311
23327,0.00019,172.217.194.0-255,7156,34361,65,198311
23328,0.000194,172.31.40.0-255,66,34427,65,198311
23329,0.000221,172.31.40.0-255,66,34493,65,198311
23330,0.000247,172.217.194.0-255,5379,39872,65,198311
23331,0.000249,172.31.40.0-255,66,39938,65,198311
23332,0.000287,172.217.194.0-255,5738,45676,65,198311
23333,0.000289,172.31.40.0-255,66,45742,65,198311
23334,0.000295,172.217.194.0-255,4320,50062,65,198311
23335,0.000298,172.31.40.0-255,66,50128,65,198311
23336,0.000347,172.217.194.0-255,6797,56925,65,198311
23337,0.00035,172.31.40.0-255,66,56991,65,198311
23338,0.000368,172.217.194.0-255,646,57637,65,198311
23339,0.00037,172.31.40.0-255,66,57703,65,198311
23340,0.000434,172.217.194.0-255,1484,59187,65,198311
23341,0.000438,172.31.40.0-255,66,59253,65,198311
23342,0.000443,172.217.194.0-255,2902,62155,65,198311
23343,0.000446,172.31.40.0-255,66,62221,65,198311
23344,0.000452,172.217.194.0-255,5738,67959,65,198311
23345,0.000455,172.31.40.0-255,66,68025,65,198311
23346,0.000499,172.31.40.0-255,66,68091,65,198311
23347,0.000511,172.31.40.0-255,66,68157,65,198311
23348,0.000562,172.217.194.0-255,1484,69641,65,198311
23349,0.00058,172.217.194.0-255,2902,72543,65,198311
23350,0.000583,172.31.40.0-255,66,72609,65,198311
23351,0.00059,172.217.194.0-255,5738,78347,65,198311
23352,0.000592,172.31.40.0-255,66,78413,65,198311
23353,0.000598,172.217.194.0-255,5738,84151,65,198311
23354,0.0006,172.31.40.0-255,66,84217,65,198311
23355,0.000622,172.217.194.0-255,576,84793,65,198311
23356,0.000714,172.217.194.0-255,1484,86277,65,198311
23357,0.000718,172.31.40.0-255,66,86343,65,198311
23358,0.000724,172.217.194.0-255,2902,89245,65,198311
23359,0.000726,172.31.40.0-255,66,89311,65,198311
23360,0.000761,172.217.194.0-255,5738,95049,65,198311
23361,0.000765,172.31.40.0-255,66,95115,65,198311
23362,0.000771,172.217.194.0-255,5738,100853,65,198311
23363,0.000773,172.31.40.0-255,66,100919,65,198311
23364,0.000787,172.31.40.0-255,66,100985,65,198311
23365,0.000801,172.217.194.0-255,1484,102469,65,198311
23366,0.000825,172.217.194.0-255,5020,107489,65,198311
23367,0.000828,172.31.40.0-255,66,107555,65,198311
23368,0.000851,172.217.194.0-255,5738,113293,65,198311
23369,0.000854,172.31.40.0-255,66,113359,65,198311
23370,0.000857,172.217.194.0-255,1484,114843,65,198311
23371,0.000886,172.31.40.0-255,66,114909,65,198311
23372,0.000914,172.217.194.0-255,4320,119229,65,198311
23373,0.000917,172.31.40.0-255,66,119295,65,198311
23374,0.000949,172.31.40.0-255,66,119361,65,198311
23375,0.000956,172.217.194.0-255,5738,125099,65,198311
23376,0.000959,172.31.40.0-255,66,125165,65,198311
23377,0.000993,172.217.194.0-255,7156,132321,65,198311
23378,0.000996,172.31.40.0-255,66,132387,65,198311
23379,0.001011,172.31.40.0-255,66,132453,65,198311
23380,0.001018,172.217.194.0-255,6438,138891,65,198311
23381,0.00102,172.31.40.0-255,66,138957,65,198311
23382,0.00111,172.217.194.0-255,1484,140441,65,198311
23383,0.001115,172.217.194.0-255,2902,143343,65,198311
23384,0.001117,172.31.40.0-255,66,143409,65,198311
23385,0.00112,172.217.194.0-255,1484,144893,65,198311
23386,0.001141,172.217.194.0-255,4320,149213,65,198311
23387,0.001143,172.31.40.0-255,66,149279,65,198311
23388,0.001172,172.31.40.0-255,66,149345,65,198311
23389,0.001228,172.31.40.0-255,66,149411,65,198311
23390,0.001325,172.217.194.0-255,1484,150895,65,198311
23391,0.001333,172.217.194.0-255,2902,153797,65,198311
23392,0.001336,172.31.40.0-255,66,153863,65,198311
23393,0.001341,172.217.194.0-255,2902,156765,65,198311
23394,0.001342,172.31.40.0-255,66,156831,65,198311
23395,0.001361,172.217.194.0-255,2902,159733,65,198311
23396,0.001363,172.31.40.0-255,66,159799,65,198311
23397,0.001369,172.217.194.0-255,5738,165537,65,198311
23398,0.00137,172.31.40.0-255,66,165603,65,198311
23399,0.001406,172.31.40.0-255,66,165669,65,198311
23400,0.001411,172.217.194.0-255,5020,170689,65,198311
23401,0.001413,172.31.40.0-255,66,170755,65,198311
23402,0.001448,172.217.194.0-255,1484,172239,65,198311
23403,0.001453,172.217.194.0-255,2902,175141,65,198311
23404,0.001455,172.31.40.0-255,66,175207,65,198311
23405,0.001477,172.217.194.0-255,5738,180945,65,198311
23406,0.001479,172.31.40.0-255,66,181011,65,198311
23407,0.00152,172.217.194.0-255,2902,183913,65,198311
23408,0.001539,172.31.40.0-255,66,183979,65,198311
23409,0.001567,172.217.194.0-255,4320,188299,65,198311
23410,0.001577,172.31.40.0-255,66,188365,65,198311
23411,0.001602,172.31.40.0-255,66,188431,65,198311
23412,0.001631,172.217.194.0-255,3602,192033,65,198311
23413,0.001642,172.31.40.0-255,66,192099,65,198311
23414,0.00166,172.217.194.0-255,5738,197837,65,198311
23415,0.001672,172.31.40.0-255,66,197903,65,198311
23416,0.001717,172.31.40.0-255,66,197969,65,198311
23417,0.001754,172.217.194.0-255,105,198074,65,198311
23418,0.001761,172.31.40.0-255,66,198140,65,198311
23419,0.017346,172.31.40.0-255,105,198245,65,198311
23420,0.019651,172.217.194.0-255,66,198311,65,198311
23421,0.0,172.31.40.0-255,105,105,65,459
23422,0.00024,172.31.40.0-255,90,195,65,459
23423,0.000251,172.31.40.0-255,66,261,65,459
23424,0.002781,172.217.194.0-255,66,327,65,459
23425,0.002801,172.217.194.0-255,66,393,65,459
23426,0.002816,172.31.40.0-255,66,459,65,459
23427,0.0,172.217.194.0-255,153,153,65,195119
23428,2.2e-05,172.31.40.0-255,66,219,65,195119
23429,2.9e-05,172.217.194.0-255,1484,1703,65,195119
23430,3.3e-05,172.31.40.0-255,66,1769,65,195119
23431,3.9e-05,172.217.194.0-255,2902,4671,65,195119
23432,4.3e-05,172.31.40.0-255,66,4737,65,195119
23433,4.8e-05,172.217.194.0-255,2902,7639,65,195119
23434,5.1e-05,172.31.40.0-255,66,7705,65,195119
23435,5.7e-05,172.217.194.0-255,4320,12025,65,195119
23436,6e-05,172.31.40.0-255,66,12091,65,195119
23437,9.6e-05,172.31.40.0-255,66,12157,65,195119
23438,0.000103,172.217.194.0-255,5738,17895,65,195119
23439,0.000106,172.31.40.0-255,66,17961,65,195119
23440,0.00013,172.217.194.0-255,1484,19445,65,195119
23441,0.000132,172.31.40.0-255,66,19511,65,195119
23442,0.000152,172.217.194.0-255,2543,22054,65,195119
23443,0.000154,172.31.40.0-255,66,22120,65,195119
23444,0.000184,172.217.194.0-255,1484,23604,65,195119
23445,0.000188,172.31.40.0-255,66,23670,65,195119
23446,0.000192,172.217.194.0-255,2902,26572,65,195119
23447,0.000194,172.31.40.0-255,66,26638,65,195119
23448,0.000222,172.217.194.0-255,4320,30958,65,195119
23449,0.000225,172.31.40.0-255,66,31024,65,195119
23450,0.000245,172.217.194.0-255,1484,32508,65,195119
23451,0.000248,172.31.40.0-255,66,32574,65,195119
23452,0.000251,172.217.194.0-255,1484,34058,65,195119
23453,0.000253,172.31.40.0-255,66,34124,65,195119
23454,0.000259,172.217.194.0-255,2902,37026,65,195119
23455,0.000261,172.31.40.0-255,66,37092,65,195119
23456,0.000283,172.217.194.0-255,2543,39635,65,195119
23457,0.000286,172.31.40.0-255,66,39701,65,195119
23458,0.000314,172.217.194.0-255,2902,42603,65,195119
23459,0.000317,172.31.40.0-255,66,42669,65,195119
23460,0.000341,172.217.194.0-255,7156,49825,65,195119
23461,0.000344,172.31.40.0-255,66,49891,65,195119
23462,0.00035,172.217.194.0-255,5738,55629,65,195119
23463,0.000353,172.31.40.0-255,66,55695,65,195119
23464,0.000385,172.217.194.0-255,1484,57179,65,195119
23465,0.000397,172.217.194.0-255,320,57499,65,195119
23466,0.0004,172.31.40.0-255,66,57565,65,195119
23467,0.000499,172.217.194.0-255,1484,59049,65,195119
23468,0.000503,172.217.194.0-255,1484,60533,65,195119
23469,0.000506,172.31.40.0-255,66,60599,65,195119
23470,0.000527,172.217.194.0-255,1484,62083,65,195119
23471,0.000534,172.217.194.0-255,5738,67821,65,195119
23472,0.000537,172.31.40.0-255,66,67887,65,195119
23473,0.000541,172.217.194.0-255,1484,69371,65,195119
23474,0.000558,172.217.194.0-255,7156,76527,65,195119
23475,0.000561,172.31.40.0-255,66,76593,65,195119
23476,0.000588,172.217.194.0-255,5379,81972,65,195119
23477,0.000591,172.31.40.0-255,66,82038,65,195119
23478,0.000612,172.31.40.0-255,66,82104,65,195119
23479,0.000634,172.217.194.0-255,1125,83229,65,195119
23480,0.001178,172.217.194.0-255,1484,84713,65,195119
23481,0.001183,172.31.40.0-255,66,84779,65,195119
23482,0.001189,172.217.194.0-255,2902,87681,65,195119
23483,0.001191,172.31.40.0-255,66,87747,65,195119
23484,0.001216,172.217.194.0-255,5738,93485,65,195119
23485,0.001219,172.31.40.0-255,66,93551,65,195119
23486,0.001242,172.31.40.0-255,66,93617,65,195119
23487,0.001258,172.217.194.0-255,2902,96519,65,195119
23488,0.00127,172.217.194.0-255,766,97285,65,195119
23489,0.001273,172.31.40.0-255,66,97351,65,195119
23490,0.001281,172.31.40.0-255,66,97417,65,195119
23491,0.001693,172.217.194.0-255,1484,98901,65,195119
23492,0.001698,172.31.40.0-255,66,98967,65,195119
23493,0.001704,172.217.194.0-255,2902,101869,65,195119
23494,0.001706,172.31.40.0-255,66,101935,65,195119
23495,0.00171,172.217.194.0-255,2902,104837,65,195119
23496,0.001712,172.31.40.0-255,66,104903,65,195119
23497,0.001734,172.217.194.0-255,2902,107805,65,195119
23498,0.001737,172.31.40.0-255,66,107871,65,195119
23499,0.001754,172.217.194.0-255,2902,110773,65,195119
23500,0.001756,172.31.40.0-255,66,110839,65,195119
23501,0.001785,172.31.40.0-255,66,110905,65,195119
23502,0.001798,172.31.40.0-255,66,110971,65,195119
23503,0.001807,172.217.194.0-255,766,111737,65,195119
23504,0.001892,172.217.194.0-255,1484,113221,65,195119
23505,0.001896,172.31.40.0-255,66,113287,65,195119
23506,0.001901,172.217.194.0-255,2902,116189,65,195119
23507,0.001904,172.31.40.0-255,66,116255,65,195119
23508,0.001938,172.217.194.0-255,2902,119157,65,195119
23509,0.001941,172.31.40.0-255,66,119223,65,195119
23510,0.001964,172.217.194.0-255,2902,122125,65,195119
23511,0.001967,172.31.40.0-255,66,122191,65,195119
23512,0.00198,172.31.40.0-255,66,122257,65,195119
23513,0.001988,172.217.194.0-255,7156,129413,65,195119
23514,0.00199,172.31.40.0-255,66,129479,65,195119
23515,0.001995,172.217.194.0-255,3602,133081,65,195119
23516,0.001997,172.31.40.0-255,66,133147,65,195119
23517,0.002207,172.217.194.0-255,1484,134631,65,195119
23518,0.002234,172.217.194.0-255,2902,137533,65,195119
23519,0.002238,172.31.40.0-255,66,137599,65,195119
23520,0.002245,172.217.194.0-255,5738,143337,65,195119
23521,0.002247,172.31.40.0-255,66,143403,65,195119
23522,0.002251,172.217.194.0-255,2902,146305,65,195119
23523,0.002253,172.31.40.0-255,66,146371,65,195119
23524,0.00228,172.217.194.0-255,2902,149273,65,195119
23525,0.002282,172.31.40.0-255,66,149339,65,195119
23526,0.002296,172.31.40.0-255,66,149405,65,195119
23527,0.002302,172.217.194.0-255,5020,154425,65,195119
23528,0.002304,172.31.40.0-255,66,154491,65,195119
23529,0.004624,172.217.194.0-255,5738,160229,65,195119
23530,0.004631,172.31.40.0-255,66,160295,65,195119
23531,0.006916,172.217.194.0-255,5738,166033,65,195119
23532,0.00692,172.31.40.0-255,66,166099,65,195119
23533,0.009198,172.217.194.0-255,5738,171837,65,195119
23534,0.009207,172.31.40.0-255,66,171903,65,195119
23535,0.011517,172.217.194.0-255,5738,177641,65,195119
23536,0.011535,172.31.40.0-255,66,177707,65,195119
23537,0.01382,172.217.194.0-255,5738,183445,65,195119
23538,0.013834,172.31.40.0-255,66,183511,65,195119
23539,0.016122,172.217.194.0-255,5738,189249,65,195119
23540,0.016137,172.31.40.0-255,66,189315,65,195119
23541,0.018433,172.217.194.0-255,5738,195053,65,195119
23542,0.018447,172.31.40.0-255,66,195119,65,195119
23543,0.0,172.217.194.0-255,153,153,65,205421
23544,2.2e-05,172.31.40.0-255,66,219,65,205421
23545,2.9e-05,172.217.194.0-255,1484,1703,65,205421
23546,3.3e-05,172.31.40.0-255,66,1769,65,205421
23547,3.8e-05,172.217.194.0-255,2902,4671,65,205421
23548,4.2e-05,172.31.40.0-255,66,4737,65,205421
23549,5e-05,172.217.194.0-255,7156,11893,65,205421
23550,5.2e-05,172.31.40.0-255,66,11959,65,205421
23551,8.9e-05,172.31.40.0-255,66,12025,65,205421
23552,0.00012,172.31.40.0-255,66,12091,65,205421
23553,0.000172,172.217.194.0-255,1484,13575,65,205421
23554,0.000175,172.31.40.0-255,66,13641,65,205421
23555,0.00018,172.217.194.0-255,2902,16543,65,205421
23556,0.000182,172.31.40.0-255,66,16609,65,205421
23557,0.000215,172.217.194.0-255,5738,22347,65,205421
23558,0.000218,172.31.40.0-255,66,22413,65,205421
23559,0.000225,172.217.194.0-255,6797,29210,65,205421
23560,0.000227,172.31.40.0-255,66,29276,65,205421
23561,0.000252,172.217.194.0-255,5738,35014,65,205421
23562,0.000254,172.31.40.0-255,66,35080,65,205421
23563,0.00028,172.217.194.0-255,5738,40818,65,205421
23564,0.000283,172.31.40.0-255,66,40884,65,205421
23565,0.000299,172.217.194.0-255,6001,46885,65,205421
23566,0.000301,172.31.40.0-255,66,46951,65,205421
23567,0.000462,172.217.194.0-255,1484,48435,65,205421
23568,0.000467,172.31.40.0-255,66,48501,65,205421
23569,0.000472,172.217.194.0-255,2902,51403,65,205421
23570,0.000475,172.31.40.0-255,66,51469,65,205421
23571,0.000496,172.217.194.0-255,5738,57207,65,205421
23572,0.000499,172.31.40.0-255,66,57273,65,205421
23573,0.000503,172.217.194.0-255,2902,60175,65,205421
23574,0.000505,172.31.40.0-255,66,60241,65,205421
23575,0.000543,172.31.40.0-255,66,60307,65,205421
23576,0.000576,172.31.40.0-255,66,60373,65,205421
23577,0.001174,172.217.194.0-255,1484,61857,65,205421
23578,0.001181,172.217.194.0-255,2902,64759,65,205421
23579,0.001184,172.31.40.0-255,66,64825,65,205421
23580,0.001192,172.217.194.0-255,5738,70563,65,205421
23581,0.001194,172.31.40.0-255,66,70629,65,205421
23582,0.001223,172.217.194.0-255,7156,77785,65,205421
23583,0.001226,172.31.40.0-255,66,77851,65,205421
23584,0.001248,172.217.194.0-255,5738,83589,65,205421
23585,0.00125,172.31.40.0-255,66,83655,65,205421
23586,0.001254,172.217.194.0-255,1484,85139,65,205421
23587,0.001278,172.31.40.0-255,66,85205,65,205421
23588,0.001315,172.31.40.0-255,66,85271,65,205421
23589,0.001333,172.217.194.0-255,1484,86755,65,205421
23590,0.001339,172.217.194.0-255,4320,91075,65,205421
23591,0.001342,172.31.40.0-255,66,91141,65,205421
23592,0.001398,172.217.194.0-255,3602,94743,65,205421
23593,0.001402,172.31.40.0-255,66,94809,65,205421
23594,0.001405,172.31.40.0-255,66,94875,65,205421
23595,0.001576,172.217.194.0-255,1484,96359,65,205421
23596,0.001581,172.217.194.0-255,2902,99261,65,205421
23597,0.001584,172.31.40.0-255,66,99327,65,205421
23598,0.001605,172.217.194.0-255,4320,103647,65,205421
23599,0.001607,172.31.40.0-255,66,103713,65,205421
23600,0.00162,172.217.194.0-255,1484,105197,65,205421
23601,0.001626,172.217.194.0-255,5738,110935,65,205421
23602,0.001628,172.31.40.0-255,66,111001,65,205421
23603,0.001659,172.31.40.0-255,66,111067,65,205421
23604,0.001678,172.217.194.0-255,5020,116087,65,205421
23605,0.00168,172.31.40.0-255,66,116153,65,205421
23606,0.001754,172.217.194.0-255,1484,117637,65,205421
23607,0.001759,172.217.194.0-255,2902,120539,65,205421
23608,0.001762,172.31.40.0-255,66,120605,65,205421
23609,0.001765,172.217.194.0-255,1484,122089,65,205421
23610,0.001782,172.217.194.0-255,4320,126409,65,205421
23611,0.001785,172.31.40.0-255,66,126475,65,205421
23612,0.001798,172.217.194.0-255,4320,130795,65,205421
23613,0.001803,172.31.40.0-255,66,130861,65,205421
23614,0.001831,172.31.40.0-255,66,130927,65,205421
23615,0.001841,172.31.40.0-255,66,130993,65,205421
23616,0.001857,172.217.194.0-255,2184,133177,65,205421
23617,0.001859,172.31.40.0-255,66,133243,65,205421
23618,0.00187,172.31.40.0-255,66,133309,65,205421
23619,0.001908,172.31.40.0-255,66,133375,65,205421
23620,0.001941,172.217.194.0-255,2902,136277,65,205421
23621,0.001943,172.31.40.0-255,66,136343,65,205421
23622,0.001978,172.31.40.0-255,66,136409,65,205421
23623,0.001981,172.217.194.0-255,1484,137893,65,205421
23624,0.002009,172.31.40.0-255,66,137959,65,205421
23625,0.002027,172.217.194.0-255,2184,140143,65,205421
23626,0.00203,172.31.40.0-255,66,140209,65,205421
23627,0.002056,172.217.194.0-255,1484,141693,65,205421
23628,0.002061,172.217.194.0-255,2902,144595,65,205421
23629,0.002064,172.31.40.0-255,66,144661,65,205421
23630,0.002069,172.217.194.0-255,5738,150399,65,205421
23631,0.002071,172.31.40.0-255,66,150465,65,205421
23632,0.00211,172.31.40.0-255,66,150531,65,205421
23633,0.002142,172.217.194.0-255,7156,157687,65,205421
23634,0.002145,172.31.40.0-255,66,157753,65,205421
23635,0.002172,172.217.194.0-255,1484,159237,65,205421
23636,0.002202,172.31.40.0-255,66,159303,65,205421
23637,0.002219,172.217.194.0-255,2902,162205,65,205421
23638,0.002222,172.31.40.0-255,66,162271,65,205421
23639,0.002228,172.217.194.0-255,5738,168009,65,205421
23640,0.00223,172.31.40.0-255,66,168075,65,205421
23641,0.002242,172.31.40.0-255,66,168141,65,205421
23642,0.002252,172.31.40.0-255,66,168207,65,205421
23643,0.002282,172.217.194.0-255,2902,171109,65,205421
23644,0.002284,172.31.40.0-255,66,171175,65,205421
23645,0.0023,172.217.194.0-255,5020,176195,65,205421
23646,0.002302,172.31.40.0-255,66,176261,65,205421
23647,0.004591,172.217.194.0-255,5738,181999,65,205421
23648,0.004599,172.31.40.0-255,66,182065,65,205421
23649,0.006877,172.217.194.0-255,5738,187803,65,205421
23650,0.006894,172.31.40.0-255,66,187869,65,205421
23651,0.00916,172.217.194.0-255,5738,193607,65,205421
23652,0.009174,172.31.40.0-255,66,193673,65,205421
23653,0.011453,172.217.194.0-255,5738,199411,65,205421
23654,0.011469,172.31.40.0-255,66,199477,65,205421
23655,0.013748,172.217.194.0-255,5707,205184,65,205421
23656,0.013752,172.31.40.0-255,66,205250,65,205421
23657,0.015431,172.31.40.0-255,105,205355,65,205421
23658,0.017664,172.217.194.0-255,66,205421,65,205421
23659,0.0,74.125.24.0-255,153,153,65,140945
23660,2.4e-05,172.31.40.0-255,66,219,65,140945
23661,3.1e-05,74.125.24.0-255,1484,1703,65,140945
23662,3.5e-05,172.31.40.0-255,66,1769,65,140945
23663,4.3e-05,74.125.24.0-255,2902,4671,65,140945
23664,4.8e-05,172.31.40.0-255,66,4737,65,140945
23665,8e-05,74.125.24.0-255,5738,10475,65,140945
23666,8.3e-05,172.31.40.0-255,66,10541,65,140945
23667,9.2e-05,74.125.24.0-255,6258,16799,65,140945
23668,9.4e-05,172.31.40.0-255,66,16865,65,140945
23669,9.7e-05,74.125.24.0-255,1484,18349,65,140945
23670,9.9e-05,172.31.40.0-255,66,18415,65,140945
23671,0.000123,74.125.24.0-255,1484,19899,65,140945
23672,0.000125,172.31.40.0-255,66,19965,65,140945
23673,0.000151,172.31.40.0-255,66,20031,65,140945
23674,0.000166,74.125.24.0-255,1484,21515,65,140945
23675,0.000169,172.31.40.0-255,66,21581,65,140945
23676,0.000207,74.125.24.0-255,1125,22706,65,140945
23677,0.000209,172.31.40.0-255,66,22772,65,140945
23678,0.000305,74.125.24.0-255,1484,24256,65,140945
23679,0.000308,172.31.40.0-255,66,24322,65,140945
23680,0.000313,74.125.24.0-255,2902,27224,65,140945
23681,0.000316,172.31.40.0-255,66,27290,65,140945
23682,0.00034,74.125.24.0-255,5738,33028,65,140945
23683,0.000342,172.31.40.0-255,66,33094,65,140945
23684,0.000372,74.125.24.0-255,6797,39891,65,140945
23685,0.000375,172.31.40.0-255,66,39957,65,140945
23686,0.000417,74.125.24.0-255,5738,45695,65,140945
23687,0.00042,172.31.40.0-255,66,45761,65,140945
23688,0.000455,172.31.40.0-255,66,45827,65,140945
23689,0.000519,74.125.24.0-255,2852,48679,65,140945
23690,0.000523,172.31.40.0-255,66,48745,65,140945
23691,0.000794,74.125.24.0-255,112,48857,65,140945
23692,0.00084,74.125.24.0-255,1484,50341,65,140945
23693,0.000844,172.31.40.0-255,66,50407,65,140945
23694,0.00085,74.125.24.0-255,2902,53309,65,140945
23695,0.000852,172.31.40.0-255,66,53375,65,140945
23696,0.000856,74.125.24.0-255,2902,56277,65,140945
23697,0.000858,172.31.40.0-255,66,56343,65,140945
23698,0.000875,74.125.24.0-255,2902,59245,65,140945
23699,0.000877,172.31.40.0-255,66,59311,65,140945
23700,0.000922,172.31.40.0-255,66,59377,65,140945
23701,0.000999,74.125.24.0-255,5738,65115,65,140945
23702,0.001003,172.31.40.0-255,66,65181,65,140945
23703,0.00102,74.125.24.0-255,5020,70201,65,140945
23704,0.001024,172.31.40.0-255,66,70267,65,140945
23705,0.002005,74.125.24.0-255,1484,71751,65,140945
23706,0.002014,74.125.24.0-255,1484,73235,65,140945
23707,0.002019,172.31.40.0-255,66,73301,65,140945
23708,0.002045,74.125.24.0-255,1484,74785,65,140945
23709,0.002052,74.125.24.0-255,5738,80523,65,140945
23710,0.002055,172.31.40.0-255,66,80589,65,140945
23711,0.002086,74.125.24.0-255,2902,83491,65,140945
23712,0.002088,172.31.40.0-255,66,83557,65,140945
23713,0.002109,172.31.40.0-255,66,83623,65,140945
23714,0.002164,74.125.24.0-255,4320,87943,65,140945
23715,0.002167,172.31.40.0-255,66,88009,65,140945
23716,0.002189,74.125.24.0-255,6438,94447,65,140945
23717,0.002191,172.31.40.0-255,66,94513,65,140945
23718,0.004262,74.125.24.0-255,5738,100251,65,140945
23719,0.004267,172.31.40.0-255,66,100317,65,140945
23720,0.006321,74.125.24.0-255,5738,106055,65,140945
23721,0.006329,172.31.40.0-255,66,106121,65,140945
23722,0.008442,74.125.24.0-255,5738,111859,65,140945
23723,0.008449,172.31.40.0-255,66,111925,65,140945
23724,0.010528,74.125.24.0-255,5738,117663,65,140945
23725,0.010536,172.31.40.0-255,66,117729,65,140945
23726,0.012683,74.125.24.0-255,5738,123467,65,140945
23727,0.012692,172.31.40.0-255,66,123533,65,140945
23728,0.014797,74.125.24.0-255,5738,129271,65,140945
23729,0.014811,172.31.40.0-255,66,129337,65,140945
23730,0.016908,74.125.24.0-255,5738,135075,65,140945
23731,0.01692,172.31.40.0-255,66,135141,65,140945
23732,0.018994,74.125.24.0-255,5738,140879,65,140945
23733,0.019004,172.31.40.0-255,66,140945,65,140945
23734,0.0,172.217.194.0-255,153,153,65,202017
23735,2.1e-05,172.31.40.0-255,66,219,65,202017
23736,2.7e-05,172.217.194.0-255,1484,1703,65,202017
23737,3.2e-05,172.31.40.0-255,66,1769,65,202017
23738,3.7e-05,172.217.194.0-255,2902,4671,65,202017
23739,4.6e-05,172.31.40.0-255,66,4737,65,202017
23740,5.3e-05,172.217.194.0-255,7156,11893,65,202017
23741,5.5e-05,172.31.40.0-255,66,11959,65,202017
23742,8.2e-05,172.217.194.0-255,2077,14036,65,202017
23743,8.8e-05,172.31.40.0-255,66,14102,65,202017
23744,0.000423,172.217.194.0-255,1484,15586,65,202017
23745,0.000427,172.31.40.0-255,66,15652,65,202017
23746,0.000433,172.217.194.0-255,1484,17136,65,202017
23747,0.000435,172.31.40.0-255,66,17202,65,202017
23748,0.000451,172.217.194.0-255,1484,18686,65,202017
23749,0.000453,172.31.40.0-255,66,18752,65,202017
23750,0.00046,172.217.194.0-255,5738,24490,65,202017
23751,0.000461,172.31.40.0-255,66,24556,65,202017
23752,0.000488,172.217.194.0-255,6797,31353,65,202017
23753,0.000491,172.31.40.0-255,66,31419,65,202017
23754,0.000653,172.217.194.0-255,1484,32903,65,202017
23755,0.000657,172.31.40.0-255,66,32969,65,202017
23756,0.000663,172.217.194.0-255,2902,35871,65,202017
23757,0.000665,172.31.40.0-255,66,35937,65,202017
23758,0.000669,172.217.194.0-255,2902,38839,65,202017
23759,0.000671,172.31.40.0-255,66,38905,65,202017
23760,0.00069,172.217.194.0-255,2902,41807,65,202017
23761,0.000696,172.31.40.0-255,66,41873,65,202017
23762,0.000727,172.217.194.0-255,2902,44775,65,202017
23763,0.00073,172.31.40.0-255,66,44841,65,202017
23764,0.000756,172.217.194.0-255,3961,48802,65,202017
23765,0.000759,172.31.40.0-255,66,48868,65,202017
23766,0.000779,172.217.194.0-255,2902,51770,65,202017
23767,0.000781,172.31.40.0-255,66,51836,65,202017
23768,0.000786,172.217.194.0-255,4320,56156,65,202017
23769,0.000789,172.31.40.0-255,66,56222,65,202017
23770,0.000791,172.217.194.0-255,1484,57706,65,202017
23771,0.000819,172.217.194.0-255,7156,64862,65,202017
23772,0.000822,172.31.40.0-255,66,64928,65,202017
23773,0.000839,172.217.194.0-255,1396,66324,65,202017
23774,0.000841,172.217.194.0-255,116,66440,65,202017
23775,0.000971,172.217.194.0-255,387,66827,65,202017
23776,0.000977,172.31.40.0-255,66,66893,65,202017
23777,0.001156,172.217.194.0-255,1484,68377,65,202017
23778,0.001162,172.217.194.0-255,1484,69861,65,202017
23779,0.001166,172.31.40.0-255,66,69927,65,202017
23780,0.001193,172.217.194.0-255,1484,71411,65,202017
23781,0.001199,172.217.194.0-255,5738,77149,65,202017
23782,0.001202,172.31.40.0-255,66,77215,65,202017
23783,0.001209,172.217.194.0-255,7156,84371,65,202017
23784,0.001212,172.31.40.0-255,66,84437,65,202017
23785,0.001217,172.217.194.0-255,5738,90175,65,202017
23786,0.00122,172.31.40.0-255,66,90241,65,202017
23787,0.001253,172.31.40.0-255,66,90307,65,202017
23788,0.001257,172.217.194.0-255,2184,92491,65,202017
23789,0.001258,172.31.40.0-255,66,92557,65,202017
23790,0.001351,172.217.194.0-255,1484,94041,65,202017
23791,0.001355,172.217.194.0-255,2902,96943,65,202017
23792,0.001357,172.31.40.0-255,66,97009,65,202017
23793,0.001361,172.217.194.0-255,2902,99911,65,202017
23794,0.001363,172.31.40.0-255,66,99977,65,202017
23795,0.001381,172.217.194.0-255,2902,102879,65,202017
23796,0.001383,172.31.40.0-255,66,102945,65,202017
23797,0.001392,172.31.40.0-255,66,103011,65,202017
23798,0.001422,172.217.194.0-255,4320,107331,65,202017
23799,0.001425,172.31.40.0-255,66,107397,65,202017
23800,0.001434,172.31.40.0-255,66,107463,65,202017
23801,0.00147,172.217.194.0-255,1484,108947,65,202017
23802,0.0015,172.217.194.0-255,1484,110431,65,202017
23803,0.001502,172.31.40.0-255,66,110497,65,202017
23804,0.001531,172.217.194.0-255,1484,111981,65,202017
23805,0.001537,172.217.194.0-255,5738,117719,65,202017
23806,0.001539,172.31.40.0-255,66,117785,65,202017
23807,0.001549,172.31.40.0-255,66,117851,65,202017
23808,0.001557,172.217.194.0-255,4320,122171,65,202017
23809,0.001559,172.31.40.0-255,66,122237,65,202017
23810,0.001584,172.31.40.0-255,66,122303,65,202017
23811,0.001611,172.217.194.0-255,5738,128041,65,202017
23812,0.001613,172.31.40.0-255,66,128107,65,202017
23813,0.001638,172.217.194.0-255,2902,131009,65,202017
23814,0.00164,172.31.40.0-255,66,131075,65,202017
23815,0.00165,172.31.40.0-255,66,131141,65,202017
23816,0.00169,172.31.40.0-255,66,131207,65,202017
23817,0.001786,172.217.194.0-255,1484,132691,65,202017
23818,0.001801,172.217.194.0-255,2902,135593,65,202017
23819,0.001803,172.31.40.0-255,66,135659,65,202017
23820,0.001809,172.217.194.0-255,5738,141397,65,202017
23821,0.001812,172.31.40.0-255,66,141463,65,202017
23822,0.001842,172.31.40.0-255,66,141529,65,202017
23823,0.001863,172.217.194.0-255,2902,144431,65,202017
23824,0.001864,172.31.40.0-255,66,144497,65,202017
23825,0.001871,172.217.194.0-255,7156,151653,65,202017
23826,0.001873,172.31.40.0-255,66,151719,65,202017
23827,0.001897,172.217.194.0-255,3602,155321,65,202017
23828,0.0019,172.31.40.0-255,66,155387,65,202017
23829,0.004079,172.217.194.0-255,1484,156871,65,202017
23830,0.004131,172.217.194.0-255,4320,161191,65,202017
23831,0.004136,172.31.40.0-255,66,161257,65,202017
23832,0.006357,172.217.194.0-255,5738,166995,65,202017
23833,0.006363,172.31.40.0-255,66,167061,65,202017
23834,0.008603,172.217.194.0-255,5738,172799,65,202017
23835,0.00861,172.31.40.0-255,66,172865,65,202017
23836,0.010832,172.217.194.0-255,5738,178603,65,202017
23837,0.010838,172.31.40.0-255,66,178669,65,202017
23838,0.013071,172.217.194.0-255,2902,181571,65,202017
23839,0.013078,172.31.40.0-255,66,181637,65,202017
23840,0.013106,172.217.194.0-255,2902,184539,65,202017
23841,0.013109,172.31.40.0-255,66,184605,65,202017
23842,0.015502,172.217.194.0-255,5738,190343,65,202017
23843,0.015513,172.31.40.0-255,66,190409,65,202017
23844,0.01775,172.217.194.0-255,5738,196147,65,202017
23845,0.017756,172.31.40.0-255,66,196213,65,202017
23846,0.019967,172.217.194.0-255,5738,201951,65,202017
23847,0.019976,172.31.40.0-255,66,202017,65,202017
23848,0.0,74.125.24.0-255,150,150,65,226962
23849,1.5e-05,172.31.40.0-255,66,216,65,226962
23850,2.2e-05,74.125.24.0-255,1484,1700,65,226962
23851,2.6e-05,172.31.40.0-255,66,1766,65,226962
23852,3.1e-05,74.125.24.0-255,2902,4668,65,226962
23853,3.4e-05,172.31.40.0-255,66,4734,65,226962
23854,8.2e-05,74.125.24.0-255,5738,10472,65,226962
23855,8.5e-05,172.31.40.0-255,66,10538,65,226962
23856,9.3e-05,74.125.24.0-255,6375,16913,65,226962
23857,9.5e-05,172.31.40.0-255,66,16979,65,226962
23858,0.0001,74.125.24.0-255,2902,19881,65,226962
23859,0.000102,172.31.40.0-255,66,19947,65,226962
23860,0.000105,74.125.24.0-255,1484,21431,65,226962
23861,0.000107,172.31.40.0-255,66,21497,65,226962
23862,0.000125,74.125.24.0-255,2902,24399,65,226962
23863,0.000128,172.31.40.0-255,66,24465,65,226962
23864,0.000166,74.125.24.0-255,6797,31262,65,226962
23865,0.000169,172.31.40.0-255,66,31328,65,226962
23866,0.000288,74.125.24.0-255,1484,32812,65,226962
23867,0.000293,172.31.40.0-255,66,32878,65,226962
23868,0.000298,74.125.24.0-255,2902,35780,65,226962
23869,0.000301,172.31.40.0-255,66,35846,65,226962
23870,0.000305,74.125.24.0-255,2902,38748,65,226962
23871,0.000309,172.31.40.0-255,66,38814,65,226962
23872,0.000332,74.125.24.0-255,2902,41716,65,226962
23873,0.000335,172.31.40.0-255,66,41782,65,226962
23874,0.000338,74.125.24.0-255,1484,43266,65,226962
23875,0.00034,172.31.40.0-255,66,43332,65,226962
23876,0.000346,74.125.24.0-255,4320,47652,65,226962
23877,0.000348,172.31.40.0-255,66,47718,65,226962
23878,0.000372,172.31.40.0-255,66,47784,65,226962
23879,0.000377,74.125.24.0-255,4320,52104,65,226962
23880,0.000379,172.31.40.0-255,66,52170,65,226962
23881,0.000398,74.125.24.0-255,4271,56441,65,226962
23882,0.000401,172.31.40.0-255,66,56507,65,226962
23883,0.000404,74.125.24.0-255,111,56618,65,226962
23884,0.000515,74.125.24.0-255,1484,58102,65,226962
23885,0.00052,172.31.40.0-255,66,58168,65,226962
23886,0.000525,74.125.24.0-255,2902,61070,65,226962
23887,0.000528,172.31.40.0-255,66,61136,65,226962
23888,0.000531,74.125.24.0-255,1484,62620,65,226962
23889,0.00055,74.125.24.0-255,4320,66940,65,226962
23890,0.000553,172.31.40.0-255,66,67006,65,226962
23891,0.000558,74.125.24.0-255,2902,69908,65,226962
23892,0.00056,172.31.40.0-255,66,69974,65,226962
23893,0.000578,74.125.24.0-255,3961,73935,65,226962
23894,0.000582,172.31.40.0-255,66,74001,65,226962
23895,0.000593,74.125.24.0-255,1484,75485,65,226962
23896,0.000617,172.31.40.0-255,66,75551,65,226962
23897,0.000635,74.125.24.0-255,2902,78453,65,226962
23898,0.000638,172.31.40.0-255,66,78519,65,226962
23899,0.000642,74.125.24.0-255,2543,81062,65,226962
23900,0.000644,172.31.40.0-255,66,81128,65,226962
23901,0.001632,74.125.24.0-255,1484,82612,65,226962
23902,0.001643,74.125.24.0-255,2902,85514,65,226962
23903,0.001648,172.31.40.0-255,66,85580,65,226962
23904,0.001656,74.125.24.0-255,5738,91318,65,226962
23905,0.001659,172.31.40.0-255,66,91384,65,226962
23906,0.001666,74.125.24.0-255,5738,97122,65,226962
23907,0.001668,172.31.40.0-255,66,97188,65,226962
23908,0.001703,74.125.24.0-255,7156,104344,65,226962
23909,0.001706,172.31.40.0-255,66,104410,65,226962
23910,0.001718,172.31.40.0-255,66,104476,65,226962
23911,0.001734,74.125.24.0-255,2902,107378,65,226962
23912,0.001737,172.31.40.0-255,66,107444,65,226962
23913,0.001742,74.125.24.0-255,4320,111764,65,226962
23914,0.001744,172.31.40.0-255,66,111830,65,226962
23915,0.001751,74.125.24.0-255,5738,117568,65,226962
23916,0.001752,172.31.40.0-255,66,117634,65,226962
23917,0.001777,74.125.24.0-255,2902,120536,65,226962
23918,0.001779,172.31.40.0-255,66,120602,65,226962
23919,0.001783,74.125.24.0-255,2902,123504,65,226962
23920,0.001785,172.31.40.0-255,66,123570,65,226962
23921,0.001802,74.125.24.0-255,7156,130726,65,226962
23922,0.001804,172.31.40.0-255,66,130792,65,226962
23923,0.001833,172.31.40.0-255,66,130858,65,226962
23924,0.001841,74.125.24.0-255,7156,138014,65,226962
23925,0.001843,172.31.40.0-255,66,138080,65,226962
23926,0.001877,172.31.40.0-255,66,138146,65,226962
23927,0.001892,172.31.40.0-255,66,138212,65,226962
23928,0.001957,172.31.40.0-255,66,138278,65,226962
23929,0.001967,172.31.40.0-255,66,138344,65,226962
23930,0.001996,172.31.40.0-255,66,138410,65,226962
23931,0.00202,74.125.24.0-255,1484,139894,65,226962
23932,0.002025,74.125.24.0-255,2902,142796,65,226962
23933,0.002027,172.31.40.0-255,66,142862,65,226962
23934,0.002034,74.125.24.0-255,5738,148600,65,226962
23935,0.002037,172.31.40.0-255,66,148666,65,226962
23936,0.002054,74.125.24.0-255,5738,154404,65,226962
23937,0.002057,172.31.40.0-255,66,154470,65,226962
23938,0.002082,74.125.24.0-255,7156,161626,65,226962
23939,0.002085,172.31.40.0-255,66,161692,65,226962
23940,0.002092,74.125.24.0-255,7156,168848,65,226962
23941,0.002094,172.31.40.0-255,66,168914,65,226962
23942,0.002115,74.125.24.0-255,3602,172516,65,226962
23943,0.002118,172.31.40.0-255,66,172582,65,226962
23944,0.002167,74.125.24.0-255,1484,174066,65,226962
23945,0.002172,74.125.24.0-255,2902,176968,65,226962
23946,0.002177,172.31.40.0-255,66,177034,65,226962
23947,0.002195,74.125.24.0-255,5738,182772,65,226962
23948,0.002198,172.31.40.0-255,66,182838,65,226962
23949,0.002202,74.125.24.0-255,2902,185740,65,226962
23950,0.002204,172.31.40.0-255,66,185806,65,226962
23951,0.002233,172.31.40.0-255,66,185872,65,226962
23952,0.002257,172.31.40.0-255,66,185938,65,226962
23953,0.002303,172.31.40.0-255,66,186004,65,226962
23954,0.002314,172.31.40.0-255,66,186070,65,226962
23955,0.004616,74.125.24.0-255,5738,191808,65,226962
23956,0.004623,172.31.40.0-255,66,191874,65,226962
23957,0.006922,74.125.24.0-255,5738,197612,65,226962
23958,0.006933,172.31.40.0-255,66,197678,65,226962
23959,0.009199,74.125.24.0-255,2902,200580,65,226962
23960,0.009203,172.31.40.0-255,66,200646,65,226962
23961,0.009221,74.125.24.0-255,2902,203548,65,226962
23962,0.009223,172.31.40.0-255,66,203614,65,226962
23963,0.011482,74.125.24.0-255,2902,206516,65,226962
23964,0.011489,172.31.40.0-255,66,206582,65,226962
23965,0.011511,74.125.24.0-255,2902,209484,65,226962
23966,0.011513,172.31.40.0-255,66,209550,65,226962
23967,0.013787,74.125.24.0-255,5738,215288,65,226962
23968,0.013795,172.31.40.0-255,66,215354,65,226962
23969,0.016096,74.125.24.0-255,5738,221092,65,226962
23970,0.016104,172.31.40.0-255,66,221158,65,226962
23971,0.018403,74.125.24.0-255,5738,226896,65,226962
23972,0.018411,172.31.40.0-255,66,226962,65,226962
23973,0.0,74.125.24.0-255,153,153,65,83044
23974,2.1e-05,172.31.40.0-255,66,219,65,83044
23975,2.8e-05,74.125.24.0-255,1484,1703,65,83044
23976,3.3e-05,172.31.40.0-255,66,1769,65,83044
23977,3.8e-05,74.125.24.0-255,2902,4671,65,83044
23978,4.8e-05,172.31.40.0-255,66,4737,65,83044
23979,8.9e-05,74.125.24.0-255,7156,11893,65,83044
23980,9.2e-05,172.31.40.0-255,66,11959,65,83044
23981,0.000192,74.125.24.0-255,2030,13989,65,83044
23982,0.000197,172.31.40.0-255,66,14055,65,83044
23983,0.000235,172.31.40.0-255,66,14121,65,83044
23984,0.000415,74.125.24.0-255,6797,20918,65,83044
23985,0.000419,172.31.40.0-255,66,20984,65,83044
23986,0.001558,74.125.24.0-255,1484,22468,65,83044
23987,0.001565,172.31.40.0-255,66,22534,65,83044
23988,0.001574,74.125.24.0-255,2902,25436,65,83044
23989,0.001576,172.31.40.0-255,66,25502,65,83044
23990,0.001609,74.125.24.0-255,5738,31240,65,83044
23991,0.001611,172.31.40.0-255,66,31306,65,83044
23992,0.001704,74.125.24.0-255,6797,38103,65,83044
23993,0.001707,172.31.40.0-255,66,38169,65,83044
23994,0.001816,74.125.24.0-255,1484,39653,65,83044
23995,0.00182,172.31.40.0-255,66,39719,65,83044
23996,0.001857,172.31.40.0-255,66,39785,65,83044
23997,0.002082,74.125.24.0-255,2543,42328,65,83044
23998,0.002088,172.31.40.0-255,66,42394,65,83044
23999,0.002127,172.31.40.0-255,66,42460,65,83044
24000,0.002166,172.31.40.0-255,66,42526,65,83044
24001,0.002454,74.125.24.0-255,1484,44010,65,83044
24002,0.002486,172.31.40.0-255,66,44076,65,83044
24003,0.00267,172.31.40.0-255,66,44142,65,83044
24004,0.002728,74.125.24.0-255,2528,46670,65,83044
24005,0.003301,74.125.24.0-255,1484,48154,65,83044
24006,0.003435,172.31.40.0-255,66,48220,65,83044
24007,0.005815,74.125.24.0-255,5738,53958,65,83044
24008,0.005821,172.31.40.0-255,66,54024,65,83044
24009,0.008203,74.125.24.0-255,5738,59762,65,83044
24010,0.00821,172.31.40.0-255,66,59828,65,83044
24011,0.010628,74.125.24.0-255,5738,65566,65,83044
24012,0.010635,172.31.40.0-255,66,65632,65,83044
24013,0.013051,74.125.24.0-255,5738,71370,65,83044
24014,0.013059,172.31.40.0-255,66,71436,65,83044
24015,0.015444,74.125.24.0-255,5738,77174,65,83044
24016,0.015453,172.31.40.0-255,66,77240,65,83044
24017,0.017882,74.125.24.0-255,5738,82978,65,83044
24018,0.017891,172.31.40.0-255,66,83044,65,83044
24019,0.0,74.125.24.0-255,155,155,65,178705
24020,2e-05,172.31.40.0-255,66,221,65,178705
24021,2.6e-05,74.125.24.0-255,1484,1705,65,178705
24022,3e-05,172.31.40.0-255,66,1771,65,178705
24023,4.8e-05,74.125.24.0-255,1484,3255,65,178705
24024,5.1e-05,172.31.40.0-255,66,3321,65,178705
24025,5.6e-05,74.125.24.0-255,2902,6223,65,178705
24026,5.9e-05,172.31.40.0-255,66,6289,65,178705
24027,7.5e-05,74.125.24.0-255,5738,12027,65,178705
24028,7.7e-05,172.31.40.0-255,66,12093,65,178705
24029,0.000111,172.31.40.0-255,66,12159,65,178705
24030,0.000114,74.125.24.0-255,1484,13643,65,178705
24031,0.000116,172.31.40.0-255,66,13709,65,178705
24032,0.000146,74.125.24.0-255,3961,17670,65,178705
24033,0.000148,172.31.40.0-255,66,17736,65,178705
24034,0.000198,74.125.24.0-255,2902,20638,65,178705
24035,0.0002,172.31.40.0-255,66,20704,65,178705
24036,0.000203,74.125.24.0-255,1484,22188,65,178705
24037,0.000205,172.31.40.0-255,66,22254,65,178705
24038,0.000221,74.125.24.0-255,2902,25156,65,178705
24039,0.000224,172.31.40.0-255,66,25222,65,178705
24040,0.000226,74.125.24.0-255,1484,26706,65,178705
24041,0.000228,172.31.40.0-255,66,26772,65,178705
24042,0.000251,74.125.24.0-255,7156,33928,65,178705
24043,0.000253,172.31.40.0-255,66,33994,65,178705
24044,0.000298,172.31.40.0-255,66,34060,65,178705
24045,0.000312,74.125.24.0-255,1125,35185,65,178705
24046,0.000314,172.31.40.0-255,66,35251,65,178705
24047,0.00032,74.125.24.0-255,5686,40937,65,178705
24048,0.000323,172.31.40.0-255,66,41003,65,178705
24049,0.000343,74.125.24.0-255,382,41385,65,178705
24050,0.000547,74.125.24.0-255,1484,42869,65,178705
24051,0.000556,172.31.40.0-255,66,42935,65,178705
24052,0.000567,74.125.24.0-255,2902,45837,65,178705
24053,0.000571,74.125.24.0-255,5738,51575,65,178705
24054,0.000581,74.125.24.0-255,1484,53059,65,178705
24055,0.000605,172.31.40.0-255,66,53125,65,178705
24056,0.00061,172.31.40.0-255,66,53191,65,178705
24057,0.000643,172.31.40.0-255,66,53257,65,178705
24058,0.000878,74.125.24.0-255,1484,54741,65,178705
24059,0.000892,74.125.24.0-255,2902,57643,65,178705
24060,0.000901,172.31.40.0-255,66,57709,65,178705
24061,0.000912,74.125.24.0-255,5738,63447,65,178705
24062,0.000926,74.125.24.0-255,4320,67767,65,178705
24063,0.000929,74.125.24.0-255,1484,69251,65,178705
24064,0.000953,74.125.24.0-255,2902,72153,65,178705
24065,0.000958,172.31.40.0-255,66,72219,65,178705
24066,0.000968,74.125.24.0-255,1484,73703,65,178705
24067,0.001005,74.125.24.0-255,3602,77305,65,178705
24068,0.001013,172.31.40.0-255,66,77371,65,178705
24069,0.001055,74.125.24.0-255,4320,81691,65,178705
24070,0.001061,172.31.40.0-255,66,81757,65,178705
24071,0.001081,74.125.24.0-255,5738,87495,65,178705
24072,0.001084,172.31.40.0-255,66,87561,65,178705
24073,0.001096,172.31.40.0-255,66,87627,65,178705
24074,0.001118,74.125.24.0-255,1484,89111,65,178705
24075,0.001146,172.31.40.0-255,66,89177,65,178705
24076,0.00124,74.125.24.0-255,1484,90661,65,178705
24077,0.001245,74.125.24.0-255,2902,93563,65,178705
24078,0.001254,172.31.40.0-255,66,93629,65,178705
24079,0.001277,74.125.24.0-255,5738,99367,65,178705
24080,0.001282,74.125.24.0-255,5738,105105,65,178705
24081,0.001289,74.125.24.0-255,7156,112261,65,178705
24082,0.001298,172.31.40.0-255,66,112327,65,178705
24083,0.001309,74.125.24.0-255,5738,118065,65,178705
24084,0.001325,74.125.24.0-255,5020,123085,65,178705
24085,0.00134,172.31.40.0-255,66,123151,65,178705
24086,0.001631,74.125.24.0-255,1484,124635,65,178705
24087,0.001649,74.125.24.0-255,2902,127537,65,178705
24088,0.001651,172.31.40.0-255,66,127603,65,178705
24089,0.001657,74.125.24.0-255,5738,133341,65,178705
24090,0.001672,172.31.40.0-255,66,133407,65,178705
24091,0.001678,74.125.24.0-255,1484,134891,65,178705
24092,0.001691,74.125.24.0-255,2902,137793,65,178705
24093,0.001708,74.125.24.0-255,5738,143531,65,178705
24094,0.00171,74.125.24.0-255,1484,145015,65,178705
24095,0.001712,172.31.40.0-255,66,145081,65,178705
24096,0.001716,172.31.40.0-255,66,145147,65,178705
24097,0.001742,74.125.24.0-255,766,145913,65,178705
24098,0.001757,172.31.40.0-255,66,145979,65,178705
24099,0.001854,74.125.24.0-255,1484,147463,65,178705
24100,0.001858,74.125.24.0-255,1484,148947,65,178705
24101,0.00186,172.31.40.0-255,66,149013,65,178705
24102,0.001879,74.125.24.0-255,1484,150497,65,178705
24103,0.001886,74.125.24.0-255,5738,156235,65,178705
24104,0.001888,74.125.24.0-255,1484,157719,65,178705
24105,0.001924,172.31.40.0-255,66,157785,65,178705
24106,0.001978,74.125.24.0-255,1484,159269,65,178705
24107,0.001991,172.31.40.0-255,66,159335,65,178705
24108,0.00205,74.125.24.0-255,4320,163655,65,178705
24109,0.002056,74.125.24.0-255,5738,169393,65,178705
24110,0.002063,172.31.40.0-255,66,169459,65,178705
24111,0.002074,74.125.24.0-255,4320,173779,65,178705
24112,0.002096,74.125.24.0-255,4320,178099,65,178705
24113,0.002109,172.31.40.0-255,66,178165,65,178705
24114,0.002133,172.31.40.0-255,66,178231,65,178705
24115,0.002186,172.31.40.0-255,66,178297,65,178705
24116,0.00222,172.31.40.0-255,66,178363,65,178705
24117,0.002243,74.125.24.0-255,105,178468,65,178705
24118,0.004146,172.31.40.0-255,66,178534,65,178705
24119,0.004184,172.31.40.0-255,105,178639,65,178705
24120,0.006404,74.125.24.0-255,66,178705,65,178705
24121,0.0,74.125.68.0-255,150,150,65,164866
24122,2.1e-05,172.31.40.0-255,66,216,65,164866
24123,2.9e-05,74.125.68.0-255,1484,1700,65,164866
24124,3.4e-05,172.31.40.0-255,66,1766,65,164866
24125,3.7e-05,74.125.68.0-255,1484,3250,65,164866
24126,4e-05,172.31.40.0-255,66,3316,65,164866
24127,5.2e-05,74.125.68.0-255,2902,6218,65,164866
24128,5.6e-05,172.31.40.0-255,66,6284,65,164866
24129,6.3e-05,74.125.68.0-255,5738,12022,65,164866
24130,6.6e-05,172.31.40.0-255,66,12088,65,164866
24131,6.9e-05,74.125.68.0-255,2029,14117,65,164866
24132,7.2e-05,172.31.40.0-255,66,14183,65,164866
24133,0.000179,74.125.68.0-255,1484,15667,65,164866
24134,0.000184,172.31.40.0-255,66,15733,65,164866
24135,0.000188,74.125.68.0-255,1484,17217,65,164866
24136,0.00019,172.31.40.0-255,66,17283,65,164866
24137,0.000217,74.125.68.0-255,1484,18767,65,164866
24138,0.000225,172.31.40.0-255,66,18833,65,164866
24139,0.000232,74.125.68.0-255,5738,24571,65,164866
24140,0.000235,172.31.40.0-255,66,24637,65,164866
24141,0.000239,74.125.68.0-255,2902,27539,65,164866
24142,0.000242,172.31.40.0-255,66,27605,65,164866
24143,0.000247,74.125.68.0-255,3961,31566,65,164866
24144,0.000249,172.31.40.0-255,66,31632,65,164866
24145,0.000285,74.125.68.0-255,5738,37370,65,164866
24146,0.000288,172.31.40.0-255,66,37436,65,164866
24147,0.000316,74.125.68.0-255,1484,38920,65,164866
24148,0.000319,172.31.40.0-255,66,38986,65,164866
24149,0.000329,172.31.40.0-255,66,39052,65,164866
24150,0.000339,74.125.68.0-255,4320,43372,65,164866
24151,0.000341,172.31.40.0-255,66,43438,65,164866
24152,0.000374,74.125.68.0-255,7156,50594,65,164866
24153,0.000377,172.31.40.0-255,66,50660,65,164866
24154,0.000381,74.125.68.0-255,2902,53562,65,164866
24155,0.000383,172.31.40.0-255,66,53628,65,164866
24156,0.000415,74.125.68.0-255,3602,57230,65,164866
24157,0.000418,172.31.40.0-255,66,57296,65,164866
24158,0.000421,74.125.68.0-255,443,57739,65,164866
24159,0.000559,74.125.68.0-255,1484,59223,65,164866
24160,0.000563,172.31.40.0-255,66,59289,65,164866
24161,0.00058,74.125.68.0-255,2902,62191,65,164866
24162,0.000583,172.31.40.0-255,66,62257,65,164866
24163,0.000614,74.125.68.0-255,4320,66577,65,164866
24164,0.000616,172.31.40.0-255,66,66643,65,164866
24165,0.000627,172.31.40.0-255,66,66709,65,164866
24166,0.000631,74.125.68.0-255,2902,69611,65,164866
24167,0.000633,172.31.40.0-255,66,69677,65,164866
24168,0.000666,74.125.68.0-255,1484,71161,65,164866
24169,0.000674,74.125.68.0-255,5738,76899,65,164866
24170,0.000677,172.31.40.0-255,66,76965,65,164866
24171,0.000681,74.125.68.0-255,2902,79867,65,164866
24172,0.000683,172.31.40.0-255,66,79933,65,164866
24173,0.000715,74.125.68.0-255,3602,83535,65,164866
24174,0.000718,172.31.40.0-255,66,83601,65,164866
24175,0.000721,74.125.68.0-255,331,83932,65,164866
24176,0.001473,172.31.40.0-255,66,83998,65,164866
24177,0.001765,74.125.68.0-255,1484,85482,65,164866
24178,0.001772,74.125.68.0-255,2902,88384,65,164866
24179,0.001776,172.31.40.0-255,66,88450,65,164866
24180,0.001807,74.125.68.0-255,5738,94188,65,164866
24181,0.00181,172.31.40.0-255,66,94254,65,164866
24182,0.001834,74.125.68.0-255,1484,95738,65,164866
24183,0.001848,74.125.68.0-255,7156,102894,65,164866
24184,0.00185,172.31.40.0-255,66,102960,65,164866
24185,0.00186,172.31.40.0-255,66,103026,65,164866
24186,0.001881,74.125.68.0-255,5020,108046,65,164866
24187,0.001883,172.31.40.0-255,66,108112,65,164866
24188,0.001976,74.125.68.0-255,1484,109596,65,164866
24189,0.001982,74.125.68.0-255,2902,112498,65,164866
24190,0.001985,172.31.40.0-255,66,112564,65,164866
24191,0.002016,74.125.68.0-255,5738,118302,65,164866
24192,0.002019,172.31.40.0-255,66,118368,65,164866
24193,0.002022,74.125.68.0-255,1484,119852,65,164866
24194,0.004003,74.125.68.0-255,4320,124172,65,164866
24195,0.004012,172.31.40.0-255,66,124238,65,164866
24196,0.006048,74.125.68.0-255,5738,129976,65,164866
24197,0.006056,172.31.40.0-255,66,130042,65,164866
24198,0.008049,74.125.68.0-255,5738,135780,65,164866
24199,0.008058,172.31.40.0-255,66,135846,65,164866
24200,0.010047,74.125.68.0-255,5738,141584,65,164866
24201,0.010053,172.31.40.0-255,66,141650,65,164866
24202,0.012046,74.125.68.0-255,5738,147388,65,164866
24203,0.012053,172.31.40.0-255,66,147454,65,164866
24204,0.014056,74.125.68.0-255,5738,153192,65,164866
24205,0.014063,172.31.40.0-255,66,153258,65,164866
24206,0.016052,74.125.68.0-255,5738,158996,65,164866
24207,0.016059,172.31.40.0-255,66,159062,65,164866
24208,0.018048,74.125.68.0-255,5738,164800,65,164866
24209,0.018054,172.31.40.0-255,66,164866,65,164866
24210,0.0,74.125.200.0-255,148,148,65,147784
24211,2.1e-05,172.31.40.0-255,66,214,65,147784
24212,2.9e-05,74.125.200.0-255,1484,1698,65,147784
24213,3.3e-05,172.31.40.0-255,66,1764,65,147784
24214,4.8e-05,74.125.200.0-255,2902,4666,65,147784
24215,5.2e-05,172.31.40.0-255,66,4732,65,147784
24216,5.8e-05,74.125.200.0-255,4320,9052,65,147784
24217,6.1e-05,172.31.40.0-255,66,9118,65,147784
24218,0.000109,74.125.200.0-255,4936,14054,65,147784
24219,0.000113,172.31.40.0-255,66,14120,65,147784
24220,0.000186,74.125.200.0-255,1484,15604,65,147784
24221,0.000189,172.31.40.0-255,66,15670,65,147784
24222,0.000194,74.125.200.0-255,2902,18572,65,147784
24223,0.000196,172.31.40.0-255,66,18638,65,147784
24224,0.000232,74.125.200.0-255,5738,24376,65,147784
24225,0.000235,172.31.40.0-255,66,24442,65,147784
24226,0.00024,74.125.200.0-255,4320,28762,65,147784
24227,0.000243,172.31.40.0-255,66,28828,65,147784
24228,0.000264,74.125.200.0-255,2543,31371,65,147784
24229,0.000267,172.31.40.0-255,66,31437,65,147784
24230,0.000293,74.125.200.0-255,1484,32921,65,147784
24231,0.000296,172.31.40.0-255,66,32987,65,147784
24232,0.000322,74.125.200.0-255,2902,35889,65,147784
24233,0.000324,172.31.40.0-255,66,35955,65,147784
24234,0.000329,74.125.200.0-255,2902,38857,65,147784
24235,0.000332,172.31.40.0-255,66,38923,65,147784
24236,0.000356,74.125.200.0-255,2902,41825,65,147784
24237,0.000359,172.31.40.0-255,66,41891,65,147784
24238,0.000367,74.125.200.0-255,6797,48688,65,147784
24239,0.000369,172.31.40.0-255,66,48754,65,147784
24240,0.001407,74.125.200.0-255,1484,50238,65,147784
24241,0.001415,172.31.40.0-255,66,50304,65,147784
24242,0.001425,74.125.200.0-255,2902,53206,65,147784
24243,0.001428,172.31.40.0-255,66,53272,65,147784
24244,0.00144,74.125.200.0-255,5738,59010,65,147784
24245,0.001442,172.31.40.0-255,66,59076,65,147784
24246,0.001448,74.125.200.0-255,2902,61978,65,147784
24247,0.00145,172.31.40.0-255,66,62044,65,147784
24248,0.001475,74.125.200.0-255,1484,63528,65,147784
24249,0.001499,74.125.200.0-255,3124,66652,65,147784
24250,0.001502,172.31.40.0-255,66,66718,65,147784
24251,0.001573,74.125.200.0-255,1484,68202,65,147784
24252,0.001578,74.125.200.0-255,2902,71104,65,147784
24253,0.00158,172.31.40.0-255,66,71170,65,147784
24254,0.001606,74.125.200.0-255,2902,74072,65,147784
24255,0.001608,172.31.40.0-255,66,74138,65,147784
24256,0.001612,74.125.200.0-255,4320,78458,65,147784
24257,0.001614,172.31.40.0-255,66,78524,65,147784
24258,0.001645,74.125.200.0-255,4320,82844,65,147784
24259,0.00165,172.31.40.0-255,66,82910,65,147784
24260,0.001677,74.125.200.0-255,5379,88289,65,147784
24261,0.00168,172.31.40.0-255,66,88355,65,147784
24262,0.001685,74.125.200.0-255,4320,92675,65,147784
24263,0.001687,172.31.40.0-255,66,92741,65,147784
24264,0.001704,74.125.200.0-255,4320,97061,65,147784
24265,0.001706,172.31.40.0-255,66,97127,65,147784
24266,0.001729,74.125.200.0-255,3961,101088,65,147784
24267,0.001732,172.31.40.0-255,66,101154,65,147784
24268,0.003897,74.125.200.0-255,1484,102638,65,147784
24269,0.003919,74.125.200.0-255,4320,106958,65,147784
24270,0.003925,172.31.40.0-255,66,107024,65,147784
24271,0.006127,74.125.200.0-255,5738,112762,65,147784
24272,0.006133,172.31.40.0-255,66,112828,65,147784
24273,0.00834,74.125.200.0-255,5738,118566,65,147784
24274,0.008346,172.31.40.0-255,66,118632,65,147784
24275,0.010553,74.125.200.0-255,5738,124370,65,147784
24276,0.010563,172.31.40.0-255,66,124436,65,147784
24277,0.01277,74.125.200.0-255,5738,130174,65,147784
24278,0.012777,172.31.40.0-255,66,130240,65,147784
24279,0.014975,74.125.200.0-255,5738,135978,65,147784
24280,0.014983,172.31.40.0-255,66,136044,65,147784
24281,0.017199,74.125.200.0-255,5738,141782,65,147784
24282,0.017212,172.31.40.0-255,66,141848,65,147784
24283,0.019437,74.125.200.0-255,2902,144750,65,147784
24284,0.019446,172.31.40.0-255,66,144816,65,147784
24285,0.019475,74.125.200.0-255,2902,147718,65,147784
24286,0.019478,172.31.40.0-255,66,147784,65,147784
24287,0.0,172.253.118.0-255,149,149,65,229685
24288,1.5e-05,172.31.40.0-255,66,215,65,229685
24289,3e-05,172.253.118.0-255,1484,1699,65,229685
24290,3.4e-05,172.31.40.0-255,66,1765,65,229685
24291,4e-05,172.253.118.0-255,2902,4667,65,229685
24292,4.3e-05,172.31.40.0-255,66,4733,65,229685
24293,4.9e-05,172.253.118.0-255,5738,10471,65,229685
24294,5.2e-05,172.31.40.0-255,66,10537,65,229685
24295,9e-05,172.253.118.0-255,3441,13978,65,229685
24296,9.3e-05,172.31.40.0-255,66,14044,65,229685
24297,0.000129,172.253.118.0-255,1484,15528,65,229685
24298,0.000133,172.31.40.0-255,66,15594,65,229685
24299,0.000141,172.253.118.0-255,2902,18496,65,229685
24300,0.000143,172.31.40.0-255,66,18562,65,229685
24301,0.000157,172.253.118.0-255,2902,21464,65,229685
24302,0.000159,172.31.40.0-255,66,21530,65,229685
24303,0.000179,172.253.118.0-255,2902,24432,65,229685
24304,0.000181,172.31.40.0-255,66,24498,65,229685
24305,0.000188,172.253.118.0-255,6797,31295,65,229685
24306,0.00019,172.31.40.0-255,66,31361,65,229685
24307,0.000377,172.253.118.0-255,1484,32845,65,229685
24308,0.000382,172.31.40.0-255,66,32911,65,229685
24309,0.000387,172.253.118.0-255,2902,35813,65,229685
24310,0.00039,172.31.40.0-255,66,35879,65,229685
24311,0.000394,172.253.118.0-255,4320,40199,65,229685
24312,0.000397,172.31.40.0-255,66,40265,65,229685
24313,0.000418,172.253.118.0-255,1484,41749,65,229685
24314,0.000421,172.31.40.0-255,66,41815,65,229685
24315,0.000449,172.253.118.0-255,7156,48971,65,229685
24316,0.000452,172.31.40.0-255,66,49037,65,229685
24317,0.000482,172.253.118.0-255,6797,55834,65,229685
24318,0.000485,172.31.40.0-255,66,55900,65,229685
24319,0.000494,172.31.40.0-255,66,55966,65,229685
24320,0.000497,172.253.118.0-255,1421,57387,65,229685
24321,0.000528,172.253.118.0-255,381,57768,65,229685
24322,0.00053,172.31.40.0-255,66,57834,65,229685
24323,0.000639,172.253.118.0-255,1484,59318,65,229685
24324,0.00066,172.253.118.0-255,2902,62220,65,229685
24325,0.000662,172.31.40.0-255,66,62286,65,229685
24326,0.000668,172.253.118.0-255,5738,68024,65,229685
24327,0.00067,172.31.40.0-255,66,68090,65,229685
24328,0.00071,172.31.40.0-255,66,68156,65,229685
24329,0.00075,172.253.118.0-255,4320,72476,65,229685
24330,0.000752,172.31.40.0-255,66,72542,65,229685
24331,0.000776,172.253.118.0-255,6797,79339,65,229685
24332,0.000779,172.31.40.0-255,66,79405,65,229685
24333,0.000816,172.253.118.0-255,1484,80889,65,229685
24334,0.000831,172.253.118.0-255,2902,83791,65,229685
24335,0.000833,172.31.40.0-255,66,83857,65,229685
24336,0.000854,172.253.118.0-255,5738,89595,65,229685
24337,0.000856,172.31.40.0-255,66,89661,65,229685
24338,0.000859,172.253.118.0-255,1484,91145,65,229685
24339,0.000879,172.253.118.0-255,5738,96883,65,229685
24340,0.000882,172.31.40.0-255,66,96949,65,229685
24341,0.000903,172.253.118.0-255,7156,104105,65,229685
24342,0.000906,172.31.40.0-255,66,104171,65,229685
24343,0.000917,172.31.40.0-255,66,104237,65,229685
24344,0.000983,172.253.118.0-255,1484,105721,65,229685
24345,0.000995,172.253.118.0-255,2902,108623,65,229685
24346,0.000998,172.31.40.0-255,66,108689,65,229685
24347,0.001002,172.253.118.0-255,2902,111591,65,229685
24348,0.001004,172.31.40.0-255,66,111657,65,229685
24349,0.001018,172.253.118.0-255,2902,114559,65,229685
24350,0.00102,172.31.40.0-255,66,114625,65,229685
24351,0.001023,172.253.118.0-255,1484,116109,65,229685
24352,0.001042,172.31.40.0-255,66,116175,65,229685
24353,0.001074,172.253.118.0-255,1484,117659,65,229685
24354,0.001087,172.31.40.0-255,66,117725,65,229685
24355,0.001102,172.253.118.0-255,1484,119209,65,229685
24356,0.001119,172.253.118.0-255,2902,122111,65,229685
24357,0.001121,172.31.40.0-255,66,122177,65,229685
24358,0.001126,172.253.118.0-255,4320,126497,65,229685
24359,0.001128,172.31.40.0-255,66,126563,65,229685
24360,0.00114,172.253.118.0-255,1484,128047,65,229685
24361,0.001181,172.31.40.0-255,66,128113,65,229685
24362,0.00121,172.253.118.0-255,4320,132433,65,229685
24363,0.00122,172.31.40.0-255,66,132499,65,229685
24364,0.001232,172.253.118.0-255,6438,138937,65,229685
24365,0.001246,172.31.40.0-255,66,139003,65,229685
24366,0.001408,172.253.118.0-255,1484,140487,65,229685
24367,0.001439,172.253.118.0-255,1484,141971,65,229685
24368,0.001442,172.31.40.0-255,66,142037,65,229685
24369,0.001462,172.253.118.0-255,1484,143521,65,229685
24370,0.001469,172.253.118.0-255,5738,149259,65,229685
24371,0.001471,172.31.40.0-255,66,149325,65,229685
24372,0.001498,172.253.118.0-255,1484,150809,65,229685
24373,0.001517,172.253.118.0-255,5020,155829,65,229685
24374,0.001523,172.31.40.0-255,66,155895,65,229685
24375,0.001728,172.253.118.0-255,1484,157379,65,229685
24376,0.001734,172.253.118.0-255,2902,160281,65,229685
24377,0.001737,172.31.40.0-255,66,160347,65,229685
24378,0.001742,172.253.118.0-255,2902,163249,65,229685
24379,0.001751,172.31.40.0-255,66,163315,65,229685
24380,0.001761,172.253.118.0-255,2902,166217,65,229685
24381,0.001772,172.253.118.0-255,7156,173373,65,229685
24382,0.001775,172.253.118.0-255,1484,174857,65,229685
24383,0.001779,172.31.40.0-255,66,174923,65,229685
24384,0.00181,172.253.118.0-255,2902,177825,65,229685
24385,0.001817,172.31.40.0-255,66,177891,65,229685
24386,0.001864,172.253.118.0-255,1484,179375,65,229685
24387,0.001872,172.31.40.0-255,66,179441,65,229685
24388,0.00191,172.31.40.0-255,66,179507,65,229685
24389,0.00193,172.253.118.0-255,5738,185245,65,229685
24390,0.001936,172.31.40.0-255,66,185311,65,229685
24391,0.00195,172.253.118.0-255,7156,192467,65,229685
24392,0.001953,172.253.118.0-255,2902,195369,65,229685
24393,0.001996,172.31.40.0-255,66,195435,65,229685
24394,0.002001,172.253.118.0-255,2902,198337,65,229685
24395,0.002007,172.253.118.0-255,6438,204775,65,229685
24396,0.002016,172.31.40.0-255,66,204841,65,229685
24397,0.002051,172.253.118.0-255,5738,210579,65,229685
24398,0.002063,172.253.118.0-255,2902,213481,65,229685
24399,0.002075,172.253.118.0-255,4320,217801,65,229685
24400,0.002141,172.253.118.0-255,4320,222121,65,229685
24401,0.002155,172.31.40.0-255,66,222187,65,229685
24402,0.002162,172.253.118.0-255,7156,229343,65,229685
24403,0.002172,172.253.118.0-255,105,229448,65,229685
24404,0.002183,172.31.40.0-255,66,229514,65,229685
24405,0.004278,172.31.40.0-255,105,229619,65,229685
24406,0.006835,172.253.118.0-255,66,229685,65,229685
24407,0.0,172.31.40.0-255,105,105,65,459
24408,0.000197,172.31.40.0-255,90,195,65,459
24409,0.000206,172.31.40.0-255,66,261,65,459
24410,0.002588,172.217.194.0-255,66,327,65,459
24411,0.002619,172.217.194.0-255,66,393,65,459
24412,0.002643,172.31.40.0-255,66,459,65,459
24413,0.0,74.125.200.0-255,153,153,65,181125
24414,2.2e-05,172.31.40.0-255,66,219,65,181125
24415,2.9e-05,74.125.200.0-255,1484,1703,65,181125
24416,3.3e-05,172.31.40.0-255,66,1769,65,181125
24417,3.9e-05,74.125.200.0-255,2902,4671,65,181125
24418,4.2e-05,172.31.40.0-255,66,4737,65,181125
24419,4.7e-05,74.125.200.0-255,2902,7639,65,181125
24420,5e-05,172.31.40.0-255,66,7705,65,181125
24421,5.6e-05,74.125.200.0-255,4320,12025,65,181125
24422,6e-05,172.31.40.0-255,66,12091,65,181125
24423,9.8e-05,74.125.200.0-255,2022,14113,65,181125
24424,0.000101,172.31.40.0-255,66,14179,65,181125
24425,0.000188,74.125.200.0-255,1484,15663,65,181125
24426,0.000191,172.31.40.0-255,66,15729,65,181125
24427,0.000212,74.125.200.0-255,2902,18631,65,181125
24428,0.000214,172.31.40.0-255,66,18697,65,181125
24429,0.000221,74.125.200.0-255,5738,24435,65,181125
24430,0.000223,172.31.40.0-255,66,24501,65,181125
24431,0.000227,74.125.200.0-255,1484,25985,65,181125
24432,0.000229,172.31.40.0-255,66,26051,65,181125
24433,0.000261,74.125.200.0-255,1484,27535,65,181125
24434,0.000263,172.31.40.0-255,66,27601,65,181125
24435,0.000321,172.31.40.0-255,66,27667,65,181125
24436,0.000343,74.125.200.0-255,2543,30210,65,181125
24437,0.000345,172.31.40.0-255,66,30276,65,181125
24438,0.000351,74.125.200.0-255,4320,34596,65,181125
24439,0.000353,172.31.40.0-255,66,34662,65,181125
24440,0.000359,74.125.200.0-255,5379,40041,65,181125
24441,0.000361,172.31.40.0-255,66,40107,65,181125
24442,0.000759,74.125.200.0-255,1484,41591,65,181125
24443,0.000764,172.31.40.0-255,66,41657,65,181125
24444,0.00077,74.125.200.0-255,2902,44559,65,181125
24445,0.000772,172.31.40.0-255,66,44625,65,181125
24446,0.000788,74.125.200.0-255,2902,47527,65,181125
24447,0.000791,172.31.40.0-255,66,47593,65,181125
24448,0.00082,74.125.200.0-255,2902,50495,65,181125
24449,0.000823,172.31.40.0-255,66,50561,65,181125
24450,0.00083,74.125.200.0-255,6797,57358,65,181125
24451,0.000832,172.31.40.0-255,66,57424,65,181125
24452,0.000855,74.125.200.0-255,647,58071,65,181125
24453,0.000972,74.125.200.0-255,1484,59555,65,181125
24454,0.000976,172.31.40.0-255,66,59621,65,181125
24455,0.000999,74.125.200.0-255,2902,62523,65,181125
24456,0.001002,74.125.200.0-255,1484,64007,65,181125
24457,0.001005,172.31.40.0-255,66,64073,65,181125
24458,0.001025,74.125.200.0-255,4320,68393,65,181125
24459,0.001028,172.31.40.0-255,66,68459,65,181125
24460,0.00104,74.125.200.0-255,1484,69943,65,181125
24461,0.00106,74.125.200.0-255,5738,75681,65,181125
24462,0.001063,172.31.40.0-255,66,75747,65,181125
24463,0.001077,74.125.200.0-255,4320,80067,65,181125
24464,0.001079,172.31.40.0-255,66,80133,65,181125
24465,0.001109,172.31.40.0-255,66,80199,65,181125
24466,0.001114,74.125.200.0-255,3602,83801,65,181125
24467,0.001117,172.31.40.0-255,66,83867,65,181125
24468,0.001186,74.125.200.0-255,1484,85351,65,181125
24469,0.001199,74.125.200.0-255,2902,88253,65,181125
24470,0.001202,172.31.40.0-255,66,88319,65,181125
24471,0.001223,74.125.200.0-255,5738,94057,65,181125
24472,0.001226,172.31.40.0-255,66,94123,65,181125
24473,0.001244,74.125.200.0-255,4320,98443,65,181125
24474,0.001247,172.31.40.0-255,66,98509,65,181125
24475,0.001277,172.31.40.0-255,66,98575,65,181125
24476,0.001283,74.125.200.0-255,4320,102895,65,181125
24477,0.001285,172.31.40.0-255,66,102961,65,181125
24478,0.001291,74.125.200.0-255,5738,108699,65,181125
24479,0.001294,172.31.40.0-255,66,108765,65,181125
24480,0.001297,74.125.200.0-255,766,109531,65,181125
24481,0.001812,74.125.200.0-255,1484,111015,65,181125
24482,0.001817,172.31.40.0-255,66,111081,65,181125
24483,0.001823,74.125.200.0-255,2902,113983,65,181125
24484,0.001825,172.31.40.0-255,66,114049,65,181125
24485,0.001828,74.125.200.0-255,1484,115533,65,181125
24486,0.001853,74.125.200.0-255,4320,119853,65,181125
24487,0.001856,172.31.40.0-255,66,119919,65,181125
24488,0.001874,74.125.200.0-255,5738,125657,65,181125
24489,0.001876,172.31.40.0-255,66,125723,65,181125
24490,0.001921,74.125.200.0-255,1484,127207,65,181125
24491,0.00196,74.125.200.0-255,2902,130109,65,181125
24492,0.001963,172.31.40.0-255,66,130175,65,181125
24493,0.003829,74.125.200.0-255,1484,131659,65,181125
24494,0.003914,74.125.200.0-255,4320,135979,65,181125
24495,0.003919,172.31.40.0-255,66,136045,65,181125
24496,0.005873,74.125.200.0-255,4320,140365,65,181125
24497,0.005876,172.31.40.0-255,66,140431,65,181125
24498,0.00589,74.125.200.0-255,1484,141915,65,181125
24499,0.00783,74.125.200.0-255,4320,146235,65,181125
24500,0.007836,172.31.40.0-255,66,146301,65,181125
24501,0.009786,74.125.200.0-255,5738,152039,65,181125
24502,0.009794,172.31.40.0-255,66,152105,65,181125
24503,0.011772,74.125.200.0-255,5738,157843,65,181125
24504,0.011781,172.31.40.0-255,66,157909,65,181125
24505,0.013745,74.125.200.0-255,5738,163647,65,181125
24506,0.013752,172.31.40.0-255,66,163713,65,181125
24507,0.01571,74.125.200.0-255,5738,169451,65,181125
24508,0.015718,172.31.40.0-255,66,169517,65,181125
24509,0.017681,74.125.200.0-255,5738,175255,65,181125
24510,0.01769,172.31.40.0-255,66,175321,65,181125
24511,0.01964,74.125.200.0-255,5738,181059,65,181125
24512,0.019647,172.31.40.0-255,66,181125,65,181125
24513,0.0,216.58.221.0-255,153,153,65,147955
24514,2.3e-05,172.31.40.0-255,66,219,65,147955
24515,3.1e-05,216.58.221.0-255,1484,1703,65,147955
24516,3.5e-05,172.31.40.0-255,66,1769,65,147955
24517,4.9e-05,216.58.221.0-255,2902,4671,65,147955
24518,5.3e-05,172.31.40.0-255,66,4737,65,147955
24519,5.9e-05,216.58.221.0-255,4320,9057,65,147955
24520,6.2e-05,172.31.40.0-255,66,9123,65,147955
24521,0.000109,172.31.40.0-255,66,9189,65,147955
24522,0.000115,216.58.221.0-255,5738,14927,65,147955
24523,0.000118,172.31.40.0-255,66,14993,65,147955
24524,0.000124,216.58.221.0-255,4320,19313,65,147955
24525,0.000148,172.31.40.0-255,66,19379,65,147955
24526,0.00016,216.58.221.0-255,2543,21922,65,147955
24527,0.000163,172.31.40.0-255,66,21988,65,147955
24528,0.000202,216.58.221.0-255,1484,23472,65,147955
24529,0.000205,172.31.40.0-255,66,23538,65,147955
24530,0.00021,216.58.221.0-255,2902,26440,65,147955
24531,0.000212,172.31.40.0-255,66,26506,65,147955
24532,0.000239,216.58.221.0-255,5738,32244,65,147955
24533,0.000241,172.31.40.0-255,66,32310,65,147955
24534,0.000247,216.58.221.0-255,4320,36630,65,147955
24535,0.000249,172.31.40.0-255,66,36696,65,147955
24536,0.000255,216.58.221.0-255,5379,42075,65,147955
24537,0.000257,172.31.40.0-255,66,42141,65,147955
24538,0.000305,216.58.221.0-255,2812,44953,65,147955
24539,0.00031,172.31.40.0-255,66,45019,65,147955
24540,0.000313,172.31.40.0-255,66,45085,65,147955
24541,0.000896,216.58.221.0-255,130,45215,65,147955
24542,0.000901,172.31.40.0-255,66,45281,65,147955
24543,0.001047,216.58.221.0-255,1484,46765,65,147955
24544,0.001053,216.58.221.0-255,1484,48249,65,147955
24545,0.001056,172.31.40.0-255,66,48315,65,147955
24546,0.001087,216.58.221.0-255,1484,49799,65,147955
24547,0.001094,216.58.221.0-255,5738,55537,65,147955
24548,0.001097,172.31.40.0-255,66,55603,65,147955
24549,0.001126,216.58.221.0-255,2902,58505,65,147955
24550,0.001128,172.31.40.0-255,66,58571,65,147955
24551,0.001163,172.31.40.0-255,66,58637,65,147955
24552,0.001176,172.31.40.0-255,66,58703,65,147955
24553,0.001742,216.58.221.0-255,1484,60187,65,147955
24554,0.00175,216.58.221.0-255,1484,61671,65,147955
24555,0.001755,172.31.40.0-255,66,61737,65,147955
24556,0.001761,216.58.221.0-255,2902,64639,65,147955
24557,0.001764,172.31.40.0-255,66,64705,65,147955
24558,0.001775,216.58.221.0-255,5738,70443,65,147955
24559,0.001777,172.31.40.0-255,66,70509,65,147955
24560,0.001823,172.31.40.0-255,66,70575,65,147955
24561,0.001831,216.58.221.0-255,7156,77731,65,147955
24562,0.001833,172.31.40.0-255,66,77797,65,147955
24563,0.001836,216.58.221.0-255,1484,79281,65,147955
24564,0.001839,216.58.221.0-255,766,80047,65,147955
24565,0.001841,172.31.40.0-255,66,80113,65,147955
24566,0.001909,216.58.221.0-255,1484,81597,65,147955
24567,0.001914,216.58.221.0-255,1484,83081,65,147955
24568,0.001916,172.31.40.0-255,66,83147,65,147955
24569,0.001948,216.58.221.0-255,1484,84631,65,147955
24570,0.001955,216.58.221.0-255,5738,90369,65,147955
24571,0.001957,172.31.40.0-255,66,90435,65,147955
24572,0.001971,172.31.40.0-255,66,90501,65,147955
24573,0.001987,172.31.40.0-255,66,90567,65,147955
24574,0.001994,216.58.221.0-255,5738,96305,65,147955
24575,0.001996,172.31.40.0-255,66,96371,65,147955
24576,0.002025,216.58.221.0-255,766,97137,65,147955
24577,0.003932,216.58.221.0-255,4320,101457,65,147955
24578,0.003941,172.31.40.0-255,66,101523,65,147955
24579,0.005877,216.58.221.0-255,5738,107261,65,147955
24580,0.005882,172.31.40.0-255,66,107327,65,147955
24581,0.00782,216.58.221.0-255,5738,113065,65,147955
24582,0.007826,172.31.40.0-255,66,113131,65,147955
24583,0.009764,216.58.221.0-255,5738,118869,65,147955
24584,0.009771,172.31.40.0-255,66,118935,65,147955
24585,0.011714,216.58.221.0-255,5738,124673,65,147955
24586,0.011722,172.31.40.0-255,66,124739,65,147955
24587,0.013664,216.58.221.0-255,5738,130477,65,147955
24588,0.013672,172.31.40.0-255,66,130543,65,147955
24589,0.015621,216.58.221.0-255,5738,136281,65,147955
24590,0.015629,172.31.40.0-255,66,136347,65,147955
24591,0.01757,216.58.221.0-255,5738,142085,65,147955
24592,0.017578,172.31.40.0-255,66,142151,65,147955
24593,0.019519,216.58.221.0-255,5738,147889,65,147955
24594,0.019527,172.31.40.0-255,66,147955,65,147955
24595,0.0,74.125.200.0-255,150,150,65,265190
24596,4.9e-05,172.31.40.0-255,66,216,65,265190
24597,5.9e-05,74.125.200.0-255,1484,1700,65,265190
24598,6.4e-05,172.31.40.0-255,66,1766,65,265190
24599,6.8e-05,74.125.200.0-255,1484,3250,65,265190
24600,7.1e-05,172.31.40.0-255,66,3316,65,265190
24601,7.7e-05,74.125.200.0-255,2902,6218,65,265190
24602,8e-05,172.31.40.0-255,66,6284,65,265190
24603,8.9e-05,74.125.200.0-255,5738,12022,65,265190
24604,9.1e-05,172.31.40.0-255,66,12088,65,265190
24605,9.9e-05,74.125.200.0-255,4990,17078,65,265190
24606,0.000102,172.31.40.0-255,66,17144,65,265190
24607,0.000112,74.125.200.0-255,5738,22882,65,265190
24608,0.000116,172.31.40.0-255,66,22948,65,265190
24609,0.000131,172.31.40.0-255,66,23014,65,265190
24610,0.000253,74.125.200.0-255,1484,24498,65,265190
24611,0.000256,172.31.40.0-255,66,24564,65,265190
24612,0.000261,74.125.200.0-255,1484,26048,65,265190
24613,0.000263,172.31.40.0-255,66,26114,65,265190
24614,0.000279,74.125.200.0-255,2902,29016,65,265190
24615,0.000281,172.31.40.0-255,66,29082,65,265190
24616,0.000288,74.125.200.0-255,2902,31984,65,265190
24617,0.00029,172.31.40.0-255,66,32050,65,265190
24618,0.000315,74.125.200.0-255,2902,34952,65,265190
24619,0.000317,172.31.40.0-255,66,35018,65,265190
24620,0.000327,74.125.200.0-255,6797,41815,65,265190
24621,0.00033,172.31.40.0-255,66,41881,65,265190
24622,0.00034,74.125.200.0-255,7156,49037,65,265190
24623,0.000342,172.31.40.0-255,66,49103,65,265190
24624,0.000375,172.31.40.0-255,66,49169,65,265190
24625,0.000455,74.125.200.0-255,377,49546,65,265190
24626,0.000552,74.125.200.0-255,1484,51030,65,265190
24627,0.000556,172.31.40.0-255,66,51096,65,265190
24628,0.000561,74.125.200.0-255,1484,52580,65,265190
24629,0.000576,74.125.200.0-255,2902,55482,65,265190
24630,0.000579,172.31.40.0-255,66,55548,65,265190
24631,0.0006,74.125.200.0-255,2902,58450,65,265190
24632,0.000602,172.31.40.0-255,66,58516,65,265190
24633,0.000626,74.125.200.0-255,2902,61418,65,265190
24634,0.000629,172.31.40.0-255,66,61484,65,265190
24635,0.000637,74.125.200.0-255,4320,65804,65,265190
24636,0.000639,172.31.40.0-255,66,65870,65,265190
24637,0.000685,74.125.200.0-255,1125,66995,65,265190
24638,0.000689,74.125.200.0-255,1484,68479,65,265190
24639,0.000691,172.31.40.0-255,66,68545,65,265190
24640,0.000698,74.125.200.0-255,4320,72865,65,265190
24641,0.000701,172.31.40.0-255,66,72931,65,265190
24642,0.000727,74.125.200.0-255,7156,80087,65,265190
24643,0.000729,172.31.40.0-255,66,80153,65,265190
24644,0.000748,74.125.200.0-255,2902,83055,65,265190
24645,0.00075,172.31.40.0-255,66,83121,65,265190
24646,0.000766,74.125.200.0-255,1125,84246,65,265190
24647,0.000896,74.125.200.0-255,1484,85730,65,265190
24648,0.000899,172.31.40.0-255,66,85796,65,265190
24649,0.000904,74.125.200.0-255,1484,87280,65,265190
24650,0.000921,74.125.200.0-255,1484,88764,65,265190
24651,0.000923,172.31.40.0-255,66,88830,65,265190
24652,0.000926,74.125.200.0-255,1484,90314,65,265190
24653,0.001019,74.125.200.0-255,2902,93216,65,265190
24654,0.001031,74.125.200.0-255,5738,98954,65,265190
24655,0.001034,74.125.200.0-255,1484,100438,65,265190
24656,0.00104,74.125.200.0-255,2902,103340,65,265190
24657,0.001048,74.125.200.0-255,5738,109078,65,265190
24658,0.001052,74.125.200.0-255,1484,110562,65,265190
24659,0.001058,74.125.200.0-255,2902,113464,65,265190
24660,0.001082,172.31.40.0-255,66,113530,65,265190
24661,0.001091,74.125.200.0-255,5020,118550,65,265190
24662,0.001103,172.31.40.0-255,66,118616,65,265190
24663,0.001171,74.125.200.0-255,1484,120100,65,265190
24664,0.00119,74.125.200.0-255,2902,123002,65,265190
24665,0.001198,74.125.200.0-255,4320,127322,65,265190
24666,0.001216,74.125.200.0-255,1484,128806,65,265190
24667,0.001224,172.31.40.0-255,66,128872,65,265190
24668,0.001245,74.125.200.0-255,2902,131774,65,265190
24669,0.001259,172.31.40.0-255,66,131840,65,265190
24670,0.001272,74.125.200.0-255,4320,136160,65,265190
24671,0.001289,74.125.200.0-255,2902,139062,65,265190
24672,0.001294,74.125.200.0-255,2902,141964,65,265190
24673,0.001302,172.31.40.0-255,66,142030,65,265190
24674,0.001311,74.125.200.0-255,1484,143514,65,265190
24675,0.001313,74.125.200.0-255,766,144280,65,265190
24676,0.001337,172.31.40.0-255,66,144346,65,265190
24677,0.001389,74.125.200.0-255,1484,145830,65,265190
24678,0.001409,74.125.200.0-255,2902,148732,65,265190
24679,0.001418,74.125.200.0-255,5738,154470,65,265190
24680,0.001426,172.31.40.0-255,66,154536,65,265190
24681,0.001439,74.125.200.0-255,4320,158856,65,265190
24682,0.001466,74.125.200.0-255,5738,164594,65,265190
24683,0.001483,74.125.200.0-255,4320,168914,65,265190
24684,0.00149,172.31.40.0-255,66,168980,65,265190
24685,0.001507,74.125.200.0-255,7156,176136,65,265190
24686,0.001512,74.125.200.0-255,2184,178320,65,265190
24687,0.001537,172.31.40.0-255,66,178386,65,265190
24688,0.001717,74.125.200.0-255,1484,179870,65,265190
24689,0.001732,74.125.200.0-255,2902,182772,65,265190
24690,0.001754,172.31.40.0-255,66,182838,65,265190
24691,0.001761,74.125.200.0-255,4320,187158,65,265190
24692,0.001773,172.31.40.0-255,66,187224,65,265190
24693,0.001791,74.125.200.0-255,5738,192962,65,265190
24694,0.001808,74.125.200.0-255,1484,194446,65,265190
24695,0.001829,74.125.200.0-255,7156,201602,65,265190
24696,0.001846,74.125.200.0-255,1484,203086,65,265190
24697,0.001852,74.125.200.0-255,2902,205988,65,265190
24698,0.001858,74.125.200.0-255,2902,208890,65,265190
24699,0.001866,172.31.40.0-255,66,208956,65,265190
24700,0.001873,74.125.200.0-255,1484,210440,65,265190
24701,0.001886,74.125.200.0-255,2184,212624,65,265190
24702,0.001909,172.31.40.0-255,66,212690,65,265190
24703,0.002121,74.125.200.0-255,1484,214174,65,265190
24704,0.002135,74.125.200.0-255,1484,215658,65,265190
24705,0.002152,74.125.200.0-255,2902,218560,65,265190
24706,0.002162,172.31.40.0-255,66,218626,65,265190
24707,0.00218,74.125.200.0-255,5738,224364,65,265190
24708,0.002196,74.125.200.0-255,1484,225848,65,265190
24709,0.0022,172.31.40.0-255,66,225914,65,265190
24710,0.002232,74.125.200.0-255,2902,228816,65,265190
24711,0.002241,74.125.200.0-255,5738,234554,65,265190
24712,0.002244,74.125.200.0-255,1484,236038,65,265190
24713,0.002272,74.125.200.0-255,2902,238940,65,265190
24714,0.002327,74.125.200.0-255,4320,243260,65,265190
24715,0.00234,74.125.200.0-255,1484,244744,65,265190
24716,0.002344,74.125.200.0-255,1484,246228,65,265190
24717,0.011238,74.125.200.0-255,1484,247712,65,265190
24718,0.012345,172.31.40.0-255,66,247778,65,265190
24719,0.0146,74.125.200.0-255,5738,253516,65,265190
24720,0.014609,172.31.40.0-255,66,253582,65,265190
24721,0.016858,74.125.200.0-255,5738,259320,65,265190
24722,0.016866,172.31.40.0-255,66,259386,65,265190
24723,0.019118,74.125.200.0-255,5738,265124,65,265190
24724,0.019126,172.31.40.0-255,66,265190,65,265190
24725,0.0,216.58.203.0-255,147,147,65,137155
24726,1.6e-05,172.31.40.0-255,66,213,65,137155
24727,2.3e-05,216.58.203.0-255,1484,1697,65,137155
24728,2.7e-05,172.31.40.0-255,66,1763,65,137155
24729,3.3e-05,216.58.203.0-255,2902,4665,65,137155
24730,3.6e-05,172.31.40.0-255,66,4731,65,137155
24731,4.4e-05,216.58.203.0-255,7156,11887,65,137155
24732,4.7e-05,172.31.40.0-255,66,11953,65,137155
24733,7.1e-05,216.58.203.0-255,2040,13993,65,137155
24734,7.4e-05,172.31.40.0-255,66,14059,65,137155
24735,0.000127,216.58.203.0-255,1484,15543,65,137155
24736,0.000131,172.31.40.0-255,66,15609,65,137155
24737,0.000136,216.58.203.0-255,2902,18511,65,137155
24738,0.000139,172.31.40.0-255,66,18577,65,137155
24739,0.000144,216.58.203.0-255,4320,22897,65,137155
24740,0.000147,172.31.40.0-255,66,22963,65,137155
24741,0.000174,216.58.203.0-255,1484,24447,65,137155
24742,0.000177,172.31.40.0-255,66,24513,65,137155
24743,0.000185,216.58.203.0-255,6797,31310,65,137155
24744,0.000187,172.31.40.0-255,66,31376,65,137155
24745,0.000208,216.58.203.0-255,4320,35696,65,137155
24746,0.000211,172.31.40.0-255,66,35762,65,137155
24747,0.000233,216.58.203.0-255,2902,38664,65,137155
24748,0.000235,172.31.40.0-255,66,38730,65,137155
24749,0.000247,172.31.40.0-255,66,38796,65,137155
24750,0.00027,216.58.203.0-255,1484,40280,65,137155
24751,0.000272,172.31.40.0-255,66,40346,65,137155
24752,0.000277,216.58.203.0-255,2902,43248,65,137155
24753,0.000279,172.31.40.0-255,66,43314,65,137155
24754,0.000301,216.58.203.0-255,1484,44798,65,137155
24755,0.000303,172.31.40.0-255,66,44864,65,137155
24756,0.000322,216.58.203.0-255,2902,47766,65,137155
24757,0.000325,172.31.40.0-255,66,47832,65,137155
24758,0.00033,216.58.203.0-255,4320,52152,65,137155
24759,0.000333,172.31.40.0-255,66,52218,65,137155
24760,0.000353,216.58.203.0-255,1484,53702,65,137155
24761,0.000368,216.58.203.0-255,2543,56245,65,137155
24762,0.000371,172.31.40.0-255,66,56311,65,137155
24763,0.000389,216.58.203.0-255,393,56704,65,137155
24764,0.000955,172.31.40.0-255,66,56770,65,137155
24765,0.001371,216.58.203.0-255,114,56884,65,137155
24766,0.001556,216.58.203.0-255,1484,58368,65,137155
24767,0.001562,172.31.40.0-255,66,58434,65,137155
24768,0.001569,216.58.203.0-255,2902,61336,65,137155
24769,0.00157,172.31.40.0-255,66,61402,65,137155
24770,0.001576,216.58.203.0-255,5738,67140,65,137155
24771,0.001578,172.31.40.0-255,66,67206,65,137155
24772,0.00158,216.58.203.0-255,1484,68690,65,137155
24773,0.001603,216.58.203.0-255,5379,74069,65,137155
24774,0.001605,172.31.40.0-255,66,74135,65,137155
24775,0.003246,216.58.203.0-255,2902,77037,65,137155
24776,0.003251,172.31.40.0-255,66,77103,65,137155
24777,0.003267,216.58.203.0-255,2902,80005,65,137155
24778,0.00327,172.31.40.0-255,66,80071,65,137155
24779,0.004887,216.58.203.0-255,2902,82973,65,137155
24780,0.004891,172.31.40.0-255,66,83039,65,137155
24781,0.004914,216.58.203.0-255,2902,85941,65,137155
24782,0.004916,172.31.40.0-255,66,86007,65,137155
24783,0.006532,216.58.203.0-255,2902,88909,65,137155
24784,0.006538,172.31.40.0-255,66,88975,65,137155
24785,0.00656,216.58.203.0-255,2902,91877,65,137155
24786,0.006562,172.31.40.0-255,66,91943,65,137155
24787,0.008177,216.58.203.0-255,2902,94845,65,137155
24788,0.008184,172.31.40.0-255,66,94911,65,137155
24789,0.008208,216.58.203.0-255,2902,97813,65,137155
24790,0.008211,172.31.40.0-255,66,97879,65,137155
24791,0.009831,216.58.203.0-255,4320,102199,65,137155
24792,0.009839,172.31.40.0-255,66,102265,65,137155
24793,0.00986,216.58.203.0-255,1484,103749,65,137155
24794,0.01149,216.58.203.0-255,4320,108069,65,137155
24795,0.011496,172.31.40.0-255,66,108135,65,137155
24796,0.013147,216.58.203.0-255,5738,113873,65,137155
24797,0.013154,172.31.40.0-255,66,113939,65,137155
24798,0.014809,216.58.203.0-255,5738,119677,65,137155
24799,0.014817,172.31.40.0-255,66,119743,65,137155
24800,0.016483,216.58.203.0-255,5738,125481,65,137155
24801,0.016491,172.31.40.0-255,66,125547,65,137155
24802,0.01814,216.58.203.0-255,5738,131285,65,137155
24803,0.018146,172.31.40.0-255,66,131351,65,137155
24804,0.019795,216.58.203.0-255,5738,137089,65,137155
24805,0.019803,172.31.40.0-255,66,137155,65,137155
24806,0.0,172.253.118.0-255,291,291,65,168694
24807,2.4e-05,172.31.40.0-255,66,357,65,168694
24808,3.1e-05,172.253.118.0-255,1484,1841,65,168694
24809,3.5e-05,172.31.40.0-255,66,1907,65,168694
24810,5e-05,172.253.118.0-255,4320,6227,65,168694
24811,5.4e-05,172.31.40.0-255,66,6293,65,168694
24812,5.9e-05,172.253.118.0-255,4320,10613,65,168694
24813,6.1e-05,172.31.40.0-255,66,10679,65,168694
24814,7.4e-05,172.31.40.0-255,66,10745,65,168694
24815,8.2e-05,172.253.118.0-255,7156,17901,65,168694
24816,8.5e-05,172.31.40.0-255,66,17967,65,168694
24817,0.000159,172.31.40.0-255,66,18033,65,168694
24818,0.000224,172.253.118.0-255,4320,22353,65,168694
24819,0.000227,172.31.40.0-255,66,22419,65,168694
24820,0.000238,172.253.118.0-255,5738,28157,65,168694
24821,0.000241,172.31.40.0-255,66,28223,65,168694
24822,0.000248,172.253.118.0-255,7108,35331,65,168694
24823,0.00025,172.31.40.0-255,66,35397,65,168694
24824,0.000254,172.253.118.0-255,109,35506,65,168694
24825,0.000256,172.31.40.0-255,66,35572,65,168694
24826,0.000438,172.253.118.0-255,1484,37056,65,168694
24827,0.000443,172.31.40.0-255,66,37122,65,168694
24828,0.00045,172.253.118.0-255,2902,40024,65,168694
24829,0.000452,172.31.40.0-255,66,40090,65,168694
24830,0.000473,172.253.118.0-255,2902,42992,65,168694
24831,0.000476,172.31.40.0-255,66,43058,65,168694
24832,0.0005,172.253.118.0-255,2902,45960,65,168694
24833,0.000502,172.31.40.0-255,66,46026,65,168694
24834,0.00054,172.31.40.0-255,66,46092,65,168694
24835,0.000558,172.253.118.0-255,2902,48994,65,168694
24836,0.000561,172.31.40.0-255,66,49060,65,168694
24837,0.000572,172.31.40.0-255,66,49126,65,168694
24838,0.000595,172.253.118.0-255,2184,51310,65,168694
24839,0.000598,172.31.40.0-255,66,51376,65,168694
24840,0.000796,172.253.118.0-255,1484,52860,65,168694
24841,0.000801,172.253.118.0-255,2902,55762,65,168694
24842,0.000807,172.253.118.0-255,5738,61500,65,168694
24843,0.000809,172.253.118.0-255,1484,62984,65,168694
24844,0.000822,172.31.40.0-255,66,63050,65,168694
24845,0.000825,172.31.40.0-255,66,63116,65,168694
24846,0.000831,172.253.118.0-255,2902,66018,65,168694
24847,0.000833,172.31.40.0-255,66,66084,65,168694
24848,0.000852,172.31.40.0-255,66,66150,65,168694
24849,0.000857,172.253.118.0-255,2902,69052,65,168694
24850,0.000859,172.31.40.0-255,66,69118,65,168694
24851,0.000874,172.253.118.0-255,5020,74138,65,168694
24852,0.000882,172.31.40.0-255,66,74204,65,168694
24853,0.000986,172.253.118.0-255,1484,75688,65,168694
24854,0.000992,172.253.118.0-255,2902,78590,65,168694
24855,0.000995,172.31.40.0-255,66,78656,65,168694
24856,0.001002,172.253.118.0-255,5738,84394,65,168694
24857,0.001005,172.31.40.0-255,66,84460,65,168694
24858,0.00105,172.31.40.0-255,66,84526,65,168694
24859,0.001056,172.253.118.0-255,7156,91682,65,168694
24860,0.001059,172.31.40.0-255,66,91748,65,168694
24861,0.001117,172.31.40.0-255,66,91814,65,168694
24862,0.001191,172.31.40.0-255,66,91880,65,168694
24863,0.001275,172.253.118.0-255,1484,93364,65,168694
24864,0.001289,172.253.118.0-255,2902,96266,65,168694
24865,0.001292,172.31.40.0-255,66,96332,65,168694
24866,0.001298,172.253.118.0-255,4320,100652,65,168694
24867,0.0013,172.31.40.0-255,66,100718,65,168694
24868,0.001352,172.31.40.0-255,66,100784,65,168694
24869,0.001356,172.253.118.0-255,2902,103686,65,168694
24870,0.001358,172.31.40.0-255,66,103752,65,168694
24871,0.001392,172.31.40.0-255,66,103818,65,168694
24872,0.00142,172.253.118.0-255,2184,106002,65,168694
24873,0.001422,172.31.40.0-255,66,106068,65,168694
24874,0.001446,172.253.118.0-255,1484,107552,65,168694
24875,0.001451,172.253.118.0-255,2902,110454,65,168694
24876,0.001454,172.31.40.0-255,66,110520,65,168694
24877,0.001458,172.253.118.0-255,2902,113422,65,168694
24878,0.001461,172.31.40.0-255,66,113488,65,168694
24879,0.001479,172.253.118.0-255,2902,116390,65,168694
24880,0.001486,172.31.40.0-255,66,116456,65,168694
24881,0.001492,172.253.118.0-255,5738,122194,65,168694
24882,0.001495,172.31.40.0-255,66,122260,65,168694
24883,0.001525,172.253.118.0-255,4320,126580,65,168694
24884,0.001528,172.31.40.0-255,66,126646,65,168694
24885,0.001546,172.253.118.0-255,4320,130966,65,168694
24886,0.00155,172.31.40.0-255,66,131032,65,168694
24887,0.001551,172.31.40.0-255,66,131098,65,168694
24888,0.001592,172.253.118.0-255,6438,137536,65,168694
24889,0.001595,172.31.40.0-255,66,137602,65,168694
24890,0.001606,172.31.40.0-255,66,137668,65,168694
24891,0.001617,172.31.40.0-255,66,137734,65,168694
24892,0.001635,172.253.118.0-255,2184,139918,65,168694
24893,0.001648,172.253.118.0-255,1484,141402,65,168694
24894,0.001656,172.31.40.0-255,66,141468,65,168694
24895,0.001667,172.253.118.0-255,4320,145788,65,168694
24896,0.0017,172.253.118.0-255,7156,152944,65,168694
24897,0.001703,172.253.118.0-255,1484,154428,65,168694
24898,0.00171,172.31.40.0-255,66,154494,65,168694
24899,0.001747,172.253.118.0-255,5738,160232,65,168694
24900,0.001756,172.31.40.0-255,66,160298,65,168694
24901,0.001775,172.31.40.0-255,66,160364,65,168694
24902,0.001797,172.253.118.0-255,1484,161848,65,168694
24903,0.001804,172.253.118.0-255,6438,168286,65,168694
24904,0.001852,172.31.40.0-255,66,168352,65,168694
24905,0.001885,172.253.118.0-255,105,168457,65,168694
24906,0.001902,172.31.40.0-255,66,168523,65,168694
24907,0.017864,172.31.40.0-255,105,168628,65,168694
24908,0.019934,172.253.118.0-255,66,168694,65,168694
24909,0.0,172.217.194.0-255,146,146,65,156784
24910,2.5e-05,172.31.40.0-255,66,212,65,156784
24911,3.2e-05,172.217.194.0-255,1484,1696,65,156784
24912,3.7e-05,172.31.40.0-255,66,1762,65,156784
24913,5.2e-05,172.217.194.0-255,2902,4664,65,156784
24914,5.5e-05,172.31.40.0-255,66,4730,65,156784
24915,6.3e-05,172.217.194.0-255,7156,11886,65,156784
24916,6.6e-05,172.31.40.0-255,66,11952,65,156784
24917,0.000111,172.31.40.0-255,66,12018,65,156784
24918,0.000118,172.217.194.0-255,7156,19174,65,156784
24919,0.00012,172.31.40.0-255,66,19240,65,156784
24920,0.000162,172.217.194.0-255,3961,23201,65,156784
24921,0.000165,172.31.40.0-255,66,23267,65,156784
24922,0.000212,172.217.194.0-255,1484,24751,65,156784
24923,0.000215,172.31.40.0-255,66,24817,65,156784
24924,0.00022,172.217.194.0-255,2902,27719,65,156784
24925,0.000222,172.31.40.0-255,66,27785,65,156784
24926,0.00025,172.217.194.0-255,5738,33523,65,156784
24927,0.000253,172.31.40.0-255,66,33589,65,156784
24928,0.000287,172.31.40.0-255,66,33655,65,156784
24929,0.000322,172.31.40.0-255,66,33721,65,156784
24930,0.000324,172.217.194.0-255,365,34086,65,156784
24931,0.000327,172.31.40.0-255,66,34152,65,156784
24932,0.000453,172.217.194.0-255,1484,35636,65,156784
24933,0.000458,172.31.40.0-255,66,35702,65,156784
24934,0.000463,172.217.194.0-255,2902,38604,65,156784
24935,0.000465,172.31.40.0-255,66,38670,65,156784
24936,0.00047,172.217.194.0-255,2902,41572,65,156784
24937,0.000477,172.31.40.0-255,66,41638,65,156784
24938,0.000499,172.217.194.0-255,2902,44540,65,156784
24939,0.000565,172.217.194.0-255,1484,46024,65,156784
24940,0.00058,172.217.194.0-255,2902,48926,65,156784
24941,0.000591,172.217.194.0-255,2902,51828,65,156784
24942,0.000604,172.217.194.0-255,2902,54730,65,156784
24943,0.000629,172.217.194.0-255,7156,61886,65,156784
24944,0.000648,172.217.194.0-255,4320,66206,65,156784
24945,0.000677,172.217.194.0-255,2184,68390,65,156784
24946,0.000712,172.31.40.0-255,66,68456,65,156784
24947,0.001801,172.217.194.0-255,1484,69940,65,156784
24948,0.001807,172.31.40.0-255,66,70006,65,156784
24949,0.001815,172.217.194.0-255,2902,72908,65,156784
24950,0.001822,172.217.194.0-255,5738,78646,65,156784
24951,0.001843,172.217.194.0-255,5738,84384,65,156784
24952,0.001871,172.217.194.0-255,7156,91540,65,156784
24953,0.001925,172.217.194.0-255,1484,93024,65,156784
24954,0.001944,172.217.194.0-255,2902,95926,65,156784
24955,0.001965,172.217.194.0-255,5738,101664,65,156784
24956,0.001968,172.217.194.0-255,1484,103148,65,156784
24957,0.002014,172.217.194.0-255,5738,108886,65,156784
24958,0.002029,172.217.194.0-255,5020,113906,65,156784
24959,0.002063,172.217.194.0-255,1484,115390,65,156784
24960,0.002077,172.217.194.0-255,2902,118292,65,156784
24961,0.002083,172.217.194.0-255,5738,124030,65,156784
24962,0.002103,172.217.194.0-255,1484,125514,65,156784
24963,0.002162,172.217.194.0-255,2184,127698,65,156784
24964,0.007652,172.31.40.0-255,66,127764,65,156784
24965,0.009996,172.217.194.0-255,5738,133502,65,156784
24966,0.010005,172.31.40.0-255,66,133568,65,156784
24967,0.012399,172.217.194.0-255,5738,139306,65,156784
24968,0.01241,172.31.40.0-255,66,139372,65,156784
24969,0.014778,172.217.194.0-255,5738,145110,65,156784
24970,0.014784,172.31.40.0-255,66,145176,65,156784
24971,0.01715,172.217.194.0-255,5738,150914,65,156784
24972,0.017158,172.31.40.0-255,66,150980,65,156784
24973,0.019483,172.217.194.0-255,5738,156718,65,156784
24974,0.019494,172.31.40.0-255,66,156784,65,156784
24975,0.0,74.125.24.0-255,153,153,65,230793
24976,2.3e-05,172.31.40.0-255,66,219,65,230793
24977,2.9e-05,74.125.24.0-255,1484,1703,65,230793
24978,3.3e-05,172.31.40.0-255,66,1769,65,230793
24979,3.9e-05,74.125.24.0-255,2902,4671,65,230793
24980,4.2e-05,172.31.40.0-255,66,4737,65,230793
24981,4.6e-05,74.125.24.0-255,1484,6221,65,230793
24982,4.8e-05,172.31.40.0-255,66,6287,65,230793
24983,6.5e-05,74.125.24.0-255,4320,10607,65,230793
24984,6.7e-05,172.31.40.0-255,66,10673,65,230793
24985,8.6e-05,74.125.24.0-255,3457,14130,65,230793
24986,8.9e-05,172.31.40.0-255,66,14196,65,230793
24987,0.000163,74.125.24.0-255,1484,15680,65,230793
24988,0.000166,172.31.40.0-255,66,15746,65,230793
24989,0.000172,74.125.24.0-255,2902,18648,65,230793
24990,0.000174,172.31.40.0-255,66,18714,65,230793
24991,0.000204,74.125.24.0-255,5738,24452,65,230793
24992,0.000208,172.31.40.0-255,66,24518,65,230793
24993,0.000246,74.125.24.0-255,7156,31674,65,230793
24994,0.000249,172.31.40.0-255,66,31740,65,230793
24995,0.000273,74.125.24.0-255,1125,32865,65,230793
24996,0.000276,172.31.40.0-255,66,32931,65,230793
24997,0.000287,172.31.40.0-255,66,32997,65,230793
24998,0.000291,74.125.24.0-255,2902,35899,65,230793
24999,0.000294,172.31.40.0-255,66,35965,65,230793
25000,0.000313,74.125.24.0-255,1484,37449,65,230793
25001,0.000316,172.31.40.0-255,66,37515,65,230793
25002,0.00033,74.125.24.0-255,2543,40058,65,230793
25003,0.000333,172.31.40.0-255,66,40124,65,230793
25004,0.000357,74.125.24.0-255,1484,41608,65,230793
25005,0.000359,172.31.40.0-255,66,41674,65,230793
25006,0.000371,74.125.24.0-255,1484,43158,65,230793
25007,0.0004,74.125.24.0-255,1484,44642,65,230793
25008,0.000403,172.31.40.0-255,66,44708,65,230793
25009,0.000407,74.125.24.0-255,2902,47610,65,230793
25010,0.00041,172.31.40.0-255,66,47676,65,230793
25011,0.000416,74.125.24.0-255,5738,53414,65,230793
25012,0.000418,172.31.40.0-255,66,53480,65,230793
25013,0.000435,74.125.24.0-255,3961,57441,65,230793
25014,0.000437,172.31.40.0-255,66,57507,65,230793
25015,0.000918,74.125.24.0-255,411,57918,65,230793
25016,0.000945,74.125.24.0-255,1484,59402,65,230793
25017,0.00095,172.31.40.0-255,66,59468,65,230793
25018,0.000974,74.125.24.0-255,4320,63788,65,230793
25019,0.000976,172.31.40.0-255,66,63854,65,230793
25020,0.000984,74.125.24.0-255,7156,71010,65,230793
25021,0.000986,172.31.40.0-255,66,71076,65,230793
25022,0.000999,74.125.24.0-255,2902,73978,65,230793
25023,0.001002,172.31.40.0-255,66,74044,65,230793
25024,0.001014,74.125.24.0-255,5738,79782,65,230793
25025,0.001016,172.31.40.0-255,66,79848,65,230793
25026,0.001041,172.31.40.0-255,66,79914,65,230793
25027,0.001086,74.125.24.0-255,332,80246,65,230793
25028,0.001099,74.125.24.0-255,1484,81730,65,230793
25029,0.001102,172.31.40.0-255,66,81796,65,230793
25030,0.001118,74.125.24.0-255,4320,86116,65,230793
25031,0.00112,172.31.40.0-255,66,86182,65,230793
25032,0.001123,74.125.24.0-255,1484,87666,65,230793
25033,0.00115,74.125.24.0-255,7156,94822,65,230793
25034,0.001152,172.31.40.0-255,66,94888,65,230793
25035,0.001156,74.125.24.0-255,2902,97790,65,230793
25036,0.001158,172.31.40.0-255,66,97856,65,230793
25037,0.001189,172.31.40.0-255,66,97922,65,230793
25038,0.001191,74.125.24.0-255,589,98511,65,230793
25039,0.001213,74.125.24.0-255,1484,99995,65,230793
25040,0.001215,172.31.40.0-255,66,100061,65,230793
25041,0.001218,74.125.24.0-255,1484,101545,65,230793
25042,0.001234,74.125.24.0-255,2902,104447,65,230793
25043,0.001236,172.31.40.0-255,66,104513,65,230793
25044,0.001239,74.125.24.0-255,1484,105997,65,230793
25045,0.00127,172.31.40.0-255,66,106063,65,230793
25046,0.001278,172.31.40.0-255,66,106129,65,230793
25047,0.001308,74.125.24.0-255,2902,109031,65,230793
25048,0.00131,172.31.40.0-255,66,109097,65,230793
25049,0.001335,74.125.24.0-255,6438,115535,65,230793
25050,0.001338,172.31.40.0-255,66,115601,65,230793
25051,0.001624,74.125.24.0-255,1484,117085,65,230793
25052,0.001629,74.125.24.0-255,2902,119987,65,230793
25053,0.001632,172.31.40.0-255,66,120053,65,230793
25054,0.001659,74.125.24.0-255,5738,125791,65,230793
25055,0.001661,74.125.24.0-255,1484,127275,65,230793
25056,0.001664,172.31.40.0-255,66,127341,65,230793
25057,0.001696,172.31.40.0-255,66,127407,65,230793
25058,0.001699,74.125.24.0-255,1484,128891,65,230793
25059,0.00172,74.125.24.0-255,2902,131793,65,230793
25060,0.001722,172.31.40.0-255,66,131859,65,230793
25061,0.001744,74.125.24.0-255,6438,138297,65,230793
25062,0.001746,172.31.40.0-255,66,138363,65,230793
25063,0.001778,74.125.24.0-255,1484,139847,65,230793
25064,0.001783,74.125.24.0-255,2902,142749,65,230793
25065,0.001785,172.31.40.0-255,66,142815,65,230793
25066,0.001789,74.125.24.0-255,2902,145717,65,230793
25067,0.001791,172.31.40.0-255,66,145783,65,230793
25068,0.001806,74.125.24.0-255,2902,148685,65,230793
25069,0.001808,172.31.40.0-255,66,148751,65,230793
25070,0.001814,74.125.24.0-255,5738,154489,65,230793
25071,0.001815,172.31.40.0-255,66,154555,65,230793
25072,0.001832,74.125.24.0-255,7156,161711,65,230793
25073,0.001834,172.31.40.0-255,66,161777,65,230793
25074,0.001838,74.125.24.0-255,4320,166097,65,230793
25075,0.001841,172.31.40.0-255,66,166163,65,230793
25076,0.00186,74.125.24.0-255,6438,172601,65,230793
25077,0.001862,172.31.40.0-255,66,172667,65,230793
25078,0.001881,74.125.24.0-255,4320,176987,65,230793
25079,0.001883,172.31.40.0-255,66,177053,65,230793
25080,0.00192,172.31.40.0-255,66,177119,65,230793
25081,0.001933,172.31.40.0-255,66,177185,65,230793
25082,0.001953,172.31.40.0-255,66,177251,65,230793
25083,0.001955,74.125.24.0-255,766,178017,65,230793
25084,0.001989,74.125.24.0-255,1484,179501,65,230793
25085,0.001991,172.31.40.0-255,66,179567,65,230793
25086,0.001996,74.125.24.0-255,2902,182469,65,230793
25087,0.001998,172.31.40.0-255,66,182535,65,230793
25088,0.002022,74.125.24.0-255,5738,188273,65,230793
25089,0.002025,172.31.40.0-255,66,188339,65,230793
25090,0.002055,74.125.24.0-255,4320,192659,65,230793
25091,0.002057,172.31.40.0-255,66,192725,65,230793
25092,0.002079,172.31.40.0-255,66,192791,65,230793
25093,0.002082,74.125.24.0-255,1484,194275,65,230793
25094,0.002091,172.31.40.0-255,66,194341,65,230793
25095,0.002103,74.125.24.0-255,766,195107,65,230793
25096,0.002143,74.125.24.0-255,1484,196591,65,230793
25097,0.002147,172.31.40.0-255,66,196657,65,230793
25098,0.002151,74.125.24.0-255,2902,199559,65,230793
25099,0.002154,172.31.40.0-255,66,199625,65,230793
25100,0.002175,74.125.24.0-255,5738,205363,65,230793
25101,0.002178,172.31.40.0-255,66,205429,65,230793
25102,0.00219,74.125.24.0-255,2902,208331,65,230793
25103,0.002193,172.31.40.0-255,66,208397,65,230793
25104,0.002219,172.31.40.0-255,66,208463,65,230793
25105,0.002222,74.125.24.0-255,1484,209947,65,230793
25106,0.002241,74.125.24.0-255,4320,214267,65,230793
25107,0.002244,172.31.40.0-255,66,214333,65,230793
25108,0.002267,74.125.24.0-255,5020,219353,65,230793
25109,0.00227,172.31.40.0-255,66,219419,65,230793
25110,0.002277,74.125.24.0-255,7156,226575,65,230793
25111,0.002279,172.31.40.0-255,66,226641,65,230793
25112,0.002299,74.125.24.0-255,2902,229543,65,230793
25113,0.002302,172.31.40.0-255,66,229609,65,230793
25114,0.002313,172.31.40.0-255,66,229675,65,230793
25115,0.002346,172.31.40.0-255,66,229741,65,230793
25116,0.002391,172.31.40.0-255,66,229807,65,230793
25117,0.002406,172.31.40.0-255,66,229873,65,230793
25118,0.002419,172.31.40.0-255,66,229939,65,230793
25119,0.002435,74.125.24.0-255,512,230451,65,230793
25120,0.002438,74.125.24.0-255,105,230556,65,230793
25121,0.008669,172.31.40.0-255,66,230622,65,230793
25122,0.008717,172.31.40.0-255,105,230727,65,230793
25123,0.011264,74.125.24.0-255,66,230793,65,230793
25124,0.0,74.125.24.0-255,153,153,65,220458
25125,2.5e-05,172.31.40.0-255,66,219,65,220458
25126,3.3e-05,74.125.24.0-255,1484,1703,65,220458
25127,3.8e-05,172.31.40.0-255,66,1769,65,220458
25128,4.3e-05,74.125.24.0-255,2902,4671,65,220458
25129,5.5e-05,172.31.40.0-255,66,4737,65,220458
25130,6.3e-05,74.125.24.0-255,7156,11893,65,220458
25131,6.5e-05,172.31.40.0-255,66,11959,65,220458
25132,6.9e-05,74.125.24.0-255,1983,13942,65,220458
25133,7.2e-05,172.31.40.0-255,66,14008,65,220458
25134,0.000109,172.31.40.0-255,66,14074,65,220458
25135,0.000138,74.125.24.0-255,1484,15558,65,220458
25136,0.000141,172.31.40.0-255,66,15624,65,220458
25137,0.000147,74.125.24.0-255,5379,21003,65,220458
25138,0.000151,172.31.40.0-255,66,21069,65,220458
25139,0.000241,74.125.24.0-255,1484,22553,65,220458
25140,0.000246,172.31.40.0-255,66,22619,65,220458
25141,0.000253,74.125.24.0-255,2902,25521,65,220458
25142,0.000255,172.31.40.0-255,66,25587,65,220458
25143,0.000266,74.125.24.0-255,5738,31325,65,220458
25144,0.000269,172.31.40.0-255,66,31391,65,220458
25145,0.000275,74.125.24.0-255,4320,35711,65,220458
25146,0.000277,172.31.40.0-255,66,35777,65,220458
25147,0.000331,172.31.40.0-255,66,35843,65,220458
25148,0.000338,74.125.24.0-255,6797,42640,65,220458
25149,0.00034,172.31.40.0-255,66,42706,65,220458
25150,0.000549,74.125.24.0-255,411,43117,65,220458
25151,0.000555,172.31.40.0-255,66,43183,65,220458
25152,0.000609,74.125.24.0-255,331,43514,65,220458
25153,0.000612,172.31.40.0-255,66,43580,65,220458
25154,0.00084,74.125.24.0-255,1484,45064,65,220458
25155,0.000849,74.125.24.0-255,2902,47966,65,220458
25156,0.000854,172.31.40.0-255,66,48032,65,220458
25157,0.000861,74.125.24.0-255,5738,53770,65,220458
25158,0.000864,172.31.40.0-255,66,53836,65,220458
25159,0.000881,172.31.40.0-255,66,53902,65,220458
25160,0.000911,74.125.24.0-255,1484,55386,65,220458
25161,0.000925,74.125.24.0-255,1484,56870,65,220458
25162,0.000929,172.31.40.0-255,66,56936,65,220458
25163,0.000956,74.125.24.0-255,5738,62674,65,220458
25164,0.000959,172.31.40.0-255,66,62740,65,220458
25165,0.000992,74.125.24.0-255,3602,66342,65,220458
25166,0.000996,172.31.40.0-255,66,66408,65,220458
25167,0.00106,74.125.24.0-255,1484,67892,65,220458
25168,0.001066,74.125.24.0-255,2902,70794,65,220458
25169,0.00107,172.31.40.0-255,66,70860,65,220458
25170,0.001077,74.125.24.0-255,5738,76598,65,220458
25171,0.001079,172.31.40.0-255,66,76664,65,220458
25172,0.001122,172.31.40.0-255,66,76730,65,220458
25173,0.001166,74.125.24.0-255,4320,81050,65,220458
25174,0.00117,172.31.40.0-255,66,81116,65,220458
25175,0.001195,74.125.24.0-255,6438,87554,65,220458
25176,0.001198,172.31.40.0-255,66,87620,65,220458
25177,0.001591,74.125.24.0-255,1484,89104,65,220458
25178,0.001599,74.125.24.0-255,2902,92006,65,220458
25179,0.001603,172.31.40.0-255,66,92072,65,220458
25180,0.001608,74.125.24.0-255,1484,93556,65,220458
25181,0.001635,74.125.24.0-255,4320,97876,65,220458
25182,0.001638,172.31.40.0-255,66,97942,65,220458
25183,0.001657,172.31.40.0-255,66,98008,65,220458
25184,0.001669,172.31.40.0-255,66,98074,65,220458
25185,0.001701,74.125.24.0-255,4320,102394,65,220458
25186,0.001704,172.31.40.0-255,66,102460,65,220458
25187,0.001734,74.125.24.0-255,5738,108198,65,220458
25188,0.001737,172.31.40.0-255,66,108264,65,220458
25189,0.001777,172.31.40.0-255,66,108330,65,220458
25190,0.001789,172.31.40.0-255,66,108396,65,220458
25191,0.001796,74.125.24.0-255,1484,109880,65,220458
25192,0.001802,74.125.24.0-255,2902,112782,65,220458
25193,0.001805,172.31.40.0-255,66,112848,65,220458
25194,0.001812,74.125.24.0-255,5738,118586,65,220458
25195,0.001815,172.31.40.0-255,66,118652,65,220458
25196,0.001829,172.31.40.0-255,66,118718,65,220458
25197,0.001839,172.31.40.0-255,66,118784,65,220458
25198,0.001901,74.125.24.0-255,2184,120968,65,220458
25199,0.001904,172.31.40.0-255,66,121034,65,220458
25200,0.001976,74.125.24.0-255,1484,122518,65,220458
25201,0.001982,74.125.24.0-255,2902,125420,65,220458
25202,0.001985,172.31.40.0-255,66,125486,65,220458
25203,0.00199,74.125.24.0-255,1484,126970,65,220458
25204,0.00202,74.125.24.0-255,4320,131290,65,220458
25205,0.002023,172.31.40.0-255,66,131356,65,220458
25206,0.002049,172.31.40.0-255,66,131422,65,220458
25207,0.002052,74.125.24.0-255,1484,132906,65,220458
25208,0.002094,172.31.40.0-255,66,132972,65,220458
25209,0.002135,74.125.24.0-255,1484,134456,65,220458
25210,0.002155,74.125.24.0-255,2902,137358,65,220458
25211,0.002157,172.31.40.0-255,66,137424,65,220458
25212,0.002177,74.125.24.0-255,4320,141744,65,220458
25213,0.002191,74.125.24.0-255,1484,143228,65,220458
25214,0.002195,74.125.24.0-255,2902,146130,65,220458
25215,0.002213,74.125.24.0-255,2902,149032,65,220458
25216,0.00224,74.125.24.0-255,1484,150516,65,220458
25217,0.002273,74.125.24.0-255,2902,153418,65,220458
25218,0.002291,74.125.24.0-255,2184,155602,65,220458
25219,0.002297,74.125.24.0-255,5738,161340,65,220458
25220,0.002328,74.125.24.0-255,5738,167078,65,220458
25221,0.002358,74.125.24.0-255,7156,174234,65,220458
25222,0.002365,74.125.24.0-255,7156,181390,65,220458
25223,0.002431,74.125.24.0-255,5738,187128,65,220458
25224,0.002705,172.31.40.0-255,66,187194,65,220458
25225,0.004692,172.31.40.0-255,101,187295,65,220458
25226,0.005002,74.125.24.0-255,5738,193033,65,220458
25227,0.005008,172.31.40.0-255,66,193099,65,220458
25228,0.006936,74.125.24.0-255,66,193165,65,220458
25229,0.007271,74.125.24.0-255,5738,198903,65,220458
25230,0.007276,172.31.40.0-255,66,198969,65,220458
25231,0.009543,74.125.24.0-255,5738,204707,65,220458
25232,0.009547,172.31.40.0-255,66,204773,65,220458
25233,0.011808,74.125.24.0-255,5738,210511,65,220458
25234,0.011815,172.31.40.0-255,66,210577,65,220458
25235,0.014135,74.125.24.0-255,5738,216315,65,220458
25236,0.014141,172.31.40.0-255,66,216381,65,220458
25237,0.016422,74.125.24.0-255,3906,220287,65,220458
25238,0.016428,172.31.40.0-255,66,220353,65,220458
25239,0.01666,172.31.40.0-255,105,220458,65,220458
25240,0.0,172.217.194.0-255,150,150,65,176123
25241,2.7e-05,172.31.40.0-255,66,216,65,176123
25242,3.5e-05,172.217.194.0-255,1484,1700,65,176123
25243,4e-05,172.31.40.0-255,66,1766,65,176123
25244,4.6e-05,172.217.194.0-255,2902,4668,65,176123
25245,4.9e-05,172.31.40.0-255,66,4734,65,176123
25246,5.7e-05,172.217.194.0-255,7156,11890,65,176123
25247,6.1e-05,172.31.40.0-255,66,11956,65,176123
25248,6.4e-05,172.217.194.0-255,1484,13440,65,176123
25249,6.6e-05,172.31.40.0-255,66,13506,65,176123
25250,0.00011,172.31.40.0-255,66,13572,65,176123
25251,0.000128,172.31.40.0-255,66,13638,65,176123
25252,0.000132,172.217.194.0-255,2184,15822,65,176123
25253,0.000134,172.31.40.0-255,66,15888,65,176123
25254,0.000187,172.217.194.0-255,1484,17372,65,176123
25255,0.00019,172.31.40.0-255,66,17438,65,176123
25256,0.000195,172.217.194.0-255,2902,20340,65,176123
25257,0.000198,172.31.40.0-255,66,20406,65,176123
25258,0.000204,172.217.194.0-255,5738,26144,65,176123
25259,0.000206,172.31.40.0-255,66,26210,65,176123
25260,0.000214,172.217.194.0-255,7117,33327,65,176123
25261,0.000217,172.31.40.0-255,66,33393,65,176123
25262,0.000619,172.217.194.0-255,1484,34877,65,176123
25263,0.000625,172.31.40.0-255,66,34943,65,176123
25264,0.000631,172.217.194.0-255,2902,37845,65,176123
25265,0.000634,172.31.40.0-255,66,37911,65,176123
25266,0.000641,172.217.194.0-255,5738,43649,65,176123
25267,0.000643,172.31.40.0-255,66,43715,65,176123
25268,0.000704,172.31.40.0-255,66,43781,65,176123
25269,0.000727,172.217.194.0-255,4320,48101,65,176123
25270,0.000752,172.217.194.0-255,6438,54539,65,176123
25271,0.000759,172.31.40.0-255,66,54605,65,176123
25272,0.000805,172.217.194.0-255,1484,56089,65,176123
25273,0.000819,172.217.194.0-255,2902,58991,65,176123
25274,0.000827,172.31.40.0-255,66,59057,65,176123
25275,0.000842,172.217.194.0-255,5738,64795,65,176123
25276,0.000848,172.31.40.0-255,66,64861,65,176123
25277,0.000865,172.217.194.0-255,4320,69181,65,176123
25278,0.000875,172.31.40.0-255,66,69247,65,176123
25279,0.000921,172.217.194.0-255,1484,70731,65,176123
25280,0.000936,172.217.194.0-255,5738,76469,65,176123
25281,0.000941,172.31.40.0-255,66,76535,65,176123
25282,0.000997,172.217.194.0-255,5738,82273,65,176123
25283,0.001002,172.217.194.0-255,2902,85175,65,176123
25284,0.001017,172.217.194.0-255,4320,89495,65,176123
25285,0.00102,172.217.194.0-255,1484,90979,65,176123
25286,0.001026,172.31.40.0-255,66,91045,65,176123
25287,0.001079,172.31.40.0-255,66,91111,65,176123
25288,0.00109,172.217.194.0-255,4320,95431,65,176123
25289,0.001094,172.31.40.0-255,66,95497,65,176123
25290,0.001126,172.31.40.0-255,66,95563,65,176123
25291,0.001151,172.217.194.0-255,5020,100583,65,176123
25292,0.001203,172.217.194.0-255,1484,102067,65,176123
25293,0.001229,172.217.194.0-255,2902,104969,65,176123
25294,0.001239,172.31.40.0-255,66,105035,65,176123
25295,0.001245,172.217.194.0-255,5738,110773,65,176123
25296,0.001248,172.217.194.0-255,1484,112257,65,176123
25297,0.001254,172.31.40.0-255,66,112323,65,176123
25298,0.001274,172.217.194.0-255,4320,116643,65,176123
25299,0.001282,172.31.40.0-255,66,116709,65,176123
25300,0.001299,172.217.194.0-255,7156,123865,65,176123
25301,0.001306,172.31.40.0-255,66,123931,65,176123
25302,0.001317,172.217.194.0-255,5738,129669,65,176123
25303,0.001322,172.217.194.0-255,5020,134689,65,176123
25304,0.001346,172.31.40.0-255,66,134755,65,176123
25305,0.001486,172.217.194.0-255,1484,136239,65,176123
25306,0.001493,172.217.194.0-255,2902,139141,65,176123
25307,0.001501,172.31.40.0-255,66,139207,65,176123
25308,0.00151,172.217.194.0-255,2902,142109,65,176123
25309,0.001515,172.31.40.0-255,66,142175,65,176123
25310,0.001524,172.217.194.0-255,2902,145077,65,176123
25311,0.001559,172.217.194.0-255,4320,149397,65,176123
25312,0.001567,172.31.40.0-255,66,149463,65,176123
25313,0.001623,172.217.194.0-255,5738,155201,65,176123
25314,0.001633,172.31.40.0-255,66,155267,65,176123
25315,0.001646,172.217.194.0-255,5020,160287,65,176123
25316,0.001667,172.31.40.0-255,66,160353,65,176123
25317,0.001695,172.217.194.0-255,1484,161837,65,176123
25318,0.0017,172.217.194.0-255,2902,164739,65,176123
25319,0.00172,172.31.40.0-255,66,164805,65,176123
25320,0.001732,172.217.194.0-255,5738,170543,65,176123
25321,0.001746,172.31.40.0-255,66,170609,65,176123
25322,0.00178,172.31.40.0-255,66,170675,65,176123
25323,0.001827,172.31.40.0-255,66,170741,65,176123
25324,0.001838,172.217.194.0-255,4320,175061,65,176123
25325,0.001843,172.31.40.0-255,66,175127,65,176123
25326,0.001868,172.217.194.0-255,105,175232,65,176123
25327,0.00187,172.217.194.0-255,129,175361,65,176123
25328,0.001893,172.31.40.0-255,66,175427,65,176123
25329,0.004559,172.31.40.0-255,105,175532,65,176123
25330,0.004603,172.31.40.0-255,105,175637,65,176123
25331,0.004849,172.31.40.0-255,90,175727,65,176123
25332,0.00486,172.31.40.0-255,66,175793,65,176123
25333,0.006616,172.217.194.0-255,66,175859,65,176123
25334,0.006628,172.217.194.0-255,66,175925,65,176123
25335,0.006889,172.217.194.0-255,66,175991,65,176123
25336,0.006895,172.217.194.0-255,66,176057,65,176123
25337,0.006902,172.31.40.0-255,66,176123,65,176123
25338,0.0,74.125.24.0-255,153,153,65,78113
25339,1.5e-05,172.31.40.0-255,66,219,65,78113
25340,2.2e-05,74.125.24.0-255,1484,1703,65,78113
25341,2.6e-05,172.31.40.0-255,66,1769,65,78113
25342,5.6e-05,74.125.24.0-255,2902,4671,65,78113
25343,5.9e-05,172.31.40.0-255,66,4737,65,78113
25344,0.000206,74.125.24.0-255,5738,10475,65,78113
25345,0.000212,172.31.40.0-255,66,10541,65,78113
25346,0.00023,74.125.24.0-255,1484,12025,65,78113
25347,0.000233,172.31.40.0-255,66,12091,65,78113
25348,0.000564,74.125.24.0-255,2075,14166,65,78113
25349,0.00057,172.31.40.0-255,66,14232,65,78113
25350,0.00067,74.125.24.0-255,4320,18552,65,78113
25351,0.000676,172.31.40.0-255,66,18618,65,78113
25352,0.000693,74.125.24.0-255,7156,25774,65,78113
25353,0.000696,172.31.40.0-255,66,25840,65,78113
25354,0.001248,74.125.24.0-255,5379,31219,65,78113
25355,0.001256,172.31.40.0-255,66,31285,65,78113
25356,0.001509,74.125.24.0-255,2902,34187,65,78113
25357,0.001511,172.31.40.0-255,66,34253,65,78113
25358,0.001546,172.31.40.0-255,66,34319,65,78113
25359,0.002447,74.125.24.0-255,2902,37221,65,78113
25360,0.00245,172.31.40.0-255,66,37287,65,78113
25361,0.002484,172.31.40.0-255,66,37353,65,78113
25362,0.003238,172.31.40.0-255,66,37419,65,78113
25363,0.003295,172.31.40.0-255,66,37485,65,78113
25364,0.005601,74.125.24.0-255,5738,43223,65,78113
25365,0.005608,172.31.40.0-255,66,43289,65,78113
25366,0.007917,74.125.24.0-255,5738,49027,65,78113
25367,0.007981,172.31.40.0-255,66,49093,65,78113
25368,0.010319,74.125.24.0-255,5738,54831,65,78113
25369,0.010327,172.31.40.0-255,66,54897,65,78113
25370,0.012614,74.125.24.0-255,5738,60635,65,78113
25371,0.012625,172.31.40.0-255,66,60701,65,78113
25372,0.014969,74.125.24.0-255,5738,66439,65,78113
25373,0.014978,172.31.40.0-255,66,66505,65,78113
25374,0.017355,74.125.24.0-255,5738,72243,65,78113
25375,0.017362,172.31.40.0-255,66,72309,65,78113
25376,0.019676,74.125.24.0-255,5738,78047,65,78113
25377,0.019684,172.31.40.0-255,66,78113,65,78113
25378,0.0,74.125.24.0-255,147,147,65,148867
25379,2.4e-05,172.31.40.0-255,66,213,65,148867
25380,3e-05,74.125.24.0-255,1484,1697,65,148867
25381,3.5e-05,172.31.40.0-255,66,1763,65,148867
25382,4.1e-05,74.125.24.0-255,2902,4665,65,148867
25383,4.4e-05,172.31.40.0-255,66,4731,65,148867
25384,5.3e-05,74.125.24.0-255,7156,11887,65,148867
25385,5.7e-05,172.31.40.0-255,66,11953,65,148867
25386,6.1e-05,74.125.24.0-255,2139,14092,65,148867
25387,6.4e-05,172.31.40.0-255,66,14158,65,148867
25388,7.8e-05,172.31.40.0-255,66,14224,65,148867
25389,8.3e-05,74.125.24.0-255,2902,17126,65,148867
25390,8.5e-05,172.31.40.0-255,66,17192,65,148867
25391,0.000111,74.125.24.0-255,2543,19735,65,148867
25392,0.000113,172.31.40.0-255,66,19801,65,148867
25393,0.000191,74.125.24.0-255,1484,21285,65,148867
25394,0.000194,172.31.40.0-255,66,21351,65,148867
25395,0.000198,74.125.24.0-255,2902,24253,65,148867
25396,0.000201,172.31.40.0-255,66,24319,65,148867
25397,0.000214,74.125.24.0-255,2902,27221,65,148867
25398,0.000217,172.31.40.0-255,66,27287,65,148867
25399,0.00024,74.125.24.0-255,2902,30189,65,148867
25400,0.000242,172.31.40.0-255,66,30255,65,148867
25401,0.000255,172.31.40.0-255,66,30321,65,148867
25402,0.000308,172.31.40.0-255,66,30387,65,148867
25403,0.000362,74.125.24.0-255,387,30774,65,148867
25404,0.000365,172.31.40.0-255,66,30840,65,148867
25405,0.000528,74.125.24.0-255,1484,32324,65,148867
25406,0.000534,172.31.40.0-255,66,32390,65,148867
25407,0.000539,74.125.24.0-255,2902,35292,65,148867
25408,0.000541,172.31.40.0-255,66,35358,65,148867
25409,0.000548,74.125.24.0-255,5738,41096,65,148867
25410,0.00055,172.31.40.0-255,66,41162,65,148867
25411,0.000624,74.125.24.0-255,2902,44064,65,148867
25412,0.000628,172.31.40.0-255,66,44130,65,148867
25413,0.000657,172.31.40.0-255,66,44196,65,148867
25414,0.00066,74.125.24.0-255,1484,45680,65,148867
25415,0.000695,172.31.40.0-255,66,45746,65,148867
25416,0.000698,74.125.24.0-255,1125,46871,65,148867
25417,0.000725,74.125.24.0-255,1484,48355,65,148867
25418,0.000727,172.31.40.0-255,66,48421,65,148867
25419,0.000732,74.125.24.0-255,2902,51323,65,148867
25420,0.000735,172.31.40.0-255,66,51389,65,148867
25421,0.00074,74.125.24.0-255,4320,55709,65,148867
25422,0.000743,172.31.40.0-255,66,55775,65,148867
25423,0.000757,74.125.24.0-255,1484,57259,65,148867
25424,0.00077,172.31.40.0-255,66,57325,65,148867
25425,0.000792,74.125.24.0-255,1484,58809,65,148867
25426,0.000799,74.125.24.0-255,7156,65965,65,148867
25427,0.000808,172.31.40.0-255,66,66031,65,148867
25428,0.000813,74.125.24.0-255,3602,69633,65,148867
25429,0.000816,172.31.40.0-255,66,69699,65,148867
25430,0.000875,74.125.24.0-255,1484,71183,65,148867
25431,0.000881,74.125.24.0-255,2902,74085,65,148867
25432,0.000884,172.31.40.0-255,66,74151,65,148867
25433,0.000906,74.125.24.0-255,5738,79889,65,148867
25434,0.00091,172.31.40.0-255,66,79955,65,148867
25435,0.000915,74.125.24.0-255,2902,82857,65,148867
25436,0.000917,172.31.40.0-255,66,82923,65,148867
25437,0.000939,172.31.40.0-255,66,82989,65,148867
25438,0.000974,172.31.40.0-255,66,83055,65,148867
25439,0.00201,74.125.24.0-255,1484,84539,65,148867
25440,0.002019,74.125.24.0-255,2902,87441,65,148867
25441,0.002025,172.31.40.0-255,66,87507,65,148867
25442,0.002032,74.125.24.0-255,5738,93245,65,148867
25443,0.002034,172.31.40.0-255,66,93311,65,148867
25444,0.00207,172.31.40.0-255,66,93377,65,148867
25445,0.002077,74.125.24.0-255,7156,100533,65,148867
25446,0.002079,172.31.40.0-255,66,100599,65,148867
25447,0.002117,74.125.24.0-255,3602,104201,65,148867
25448,0.00212,172.31.40.0-255,66,104267,65,148867
25449,0.002201,74.125.24.0-255,1484,105751,65,148867
25450,0.002213,74.125.24.0-255,1484,107235,65,148867
25451,0.002215,172.31.40.0-255,66,107301,65,148867
25452,0.002231,74.125.24.0-255,1484,108785,65,148867
25453,0.002237,74.125.24.0-255,5738,114523,65,148867
25454,0.002238,172.31.40.0-255,66,114589,65,148867
25455,0.002241,74.125.24.0-255,1484,116073,65,148867
25456,0.002265,172.31.40.0-255,66,116139,65,148867
25457,0.002271,74.125.24.0-255,5738,121877,65,148867
25458,0.002274,172.31.40.0-255,66,121943,65,148867
25459,0.002301,74.125.24.0-255,4320,126263,65,148867
25460,0.002303,172.31.40.0-255,66,126329,65,148867
25461,0.002333,172.31.40.0-255,66,126395,65,148867
25462,0.002348,172.31.40.0-255,66,126461,65,148867
25463,0.002377,74.125.24.0-255,4320,130781,65,148867
25464,0.002379,172.31.40.0-255,66,130847,65,148867
25465,0.002418,172.31.40.0-255,66,130913,65,148867
25466,0.002423,74.125.24.0-255,4320,135233,65,148867
25467,0.002425,172.31.40.0-255,66,135299,65,148867
25468,0.002457,172.31.40.0-255,66,135365,65,148867
25469,0.00247,74.125.24.0-255,2184,137549,65,148867
25470,0.002472,172.31.40.0-255,66,137615,65,148867
25471,0.002478,74.125.24.0-255,5738,143353,65,148867
25472,0.00248,172.31.40.0-255,66,143419,65,148867
25473,0.002512,172.31.40.0-255,66,143485,65,148867
25474,0.00258,172.31.40.0-255,66,143551,65,148867
25475,0.002584,74.125.24.0-255,4320,147871,65,148867
25476,0.002586,172.31.40.0-255,66,147937,65,148867
25477,0.002598,172.31.40.0-255,66,148003,65,148867
25478,0.005107,74.125.24.0-255,168,148171,65,148867
25479,0.012202,172.31.40.0-255,105,148276,65,148867
25480,0.012253,172.31.40.0-255,105,148381,65,148867
25481,0.012536,172.31.40.0-255,90,148471,65,148867
25482,0.012547,172.31.40.0-255,66,148537,65,148867
25483,0.01469,74.125.24.0-255,66,148603,65,148867
25484,0.014717,74.125.24.0-255,66,148669,65,148867
25485,0.01503,74.125.24.0-255,66,148735,65,148867
25486,0.015235,74.125.24.0-255,66,148801,65,148867
25487,0.015245,172.31.40.0-255,66,148867,65,148867
25488,0.0,172.217.194.0-255,150,150,65,260971
25489,2.2e-05,172.31.40.0-255,66,216,65,260971
25490,3e-05,172.217.194.0-255,1484,1700,65,260971
25491,3.5e-05,172.31.40.0-255,66,1766,65,260971
25492,4.1e-05,172.217.194.0-255,2902,4668,65,260971
25493,4.5e-05,172.31.40.0-255,66,4734,65,260971
25494,5.1e-05,172.217.194.0-255,4320,9054,65,260971
25495,5.4e-05,172.31.40.0-255,66,9120,65,260971
25496,8e-05,172.31.40.0-255,66,9186,65,260971
25497,9.2e-05,172.31.40.0-255,66,9252,65,260971
25498,0.000119,172.217.194.0-255,2543,11795,65,260971
25499,0.000121,172.31.40.0-255,66,11861,65,260971
25500,0.000152,172.217.194.0-255,2902,14763,65,260971
25501,0.000154,172.31.40.0-255,66,14829,65,260971
25502,0.000159,172.217.194.0-255,2902,17731,65,260971
25503,0.000161,172.31.40.0-255,66,17797,65,260971
25504,0.000194,172.217.194.0-255,7156,24953,65,260971
25505,0.000198,172.31.40.0-255,66,25019,65,260971
25506,0.000215,172.217.194.0-255,3961,28980,65,260971
25507,0.000218,172.31.40.0-255,66,29046,65,260971
25508,0.000442,172.217.194.0-255,1484,30530,65,260971
25509,0.000448,172.31.40.0-255,66,30596,65,260971
25510,0.000454,172.217.194.0-255,2902,33498,65,260971
25511,0.000456,172.31.40.0-255,66,33564,65,260971
25512,0.000513,172.217.194.0-255,4320,37884,65,260971
25513,0.000516,172.31.40.0-255,66,37950,65,260971
25514,0.000539,172.217.194.0-255,1484,39434,65,260971
25515,0.000541,172.31.40.0-255,66,39500,65,260971
25516,0.000547,172.217.194.0-255,4320,43820,65,260971
25517,0.00055,172.31.40.0-255,66,43886,65,260971
25518,0.000553,172.217.194.0-255,2840,46726,65,260971
25519,0.000555,172.31.40.0-255,66,46792,65,260971
25520,0.000673,172.217.194.0-255,381,47173,65,260971
25521,0.000862,172.217.194.0-255,1484,48657,65,260971
25522,0.000866,172.31.40.0-255,66,48723,65,260971
25523,0.000871,172.217.194.0-255,2902,51625,65,260971
25524,0.000873,172.31.40.0-255,66,51691,65,260971
25525,0.00088,172.217.194.0-255,5738,57429,65,260971
25526,0.000882,172.31.40.0-255,66,57495,65,260971
25527,0.000922,172.217.194.0-255,4320,61815,65,260971
25528,0.000925,172.31.40.0-255,66,61881,65,260971
25529,0.000944,172.217.194.0-255,2543,64424,65,260971
25530,0.000947,172.31.40.0-255,66,64490,65,260971
25531,0.000962,172.217.194.0-255,2902,67392,65,260971
25532,0.000964,172.31.40.0-255,66,67458,65,260971
25533,0.000984,172.217.194.0-255,4320,71778,65,260971
25534,0.000987,172.31.40.0-255,66,71844,65,260971
25535,0.001022,172.217.194.0-255,1484,73328,65,260971
25536,0.001043,172.217.194.0-255,5738,79066,65,260971
25537,0.001045,172.31.40.0-255,66,79132,65,260971
25538,0.001065,172.217.194.0-255,2543,81675,65,260971
25539,0.001067,172.31.40.0-255,66,81741,65,260971
25540,0.001565,172.217.194.0-255,1484,83225,65,260971
25541,0.001573,172.217.194.0-255,2902,86127,65,260971
25542,0.001576,172.31.40.0-255,66,86193,65,260971
25543,0.001581,172.217.194.0-255,2902,89095,65,260971
25544,0.001583,172.31.40.0-255,66,89161,65,260971
25545,0.001596,172.217.194.0-255,2902,92063,65,260971
25546,0.001598,172.31.40.0-255,66,92129,65,260971
25547,0.001603,172.217.194.0-255,4320,96449,65,260971
25548,0.001605,172.31.40.0-255,66,96515,65,260971
25549,0.001636,172.31.40.0-255,66,96581,65,260971
25550,0.00164,172.217.194.0-255,2902,99483,65,260971
25551,0.001642,172.31.40.0-255,66,99549,65,260971
25552,0.001659,172.31.40.0-255,66,99615,65,260971
25553,0.001688,172.217.194.0-255,1484,101099,65,260971
25554,0.001691,172.217.194.0-255,2902,104001,65,260971
25555,0.001693,172.31.40.0-255,66,104067,65,260971
25556,0.001715,172.217.194.0-255,5738,109805,65,260971
25557,0.001717,172.31.40.0-255,66,109871,65,260971
25558,0.001722,172.217.194.0-255,4320,114191,65,260971
25559,0.001724,172.31.40.0-255,66,114257,65,260971
25560,0.001744,172.31.40.0-255,66,114323,65,260971
25561,0.001748,172.217.194.0-255,2902,117225,65,260971
25562,0.001749,172.31.40.0-255,66,117291,65,260971
25563,0.001771,172.31.40.0-255,66,117357,65,260971
25564,0.001815,172.217.194.0-255,1484,118841,65,260971
25565,0.00183,172.217.194.0-255,2902,121743,65,260971
25566,0.001834,172.31.40.0-255,66,121809,65,260971
25567,0.001837,172.217.194.0-255,1484,123293,65,260971
25568,0.001853,172.217.194.0-255,4320,127613,65,260971
25569,0.001856,172.31.40.0-255,66,127679,65,260971
25570,0.001867,172.31.40.0-255,66,127745,65,260971
25571,0.001877,172.31.40.0-255,66,127811,65,260971
25572,0.00188,172.217.194.0-255,766,128577,65,260971
25573,0.001917,172.217.194.0-255,1484,130061,65,260971
25574,0.00192,172.31.40.0-255,66,130127,65,260971
25575,0.001925,172.217.194.0-255,4320,134447,65,260971
25576,0.001928,172.31.40.0-255,66,134513,65,260971
25577,0.001947,172.217.194.0-255,5738,140251,65,260971
25578,0.00195,172.31.40.0-255,66,140317,65,260971
25579,0.001977,172.217.194.0-255,4320,144637,65,260971
25580,0.00198,172.31.40.0-255,66,144703,65,260971
25581,0.001992,172.31.40.0-255,66,144769,65,260971
25582,0.002016,172.217.194.0-255,6438,151207,65,260971
25583,0.002019,172.31.40.0-255,66,151273,65,260971
25584,0.002063,172.217.194.0-255,1484,152757,65,260971
25585,0.002094,172.217.194.0-255,1484,154241,65,260971
25586,0.002097,172.31.40.0-255,66,154307,65,260971
25587,0.002111,172.217.194.0-255,1484,155791,65,260971
25588,0.002117,172.217.194.0-255,5738,161529,65,260971
25589,0.00212,172.31.40.0-255,66,161595,65,260971
25590,0.002136,172.31.40.0-255,66,161661,65,260971
25591,0.002156,172.217.194.0-255,2902,164563,65,260971
25592,0.002158,172.31.40.0-255,66,164629,65,260971
25593,0.002185,172.31.40.0-255,66,164695,65,260971
25594,0.002205,172.217.194.0-255,5738,170433,65,260971
25595,0.002207,172.31.40.0-255,66,170499,65,260971
25596,0.002213,172.217.194.0-255,5738,176237,65,260971
25597,0.002215,172.31.40.0-255,66,176303,65,260971
25598,0.002228,172.217.194.0-255,1484,177787,65,260971
25599,0.002231,172.217.194.0-255,1484,179271,65,260971
25600,0.002233,172.31.40.0-255,66,179337,65,260971
25601,0.002272,172.31.40.0-255,66,179403,65,260971
25602,0.002278,172.217.194.0-255,6438,185841,65,260971
25603,0.00228,172.31.40.0-255,66,185907,65,260971
25604,0.002319,172.217.194.0-255,1484,187391,65,260971
25605,0.002333,172.217.194.0-255,2902,190293,65,260971
25606,0.002335,172.31.40.0-255,66,190359,65,260971
25607,0.002356,172.217.194.0-255,5738,196097,65,260971
25608,0.002358,172.31.40.0-255,66,196163,65,260971
25609,0.002363,172.217.194.0-255,4320,200483,65,260971
25610,0.002365,172.31.40.0-255,66,200549,65,260971
25611,0.002376,172.217.194.0-255,2902,203451,65,260971
25612,0.002379,172.31.40.0-255,66,203517,65,260971
25613,0.002385,172.217.194.0-255,7156,210673,65,260971
25614,0.002387,172.31.40.0-255,66,210739,65,260971
25615,0.002406,172.217.194.0-255,7156,217895,65,260971
25616,0.002408,172.31.40.0-255,66,217961,65,260971
25617,0.002413,172.217.194.0-255,2184,220145,65,260971
25618,0.002415,172.31.40.0-255,66,220211,65,260971
25619,0.004776,172.217.194.0-255,2902,223113,65,260971
25620,0.004783,172.31.40.0-255,66,223179,65,260971
25621,0.004796,172.217.194.0-255,2902,226081,65,260971
25622,0.004798,172.31.40.0-255,66,226147,65,260971
25623,0.007163,172.217.194.0-255,5738,231885,65,260971
25624,0.00717,172.31.40.0-255,66,231951,65,260971
25625,0.009571,172.217.194.0-255,5738,237689,65,260971
25626,0.009591,172.31.40.0-255,66,237755,65,260971
25627,0.011969,172.217.194.0-255,5738,243493,65,260971
25628,0.011989,172.31.40.0-255,66,243559,65,260971
25629,0.014323,172.217.194.0-255,5738,249297,65,260971
25630,0.01433,172.31.40.0-255,66,249363,65,260971
25631,0.016719,172.217.194.0-255,5738,255101,65,260971
25632,0.016739,172.31.40.0-255,66,255167,65,260971
25633,0.019144,172.217.194.0-255,5738,260905,65,260971
25634,0.019164,172.31.40.0-255,66,260971,65,260971
25635,0.0,74.125.68.0-255,296,296,65,292101
25636,1.2e-05,172.31.40.0-255,66,362,65,292101
25637,4.3e-05,74.125.68.0-255,1484,1846,65,292101
25638,4.7e-05,172.31.40.0-255,66,1912,65,292101
25639,5.1e-05,74.125.68.0-255,1484,3396,65,292101
25640,5.3e-05,172.31.40.0-255,66,3462,65,292101
25641,6.7e-05,74.125.68.0-255,1484,4946,65,292101
25642,6.9e-05,172.31.40.0-255,66,5012,65,292101
25643,7.7e-05,74.125.68.0-255,5738,10750,65,292101
25644,8e-05,172.31.40.0-255,66,10816,65,292101
25645,8.5e-05,74.125.68.0-255,3353,14169,65,292101
25646,8.8e-05,172.31.40.0-255,66,14235,65,292101
25647,0.000111,74.125.68.0-255,4320,18555,65,292101
25648,0.000113,172.31.40.0-255,66,18621,65,292101
25649,0.000148,172.31.40.0-255,66,18687,65,292101
25650,0.000165,74.125.68.0-255,1484,20171,65,292101
25651,0.000167,172.31.40.0-255,66,20237,65,292101
25652,0.000186,74.125.68.0-255,2543,22780,65,292101
25653,0.000189,172.31.40.0-255,66,22846,65,292101
25654,0.000243,74.125.68.0-255,1484,24330,65,292101
25655,0.000246,172.31.40.0-255,66,24396,65,292101
25656,0.000251,74.125.68.0-255,2902,27298,65,292101
25657,0.000254,172.31.40.0-255,66,27364,65,292101
25658,0.000283,74.125.68.0-255,5738,33102,65,292101
25659,0.000286,172.31.40.0-255,66,33168,65,292101
25660,0.000309,74.125.68.0-255,6797,39965,65,292101
25661,0.000311,172.31.40.0-255,66,40031,65,292101
25662,0.000336,74.125.68.0-255,2902,42933,65,292101
25663,0.000339,172.31.40.0-255,66,42999,65,292101
25664,0.000356,74.125.68.0-255,4320,47319,65,292101
25665,0.000358,172.31.40.0-255,66,47385,65,292101
25666,0.000365,74.125.68.0-255,5738,53123,65,292101
25667,0.000367,172.31.40.0-255,66,53189,65,292101
25668,0.000384,74.125.68.0-255,2902,56091,65,292101
25669,0.000386,172.31.40.0-255,66,56157,65,292101
25670,0.000389,74.125.68.0-255,1404,57561,65,292101
25671,0.000424,74.125.68.0-255,132,57693,65,292101
25672,0.00051,74.125.68.0-255,1484,59177,65,292101
25673,0.000514,172.31.40.0-255,66,59243,65,292101
25674,0.00053,74.125.68.0-255,2902,62145,65,292101
25675,0.000533,172.31.40.0-255,66,62211,65,292101
25676,0.00055,74.125.68.0-255,2902,65113,65,292101
25677,0.000552,172.31.40.0-255,66,65179,65,292101
25678,0.000575,74.125.68.0-255,2902,68081,65,292101
25679,0.000577,172.31.40.0-255,66,68147,65,292101
25680,0.000585,74.125.68.0-255,7156,75303,65,292101
25681,0.000588,172.31.40.0-255,66,75369,65,292101
25682,0.000603,74.125.68.0-255,5738,81107,65,292101
25683,0.000605,172.31.40.0-255,66,81173,65,292101
25684,0.000634,172.31.40.0-255,66,81239,65,292101
25685,0.000637,74.125.68.0-255,1484,82723,65,292101
25686,0.000655,74.125.68.0-255,1042,83765,65,292101
25687,0.000657,172.31.40.0-255,66,83831,65,292101
25688,0.000762,74.125.68.0-255,1484,85315,65,292101
25689,0.000779,74.125.68.0-255,2902,88217,65,292101
25690,0.000782,74.125.68.0-255,1484,89701,65,292101
25691,0.000786,172.31.40.0-255,66,89767,65,292101
25692,0.000804,74.125.68.0-255,4320,94087,65,292101
25693,0.000807,172.31.40.0-255,66,94153,65,292101
25694,0.000821,74.125.68.0-255,4320,98473,65,292101
25695,0.000824,172.31.40.0-255,66,98539,65,292101
25696,0.000835,74.125.68.0-255,2902,101441,65,292101
25697,0.000838,172.31.40.0-255,66,101507,65,292101
25698,0.000891,172.31.40.0-255,66,101573,65,292101
25699,0.00091,74.125.68.0-255,6438,108011,65,292101
25700,0.000912,172.31.40.0-255,66,108077,65,292101
25701,0.001214,74.125.68.0-255,1484,109561,65,292101
25702,0.001232,74.125.68.0-255,2902,112463,65,292101
25703,0.001236,172.31.40.0-255,66,112529,65,292101
25704,0.001256,74.125.68.0-255,4320,116849,65,292101
25705,0.001258,172.31.40.0-255,66,116915,65,292101
25706,0.001276,74.125.68.0-255,1484,118399,65,292101
25707,0.001306,74.125.68.0-255,2902,121301,65,292101
25708,0.001309,172.31.40.0-255,66,121367,65,292101
25709,0.00133,74.125.68.0-255,4320,125687,65,292101
25710,0.001333,172.31.40.0-255,66,125753,65,292101
25711,0.001349,74.125.68.0-255,2902,128655,65,292101
25712,0.001352,172.31.40.0-255,66,128721,65,292101
25713,0.001367,74.125.68.0-255,4320,133041,65,292101
25714,0.001369,172.31.40.0-255,66,133107,65,292101
25715,0.001404,74.125.68.0-255,2902,136009,65,292101
25716,0.001406,172.31.40.0-255,66,136075,65,292101
25717,0.001428,74.125.68.0-255,4320,140395,65,292101
25718,0.001431,172.31.40.0-255,66,140461,65,292101
25719,0.001461,74.125.68.0-255,2184,142645,65,292101
25720,0.001465,172.31.40.0-255,66,142711,65,292101
25721,0.001564,74.125.68.0-255,1484,144195,65,292101
25722,0.001571,74.125.68.0-255,2902,147097,65,292101
25723,0.001574,172.31.40.0-255,66,147163,65,292101
25724,0.001599,74.125.68.0-255,5738,152901,65,292101
25725,0.001602,172.31.40.0-255,66,152967,65,292101
25726,0.001607,74.125.68.0-255,4320,157287,65,292101
25727,0.001609,172.31.40.0-255,66,157353,65,292101
25728,0.001634,74.125.68.0-255,5738,163091,65,292101
25729,0.001637,172.31.40.0-255,66,163157,65,292101
25730,0.001649,74.125.68.0-255,1484,164641,65,292101
25731,0.001664,74.125.68.0-255,2902,167543,65,292101
25732,0.001666,172.31.40.0-255,66,167609,65,292101
25733,0.001706,74.125.68.0-255,1484,169093,65,292101
25734,0.001734,74.125.68.0-255,2902,171995,65,292101
25735,0.001737,172.31.40.0-255,66,172061,65,292101
25736,0.001747,74.125.68.0-255,1484,173545,65,292101
25737,0.001765,74.125.68.0-255,3602,177147,65,292101
25738,0.00177,172.31.40.0-255,66,177213,65,292101
25739,0.001907,74.125.68.0-255,1484,178697,65,292101
25740,0.00192,74.125.68.0-255,2902,181599,65,292101
25741,0.001924,172.31.40.0-255,66,181665,65,292101
25742,0.001927,74.125.68.0-255,1484,183149,65,292101
25743,0.001945,74.125.68.0-255,4320,187469,65,292101
25744,0.001948,172.31.40.0-255,66,187535,65,292101
25745,0.001954,74.125.68.0-255,4320,191855,65,292101
25746,0.001956,172.31.40.0-255,66,191921,65,292101
25747,0.001971,74.125.68.0-255,2902,194823,65,292101
25748,0.001974,172.31.40.0-255,66,194889,65,292101
25749,0.00198,74.125.68.0-255,4320,199209,65,292101
25750,0.001982,172.31.40.0-255,66,199275,65,292101
25751,0.002003,74.125.68.0-255,4320,203595,65,292101
25752,0.002006,172.31.40.0-255,66,203661,65,292101
25753,0.002017,172.31.40.0-255,66,203727,65,292101
25754,0.002073,74.125.68.0-255,1484,205211,65,292101
25755,0.002078,74.125.68.0-255,2902,208113,65,292101
25756,0.002081,172.31.40.0-255,66,208179,65,292101
25757,0.002094,74.125.68.0-255,1484,209663,65,292101
25758,0.00211,74.125.68.0-255,4320,213983,65,292101
25759,0.002113,172.31.40.0-255,66,214049,65,292101
25760,0.002124,74.125.68.0-255,4320,218369,65,292101
25761,0.002126,172.31.40.0-255,66,218435,65,292101
25762,0.002132,74.125.68.0-255,4320,222755,65,292101
25763,0.002135,172.31.40.0-255,66,222821,65,292101
25764,0.002149,74.125.68.0-255,1484,224305,65,292101
25765,0.002154,74.125.68.0-255,2902,227207,65,292101
25766,0.002157,172.31.40.0-255,66,227273,65,292101
25767,0.002187,172.31.40.0-255,66,227339,65,292101
25768,0.002192,74.125.68.0-255,2184,229523,65,292101
25769,0.002193,172.31.40.0-255,66,229589,65,292101
25770,0.002215,74.125.68.0-255,1484,231073,65,292101
25771,0.002241,172.31.40.0-255,66,231139,65,292101
25772,0.002247,74.125.68.0-255,5738,236877,65,292101
25773,0.00225,172.31.40.0-255,66,236943,65,292101
25774,0.002273,74.125.68.0-255,2902,239845,65,292101
25775,0.002275,172.31.40.0-255,66,239911,65,292101
25776,0.002296,74.125.68.0-255,5738,245649,65,292101
25777,0.002299,172.31.40.0-255,66,245715,65,292101
25778,0.002301,74.125.68.0-255,1484,247199,65,292101
25779,0.002303,172.31.40.0-255,78,247277,65,292101
25780,0.002308,74.125.68.0-255,3602,250879,65,292101
25781,0.002311,172.31.40.0-255,66,250945,65,292101
25782,0.004561,74.125.68.0-255,1484,252429,65,292101
25783,0.004628,74.125.68.0-255,4320,256749,65,292101
25784,0.00464,172.31.40.0-255,66,256815,65,292101
25785,0.006908,74.125.68.0-255,5738,262553,65,292101
25786,0.006923,172.31.40.0-255,66,262619,65,292101
25787,0.00918,74.125.68.0-255,5738,268357,65,292101
25788,0.009188,172.31.40.0-255,66,268423,65,292101
25789,0.011431,74.125.68.0-255,2902,271325,65,292101
25790,0.011435,172.31.40.0-255,66,271391,65,292101
25791,0.011446,74.125.68.0-255,2902,274293,65,292101
25792,0.011448,172.31.40.0-255,66,274359,65,292101
25793,0.0137,74.125.68.0-255,2902,277261,65,292101
25794,0.013707,172.31.40.0-255,66,277327,65,292101
25795,0.013728,74.125.68.0-255,2902,280229,65,292101
25796,0.013731,172.31.40.0-255,66,280295,65,292101
25797,0.015977,74.125.68.0-255,2902,283197,65,292101
25798,0.015991,172.31.40.0-255,66,283263,65,292101
25799,0.016009,74.125.68.0-255,2902,286165,65,292101
25800,0.016011,172.31.40.0-255,66,286231,65,292101
25801,0.018252,74.125.68.0-255,4320,290551,65,292101
25802,0.01826,172.31.40.0-255,66,290617,65,292101
25803,0.018282,74.125.68.0-255,1484,292101,65,292101
25804,0.0,74.125.24.0-255,153,153,65,215956
25805,2.3e-05,172.31.40.0-255,66,219,65,215956
25806,3.1e-05,74.125.24.0-255,1484,1703,65,215956
25807,3.5e-05,172.31.40.0-255,66,1769,65,215956
25808,4e-05,74.125.24.0-255,2902,4671,65,215956
25809,4.4e-05,172.31.40.0-255,66,4737,65,215956
25810,5.1e-05,74.125.24.0-255,7156,11893,65,215956
25811,5.5e-05,172.31.40.0-255,66,11959,65,215956
25812,6.1e-05,74.125.24.0-255,2039,13998,65,215956
25813,6.3e-05,172.31.40.0-255,66,14064,65,215956
25814,0.000106,74.125.24.0-255,1484,15548,65,215956
25815,0.000109,172.31.40.0-255,66,15614,65,215956
25816,0.000114,74.125.24.0-255,2902,18516,65,215956
25817,0.000116,172.31.40.0-255,66,18582,65,215956
25818,0.000145,74.125.24.0-255,5738,24320,65,215956
25819,0.000147,172.31.40.0-255,66,24386,65,215956
25820,0.000165,74.125.24.0-255,6797,31183,65,215956
25821,0.000167,172.31.40.0-255,66,31249,65,215956
25822,0.00022,74.125.24.0-255,1484,32733,65,215956
25823,0.000223,172.31.40.0-255,66,32799,65,215956
25824,0.000248,74.125.24.0-255,2902,35701,65,215956
25825,0.00025,172.31.40.0-255,66,35767,65,215956
25826,0.000257,74.125.24.0-255,5738,41505,65,215956
25827,0.00026,172.31.40.0-255,66,41571,65,215956
25828,0.000267,74.125.24.0-255,6797,48368,65,215956
25829,0.00027,172.31.40.0-255,66,48434,65,215956
25830,0.000301,172.31.40.0-255,66,48500,65,215956
25831,0.000322,74.125.24.0-255,4320,52820,65,215956
25832,0.000325,172.31.40.0-255,66,52886,65,215956
25833,0.000329,74.125.24.0-255,2872,55758,65,215956
25834,0.000331,172.31.40.0-255,66,55824,65,215956
25835,0.000446,74.125.24.0-255,114,55938,65,215956
25836,0.000581,74.125.24.0-255,1484,57422,65,215956
25837,0.000587,172.31.40.0-255,66,57488,65,215956
25838,0.000592,74.125.24.0-255,2902,60390,65,215956
25839,0.000595,172.31.40.0-255,66,60456,65,215956
25840,0.000602,74.125.24.0-255,5738,66194,65,215956
25841,0.000604,172.31.40.0-255,66,66260,65,215956
25842,0.000608,74.125.24.0-255,2902,69162,65,215956
25843,0.000611,172.31.40.0-255,66,69228,65,215956
25844,0.000627,74.125.24.0-255,2902,72130,65,215956
25845,0.00063,172.31.40.0-255,66,72196,65,215956
25846,0.000657,74.125.24.0-255,5738,77934,65,215956
25847,0.00066,172.31.40.0-255,66,78000,65,215956
25848,0.00068,172.31.40.0-255,66,78066,65,215956
25849,0.000686,74.125.24.0-255,3961,82027,65,215956
25850,0.000687,172.31.40.0-255,66,82093,65,215956
25851,0.000728,74.125.24.0-255,332,82425,65,215956
25852,0.001253,74.125.24.0-255,1484,83909,65,215956
25853,0.001258,172.31.40.0-255,66,83975,65,215956
25854,0.001264,74.125.24.0-255,2902,86877,65,215956
25855,0.001266,172.31.40.0-255,66,86943,65,215956
25856,0.001271,74.125.24.0-255,4320,91263,65,215956
25857,0.001274,172.31.40.0-255,66,91329,65,215956
25858,0.00131,172.31.40.0-255,66,91395,65,215956
25859,0.001338,172.31.40.0-255,66,91461,65,215956
25860,0.001359,172.31.40.0-255,66,91527,65,215956
25861,0.001821,74.125.24.0-255,1484,93011,65,215956
25862,0.001831,74.125.24.0-255,2902,95913,65,215956
25863,0.001835,172.31.40.0-255,66,95979,65,215956
25864,0.001842,74.125.24.0-255,5738,101717,65,215956
25865,0.001845,172.31.40.0-255,66,101783,65,215956
25866,0.001884,172.31.40.0-255,66,101849,65,215956
25867,0.001887,74.125.24.0-255,1484,103333,65,215956
25868,0.001905,74.125.24.0-255,4320,107653,65,215956
25869,0.001908,172.31.40.0-255,66,107719,65,215956
25870,0.001929,74.125.24.0-255,5020,112739,65,215956
25871,0.001931,172.31.40.0-255,66,112805,65,215956
25872,0.001978,74.125.24.0-255,5738,118543,65,215956
25873,0.001982,172.31.40.0-255,66,118609,65,215956
25874,0.001989,74.125.24.0-255,5738,124347,65,215956
25875,0.001991,172.31.40.0-255,66,124413,65,215956
25876,0.002015,74.125.24.0-255,7156,131569,65,215956
25877,0.002017,172.31.40.0-255,66,131635,65,215956
25878,0.002048,74.125.24.0-255,5738,137373,65,215956
25879,0.002051,172.31.40.0-255,66,137439,65,215956
25880,0.002063,172.31.40.0-255,66,137505,65,215956
25881,0.002096,74.125.24.0-255,1484,138989,65,215956
25882,0.00211,74.125.24.0-255,2902,141891,65,215956
25883,0.002113,172.31.40.0-255,66,141957,65,215956
25884,0.002137,74.125.24.0-255,5738,147695,65,215956
25885,0.00214,172.31.40.0-255,66,147761,65,215956
25886,0.002146,74.125.24.0-255,4320,152081,65,215956
25887,0.002148,172.31.40.0-255,66,152147,65,215956
25888,0.002173,172.31.40.0-255,66,152213,65,215956
25889,0.002177,74.125.24.0-255,1484,153697,65,215956
25890,0.00218,74.125.24.0-255,1484,155181,65,215956
25891,0.002182,172.31.40.0-255,66,155247,65,215956
25892,0.002217,172.31.40.0-255,66,155313,65,215956
25893,0.002273,74.125.24.0-255,1484,156797,65,215956
25894,0.002279,74.125.24.0-255,2902,159699,65,215956
25895,0.002282,172.31.40.0-255,66,159765,65,215956
25896,0.002287,74.125.24.0-255,2902,162667,65,215956
25897,0.002289,172.31.40.0-255,66,162733,65,215956
25898,0.002305,74.125.24.0-255,2902,165635,65,215956
25899,0.002307,172.31.40.0-255,66,165701,65,215956
25900,0.00231,74.125.24.0-255,1484,167185,65,215956
25901,0.002353,172.31.40.0-255,66,167251,65,215956
25902,0.002363,172.31.40.0-255,66,167317,65,215956
25903,0.002375,74.125.24.0-255,2184,169501,65,215956
25904,0.002376,172.31.40.0-255,66,169567,65,215956
25905,0.002412,74.125.24.0-255,1484,171051,65,215956
25906,0.002416,74.125.24.0-255,2902,173953,65,215956
25907,0.002418,172.31.40.0-255,66,174019,65,215956
25908,0.002424,74.125.24.0-255,5738,179757,65,215956
25909,0.002426,172.31.40.0-255,66,179823,65,215956
25910,0.002428,74.125.24.0-255,1484,181307,65,215956
25911,0.002459,172.31.40.0-255,66,181373,65,215956
25912,0.002469,172.31.40.0-255,66,181439,65,215956
25913,0.00249,74.125.24.0-255,1484,182923,65,215956
25914,0.002535,172.31.40.0-255,66,182989,65,215956
25915,0.002545,172.31.40.0-255,66,183055,65,215956
25916,0.002589,172.31.40.0-255,66,183121,65,215956
25917,0.002629,172.31.40.0-255,66,183187,65,215956
25918,0.005182,74.125.24.0-255,5738,188925,65,215956
25919,0.005189,172.31.40.0-255,66,188991,65,215956
25920,0.007709,74.125.24.0-255,5738,194729,65,215956
25921,0.007714,172.31.40.0-255,66,194795,65,215956
25922,0.010264,74.125.24.0-255,5738,200533,65,215956
25923,0.010271,172.31.40.0-255,66,200599,65,215956
25924,0.012822,74.125.24.0-255,5738,206337,65,215956
25925,0.012831,172.31.40.0-255,66,206403,65,215956
25926,0.015375,74.125.24.0-255,5738,212141,65,215956
25927,0.015383,172.31.40.0-255,66,212207,65,215956
25928,0.017942,74.125.24.0-255,3578,215785,65,215956
25929,0.017951,172.31.40.0-255,66,215851,65,215956
25930,0.018833,172.31.40.0-255,105,215956,65,215956
25931,0.0,172.217.194.0-255,153,153,65,152400
25932,1.9e-05,172.31.40.0-255,66,219,65,152400
25933,2.6e-05,172.217.194.0-255,1484,1703,65,152400
25934,3.1e-05,172.31.40.0-255,66,1769,65,152400
25935,3.7e-05,172.217.194.0-255,2902,4671,65,152400
25936,4.8e-05,172.31.40.0-255,66,4737,65,152400
25937,5.6e-05,172.217.194.0-255,7156,11893,65,152400
25938,5.8e-05,172.31.40.0-255,66,11959,65,152400
25939,7e-05,172.31.40.0-255,66,12025,65,152400
25940,0.000109,172.31.40.0-255,66,12091,65,152400
25941,0.000136,172.217.194.0-255,1484,13575,65,152400
25942,0.000138,172.31.40.0-255,66,13641,65,152400
25943,0.000142,172.217.194.0-255,1484,15125,65,152400
25944,0.000144,172.31.40.0-255,66,15191,65,152400
25945,0.000178,172.217.194.0-255,1484,16675,65,152400
25946,0.00018,172.31.40.0-255,66,16741,65,152400
25947,0.000187,172.217.194.0-255,5738,22479,65,152400
25948,0.000189,172.31.40.0-255,66,22545,65,152400
25949,0.0002,172.31.40.0-255,66,22611,65,152400
25950,0.00024,172.217.194.0-255,4320,26931,65,152400
25951,0.000243,172.31.40.0-255,66,26997,65,152400
25952,0.000279,172.31.40.0-255,66,27063,65,152400
25953,0.000282,172.217.194.0-255,676,27739,65,152400
25954,0.000284,172.31.40.0-255,66,27805,65,152400
25955,0.000542,172.217.194.0-255,1484,29289,65,152400
25956,0.000549,172.31.40.0-255,66,29355,65,152400
25957,0.000554,172.217.194.0-255,2902,32257,65,152400
25958,0.000557,172.31.40.0-255,66,32323,65,152400
25959,0.00058,172.217.194.0-255,5738,38061,65,152400
25960,0.000583,172.31.40.0-255,66,38127,65,152400
25961,0.00059,172.217.194.0-255,5738,43865,65,152400
25962,0.000593,172.31.40.0-255,66,43931,65,152400
25963,0.000622,172.217.194.0-255,577,44508,65,152400
25964,0.000672,172.217.194.0-255,1484,45992,65,152400
25965,0.000676,172.31.40.0-255,66,46058,65,152400
25966,0.000681,172.217.194.0-255,2902,48960,65,152400
25967,0.000683,172.31.40.0-255,66,49026,65,152400
25968,0.000696,172.217.194.0-255,5738,54764,65,152400
25969,0.000699,172.31.40.0-255,66,54830,65,152400
25970,0.000706,172.217.194.0-255,5738,60568,65,152400
25971,0.000708,172.31.40.0-255,66,60634,65,152400
25972,0.000744,172.217.194.0-255,7156,67790,65,152400
25973,0.000747,172.31.40.0-255,66,67856,65,152400
25974,0.000788,172.31.40.0-255,66,67922,65,152400
25975,0.000809,172.217.194.0-255,2184,70106,65,152400
25976,0.000811,172.31.40.0-255,66,70172,65,152400
25977,0.001172,172.217.194.0-255,1484,71656,65,152400
25978,0.001185,172.217.194.0-255,2902,74558,65,152400
25979,0.001189,172.31.40.0-255,66,74624,65,152400
25980,0.001194,172.217.194.0-255,2902,77526,65,152400
25981,0.001196,172.31.40.0-255,66,77592,65,152400
25982,0.001217,172.217.194.0-255,2902,80494,65,152400
25983,0.001219,172.31.40.0-255,66,80560,65,152400
25984,0.001237,172.31.40.0-255,66,80626,65,152400
25985,0.001279,172.31.40.0-255,66,80692,65,152400
25986,0.001386,172.217.194.0-255,1484,82176,65,152400
25987,0.001392,172.217.194.0-255,2902,85078,65,152400
25988,0.001395,172.31.40.0-255,66,85144,65,152400
25989,0.00143,172.217.194.0-255,5738,90882,65,152400
25990,0.001434,172.31.40.0-255,66,90948,65,152400
25991,0.001452,172.31.40.0-255,66,91014,65,152400
25992,0.001458,172.217.194.0-255,5738,96752,65,152400
25993,0.00146,172.31.40.0-255,66,96818,65,152400
25994,0.001494,172.217.194.0-255,5020,101838,65,152400
25995,0.001497,172.31.40.0-255,66,101904,65,152400
25996,0.002032,172.217.194.0-255,1484,103388,65,152400
25997,0.002038,172.217.194.0-255,2902,106290,65,152400
25998,0.002042,172.31.40.0-255,66,106356,65,152400
25999,0.002075,172.217.194.0-255,5738,112094,65,152400
26000,0.002079,172.31.40.0-255,66,112160,65,152400
26001,0.002093,172.31.40.0-255,66,112226,65,152400
26002,0.002122,172.31.40.0-255,66,112292,65,152400
26003,0.002152,172.217.194.0-255,766,113058,65,152400
26004,0.002714,172.31.40.0-255,66,113124,65,152400
26005,0.004479,172.217.194.0-255,4320,117444,65,152400
26006,0.004486,172.31.40.0-255,66,117510,65,152400
26007,0.005087,172.217.194.0-255,1484,118994,65,152400
26008,0.006826,172.217.194.0-255,4320,123314,65,152400
26009,0.006831,172.31.40.0-255,66,123380,65,152400
26010,0.009219,172.217.194.0-255,5738,129118,65,152400
26011,0.009227,172.31.40.0-255,66,129184,65,152400
26012,0.011581,172.217.194.0-255,5738,134922,65,152400
26013,0.011589,172.31.40.0-255,66,134988,65,152400
26014,0.013962,172.217.194.0-255,5738,140726,65,152400
26015,0.013971,172.31.40.0-255,66,140792,65,152400
26016,0.016347,172.217.194.0-255,5738,146530,65,152400
26017,0.016357,172.31.40.0-255,66,146596,65,152400
26018,0.018715,172.217.194.0-255,5738,152334,65,152400
26019,0.018723,172.31.40.0-255,66,152400,65,152400
26020,0.0,172.217.194.0-255,152,152,65,141959
26021,2.3e-05,172.31.40.0-255,66,218,65,141959
26022,3e-05,172.217.194.0-255,1484,1702,65,141959
26023,3.4e-05,172.31.40.0-255,66,1768,65,141959
26024,4.9e-05,172.217.194.0-255,2902,4670,65,141959
26025,5.4e-05,172.31.40.0-255,66,4736,65,141959
26026,6.1e-05,172.217.194.0-255,7156,11892,65,141959
26027,6.4e-05,172.31.40.0-255,66,11958,65,141959
26028,6.7e-05,172.217.194.0-255,1484,13442,65,141959
26029,7e-05,172.31.40.0-255,66,13508,65,141959
26030,0.000118,172.31.40.0-255,66,13574,65,141959
26031,0.000125,172.217.194.0-255,6797,20371,65,141959
26032,0.000128,172.31.40.0-255,66,20437,65,141959
26033,0.000173,172.217.194.0-255,7156,27593,65,141959
26034,0.000176,172.31.40.0-255,66,27659,65,141959
26035,0.000179,172.217.194.0-255,1484,29143,65,141959
26036,0.000182,172.31.40.0-255,66,29209,65,141959
26037,0.000213,172.217.194.0-255,7156,36365,65,141959
26038,0.000216,172.31.40.0-255,66,36431,65,141959
26039,0.000221,172.217.194.0-255,4320,40751,65,141959
26040,0.000222,172.31.40.0-255,66,40817,65,141959
26041,0.000253,172.31.40.0-255,66,40883,65,141959
26042,0.00028,172.217.194.0-255,646,41529,65,141959
26043,0.000282,172.31.40.0-255,66,41595,65,141959
26044,0.00031,172.217.194.0-255,1484,43079,65,141959
26045,0.000312,172.31.40.0-255,66,43145,65,141959
26046,0.000333,172.217.194.0-255,4320,47465,65,141959
26047,0.000336,172.31.40.0-255,66,47531,65,141959
26048,0.000342,172.217.194.0-255,4320,51851,65,141959
26049,0.000345,172.31.40.0-255,66,51917,65,141959
26050,0.000366,172.217.194.0-255,2902,54819,65,141959
26051,0.000368,172.31.40.0-255,66,54885,65,141959
26052,0.000401,172.31.40.0-255,66,54951,65,141959
26053,0.000409,172.217.194.0-255,7156,62107,65,141959
26054,0.000411,172.31.40.0-255,66,62173,65,141959
26055,0.000438,172.217.194.0-255,1484,63657,65,141959
26056,0.000442,172.217.194.0-255,1484,65141,65,141959
26057,0.000444,172.31.40.0-255,66,65207,65,141959
26058,0.000473,172.217.194.0-255,2543,67750,65,141959
26059,0.000476,172.31.40.0-255,66,67816,65,141959
26060,0.001066,172.217.194.0-255,1484,69300,65,141959
26061,0.001074,172.217.194.0-255,2902,72202,65,141959
26062,0.001078,172.31.40.0-255,66,72268,65,141959
26063,0.001113,172.217.194.0-255,4320,76588,65,141959
26064,0.001116,172.31.40.0-255,66,76654,65,141959
26065,0.001134,172.31.40.0-255,66,76720,65,141959
26066,0.001209,172.31.40.0-255,66,76786,65,141959
26067,0.001265,172.217.194.0-255,1484,78270,65,141959
26068,0.001269,172.217.194.0-255,1484,79754,65,141959
26069,0.001272,172.31.40.0-255,66,79820,65,141959
26070,0.001288,172.217.194.0-255,1484,81304,65,141959
26071,0.001298,172.217.194.0-255,5738,87042,65,141959
26072,0.001301,172.31.40.0-255,66,87108,65,141959
26073,0.001305,172.217.194.0-255,2902,90010,65,141959
26074,0.001307,172.31.40.0-255,66,90076,65,141959
26075,0.001328,172.217.194.0-255,2902,92978,65,141959
26076,0.001331,172.31.40.0-255,66,93044,65,141959
26077,0.001343,172.31.40.0-255,66,93110,65,141959
26078,0.001368,172.217.194.0-255,2902,96012,65,141959
26079,0.001378,172.217.194.0-255,5020,101032,65,141959
26080,0.001381,172.31.40.0-255,66,101098,65,141959
26081,0.001389,172.31.40.0-255,66,101164,65,141959
26082,0.00188,172.31.40.0-255,101,101265,65,141959
26083,0.00374,172.217.194.0-255,5738,107003,65,141959
26084,0.003748,172.31.40.0-255,66,107069,65,141959
26085,0.004136,172.217.194.0-255,66,107135,65,141959
26086,0.006079,172.217.194.0-255,5738,112873,65,141959
26087,0.006086,172.31.40.0-255,66,112939,65,141959
26088,0.008484,172.217.194.0-255,5738,118677,65,141959
26089,0.008491,172.31.40.0-255,66,118743,65,141959
26090,0.010849,172.217.194.0-255,5738,124481,65,141959
26091,0.010858,172.31.40.0-255,66,124547,65,141959
26092,0.013214,172.217.194.0-255,5738,130285,65,141959
26093,0.013227,172.31.40.0-255,66,130351,65,141959
26094,0.015557,172.217.194.0-255,5738,136089,65,141959
26095,0.015567,172.31.40.0-255,66,136155,65,141959
26096,0.017941,172.217.194.0-255,5738,141893,65,141959
26097,0.017951,172.31.40.0-255,66,141959,65,141959
26098,0.0,74.125.130.0-255,153,153,65,166617
26099,2.4e-05,172.31.40.0-255,66,219,65,166617
26100,3.3e-05,74.125.130.0-255,1484,1703,65,166617
26101,3.8e-05,172.31.40.0-255,66,1769,65,166617
26102,4.3e-05,74.125.130.0-255,2902,4671,65,166617
26103,4.6e-05,172.31.40.0-255,66,4737,65,166617
26104,5.1e-05,74.125.130.0-255,2902,7639,65,166617
26105,5.4e-05,172.31.40.0-255,66,7705,65,166617
26106,8e-05,74.125.130.0-255,2902,10607,65,166617
26107,8.2e-05,172.31.40.0-255,66,10673,65,166617
26108,8.6e-05,74.125.130.0-255,2902,13575,65,166617
26109,8.9e-05,172.31.40.0-255,66,13641,65,166617
26110,9.4e-05,74.125.130.0-255,3366,17007,65,166617
26111,9.7e-05,172.31.40.0-255,66,17073,65,166617
26112,0.000128,172.31.40.0-255,66,17139,65,166617
26113,0.000131,74.125.130.0-255,1484,18623,65,166617
26114,0.000133,172.31.40.0-255,66,18689,65,166617
26115,0.000176,74.125.130.0-255,2902,21591,65,166617
26116,0.000179,172.31.40.0-255,66,21657,65,166617
26117,0.000215,74.125.130.0-255,1125,22782,65,166617
26118,0.000218,172.31.40.0-255,66,22848,65,166617
26119,0.000364,74.125.130.0-255,1484,24332,65,166617
26120,0.00037,172.31.40.0-255,66,24398,65,166617
26121,0.000374,74.125.130.0-255,1484,25882,65,166617
26122,0.000376,172.31.40.0-255,66,25948,65,166617
26123,0.00038,74.125.130.0-255,1484,27432,65,166617
26124,0.000382,172.31.40.0-255,66,27498,65,166617
26125,0.00041,74.125.130.0-255,1484,28982,65,166617
26126,0.000413,172.31.40.0-255,66,29048,65,166617
26127,0.00042,74.125.130.0-255,5738,34786,65,166617
26128,0.000423,172.31.40.0-255,66,34852,65,166617
26129,0.000429,74.125.130.0-255,5379,40231,65,166617
26130,0.000432,172.31.40.0-255,66,40297,65,166617
26131,0.000453,74.125.130.0-255,5738,46035,65,166617
26132,0.000456,172.31.40.0-255,66,46101,65,166617
26133,0.000481,74.125.130.0-255,2902,49003,65,166617
26134,0.000484,172.31.40.0-255,66,49069,65,166617
26135,0.000489,74.125.130.0-255,4320,53389,65,166617
26136,0.000492,172.31.40.0-255,66,53455,65,166617
26137,0.000534,74.125.130.0-255,4214,57669,65,166617
26138,0.000538,172.31.40.0-255,66,57735,65,166617
26139,0.000551,74.125.130.0-255,404,58139,65,166617
26140,0.000647,74.125.130.0-255,1484,59623,65,166617
26141,0.000651,172.31.40.0-255,66,59689,65,166617
26142,0.000656,74.125.130.0-255,2902,62591,65,166617
26143,0.000659,172.31.40.0-255,66,62657,65,166617
26144,0.000674,74.125.130.0-255,2902,65559,65,166617
26145,0.000677,172.31.40.0-255,66,65625,65,166617
26146,0.000681,74.125.130.0-255,2902,68527,65,166617
26147,0.000683,172.31.40.0-255,66,68593,65,166617
26148,0.000703,74.125.130.0-255,1484,70077,65,166617
26149,0.000711,74.125.130.0-255,5738,75815,65,166617
26150,0.000714,172.31.40.0-255,66,75881,65,166617
26151,0.000736,74.125.130.0-255,2902,78783,65,166617
26152,0.000739,172.31.40.0-255,66,78849,65,166617
26153,0.000745,74.125.130.0-255,5738,84587,65,166617
26154,0.000747,172.31.40.0-255,66,84653,65,166617
26155,0.000754,74.125.130.0-255,7156,91809,65,166617
26156,0.000756,172.31.40.0-255,66,91875,65,166617
26157,0.000759,74.125.130.0-255,766,92641,65,166617
26158,0.001429,172.31.40.0-255,66,92707,65,166617
26159,0.002043,74.125.130.0-255,1484,94191,65,166617
26160,0.002055,74.125.130.0-255,2902,97093,65,166617
26161,0.00206,172.31.40.0-255,66,97159,65,166617
26162,0.002088,74.125.130.0-255,1484,98643,65,166617
26163,0.002108,74.125.130.0-255,2902,101545,65,166617
26164,0.002111,172.31.40.0-255,66,101611,65,166617
26165,0.002135,74.125.130.0-255,5738,107349,65,166617
26166,0.002138,172.31.40.0-255,66,107415,65,166617
26167,0.002141,74.125.130.0-255,1484,108899,65,166617
26168,0.002145,74.125.130.0-255,2902,111801,65,166617
26169,0.002147,172.31.40.0-255,66,111867,65,166617
26170,0.002186,74.125.130.0-255,1484,113351,65,166617
26171,0.002204,74.125.130.0-255,2902,116253,65,166617
26172,0.002207,172.31.40.0-255,66,116319,65,166617
26173,0.002221,74.125.130.0-255,2902,119221,65,166617
26174,0.002224,172.31.40.0-255,66,119287,65,166617
26175,0.00224,74.125.130.0-255,2902,122189,65,166617
26176,0.002242,172.31.40.0-255,66,122255,65,166617
26177,0.002248,74.125.130.0-255,4320,126575,65,166617
26178,0.00225,172.31.40.0-255,66,126641,65,166617
26179,0.002272,74.125.130.0-255,766,127407,65,166617
26180,0.004744,74.125.130.0-255,4320,131727,65,166617
26181,0.004748,172.31.40.0-255,66,131793,65,166617
26182,0.007273,74.125.130.0-255,5738,137531,65,166617
26183,0.007281,172.31.40.0-255,66,137597,65,166617
26184,0.009812,74.125.130.0-255,5738,143335,65,166617
26185,0.009823,172.31.40.0-255,66,143401,65,166617
26186,0.012345,74.125.130.0-255,5738,149139,65,166617
26187,0.012356,172.31.40.0-255,66,149205,65,166617
26188,0.014871,74.125.130.0-255,5738,154943,65,166617
26189,0.014879,172.31.40.0-255,66,155009,65,166617
26190,0.017396,74.125.130.0-255,5738,160747,65,166617
26191,0.017405,172.31.40.0-255,66,160813,65,166617
26192,0.019925,74.125.130.0-255,5738,166551,65,166617
26193,0.019934,172.31.40.0-255,66,166617,65,166617
26194,0.0,172.217.194.0-255,154,154,65,137623
26195,2.1e-05,172.31.40.0-255,66,220,65,137623
26196,2.9e-05,172.217.194.0-255,1484,1704,65,137623
26197,3.3e-05,172.31.40.0-255,66,1770,65,137623
26198,3.9e-05,172.217.194.0-255,2902,4672,65,137623
26199,5e-05,172.31.40.0-255,66,4738,65,137623
26200,5.4e-05,172.217.194.0-255,1484,6222,65,137623
26201,5.7e-05,172.31.40.0-255,66,6288,65,137623
26202,6.2e-05,172.217.194.0-255,2902,9190,65,137623
26203,6.5e-05,172.31.40.0-255,66,9256,65,137623
26204,7.2e-05,172.217.194.0-255,6285,15541,65,137623
26205,7.5e-05,172.31.40.0-255,66,15607,65,137623
26206,9.9e-05,172.217.194.0-255,4320,19927,65,137623
26207,0.000105,172.31.40.0-255,66,19993,65,137623
26208,0.000135,172.217.194.0-255,4320,24313,65,137623
26209,0.000138,172.31.40.0-255,66,24379,65,137623
26210,0.000165,172.217.194.0-255,2902,27281,65,137623
26211,0.000168,172.31.40.0-255,66,27347,65,137623
26212,0.000199,172.217.194.0-255,3961,31308,65,137623
26213,0.000202,172.31.40.0-255,66,31374,65,137623
26214,0.000236,172.217.194.0-255,7156,38530,65,137623
26215,0.000239,172.31.40.0-255,66,38596,65,137623
26216,0.000273,172.31.40.0-255,66,38662,65,137623
26217,0.000311,172.217.194.0-255,6797,45459,65,137623
26218,0.000314,172.31.40.0-255,66,45525,65,137623
26219,0.000373,172.217.194.0-255,1484,47009,65,137623
26220,0.000377,172.31.40.0-255,66,47075,65,137623
26221,0.000418,172.31.40.0-255,66,47141,65,137623
26222,0.000429,172.217.194.0-255,99,47240,65,137623
26223,0.000431,172.31.40.0-255,66,47306,65,137623
26224,0.000438,172.217.194.0-255,365,47671,65,137623
26225,0.001101,172.31.40.0-255,66,47737,65,137623
26226,0.001494,172.217.194.0-255,1484,49221,65,137623
26227,0.001505,172.217.194.0-255,2902,52123,65,137623
26228,0.001509,172.31.40.0-255,66,52189,65,137623
26229,0.001516,172.217.194.0-255,4320,56509,65,137623
26230,0.001519,172.31.40.0-255,66,56575,65,137623
26231,0.001546,172.217.194.0-255,1484,58059,65,137623
26232,0.001549,172.217.194.0-255,1484,59543,65,137623
26233,0.001552,172.31.40.0-255,66,59609,65,137623
26234,0.001597,172.31.40.0-255,66,59675,65,137623
26235,0.001635,172.217.194.0-255,4320,63995,65,137623
26236,0.001638,172.31.40.0-255,66,64061,65,137623
26237,0.001663,172.217.194.0-255,6438,70499,65,137623
26238,0.001666,172.31.40.0-255,66,70565,65,137623
26239,0.001736,172.31.40.0-255,66,70631,65,137623
26240,0.001806,172.217.194.0-255,7156,77787,65,137623
26241,0.00181,172.31.40.0-255,66,77853,65,137623
26242,0.001848,172.31.40.0-255,66,77919,65,137623
26243,0.00194,172.217.194.0-255,4320,82239,65,137623
26244,0.001945,172.31.40.0-255,66,82305,65,137623
26245,0.001985,172.31.40.0-255,66,82371,65,137623
26246,0.002073,172.31.40.0-255,66,82437,65,137623
26247,0.002103,172.31.40.0-255,66,82503,65,137623
26248,0.002213,172.217.194.0-255,1484,83987,65,137623
26249,0.002275,172.31.40.0-255,66,84053,65,137623
26250,0.002433,172.217.194.0-255,1484,85537,65,137623
26251,0.002452,172.217.194.0-255,6438,91975,65,137623
26252,0.002489,172.217.194.0-255,2902,94877,65,137623
26253,0.002548,172.217.194.0-255,3602,98479,65,137623
26254,0.0028,172.217.194.0-255,2902,101381,65,137623
26255,0.003218,172.217.194.0-255,7156,108537,65,137623
26256,0.008079,172.31.40.0-255,66,108603,65,137623
26257,0.010415,172.217.194.0-255,5738,114341,65,137623
26258,0.010426,172.31.40.0-255,66,114407,65,137623
26259,0.012744,172.217.194.0-255,5738,120145,65,137623
26260,0.012751,172.31.40.0-255,66,120211,65,137623
26261,0.015088,172.217.194.0-255,5738,125949,65,137623
26262,0.015102,172.31.40.0-255,66,126015,65,137623
26263,0.017435,172.217.194.0-255,5738,131753,65,137623
26264,0.017442,172.31.40.0-255,66,131819,65,137623
26265,0.019774,172.217.194.0-255,5738,137557,65,137623
26266,0.019785,172.31.40.0-255,66,137623,65,137623
26267,0.0,172.217.194.0-255,152,152,65,181924
26268,3.1e-05,172.31.40.0-255,66,218,65,181924
26269,3.6e-05,172.217.194.0-255,1484,1702,65,181924
26270,4e-05,172.31.40.0-255,66,1768,65,181924
26271,4.4e-05,172.217.194.0-255,2902,4670,65,181924
26272,4.6e-05,172.31.40.0-255,66,4736,65,181924
26273,5.2e-05,172.217.194.0-255,7156,11892,65,181924
26274,5.5e-05,172.31.40.0-255,66,11958,65,181924
26275,8.5e-05,172.31.40.0-255,66,12024,65,181924
26276,0.000104,172.217.194.0-255,1982,14006,65,181924
26277,0.000106,172.31.40.0-255,66,14072,65,181924
26278,0.00013,172.217.194.0-255,6797,20869,65,181924
26279,0.000133,172.31.40.0-255,66,20935,65,181924
26280,0.000136,172.217.194.0-255,2902,23837,65,181924
26281,0.000138,172.31.40.0-255,66,23903,65,181924
26282,0.000155,172.217.194.0-255,4320,28223,65,181924
26283,0.000158,172.31.40.0-255,66,28289,65,181924
26284,0.000176,172.217.194.0-255,4320,32609,65,181924
26285,0.000178,172.31.40.0-255,66,32675,65,181924
26286,0.000192,172.217.194.0-255,5738,38413,65,181924
26287,0.000194,172.31.40.0-255,66,38479,65,181924
26288,0.000214,172.217.194.0-255,5738,44217,65,181924
26289,0.000216,172.31.40.0-255,66,44283,65,181924
26290,0.000219,172.217.194.0-255,1484,45767,65,181924
26291,0.000221,172.31.40.0-255,66,45833,65,181924
26292,0.000224,172.217.194.0-255,1484,47317,65,181924
26293,0.000225,172.31.40.0-255,66,47383,65,181924
26294,0.000258,172.31.40.0-255,66,47449,65,181924
26295,0.00026,172.217.194.0-255,410,47859,65,181924
26296,0.000262,172.31.40.0-255,66,47925,65,181924
26297,0.000318,172.217.194.0-255,1484,49409,65,181924
26298,0.000336,172.217.194.0-255,2902,52311,65,181924
26299,0.000339,172.31.40.0-255,66,52377,65,181924
26300,0.000363,172.217.194.0-255,5738,58115,65,181924
26301,0.000367,172.31.40.0-255,66,58181,65,181924
26302,0.000372,172.217.194.0-255,2902,61083,65,181924
26303,0.000374,172.31.40.0-255,66,61149,65,181924
26304,0.000397,172.31.40.0-255,66,61215,65,181924
26305,0.000407,172.31.40.0-255,66,61281,65,181924
26306,0.00077,172.217.194.0-255,1484,62765,65,181924
26307,0.000776,172.217.194.0-255,2902,65667,65,181924
26308,0.000779,172.31.40.0-255,66,65733,65,181924
26309,0.000804,172.217.194.0-255,5738,71471,65,181924
26310,0.000807,172.31.40.0-255,66,71537,65,181924
26311,0.000838,172.217.194.0-255,4320,75857,65,181924
26312,0.000841,172.31.40.0-255,66,75923,65,181924
26313,0.000865,172.217.194.0-255,6515,82438,65,181924
26314,0.000868,172.31.40.0-255,66,82504,65,181924
26315,0.000877,172.31.40.0-255,66,82570,65,181924
26316,0.00089,172.217.194.0-255,2902,85472,65,181924
26317,0.000892,172.31.40.0-255,66,85538,65,181924
26318,0.000895,172.217.194.0-255,1484,87022,65,181924
26319,0.000939,172.217.194.0-255,5738,92760,65,181924
26320,0.000942,172.31.40.0-255,66,92826,65,181924
26321,0.000964,172.31.40.0-255,66,92892,65,181924
26322,0.000968,172.217.194.0-255,2184,95076,65,181924
26323,0.000971,172.31.40.0-255,66,95142,65,181924
26324,0.001154,172.217.194.0-255,1484,96626,65,181924
26325,0.001159,172.217.194.0-255,2902,99528,65,181924
26326,0.001163,172.31.40.0-255,66,99594,65,181924
26327,0.001169,172.217.194.0-255,5738,105332,65,181924
26328,0.001171,172.31.40.0-255,66,105398,65,181924
26329,0.001189,172.217.194.0-255,1484,106882,65,181924
26330,0.001226,172.31.40.0-255,66,106948,65,181924
26331,0.001236,172.31.40.0-255,66,107014,65,181924
26332,0.00125,172.217.194.0-255,3602,110616,65,181924
26333,0.001252,172.31.40.0-255,66,110682,65,181924
26334,0.001311,172.217.194.0-255,1484,112166,65,181924
26335,0.001324,172.217.194.0-255,1484,113650,65,181924
26336,0.001327,172.31.40.0-255,66,113716,65,181924
26337,0.001345,172.217.194.0-255,1484,115200,65,181924
26338,0.001351,172.217.194.0-255,5738,120938,65,181924
26339,0.001353,172.31.40.0-255,66,121004,65,181924
26340,0.001377,172.217.194.0-255,2902,123906,65,181924
26341,0.001379,172.31.40.0-255,66,123972,65,181924
26342,0.001399,172.217.194.0-255,4320,128292,65,181924
26343,0.001401,172.31.40.0-255,66,128358,65,181924
26344,0.001412,172.31.40.0-255,66,128424,65,181924
26345,0.001437,172.217.194.0-255,4320,132744,65,181924
26346,0.00144,172.217.194.0-255,2184,134928,65,181924
26347,0.001441,172.31.40.0-255,66,134994,65,181924
26348,0.001444,172.31.40.0-255,66,135060,65,181924
26349,0.00146,172.217.194.0-255,2902,137962,65,181924
26350,0.001463,172.31.40.0-255,66,138028,65,181924
26351,0.001478,172.217.194.0-255,7156,145184,65,181924
26352,0.00148,172.31.40.0-255,66,145250,65,181924
26353,0.001497,172.217.194.0-255,7156,152406,65,181924
26354,0.0015,172.31.40.0-255,66,152472,65,181924
26355,0.001506,172.217.194.0-255,7156,159628,65,181924
26356,0.001508,172.31.40.0-255,66,159694,65,181924
26357,0.001545,172.31.40.0-255,66,159760,65,181924
26358,0.001561,172.217.194.0-255,766,160526,65,181924
26359,0.001573,172.31.40.0-255,66,160592,65,181924
26360,0.001604,172.217.194.0-255,1484,162076,65,181924
26361,0.001629,172.31.40.0-255,66,162142,65,181924
26362,0.001661,172.31.40.0-255,66,162208,65,181924
26363,0.001702,172.217.194.0-255,5738,167946,65,181924
26364,0.001705,172.31.40.0-255,66,168012,65,181924
26365,0.00174,172.31.40.0-255,66,168078,65,181924
26366,0.001774,172.217.194.0-255,2902,170980,65,181924
26367,0.001777,172.31.40.0-255,66,171046,65,181924
26368,0.001812,172.31.40.0-255,66,171112,65,181924
26369,0.001862,172.217.194.0-255,2902,174014,65,181924
26370,0.001862,172.31.40.0-255,66,174080,65,181924
26371,0.001866,172.31.40.0-255,66,174146,65,181924
26372,0.001909,172.31.40.0-255,66,174212,65,181924
26373,0.001912,172.217.194.0-255,1484,175696,65,181924
26374,0.001934,172.31.40.0-255,66,175762,65,181924
26375,0.001961,172.217.194.0-255,5754,181516,65,181924
26376,0.001964,172.217.194.0-255,105,181621,65,181924
26377,0.001965,172.31.40.0-255,66,181687,65,181924
26378,0.003084,172.31.40.0-255,66,181753,65,181924
26379,0.003112,172.31.40.0-255,105,181858,65,181924
26380,0.005431,172.217.194.0-255,66,181924,65,181924
26381,0.0,172.217.194.0-255,150,150,65,154967
26382,2.1e-05,172.31.40.0-255,66,216,65,154967
26383,2.8e-05,172.217.194.0-255,1484,1700,65,154967
26384,3.3e-05,172.31.40.0-255,66,1766,65,154967
26385,3.8e-05,172.217.194.0-255,2902,4668,65,154967
26386,4.2e-05,172.31.40.0-255,66,4734,65,154967
26387,5.4e-05,172.217.194.0-255,1484,6218,65,154967
26388,5.7e-05,172.31.40.0-255,66,6284,65,154967
26389,6.5e-05,172.217.194.0-255,5738,12022,65,154967
26390,6.8e-05,172.31.40.0-255,66,12088,65,154967
26391,7.4e-05,172.217.194.0-255,3403,15491,65,154967
26392,7.7e-05,172.31.40.0-255,66,15557,65,154967
26393,8.2e-05,172.217.194.0-255,4320,19877,65,154967
26394,8.5e-05,172.31.40.0-255,66,19943,65,154967
26395,9.4e-05,172.217.194.0-255,7156,27099,65,154967
26396,9.7e-05,172.31.40.0-255,66,27165,65,154967
26397,0.00014,172.217.194.0-255,2902,30067,65,154967
26398,0.000143,172.31.40.0-255,66,30133,65,154967
26399,0.000147,172.217.194.0-255,1125,31258,65,154967
26400,0.000149,172.31.40.0-255,66,31324,65,154967
26401,0.000152,172.217.194.0-255,1484,32808,65,154967
26402,0.000154,172.31.40.0-255,66,32874,65,154967
26403,0.00016,172.217.194.0-255,4320,37194,65,154967
26404,0.000163,172.31.40.0-255,66,37260,65,154967
26405,0.000228,172.217.194.0-255,7156,44416,65,154967
26406,0.000231,172.31.40.0-255,66,44482,65,154967
26407,0.000247,172.31.40.0-255,66,44548,65,154967
26408,0.000252,172.217.194.0-255,3961,48509,65,154967
26409,0.000254,172.31.40.0-255,66,48575,65,154967
26410,0.000257,172.217.194.0-255,676,49251,65,154967
26411,0.00026,172.31.40.0-255,66,49317,65,154967
26412,0.000433,172.217.194.0-255,1484,50801,65,154967
26413,0.00044,172.217.194.0-255,2902,53703,65,154967
26414,0.000444,172.31.40.0-255,66,53769,65,154967
26415,0.000448,172.217.194.0-255,1484,55253,65,154967
26416,0.000503,172.217.194.0-255,4320,59573,65,154967
26417,0.000506,172.31.40.0-255,66,59639,65,154967
26418,0.000519,172.31.40.0-255,66,59705,65,154967
26419,0.00056,172.31.40.0-255,66,59771,65,154967
26420,0.000921,172.217.194.0-255,1484,61255,65,154967
26421,0.000954,172.217.194.0-255,2902,64157,65,154967
26422,0.000958,172.31.40.0-255,66,64223,65,154967
26423,0.000966,172.217.194.0-255,5738,69961,65,154967
26424,0.000968,172.31.40.0-255,66,70027,65,154967
26425,0.000987,172.31.40.0-255,66,70093,65,154967
26426,0.001,172.31.40.0-255,66,70159,65,154967
26427,0.001025,172.217.194.0-255,766,70925,65,154967
26428,0.001289,172.217.194.0-255,1484,72409,65,154967
26429,0.001294,172.31.40.0-255,66,72475,65,154967
26430,0.001299,172.217.194.0-255,2902,75377,65,154967
26431,0.001301,172.31.40.0-255,66,75443,65,154967
26432,0.001308,172.217.194.0-255,5738,81181,65,154967
26433,0.001316,172.31.40.0-255,66,81247,65,154967
26434,0.001319,172.217.194.0-255,1484,82731,65,154967
26435,0.001357,172.31.40.0-255,66,82797,65,154967
26436,0.001368,172.31.40.0-255,66,82863,65,154967
26437,0.001371,172.217.194.0-255,766,83629,65,154967
26438,0.001545,172.217.194.0-255,1484,85113,65,154967
26439,0.00155,172.31.40.0-255,66,85179,65,154967
26440,0.001555,172.217.194.0-255,2902,88081,65,154967
26441,0.001557,172.31.40.0-255,66,88147,65,154967
26442,0.001591,172.217.194.0-255,5738,93885,65,154967
26443,0.001594,172.31.40.0-255,66,93951,65,154967
26444,0.001605,172.31.40.0-255,66,94017,65,154967
26445,0.001637,172.217.194.0-255,4320,98337,65,154967
26446,0.001641,172.31.40.0-255,66,98403,65,154967
26447,0.001652,172.31.40.0-255,66,98469,65,154967
26448,0.001655,172.217.194.0-255,766,99235,65,154967
26449,0.00183,172.217.194.0-255,1484,100719,65,154967
26450,0.001835,172.31.40.0-255,66,100785,65,154967
26451,0.00184,172.217.194.0-255,2902,103687,65,154967
26452,0.001842,172.31.40.0-255,66,103753,65,154967
26453,0.001926,172.217.194.0-255,5738,109491,65,154967
26454,0.001931,172.31.40.0-255,66,109557,65,154967
26455,0.001936,172.217.194.0-255,4320,113877,65,154967
26456,0.001939,172.31.40.0-255,66,113943,65,154967
26457,0.001951,172.31.40.0-255,66,114009,65,154967
26458,0.001961,172.31.40.0-255,66,114075,65,154967
26459,0.004515,172.217.194.0-255,5738,119813,65,154967
26460,0.004522,172.31.40.0-255,66,119879,65,154967
26461,0.00706,172.217.194.0-255,2902,122781,65,154967
26462,0.007064,172.31.40.0-255,66,122847,65,154967
26463,0.007092,172.217.194.0-255,2902,125749,65,154967
26464,0.007095,172.31.40.0-255,66,125815,65,154967
26465,0.009604,172.217.194.0-255,2902,128717,65,154967
26466,0.009612,172.31.40.0-255,66,128783,65,154967
26467,0.009642,172.217.194.0-255,2902,131685,65,154967
26468,0.009649,172.31.40.0-255,66,131751,65,154967
26469,0.012176,172.217.194.0-255,5738,137489,65,154967
26470,0.012187,172.31.40.0-255,66,137555,65,154967
26471,0.014763,172.217.194.0-255,5738,143293,65,154967
26472,0.014772,172.31.40.0-255,66,143359,65,154967
26473,0.017373,172.217.194.0-255,5738,149097,65,154967
26474,0.017381,172.31.40.0-255,66,149163,65,154967
26475,0.019947,172.217.194.0-255,5738,154901,65,154967
26476,0.019954,172.31.40.0-255,66,154967,65,154967
26477,0.0,172.217.194.0-255,147,147,65,103835
26478,2.2e-05,172.31.40.0-255,66,213,65,103835
26479,2.8e-05,172.217.194.0-255,1484,1697,65,103835
26480,3.2e-05,172.31.40.0-255,66,1763,65,103835
26481,3.8e-05,172.217.194.0-255,2902,4665,65,103835
26482,4e-05,172.31.40.0-255,66,4731,65,103835
26483,7.6e-05,172.217.194.0-255,4320,9051,65,103835
26484,7.9e-05,172.31.40.0-255,66,9117,65,103835
26485,0.000111,172.217.194.0-255,2902,12019,65,103835
26486,0.000113,172.31.40.0-255,66,12085,65,103835
26487,0.000125,172.31.40.0-255,66,12151,65,103835
26488,0.000137,172.31.40.0-255,66,12217,65,103835
26489,0.000177,172.31.40.0-255,66,12283,65,103835
26490,0.000204,172.217.194.0-255,1484,13767,65,103835
26491,0.000206,172.31.40.0-255,66,13833,65,103835
26492,0.000211,172.217.194.0-255,2902,16735,65,103835
26493,0.000213,172.31.40.0-255,66,16801,65,103835
26494,0.000245,172.217.194.0-255,5738,22539,65,103835
26495,0.000248,172.31.40.0-255,66,22605,65,103835
26496,0.000268,172.217.194.0-255,7087,29692,65,103835
26497,0.00027,172.31.40.0-255,66,29758,65,103835
26498,0.00049,172.217.194.0-255,365,30123,65,103835
26499,0.000495,172.31.40.0-255,66,30189,65,103835
26500,0.000518,172.217.194.0-255,1484,31673,65,103835
26501,0.000521,172.31.40.0-255,66,31739,65,103835
26502,0.000524,172.217.194.0-255,1484,33223,65,103835
26503,0.000525,172.31.40.0-255,66,33289,65,103835
26504,0.000552,172.217.194.0-255,2902,36191,65,103835
26505,0.000555,172.31.40.0-255,66,36257,65,103835
26506,0.000562,172.217.194.0-255,7156,43413,65,103835
26507,0.000568,172.217.194.0-255,4320,47733,65,103835
26508,0.000593,172.217.194.0-255,4320,52053,65,103835
26509,0.000595,172.217.194.0-255,1484,53537,65,103835
26510,0.000612,172.217.194.0-255,7156,60693,65,103835
26511,0.000614,172.31.40.0-255,66,60759,65,103835
26512,0.000619,172.31.40.0-255,66,60825,65,103835
26513,0.000627,172.217.194.0-255,3602,64427,65,103835
26514,0.000649,172.31.40.0-255,66,64493,65,103835
26515,0.004005,172.217.194.0-255,1484,65977,65,103835
26516,0.004017,172.217.194.0-255,2902,68879,65,103835
26517,0.004022,172.31.40.0-255,66,68945,65,103835
26518,0.004027,172.217.194.0-255,1484,70429,65,103835
26519,0.006336,172.217.194.0-255,4320,74749,65,103835
26520,0.00634,172.31.40.0-255,66,74815,65,103835
26521,0.008639,172.217.194.0-255,5738,80553,65,103835
26522,0.008646,172.31.40.0-255,66,80619,65,103835
26523,0.010962,172.217.194.0-255,5738,86357,65,103835
26524,0.010971,172.31.40.0-255,66,86423,65,103835
26525,0.013327,172.217.194.0-255,5738,92161,65,103835
26526,0.01334,172.31.40.0-255,66,92227,65,103835
26527,0.015693,172.217.194.0-255,5738,97965,65,103835
26528,0.015704,172.31.40.0-255,66,98031,65,103835
26529,0.018019,172.217.194.0-255,5738,103769,65,103835
26530,0.018027,172.31.40.0-255,66,103835,65,103835
26531,0.0,172.217.194.0-255,153,153,65,149532
26532,2.2e-05,172.31.40.0-255,66,219,65,149532
26533,2.9e-05,172.217.194.0-255,1484,1703,65,149532
26534,3.5e-05,172.31.40.0-255,66,1769,65,149532
26535,3.8e-05,172.217.194.0-255,1484,3253,65,149532
26536,4.1e-05,172.31.40.0-255,66,3319,65,149532
26537,6e-05,172.217.194.0-255,1484,4803,65,149532
26538,6.3e-05,172.31.40.0-255,66,4869,65,149532
26539,6.8e-05,172.217.194.0-255,2902,7771,65,149532
26540,7.1e-05,172.31.40.0-255,66,7837,65,149532
26541,0.000124,172.217.194.0-255,6285,14122,65,149532
26542,0.000128,172.31.40.0-255,66,14188,65,149532
26543,0.000239,172.217.194.0-255,1484,15672,65,149532
26544,0.000243,172.31.40.0-255,66,15738,65,149532
26545,0.000249,172.217.194.0-255,2902,18640,65,149532
26546,0.000251,172.31.40.0-255,66,18706,65,149532
26547,0.000277,172.217.194.0-255,5738,24444,65,149532
26548,0.000281,172.31.40.0-255,66,24510,65,149532
26549,0.00032,172.217.194.0-255,7156,31666,65,149532
26550,0.000324,172.31.40.0-255,66,31732,65,149532
26551,0.000347,172.217.194.0-255,6797,38529,65,149532
26552,0.000349,172.31.40.0-255,66,38595,65,149532
26553,0.000367,172.217.194.0-255,4320,42915,65,149532
26554,0.00037,172.31.40.0-255,66,42981,65,149532
26555,0.00039,172.217.194.0-255,5379,48360,65,149532
26556,0.000393,172.31.40.0-255,66,48426,65,149532
26557,0.00043,172.217.194.0-255,5738,54164,65,149532
26558,0.000433,172.31.40.0-255,66,54230,65,149532
26559,0.00044,172.217.194.0-255,7156,61386,65,149532
26560,0.000444,172.31.40.0-255,66,61452,65,149532
26561,0.000473,172.217.194.0-255,3961,65413,65,149532
26562,0.000476,172.31.40.0-255,66,65479,65,149532
26563,0.00051,172.217.194.0-255,676,66155,65,149532
26564,0.000798,172.217.194.0-255,1484,67639,65,149532
26565,0.000803,172.31.40.0-255,66,67705,65,149532
26566,0.000808,172.217.194.0-255,2902,70607,65,149532
26567,0.000811,172.31.40.0-255,66,70673,65,149532
26568,0.00084,172.217.194.0-255,5738,76411,65,149532
26569,0.000844,172.31.40.0-255,66,76477,65,149532
26570,0.000851,172.217.194.0-255,7156,83633,65,149532
26571,0.000854,172.31.40.0-255,66,83699,65,149532
26572,0.000869,172.217.194.0-255,2902,86601,65,149532
26573,0.000871,172.31.40.0-255,66,86667,65,149532
26574,0.000884,172.31.40.0-255,66,86733,65,149532
26575,0.000888,172.217.194.0-255,2184,88917,65,149532
26576,0.00089,172.31.40.0-255,66,88983,65,149532
26577,0.00137,172.217.194.0-255,1484,90467,65,149532
26578,0.001376,172.217.194.0-255,2902,93369,65,149532
26579,0.001379,172.31.40.0-255,66,93435,65,149532
26580,0.001383,172.217.194.0-255,1484,94919,65,149532
26581,0.001404,172.217.194.0-255,4320,99239,65,149532
26582,0.001407,172.31.40.0-255,66,99305,65,149532
26583,0.00142,172.31.40.0-255,66,99371,65,149532
26584,0.001446,172.217.194.0-255,1484,100855,65,149532
26585,0.001458,172.31.40.0-255,66,100921,65,149532
26586,0.001618,172.31.40.0-255,101,101022,65,149532
26587,0.002244,172.217.194.0-255,1484,102506,65,149532
26588,0.002256,172.217.194.0-255,2902,105408,65,149532
26589,0.002261,172.31.40.0-255,66,105474,65,149532
26590,0.002285,172.217.194.0-255,5738,111212,65,149532
26591,0.002288,172.31.40.0-255,66,111278,65,149532
26592,0.002302,172.217.194.0-255,2902,114180,65,149532
26593,0.002304,172.31.40.0-255,66,114246,65,149532
26594,0.002341,172.31.40.0-255,66,114312,65,149532
26595,0.002392,172.31.40.0-255,66,114378,65,149532
26596,0.004108,172.217.194.0-255,66,114444,65,149532
26597,0.004915,172.217.194.0-255,2902,117346,65,149532
26598,0.00492,172.31.40.0-255,66,117412,65,149532
26599,0.004938,172.217.194.0-255,2902,120314,65,149532
26600,0.00494,172.31.40.0-255,66,120380,65,149532
26601,0.007487,172.217.194.0-255,2902,123282,65,149532
26602,0.007494,172.31.40.0-255,66,123348,65,149532
26603,0.007517,172.217.194.0-255,2902,126250,65,149532
26604,0.007519,172.31.40.0-255,66,126316,65,149532
26605,0.010043,172.217.194.0-255,5738,132054,65,149532
26606,0.010051,172.31.40.0-255,66,132120,65,149532
26607,0.012581,172.217.194.0-255,5738,137858,65,149532
26608,0.012589,172.31.40.0-255,66,137924,65,149532
26609,0.01514,172.217.194.0-255,5738,143662,65,149532
26610,0.015148,172.31.40.0-255,66,143728,65,149532
26611,0.017696,172.217.194.0-255,5738,149466,65,149532
26612,0.017703,172.31.40.0-255,66,149532,65,149532
26613,0.0,74.125.68.0-255,182,182,65,259878
26614,2.2e-05,172.31.40.0-255,66,248,65,259878
26615,3e-05,74.125.68.0-255,1484,1732,65,259878
26616,3.5e-05,172.31.40.0-255,66,1798,65,259878
26617,4.1e-05,74.125.68.0-255,2902,4700,65,259878
26618,4.5e-05,172.31.40.0-255,66,4766,65,259878
26619,4.8e-05,74.125.68.0-255,1484,6250,65,259878
26620,5.1e-05,172.31.40.0-255,66,6316,65,259878
26621,7.7e-05,74.125.68.0-255,2902,9218,65,259878
26622,8e-05,172.31.40.0-255,66,9284,65,259878
26623,0.000111,74.125.68.0-255,4936,14220,65,259878
26624,0.000115,172.31.40.0-255,66,14286,65,259878
26625,0.000118,74.125.68.0-255,1484,15770,65,259878
26626,0.00012,172.31.40.0-255,66,15836,65,259878
26627,0.000135,74.125.68.0-255,4320,20156,65,259878
26628,0.000138,172.31.40.0-255,66,20222,65,259878
26629,0.000141,74.125.68.0-255,1484,21706,65,259878
26630,0.000144,172.31.40.0-255,66,21772,65,259878
26631,0.000148,74.125.68.0-255,2902,24674,65,259878
26632,0.000151,172.31.40.0-255,66,24740,65,259878
26633,0.00018,74.125.68.0-255,5738,30478,65,259878
26634,0.000183,172.31.40.0-255,66,30544,65,259878
26635,0.000186,74.125.68.0-255,1484,32028,65,259878
26636,0.000188,172.31.40.0-255,66,32094,65,259878
26637,0.000225,172.31.40.0-255,66,32160,65,259878
26638,0.000245,74.125.68.0-255,5738,37898,65,259878
26639,0.000248,172.31.40.0-255,66,37964,65,259878
26640,0.000267,74.125.68.0-255,2184,40148,65,259878
26641,0.00027,172.31.40.0-255,66,40214,65,259878
26642,0.000288,74.125.68.0-255,1484,41698,65,259878
26643,0.00029,172.31.40.0-255,66,41764,65,259878
26644,0.000313,74.125.68.0-255,2902,44666,65,259878
26645,0.000316,172.31.40.0-255,66,44732,65,259878
26646,0.000345,74.125.68.0-255,5738,50470,65,259878
26647,0.000348,172.31.40.0-255,66,50536,65,259878
26648,0.000367,74.125.68.0-255,4320,54856,65,259878
26649,0.000369,172.31.40.0-255,66,54922,65,259878
26650,0.000392,74.125.68.0-255,2847,57769,65,259878
26651,0.000395,172.31.40.0-255,66,57835,65,259878
26652,0.000398,74.125.68.0-255,117,57952,65,259878
26653,0.000528,74.125.68.0-255,1484,59436,65,259878
26654,0.000533,172.31.40.0-255,66,59502,65,259878
26655,0.000538,74.125.68.0-255,2902,62404,65,259878
26656,0.00054,172.31.40.0-255,66,62470,65,259878
26657,0.000543,74.125.68.0-255,1484,63954,65,259878
26658,0.000546,74.125.68.0-255,1484,65438,65,259878
26659,0.000548,172.31.40.0-255,66,65504,65,259878
26660,0.000569,74.125.68.0-255,1484,66988,65,259878
26661,0.000586,74.125.68.0-255,5738,72726,65,259878
26662,0.000588,172.31.40.0-255,66,72792,65,259878
26663,0.000591,74.125.68.0-255,1484,74276,65,259878
26664,0.000611,74.125.68.0-255,2902,77178,65,259878
26665,0.000614,172.31.40.0-255,66,77244,65,259878
26666,0.000619,74.125.68.0-255,4320,81564,65,259878
26667,0.000622,172.31.40.0-255,66,81630,65,259878
26668,0.000634,74.125.68.0-255,1484,83114,65,259878
26669,0.000647,74.125.68.0-255,2902,86016,65,259878
26670,0.000649,172.31.40.0-255,66,86082,65,259878
26671,0.00067,74.125.68.0-255,4320,90402,65,259878
26672,0.000673,172.31.40.0-255,66,90468,65,259878
26673,0.000708,74.125.68.0-255,5020,95488,65,259878
26674,0.000712,172.31.40.0-255,66,95554,65,259878
26675,0.000718,74.125.68.0-255,4320,99874,65,259878
26676,0.000721,172.31.40.0-255,66,99940,65,259878
26677,0.000734,74.125.68.0-255,1484,101424,65,259878
26678,0.000754,74.125.68.0-255,5738,107162,65,259878
26679,0.000756,172.31.40.0-255,66,107228,65,259878
26680,0.00078,74.125.68.0-255,5738,112966,65,259878
26681,0.000783,172.31.40.0-255,66,113032,65,259878
26682,0.000794,172.31.40.0-255,66,113098,65,259878
26683,0.00081,74.125.68.0-255,4320,117418,65,259878
26684,0.000813,172.31.40.0-255,66,117484,65,259878
26685,0.000816,74.125.68.0-255,766,118250,65,259878
26686,0.00083,74.125.68.0-255,330,118580,65,259878
26687,0.000887,74.125.68.0-255,1484,120064,65,259878
26688,0.000892,172.31.40.0-255,66,120130,65,259878
26689,0.000901,74.125.68.0-255,2902,123032,65,259878
26690,0.000904,172.31.40.0-255,66,123098,65,259878
26691,0.000909,74.125.68.0-255,2902,126000,65,259878
26692,0.000911,172.31.40.0-255,66,126066,65,259878
26693,0.000928,74.125.68.0-255,1484,127550,65,259878
26694,0.000944,74.125.68.0-255,4320,131870,65,259878
26695,0.000946,172.31.40.0-255,66,131936,65,259878
26696,0.000972,74.125.68.0-255,4320,136256,65,259878
26697,0.000975,172.31.40.0-255,66,136322,65,259878
26698,0.000979,74.125.68.0-255,2902,139224,65,259878
26699,0.000981,172.31.40.0-255,66,139290,65,259878
26700,0.001038,74.125.68.0-255,766,140056,65,259878
26701,0.001041,172.31.40.0-255,66,140122,65,259878
26702,0.001293,74.125.68.0-255,1484,141606,65,259878
26703,0.001298,172.31.40.0-255,66,141672,65,259878
26704,0.001302,74.125.68.0-255,1484,143156,65,259878
26705,0.001321,74.125.68.0-255,2902,146058,65,259878
26706,0.001324,172.31.40.0-255,66,146124,65,259878
26707,0.001327,74.125.68.0-255,1484,147608,65,259878
26708,0.001343,74.125.68.0-255,4320,151928,65,259878
26709,0.001347,172.31.40.0-255,66,151994,65,259878
26710,0.001356,74.125.68.0-255,2902,154896,65,259878
26711,0.001358,172.31.40.0-255,66,154962,65,259878
26712,0.001373,74.125.68.0-255,2902,157864,65,259878
26713,0.001376,172.31.40.0-255,66,157930,65,259878
26714,0.001379,74.125.68.0-255,1484,159414,65,259878
26715,0.001399,74.125.68.0-255,5738,165152,65,259878
26716,0.001402,172.31.40.0-255,66,165218,65,259878
26717,0.001426,74.125.68.0-255,4320,169538,65,259878
26718,0.00143,172.31.40.0-255,66,169604,65,259878
26719,0.001452,74.125.68.0-255,5020,174624,65,259878
26720,0.001455,172.31.40.0-255,66,174690,65,259878
26721,0.001921,74.125.68.0-255,1484,176174,65,259878
26722,0.001937,74.125.68.0-255,2902,179076,65,259878
26723,0.001941,172.31.40.0-255,66,179142,65,259878
26724,0.001945,74.125.68.0-255,1484,180626,65,259878
26725,0.001968,74.125.68.0-255,4320,184946,65,259878
26726,0.001971,172.31.40.0-255,66,185012,65,259878
26727,0.001976,74.125.68.0-255,4320,189332,65,259878
26728,0.001978,172.31.40.0-255,66,189398,65,259878
26729,0.002018,74.125.68.0-255,5738,195136,65,259878
26730,0.002021,172.31.40.0-255,66,195202,65,259878
26731,0.002025,74.125.68.0-255,1484,196686,65,259878
26732,0.002062,74.125.68.0-255,5738,202424,65,259878
26733,0.002065,172.31.40.0-255,66,202490,65,259878
26734,0.002087,74.125.68.0-255,6438,208928,65,259878
26735,0.00209,172.31.40.0-255,66,208994,65,259878
26736,0.002287,74.125.68.0-255,1484,210478,65,259878
26737,0.002294,74.125.68.0-255,2902,213380,65,259878
26738,0.002297,172.31.40.0-255,66,213446,65,259878
26739,0.002327,74.125.68.0-255,5738,219184,65,259878
26740,0.00233,172.31.40.0-255,66,219250,65,259878
26741,0.004659,74.125.68.0-255,5738,224988,65,259878
26742,0.004667,172.31.40.0-255,66,225054,65,259878
26743,0.006995,74.125.68.0-255,5738,230792,65,259878
26744,0.007001,172.31.40.0-255,66,230858,65,259878
26745,0.009335,74.125.68.0-255,5738,236596,65,259878
26746,0.009345,172.31.40.0-255,66,236662,65,259878
26747,0.011679,74.125.68.0-255,5738,242400,65,259878
26748,0.011699,172.31.40.0-255,66,242466,65,259878
26749,0.014081,74.125.68.0-255,5738,248204,65,259878
26750,0.014101,172.31.40.0-255,66,248270,65,259878
26751,0.016448,74.125.68.0-255,5738,254008,65,259878
26752,0.016466,172.31.40.0-255,66,254074,65,259878
26753,0.018813,74.125.68.0-255,5738,259812,65,259878
26754,0.01883,172.31.40.0-255,66,259878,65,259878
26755,0.0,74.125.24.0-255,146,146,65,105517
26756,1.6e-05,172.31.40.0-255,66,212,65,105517
26757,2.3e-05,74.125.24.0-255,1484,1696,65,105517
26758,2.7e-05,172.31.40.0-255,66,1762,65,105517
26759,3.3e-05,74.125.24.0-255,2902,4664,65,105517
26760,3.6e-05,172.31.40.0-255,66,4730,65,105517
26761,4.2e-05,74.125.24.0-255,4320,9050,65,105517
26762,4.4e-05,172.31.40.0-255,66,9116,65,105517
26763,5.1e-05,74.125.24.0-255,4947,14063,65,105517
26764,5.4e-05,172.31.40.0-255,66,14129,65,105517
26765,7.7e-05,74.125.24.0-255,1484,15613,65,105517
26766,8e-05,172.31.40.0-255,66,15679,65,105517
26767,0.000106,74.125.24.0-255,2902,18581,65,105517
26768,0.000108,172.31.40.0-255,66,18647,65,105517
26769,0.000115,74.125.24.0-255,5738,24385,65,105517
26770,0.000117,172.31.40.0-255,66,24451,65,105517
26771,0.00012,74.125.24.0-255,1484,25935,65,105517
26772,0.000122,172.31.40.0-255,66,26001,65,105517
26773,0.000155,172.31.40.0-255,66,26067,65,105517
26774,0.000161,74.125.24.0-255,4320,30387,65,105517
26775,0.000163,172.31.40.0-255,66,30453,65,105517
26776,0.000187,74.125.24.0-255,2902,33355,65,105517
26777,0.000189,172.31.40.0-255,66,33421,65,105517
26778,0.000195,74.125.24.0-255,3602,37023,65,105517
26779,0.000197,172.31.40.0-255,66,37089,65,105517
26780,0.001837,74.125.24.0-255,1484,38573,65,105517
26781,0.001844,172.31.40.0-255,66,38639,65,105517
26782,0.001852,74.125.24.0-255,2902,41541,65,105517
26783,0.001855,172.31.40.0-255,66,41607,65,105517
26784,0.001862,74.125.24.0-255,5738,47345,65,105517
26785,0.001864,172.31.40.0-255,66,47411,65,105517
26786,0.001906,74.125.24.0-255,4320,51731,65,105517
26787,0.001912,172.31.40.0-255,66,51797,65,105517
26788,0.001962,74.125.24.0-255,5738,57535,65,105517
26789,0.001964,74.125.24.0-255,1484,59019,65,105517
26790,0.002002,172.31.40.0-255,66,59085,65,105517
26791,0.004077,74.125.24.0-255,5738,64823,65,105517
26792,0.004082,172.31.40.0-255,66,64889,65,105517
26793,0.006145,74.125.24.0-255,5738,70627,65,105517
26794,0.006151,172.31.40.0-255,66,70693,65,105517
26795,0.008202,74.125.24.0-255,5738,76431,65,105517
26796,0.008209,172.31.40.0-255,66,76497,65,105517
26797,0.010242,74.125.24.0-255,5738,82235,65,105517
26798,0.01025,172.31.40.0-255,66,82301,65,105517
26799,0.012284,74.125.24.0-255,5738,88039,65,105517
26800,0.012292,172.31.40.0-255,66,88105,65,105517
26801,0.014317,74.125.24.0-255,5738,93843,65,105517
26802,0.014326,172.31.40.0-255,66,93909,65,105517
26803,0.016346,74.125.24.0-255,5738,99647,65,105517
26804,0.016356,172.31.40.0-255,66,99713,65,105517
26805,0.018399,74.125.24.0-255,5738,105451,65,105517
26806,0.018409,172.31.40.0-255,66,105517,65,105517
26807,0.0,172.217.194.0-255,150,150,65,170536
26808,1.6e-05,172.31.40.0-255,66,216,65,170536
26809,2.3e-05,172.217.194.0-255,1484,1700,65,170536
26810,2.7e-05,172.31.40.0-255,66,1766,65,170536
26811,3.2e-05,172.217.194.0-255,2902,4668,65,170536
26812,3.5e-05,172.31.40.0-255,66,4734,65,170536
26813,5e-05,172.217.194.0-255,7156,11890,65,170536
26814,5.3e-05,172.31.40.0-255,66,11956,65,170536
26815,5.9e-05,172.217.194.0-255,4320,16276,65,170536
26816,6.2e-05,172.31.40.0-255,66,16342,65,170536
26817,0.000109,172.31.40.0-255,66,16408,65,170536
26818,0.000117,172.217.194.0-255,6797,23205,65,170536
26819,0.000119,172.31.40.0-255,66,23271,65,170536
26820,0.000142,172.217.194.0-255,1484,24755,65,170536
26821,0.000144,172.31.40.0-255,66,24821,65,170536
26822,0.000149,172.217.194.0-255,2902,27723,65,170536
26823,0.000151,172.31.40.0-255,66,27789,65,170536
26824,0.000162,172.217.194.0-255,5738,33527,65,170536
26825,0.000164,172.31.40.0-255,66,33593,65,170536
26826,0.000224,172.31.40.0-255,66,33659,65,170536
26827,0.000241,172.31.40.0-255,66,33725,65,170536
26828,0.000243,172.217.194.0-255,1376,35101,65,170536
26829,0.000245,172.31.40.0-255,66,35167,65,170536
26830,0.000248,172.217.194.0-255,123,35290,65,170536
26831,0.00025,172.31.40.0-255,66,35356,65,170536
26832,0.000296,172.217.194.0-255,378,35734,65,170536
26833,0.000298,172.31.40.0-255,66,35800,65,170536
26834,0.000625,172.217.194.0-255,1484,37284,65,170536
26835,0.000631,172.31.40.0-255,66,37350,65,170536
26836,0.000638,172.217.194.0-255,2902,40252,65,170536
26837,0.000641,172.31.40.0-255,66,40318,65,170536
26838,0.000652,172.217.194.0-255,5738,46056,65,170536
26839,0.000654,172.31.40.0-255,66,46122,65,170536
26840,0.000671,172.31.40.0-255,66,46188,65,170536
26841,0.0007,172.217.194.0-255,7156,53344,65,170536
26842,0.000702,172.31.40.0-255,66,53410,65,170536
26843,0.00073,172.217.194.0-255,3602,57012,65,170536
26844,0.000732,172.31.40.0-255,66,57078,65,170536
26845,0.001044,172.217.194.0-255,1484,58562,65,170536
26846,0.00105,172.217.194.0-255,2902,61464,65,170536
26847,0.001053,172.31.40.0-255,66,61530,65,170536
26848,0.001084,172.217.194.0-255,5738,67268,65,170536
26849,0.001086,172.31.40.0-255,66,67334,65,170536
26850,0.001092,172.217.194.0-255,5738,73072,65,170536
26851,0.001094,172.31.40.0-255,66,73138,65,170536
26852,0.001126,172.217.194.0-255,7156,80294,65,170536
26853,0.001129,172.31.40.0-255,66,80360,65,170536
26854,0.001145,172.31.40.0-255,66,80426,65,170536
26855,0.00159,172.217.194.0-255,1484,81910,65,170536
26856,0.001596,172.217.194.0-255,2902,84812,65,170536
26857,0.001598,172.31.40.0-255,66,84878,65,170536
26858,0.001605,172.217.194.0-255,5738,90616,65,170536
26859,0.001607,172.31.40.0-255,66,90682,65,170536
26860,0.001625,172.217.194.0-255,4320,95002,65,170536
26861,0.001627,172.31.40.0-255,66,95068,65,170536
26862,0.001661,172.31.40.0-255,66,95134,65,170536
26863,0.001671,172.31.40.0-255,66,95200,65,170536
26864,0.001691,172.217.194.0-255,2184,97384,65,170536
26865,0.001693,172.31.40.0-255,66,97450,65,170536
26866,0.00172,172.217.194.0-255,1484,98934,65,170536
26867,0.001733,172.217.194.0-255,2902,101836,65,170536
26868,0.001736,172.31.40.0-255,66,101902,65,170536
26869,0.00174,172.217.194.0-255,2902,104804,65,170536
26870,0.001742,172.31.40.0-255,66,104870,65,170536
26871,0.001762,172.217.194.0-255,2902,107772,65,170536
26872,0.001765,172.31.40.0-255,66,107838,65,170536
26873,0.001781,172.31.40.0-255,66,107904,65,170536
26874,0.001783,172.217.194.0-255,1484,109388,65,170536
26875,0.001824,172.217.194.0-255,1484,110872,65,170536
26876,0.001826,172.31.40.0-255,66,110938,65,170536
26877,0.001862,172.31.40.0-255,66,111004,65,170536
26878,0.001925,172.217.194.0-255,1484,112488,65,170536
26879,0.001941,172.217.194.0-255,2902,115390,65,170536
26880,0.001944,172.31.40.0-255,66,115456,65,170536
26881,0.00195,172.217.194.0-255,5738,121194,65,170536
26882,0.001952,172.31.40.0-255,66,121260,65,170536
26883,0.001979,172.217.194.0-255,7156,128416,65,170536
26884,0.001981,172.31.40.0-255,66,128482,65,170536
26885,0.002015,172.31.40.0-255,66,128548,65,170536
26886,0.002019,172.217.194.0-255,2184,130732,65,170536
26887,0.00202,172.31.40.0-255,66,130798,65,170536
26888,0.002086,172.217.194.0-255,1484,132282,65,170536
26889,0.002092,172.217.194.0-255,2902,135184,65,170536
26890,0.002095,172.31.40.0-255,66,135250,65,170536
26891,0.002098,172.217.194.0-255,1484,136734,65,170536
26892,0.002125,172.217.194.0-255,4320,141054,65,170536
26893,0.002128,172.31.40.0-255,66,141120,65,170536
26894,0.002145,172.31.40.0-255,66,141186,65,170536
26895,0.00219,172.31.40.0-255,66,141252,65,170536
26896,0.002203,172.31.40.0-255,66,141318,65,170536
26897,0.002252,172.31.40.0-255,66,141384,65,170536
26898,0.002295,172.31.40.0-255,66,141450,65,170536
26899,0.004518,172.217.194.0-255,5738,147188,65,170536
26900,0.004534,172.31.40.0-255,66,147254,65,170536
26901,0.006749,172.217.194.0-255,5738,152992,65,170536
26902,0.013297,172.31.40.0-255,66,153058,65,170536
26903,0.01441,172.217.194.0-255,1484,154542,65,170536
26904,0.015508,172.217.194.0-255,4320,158862,65,170536
26905,0.015515,172.31.40.0-255,66,158928,65,170536
26906,0.017747,172.217.194.0-255,5738,164666,65,170536
26907,0.017754,172.31.40.0-255,66,164732,65,170536
26908,0.01998,172.217.194.0-255,5738,170470,65,170536
26909,0.019993,172.31.40.0-255,66,170536,65,170536
26910,0.0,74.125.68.0-255,152,152,65,161177
26911,1.4e-05,172.31.40.0-255,66,218,65,161177
26912,2e-05,74.125.68.0-255,1484,1702,65,161177
26913,2.4e-05,172.31.40.0-255,66,1768,65,161177
26914,4.6e-05,74.125.68.0-255,1484,3252,65,161177
26915,5.3e-05,172.31.40.0-255,66,3318,65,161177
26916,5.8e-05,74.125.68.0-255,2902,6220,65,161177
26917,6e-05,172.31.40.0-255,66,6286,65,161177
26918,9.3e-05,74.125.68.0-255,4320,10606,65,161177
26919,9.5e-05,172.31.40.0-255,66,10672,65,161177
26920,0.000125,74.125.68.0-255,3447,14119,65,161177
26921,0.000127,172.31.40.0-255,66,14185,65,161177
26922,0.000597,74.125.68.0-255,1484,15669,65,161177
26923,0.000602,172.31.40.0-255,66,15735,65,161177
26924,0.000611,74.125.68.0-255,2902,18637,65,161177
26925,0.000613,172.31.40.0-255,66,18703,65,161177
26926,0.000617,74.125.68.0-255,1484,20187,65,161177
26927,0.000618,172.31.40.0-255,66,20253,65,161177
26928,0.000645,74.125.68.0-255,4320,24573,65,161177
26929,0.000647,172.31.40.0-255,66,24639,65,161177
26930,0.00065,74.125.68.0-255,1484,26123,65,161177
26931,0.000652,172.31.40.0-255,66,26189,65,161177
26932,0.000655,74.125.68.0-255,2902,29091,65,161177
26933,0.000658,172.31.40.0-255,66,29157,65,161177
26934,0.00068,74.125.68.0-255,2902,32059,65,161177
26935,0.000683,172.31.40.0-255,66,32125,65,161177
26936,0.000701,74.125.68.0-255,1125,33250,65,161177
26937,0.000704,172.31.40.0-255,66,33316,65,161177
26938,0.000727,74.125.68.0-255,4320,37636,65,161177
26939,0.000731,172.31.40.0-255,66,37702,65,161177
26940,0.000733,74.125.68.0-255,1484,39186,65,161177
26941,0.000735,172.31.40.0-255,66,39252,65,161177
26942,0.00077,74.125.68.0-255,5738,44990,65,161177
26943,0.000782,74.125.68.0-255,1484,46474,65,161177
26944,0.000785,74.125.68.0-255,1484,47958,65,161177
26945,0.000808,74.125.68.0-255,7156,55114,65,161177
26946,0.000811,74.125.68.0-255,1484,56598,65,161177
26947,0.000832,74.125.68.0-255,766,57364,65,161177
26948,0.000865,74.125.68.0-255,395,57759,65,161177
26949,0.001293,74.125.68.0-255,118,57877,65,161177
26950,0.001481,74.125.68.0-255,1484,59361,65,161177
26951,0.001498,74.125.68.0-255,2902,62263,65,161177
26952,0.0015,74.125.68.0-255,1484,63747,65,161177
26953,0.001518,74.125.68.0-255,2902,66649,65,161177
26954,0.001535,74.125.68.0-255,5738,72387,65,161177
26955,0.001546,74.125.68.0-255,2902,75289,65,161177
26956,0.001548,74.125.68.0-255,1484,76773,65,161177
26957,0.001569,74.125.68.0-255,5738,82511,65,161177
26958,0.001584,74.125.68.0-255,4320,86831,65,161177
26959,0.001602,74.125.68.0-255,4320,91151,65,161177
26960,0.001604,74.125.68.0-255,766,91917,65,161177
26961,0.00179,172.31.40.0-255,66,91983,65,161177
26962,0.00209,74.125.68.0-255,1484,93467,65,161177
26963,0.002109,74.125.68.0-255,1484,94951,65,161177
26964,0.002124,172.31.40.0-255,66,95017,65,161177
26965,0.00213,74.125.68.0-255,2902,97919,65,161177
26966,0.002136,172.31.40.0-255,66,97985,65,161177
26967,0.00216,74.125.68.0-255,5738,103723,65,161177
26968,0.002164,74.125.68.0-255,2902,106625,65,161177
26969,0.002169,74.125.68.0-255,4320,110945,65,161177
26970,0.002198,74.125.68.0-255,4320,115265,65,161177
26971,0.002206,172.31.40.0-255,66,115331,65,161177
26972,0.002216,74.125.68.0-255,4320,119651,65,161177
26973,0.002257,74.125.68.0-255,2902,122553,65,161177
26974,0.002265,172.31.40.0-255,66,122619,65,161177
26975,0.002284,74.125.68.0-255,3602,126221,65,161177
26976,0.002296,172.31.40.0-255,66,126287,65,161177
26977,0.004858,74.125.68.0-255,1484,127771,65,161177
26978,0.004883,74.125.68.0-255,4320,132091,65,161177
26979,0.004888,172.31.40.0-255,66,132157,65,161177
26980,0.007485,74.125.68.0-255,5738,137895,65,161177
26981,0.007494,172.31.40.0-255,66,137961,65,161177
26982,0.010085,74.125.68.0-255,5738,143699,65,161177
26983,0.010094,172.31.40.0-255,66,143765,65,161177
26984,0.012694,74.125.68.0-255,5738,149503,65,161177
26985,0.012704,172.31.40.0-255,66,149569,65,161177
26986,0.015292,74.125.68.0-255,5738,155307,65,161177
26987,0.0153,172.31.40.0-255,66,155373,65,161177
26988,0.017892,74.125.68.0-255,5738,161111,65,161177
26989,0.017901,172.31.40.0-255,66,161177,65,161177
26990,0.0,172.217.194.0-255,157,157,65,230312
26991,3.4e-05,172.31.40.0-255,66,223,65,230312
26992,4.1e-05,172.217.194.0-255,1484,1707,65,230312
26993,4.6e-05,172.31.40.0-255,66,1773,65,230312
26994,5.2e-05,172.217.194.0-255,2902,4675,65,230312
26995,5.5e-05,172.31.40.0-255,66,4741,65,230312
26996,6.5e-05,172.217.194.0-255,1484,6225,65,230312
26997,6.9e-05,172.31.40.0-255,66,6291,65,230312
26998,7.4e-05,172.217.194.0-255,2902,9193,65,230312
26999,7.6e-05,172.31.40.0-255,66,9259,65,230312
27000,0.000111,172.217.194.0-255,4866,14125,65,230312
27001,0.000114,172.31.40.0-255,66,14191,65,230312
27002,0.00021,172.217.194.0-255,1484,15675,65,230312
27003,0.000214,172.31.40.0-255,66,15741,65,230312
27004,0.000221,172.217.194.0-255,2902,18643,65,230312
27005,0.000223,172.31.40.0-255,66,18709,65,230312
27006,0.000256,172.217.194.0-255,5738,24447,65,230312
27007,0.000259,172.31.40.0-255,66,24513,65,230312
27008,0.000264,172.217.194.0-255,4320,28833,65,230312
27009,0.000266,172.31.40.0-255,66,28899,65,230312
27010,0.000317,172.217.194.0-255,4320,33219,65,230312
27011,0.000321,172.31.40.0-255,66,33285,65,230312
27012,0.000358,172.217.194.0-255,6797,40082,65,230312
27013,0.000363,172.31.40.0-255,66,40148,65,230312
27014,0.000376,172.31.40.0-255,66,40214,65,230312
27015,0.000379,172.217.194.0-255,1484,41698,65,230312
27016,0.000381,172.31.40.0-255,66,41764,65,230312
27017,0.000413,172.217.194.0-255,5738,47502,65,230312
27018,0.000417,172.31.40.0-255,66,47568,65,230312
27019,0.000451,172.217.194.0-255,6438,54006,65,230312
27020,0.000455,172.31.40.0-255,66,54072,65,230312
27021,0.000465,172.217.194.0-255,379,54451,65,230312
27022,0.000506,172.217.194.0-255,365,54816,65,230312
27023,0.00066,172.217.194.0-255,1484,56300,65,230312
27024,0.000664,172.31.40.0-255,66,56366,65,230312
27025,0.000692,172.217.194.0-255,2902,59268,65,230312
27026,0.000695,172.31.40.0-255,66,59334,65,230312
27027,0.000701,172.217.194.0-255,5738,65072,65,230312
27028,0.000703,172.31.40.0-255,66,65138,65,230312
27029,0.000706,172.217.194.0-255,1484,66622,65,230312
27030,0.000732,172.217.194.0-255,5738,72360,65,230312
27031,0.000735,172.31.40.0-255,66,72426,65,230312
27032,0.000738,172.217.194.0-255,1484,73910,65,230312
27033,0.000779,172.31.40.0-255,66,73976,65,230312
27034,0.000784,172.217.194.0-255,2184,76160,65,230312
27035,0.000786,172.31.40.0-255,66,76226,65,230312
27036,0.001143,172.217.194.0-255,1484,77710,65,230312
27037,0.001149,172.217.194.0-255,2902,80612,65,230312
27038,0.001152,172.31.40.0-255,66,80678,65,230312
27039,0.001156,172.217.194.0-255,1484,82162,65,230312
27040,0.001208,172.217.194.0-255,5738,87900,65,230312
27041,0.001211,172.31.40.0-255,66,87966,65,230312
27042,0.001218,172.217.194.0-255,5738,93704,65,230312
27043,0.00122,172.31.40.0-255,66,93770,65,230312
27044,0.001246,172.217.194.0-255,7156,100926,65,230312
27045,0.00125,172.31.40.0-255,66,100992,65,230312
27046,0.001294,172.31.40.0-255,66,101058,65,230312
27047,0.001373,172.217.194.0-255,1484,102542,65,230312
27048,0.001377,172.217.194.0-255,2902,105444,65,230312
27049,0.00138,172.31.40.0-255,66,105510,65,230312
27050,0.001416,172.217.194.0-255,5738,111248,65,230312
27051,0.001419,172.31.40.0-255,66,111314,65,230312
27052,0.001428,172.217.194.0-255,7156,118470,65,230312
27053,0.00143,172.31.40.0-255,66,118536,65,230312
27054,0.00145,172.217.194.0-255,1484,120020,65,230312
27055,0.001468,172.31.40.0-255,66,120086,65,230312
27056,0.001474,172.217.194.0-255,5020,125106,65,230312
27057,0.001476,172.31.40.0-255,66,125172,65,230312
27058,0.001537,172.217.194.0-255,1484,126656,65,230312
27059,0.001541,172.217.194.0-255,1484,128140,65,230312
27060,0.001544,172.31.40.0-255,66,128206,65,230312
27061,0.001564,172.217.194.0-255,1484,129690,65,230312
27062,0.001587,172.217.194.0-255,5738,135428,65,230312
27063,0.00159,172.31.40.0-255,66,135494,65,230312
27064,0.001597,172.217.194.0-255,5738,141232,65,230312
27065,0.001599,172.31.40.0-255,66,141298,65,230312
27066,0.001633,172.217.194.0-255,4320,145618,65,230312
27067,0.001638,172.31.40.0-255,66,145684,65,230312
27068,0.001651,172.31.40.0-255,66,145750,65,230312
27069,0.001973,172.217.194.0-255,1484,147234,65,230312
27070,0.001978,172.217.194.0-255,2902,150136,65,230312
27071,0.001982,172.31.40.0-255,66,150202,65,230312
27072,0.001989,172.217.194.0-255,5738,155940,65,230312
27073,0.001991,172.31.40.0-255,66,156006,65,230312
27074,0.002029,172.31.40.0-255,66,156072,65,230312
27075,0.002041,172.31.40.0-255,66,156138,65,230312
27076,0.002095,172.217.194.0-255,1484,157622,65,230312
27077,0.002101,172.217.194.0-255,2902,160524,65,230312
27078,0.002103,172.31.40.0-255,66,160590,65,230312
27079,0.002109,172.217.194.0-255,4320,164910,65,230312
27080,0.002111,172.31.40.0-255,66,164976,65,230312
27081,0.002132,172.217.194.0-255,1484,166460,65,230312
27082,0.002154,172.31.40.0-255,66,166526,65,230312
27083,0.002198,172.31.40.0-255,66,166592,65,230312
27084,0.002256,172.217.194.0-255,1484,168076,65,230312
27085,0.002261,172.217.194.0-255,2902,170978,65,230312
27086,0.002266,172.31.40.0-255,66,171044,65,230312
27087,0.002291,172.217.194.0-255,5738,176782,65,230312
27088,0.002295,172.31.40.0-255,66,176848,65,230312
27089,0.002366,172.31.40.0-255,66,176914,65,230312
27090,0.002393,172.217.194.0-255,1484,178398,65,230312
27091,0.002401,172.217.194.0-255,7156,185554,65,230312
27092,0.002404,172.31.40.0-255,66,185620,65,230312
27093,0.002409,172.217.194.0-255,3602,189222,65,230312
27094,0.002411,172.31.40.0-255,66,189288,65,230312
27095,0.004773,172.217.194.0-255,1484,190772,65,230312
27096,0.004809,172.217.194.0-255,4320,195092,65,230312
27097,0.00482,172.31.40.0-255,66,195158,65,230312
27098,0.007197,172.217.194.0-255,2902,198060,65,230312
27099,0.007212,172.31.40.0-255,66,198126,65,230312
27100,0.007242,172.217.194.0-255,2902,201028,65,230312
27101,0.007245,172.31.40.0-255,66,201094,65,230312
27102,0.009593,172.217.194.0-255,2902,203996,65,230312
27103,0.009596,172.31.40.0-255,66,204062,65,230312
27104,0.00963,172.217.194.0-255,2902,206964,65,230312
27105,0.009632,172.31.40.0-255,66,207030,65,230312
27106,0.011987,172.217.194.0-255,1484,208514,65,230312
27107,0.01201,172.217.194.0-255,4320,212834,65,230312
27108,0.012014,172.31.40.0-255,66,212900,65,230312
27109,0.014367,172.217.194.0-255,5738,218638,65,230312
27110,0.01438,172.31.40.0-255,66,218704,65,230312
27111,0.016748,172.217.194.0-255,5738,224442,65,230312
27112,0.016764,172.31.40.0-255,66,224508,65,230312
27113,0.019148,172.217.194.0-255,5738,230246,65,230312
27114,0.019158,172.31.40.0-255,66,230312,65,230312
27115,0.0,74.125.68.0-255,150,150,65,328890
27116,2.3e-05,172.31.40.0-255,66,216,65,328890
27117,3.1e-05,74.125.68.0-255,1484,1700,65,328890
27118,3.5e-05,172.31.40.0-255,66,1766,65,328890
27119,5.4e-05,74.125.68.0-255,2902,4668,65,328890
27120,5.8e-05,172.31.40.0-255,66,4734,65,328890
27121,7.8e-05,74.125.68.0-255,1484,6218,65,328890
27122,8.1e-05,172.31.40.0-255,66,6284,65,328890
27123,0.000103,74.125.68.0-255,2902,9186,65,328890
27124,0.000106,172.31.40.0-255,66,9252,65,328890
27125,0.000112,74.125.68.0-255,4874,14126,65,328890
27126,0.000115,172.31.40.0-255,66,14192,65,328890
27127,0.000118,74.125.68.0-255,1484,15676,65,328890
27128,0.00012,172.31.40.0-255,66,15742,65,328890
27129,0.000123,74.125.68.0-255,1484,17226,65,328890
27130,0.000125,172.31.40.0-255,66,17292,65,328890
27131,0.000148,74.125.68.0-255,1484,18776,65,328890
27132,0.00015,172.31.40.0-255,66,18842,65,328890
27133,0.000157,74.125.68.0-255,4320,23162,65,328890
27134,0.00016,172.31.40.0-255,66,23228,65,328890
27135,0.000172,74.125.68.0-255,1484,24712,65,328890
27136,0.000174,172.31.40.0-255,66,24778,65,328890
27137,0.00019,74.125.68.0-255,4320,29098,65,328890
27138,0.000193,172.31.40.0-255,66,29164,65,328890
27139,0.000209,74.125.68.0-255,5738,34902,65,328890
27140,0.000212,172.31.40.0-255,66,34968,65,328890
27141,0.000237,74.125.68.0-255,7156,42124,65,328890
27142,0.00024,172.31.40.0-255,66,42190,65,328890
27143,0.000243,74.125.68.0-255,1484,43674,65,328890
27144,0.000245,172.31.40.0-255,66,43740,65,328890
27145,0.000259,74.125.68.0-255,2902,46642,65,328890
27146,0.000261,172.31.40.0-255,66,46708,65,328890
27147,0.000306,74.125.68.0-255,2184,48892,65,328890
27148,0.00031,172.31.40.0-255,66,48958,65,328890
27149,0.000422,74.125.68.0-255,1484,50442,65,328890
27150,0.000428,74.125.68.0-255,2902,53344,65,328890
27151,0.000432,172.31.40.0-255,66,53410,65,328890
27152,0.000455,74.125.68.0-255,5738,59148,65,328890
27153,0.000458,172.31.40.0-255,66,59214,65,328890
27154,0.000463,74.125.68.0-255,2902,62116,65,328890
27155,0.000465,172.31.40.0-255,66,62182,65,328890
27156,0.000486,74.125.68.0-255,1484,63666,65,328890
27157,0.000504,74.125.68.0-255,2543,66209,65,328890
27158,0.000507,172.31.40.0-255,66,66275,65,328890
27159,0.000509,74.125.68.0-255,394,66669,65,328890
27160,0.000731,74.125.68.0-255,1484,68153,65,328890
27161,0.000736,172.31.40.0-255,66,68219,65,328890
27162,0.000742,74.125.68.0-255,2902,71121,65,328890
27163,0.000745,172.31.40.0-255,66,71187,65,328890
27164,0.000765,74.125.68.0-255,5738,76925,65,328890
27165,0.000768,172.31.40.0-255,66,76991,65,328890
27166,0.000793,74.125.68.0-255,7156,84147,65,328890
27167,0.000803,172.31.40.0-255,66,84213,65,328890
27168,0.000827,172.31.40.0-255,66,84279,65,328890
27169,0.000843,74.125.68.0-255,2902,87181,65,328890
27170,0.000847,172.31.40.0-255,66,87247,65,328890
27171,0.000897,74.125.68.0-255,4320,91567,65,328890
27172,0.0009,172.31.40.0-255,66,91633,65,328890
27173,0.000912,74.125.68.0-255,766,92399,65,328890
27174,0.001012,74.125.68.0-255,1484,93883,65,328890
27175,0.001016,172.31.40.0-255,66,93949,65,328890
27176,0.00102,74.125.68.0-255,1484,95433,65,328890
27177,0.001037,74.125.68.0-255,1484,96917,65,328890
27178,0.001039,172.31.40.0-255,66,96983,65,328890
27179,0.001045,74.125.68.0-255,4320,101303,65,328890
27180,0.001047,172.31.40.0-255,66,101369,65,328890
27181,0.001052,74.125.68.0-255,2902,104271,65,328890
27182,0.001053,172.31.40.0-255,66,104337,65,328890
27183,0.001078,74.125.68.0-255,5738,110075,65,328890
27184,0.001081,172.31.40.0-255,66,110141,65,328890
27185,0.001086,74.125.68.0-255,4320,114461,65,328890
27186,0.001088,172.31.40.0-255,66,114527,65,328890
27187,0.001131,74.125.68.0-255,5738,120265,65,328890
27188,0.001135,172.31.40.0-255,66,120331,65,328890
27189,0.001157,172.31.40.0-255,66,120397,65,328890
27190,0.001168,74.125.68.0-255,1484,121881,65,328890
27191,0.0012,172.31.40.0-255,66,121947,65,328890
27192,0.001233,172.31.40.0-255,66,122013,65,328890
27193,0.001239,74.125.68.0-255,5020,127033,65,328890
27194,0.001242,172.31.40.0-255,66,127099,65,328890
27195,0.001661,74.125.68.0-255,1484,128583,65,328890
27196,0.001667,74.125.68.0-255,2902,131485,65,328890
27197,0.00167,172.31.40.0-255,66,131551,65,328890
27198,0.001695,74.125.68.0-255,4320,135871,65,328890
27199,0.001697,172.31.40.0-255,66,135937,65,328890
27200,0.001741,172.31.40.0-255,66,136003,65,328890
27201,0.001749,74.125.68.0-255,7156,143159,65,328890
27202,0.001751,172.31.40.0-255,66,143225,65,328890
27203,0.001771,74.125.68.0-255,4320,147545,65,328890
27204,0.001773,172.31.40.0-255,66,147611,65,328890
27205,0.001796,74.125.68.0-255,4320,151931,65,328890
27206,0.001799,172.31.40.0-255,66,151997,65,328890
27207,0.001802,74.125.68.0-255,766,152763,65,328890
27208,0.001913,74.125.68.0-255,1484,154247,65,328890
27209,0.001917,172.31.40.0-255,66,154313,65,328890
27210,0.001921,74.125.68.0-255,1484,155797,65,328890
27211,0.001936,74.125.68.0-255,1484,157281,65,328890
27212,0.001939,172.31.40.0-255,66,157347,65,328890
27213,0.001963,74.125.68.0-255,4320,161667,65,328890
27214,0.001966,172.31.40.0-255,66,161733,65,328890
27215,0.001972,74.125.68.0-255,5738,167471,65,328890
27216,0.001974,172.31.40.0-255,66,167537,65,328890
27217,0.001991,74.125.68.0-255,2902,170439,65,328890
27218,0.001994,172.31.40.0-255,66,170505,65,328890
27219,0.002,74.125.68.0-255,5738,176243,65,328890
27220,0.002002,172.31.40.0-255,66,176309,65,328890
27221,0.002024,74.125.68.0-255,1484,177793,65,328890
27222,0.002047,74.125.68.0-255,5738,183531,65,328890
27223,0.00205,172.31.40.0-255,66,183597,65,328890
27224,0.002082,74.125.68.0-255,4320,187917,65,328890
27225,0.002085,172.31.40.0-255,66,187983,65,328890
27226,0.002098,74.125.68.0-255,766,188749,65,328890
27227,0.002105,74.125.68.0-255,5738,194487,65,328890
27228,0.002107,172.31.40.0-255,66,194553,65,328890
27229,0.00215,74.125.68.0-255,2902,197455,65,328890
27230,0.002153,172.31.40.0-255,66,197521,65,328890
27231,0.002181,74.125.68.0-255,5738,203259,65,328890
27232,0.002184,172.31.40.0-255,66,203325,65,328890
27233,0.002196,172.31.40.0-255,66,203391,65,328890
27234,0.002202,74.125.68.0-255,5738,209129,65,328890
27235,0.002205,172.31.40.0-255,66,209195,65,328890
27236,0.002231,74.125.68.0-255,5738,214933,65,328890
27237,0.002234,172.31.40.0-255,66,214999,65,328890
27238,0.002251,74.125.68.0-255,766,215765,65,328890
27239,0.002268,74.125.68.0-255,4320,220085,65,328890
27240,0.002271,172.31.40.0-255,66,220151,65,328890
27241,0.002293,74.125.68.0-255,2902,223053,65,328890
27242,0.002295,172.31.40.0-255,66,223119,65,328890
27243,0.002357,172.31.40.0-255,66,223185,65,328890
27244,0.002364,74.125.68.0-255,7156,230341,65,328890
27245,0.002367,172.31.40.0-255,66,230407,65,328890
27246,0.00237,74.125.68.0-255,1484,231891,65,328890
27247,0.002375,74.125.68.0-255,2184,234075,65,328890
27248,0.002377,172.31.40.0-255,66,234141,65,328890
27249,0.002399,74.125.68.0-255,1484,235625,65,328890
27250,0.002426,74.125.68.0-255,2902,238527,65,328890
27251,0.00243,172.31.40.0-255,66,238593,65,328890
27252,0.002433,74.125.68.0-255,1484,240077,65,328890
27253,0.002447,74.125.68.0-255,1484,241561,65,328890
27254,0.00245,172.31.40.0-255,66,241627,65,328890
27255,0.002468,74.125.68.0-255,2902,244529,65,328890
27256,0.002472,172.31.40.0-255,66,244595,65,328890
27257,0.002493,74.125.68.0-255,2902,247497,65,328890
27258,0.002496,172.31.40.0-255,66,247563,65,328890
27259,0.002501,74.125.68.0-255,4320,251883,65,328890
27260,0.002504,172.31.40.0-255,66,251949,65,328890
27261,0.002528,74.125.68.0-255,1484,253433,65,328890
27262,0.002547,74.125.68.0-255,1484,254917,65,328890
27263,0.00255,172.31.40.0-255,66,254983,65,328890
27264,0.002554,74.125.68.0-255,1484,256467,65,328890
27265,0.002557,74.125.68.0-255,1484,257951,65,328890
27266,0.002559,172.31.40.0-255,66,258017,65,328890
27267,0.002587,74.125.68.0-255,2902,260919,65,328890
27268,0.00259,172.31.40.0-255,66,260985,65,328890
27269,0.002594,74.125.68.0-255,2902,263887,65,328890
27270,0.002596,172.31.40.0-255,66,263953,65,328890
27271,0.00261,74.125.68.0-255,4320,268273,65,328890
27272,0.002612,172.31.40.0-255,66,268339,65,328890
27273,0.002628,74.125.68.0-255,766,269105,65,328890
27274,0.002636,74.125.68.0-255,7156,276261,65,328890
27275,0.002639,172.31.40.0-255,66,276327,65,328890
27276,0.002667,74.125.68.0-255,5738,282065,65,328890
27277,0.00267,172.31.40.0-255,66,282131,65,328890
27278,0.002693,74.125.68.0-255,5738,287869,65,328890
27279,0.002696,172.31.40.0-255,66,287935,65,328890
27280,0.002715,74.125.68.0-255,1484,289419,65,328890
27281,0.00272,74.125.68.0-255,2902,292321,65,328890
27282,0.002723,172.31.40.0-255,66,292387,65,328890
27283,0.002725,74.125.68.0-255,1484,293871,65,328890
27284,0.002728,172.31.40.0-255,78,293949,65,328890
27285,0.002735,74.125.68.0-255,7156,301105,65,328890
27286,0.002738,172.31.40.0-255,66,301171,65,328890
27287,0.00274,74.125.68.0-255,1484,302655,65,328890
27288,0.002743,74.125.68.0-255,766,303421,65,328890
27289,0.002745,172.31.40.0-255,66,303487,65,328890
27290,0.002767,74.125.68.0-255,2902,306389,65,328890
27291,0.00277,172.31.40.0-255,66,306455,65,328890
27292,0.002786,74.125.68.0-255,4320,310775,65,328890
27293,0.002789,172.31.40.0-255,66,310841,65,328890
27294,0.002812,74.125.68.0-255,4320,315161,65,328890
27295,0.002815,172.31.40.0-255,66,315227,65,328890
27296,0.002818,74.125.68.0-255,1484,316711,65,328890
27297,0.002842,74.125.68.0-255,4320,321031,65,328890
27298,0.002845,172.31.40.0-255,66,321097,65,328890
27299,0.002848,74.125.68.0-255,1484,322581,65,328890
27300,0.00287,74.125.68.0-255,5738,328319,65,328890
27301,0.002873,172.31.40.0-255,66,328385,65,328890
27302,0.002884,172.31.40.0-255,66,328451,65,328890
27303,0.002887,74.125.68.0-255,97,328548,65,328890
27304,0.002956,74.125.68.0-255,105,328653,65,328890
27305,0.009088,172.31.40.0-255,66,328719,65,328890
27306,0.009126,172.31.40.0-255,105,328824,65,328890
27307,0.01136,74.125.68.0-255,66,328890,65,328890
27308,0.0,172.217.194.0-255,153,153,65,169114
27309,2.4e-05,172.31.40.0-255,66,219,65,169114
27310,3.1e-05,172.217.194.0-255,1484,1703,65,169114
27311,3.7e-05,172.31.40.0-255,66,1769,65,169114
27312,5.2e-05,172.217.194.0-255,2902,4671,65,169114
27313,5.6e-05,172.31.40.0-255,66,4737,65,169114
27314,6.4e-05,172.217.194.0-255,7156,11893,65,169114
27315,6.7e-05,172.31.40.0-255,66,11959,65,169114
27316,7.3e-05,172.217.194.0-255,4935,16894,65,169114
27317,7.7e-05,172.31.40.0-255,66,16960,65,169114
27318,8.3e-05,172.217.194.0-255,5738,22698,65,169114
27319,8.7e-05,172.31.40.0-255,66,22764,65,169114
27320,0.000149,172.31.40.0-255,66,22830,65,169114
27321,0.00021,172.217.194.0-255,1484,24314,65,169114
27322,0.000212,172.31.40.0-255,66,24380,65,169114
27323,0.000218,172.217.194.0-255,2902,27282,65,169114
27324,0.00022,172.31.40.0-255,66,27348,65,169114
27325,0.000258,172.217.194.0-255,5738,33086,65,169114
27326,0.000261,172.31.40.0-255,66,33152,65,169114
27327,0.000265,172.217.194.0-255,2902,36054,65,169114
27328,0.000267,172.31.40.0-255,66,36120,65,169114
27329,0.000308,172.31.40.0-255,66,36186,65,169114
27330,0.00032,172.217.194.0-255,2902,39088,65,169114
27331,0.000326,172.31.40.0-255,66,39154,65,169114
27332,0.000363,172.31.40.0-255,66,39220,65,169114
27333,0.000679,172.217.194.0-255,646,39866,65,169114
27334,0.000685,172.31.40.0-255,66,39932,65,169114
27335,0.000783,172.217.194.0-255,1484,41416,65,169114
27336,0.000788,172.31.40.0-255,66,41482,65,169114
27337,0.000794,172.217.194.0-255,2902,44384,65,169114
27338,0.000797,172.31.40.0-255,66,44450,65,169114
27339,0.000818,172.217.194.0-255,5738,50188,65,169114
27340,0.00082,172.31.40.0-255,66,50254,65,169114
27341,0.000825,172.217.194.0-255,2902,53156,65,169114
27342,0.000827,172.31.40.0-255,66,53222,65,169114
27343,0.000861,172.217.194.0-255,7156,60378,65,169114
27344,0.000868,172.31.40.0-255,66,60444,65,169114
27345,0.000898,172.217.194.0-255,7156,67600,65,169114
27346,0.000903,172.31.40.0-255,66,67666,65,169114
27347,0.000916,172.217.194.0-255,6438,74104,65,169114
27348,0.000918,172.217.194.0-255,1484,75588,65,169114
27349,0.00093,172.31.40.0-255,66,75654,65,169114
27350,0.000972,172.31.40.0-255,66,75720,65,169114
27351,0.000984,172.31.40.0-255,66,75786,65,169114
27352,0.000989,172.217.194.0-255,2902,78688,65,169114
27353,0.000991,172.31.40.0-255,66,78754,65,169114
27354,0.001047,172.31.40.0-255,66,78820,65,169114
27355,0.001052,172.217.194.0-255,2902,81722,65,169114
27356,0.001054,172.31.40.0-255,66,81788,65,169114
27357,0.001104,172.31.40.0-255,66,81854,65,169114
27358,0.001115,172.217.194.0-255,2902,84756,65,169114
27359,0.001117,172.31.40.0-255,66,84822,65,169114
27360,0.00116,172.217.194.0-255,7156,91978,65,169114
27361,0.001163,172.31.40.0-255,66,92044,65,169114
27362,0.001176,172.31.40.0-255,66,92110,65,169114
27363,0.001192,172.31.40.0-255,66,92176,65,169114
27364,0.001223,172.217.194.0-255,3602,95778,65,169114
27365,0.001226,172.217.194.0-255,1484,97262,65,169114
27366,0.001231,172.217.194.0-255,2902,100164,65,169114
27367,0.001277,172.217.194.0-255,1484,101648,65,169114
27368,0.001295,172.217.194.0-255,4320,105968,65,169114
27369,0.001312,172.217.194.0-255,2902,108870,65,169114
27370,0.001316,172.31.40.0-255,66,108936,65,169114
27371,0.001357,172.217.194.0-255,1484,110420,65,169114
27372,0.00136,172.31.40.0-255,66,110486,65,169114
27373,0.001387,172.217.194.0-255,2902,113388,65,169114
27374,0.001394,172.217.194.0-255,5738,119126,65,169114
27375,0.001397,172.217.194.0-255,1484,120610,65,169114
27376,0.00141,172.217.194.0-255,2902,123512,65,169114
27377,0.00143,172.217.194.0-255,2902,126414,65,169114
27378,0.001452,172.217.194.0-255,2184,128598,65,169114
27379,0.001457,172.31.40.0-255,66,128664,65,169114
27380,0.001475,172.31.40.0-255,66,128730,65,169114
27381,0.001759,172.217.194.0-255,1484,130214,65,169114
27382,0.001778,172.217.194.0-255,2902,133116,65,169114
27383,0.001788,172.31.40.0-255,66,133182,65,169114
27384,0.001798,172.217.194.0-255,1484,134666,65,169114
27385,0.001821,172.217.194.0-255,4320,138986,65,169114
27386,0.001846,172.217.194.0-255,1484,140470,65,169114
27387,0.001858,172.31.40.0-255,66,140536,65,169114
27388,0.001866,172.217.194.0-255,1484,142020,65,169114
27389,0.001895,172.31.40.0-255,66,142086,65,169114
27390,0.001901,172.217.194.0-255,4320,146406,65,169114
27391,0.001929,172.217.194.0-255,7156,153562,65,169114
27392,0.001973,172.31.40.0-255,66,153628,65,169114
27393,0.001988,172.31.40.0-255,66,153694,65,169114
27394,0.002005,172.217.194.0-255,3602,157296,65,169114
27395,0.002043,172.217.194.0-255,7156,164452,65,169114
27396,0.002109,172.217.194.0-255,4320,168772,65,169114
27397,0.002158,172.217.194.0-255,105,168877,65,169114
27398,0.010481,172.31.40.0-255,66,168943,65,169114
27399,0.013221,172.31.40.0-255,105,169048,65,169114
27400,0.0158,172.217.194.0-255,66,169114,65,169114
27401,0.0,74.125.200.0-255,153,153,65,193173
27402,2.3e-05,172.31.40.0-255,66,219,65,193173
27403,3.1e-05,74.125.200.0-255,1484,1703,65,193173
27404,3.5e-05,172.31.40.0-255,66,1769,65,193173
27405,4.8e-05,74.125.200.0-255,2902,4671,65,193173
27406,5.2e-05,172.31.40.0-255,66,4737,65,193173
27407,8.1e-05,74.125.200.0-255,7156,11893,65,193173
27408,8.5e-05,172.31.40.0-255,66,11959,65,193173
27409,0.000121,172.31.40.0-255,66,12025,65,193173
27410,0.000125,74.125.200.0-255,2902,14927,65,193173
27411,0.000127,172.31.40.0-255,66,14993,65,193173
27412,0.000132,74.125.200.0-255,2902,17895,65,193173
27413,0.000135,172.31.40.0-255,66,17961,65,193173
27414,0.000164,74.125.200.0-255,1484,19445,65,193173
27415,0.000167,172.31.40.0-255,66,19511,65,193173
27416,0.000172,74.125.200.0-255,3961,23472,65,193173
27417,0.000175,172.31.40.0-255,66,23538,65,193173
27418,0.000394,74.125.200.0-255,1484,25022,65,193173
27419,0.0004,172.31.40.0-255,66,25088,65,193173
27420,0.000404,74.125.200.0-255,1484,26572,65,193173
27421,0.000406,172.31.40.0-255,66,26638,65,193173
27422,0.000427,74.125.200.0-255,1484,28122,65,193173
27423,0.00043,172.31.40.0-255,66,28188,65,193173
27424,0.000436,74.125.200.0-255,1484,29672,65,193173
27425,0.000438,172.31.40.0-255,66,29738,65,193173
27426,0.000444,74.125.200.0-255,2902,32640,65,193173
27427,0.000446,172.31.40.0-255,66,32706,65,193173
27428,0.000485,74.125.200.0-255,5738,38444,65,193173
27429,0.000488,172.31.40.0-255,66,38510,65,193173
27430,0.000491,74.125.200.0-255,1484,39994,65,193173
27431,0.000494,172.31.40.0-255,66,40060,65,193173
27432,0.000498,74.125.200.0-255,2543,42603,65,193173
27433,0.0005,172.31.40.0-255,66,42669,65,193173
27434,0.000534,74.125.200.0-255,5738,48407,65,193173
27435,0.000538,172.31.40.0-255,66,48473,65,193173
27436,0.000566,74.125.200.0-255,5738,54211,65,193173
27437,0.00057,172.31.40.0-255,66,54277,65,193173
27438,0.000593,74.125.200.0-255,1484,55761,65,193173
27439,0.000598,74.125.200.0-255,1484,57245,65,193173
27440,0.0006,172.31.40.0-255,66,57311,65,193173
27441,0.000623,74.125.200.0-255,1459,58770,65,193173
27442,0.000714,74.125.200.0-255,112,58882,65,193173
27443,0.000717,172.31.40.0-255,66,58948,65,193173
27444,0.000744,74.125.200.0-255,329,59277,65,193173
27445,0.001,74.125.200.0-255,1484,60761,65,193173
27446,0.001005,172.31.40.0-255,66,60827,65,193173
27447,0.001011,74.125.200.0-255,2902,63729,65,193173
27448,0.001013,172.31.40.0-255,66,63795,65,193173
27449,0.001016,74.125.200.0-255,1484,65279,65,193173
27450,0.001037,74.125.200.0-255,4320,69599,65,193173
27451,0.001039,172.31.40.0-255,66,69665,65,193173
27452,0.001043,74.125.200.0-255,2902,72567,65,193173
27453,0.001045,172.31.40.0-255,66,72633,65,193173
27454,0.00105,74.125.200.0-255,4320,76953,65,193173
27455,0.001053,172.31.40.0-255,66,77019,65,193173
27456,0.001098,74.125.200.0-255,2902,79921,65,193173
27457,0.001101,172.31.40.0-255,66,79987,65,193173
27458,0.001135,74.125.200.0-255,5738,85725,65,193173
27459,0.001138,172.31.40.0-255,66,85791,65,193173
27460,0.001143,74.125.200.0-255,2902,88693,65,193173
27461,0.001146,172.31.40.0-255,66,88759,65,193173
27462,0.001169,74.125.200.0-255,5020,93779,65,193173
27463,0.001177,172.31.40.0-255,66,93845,65,193173
27464,0.001292,74.125.200.0-255,1484,95329,65,193173
27465,0.001311,74.125.200.0-255,2902,98231,65,193173
27466,0.001314,172.31.40.0-255,66,98297,65,193173
27467,0.001318,74.125.200.0-255,1484,99781,65,193173
27468,0.001339,74.125.200.0-255,4320,104101,65,193173
27469,0.001342,172.31.40.0-255,66,104167,65,193173
27470,0.001348,74.125.200.0-255,5738,109905,65,193173
27471,0.001352,172.31.40.0-255,66,109971,65,193173
27472,0.001381,74.125.200.0-255,2902,112873,65,193173
27473,0.001383,172.31.40.0-255,66,112939,65,193173
27474,0.001423,74.125.200.0-255,4320,117259,65,193173
27475,0.001427,172.31.40.0-255,66,117325,65,193173
27476,0.001439,172.31.40.0-255,66,117391,65,193173
27477,0.001462,74.125.200.0-255,1484,118875,65,193173
27478,0.001467,74.125.200.0-255,2902,121777,65,193173
27479,0.001473,172.31.40.0-255,66,121843,65,193173
27480,0.001479,74.125.200.0-255,4320,126163,65,193173
27481,0.001481,172.31.40.0-255,66,126229,65,193173
27482,0.001501,74.125.200.0-255,1484,127713,65,193173
27483,0.001505,74.125.200.0-255,2902,130615,65,193173
27484,0.001508,172.31.40.0-255,66,130681,65,193173
27485,0.001522,74.125.200.0-255,4320,135001,65,193173
27486,0.001529,172.31.40.0-255,66,135067,65,193173
27487,0.001556,74.125.200.0-255,5738,140805,65,193173
27488,0.001559,172.31.40.0-255,66,140871,65,193173
27489,0.001572,172.31.40.0-255,66,140937,65,193173
27490,0.003561,74.125.200.0-255,5738,146675,65,193173
27491,0.003568,172.31.40.0-255,66,146741,65,193173
27492,0.005541,74.125.200.0-255,5738,152479,65,193173
27493,0.005547,172.31.40.0-255,66,152545,65,193173
27494,0.007528,74.125.200.0-255,5738,158283,65,193173
27495,0.007532,172.31.40.0-255,66,158349,65,193173
27496,0.009518,74.125.200.0-255,5738,164087,65,193173
27497,0.009526,172.31.40.0-255,66,164153,65,193173
27498,0.011518,74.125.200.0-255,5738,169891,65,193173
27499,0.011525,172.31.40.0-255,66,169957,65,193173
27500,0.013512,74.125.200.0-255,5738,175695,65,193173
27501,0.013521,172.31.40.0-255,66,175761,65,193173
27502,0.015518,74.125.200.0-255,5738,181499,65,193173
27503,0.015527,172.31.40.0-255,66,181565,65,193173
27504,0.017526,74.125.200.0-255,5738,187303,65,193173
27505,0.017535,172.31.40.0-255,66,187369,65,193173
27506,0.019523,74.125.200.0-255,5738,193107,65,193173
27507,0.01953,172.31.40.0-255,66,193173,65,193173
27508,0.0,172.31.40.0-255,105,105,65,276
27509,0.001773,157.240.24.0-255,105,210,65,276
27510,0.001785,172.31.40.0-255,66,276,65,276
27511,0.0,74.125.200.0-255,153,153,65,197306
27512,2e-05,172.31.40.0-255,66,219,65,197306
27513,2.8e-05,74.125.200.0-255,1484,1703,65,197306
27514,3.2e-05,172.31.40.0-255,66,1769,65,197306
27515,3.5e-05,74.125.200.0-255,1484,3253,65,197306
27516,3.7e-05,172.31.40.0-255,66,3319,65,197306
27517,4.3e-05,74.125.200.0-255,2902,6221,65,197306
27518,4.7e-05,172.31.40.0-255,66,6287,65,197306
27519,5e-05,74.125.200.0-255,1484,7771,65,197306
27520,5.2e-05,172.31.40.0-255,66,7837,65,197306
27521,7.7e-05,74.125.200.0-255,4320,12157,65,197306
27522,8e-05,172.31.40.0-255,66,12223,65,197306
27523,8.4e-05,74.125.200.0-255,1938,14161,65,197306
27524,8.6e-05,172.31.40.0-255,66,14227,65,197306
27525,0.000132,74.125.200.0-255,2902,17129,65,197306
27526,0.000134,172.31.40.0-255,66,17195,65,197306
27527,0.00014,74.125.200.0-255,4320,21515,65,197306
27528,0.000142,172.31.40.0-255,66,21581,65,197306
27529,0.000184,74.125.200.0-255,4320,25901,65,197306
27530,0.000187,172.31.40.0-255,66,25967,65,197306
27531,0.000207,74.125.200.0-255,2902,28869,65,197306
27532,0.00021,172.31.40.0-255,66,28935,65,197306
27533,0.00024,74.125.200.0-255,2543,31478,65,197306
27534,0.000243,172.31.40.0-255,66,31544,65,197306
27535,0.000421,74.125.200.0-255,1484,33028,65,197306
27536,0.000426,172.31.40.0-255,66,33094,65,197306
27537,0.000432,74.125.200.0-255,2902,35996,65,197306
27538,0.000434,172.31.40.0-255,66,36062,65,197306
27539,0.000448,74.125.200.0-255,1484,37546,65,197306
27540,0.00045,172.31.40.0-255,66,37612,65,197306
27541,0.000478,74.125.200.0-255,2902,40514,65,197306
27542,0.000481,172.31.40.0-255,66,40580,65,197306
27543,0.000501,74.125.200.0-255,4320,44900,65,197306
27544,0.000505,172.31.40.0-255,66,44966,65,197306
27545,0.000522,74.125.200.0-255,1484,46450,65,197306
27546,0.000531,74.125.200.0-255,6797,53247,65,197306
27547,0.000533,172.31.40.0-255,66,53313,65,197306
27548,0.000558,74.125.200.0-255,4320,57633,65,197306
27549,0.000562,172.31.40.0-255,66,57699,65,197306
27550,0.000584,74.125.200.0-255,2902,60601,65,197306
27551,0.000587,172.31.40.0-255,66,60667,65,197306
27552,0.000594,74.125.200.0-255,5379,66046,65,197306
27553,0.000596,172.31.40.0-255,66,66112,65,197306
27554,0.000849,74.125.200.0-255,396,66508,65,197306
27555,0.00092,74.125.200.0-255,1484,67992,65,197306
27556,0.000924,172.31.40.0-255,66,68058,65,197306
27557,0.000949,74.125.200.0-255,2902,70960,65,197306
27558,0.000952,172.31.40.0-255,66,71026,65,197306
27559,0.000957,74.125.200.0-255,4320,75346,65,197306
27560,0.000959,172.31.40.0-255,66,75412,65,197306
27561,0.000988,74.125.200.0-255,2902,78314,65,197306
27562,0.000991,172.31.40.0-255,66,78380,65,197306
27563,0.001012,74.125.200.0-255,5080,83460,65,197306
27564,0.001015,172.31.40.0-255,66,83526,65,197306
27565,0.001169,74.125.200.0-255,1484,85010,65,197306
27566,0.001182,74.125.200.0-255,2902,87912,65,197306
27567,0.001185,172.31.40.0-255,66,87978,65,197306
27568,0.00121,74.125.200.0-255,4320,92298,65,197306
27569,0.001213,172.31.40.0-255,66,92364,65,197306
27570,0.001252,172.31.40.0-255,66,92430,65,197306
27571,0.001258,74.125.200.0-255,5738,98168,65,197306
27572,0.00126,172.31.40.0-255,66,98234,65,197306
27573,0.001268,74.125.200.0-255,5738,103972,65,197306
27574,0.00127,172.31.40.0-255,66,104038,65,197306
27575,0.001281,74.125.200.0-255,1484,105522,65,197306
27576,0.001318,74.125.200.0-255,1484,107006,65,197306
27577,0.00132,172.31.40.0-255,66,107072,65,197306
27578,0.001337,74.125.200.0-255,2184,109256,65,197306
27579,0.001339,172.31.40.0-255,66,109322,65,197306
27580,0.001836,74.125.200.0-255,1484,110806,65,197306
27581,0.001845,74.125.200.0-255,2902,113708,65,197306
27582,0.001849,172.31.40.0-255,66,113774,65,197306
27583,0.001854,74.125.200.0-255,1484,115258,65,197306
27584,0.001875,74.125.200.0-255,4320,119578,65,197306
27585,0.001877,172.31.40.0-255,66,119644,65,197306
27586,0.001891,74.125.200.0-255,4320,123964,65,197306
27587,0.001894,172.31.40.0-255,66,124030,65,197306
27588,0.001912,74.125.200.0-255,2902,126932,65,197306
27589,0.001914,172.31.40.0-255,66,126998,65,197306
27590,0.001938,74.125.200.0-255,5738,132736,65,197306
27591,0.00194,172.31.40.0-255,66,132802,65,197306
27592,0.001943,74.125.200.0-255,1484,134286,65,197306
27593,0.001982,172.31.40.0-255,66,134352,65,197306
27594,0.002226,74.125.200.0-255,1484,135836,65,197306
27595,0.002234,74.125.200.0-255,2902,138738,65,197306
27596,0.002238,172.31.40.0-255,66,138804,65,197306
27597,0.002242,74.125.200.0-255,1484,140288,65,197306
27598,0.002245,74.125.200.0-255,1484,141772,65,197306
27599,0.002247,172.31.40.0-255,66,141838,65,197306
27600,0.002261,74.125.200.0-255,1484,143322,65,197306
27601,0.002265,74.125.200.0-255,2902,146224,65,197306
27602,0.002267,172.31.40.0-255,66,146290,65,197306
27603,0.002288,74.125.200.0-255,2902,149192,65,197306
27604,0.00229,172.31.40.0-255,66,149258,65,197306
27605,0.002295,74.125.200.0-255,2902,152160,65,197306
27606,0.002297,172.31.40.0-255,66,152226,65,197306
27607,0.002316,74.125.200.0-255,4320,156546,65,197306
27608,0.002318,172.31.40.0-255,66,156612,65,197306
27609,0.002322,74.125.200.0-255,1484,158096,65,197306
27610,0.004586,74.125.200.0-255,4320,162416,65,197306
27611,0.004592,172.31.40.0-255,66,162482,65,197306
27612,0.006885,74.125.200.0-255,5738,168220,65,197306
27613,0.006892,172.31.40.0-255,66,168286,65,197306
27614,0.009181,74.125.200.0-255,5738,174024,65,197306
27615,0.009188,172.31.40.0-255,66,174090,65,197306
27616,0.011479,74.125.200.0-255,5738,179828,65,197306
27617,0.011486,172.31.40.0-255,66,179894,65,197306
27618,0.01378,74.125.200.0-255,5738,185632,65,197306
27619,0.013788,172.31.40.0-255,66,185698,65,197306
27620,0.016073,74.125.200.0-255,5738,191436,65,197306
27621,0.01608,172.31.40.0-255,66,191502,65,197306
27622,0.018362,74.125.200.0-255,5738,197240,65,197306
27623,0.018369,172.31.40.0-255,66,197306,65,197306
27624,0.0,74.125.200.0-255,150,150,65,301652
27625,2.5e-05,172.31.40.0-255,66,216,65,301652
27626,3.2e-05,74.125.200.0-255,1484,1700,65,301652
27627,3.6e-05,172.31.40.0-255,66,1766,65,301652
27628,4.3e-05,74.125.200.0-255,2902,4668,65,301652
27629,4.7e-05,172.31.40.0-255,66,4734,65,301652
27630,5.2e-05,74.125.200.0-255,2902,7636,65,301652
27631,5.5e-05,172.31.40.0-255,66,7702,65,301652
27632,6.3e-05,74.125.200.0-255,4320,12022,65,301652
27633,6.7e-05,172.31.40.0-255,66,12088,65,301652
27634,7.4e-05,74.125.200.0-255,7156,19244,65,301652
27635,7.7e-05,172.31.40.0-255,66,19310,65,301652
27636,0.000131,74.125.200.0-255,2066,21376,65,301652
27637,0.000134,172.31.40.0-255,66,21442,65,301652
27638,0.000147,172.31.40.0-255,66,21508,65,301652
27639,0.000201,74.125.200.0-255,1484,22992,65,301652
27640,0.000204,172.31.40.0-255,66,23058,65,301652
27641,0.000221,74.125.200.0-255,1484,24542,65,301652
27642,0.000224,172.31.40.0-255,66,24608,65,301652
27643,0.000228,74.125.200.0-255,2902,27510,65,301652
27644,0.000231,172.31.40.0-255,66,27576,65,301652
27645,0.000265,74.125.200.0-255,5738,33314,65,301652
27646,0.000268,172.31.40.0-255,66,33380,65,301652
27647,0.000273,74.125.200.0-255,4320,37700,65,301652
27648,0.000274,172.31.40.0-255,66,37766,65,301652
27649,0.000291,74.125.200.0-255,5379,43145,65,301652
27650,0.000294,172.31.40.0-255,66,43211,65,301652
27651,0.000348,74.125.200.0-255,2902,46113,65,301652
27652,0.000351,172.31.40.0-255,66,46179,65,301652
27653,0.000368,172.31.40.0-255,66,46245,65,301652
27654,0.000371,74.125.200.0-255,1397,47642,65,301652
27655,0.000532,74.125.200.0-255,382,48024,65,301652
27656,0.000536,172.31.40.0-255,66,48090,65,301652
27657,0.000688,74.125.200.0-255,1484,49574,65,301652
27658,0.000703,74.125.200.0-255,2902,52476,65,301652
27659,0.000707,172.31.40.0-255,66,52542,65,301652
27660,0.000736,74.125.200.0-255,5738,58280,65,301652
27661,0.00074,172.31.40.0-255,66,58346,65,301652
27662,0.000745,74.125.200.0-255,2902,61248,65,301652
27663,0.000747,172.31.40.0-255,66,61314,65,301652
27664,0.000759,74.125.200.0-255,1484,62798,65,301652
27665,0.000778,74.125.200.0-255,2543,65341,65,301652
27666,0.000781,172.31.40.0-255,66,65407,65,301652
27667,0.000795,74.125.200.0-255,1484,66891,65,301652
27668,0.000815,74.125.200.0-255,2902,69793,65,301652
27669,0.000817,172.31.40.0-255,66,69859,65,301652
27670,0.000835,74.125.200.0-255,1484,71343,65,301652
27671,0.000863,74.125.200.0-255,2902,74245,65,301652
27672,0.000867,172.31.40.0-255,66,74311,65,301652
27673,0.000875,74.125.200.0-255,1484,75795,65,301652
27674,0.000905,74.125.200.0-255,2902,78697,65,301652
27675,0.000909,172.31.40.0-255,66,78763,65,301652
27676,0.000928,74.125.200.0-255,1484,80247,65,301652
27677,0.000955,74.125.200.0-255,2543,82790,65,301652
27678,0.000958,172.31.40.0-255,66,82856,65,301652
27679,0.001192,74.125.200.0-255,1484,84340,65,301652
27680,0.001208,74.125.200.0-255,2902,87242,65,301652
27681,0.001212,172.31.40.0-255,66,87308,65,301652
27682,0.00122,74.125.200.0-255,5738,93046,65,301652
27683,0.001221,172.31.40.0-255,66,93112,65,301652
27684,0.001225,74.125.200.0-255,1484,94596,65,301652
27685,0.001253,74.125.200.0-255,5738,100334,65,301652
27686,0.001257,74.125.200.0-255,2902,103236,65,301652
27687,0.00126,172.31.40.0-255,66,103302,65,301652
27688,0.001267,172.31.40.0-255,66,103368,65,301652
27689,0.001274,74.125.200.0-255,5738,109106,65,301652
27690,0.001277,172.31.40.0-255,66,109172,65,301652
27691,0.001312,172.31.40.0-255,66,109238,65,301652
27692,0.001372,74.125.200.0-255,1484,110722,65,301652
27693,0.001377,74.125.200.0-255,2902,113624,65,301652
27694,0.00138,172.31.40.0-255,66,113690,65,301652
27695,0.001392,74.125.200.0-255,2902,116592,65,301652
27696,0.001394,172.31.40.0-255,66,116658,65,301652
27697,0.001414,74.125.200.0-255,2902,119560,65,301652
27698,0.001417,172.31.40.0-255,66,119626,65,301652
27699,0.00143,74.125.200.0-255,4320,123946,65,301652
27700,0.001433,172.31.40.0-255,66,124012,65,301652
27701,0.001463,172.31.40.0-255,66,124078,65,301652
27702,0.001466,74.125.200.0-255,1484,125562,65,301652
27703,0.001471,74.125.200.0-255,2902,128464,65,301652
27704,0.001473,172.31.40.0-255,66,128530,65,301652
27705,0.001488,74.125.200.0-255,1484,130014,65,301652
27706,0.00152,74.125.200.0-255,2902,132916,65,301652
27707,0.001525,172.31.40.0-255,66,132982,65,301652
27708,0.001543,74.125.200.0-255,2184,135166,65,301652
27709,0.001545,172.31.40.0-255,66,135232,65,301652
27710,0.001613,74.125.200.0-255,1484,136716,65,301652
27711,0.001648,74.125.200.0-255,1484,138200,65,301652
27712,0.001651,172.31.40.0-255,66,138266,65,301652
27713,0.001671,74.125.200.0-255,2902,141168,65,301652
27714,0.001674,172.31.40.0-255,66,141234,65,301652
27715,0.0017,74.125.200.0-255,4320,145554,65,301652
27716,0.001703,172.31.40.0-255,66,145620,65,301652
27717,0.001708,74.125.200.0-255,4320,149940,65,301652
27718,0.00171,172.31.40.0-255,66,150006,65,301652
27719,0.001724,74.125.200.0-255,1484,151490,65,301652
27720,0.001742,74.125.200.0-255,2902,154392,65,301652
27721,0.001744,172.31.40.0-255,66,154458,65,301652
27722,0.001764,74.125.200.0-255,2902,157360,65,301652
27723,0.001766,172.31.40.0-255,66,157426,65,301652
27724,0.001777,74.125.200.0-255,1484,158910,65,301652
27725,0.001791,74.125.200.0-255,2902,161812,65,301652
27726,0.001794,172.31.40.0-255,66,161878,65,301652
27727,0.001811,74.125.200.0-255,2902,164780,65,301652
27728,0.001814,172.31.40.0-255,66,164846,65,301652
27729,0.001845,74.125.200.0-255,5020,169866,65,301652
27730,0.001848,172.31.40.0-255,66,169932,65,301652
27731,0.00187,74.125.200.0-255,4320,174252,65,301652
27732,0.001873,172.31.40.0-255,66,174318,65,301652
27733,0.001893,74.125.200.0-255,1484,175802,65,301652
27734,0.001897,74.125.200.0-255,1484,177286,65,301652
27735,0.001899,172.31.40.0-255,66,177352,65,301652
27736,0.001923,74.125.200.0-255,2902,180254,65,301652
27737,0.001927,172.31.40.0-255,66,180320,65,301652
27738,0.001932,74.125.200.0-255,2902,183222,65,301652
27739,0.001934,172.31.40.0-255,66,183288,65,301652
27740,0.001955,74.125.200.0-255,2902,186190,65,301652
27741,0.001958,172.31.40.0-255,66,186256,65,301652
27742,0.001963,74.125.200.0-255,4320,190576,65,301652
27743,0.001965,172.31.40.0-255,66,190642,65,301652
27744,0.00197,74.125.200.0-255,2902,193544,65,301652
27745,0.001972,172.31.40.0-255,66,193610,65,301652
27746,0.001988,74.125.200.0-255,2902,196512,65,301652
27747,0.00199,172.31.40.0-255,66,196578,65,301652
27748,0.002025,172.31.40.0-255,66,196644,65,301652
27749,0.002146,74.125.200.0-255,1484,198128,65,301652
27750,0.002179,74.125.200.0-255,1484,199612,65,301652
27751,0.002182,172.31.40.0-255,66,199678,65,301652
27752,0.002201,74.125.200.0-255,1484,201162,65,301652
27753,0.002207,74.125.200.0-255,5738,206900,65,301652
27754,0.00221,172.31.40.0-255,66,206966,65,301652
27755,0.002223,74.125.200.0-255,7156,214122,65,301652
27756,0.002225,172.31.40.0-255,66,214188,65,301652
27757,0.002235,172.31.40.0-255,66,214254,65,301652
27758,0.002271,172.31.40.0-255,66,214320,65,301652
27759,0.00234,74.125.200.0-255,1484,215804,65,301652
27760,0.002346,74.125.200.0-255,2902,218706,65,301652
27761,0.002348,172.31.40.0-255,66,218772,65,301652
27762,0.002363,74.125.200.0-255,4320,223092,65,301652
27763,0.002365,172.31.40.0-255,66,223158,65,301652
27764,0.002387,74.125.200.0-255,1484,224642,65,301652
27765,0.002401,74.125.200.0-255,4320,228962,65,301652
27766,0.002403,172.31.40.0-255,66,229028,65,301652
27767,0.002425,74.125.200.0-255,4320,233348,65,301652
27768,0.002427,172.31.40.0-255,66,233414,65,301652
27769,0.002459,172.31.40.0-255,66,233480,65,301652
27770,0.002464,74.125.200.0-255,4320,237800,65,301652
27771,0.002468,172.31.40.0-255,66,237866,65,301652
27772,0.002487,74.125.200.0-255,1484,239350,65,301652
27773,0.002502,74.125.200.0-255,3602,242952,65,301652
27774,0.002505,172.31.40.0-255,66,243018,65,301652
27775,0.002524,74.125.200.0-255,1484,244502,65,301652
27776,0.002528,74.125.200.0-255,2902,247404,65,301652
27777,0.002531,172.31.40.0-255,66,247470,65,301652
27778,0.002551,74.125.200.0-255,5738,253208,65,301652
27779,0.002554,172.31.40.0-255,66,253274,65,301652
27780,0.002559,74.125.200.0-255,2902,256176,65,301652
27781,0.002561,172.31.40.0-255,66,256242,65,301652
27782,0.002586,74.125.200.0-255,4320,260562,65,301652
27783,0.002589,172.31.40.0-255,66,260628,65,301652
27784,0.002602,74.125.200.0-255,2902,263530,65,301652
27785,0.002604,172.31.40.0-255,66,263596,65,301652
27786,0.002629,74.125.200.0-255,2902,266498,65,301652
27787,0.002632,172.31.40.0-255,66,266564,65,301652
27788,0.005167,74.125.200.0-255,2902,269466,65,301652
27789,0.005176,172.31.40.0-255,66,269532,65,301652
27790,0.005195,74.125.200.0-255,2902,272434,65,301652
27791,0.005198,172.31.40.0-255,66,272500,65,301652
27792,0.007743,74.125.200.0-255,2902,275402,65,301652
27793,0.007747,172.31.40.0-255,66,275468,65,301652
27794,0.007767,74.125.200.0-255,2902,278370,65,301652
27795,0.00777,172.31.40.0-255,66,278436,65,301652
27796,0.01033,74.125.200.0-255,5738,284174,65,301652
27797,0.010353,172.31.40.0-255,66,284240,65,301652
27798,0.012925,74.125.200.0-255,5738,289978,65,301652
27799,0.012942,172.31.40.0-255,66,290044,65,301652
27800,0.015516,74.125.200.0-255,5738,295782,65,301652
27801,0.015529,172.31.40.0-255,66,295848,65,301652
27802,0.018146,74.125.200.0-255,5738,301586,65,301652
27803,0.018163,172.31.40.0-255,66,301652,65,301652
27804,0.0,172.217.26.0-255,298,298,65,160287
27805,2.3e-05,172.31.40.0-255,66,364,65,160287
27806,3e-05,172.217.26.0-255,1484,1848,65,160287
27807,3.4e-05,172.31.40.0-255,66,1914,65,160287
27808,4e-05,172.217.26.0-255,2902,4816,65,160287
27809,4.2e-05,172.31.40.0-255,66,4882,65,160287
27810,5.6e-05,172.217.26.0-255,4320,9202,65,160287
27811,6e-05,172.31.40.0-255,66,9268,65,160287
27812,6.3e-05,172.217.26.0-255,1484,10752,65,160287
27813,6.6e-05,172.31.40.0-255,66,10818,65,160287
27814,0.000112,172.31.40.0-255,66,10884,65,160287
27815,0.000117,172.217.26.0-255,4320,15204,65,160287
27816,0.000119,172.31.40.0-255,66,15270,65,160287
27817,0.000126,172.217.26.0-255,5738,21008,65,160287
27818,0.000129,172.31.40.0-255,66,21074,65,160287
27819,0.000153,172.217.26.0-255,2543,23617,65,160287
27820,0.000156,172.31.40.0-255,66,23683,65,160287
27821,0.000223,172.217.26.0-255,1484,25167,65,160287
27822,0.000226,172.31.40.0-255,66,25233,65,160287
27823,0.000238,172.217.26.0-255,1484,26717,65,160287
27824,0.000244,172.31.40.0-255,66,26783,65,160287
27825,0.000249,172.217.26.0-255,2902,29685,65,160287
27826,0.000251,172.31.40.0-255,66,29751,65,160287
27827,0.000254,172.217.26.0-255,1484,31235,65,160287
27828,0.000257,172.31.40.0-255,66,31301,65,160287
27829,0.000298,172.217.26.0-255,4320,35621,65,160287
27830,0.000301,172.31.40.0-255,66,35687,65,160287
27831,0.000307,172.217.26.0-255,5379,41066,65,160287
27832,0.000309,172.31.40.0-255,66,41132,65,160287
27833,0.000464,172.217.26.0-255,1484,42616,65,160287
27834,0.000468,172.31.40.0-255,66,42682,65,160287
27835,0.000473,172.217.26.0-255,1484,44166,65,160287
27836,0.000494,172.217.26.0-255,1484,45650,65,160287
27837,0.000497,172.31.40.0-255,66,45716,65,160287
27838,0.000503,172.217.26.0-255,4320,50036,65,160287
27839,0.000506,172.31.40.0-255,66,50102,65,160287
27840,0.000517,172.217.26.0-255,5738,55840,65,160287
27841,0.000519,172.31.40.0-255,66,55906,65,160287
27842,0.000581,172.217.26.0-255,2831,58737,65,160287
27843,0.000584,172.31.40.0-255,66,58803,65,160287
27844,0.001027,172.217.26.0-255,389,59192,65,160287
27845,0.001176,172.217.26.0-255,1484,60676,65,160287
27846,0.001182,172.31.40.0-255,66,60742,65,160287
27847,0.001211,172.217.26.0-255,1484,62226,65,160287
27848,0.001216,172.217.26.0-255,2902,65128,65,160287
27849,0.001218,172.31.40.0-255,66,65194,65,160287
27850,0.001225,172.217.26.0-255,5738,70932,65,160287
27851,0.001227,172.31.40.0-255,66,70998,65,160287
27852,0.001267,172.31.40.0-255,66,71064,65,160287
27853,0.001274,172.217.26.0-255,7156,78220,65,160287
27854,0.001276,172.31.40.0-255,66,78286,65,160287
27855,0.001296,172.217.26.0-255,2902,81188,65,160287
27856,0.001298,172.31.40.0-255,66,81254,65,160287
27857,0.001307,172.217.26.0-255,2543,83797,65,160287
27858,0.001309,172.31.40.0-255,66,83863,65,160287
27859,0.001387,172.217.26.0-255,1484,85347,65,160287
27860,0.001393,172.217.26.0-255,2902,88249,65,160287
27861,0.001396,172.31.40.0-255,66,88315,65,160287
27862,0.001399,172.217.26.0-255,1484,89799,65,160287
27863,0.001426,172.217.26.0-255,5738,95537,65,160287
27864,0.001428,172.31.40.0-255,66,95603,65,160287
27865,0.001439,172.217.26.0-255,1484,97087,65,160287
27866,0.001471,172.31.40.0-255,66,97153,65,160287
27867,0.001481,172.31.40.0-255,66,97219,65,160287
27868,0.001501,172.217.26.0-255,766,97985,65,160287
27869,0.001697,172.217.26.0-255,1484,99469,65,160287
27870,0.001702,172.31.40.0-255,66,99535,65,160287
27871,0.001706,172.217.26.0-255,1484,101019,65,160287
27872,0.001733,172.217.26.0-255,2902,103921,65,160287
27873,0.001736,172.31.40.0-255,66,103987,65,160287
27874,0.001741,172.217.26.0-255,5738,109725,65,160287
27875,0.001743,172.31.40.0-255,66,109791,65,160287
27876,0.001791,172.31.40.0-255,66,109857,65,160287
27877,0.001832,172.31.40.0-255,66,109923,65,160287
27878,0.001835,172.217.26.0-255,766,110689,65,160287
27879,0.002304,172.31.40.0-255,66,110755,65,160287
27880,0.003773,172.217.26.0-255,4320,115075,65,160287
27881,0.00378,172.31.40.0-255,66,115141,65,160287
27882,0.004238,172.217.26.0-255,1484,116625,65,160287
27883,0.00572,172.217.26.0-255,4320,120945,65,160287
27884,0.005727,172.31.40.0-255,66,121011,65,160287
27885,0.00766,172.217.26.0-255,4320,125331,65,160287
27886,0.007663,172.31.40.0-255,66,125397,65,160287
27887,0.007686,172.217.26.0-255,1484,126881,65,160287
27888,0.009604,172.217.26.0-255,4320,131201,65,160287
27889,0.009611,172.31.40.0-255,66,131267,65,160287
27890,0.011562,172.217.26.0-255,5738,137005,65,160287
27891,0.011568,172.31.40.0-255,66,137071,65,160287
27892,0.013512,172.217.26.0-255,5738,142809,65,160287
27893,0.01352,172.31.40.0-255,66,142875,65,160287
27894,0.015458,172.217.26.0-255,5738,148613,65,160287
27895,0.015465,172.31.40.0-255,66,148679,65,160287
27896,0.01741,172.217.26.0-255,5738,154417,65,160287
27897,0.017419,172.31.40.0-255,66,154483,65,160287
27898,0.019358,172.217.26.0-255,5738,160221,65,160287
27899,0.019364,172.31.40.0-255,66,160287,65,160287
27900,0.0,74.125.24.0-255,146,146,65,186152
27901,2.3e-05,172.31.40.0-255,66,212,65,186152
27902,2.9e-05,74.125.24.0-255,1484,1696,65,186152
27903,3.3e-05,172.31.40.0-255,66,1762,65,186152
27904,3.9e-05,74.125.24.0-255,2902,4664,65,186152
27905,4.2e-05,172.31.40.0-255,66,4730,65,186152
27906,5.8e-05,74.125.24.0-255,7156,11886,65,186152
27907,6.2e-05,172.31.40.0-255,66,11952,65,186152
27908,6.6e-05,74.125.24.0-255,2002,13954,65,186152
27909,7e-05,172.31.40.0-255,66,14020,65,186152
27910,0.000122,74.125.24.0-255,1484,15504,65,186152
27911,0.000125,172.31.40.0-255,66,15570,65,186152
27912,0.000131,74.125.24.0-255,2902,18472,65,186152
27913,0.000133,172.31.40.0-255,66,18538,65,186152
27914,0.00017,74.125.24.0-255,5738,24276,65,186152
27915,0.000173,172.31.40.0-255,66,24342,65,186152
27916,0.00018,74.125.24.0-255,6797,31139,65,186152
27917,0.000182,172.31.40.0-255,66,31205,65,186152
27918,0.000296,74.125.24.0-255,1484,32689,65,186152
27919,0.0003,172.31.40.0-255,66,32755,65,186152
27920,0.000305,74.125.24.0-255,2902,35657,65,186152
27921,0.000308,172.31.40.0-255,66,35723,65,186152
27922,0.000342,74.125.24.0-255,5738,41461,65,186152
27923,0.000345,172.31.40.0-255,66,41527,65,186152
27924,0.00035,74.125.24.0-255,2902,44429,65,186152
27925,0.000352,172.31.40.0-255,66,44495,65,186152
27926,0.000397,172.31.40.0-255,66,44561,65,186152
27927,0.000421,74.125.24.0-255,5738,50299,65,186152
27928,0.000424,172.31.40.0-255,66,50365,65,186152
27929,0.000454,74.125.24.0-255,4293,54658,65,186152
27930,0.000456,172.31.40.0-255,66,54724,65,186152
27931,0.000459,74.125.24.0-255,113,54837,65,186152
27932,0.000482,74.125.24.0-255,331,55168,65,186152
27933,0.000844,74.125.24.0-255,1484,56652,65,186152
27934,0.000849,172.31.40.0-255,66,56718,65,186152
27935,0.000854,74.125.24.0-255,2902,59620,65,186152
27936,0.000857,172.31.40.0-255,66,59686,65,186152
27937,0.000864,74.125.24.0-255,5738,65424,65,186152
27938,0.00087,172.31.40.0-255,66,65490,65,186152
27939,0.000921,172.31.40.0-255,66,65556,65,186152
27940,0.000939,172.31.40.0-255,66,65622,65,186152
27941,0.001788,74.125.24.0-255,1484,67106,65,186152
27942,0.001799,74.125.24.0-255,2902,70008,65,186152
27943,0.001803,172.31.40.0-255,66,70074,65,186152
27944,0.001811,74.125.24.0-255,5738,75812,65,186152
27945,0.001813,172.31.40.0-255,66,75878,65,186152
27946,0.001822,74.125.24.0-255,1484,77362,65,186152
27947,0.001827,74.125.24.0-255,2902,80264,65,186152
27948,0.001829,172.31.40.0-255,66,80330,65,186152
27949,0.001832,74.125.24.0-255,1484,81814,65,186152
27950,0.001863,74.125.24.0-255,4320,86134,65,186152
27951,0.001865,172.31.40.0-255,66,86200,65,186152
27952,0.00188,172.31.40.0-255,66,86266,65,186152
27953,0.001906,74.125.24.0-255,4320,90586,65,186152
27954,0.001912,172.31.40.0-255,66,90652,65,186152
27955,0.001915,74.125.24.0-255,766,91418,65,186152
27956,0.002111,74.125.24.0-255,1484,92902,65,186152
27957,0.002116,172.31.40.0-255,66,92968,65,186152
27958,0.002122,74.125.24.0-255,2902,95870,65,186152
27959,0.002124,172.31.40.0-255,66,95936,65,186152
27960,0.002128,74.125.24.0-255,2902,98838,65,186152
27961,0.002131,172.31.40.0-255,66,98904,65,186152
27962,0.002164,74.125.24.0-255,2902,101806,65,186152
27963,0.002166,172.31.40.0-255,66,101872,65,186152
27964,0.002179,172.31.40.0-255,66,101938,65,186152
27965,0.002218,74.125.24.0-255,4320,106258,65,186152
27966,0.00222,172.31.40.0-255,66,106324,65,186152
27967,0.002258,74.125.24.0-255,6438,112762,65,186152
27968,0.00226,172.31.40.0-255,66,112828,65,186152
27969,0.002287,172.31.40.0-255,66,112894,65,186152
27970,0.002297,172.31.40.0-255,66,112960,65,186152
27971,0.0023,74.125.24.0-255,1484,114444,65,186152
27972,0.002332,74.125.24.0-255,2902,117346,65,186152
27973,0.002334,172.31.40.0-255,66,117412,65,186152
27974,0.002341,74.125.24.0-255,5738,123150,65,186152
27975,0.002343,172.31.40.0-255,66,123216,65,186152
27976,0.00235,74.125.24.0-255,7156,130372,65,186152
27977,0.002357,172.31.40.0-255,66,130438,65,186152
27978,0.002361,74.125.24.0-255,2902,133340,65,186152
27979,0.002363,172.31.40.0-255,66,133406,65,186152
27980,0.002409,172.31.40.0-255,66,133472,65,186152
27981,0.002418,172.31.40.0-255,66,133538,65,186152
27982,0.002428,172.31.40.0-255,66,133604,65,186152
27983,0.002437,74.125.24.0-255,4320,137924,65,186152
27984,0.00244,172.31.40.0-255,66,137990,65,186152
27985,0.002485,172.31.40.0-255,66,138056,65,186152
27986,0.002488,74.125.24.0-255,2184,140240,65,186152
27987,0.00249,172.31.40.0-255,66,140306,65,186152
27988,0.002497,74.125.24.0-255,7156,147462,65,186152
27989,0.002499,172.31.40.0-255,66,147528,65,186152
27990,0.002541,172.31.40.0-255,66,147594,65,186152
27991,0.002548,74.125.24.0-255,7156,154750,65,186152
27992,0.00255,172.31.40.0-255,66,154816,65,186152
27993,0.002586,74.125.24.0-255,2184,157000,65,186152
27994,0.002593,172.31.40.0-255,66,157066,65,186152
27995,0.00261,172.31.40.0-255,66,157132,65,186152
27996,0.005123,74.125.24.0-255,5738,162870,65,186152
27997,0.005132,172.31.40.0-255,66,162936,65,186152
27998,0.007672,74.125.24.0-255,5738,168674,65,186152
27999,0.010999,172.31.40.0-255,66,168740,65,186152
28000,0.013529,74.125.24.0-255,5738,174478,65,186152
28001,0.013539,172.31.40.0-255,66,174544,65,186152
28002,0.016112,74.125.24.0-255,5738,180282,65,186152
28003,0.016116,172.31.40.0-255,66,180348,65,186152
28004,0.018643,74.125.24.0-255,5738,186086,65,186152
28005,0.018651,172.31.40.0-255,66,186152,65,186152
28006,0.0,172.217.27.0-255,146,146,65,125821
28007,2.5e-05,172.31.40.0-255,66,212,65,125821
28008,3.3e-05,172.217.27.0-255,1484,1696,65,125821
28009,3.8e-05,172.31.40.0-255,66,1762,65,125821
28010,4.3e-05,172.217.27.0-255,2902,4664,65,125821
28011,4.6e-05,172.31.40.0-255,66,4730,65,125821
28012,5.2e-05,172.217.27.0-255,4320,9050,65,125821
28013,5.5e-05,172.31.40.0-255,66,9116,65,125821
28014,7.4e-05,172.217.27.0-255,1484,10600,65,125821
28015,7.7e-05,172.31.40.0-255,66,10666,65,125821
28016,0.00014,172.217.27.0-255,1484,12150,65,125821
28017,0.000143,172.31.40.0-255,66,12216,65,125821
28018,0.000156,172.217.27.0-255,2099,14315,65,125821
28019,0.000159,172.31.40.0-255,66,14381,65,125821
28020,0.000211,172.217.27.0-255,4320,18701,65,125821
28021,0.000216,172.31.40.0-255,66,18767,65,125821
28022,0.000299,172.217.27.0-255,7156,25923,65,125821
28023,0.000303,172.31.40.0-255,66,25989,65,125821
28024,0.000322,172.217.27.0-255,2902,28891,65,125821
28025,0.000324,172.31.40.0-255,66,28957,65,125821
28026,0.000455,172.31.40.0-255,66,29023,65,125821
28027,0.000477,172.217.27.0-255,5020,34043,65,125821
28028,0.00048,172.31.40.0-255,66,34109,65,125821
28029,0.000769,172.217.27.0-255,7156,41265,65,125821
28030,0.000774,172.31.40.0-255,66,41331,65,125821
28031,0.000888,172.217.27.0-255,5738,47069,65,125821
28032,0.000892,172.31.40.0-255,66,47135,65,125821
28033,0.000908,172.217.27.0-255,4285,51420,65,125821
28034,0.00091,172.31.40.0-255,66,51486,65,125821
28035,0.001054,172.217.27.0-255,2902,54388,65,125821
28036,0.001058,172.31.40.0-255,66,54454,65,125821
28037,0.001089,172.31.40.0-255,66,54520,65,125821
28038,0.001358,172.31.40.0-255,66,54586,65,125821
28039,0.001399,172.217.27.0-255,5379,59965,65,125821
28040,0.001402,172.31.40.0-255,66,60031,65,125821
28041,0.001628,172.217.27.0-255,5738,65769,65,125821
28042,0.001633,172.31.40.0-255,66,65835,65,125821
28043,0.001667,172.31.40.0-255,66,65901,65,125821
28044,0.001694,172.31.40.0-255,66,65967,65,125821
28045,0.002196,172.217.27.0-255,4320,70287,65,125821
28046,0.002203,172.31.40.0-255,66,70353,65,125821
28047,0.002239,172.31.40.0-255,66,70419,65,125821
28048,0.002288,172.31.40.0-255,66,70485,65,125821
28049,0.003907,172.217.27.0-255,5738,76223,65,125821
28050,0.003913,172.31.40.0-255,66,76289,65,125821
28051,0.005525,172.217.27.0-255,4320,80609,65,125821
28052,0.005529,172.31.40.0-255,66,80675,65,125821
28053,0.005546,172.217.27.0-255,1484,82159,65,125821
28054,0.007144,172.217.27.0-255,4320,86479,65,125821
28055,0.007147,172.31.40.0-255,66,86545,65,125821
28056,0.008762,172.217.27.0-255,5738,92283,65,125821
28057,0.008769,172.31.40.0-255,66,92349,65,125821
28058,0.010383,172.217.27.0-255,5738,98087,65,125821
28059,0.01039,172.31.40.0-255,66,98153,65,125821
28060,0.012012,172.217.27.0-255,4320,102473,65,125821
28061,0.012019,172.31.40.0-255,66,102539,65,125821
28062,0.012036,172.217.27.0-255,1484,104023,65,125821
28063,0.013649,172.217.27.0-255,4320,108343,65,125821
28064,0.013657,172.31.40.0-255,66,108409,65,125821
28065,0.015318,172.217.27.0-255,5738,114147,65,125821
28066,0.015324,172.31.40.0-255,66,114213,65,125821
28067,0.016951,172.217.27.0-255,5738,119951,65,125821
28068,0.016958,172.31.40.0-255,66,120017,65,125821
28069,0.01859,172.217.27.0-255,5738,125755,65,125821
28070,0.018597,172.31.40.0-255,66,125821,65,125821
28071,0.0,74.125.130.0-255,146,146,65,223179
28072,2.2e-05,172.31.40.0-255,66,212,65,223179
28073,2.9e-05,74.125.130.0-255,1484,1696,65,223179
28074,3.4e-05,172.31.40.0-255,66,1762,65,223179
28075,3.9e-05,74.125.130.0-255,2902,4664,65,223179
28076,4.2e-05,172.31.40.0-255,66,4730,65,223179
28077,4.5e-05,74.125.130.0-255,1484,6214,65,223179
28078,4.8e-05,172.31.40.0-255,66,6280,65,223179
28079,6.9e-05,74.125.130.0-255,4320,10600,65,223179
28080,7.2e-05,172.31.40.0-255,66,10666,65,223179
28081,9e-05,74.125.130.0-255,4320,14986,65,223179
28082,9.3e-05,172.31.40.0-255,66,15052,65,223179
28083,0.000105,74.125.130.0-255,2022,17074,65,223179
28084,0.000107,172.31.40.0-255,66,17140,65,223179
28085,0.00011,74.125.130.0-255,1484,18624,65,223179
28086,0.000112,172.31.40.0-255,66,18690,65,223179
28087,0.000126,74.125.130.0-255,2902,21592,65,223179
28088,0.000128,172.31.40.0-255,66,21658,65,223179
28089,0.000146,74.125.130.0-255,4320,25978,65,223179
28090,0.000149,172.31.40.0-255,66,26044,65,223179
28091,0.000161,74.125.130.0-255,1484,27528,65,223179
28092,0.000163,172.31.40.0-255,66,27594,65,223179
28093,0.000166,74.125.130.0-255,1484,29078,65,223179
28094,0.000168,172.31.40.0-255,66,29144,65,223179
28095,0.000214,74.125.130.0-255,2543,31687,65,223179
28096,0.000217,172.31.40.0-255,66,31753,65,223179
28097,0.000386,74.125.130.0-255,1484,33237,65,223179
28098,0.000391,172.31.40.0-255,66,33303,65,223179
28099,0.000395,74.125.130.0-255,1484,34787,65,223179
28100,0.000399,172.31.40.0-255,66,34853,65,223179
28101,0.000412,74.125.130.0-255,1484,36337,65,223179
28102,0.000414,172.31.40.0-255,66,36403,65,223179
28103,0.000435,74.125.130.0-255,4320,40723,65,223179
28104,0.000437,172.31.40.0-255,66,40789,65,223179
28105,0.000463,74.125.130.0-255,2902,43691,65,223179
28106,0.000465,172.31.40.0-255,66,43757,65,223179
28107,0.000487,74.125.130.0-255,5379,49136,65,223179
28108,0.000489,172.31.40.0-255,66,49202,65,223179
28109,0.000544,172.31.40.0-255,66,49268,65,223179
28110,0.000568,74.125.130.0-255,5738,55006,65,223179
28111,0.000571,172.31.40.0-255,66,55072,65,223179
28112,0.00059,74.125.130.0-255,2543,57615,65,223179
28113,0.000593,172.31.40.0-255,66,57681,65,223179
28114,0.000596,74.125.130.0-255,343,58024,65,223179
28115,0.000766,74.125.130.0-255,1484,59508,65,223179
28116,0.00077,172.31.40.0-255,66,59574,65,223179
28117,0.000788,74.125.130.0-255,2902,62476,65,223179
28118,0.000791,172.31.40.0-255,66,62542,65,223179
28119,0.000813,74.125.130.0-255,5738,68280,65,223179
28120,0.000816,172.31.40.0-255,66,68346,65,223179
28121,0.000845,74.125.130.0-255,4320,72666,65,223179
28122,0.000848,172.31.40.0-255,66,72732,65,223179
28123,0.000867,74.125.130.0-255,2297,75029,65,223179
28124,0.000869,172.31.40.0-255,66,75095,65,223179
28125,0.000978,74.125.130.0-255,1484,76579,65,223179
28126,0.000991,74.125.130.0-255,1484,78063,65,223179
28127,0.000994,172.31.40.0-255,66,78129,65,223179
28128,0.001015,74.125.130.0-255,1484,79613,65,223179
28129,0.001027,74.125.130.0-255,1484,81097,65,223179
28130,0.001029,172.31.40.0-255,66,81163,65,223179
28131,0.001044,74.125.130.0-255,2902,84065,65,223179
28132,0.001046,172.31.40.0-255,66,84131,65,223179
28133,0.001067,74.125.130.0-255,4320,88451,65,223179
28134,0.00107,172.31.40.0-255,66,88517,65,223179
28135,0.001103,74.125.130.0-255,5738,94255,65,223179
28136,0.001106,172.31.40.0-255,66,94321,65,223179
28137,0.001111,74.125.130.0-255,2902,97223,65,223179
28138,0.001113,172.31.40.0-255,66,97289,65,223179
28139,0.001128,74.125.130.0-255,2902,100191,65,223179
28140,0.001131,172.31.40.0-255,66,100257,65,223179
28141,0.001134,74.125.130.0-255,1484,101741,65,223179
28142,0.001149,74.125.130.0-255,5738,107479,65,223179
28143,0.001152,172.31.40.0-255,66,107545,65,223179
28144,0.001173,74.125.130.0-255,2184,109729,65,223179
28145,0.001175,172.31.40.0-255,66,109795,65,223179
28146,0.001313,74.125.130.0-255,1484,111279,65,223179
28147,0.001333,74.125.130.0-255,2902,114181,65,223179
28148,0.001337,172.31.40.0-255,66,114247,65,223179
28149,0.001355,74.125.130.0-255,1484,115731,65,223179
28150,0.001378,74.125.130.0-255,4320,120051,65,223179
28151,0.001382,172.31.40.0-255,66,120117,65,223179
28152,0.001385,74.125.130.0-255,1484,121601,65,223179
28153,0.001389,74.125.130.0-255,2902,124503,65,223179
28154,0.001391,172.31.40.0-255,66,124569,65,223179
28155,0.001423,74.125.130.0-255,5738,130307,65,223179
28156,0.001426,172.31.40.0-255,66,130373,65,223179
28157,0.00143,74.125.130.0-255,2902,133275,65,223179
28158,0.001433,172.31.40.0-255,66,133341,65,223179
28159,0.001439,74.125.130.0-255,4320,137661,65,223179
28160,0.001441,172.31.40.0-255,66,137727,65,223179
28161,0.001477,74.125.130.0-255,2902,140629,65,223179
28162,0.00148,172.31.40.0-255,66,140695,65,223179
28163,0.001497,74.125.130.0-255,3602,144297,65,223179
28164,0.0015,172.31.40.0-255,66,144363,65,223179
28165,0.001652,74.125.130.0-255,1484,145847,65,223179
28166,0.001668,74.125.130.0-255,1484,147331,65,223179
28167,0.001671,172.31.40.0-255,66,147397,65,223179
28168,0.001685,74.125.130.0-255,2902,150299,65,223179
28169,0.001688,172.31.40.0-255,66,150365,65,223179
28170,0.001706,74.125.130.0-255,2902,153267,65,223179
28171,0.001709,172.31.40.0-255,66,153333,65,223179
28172,0.001743,74.125.130.0-255,2902,156235,65,223179
28173,0.001747,172.31.40.0-255,66,156301,65,223179
28174,0.001751,74.125.130.0-255,2902,159203,65,223179
28175,0.001753,172.31.40.0-255,66,159269,65,223179
28176,0.001759,74.125.130.0-255,4320,163589,65,223179
28177,0.001761,172.31.40.0-255,66,163655,65,223179
28178,0.001797,74.125.130.0-255,7156,170811,65,223179
28179,0.001802,172.31.40.0-255,66,170877,65,223179
28180,0.001821,172.31.40.0-255,66,170943,65,223179
28181,0.003825,74.125.130.0-255,5738,176681,65,223179
28182,0.003833,172.31.40.0-255,66,176747,65,223179
28183,0.005843,74.125.130.0-255,5738,182485,65,223179
28184,0.005847,172.31.40.0-255,66,182551,65,223179
28185,0.007849,74.125.130.0-255,5738,188289,65,223179
28186,0.007855,172.31.40.0-255,66,188355,65,223179
28187,0.009862,74.125.130.0-255,5738,194093,65,223179
28188,0.009868,172.31.40.0-255,66,194159,65,223179
28189,0.011867,74.125.130.0-255,5738,199897,65,223179
28190,0.011875,172.31.40.0-255,66,199963,65,223179
28191,0.013877,74.125.130.0-255,5738,205701,65,223179
28192,0.013885,172.31.40.0-255,66,205767,65,223179
28193,0.015891,74.125.130.0-255,5738,211505,65,223179
28194,0.015898,172.31.40.0-255,66,211571,65,223179
28195,0.017938,74.125.130.0-255,5738,217309,65,223179
28196,0.017945,172.31.40.0-255,66,217375,65,223179
28197,0.019948,74.125.130.0-255,5738,223113,65,223179
28198,0.019955,172.31.40.0-255,66,223179,65,223179
28199,0.0,172.217.194.0-255,153,153,65,175705
28200,1.7e-05,172.31.40.0-255,66,219,65,175705
28201,2.4e-05,172.217.194.0-255,1484,1703,65,175705
28202,2.9e-05,172.31.40.0-255,66,1769,65,175705
28203,4.4e-05,172.217.194.0-255,2902,4671,65,175705
28204,4.7e-05,172.31.40.0-255,66,4737,65,175705
28205,5.5e-05,172.217.194.0-255,7156,11893,65,175705
28206,5.7e-05,172.31.40.0-255,66,11959,65,175705
28207,7.2e-05,172.31.40.0-255,66,12025,65,175705
28208,7.8e-05,172.217.194.0-255,6797,18822,65,175705
28209,8.2e-05,172.31.40.0-255,66,18888,65,175705
28210,0.000187,172.217.194.0-255,1484,20372,65,175705
28211,0.000191,172.31.40.0-255,66,20438,65,175705
28212,0.000197,172.217.194.0-255,2902,23340,65,175705
28213,0.000199,172.31.40.0-255,66,23406,65,175705
28214,0.000218,172.217.194.0-255,5738,29144,65,175705
28215,0.000225,172.31.40.0-255,66,29210,65,175705
28216,0.000228,172.217.194.0-255,1484,30694,65,175705
28217,0.00023,172.31.40.0-255,66,30760,65,175705
28218,0.000269,172.217.194.0-255,5379,36139,65,175705
28219,0.000272,172.31.40.0-255,66,36205,65,175705
28220,0.000286,172.31.40.0-255,66,36271,65,175705
28221,0.000318,172.217.194.0-255,2902,39173,65,175705
28222,0.000321,172.31.40.0-255,66,39239,65,175705
28223,0.000325,172.217.194.0-255,2794,42033,65,175705
28224,0.000327,172.31.40.0-255,66,42099,65,175705
28225,0.00033,172.217.194.0-255,121,42220,65,175705
28226,0.000334,172.31.40.0-255,66,42286,65,175705
28227,0.000497,172.217.194.0-255,1484,43770,65,175705
28228,0.000503,172.31.40.0-255,66,43836,65,175705
28229,0.000508,172.217.194.0-255,2902,46738,65,175705
28230,0.000511,172.31.40.0-255,66,46804,65,175705
28231,0.000522,172.217.194.0-255,5738,52542,65,175705
28232,0.000525,172.31.40.0-255,66,52608,65,175705
28233,0.000528,172.217.194.0-255,1484,54092,65,175705
28234,0.000556,172.31.40.0-255,66,54158,65,175705
28235,0.000605,172.31.40.0-255,66,54224,65,175705
28236,0.000785,172.217.194.0-255,1484,55708,65,175705
28237,0.000791,172.217.194.0-255,2902,58610,65,175705
28238,0.000794,172.31.40.0-255,66,58676,65,175705
28239,0.000801,172.217.194.0-255,4320,62996,65,175705
28240,0.000804,172.31.40.0-255,66,63062,65,175705
28241,0.000828,172.217.194.0-255,1484,64546,65,175705
28242,0.000848,172.31.40.0-255,66,64612,65,175705
28243,0.000853,172.217.194.0-255,2902,67514,65,175705
28244,0.000855,172.31.40.0-255,66,67580,65,175705
28245,0.000872,172.31.40.0-255,66,67646,65,175705
28246,0.000909,172.217.194.0-255,1633,69279,65,175705
28247,0.000912,172.31.40.0-255,66,69345,65,175705
28248,0.000927,172.31.40.0-255,66,69411,65,175705
28249,0.001007,172.31.40.0-255,66,69477,65,175705
28250,0.001117,172.217.194.0-255,1484,70961,65,175705
28251,0.001123,172.217.194.0-255,2902,73863,65,175705
28252,0.001139,172.217.194.0-255,5738,79601,65,175705
28253,0.001148,172.31.40.0-255,66,79667,65,175705
28254,0.001157,172.217.194.0-255,2902,82569,65,175705
28255,0.001162,172.31.40.0-255,66,82635,65,175705
28256,0.001185,172.217.194.0-255,7156,89791,65,175705
28257,0.001205,172.217.194.0-255,1484,91275,65,175705
28258,0.001224,172.31.40.0-255,66,91341,65,175705
28259,0.001245,172.31.40.0-255,66,91407,65,175705
28260,0.0016,172.217.194.0-255,1484,92891,65,175705
28261,0.001618,172.217.194.0-255,2902,95793,65,175705
28262,0.001622,172.31.40.0-255,66,95859,65,175705
28263,0.001627,172.217.194.0-255,2902,98761,65,175705
28264,0.001629,172.31.40.0-255,66,98827,65,175705
28265,0.001645,172.217.194.0-255,2902,101729,65,175705
28266,0.001647,172.31.40.0-255,66,101795,65,175705
28267,0.001669,172.217.194.0-255,2902,104697,65,175705
28268,0.001698,172.31.40.0-255,66,104763,65,175705
28269,0.001735,172.31.40.0-255,66,104829,65,175705
28270,0.001878,172.217.194.0-255,1484,106313,65,175705
28271,0.001884,172.217.194.0-255,2902,109215,65,175705
28272,0.001922,172.217.194.0-255,5738,114953,65,175705
28273,0.001929,172.217.194.0-255,7156,122109,65,175705
28274,0.001946,172.217.194.0-255,1484,123593,65,175705
28275,0.00195,172.31.40.0-255,66,123659,65,175705
28276,0.001998,172.217.194.0-255,2184,125843,65,175705
28277,0.002024,172.31.40.0-255,66,125909,65,175705
28278,0.002091,172.217.194.0-255,1484,127393,65,175705
28279,0.002104,172.217.194.0-255,2902,130295,65,175705
28280,0.002107,172.31.40.0-255,66,130361,65,175705
28281,0.00211,172.217.194.0-255,1484,131845,65,175705
28282,0.002135,172.217.194.0-255,4320,136165,65,175705
28283,0.002138,172.217.194.0-255,1484,137649,65,175705
28284,0.002161,172.31.40.0-255,66,137715,65,175705
28285,0.002217,172.217.194.0-255,2902,140617,65,175705
28286,0.002225,172.31.40.0-255,66,140683,65,175705
28287,0.00228,172.31.40.0-255,66,140749,65,175705
28288,0.002293,172.217.194.0-255,5738,146487,65,175705
28289,0.00232,172.31.40.0-255,66,146553,65,175705
28290,0.002392,172.31.40.0-255,66,146619,65,175705
28291,0.004688,172.217.194.0-255,5738,152357,65,175705
28292,0.0047,172.31.40.0-255,66,152423,65,175705
28293,0.006979,172.217.194.0-255,5738,158161,65,175705
28294,0.011801,172.31.40.0-255,66,158227,65,175705
28295,0.014127,172.217.194.0-255,1484,159711,65,175705
28296,0.014148,172.217.194.0-255,4320,164031,65,175705
28297,0.014155,172.31.40.0-255,66,164097,65,175705
28298,0.016435,172.217.194.0-255,5738,169835,65,175705
28299,0.016449,172.31.40.0-255,66,169901,65,175705
28300,0.018721,172.217.194.0-255,5738,175639,65,175705
28301,0.018739,172.31.40.0-255,66,175705,65,175705
28302,0.0,74.125.24.0-255,147,147,65,125309
28303,1.4e-05,172.31.40.0-255,66,213,65,125309
28304,2e-05,74.125.24.0-255,1484,1697,65,125309
28305,2.5e-05,172.31.40.0-255,66,1763,65,125309
28306,3e-05,74.125.24.0-255,2902,4665,65,125309
28307,3.3e-05,172.31.40.0-255,66,4731,65,125309
28308,5e-05,74.125.24.0-255,5738,10469,65,125309
28309,5.3e-05,172.31.40.0-255,66,10535,65,125309
28310,7.5e-05,74.125.24.0-255,1484,12019,65,125309
28311,7.7e-05,172.31.40.0-255,66,12085,65,125309
28312,8.2e-05,74.125.24.0-255,1988,14073,65,125309
28313,8.4e-05,172.31.40.0-255,66,14139,65,125309
28314,0.000653,74.125.24.0-255,1484,15623,65,125309
28315,0.000661,172.31.40.0-255,66,15689,65,125309
28316,0.000669,74.125.24.0-255,2902,18591,65,125309
28317,0.000672,172.31.40.0-255,66,18657,65,125309
28318,0.000677,74.125.24.0-255,2902,21559,65,125309
28319,0.000679,172.31.40.0-255,66,21625,65,125309
28320,0.000693,74.125.24.0-255,2902,24527,65,125309
28321,0.000696,172.31.40.0-255,66,24593,65,125309
28322,0.000725,74.125.24.0-255,4320,28913,65,125309
28323,0.000728,172.31.40.0-255,66,28979,65,125309
28324,0.000747,74.125.24.0-255,2543,31522,65,125309
28325,0.000751,172.31.40.0-255,66,31588,65,125309
28326,0.000936,74.125.24.0-255,1484,33072,65,125309
28327,0.000942,172.31.40.0-255,66,33138,65,125309
28328,0.000947,74.125.24.0-255,1484,34622,65,125309
28329,0.00095,172.31.40.0-255,66,34688,65,125309
28330,0.000962,74.125.24.0-255,1484,36172,65,125309
28331,0.000964,172.31.40.0-255,66,36238,65,125309
28332,0.000991,74.125.24.0-255,5738,41976,65,125309
28333,0.000993,172.31.40.0-255,66,42042,65,125309
28334,0.001017,74.125.24.0-255,6797,48839,65,125309
28335,0.00102,172.31.40.0-255,66,48905,65,125309
28336,0.001023,74.125.24.0-255,1484,50389,65,125309
28337,0.001049,172.31.40.0-255,66,50455,65,125309
28338,0.001068,74.125.24.0-255,1484,51939,65,125309
28339,0.001073,74.125.24.0-255,2543,54482,65,125309
28340,0.001075,172.31.40.0-255,66,54548,65,125309
28341,0.001078,74.125.24.0-255,399,54947,65,125309
28342,0.001279,74.125.24.0-255,112,55059,65,125309
28343,0.001285,74.125.24.0-255,330,55389,65,125309
28344,0.001582,74.125.24.0-255,1484,56873,65,125309
28345,0.001588,172.31.40.0-255,66,56939,65,125309
28346,0.001595,74.125.24.0-255,2902,59841,65,125309
28347,0.001598,172.31.40.0-255,66,59907,65,125309
28348,0.001602,74.125.24.0-255,2902,62809,65,125309
28349,0.001605,172.31.40.0-255,66,62875,65,125309
28350,0.001624,74.125.24.0-255,2902,65777,65,125309
28351,0.001626,172.31.40.0-255,66,65843,65,125309
28352,0.001631,74.125.24.0-255,2902,68745,65,125309
28353,0.001634,172.31.40.0-255,66,68811,65,125309
28354,0.001663,172.31.40.0-255,66,68877,65,125309
28355,0.001673,172.31.40.0-255,66,68943,65,125309
28356,0.001692,74.125.24.0-255,2184,71127,65,125309
28357,0.001694,172.31.40.0-255,66,71193,65,125309
28358,0.00217,74.125.24.0-255,1484,72677,65,125309
28359,0.002174,74.125.24.0-255,1484,74161,65,125309
28360,0.002177,172.31.40.0-255,66,74227,65,125309
28361,0.00219,74.125.24.0-255,1484,75711,65,125309
28362,0.002197,74.125.24.0-255,5738,81449,65,125309
28363,0.0022,172.31.40.0-255,66,81515,65,125309
28364,0.002229,172.31.40.0-255,66,81581,65,125309
28365,0.002274,74.125.24.0-255,4320,85901,65,125309
28366,0.002276,172.31.40.0-255,66,85967,65,125309
28367,0.002289,172.31.40.0-255,66,86033,65,125309
28368,0.004615,74.125.24.0-255,4320,90353,65,125309
28369,0.004628,172.31.40.0-255,66,90419,65,125309
28370,0.004632,74.125.24.0-255,1484,91903,65,125309
28371,0.006948,74.125.24.0-255,4320,96223,65,125309
28372,0.006955,172.31.40.0-255,66,96289,65,125309
28373,0.009278,74.125.24.0-255,5738,102027,65,125309
28374,0.009286,172.31.40.0-255,66,102093,65,125309
28375,0.011663,74.125.24.0-255,5738,107831,65,125309
28376,0.011671,172.31.40.0-255,66,107897,65,125309
28377,0.014042,74.125.24.0-255,5738,113635,65,125309
28378,0.014051,172.31.40.0-255,66,113701,65,125309
28379,0.016425,74.125.24.0-255,5738,119439,65,125309
28380,0.016433,172.31.40.0-255,66,119505,65,125309
28381,0.018806,74.125.24.0-255,5738,125243,65,125309
28382,0.018814,172.31.40.0-255,66,125309,65,125309
28383,0.0,74.125.24.0-255,149,149,65,214696
28384,2.5e-05,172.31.40.0-255,66,215,65,214696
28385,3.3e-05,74.125.24.0-255,1484,1699,65,214696
28386,3.8e-05,172.31.40.0-255,66,1765,65,214696
28387,4.4e-05,74.125.24.0-255,2902,4667,65,214696
28388,4.7e-05,172.31.40.0-255,66,4733,65,214696
28389,5.4e-05,74.125.24.0-255,7156,11889,65,214696
28390,5.7e-05,172.31.40.0-255,66,11955,65,214696
28391,6.1e-05,74.125.24.0-255,2151,14106,65,214696
28392,6.4e-05,172.31.40.0-255,66,14172,65,214696
28393,0.00012,74.125.24.0-255,1484,15656,65,214696
28394,0.000123,172.31.40.0-255,66,15722,65,214696
28395,0.000138,74.125.24.0-255,2902,18624,65,214696
28396,0.000141,172.31.40.0-255,66,18690,65,214696
28397,0.000158,74.125.24.0-255,4320,23010,65,214696
28398,0.000161,172.31.40.0-255,66,23076,65,214696
28399,0.000179,74.125.24.0-255,1484,24560,65,214696
28400,0.000181,172.31.40.0-255,66,24626,65,214696
28401,0.000188,74.125.24.0-255,5738,30364,65,214696
28402,0.00019,172.31.40.0-255,66,30430,65,214696
28403,0.000225,74.125.24.0-255,2902,33332,65,214696
28404,0.000228,172.31.40.0-255,66,33398,65,214696
28405,0.000256,172.31.40.0-255,66,33464,65,214696
28406,0.000273,74.125.24.0-255,1125,34589,65,214696
28407,0.000275,172.31.40.0-255,66,34655,65,214696
28408,0.000282,74.125.24.0-255,5379,40034,65,214696
28409,0.000285,172.31.40.0-255,66,40100,65,214696
28410,0.000289,74.125.24.0-255,2902,43002,65,214696
28411,0.000291,172.31.40.0-255,66,43068,65,214696
28412,0.000309,74.125.24.0-255,2902,45970,65,214696
28413,0.000311,172.31.40.0-255,66,46036,65,214696
28414,0.000324,74.125.24.0-255,1484,47520,65,214696
28415,0.000353,172.31.40.0-255,66,47586,65,214696
28416,0.000356,74.125.24.0-255,361,47947,65,214696
28417,0.000378,74.125.24.0-255,413,48360,65,214696
28418,0.000603,74.125.24.0-255,1484,49844,65,214696
28419,0.000608,172.31.40.0-255,66,49910,65,214696
28420,0.000612,74.125.24.0-255,2902,52812,65,214696
28421,0.000615,172.31.40.0-255,66,52878,65,214696
28422,0.000617,74.125.24.0-255,1484,54362,65,214696
28423,0.000645,74.125.24.0-255,2902,57264,65,214696
28424,0.000648,172.31.40.0-255,66,57330,65,214696
28425,0.000659,172.31.40.0-255,66,57396,65,214696
28426,0.000682,74.125.24.0-255,7156,64552,65,214696
28427,0.000686,172.31.40.0-255,66,64618,65,214696
28428,0.000712,172.31.40.0-255,66,64684,65,214696
28429,0.001101,74.125.24.0-255,1484,66168,65,214696
28430,0.001106,74.125.24.0-255,1484,67652,65,214696
28431,0.001108,172.31.40.0-255,66,67718,65,214696
28432,0.001126,74.125.24.0-255,1484,69202,65,214696
28433,0.00115,74.125.24.0-255,5738,74940,65,214696
28434,0.001153,172.31.40.0-255,66,75006,65,214696
28435,0.001167,172.31.40.0-255,66,75072,65,214696
28436,0.001172,74.125.24.0-255,4320,79392,65,214696
28437,0.001173,172.31.40.0-255,66,79458,65,214696
28438,0.001216,74.125.24.0-255,6438,85896,65,214696
28439,0.001219,172.31.40.0-255,66,85962,65,214696
28440,0.001259,74.125.24.0-255,1484,87446,65,214696
28441,0.001264,74.125.24.0-255,2902,90348,65,214696
28442,0.001267,172.31.40.0-255,66,90414,65,214696
28443,0.001278,74.125.24.0-255,1484,91898,65,214696
28444,0.001296,74.125.24.0-255,4320,96218,65,214696
28445,0.001298,172.31.40.0-255,66,96284,65,214696
28446,0.001302,74.125.24.0-255,1484,97768,65,214696
28447,0.001329,172.31.40.0-255,66,97834,65,214696
28448,0.001336,74.125.24.0-255,7156,104990,65,214696
28449,0.001338,172.31.40.0-255,66,105056,65,214696
28450,0.001393,74.125.24.0-255,3602,108658,65,214696
28451,0.001396,172.31.40.0-255,66,108724,65,214696
28452,0.001416,74.125.24.0-255,4320,113044,65,214696
28453,0.00142,172.31.40.0-255,66,113110,65,214696
28454,0.001426,74.125.24.0-255,4320,117430,65,214696
28455,0.001428,172.31.40.0-255,66,117496,65,214696
28456,0.001451,74.125.24.0-255,1484,118980,65,214696
28457,0.001465,172.31.40.0-255,66,119046,65,214696
28458,0.001506,172.31.40.0-255,66,119112,65,214696
28459,0.001548,74.125.24.0-255,1484,120596,65,214696
28460,0.001608,74.125.24.0-255,2902,123498,65,214696
28461,0.001612,172.31.40.0-255,66,123564,65,214696
28462,0.001618,74.125.24.0-255,5738,129302,65,214696
28463,0.001621,172.31.40.0-255,66,129368,65,214696
28464,0.001636,172.31.40.0-255,66,129434,65,214696
28465,0.001642,74.125.24.0-255,5738,135172,65,214696
28466,0.001644,172.31.40.0-255,66,135238,65,214696
28467,0.001661,74.125.24.0-255,1484,136722,65,214696
28468,0.001684,74.125.24.0-255,3602,140324,65,214696
28469,0.001687,172.31.40.0-255,66,140390,65,214696
28470,0.001713,74.125.24.0-255,1484,141874,65,214696
28471,0.001726,74.125.24.0-255,4320,146194,65,214696
28472,0.001729,172.31.40.0-255,66,146260,65,214696
28473,0.001746,74.125.24.0-255,1484,147744,65,214696
28474,0.001765,74.125.24.0-255,4320,152064,65,214696
28475,0.001769,172.31.40.0-255,66,152130,65,214696
28476,0.001772,74.125.24.0-255,1484,153614,65,214696
28477,0.001804,172.31.40.0-255,66,153680,65,214696
28478,0.00182,172.31.40.0-255,66,153746,65,214696
28479,0.001834,172.31.40.0-255,66,153812,65,214696
28480,0.001849,172.31.40.0-255,66,153878,65,214696
28481,0.001871,74.125.24.0-255,2902,156780,65,214696
28482,0.001874,172.31.40.0-255,66,156846,65,214696
28483,0.001889,74.125.24.0-255,2184,159030,65,214696
28484,0.001891,172.31.40.0-255,66,159096,65,214696
28485,0.001948,74.125.24.0-255,1484,160580,65,214696
28486,0.001953,74.125.24.0-255,2902,163482,65,214696
28487,0.001956,172.31.40.0-255,66,163548,65,214696
28488,0.001971,74.125.24.0-255,1484,165032,65,214696
28489,0.00199,74.125.24.0-255,2902,167934,65,214696
28490,0.001993,172.31.40.0-255,66,168000,65,214696
28491,0.002015,74.125.24.0-255,2902,170902,65,214696
28492,0.002018,172.31.40.0-255,66,170968,65,214696
28493,0.002039,74.125.24.0-255,2902,173870,65,214696
28494,0.002041,172.31.40.0-255,66,173936,65,214696
28495,0.002056,172.31.40.0-255,66,174002,65,214696
28496,0.002067,172.31.40.0-255,66,174068,65,214696
28497,0.004364,74.125.24.0-255,5738,179806,65,214696
28498,0.004375,172.31.40.0-255,66,179872,65,214696
28499,0.006666,74.125.24.0-255,5738,185610,65,214696
28500,0.006673,172.31.40.0-255,66,185676,65,214696
28501,0.008983,74.125.24.0-255,5738,191414,65,214696
28502,0.009002,172.31.40.0-255,66,191480,65,214696
28503,0.011336,74.125.24.0-255,5738,197218,65,214696
28504,0.011349,172.31.40.0-255,66,197284,65,214696
28505,0.013704,74.125.24.0-255,5738,203022,65,214696
28506,0.013716,172.31.40.0-255,66,203088,65,214696
28507,0.015965,74.125.24.0-255,5738,208826,65,214696
28508,0.015974,172.31.40.0-255,66,208892,65,214696
28509,0.018229,74.125.24.0-255,5738,214630,65,214696
28510,0.018237,172.31.40.0-255,66,214696,65,214696
28511,0.0,172.31.40.0-255,105,105,65,459
28512,0.000259,172.31.40.0-255,90,195,65,459
28513,0.00027,172.31.40.0-255,66,261,65,459
28514,0.002689,172.217.194.0-255,66,327,65,459
28515,0.002705,172.217.194.0-255,66,393,65,459
28516,0.002719,172.31.40.0-255,66,459,65,459
28517,0.0,172.217.194.0-255,153,153,65,180830
28518,2.4e-05,172.31.40.0-255,66,219,65,180830
28519,3.1e-05,172.217.194.0-255,1484,1703,65,180830
28520,3.6e-05,172.31.40.0-255,66,1769,65,180830
28521,4.1e-05,172.217.194.0-255,2902,4671,65,180830
28522,4.4e-05,172.31.40.0-255,66,4737,65,180830
28523,5e-05,172.217.194.0-255,2902,7639,65,180830
28524,5.3e-05,172.31.40.0-255,66,7705,65,180830
28525,7.5e-05,172.217.194.0-255,4320,12025,65,180830
28526,7.8e-05,172.31.40.0-255,66,12091,65,180830
28527,8.5e-05,172.217.194.0-255,7156,19247,65,180830
28528,8.8e-05,172.31.40.0-255,66,19313,65,180830
28529,0.000118,172.217.194.0-255,2166,21479,65,180830
28530,0.00012,172.31.40.0-255,66,21545,65,180830
28531,0.000134,172.31.40.0-255,66,21611,65,180830
28532,0.000166,172.217.194.0-255,1484,23095,65,180830
28533,0.000168,172.31.40.0-255,66,23161,65,180830
28534,0.000172,172.217.194.0-255,2902,26063,65,180830
28535,0.000174,172.31.40.0-255,66,26129,65,180830
28536,0.00019,172.217.194.0-255,4320,30449,65,180830
28537,0.000192,172.31.40.0-255,66,30515,65,180830
28538,0.000204,172.217.194.0-255,1484,31999,65,180830
28539,0.000206,172.31.40.0-255,66,32065,65,180830
28540,0.00021,172.217.194.0-255,1484,33549,65,180830
28541,0.000211,172.31.40.0-255,66,33615,65,180830
28542,0.000253,172.31.40.0-255,66,33681,65,180830
28543,0.000264,172.31.40.0-255,66,33747,65,180830
28544,0.000267,172.217.194.0-255,122,33869,65,180830
28545,0.00027,172.31.40.0-255,66,33935,65,180830
28546,0.000273,172.217.194.0-255,381,34316,65,180830
28547,0.00058,172.217.194.0-255,1484,35800,65,180830
28548,0.000586,172.31.40.0-255,66,35866,65,180830
28549,0.000592,172.217.194.0-255,2902,38768,65,180830
28550,0.000594,172.31.40.0-255,66,38834,65,180830
28551,0.000601,172.217.194.0-255,5738,44572,65,180830
28552,0.000604,172.31.40.0-255,66,44638,65,180830
28553,0.000638,172.31.40.0-255,66,44704,65,180830
28554,0.00066,172.217.194.0-255,2902,47606,65,180830
28555,0.000674,172.31.40.0-255,66,47672,65,180830
28556,0.000683,172.31.40.0-255,66,47738,65,180830
28557,0.001362,172.217.194.0-255,1484,49222,65,180830
28558,0.001369,172.217.194.0-255,2902,52124,65,180830
28559,0.001373,172.31.40.0-255,66,52190,65,180830
28560,0.001377,172.217.194.0-255,1484,53674,65,180830
28561,0.001397,172.217.194.0-255,4320,57994,65,180830
28562,0.001399,172.31.40.0-255,66,58060,65,180830
28563,0.001405,172.217.194.0-255,5738,63798,65,180830
28564,0.001407,172.31.40.0-255,66,63864,65,180830
28565,0.001421,172.217.194.0-255,1484,65348,65,180830
28566,0.001427,172.217.194.0-255,5738,71086,65,180830
28567,0.001429,172.31.40.0-255,66,71152,65,180830
28568,0.001465,172.31.40.0-255,66,71218,65,180830
28569,0.001471,172.217.194.0-255,2184,73402,65,180830
28570,0.001473,172.31.40.0-255,66,73468,65,180830
28571,0.001588,172.217.194.0-255,1484,74952,65,180830
28572,0.001601,172.217.194.0-255,2902,77854,65,180830
28573,0.001604,172.31.40.0-255,66,77920,65,180830
28574,0.001612,172.217.194.0-255,5738,83658,65,180830
28575,0.001613,172.31.40.0-255,66,83724,65,180830
28576,0.001638,172.217.194.0-255,2902,86626,65,180830
28577,0.001641,172.31.40.0-255,66,86692,65,180830
28578,0.001682,172.217.194.0-255,7156,93848,65,180830
28579,0.001685,172.31.40.0-255,66,93914,65,180830
28580,0.001699,172.217.194.0-255,2902,96816,65,180830
28581,0.001701,172.31.40.0-255,66,96882,65,180830
28582,0.001713,172.31.40.0-255,66,96948,65,180830
28583,0.001797,172.217.194.0-255,1484,98432,65,180830
28584,0.001801,172.217.194.0-255,2902,101334,65,180830
28585,0.001806,172.31.40.0-255,66,101400,65,180830
28586,0.001814,172.217.194.0-255,1484,102884,65,180830
28587,0.001831,172.217.194.0-255,4320,107204,65,180830
28588,0.001833,172.31.40.0-255,66,107270,65,180830
28589,0.001839,172.217.194.0-255,5738,113008,65,180830
28590,0.001841,172.31.40.0-255,66,113074,65,180830
28591,0.001864,172.217.194.0-255,7156,120230,65,180830
28592,0.001867,172.31.40.0-255,66,120296,65,180830
28593,0.001871,172.217.194.0-255,2902,123198,65,180830
28594,0.001874,172.31.40.0-255,66,123264,65,180830
28595,0.001907,172.31.40.0-255,66,123330,65,180830
28596,0.00191,172.217.194.0-255,1484,124814,65,180830
28597,0.001927,172.217.194.0-255,2902,127716,65,180830
28598,0.00193,172.31.40.0-255,66,127782,65,180830
28599,0.001936,172.217.194.0-255,5738,133520,65,180830
28600,0.001938,172.31.40.0-255,66,133586,65,180830
28601,0.001954,172.217.194.0-255,4320,137906,65,180830
28602,0.001956,172.31.40.0-255,66,137972,65,180830
28603,0.001981,172.31.40.0-255,66,138038,65,180830
28604,0.001992,172.31.40.0-255,66,138104,65,180830
28605,0.002013,172.217.194.0-255,1484,139588,65,180830
28606,0.002054,172.31.40.0-255,66,139654,65,180830
28607,0.002074,172.217.194.0-255,2902,142556,65,180830
28608,0.002076,172.31.40.0-255,66,142622,65,180830
28609,0.002097,172.31.40.0-255,66,142688,65,180830
28610,0.002113,172.217.194.0-255,5020,147708,65,180830
28611,0.002115,172.31.40.0-255,66,147774,65,180830
28612,0.002128,172.31.40.0-255,66,147840,65,180830
28613,0.002155,172.217.194.0-255,4320,152160,65,180830
28614,0.002157,172.31.40.0-255,66,152226,65,180830
28615,0.002173,172.31.40.0-255,66,152292,65,180830
28616,0.002185,172.217.194.0-255,1484,153776,65,180830
28617,0.002215,172.31.40.0-255,66,153842,65,180830
28618,0.002251,172.31.40.0-255,66,153908,65,180830
28619,0.002261,172.31.40.0-255,66,153974,65,180830
28620,0.002271,172.31.40.0-255,66,154040,65,180830
28621,0.002307,172.217.194.0-255,1484,155524,65,180830
28622,0.002331,172.31.40.0-255,66,155590,65,180830
28623,0.002337,172.217.194.0-255,6438,162028,65,180830
28624,0.002339,172.31.40.0-255,66,162094,65,180830
28625,0.002352,172.217.194.0-255,1484,163578,65,180830
28626,0.002379,172.31.40.0-255,66,163644,65,180830
28627,0.002397,172.217.194.0-255,4320,167964,65,180830
28628,0.002399,172.31.40.0-255,66,168030,65,180830
28629,0.002405,172.217.194.0-255,5738,173768,65,180830
28630,0.002407,172.31.40.0-255,66,173834,65,180830
28631,0.00243,172.217.194.0-255,6588,180422,65,180830
28632,0.002433,172.31.40.0-255,66,180488,65,180830
28633,0.004748,172.217.194.0-255,105,180593,65,180830
28634,0.010762,172.31.40.0-255,66,180659,65,180830
28635,0.010833,172.31.40.0-255,105,180764,65,180830
28636,0.013156,172.217.194.0-255,66,180830,65,180830
28637,0.0,74.125.24.0-255,300,300,65,168270
28638,1.5e-05,172.31.40.0-255,66,366,65,168270
28639,2e-05,74.125.24.0-255,1484,1850,65,168270
28640,2.5e-05,172.31.40.0-255,66,1916,65,168270
28641,3.3e-05,74.125.24.0-255,4320,6236,65,168270
28642,4.4e-05,172.31.40.0-255,66,6302,65,168270
28643,5.6e-05,172.31.40.0-255,66,6368,65,168270
28644,5.9e-05,74.125.24.0-255,1484,7852,65,168270
28645,6.2e-05,172.31.40.0-255,66,7918,65,168270
28646,0.0001,74.125.24.0-255,7156,15074,65,168270
28647,0.000102,172.31.40.0-255,66,15140,65,168270
28648,0.000114,172.31.40.0-255,66,15206,65,168270
28649,0.000335,74.125.24.0-255,1484,16690,65,168270
28650,0.00034,172.31.40.0-255,66,16756,65,168270
28651,0.000346,74.125.24.0-255,2902,19658,65,168270
28652,0.000349,172.31.40.0-255,66,19724,65,168270
28653,0.000359,74.125.24.0-255,4320,24044,65,168270
28654,0.000362,172.31.40.0-255,66,24110,65,168270
28655,0.000383,74.125.24.0-255,1484,25594,65,168270
28656,0.000385,172.31.40.0-255,66,25660,65,168270
28657,0.000392,74.125.24.0-255,5738,31398,65,168270
28658,0.000395,172.31.40.0-255,66,31464,65,168270
28659,0.000427,74.125.24.0-255,6797,38261,65,168270
28660,0.00043,172.31.40.0-255,66,38327,65,168270
28661,0.000437,74.125.24.0-255,5738,44065,65,168270
28662,0.00044,172.31.40.0-255,66,44131,65,168270
28663,0.000472,74.125.24.0-255,5715,49846,65,168270
28664,0.000475,172.31.40.0-255,66,49912,65,168270
28665,0.000574,74.125.24.0-255,342,50254,65,168270
28666,0.000579,172.31.40.0-255,66,50320,65,168270
28667,0.000715,74.125.24.0-255,1484,51804,65,168270
28668,0.00073,74.125.24.0-255,2902,54706,65,168270
28669,0.000733,172.31.40.0-255,66,54772,65,168270
28670,0.000741,74.125.24.0-255,5738,60510,65,168270
28671,0.000743,172.31.40.0-255,66,60576,65,168270
28672,0.000787,74.125.24.0-255,1484,62060,65,168270
28673,0.000807,74.125.24.0-255,6797,68857,65,168270
28674,0.00081,172.31.40.0-255,66,68923,65,168270
28675,0.000826,172.31.40.0-255,66,68989,65,168270
28676,0.000837,74.125.24.0-255,1484,70473,65,168270
28677,0.000858,74.125.24.0-255,5379,75852,65,168270
28678,0.00086,172.31.40.0-255,66,75918,65,168270
28679,0.001185,74.125.24.0-255,1484,77402,65,168270
28680,0.00119,74.125.24.0-255,1484,78886,65,168270
28681,0.001193,172.31.40.0-255,66,78952,65,168270
28682,0.001223,74.125.24.0-255,1484,80436,65,168270
28683,0.00123,74.125.24.0-255,5738,86174,65,168270
28684,0.001233,172.31.40.0-255,66,86240,65,168270
28685,0.001247,172.31.40.0-255,66,86306,65,168270
28686,0.001254,74.125.24.0-255,7156,93462,65,168270
28687,0.001258,172.31.40.0-255,66,93528,65,168270
28688,0.001286,74.125.24.0-255,3602,97130,65,168270
28689,0.001289,172.31.40.0-255,66,97196,65,168270
28690,0.001616,74.125.24.0-255,1484,98680,65,168270
28691,0.001622,74.125.24.0-255,2902,101582,65,168270
28692,0.001625,172.31.40.0-255,66,101648,65,168270
28693,0.001631,74.125.24.0-255,4320,105968,65,168270
28694,0.001633,172.31.40.0-255,66,106034,65,168270
28695,0.00167,74.125.24.0-255,1484,107518,65,168270
28696,0.001678,74.125.24.0-255,7156,114674,65,168270
28697,0.00168,172.31.40.0-255,66,114740,65,168270
28698,0.001691,172.31.40.0-255,66,114806,65,168270
28699,0.001717,74.125.24.0-255,4320,119126,65,168270
28700,0.00172,74.125.24.0-255,2184,121310,65,168270
28701,0.001724,172.31.40.0-255,66,121376,65,168270
28702,0.001726,172.31.40.0-255,66,121442,65,168270
28703,0.003971,74.125.24.0-255,2902,124344,65,168270
28704,0.003976,172.31.40.0-255,66,124410,65,168270
28705,0.004017,74.125.24.0-255,2902,127312,65,168270
28706,0.00402,172.31.40.0-255,66,127378,65,168270
28707,0.006223,74.125.24.0-255,2902,130280,65,168270
28708,0.00623,172.31.40.0-255,66,130346,65,168270
28709,0.006279,74.125.24.0-255,2902,133248,65,168270
28710,0.006281,172.31.40.0-255,66,133314,65,168270
28711,0.008466,74.125.24.0-255,2902,136216,65,168270
28712,0.008471,172.31.40.0-255,66,136282,65,168270
28713,0.008527,74.125.24.0-255,2902,139184,65,168270
28714,0.008532,172.31.40.0-255,66,139250,65,168270
28715,0.010776,74.125.24.0-255,5738,144988,65,168270
28716,0.010785,172.31.40.0-255,66,145054,65,168270
28717,0.013064,74.125.24.0-255,5738,150792,65,168270
28718,0.013073,172.31.40.0-255,66,150858,65,168270
28719,0.015371,74.125.24.0-255,5738,156596,65,168270
28720,0.015382,172.31.40.0-255,66,156662,65,168270
28721,0.017636,74.125.24.0-255,5738,162400,65,168270
28722,0.017645,172.31.40.0-255,66,162466,65,168270
28723,0.019916,74.125.24.0-255,5738,168204,65,168270
28724,0.019924,172.31.40.0-255,66,168270,65,168270
28725,0.0,172.217.194.0-255,153,153,65,226730
28726,2.4e-05,172.31.40.0-255,66,219,65,226730
28727,3.1e-05,172.217.194.0-255,1484,1703,65,226730
28728,3.6e-05,172.31.40.0-255,66,1769,65,226730
28729,4.1e-05,172.217.194.0-255,2902,4671,65,226730
28730,4.4e-05,172.31.40.0-255,66,4737,65,226730
28731,5.2e-05,172.217.194.0-255,7156,11893,65,226730
28732,5.5e-05,172.31.40.0-255,66,11959,65,226730
28733,9.7e-05,172.31.40.0-255,66,12025,65,226730
28734,0.000128,172.217.194.0-255,4320,16345,65,226730
28735,0.00013,172.31.40.0-255,66,16411,65,226730
28736,0.00015,172.217.194.0-255,3961,20372,65,226730
28737,0.000152,172.31.40.0-255,66,20438,65,226730
28738,0.000311,172.217.194.0-255,1484,21922,65,226730
28739,0.000315,172.31.40.0-255,66,21988,65,226730
28740,0.000321,172.217.194.0-255,2902,24890,65,226730
28741,0.000324,172.31.40.0-255,66,24956,65,226730
28742,0.000328,172.217.194.0-255,2902,27858,65,226730
28743,0.00033,172.31.40.0-255,66,27924,65,226730
28744,0.000347,172.217.194.0-255,2902,30826,65,226730
28745,0.00035,172.31.40.0-255,66,30892,65,226730
28746,0.000383,172.217.194.0-255,6797,37689,65,226730
28747,0.000386,172.31.40.0-255,66,37755,65,226730
28748,0.000403,172.217.194.0-255,1484,39239,65,226730
28749,0.000405,172.31.40.0-255,66,39305,65,226730
28750,0.00041,172.217.194.0-255,2902,42207,65,226730
28751,0.000412,172.31.40.0-255,66,42273,65,226730
28752,0.000438,172.217.194.0-255,5738,48011,65,226730
28753,0.000441,172.31.40.0-255,66,48077,65,226730
28754,0.000464,172.217.194.0-255,7110,55187,65,226730
28755,0.000468,172.31.40.0-255,66,55253,65,226730
28756,0.000655,172.217.194.0-255,364,55617,65,226730
28757,0.000768,172.217.194.0-255,1484,57101,65,226730
28758,0.000774,172.217.194.0-255,2902,60003,65,226730
28759,0.000786,172.217.194.0-255,2902,62905,65,226730
28760,0.000791,172.31.40.0-255,66,62971,65,226730
28761,0.0008,172.217.194.0-255,2902,65873,65,226730
28762,0.000806,172.31.40.0-255,66,65939,65,226730
28763,0.000815,172.217.194.0-255,4320,70259,65,226730
28764,0.00087,172.217.194.0-255,2902,73161,65,226730
28765,0.000892,172.31.40.0-255,66,73227,65,226730
28766,0.000896,172.31.40.0-255,66,73293,65,226730
28767,0.000913,172.217.194.0-255,4320,77613,65,226730
28768,0.00093,172.217.194.0-255,2543,80156,65,226730
28769,0.000936,172.31.40.0-255,66,80222,65,226730
28770,0.001243,172.217.194.0-255,1484,81706,65,226730
28771,0.00125,172.217.194.0-255,2902,84608,65,226730
28772,0.001253,172.31.40.0-255,66,84674,65,226730
28773,0.001259,172.217.194.0-255,4320,88994,65,226730
28774,0.001274,172.217.194.0-255,1484,90478,65,226730
28775,0.001281,172.31.40.0-255,66,90544,65,226730
28776,0.001311,172.217.194.0-255,4320,94864,65,226730
28777,0.001321,172.31.40.0-255,66,94930,65,226730
28778,0.001365,172.217.194.0-255,7156,102086,65,226730
28779,0.001373,172.31.40.0-255,66,102152,65,226730
28780,0.001383,172.217.194.0-255,3602,105754,65,226730
28781,0.001388,172.31.40.0-255,66,105820,65,226730
28782,0.001434,172.217.194.0-255,1484,107304,65,226730
28783,0.001437,172.217.194.0-255,1484,108788,65,226730
28784,0.00144,172.31.40.0-255,66,108854,65,226730
28785,0.001451,172.217.194.0-255,1484,110338,65,226730
28786,0.001457,172.217.194.0-255,4320,114658,65,226730
28787,0.001468,172.217.194.0-255,1484,116142,65,226730
28788,0.00148,172.31.40.0-255,66,116208,65,226730
28789,0.001487,172.217.194.0-255,5738,121946,65,226730
28790,0.001491,172.31.40.0-255,66,122012,65,226730
28791,0.001504,172.217.194.0-255,5738,127750,65,226730
28792,0.001522,172.31.40.0-255,66,127816,65,226730
28793,0.001551,172.217.194.0-255,5738,133554,65,226730
28794,0.001556,172.31.40.0-255,66,133620,65,226730
28795,0.001576,172.217.194.0-255,6438,140058,65,226730
28796,0.00159,172.31.40.0-255,66,140124,65,226730
28797,0.001631,172.217.194.0-255,4320,144444,65,226730
28798,0.001651,172.31.40.0-255,66,144510,65,226730
28799,0.001656,172.31.40.0-255,66,144576,65,226730
28800,0.001712,172.217.194.0-255,4320,148896,65,226730
28801,0.001728,172.217.194.0-255,5738,154634,65,226730
28802,0.001743,172.217.194.0-255,7156,161790,65,226730
28803,0.001747,172.31.40.0-255,66,161856,65,226730
28804,0.001757,172.31.40.0-255,66,161922,65,226730
28805,0.001762,172.217.194.0-255,3602,165524,65,226730
28806,0.00179,172.31.40.0-255,66,165590,65,226730
28807,0.0019,172.217.194.0-255,1484,167074,65,226730
28808,0.001906,172.217.194.0-255,2902,169976,65,226730
28809,0.001914,172.31.40.0-255,66,170042,65,226730
28810,0.001921,172.217.194.0-255,1484,171526,65,226730
28811,0.001942,172.217.194.0-255,4320,175846,65,226730
28812,0.001948,172.217.194.0-255,5738,181584,65,226730
28813,0.001964,172.31.40.0-255,66,181650,65,226730
28814,0.003907,172.217.194.0-255,4320,185970,65,226730
28815,0.003915,172.31.40.0-255,66,186036,65,226730
28816,0.003932,172.217.194.0-255,1484,187520,65,226730
28817,0.005909,172.217.194.0-255,4320,191840,65,226730
28818,0.007775,172.31.40.0-255,66,191906,65,226730
28819,0.00972,172.217.194.0-255,5738,197644,65,226730
28820,0.009727,172.31.40.0-255,66,197710,65,226730
28821,0.011656,172.217.194.0-255,5738,203448,65,226730
28822,0.011664,172.31.40.0-255,66,203514,65,226730
28823,0.013616,172.217.194.0-255,5738,209252,65,226730
28824,0.013623,172.31.40.0-255,66,209318,65,226730
28825,0.015557,172.217.194.0-255,5738,215056,65,226730
28826,0.015564,172.31.40.0-255,66,215122,65,226730
28827,0.017502,172.217.194.0-255,5738,220860,65,226730
28828,0.017508,172.31.40.0-255,66,220926,65,226730
28829,0.019503,172.217.194.0-255,5738,226664,65,226730
28830,0.01951,172.31.40.0-255,66,226730,65,226730
28831,0.0,74.125.68.0-255,146,146,65,288524
28832,1.9e-05,172.31.40.0-255,66,212,65,288524
28833,2.6e-05,74.125.68.0-255,1484,1696,65,288524
28834,3e-05,172.31.40.0-255,66,1762,65,288524
28835,3.6e-05,74.125.68.0-255,2902,4664,65,288524
28836,3.8e-05,172.31.40.0-255,66,4730,65,288524
28837,4.3e-05,74.125.68.0-255,2902,7632,65,288524
28838,4.6e-05,172.31.40.0-255,66,7698,65,288524
28839,5.2e-05,74.125.68.0-255,4320,12018,65,288524
28840,5.5e-05,172.31.40.0-255,66,12084,65,288524
28841,5.9e-05,74.125.68.0-255,2021,14105,65,288524
28842,6.2e-05,172.31.40.0-255,66,14171,65,288524
28843,0.000127,74.125.68.0-255,2902,17073,65,288524
28844,0.000131,172.31.40.0-255,66,17139,65,288524
28845,0.000139,74.125.68.0-255,7156,24295,65,288524
28846,0.000141,172.31.40.0-255,66,24361,65,288524
28847,0.000174,74.125.68.0-255,6797,31158,65,288524
28848,0.000177,172.31.40.0-255,66,31224,65,288524
28849,0.000285,74.125.68.0-255,1484,32708,65,288524
28850,0.000289,172.31.40.0-255,66,32774,65,288524
28851,0.000293,74.125.68.0-255,1484,34258,65,288524
28852,0.000295,172.31.40.0-255,66,34324,65,288524
28853,0.00031,74.125.68.0-255,1484,35808,65,288524
28854,0.000312,172.31.40.0-255,66,35874,65,288524
28855,0.000317,74.125.68.0-255,1484,37358,65,288524
28856,0.000319,172.31.40.0-255,66,37424,65,288524
28857,0.000324,74.125.68.0-255,2902,40326,65,288524
28858,0.000327,172.31.40.0-255,66,40392,65,288524
28859,0.000333,74.125.68.0-255,5738,46130,65,288524
28860,0.000336,172.31.40.0-255,66,46196,65,288524
28861,0.000377,74.125.68.0-255,5379,51575,65,288524
28862,0.000381,172.31.40.0-255,66,51641,65,288524
28863,0.000431,74.125.68.0-255,5738,57379,65,288524
28864,0.000435,172.31.40.0-255,66,57445,65,288524
28865,0.000445,172.31.40.0-255,66,57511,65,288524
28866,0.000448,74.125.68.0-255,131,57642,65,288524
28867,0.000551,74.125.68.0-255,1484,59126,65,288524
28868,0.000554,172.31.40.0-255,66,59192,65,288524
28869,0.000559,74.125.68.0-255,2902,62094,65,288524
28870,0.00056,172.31.40.0-255,66,62160,65,288524
28871,0.000566,74.125.68.0-255,5738,67898,65,288524
28872,0.000568,172.31.40.0-255,66,67964,65,288524
28873,0.000572,74.125.68.0-255,2902,70866,65,288524
28874,0.000574,172.31.40.0-255,66,70932,65,288524
28875,0.000579,74.125.68.0-255,4320,75252,65,288524
28876,0.000581,172.31.40.0-255,66,75318,65,288524
28877,0.000615,172.31.40.0-255,66,75384,65,288524
28878,0.000647,74.125.68.0-255,1484,76868,65,288524
28879,0.000674,74.125.68.0-255,6438,83306,65,288524
28880,0.000677,172.31.40.0-255,66,83372,65,288524
28881,0.000687,172.31.40.0-255,66,83438,65,288524
28882,0.000691,74.125.68.0-255,4320,87758,65,288524
28883,0.000693,172.31.40.0-255,66,87824,65,288524
28884,0.00071,74.125.68.0-255,1484,89308,65,288524
28885,0.000723,74.125.68.0-255,2243,91551,65,288524
28886,0.000725,172.31.40.0-255,66,91617,65,288524
28887,0.000799,74.125.68.0-255,1484,93101,65,288524
28888,0.000804,74.125.68.0-255,2902,96003,65,288524
28889,0.000806,172.31.40.0-255,66,96069,65,288524
28890,0.000812,74.125.68.0-255,5738,101807,65,288524
28891,0.000814,172.31.40.0-255,66,101873,65,288524
28892,0.000818,74.125.68.0-255,2902,104775,65,288524
28893,0.000819,172.31.40.0-255,66,104841,65,288524
28894,0.000869,74.125.68.0-255,4320,109161,65,288524
28895,0.000872,172.31.40.0-255,66,109227,65,288524
28896,0.000881,172.31.40.0-255,66,109293,65,288524
28897,0.000885,74.125.68.0-255,4320,113613,65,288524
28898,0.000887,172.31.40.0-255,66,113679,65,288524
28899,0.000951,74.125.68.0-255,3602,117281,65,288524
28900,0.000954,172.31.40.0-255,66,117347,65,288524
28901,0.001254,74.125.68.0-255,1484,118831,65,288524
28902,0.001258,74.125.68.0-255,1484,120315,65,288524
28903,0.001262,172.31.40.0-255,66,120381,65,288524
28904,0.001276,74.125.68.0-255,2902,123283,65,288524
28905,0.001279,172.31.40.0-255,66,123349,65,288524
28906,0.001309,74.125.68.0-255,5738,129087,65,288524
28907,0.001313,172.31.40.0-255,66,129153,65,288524
28908,0.001317,74.125.68.0-255,2902,132055,65,288524
28909,0.001319,172.31.40.0-255,66,132121,65,288524
28910,0.001341,74.125.68.0-255,5738,137859,65,288524
28911,0.001343,172.31.40.0-255,66,137925,65,288524
28912,0.001351,74.125.68.0-255,7156,145081,65,288524
28913,0.001353,172.31.40.0-255,66,145147,65,288524
28914,0.001375,74.125.68.0-255,2902,148049,65,288524
28915,0.001377,172.31.40.0-255,66,148115,65,288524
28916,0.001383,74.125.68.0-255,3602,151717,65,288524
28917,0.001385,172.31.40.0-255,66,151783,65,288524
28918,0.001463,74.125.68.0-255,1484,153267,65,288524
28919,0.00147,74.125.68.0-255,2902,156169,65,288524
28920,0.001473,172.31.40.0-255,66,156235,65,288524
28921,0.001477,74.125.68.0-255,1484,157719,65,288524
28922,0.001481,74.125.68.0-255,2902,160621,65,288524
28923,0.001483,172.31.40.0-255,66,160687,65,288524
28924,0.001486,74.125.68.0-255,1484,162171,65,288524
28925,0.001511,74.125.68.0-255,4320,166491,65,288524
28926,0.001515,172.31.40.0-255,66,166557,65,288524
28927,0.001518,74.125.68.0-255,1484,168041,65,288524
28928,0.001553,172.31.40.0-255,66,168107,65,288524
28929,0.001572,74.125.68.0-255,1484,169591,65,288524
28930,0.001594,74.125.68.0-255,6438,176029,65,288524
28931,0.001597,172.31.40.0-255,66,176095,65,288524
28932,0.001629,74.125.68.0-255,1484,177579,65,288524
28933,0.001649,74.125.68.0-255,2902,180481,65,288524
28934,0.001652,172.31.40.0-255,66,180547,65,288524
28935,0.001669,74.125.68.0-255,1484,182031,65,288524
28936,0.001685,74.125.68.0-255,4320,186351,65,288524
28937,0.001691,172.31.40.0-255,66,186417,65,288524
28938,0.001716,74.125.68.0-255,1484,187901,65,288524
28939,0.001787,74.125.68.0-255,1484,189385,65,288524
28940,0.001792,172.31.40.0-255,66,189451,65,288524
28941,0.001805,74.125.68.0-255,2902,192353,65,288524
28942,0.001808,172.31.40.0-255,66,192419,65,288524
28943,0.001829,74.125.68.0-255,5738,198157,65,288524
28944,0.001831,172.31.40.0-255,66,198223,65,288524
28945,0.001834,74.125.68.0-255,1484,199707,65,288524
28946,0.001863,172.31.40.0-255,66,199773,65,288524
28947,0.001871,172.31.40.0-255,101,199874,65,288524
28948,0.001888,74.125.68.0-255,2184,202058,65,288524
28949,0.001892,172.31.40.0-255,66,202124,65,288524
28950,0.001968,74.125.68.0-255,1484,203608,65,288524
28951,0.001972,74.125.68.0-255,1484,205092,65,288524
28952,0.001976,172.31.40.0-255,66,205158,65,288524
28953,0.001991,74.125.68.0-255,1484,206642,65,288524
28954,0.001998,74.125.68.0-255,5738,212380,65,288524
28955,0.002001,172.31.40.0-255,66,212446,65,288524
28956,0.002049,172.31.40.0-255,66,212512,65,288524
28957,0.002051,74.125.68.0-255,1484,213996,65,288524
28958,0.002082,172.31.40.0-255,66,214062,65,288524
28959,0.002146,74.125.68.0-255,1484,215546,65,288524
28960,0.00215,74.125.68.0-255,1484,217030,65,288524
28961,0.002153,172.31.40.0-255,66,217096,65,288524
28962,0.002168,74.125.68.0-255,1484,218580,65,288524
28963,0.002175,74.125.68.0-255,5738,224318,65,288524
28964,0.002179,172.31.40.0-255,66,224384,65,288524
28965,0.002207,74.125.68.0-255,7156,231540,65,288524
28966,0.00221,172.31.40.0-255,66,231606,65,288524
28967,0.002256,172.31.40.0-255,66,231672,65,288524
28968,0.00226,74.125.68.0-255,2184,233856,65,288524
28969,0.002262,172.31.40.0-255,66,233922,65,288524
28970,0.002335,74.125.68.0-255,2902,236824,65,288524
28971,0.002337,74.125.68.0-255,1484,238308,65,288524
28972,0.00234,74.125.68.0-255,1484,239792,65,288524
28973,0.002341,74.125.68.0-255,1484,241276,65,288524
28974,0.002343,74.125.68.0-255,1484,242760,65,288524
28975,0.002349,74.125.68.0-255,4320,247080,65,288524
28976,0.002354,172.31.40.0-255,66,247146,65,288524
28977,0.002356,172.31.40.0-255,66,247212,65,288524
28978,0.002365,172.31.40.0-255,66,247278,65,288524
28979,0.002369,172.31.40.0-255,66,247344,65,288524
28980,0.002372,172.31.40.0-255,66,247410,65,288524
28981,0.002413,172.31.40.0-255,66,247476,65,288524
28982,0.002417,74.125.68.0-255,2902,250378,65,288524
28983,0.002419,172.31.40.0-255,66,250444,65,288524
28984,0.002424,74.125.68.0-255,4320,254764,65,288524
28985,0.002426,172.31.40.0-255,66,254830,65,288524
28986,0.002452,172.31.40.0-255,66,254896,65,288524
28987,0.002455,74.125.68.0-255,1484,256380,65,288524
28988,0.002458,74.125.68.0-255,1484,257864,65,288524
28989,0.00246,172.31.40.0-255,66,257930,65,288524
28990,0.002463,74.125.68.0-255,1484,259414,65,288524
28991,0.00247,74.125.68.0-255,7156,266570,65,288524
28992,0.002472,172.31.40.0-255,66,266636,65,288524
28993,0.002475,74.125.68.0-255,1484,268120,65,288524
28994,0.002495,74.125.68.0-255,2184,270304,65,288524
28995,0.002498,172.31.40.0-255,66,270370,65,288524
28996,0.002526,74.125.68.0-255,5738,276108,65,288524
28997,0.002529,172.31.40.0-255,66,276174,65,288524
28998,0.002531,74.125.68.0-255,1484,277658,65,288524
28999,0.002536,74.125.68.0-255,2902,280560,65,288524
29000,0.002538,172.31.40.0-255,66,280626,65,288524
29001,0.002553,74.125.68.0-255,7156,287782,65,288524
29002,0.002556,172.31.40.0-255,66,287848,65,288524
29003,0.002559,74.125.68.0-255,171,288019,65,288524
29004,0.002561,74.125.68.0-255,97,288116,65,288524
29005,0.002607,74.125.68.0-255,105,288221,65,288524
29006,0.004109,74.125.68.0-255,66,288287,65,288524
29007,0.004467,172.31.40.0-255,66,288353,65,288524
29008,0.004498,172.31.40.0-255,105,288458,65,288524
29009,0.006734,74.125.68.0-255,66,288524,65,288524
29010,0.0,172.217.24.0-255,150,150,65,148562
29011,2.5e-05,172.31.40.0-255,66,216,65,148562
29012,3.1e-05,172.217.24.0-255,1484,1700,65,148562
29013,3.7e-05,172.31.40.0-255,66,1766,65,148562
29014,4.2e-05,172.217.24.0-255,2902,4668,65,148562
29015,4.6e-05,172.31.40.0-255,66,4734,65,148562
29016,5.4e-05,172.217.24.0-255,7156,11890,65,148562
29017,5.7e-05,172.31.40.0-255,66,11956,65,148562
29018,6.2e-05,172.217.24.0-255,2072,14028,65,148562
29019,6.5e-05,172.31.40.0-255,66,14094,65,148562
29020,7e-05,172.217.24.0-255,2902,16996,65,148562
29021,7.3e-05,172.31.40.0-255,66,17062,65,148562
29022,8e-05,172.217.24.0-255,5738,22800,65,148562
29023,8.3e-05,172.31.40.0-255,66,22866,65,148562
29024,0.000111,172.217.24.0-255,1484,24350,65,148562
29025,0.000114,172.31.40.0-255,66,24416,65,148562
29026,0.000121,172.217.24.0-255,6797,31213,65,148562
29027,0.000124,172.31.40.0-255,66,31279,65,148562
29028,0.000186,172.217.24.0-255,1484,32763,65,148562
29029,0.000189,172.31.40.0-255,66,32829,65,148562
29030,0.000192,172.217.24.0-255,1484,34313,65,148562
29031,0.000194,172.31.40.0-255,66,34379,65,148562
29032,0.000205,172.217.24.0-255,1484,35863,65,148562
29033,0.000208,172.31.40.0-255,66,35929,65,148562
29034,0.000214,172.217.24.0-255,4320,40249,65,148562
29035,0.000217,172.31.40.0-255,66,40315,65,148562
29036,0.000253,172.31.40.0-255,66,40381,65,148562
29037,0.00026,172.217.24.0-255,7156,47537,65,148562
29038,0.000262,172.31.40.0-255,66,47603,65,148562
29039,0.000286,172.217.24.0-255,5738,53341,65,148562
29040,0.000289,172.31.40.0-255,66,53407,65,148562
29041,0.000301,172.217.24.0-255,2875,56282,65,148562
29042,0.000303,172.31.40.0-255,66,56348,65,148562
29043,0.000843,172.217.24.0-255,114,56462,65,148562
29044,0.00094,172.217.24.0-255,1484,57946,65,148562
29045,0.000945,172.31.40.0-255,66,58012,65,148562
29046,0.000952,172.217.24.0-255,2902,60914,65,148562
29047,0.000954,172.31.40.0-255,66,60980,65,148562
29048,0.000959,172.217.24.0-255,2902,63882,65,148562
29049,0.000961,172.31.40.0-255,66,63948,65,148562
29050,0.000964,172.217.24.0-255,1484,65432,65,148562
29051,0.000984,172.217.24.0-255,2902,68334,65,148562
29052,0.000987,172.31.40.0-255,66,68400,65,148562
29053,0.00099,172.217.24.0-255,1484,69884,65,148562
29054,0.001033,172.217.24.0-255,3961,73845,65,148562
29055,0.001036,172.31.40.0-255,66,73911,65,148562
29056,0.001078,172.217.24.0-255,1484,75395,65,148562
29057,0.001084,172.217.24.0-255,2902,78297,65,148562
29058,0.001087,172.31.40.0-255,66,78363,65,148562
29059,0.001114,172.217.24.0-255,5738,84101,65,148562
29060,0.001118,172.31.40.0-255,66,84167,65,148562
29061,0.001125,172.217.24.0-255,6797,90964,65,148562
29062,0.001127,172.31.40.0-255,66,91030,65,148562
29063,0.001161,172.31.40.0-255,66,91096,65,148562
29064,0.00118,172.217.24.0-255,1484,92580,65,148562
29065,0.001196,172.31.40.0-255,66,92646,65,148562
29066,0.001212,172.217.24.0-255,2902,95548,65,148562
29067,0.001214,172.31.40.0-255,66,95614,65,148562
29068,0.001226,172.217.24.0-255,1866,97480,65,148562
29069,0.001228,172.31.40.0-255,66,97546,65,148562
29070,0.003109,172.217.24.0-255,2902,100448,65,148562
29071,0.003121,172.31.40.0-255,66,100514,65,148562
29072,0.003145,172.217.24.0-255,2902,103416,65,148562
29073,0.003148,172.31.40.0-255,66,103482,65,148562
29074,0.005021,172.217.24.0-255,5738,109220,65,148562
29075,0.005023,172.31.40.0-255,66,109286,65,148562
29076,0.006904,172.217.24.0-255,5738,115024,65,148562
29077,0.006911,172.31.40.0-255,66,115090,65,148562
29078,0.008801,172.217.24.0-255,5738,120828,65,148562
29079,0.008809,172.31.40.0-255,66,120894,65,148562
29080,0.010699,172.217.24.0-255,4320,125214,65,148562
29081,0.010707,172.31.40.0-255,66,125280,65,148562
29082,0.010725,172.217.24.0-255,1484,126764,65,148562
29083,0.012607,172.217.24.0-255,4320,131084,65,148562
29084,0.012614,172.31.40.0-255,66,131150,65,148562
29085,0.01451,172.217.24.0-255,5738,136888,65,148562
29086,0.014518,172.31.40.0-255,66,136954,65,148562
29087,0.016423,172.217.24.0-255,5738,142692,65,148562
29088,0.016432,172.31.40.0-255,66,142758,65,148562
29089,0.018402,172.217.24.0-255,5738,148496,65,148562
29090,0.01841,172.31.40.0-255,66,148562,65,148562
29091,0.0,74.125.24.0-255,146,146,65,257898
29092,2.4e-05,172.31.40.0-255,66,212,65,257898
29093,3.1e-05,74.125.24.0-255,1484,1696,65,257898
29094,3.5e-05,172.31.40.0-255,66,1762,65,257898
29095,4.1e-05,74.125.24.0-255,2902,4664,65,257898
29096,4.4e-05,172.31.40.0-255,66,4730,65,257898
29097,5.2e-05,74.125.24.0-255,7156,11886,65,257898
29098,5.5e-05,172.31.40.0-255,66,11952,65,257898
29099,7e-05,74.125.24.0-255,2079,14031,65,257898
29100,7.2e-05,172.31.40.0-255,66,14097,65,257898
29101,0.000126,74.125.24.0-255,1484,15581,65,257898
29102,0.000129,172.31.40.0-255,66,15647,65,257898
29103,0.000134,74.125.24.0-255,2902,18549,65,257898
29104,0.000136,172.31.40.0-255,66,18615,65,257898
29105,0.00014,74.125.24.0-255,1484,20099,65,257898
29106,0.000142,172.31.40.0-255,66,20165,65,257898
29107,0.000162,74.125.24.0-255,4320,24485,65,257898
29108,0.000165,172.31.40.0-255,66,24551,65,257898
29109,0.00019,74.125.24.0-255,6797,31348,65,257898
29110,0.000193,172.31.40.0-255,66,31414,65,257898
29111,0.000221,74.125.24.0-255,1484,32898,65,257898
29112,0.000223,172.31.40.0-255,66,32964,65,257898
29113,0.000228,74.125.24.0-255,2902,35866,65,257898
29114,0.00023,172.31.40.0-255,66,35932,65,257898
29115,0.000246,74.125.24.0-255,5738,41670,65,257898
29116,0.000248,172.31.40.0-255,66,41736,65,257898
29117,0.000272,74.125.24.0-255,2902,44638,65,257898
29118,0.000274,172.31.40.0-255,66,44704,65,257898
29119,0.000292,74.125.24.0-255,3961,48665,65,257898
29120,0.000294,172.31.40.0-255,66,48731,65,257898
29121,0.000396,74.125.24.0-255,1484,50215,65,257898
29122,0.000399,172.31.40.0-255,66,50281,65,257898
29123,0.000403,74.125.24.0-255,1484,51765,65,257898
29124,0.000417,74.125.24.0-255,1484,53249,65,257898
29125,0.00042,172.31.40.0-255,66,53315,65,257898
29126,0.000425,74.125.24.0-255,4320,57635,65,257898
29127,0.000428,172.31.40.0-255,66,57701,65,257898
29128,0.000448,74.125.24.0-255,5738,63439,65,257898
29129,0.000451,172.31.40.0-255,66,63505,65,257898
29130,0.000474,74.125.24.0-255,2872,66377,65,257898
29131,0.000476,172.31.40.0-255,66,66443,65,257898
29132,0.001466,74.125.24.0-255,349,66792,65,257898
29133,0.001581,74.125.24.0-255,1484,68276,65,257898
29134,0.001587,172.31.40.0-255,66,68342,65,257898
29135,0.001595,74.125.24.0-255,2902,71244,65,257898
29136,0.001597,172.31.40.0-255,66,71310,65,257898
29137,0.0016,74.125.24.0-255,1484,72794,65,257898
29138,0.001627,74.125.24.0-255,4320,77114,65,257898
29139,0.001629,172.31.40.0-255,66,77180,65,257898
29140,0.001673,74.125.24.0-255,4320,81500,65,257898
29141,0.001676,172.31.40.0-255,66,81566,65,257898
29142,0.001696,74.125.24.0-255,1993,83559,65,257898
29143,0.001698,172.31.40.0-255,66,83625,65,257898
29144,0.001915,74.125.24.0-255,1484,85109,65,257898
29145,0.001922,74.125.24.0-255,1484,86593,65,257898
29146,0.001925,172.31.40.0-255,66,86659,65,257898
29147,0.001947,74.125.24.0-255,1484,88143,65,257898
29148,0.001954,74.125.24.0-255,5738,93881,65,257898
29149,0.001957,172.31.40.0-255,66,93947,65,257898
29150,0.001968,74.125.24.0-255,2902,96849,65,257898
29151,0.001971,172.31.40.0-255,66,96915,65,257898
29152,0.002006,172.31.40.0-255,66,96981,65,257898
29153,0.002016,172.31.40.0-255,66,97047,65,257898
29154,0.002039,74.125.24.0-255,2184,99231,65,257898
29155,0.002042,172.31.40.0-255,66,99297,65,257898
29156,0.002105,74.125.24.0-255,1484,100781,65,257898
29157,0.002127,74.125.24.0-255,2902,103683,65,257898
29158,0.00213,172.31.40.0-255,66,103749,65,257898
29159,0.002137,74.125.24.0-255,5738,109487,65,257898
29160,0.002139,172.31.40.0-255,66,109553,65,257898
29161,0.002142,74.125.24.0-255,1484,111037,65,257898
29162,0.00218,172.31.40.0-255,66,111103,65,257898
29163,0.002225,74.125.24.0-255,2902,114005,65,257898
29164,0.002227,172.31.40.0-255,66,114071,65,257898
29165,0.002254,172.31.40.0-255,66,114137,65,257898
29166,0.002272,74.125.24.0-255,1484,115621,65,257898
29167,0.002275,74.125.24.0-255,1484,117105,65,257898
29168,0.002277,172.31.40.0-255,66,117171,65,257898
29169,0.002289,74.125.24.0-255,1484,118655,65,257898
29170,0.0023,74.125.24.0-255,1484,120139,65,257898
29171,0.002302,172.31.40.0-255,66,120205,65,257898
29172,0.002325,74.125.24.0-255,4320,124525,65,257898
29173,0.002327,172.31.40.0-255,66,124591,65,257898
29174,0.002339,172.31.40.0-255,66,124657,65,257898
29175,0.002345,74.125.24.0-255,5738,130395,65,257898
29176,0.002348,172.31.40.0-255,66,130461,65,257898
29177,0.00239,74.125.24.0-255,5738,136199,65,257898
29178,0.002392,172.31.40.0-255,66,136265,65,257898
29179,0.002409,74.125.24.0-255,766,137031,65,257898
29180,0.002416,74.125.24.0-255,7156,144187,65,257898
29181,0.002419,172.31.40.0-255,66,144253,65,257898
29182,0.002445,74.125.24.0-255,4320,148573,65,257898
29183,0.002448,172.31.40.0-255,66,148639,65,257898
29184,0.002476,172.31.40.0-255,66,148705,65,257898
29185,0.002479,74.125.24.0-255,1484,150189,65,257898
29186,0.002484,74.125.24.0-255,2902,153091,65,257898
29187,0.002486,172.31.40.0-255,66,153157,65,257898
29188,0.002494,74.125.24.0-255,6438,159595,65,257898
29189,0.002496,172.31.40.0-255,66,159661,65,257898
29190,0.002529,74.125.24.0-255,7156,166817,65,257898
29191,0.002532,172.31.40.0-255,66,166883,65,257898
29192,0.002534,74.125.24.0-255,1484,168367,65,257898
29193,0.002556,74.125.24.0-255,4320,172687,65,257898
29194,0.002558,172.31.40.0-255,66,172753,65,257898
29195,0.002561,74.125.24.0-255,1484,174237,65,257898
29196,0.002567,74.125.24.0-255,5738,179975,65,257898
29197,0.002569,172.31.40.0-255,66,180041,65,257898
29198,0.002595,74.125.24.0-255,5738,185779,65,257898
29199,0.002598,172.31.40.0-255,66,185845,65,257898
29200,0.002627,172.31.40.0-255,66,185911,65,257898
29201,0.002646,74.125.24.0-255,7156,193067,65,257898
29202,0.002649,172.31.40.0-255,66,193133,65,257898
29203,0.002652,74.125.24.0-255,1484,194617,65,257898
29204,0.002673,74.125.24.0-255,7156,201773,65,257898
29205,0.002676,172.31.40.0-255,66,201839,65,257898
29206,0.002683,74.125.24.0-255,5738,207577,65,257898
29207,0.002686,172.31.40.0-255,66,207643,65,257898
29208,0.00272,172.31.40.0-255,66,207709,65,257898
29209,0.002734,74.125.24.0-255,2184,209893,65,257898
29210,0.002736,172.31.40.0-255,66,209959,65,257898
29211,0.002759,74.125.24.0-255,1484,211443,65,257898
29212,0.002764,74.125.24.0-255,2902,214345,65,257898
29213,0.002767,172.31.40.0-255,66,214411,65,257898
29214,0.002773,74.125.24.0-255,5738,220149,65,257898
29215,0.002775,172.31.40.0-255,66,220215,65,257898
29216,0.002778,74.125.24.0-255,1484,221699,65,257898
29217,0.002806,172.31.40.0-255,66,221765,65,257898
29218,0.002872,172.31.40.0-255,66,221831,65,257898
29219,0.002894,74.125.24.0-255,5738,227569,65,257898
29220,0.002896,172.31.40.0-255,66,227635,65,257898
29221,0.002909,74.125.24.0-255,2902,230537,65,257898
29222,0.002912,172.31.40.0-255,66,230603,65,257898
29223,0.002933,74.125.24.0-255,4320,234923,65,257898
29224,0.002936,172.31.40.0-255,66,234989,65,257898
29225,0.00295,172.31.40.0-255,66,235055,65,257898
29226,0.002957,74.125.24.0-255,6438,241493,65,257898
29227,0.002959,172.31.40.0-255,66,241559,65,257898
29228,0.002999,74.125.24.0-255,4320,245879,65,257898
29229,0.003001,172.31.40.0-255,66,245945,65,257898
29230,0.003025,74.125.24.0-255,5738,251683,65,257898
29231,0.003028,172.31.40.0-255,66,251749,65,257898
29232,0.003041,172.31.40.0-255,66,251815,65,257898
29233,0.003055,74.125.24.0-255,2902,254717,65,257898
29234,0.003057,172.31.40.0-255,66,254783,65,257898
29235,0.003085,172.31.40.0-255,66,254849,65,257898
29236,0.003098,172.31.40.0-255,66,254915,65,257898
29237,0.003111,74.125.24.0-255,2478,257393,65,257898
29238,0.003114,172.31.40.0-255,66,257459,65,257898
29239,0.003117,74.125.24.0-255,97,257556,65,257898
29240,0.003146,74.125.24.0-255,105,257661,65,257898
29241,0.006821,172.31.40.0-255,66,257727,65,257898
29242,0.006859,172.31.40.0-255,105,257832,65,257898
29243,0.009092,74.125.24.0-255,66,257898,65,257898
29244,0.0,172.217.194.0-255,146,146,65,187668
29245,2.3e-05,172.31.40.0-255,66,212,65,187668
29246,3.1e-05,172.217.194.0-255,1484,1696,65,187668
29247,3.5e-05,172.31.40.0-255,66,1762,65,187668
29248,4.1e-05,172.217.194.0-255,2902,4664,65,187668
29249,4.3e-05,172.31.40.0-255,66,4730,65,187668
29250,5.9e-05,172.217.194.0-255,7156,11886,65,187668
29251,6.2e-05,172.31.40.0-255,66,11952,65,187668
29252,9.5e-05,172.217.194.0-255,2133,14085,65,187668
29253,9.8e-05,172.31.40.0-255,66,14151,65,187668
29254,0.000124,172.217.194.0-255,2902,17053,65,187668
29255,0.000127,172.31.40.0-255,66,17119,65,187668
29256,0.000132,172.217.194.0-255,4320,21439,65,187668
29257,0.000134,172.31.40.0-255,66,21505,65,187668
29258,0.000143,172.217.194.0-255,2902,24407,65,187668
29259,0.000145,172.31.40.0-255,66,24473,65,187668
29260,0.000169,172.217.194.0-255,5738,30211,65,187668
29261,0.000176,172.31.40.0-255,66,30277,65,187668
29262,0.000179,172.217.194.0-255,1125,31402,65,187668
29263,0.000181,172.31.40.0-255,66,31468,65,187668
29264,0.000259,172.217.194.0-255,1484,32952,65,187668
29265,0.000261,172.31.40.0-255,66,33018,65,187668
29266,0.000267,172.217.194.0-255,2902,35920,65,187668
29267,0.000269,172.31.40.0-255,66,35986,65,187668
29268,0.000271,172.217.194.0-255,1484,37470,65,187668
29269,0.000274,172.31.40.0-255,66,37536,65,187668
29270,0.000304,172.217.194.0-255,4320,41856,65,187668
29271,0.000311,172.31.40.0-255,66,41922,65,187668
29272,0.000339,172.217.194.0-255,6797,48719,65,187668
29273,0.000342,172.31.40.0-255,66,48785,65,187668
29274,0.00048,172.217.194.0-255,1484,50269,65,187668
29275,0.000485,172.31.40.0-255,66,50335,65,187668
29276,0.000491,172.217.194.0-255,2902,53237,65,187668
29277,0.000494,172.31.40.0-255,66,53303,65,187668
29278,0.000504,172.217.194.0-255,4320,57623,65,187668
29279,0.000507,172.31.40.0-255,66,57689,65,187668
29280,0.00053,172.217.194.0-255,1484,59173,65,187668
29281,0.000544,172.217.194.0-255,7099,66272,65,187668
29282,0.000547,172.31.40.0-255,66,66338,65,187668
29283,0.000735,172.217.194.0-255,375,66713,65,187668
29284,0.000924,172.217.194.0-255,1484,68197,65,187668
29285,0.000928,172.31.40.0-255,66,68263,65,187668
29286,0.000969,172.217.194.0-255,2902,71165,65,187668
29287,0.000973,172.31.40.0-255,66,71231,65,187668
29288,0.000979,172.217.194.0-255,5738,76969,65,187668
29289,0.000981,172.31.40.0-255,66,77035,65,187668
29290,0.001016,172.31.40.0-255,66,77101,65,187668
29291,0.001032,172.31.40.0-255,66,77167,65,187668
29292,0.001038,172.217.194.0-255,3961,81128,65,187668
29293,0.00104,172.31.40.0-255,66,81194,65,187668
29294,0.001727,172.217.194.0-255,1484,82678,65,187668
29295,0.001739,172.217.194.0-255,2902,85580,65,187668
29296,0.001743,172.31.40.0-255,66,85646,65,187668
29297,0.001752,172.217.194.0-255,5738,91384,65,187668
29298,0.001754,172.31.40.0-255,66,91450,65,187668
29299,0.001802,172.31.40.0-255,66,91516,65,187668
29300,0.00182,172.31.40.0-255,66,91582,65,187668
29301,0.001839,172.217.194.0-255,1484,93066,65,187668
29302,0.001874,172.31.40.0-255,66,93132,65,187668
29303,0.001893,172.31.40.0-255,66,93198,65,187668
29304,0.001925,172.217.194.0-255,2902,96100,65,187668
29305,0.001927,172.31.40.0-255,66,96166,65,187668
29306,0.001957,172.217.194.0-255,6438,102604,65,187668
29307,0.001959,172.31.40.0-255,66,102670,65,187668
29308,0.001962,172.217.194.0-255,1484,104154,65,187668
29309,0.00199,172.217.194.0-255,2902,107056,65,187668
29310,0.001992,172.31.40.0-255,66,107122,65,187668
29311,0.001999,172.217.194.0-255,5738,112860,65,187668
29312,0.002001,172.31.40.0-255,66,112926,65,187668
29313,0.002012,172.217.194.0-255,4320,117246,65,187668
29314,0.002014,172.31.40.0-255,66,117312,65,187668
29315,0.00205,172.31.40.0-255,66,117378,65,187668
29316,0.00206,172.217.194.0-255,4320,121698,65,187668
29317,0.002062,172.31.40.0-255,66,121764,65,187668
29318,0.002087,172.217.194.0-255,3602,125366,65,187668
29319,0.00209,172.31.40.0-255,66,125432,65,187668
29320,0.002117,172.217.194.0-255,2902,128334,65,187668
29321,0.00212,172.31.40.0-255,66,128400,65,187668
29322,0.002125,172.217.194.0-255,4320,132720,65,187668
29323,0.002128,172.31.40.0-255,66,132786,65,187668
29324,0.002143,172.31.40.0-255,66,132852,65,187668
29325,0.002193,172.31.40.0-255,66,132918,65,187668
29326,0.002196,172.217.194.0-255,1484,134402,65,187668
29327,0.002224,172.217.194.0-255,2902,137304,65,187668
29328,0.002227,172.31.40.0-255,66,137370,65,187668
29329,0.002233,172.217.194.0-255,5738,143108,65,187668
29330,0.002236,172.31.40.0-255,66,143174,65,187668
29331,0.002258,172.31.40.0-255,66,143240,65,187668
29332,0.00227,172.31.40.0-255,66,143306,65,187668
29333,0.0023,172.217.194.0-255,3602,146908,65,187668
29334,0.002302,172.31.40.0-255,66,146974,65,187668
29335,0.004503,172.217.194.0-255,1484,148458,65,187668
29336,0.004536,172.217.194.0-255,4320,152778,65,187668
29337,0.004542,172.31.40.0-255,66,152844,65,187668
29338,0.006778,172.217.194.0-255,5738,158582,65,187668
29339,0.006784,172.31.40.0-255,66,158648,65,187668
29340,0.009059,172.217.194.0-255,5738,164386,65,187668
29341,0.009081,172.31.40.0-255,66,164452,65,187668
29342,0.011325,172.217.194.0-255,5738,170190,65,187668
29343,0.011337,172.31.40.0-255,66,170256,65,187668
29344,0.013578,172.217.194.0-255,5738,175994,65,187668
29345,0.013589,172.31.40.0-255,66,176060,65,187668
29346,0.015848,172.217.194.0-255,5738,181798,65,187668
29347,0.015862,172.31.40.0-255,66,181864,65,187668
29348,0.018105,172.217.194.0-255,5738,187602,65,187668
29349,0.01812,172.31.40.0-255,66,187668,65,187668
29350,0.0,74.125.24.0-255,146,146,65,179349
29351,2.3e-05,172.31.40.0-255,66,212,65,179349
29352,3e-05,74.125.24.0-255,1484,1696,65,179349
29353,3.5e-05,172.31.40.0-255,66,1762,65,179349
29354,4.9e-05,74.125.24.0-255,2902,4664,65,179349
29355,5.4e-05,172.31.40.0-255,66,4730,65,179349
29356,6.2e-05,74.125.24.0-255,7156,11886,65,179349
29357,6.4e-05,172.31.40.0-255,66,11952,65,179349
29358,7e-05,74.125.24.0-255,2002,13954,65,179349
29359,7.2e-05,172.31.40.0-255,66,14020,65,179349
29360,0.000148,74.125.24.0-255,1484,15504,65,179349
29361,0.000151,172.31.40.0-255,66,15570,65,179349
29362,0.000156,74.125.24.0-255,2902,18472,65,179349
29363,0.000159,172.31.40.0-255,66,18538,65,179349
29364,0.000187,74.125.24.0-255,5738,24276,65,179349
29365,0.00019,172.31.40.0-255,66,24342,65,179349
29366,0.000196,74.125.24.0-255,4320,28662,65,179349
29367,0.000198,172.31.40.0-255,66,28728,65,179349
29368,0.00022,74.125.24.0-255,2543,31271,65,179349
29369,0.000222,172.31.40.0-255,66,31337,65,179349
29370,0.000262,74.125.24.0-255,1484,32821,65,179349
29371,0.000264,172.31.40.0-255,66,32887,65,179349
29372,0.000269,74.125.24.0-255,2902,35789,65,179349
29373,0.000272,172.31.40.0-255,66,35855,65,179349
29374,0.0003,74.125.24.0-255,5738,41593,65,179349
29375,0.000304,172.31.40.0-255,66,41659,65,179349
29376,0.000309,74.125.24.0-255,4320,45979,65,179349
29377,0.000311,172.31.40.0-255,66,46045,65,179349
29378,0.000347,74.125.24.0-255,2543,48588,65,179349
29379,0.000349,172.31.40.0-255,66,48654,65,179349
29380,0.000449,74.125.24.0-255,1484,50138,65,179349
29381,0.000453,172.31.40.0-255,66,50204,65,179349
29382,0.000458,74.125.24.0-255,2902,53106,65,179349
29383,0.000461,172.31.40.0-255,66,53172,65,179349
29384,0.000464,74.125.24.0-255,1484,54656,65,179349
29385,0.000494,74.125.24.0-255,4320,58976,65,179349
29386,0.000498,172.31.40.0-255,66,59042,65,179349
29387,0.000504,74.125.24.0-255,4320,63362,65,179349
29388,0.000506,172.31.40.0-255,66,63428,65,179349
29389,0.000543,74.125.24.0-255,2543,65971,65,179349
29390,0.000546,172.31.40.0-255,66,66037,65,179349
29391,0.000772,74.125.24.0-255,646,66683,65,179349
29392,0.001174,172.31.40.0-255,66,66749,65,179349
29393,0.001383,74.125.24.0-255,1484,68233,65,179349
29394,0.001394,74.125.24.0-255,2902,71135,65,179349
29395,0.001399,172.31.40.0-255,66,71201,65,179349
29396,0.001403,74.125.24.0-255,1484,72685,65,179349
29397,0.001436,74.125.24.0-255,4320,77005,65,179349
29398,0.001439,172.31.40.0-255,66,77071,65,179349
29399,0.00145,172.31.40.0-255,66,77137,65,179349
29400,0.001481,74.125.24.0-255,7156,84293,65,179349
29401,0.001484,172.31.40.0-255,66,84359,65,179349
29402,0.00152,74.125.24.0-255,6438,90797,65,179349
29403,0.001523,172.31.40.0-255,66,90863,65,179349
29404,0.001671,74.125.24.0-255,1484,92347,65,179349
29405,0.001678,74.125.24.0-255,2902,95249,65,179349
29406,0.001682,172.31.40.0-255,66,95315,65,179349
29407,0.001717,74.125.24.0-255,2902,98217,65,179349
29408,0.00172,172.31.40.0-255,66,98283,65,179349
29409,0.001747,74.125.24.0-255,2902,101185,65,179349
29410,0.00175,172.31.40.0-255,66,101251,65,179349
29411,0.001753,74.125.24.0-255,1484,102735,65,179349
29412,0.001764,172.31.40.0-255,66,102801,65,179349
29413,0.00179,74.125.24.0-255,4320,107121,65,179349
29414,0.001793,172.31.40.0-255,66,107187,65,179349
29415,0.001841,172.31.40.0-255,66,107253,65,179349
29416,0.001888,74.125.24.0-255,1484,108737,65,179349
29417,0.001893,74.125.24.0-255,2902,111639,65,179349
29418,0.001895,172.31.40.0-255,66,111705,65,179349
29419,0.001898,74.125.24.0-255,1484,113189,65,179349
29420,0.001923,74.125.24.0-255,4320,117509,65,179349
29421,0.001925,172.31.40.0-255,66,117575,65,179349
29422,0.001937,172.31.40.0-255,66,117641,65,179349
29423,0.001969,74.125.24.0-255,4320,121961,65,179349
29424,0.001973,172.31.40.0-255,66,122027,65,179349
29425,0.001979,74.125.24.0-255,5738,127765,65,179349
29426,0.001982,172.31.40.0-255,66,127831,65,179349
29427,0.001988,74.125.24.0-255,5020,132851,65,179349
29428,0.001991,172.31.40.0-255,66,132917,65,179349
29429,0.004029,74.125.24.0-255,5738,138655,65,179349
29430,0.004037,172.31.40.0-255,66,138721,65,179349
29431,0.006083,74.125.24.0-255,5738,144459,65,179349
29432,0.006089,172.31.40.0-255,66,144525,65,179349
29433,0.008124,74.125.24.0-255,5738,150263,65,179349
29434,0.00813,172.31.40.0-255,66,150329,65,179349
29435,0.010193,74.125.24.0-255,5738,156067,65,179349
29436,0.010201,172.31.40.0-255,66,156133,65,179349
29437,0.012232,74.125.24.0-255,5738,161871,65,179349
29438,0.012239,172.31.40.0-255,66,161937,65,179349
29439,0.014344,74.125.24.0-255,5738,167675,65,179349
29440,0.014354,172.31.40.0-255,66,167741,65,179349
29441,0.016393,74.125.24.0-255,5738,173479,65,179349
29442,0.016401,172.31.40.0-255,66,173545,65,179349
29443,0.018433,74.125.24.0-255,5738,179283,65,179349
29444,0.018439,172.31.40.0-255,66,179349,65,179349
29445,0.0,172.217.194.0-255,155,155,65,134633
29446,2.4e-05,172.31.40.0-255,66,221,65,134633
29447,3.5e-05,172.217.194.0-255,1484,1705,65,134633
29448,4e-05,172.31.40.0-255,66,1771,65,134633
29449,4.6e-05,172.217.194.0-255,2902,4673,65,134633
29450,5e-05,172.31.40.0-255,66,4739,65,134633
29451,5.8e-05,172.217.194.0-255,7156,11895,65,134633
29452,6e-05,172.31.40.0-255,66,11961,65,134633
29453,6.4e-05,172.217.194.0-255,2027,13988,65,134633
29454,6.8e-05,172.31.40.0-255,66,14054,65,134633
29455,8.2e-05,172.31.40.0-255,66,14120,65,134633
29456,0.000136,172.31.40.0-255,66,14186,65,134633
29457,0.000168,172.31.40.0-255,66,14252,65,134633
29458,0.000183,172.31.40.0-255,66,14318,65,134633
29459,0.000205,172.217.194.0-255,1125,15443,65,134633
29460,0.000208,172.31.40.0-255,66,15509,65,134633
29461,0.00075,172.217.194.0-255,645,16154,65,134633
29462,0.000757,172.31.40.0-255,66,16220,65,134633
29463,0.001104,172.217.194.0-255,1484,17704,65,134633
29464,0.00111,172.31.40.0-255,66,17770,65,134633
29465,0.001117,172.217.194.0-255,2902,20672,65,134633
29466,0.00112,172.31.40.0-255,66,20738,65,134633
29467,0.001127,172.217.194.0-255,5738,26476,65,134633
29468,0.001129,172.31.40.0-255,66,26542,65,134633
29469,0.001154,172.217.194.0-255,1484,28026,65,134633
29470,0.001156,172.31.40.0-255,66,28092,65,134633
29471,0.001179,172.217.194.0-255,4831,32923,65,134633
29472,0.001181,172.31.40.0-255,66,32989,65,134633
29473,0.001299,172.217.194.0-255,1484,34473,65,134633
29474,0.001316,172.217.194.0-255,1484,35957,65,134633
29475,0.001319,172.31.40.0-255,66,36023,65,134633
29476,0.001358,172.217.194.0-255,1484,37507,65,134633
29477,0.001365,172.217.194.0-255,5738,43245,65,134633
29478,0.001369,172.31.40.0-255,66,43311,65,134633
29479,0.001376,172.217.194.0-255,7156,50467,65,134633
29480,0.001379,172.31.40.0-255,66,50533,65,134633
29481,0.001393,172.31.40.0-255,66,50599,65,134633
29482,0.001398,172.217.194.0-255,2184,52783,65,134633
29483,0.0014,172.31.40.0-255,66,52849,65,134633
29484,0.001776,172.217.194.0-255,1484,54333,65,134633
29485,0.001784,172.217.194.0-255,2902,57235,65,134633
29486,0.001788,172.31.40.0-255,66,57301,65,134633
29487,0.001792,172.217.194.0-255,1484,58785,65,134633
29488,0.001812,172.217.194.0-255,4320,63105,65,134633
29489,0.001814,172.31.40.0-255,66,63171,65,134633
29490,0.00184,172.217.194.0-255,2902,66073,65,134633
29491,0.001843,172.31.40.0-255,66,66139,65,134633
29492,0.001851,172.217.194.0-255,7156,73295,65,134633
29493,0.001854,172.31.40.0-255,66,73361,65,134633
29494,0.001876,172.217.194.0-255,2902,76263,65,134633
29495,0.001878,172.31.40.0-255,66,76329,65,134633
29496,0.001905,172.31.40.0-255,66,76395,65,134633
29497,0.002324,172.217.194.0-255,1484,77879,65,134633
29498,0.002331,172.217.194.0-255,2902,80781,65,134633
29499,0.002333,172.31.40.0-255,66,80847,65,134633
29500,0.002336,172.217.194.0-255,1484,82331,65,134633
29501,0.00235,172.217.194.0-255,4320,86651,65,134633
29502,0.002353,172.31.40.0-255,66,86717,65,134633
29503,0.002375,172.217.194.0-255,7156,93873,65,134633
29504,0.002378,172.31.40.0-255,66,93939,65,134633
29505,0.002394,172.217.194.0-255,5738,99677,65,134633
29506,0.002397,172.31.40.0-255,66,99743,65,134633
29507,0.002409,172.31.40.0-255,66,99809,65,134633
29508,0.004996,172.217.194.0-255,5738,105547,65,134633
29509,0.005011,172.31.40.0-255,66,105613,65,134633
29510,0.007589,172.217.194.0-255,5738,111351,65,134633
29511,0.007599,172.31.40.0-255,66,111417,65,134633
29512,0.010167,172.217.194.0-255,5738,117155,65,134633
29513,0.010177,172.31.40.0-255,66,117221,65,134633
29514,0.012777,172.217.194.0-255,5738,122959,65,134633
29515,0.012795,172.31.40.0-255,66,123025,65,134633
29516,0.015366,172.217.194.0-255,5738,128763,65,134633
29517,0.015373,172.31.40.0-255,66,128829,65,134633
29518,0.017937,172.217.194.0-255,5738,134567,65,134633
29519,0.017953,172.31.40.0-255,66,134633,65,134633
29520,0.0,74.125.200.0-255,152,152,65,176302
29521,2.3e-05,172.31.40.0-255,66,218,65,176302
29522,3e-05,74.125.200.0-255,1484,1702,65,176302
29523,3.4e-05,172.31.40.0-255,66,1768,65,176302
29524,3.9e-05,74.125.200.0-255,2902,4670,65,176302
29525,4.3e-05,172.31.40.0-255,66,4736,65,176302
29526,4.9e-05,74.125.200.0-255,4320,9056,65,176302
29527,5.2e-05,172.31.40.0-255,66,9122,65,176302
29528,7.2e-05,74.125.200.0-255,1484,10606,65,176302
29529,7.5e-05,172.31.40.0-255,66,10672,65,176302
29530,8.1e-05,74.125.200.0-255,3401,14073,65,176302
29531,8.3e-05,172.31.40.0-255,66,14139,65,176302
29532,0.00015,74.125.200.0-255,1484,15623,65,176302
29533,0.000153,172.31.40.0-255,66,15689,65,176302
29534,0.000164,74.125.200.0-255,1484,17173,65,176302
29535,0.000166,172.31.40.0-255,66,17239,65,176302
29536,0.000195,74.125.200.0-255,1484,18723,65,176302
29537,0.000198,172.31.40.0-255,66,18789,65,176302
29538,0.000204,74.125.200.0-255,4320,23109,65,176302
29539,0.000206,172.31.40.0-255,66,23175,65,176302
29540,0.000228,74.125.200.0-255,1484,24659,65,176302
29541,0.00023,172.31.40.0-255,66,24725,65,176302
29542,0.000246,74.125.200.0-255,5738,30463,65,176302
29543,0.000248,172.31.40.0-255,66,30529,65,176302
29544,0.000263,74.125.200.0-255,1125,31654,65,176302
29545,0.000265,172.31.40.0-255,66,31720,65,176302
29546,0.000286,74.125.200.0-255,2902,34622,65,176302
29547,0.000289,172.31.40.0-255,66,34688,65,176302
29548,0.000305,74.125.200.0-255,1484,36172,65,176302
29549,0.000307,172.31.40.0-255,66,36238,65,176302
29550,0.000314,74.125.200.0-255,5738,41976,65,176302
29551,0.000316,172.31.40.0-255,66,42042,65,176302
29552,0.000347,74.125.200.0-255,6797,48839,65,176302
29553,0.000404,74.125.200.0-255,1484,50323,65,176302
29554,0.000427,74.125.200.0-255,1484,51807,65,176302
29555,0.000441,74.125.200.0-255,2902,54709,65,176302
29556,0.000474,74.125.200.0-255,5738,60447,65,176302
29557,0.000501,74.125.200.0-255,1484,61931,65,176302
29558,0.000529,74.125.200.0-255,2902,64833,65,176302
29559,0.000532,172.31.40.0-255,66,64899,65,176302
29560,0.000542,172.31.40.0-255,66,64965,65,176302
29561,0.000564,74.125.200.0-255,1125,66090,65,176302
29562,0.00064,74.125.200.0-255,646,66736,65,176302
29563,0.000649,172.31.40.0-255,66,66802,65,176302
29564,0.0007,74.125.200.0-255,1484,68286,65,176302
29565,0.000704,74.125.200.0-255,1484,69770,65,176302
29566,0.000719,74.125.200.0-255,1484,71254,65,176302
29567,0.000722,74.125.200.0-255,1484,72738,65,176302
29568,0.000735,172.31.40.0-255,66,72804,65,176302
29569,0.000747,74.125.200.0-255,2902,75706,65,176302
29570,0.000771,172.31.40.0-255,66,75772,65,176302
29571,0.000785,74.125.200.0-255,5738,81510,65,176302
29572,0.00079,74.125.200.0-255,1484,82994,65,176302
29573,0.000805,74.125.200.0-255,2902,85896,65,176302
29574,0.000816,74.125.200.0-255,1484,87380,65,176302
29575,0.000829,74.125.200.0-255,4320,91700,65,176302
29576,0.000831,74.125.200.0-255,1484,93184,65,176302
29577,0.000834,172.31.40.0-255,66,93250,65,176302
29578,0.000844,74.125.200.0-255,1484,94734,65,176302
29579,0.000847,74.125.200.0-255,1484,96218,65,176302
29580,0.000851,172.31.40.0-255,66,96284,65,176302
29581,0.000861,74.125.200.0-255,2902,99186,65,176302
29582,0.000892,74.125.200.0-255,2184,101370,65,176302
29583,0.000898,172.31.40.0-255,66,101436,65,176302
29584,0.001065,74.125.200.0-255,1484,102920,65,176302
29585,0.001071,74.125.200.0-255,2902,105822,65,176302
29586,0.001076,172.31.40.0-255,66,105888,65,176302
29587,0.001086,74.125.200.0-255,2902,108790,65,176302
29588,0.001103,74.125.200.0-255,4320,113110,65,176302
29589,0.001132,74.125.200.0-255,5738,118848,65,176302
29590,0.001148,74.125.200.0-255,2902,121750,65,176302
29591,0.001154,74.125.200.0-255,5738,127488,65,176302
29592,0.001156,74.125.200.0-255,1484,128972,65,176302
29593,0.001159,172.31.40.0-255,66,129038,65,176302
29594,0.001165,172.31.40.0-255,66,129104,65,176302
29595,0.00118,74.125.200.0-255,5738,134842,65,176302
29596,0.001183,74.125.200.0-255,766,135608,65,176302
29597,0.001202,172.31.40.0-255,66,135674,65,176302
29598,0.003547,74.125.200.0-255,5738,141412,65,176302
29599,0.003556,172.31.40.0-255,66,141478,65,176302
29600,0.005907,74.125.200.0-255,5738,147216,65,176302
29601,0.005913,172.31.40.0-255,66,147282,65,176302
29602,0.008258,74.125.200.0-255,5738,153020,65,176302
29603,0.008267,172.31.40.0-255,66,153086,65,176302
29604,0.01063,74.125.200.0-255,5738,158824,65,176302
29605,0.010642,172.31.40.0-255,66,158890,65,176302
29606,0.013034,74.125.200.0-255,5738,164628,65,176302
29607,0.013047,172.31.40.0-255,66,164694,65,176302
29608,0.015489,74.125.200.0-255,5738,170432,65,176302
29609,0.015879,172.31.40.0-255,66,170498,65,176302
29610,0.018236,74.125.200.0-255,5738,176236,65,176302
29611,0.018251,172.31.40.0-255,66,176302,65,176302
29612,0.0,74.125.24.0-255,153,153,65,192279
29613,1.3e-05,172.31.40.0-255,66,219,65,192279
29614,1.9e-05,74.125.24.0-255,1484,1703,65,192279
29615,2.4e-05,172.31.40.0-255,66,1769,65,192279
29616,2.9e-05,74.125.24.0-255,2902,4671,65,192279
29617,3.9e-05,172.31.40.0-255,66,4737,65,192279
29618,4.3e-05,74.125.24.0-255,2902,7639,65,192279
29619,4.5e-05,172.31.40.0-255,66,7705,65,192279
29620,7.6e-05,74.125.24.0-255,4320,12025,65,192279
29621,7.9e-05,172.31.40.0-255,66,12091,65,192279
29622,0.000121,74.125.24.0-255,1981,14072,65,192279
29623,0.000123,172.31.40.0-255,66,14138,65,192279
29624,0.000127,74.125.24.0-255,2902,17040,65,192279
29625,0.000129,172.31.40.0-255,66,17106,65,192279
29626,0.000135,74.125.24.0-255,5738,22844,65,192279
29627,0.000137,172.31.40.0-255,66,22910,65,192279
29628,0.000152,74.125.24.0-255,1484,24394,65,192279
29629,0.000154,172.31.40.0-255,66,24460,65,192279
29630,0.000159,74.125.24.0-255,4320,28780,65,192279
29631,0.000161,172.31.40.0-255,66,28846,65,192279
29632,0.000197,74.125.24.0-255,2543,31389,65,192279
29633,0.000199,172.31.40.0-255,66,31455,65,192279
29634,0.0003,74.125.24.0-255,1484,32939,65,192279
29635,0.000304,172.31.40.0-255,66,33005,65,192279
29636,0.000321,74.125.24.0-255,2902,35907,65,192279
29637,0.000323,172.31.40.0-255,66,35973,65,192279
29638,0.000332,74.125.24.0-255,5738,41711,65,192279
29639,0.000334,172.31.40.0-255,66,41777,65,192279
29640,0.00039,172.31.40.0-255,66,41843,65,192279
29641,0.000426,172.31.40.0-255,66,41909,65,192279
29642,0.000428,74.125.24.0-255,330,42239,65,192279
29643,0.000634,74.125.24.0-255,1484,43723,65,192279
29644,0.000638,172.31.40.0-255,66,43789,65,192279
29645,0.000643,74.125.24.0-255,2902,46691,65,192279
29646,0.000645,172.31.40.0-255,66,46757,65,192279
29647,0.000648,74.125.24.0-255,1484,48241,65,192279
29648,0.000662,74.125.24.0-255,4320,52561,65,192279
29649,0.000664,172.31.40.0-255,66,52627,65,192279
29650,0.000673,74.125.24.0-255,5738,58365,65,192279
29651,0.000675,172.31.40.0-255,66,58431,65,192279
29652,0.000707,172.31.40.0-255,66,58497,65,192279
29653,0.000731,74.125.24.0-255,2902,61399,65,192279
29654,0.000733,172.31.40.0-255,66,61465,65,192279
29655,0.000739,74.125.24.0-255,5020,66485,65,192279
29656,0.000741,172.31.40.0-255,66,66551,65,192279
29657,0.000869,74.125.24.0-255,1484,68035,65,192279
29658,0.000874,74.125.24.0-255,1484,69519,65,192279
29659,0.000877,172.31.40.0-255,66,69585,65,192279
29660,0.000918,74.125.24.0-255,1484,71069,65,192279
29661,0.000925,74.125.24.0-255,5738,76807,65,192279
29662,0.000928,172.31.40.0-255,66,76873,65,192279
29663,0.000945,172.31.40.0-255,66,76939,65,192279
29664,0.000957,172.31.40.0-255,66,77005,65,192279
29665,0.000978,74.125.24.0-255,2184,79189,65,192279
29666,0.00098,172.31.40.0-255,66,79255,65,192279
29667,0.001282,74.125.24.0-255,1484,80739,65,192279
29668,0.001288,74.125.24.0-255,2902,83641,65,192279
29669,0.001291,172.31.40.0-255,66,83707,65,192279
29670,0.001297,74.125.24.0-255,2902,86609,65,192279
29671,0.001299,172.31.40.0-255,66,86675,65,192279
29672,0.001321,74.125.24.0-255,2902,89577,65,192279
29673,0.001323,172.31.40.0-255,66,89643,65,192279
29674,0.00133,74.125.24.0-255,5738,95381,65,192279
29675,0.001332,172.31.40.0-255,66,95447,65,192279
29676,0.001369,74.125.24.0-255,7156,102603,65,192279
29677,0.001372,172.31.40.0-255,66,102669,65,192279
29678,0.001376,74.125.24.0-255,1484,104153,65,192279
29679,0.00141,172.31.40.0-255,66,104219,65,192279
29680,0.00202,74.125.24.0-255,1484,105703,65,192279
29681,0.002026,74.125.24.0-255,2902,108605,65,192279
29682,0.00203,172.31.40.0-255,66,108671,65,192279
29683,0.002034,74.125.24.0-255,1484,110155,65,192279
29684,0.002063,74.125.24.0-255,4320,114475,65,192279
29685,0.002065,172.31.40.0-255,66,114541,65,192279
29686,0.002073,74.125.24.0-255,7156,121697,65,192279
29687,0.002075,172.31.40.0-255,66,121763,65,192279
29688,0.002147,172.31.40.0-255,66,121829,65,192279
29689,0.002175,74.125.24.0-255,2902,124731,65,192279
29690,0.002177,172.31.40.0-255,66,124797,65,192279
29691,0.002183,74.125.24.0-255,5020,129817,65,192279
29692,0.002185,172.31.40.0-255,66,129883,65,192279
29693,0.002716,74.125.24.0-255,1484,131367,65,192279
29694,0.002723,74.125.24.0-255,2902,134269,65,192279
29695,0.002727,172.31.40.0-255,66,134335,65,192279
29696,0.002744,74.125.24.0-255,1484,135819,65,192279
29697,0.002763,74.125.24.0-255,5738,141557,65,192279
29698,0.002765,172.31.40.0-255,66,141623,65,192279
29699,0.002792,74.125.24.0-255,5738,147361,65,192279
29700,0.002794,172.31.40.0-255,66,147427,65,192279
29701,0.002821,74.125.24.0-255,2902,150329,65,192279
29702,0.002823,172.31.40.0-255,66,150395,65,192279
29703,0.002833,172.31.40.0-255,66,150461,65,192279
29704,0.002837,74.125.24.0-255,3602,154063,65,192279
29705,0.002845,74.125.24.0-255,7156,161219,65,192279
29706,0.002849,172.31.40.0-255,66,161285,65,192279
29707,0.00285,172.31.40.0-255,66,161351,65,192279
29708,0.002898,172.31.40.0-255,66,161417,65,192279
29709,0.0029,172.31.40.0-255,66,161483,65,192279
29710,0.002926,172.31.40.0-255,66,161549,65,192279
29711,0.00296,172.31.40.0-255,66,161615,65,192279
29712,0.002963,74.125.24.0-255,1484,163099,65,192279
29713,0.002966,74.125.24.0-255,1484,164583,65,192279
29714,0.002967,172.31.40.0-255,66,164649,65,192279
29715,0.002988,172.31.40.0-255,66,164715,65,192279
29716,0.003011,172.31.40.0-255,66,164781,65,192279
29717,0.003028,172.31.40.0-255,66,164847,65,192279
29718,0.00304,172.31.40.0-255,66,164913,65,192279
29719,0.003059,74.125.24.0-255,2184,167097,65,192279
29720,0.003061,172.31.40.0-255,66,167163,65,192279
29721,0.003063,74.125.24.0-255,1484,168647,65,192279
29722,0.003069,74.125.24.0-255,5738,174385,65,192279
29723,0.003071,172.31.40.0-255,66,174451,65,192279
29724,0.003109,172.31.40.0-255,66,174517,65,192279
29725,0.00312,172.31.40.0-255,66,174583,65,192279
29726,0.003123,74.125.24.0-255,2184,176767,65,192279
29727,0.003126,172.31.40.0-255,66,176833,65,192279
29728,0.003129,74.125.24.0-255,2902,179735,65,192279
29729,0.003132,172.31.40.0-255,66,179801,65,192279
29730,0.003154,74.125.24.0-255,5738,185539,65,192279
29731,0.003157,172.31.40.0-255,66,185605,65,192279
29732,0.003194,74.125.24.0-255,1484,187089,65,192279
29733,0.003224,172.31.40.0-255,66,187155,65,192279
29734,0.003234,172.31.40.0-255,66,187221,65,192279
29735,0.003239,74.125.24.0-255,4553,191774,65,192279
29736,0.003242,172.31.40.0-255,66,191840,65,192279
29737,0.003245,74.125.24.0-255,97,191937,65,192279
29738,0.003247,74.125.24.0-255,105,192042,65,192279
29739,0.005255,172.31.40.0-255,66,192108,65,192279
29740,0.005293,172.31.40.0-255,105,192213,65,192279
29741,0.00784,74.125.24.0-255,66,192279,65,192279
29742,0.0,172.217.194.0-255,312,312,65,173069
29743,2.4e-05,172.31.40.0-255,66,378,65,173069
29744,3.2e-05,172.217.194.0-255,1484,1862,65,173069
29745,3.7e-05,172.31.40.0-255,66,1928,65,173069
29746,4.3e-05,172.217.194.0-255,4320,6248,65,173069
29747,4.7e-05,172.31.40.0-255,66,6314,65,173069
29748,5.4e-05,172.217.194.0-255,5738,12052,65,173069
29749,5.7e-05,172.31.40.0-255,66,12118,65,173069
29750,7.7e-05,172.217.194.0-255,2098,14216,65,173069
29751,8e-05,172.31.40.0-255,66,14282,65,173069
29752,0.000117,172.31.40.0-255,66,14348,65,173069
29753,0.000128,172.31.40.0-255,66,14414,65,173069
29754,0.00025,172.217.194.0-255,1484,15898,65,173069
29755,0.000255,172.31.40.0-255,66,15964,65,173069
29756,0.000261,172.217.194.0-255,2902,18866,65,173069
29757,0.000263,172.31.40.0-255,66,18932,65,173069
29758,0.000269,172.217.194.0-255,5738,24670,65,173069
29759,0.000272,172.31.40.0-255,66,24736,65,173069
29760,0.000314,172.217.194.0-255,6797,31533,65,173069
29761,0.000317,172.31.40.0-255,66,31599,65,173069
29762,0.000328,172.217.194.0-255,1484,33083,65,173069
29763,0.00033,172.31.40.0-255,66,33149,65,173069
29764,0.00035,172.217.194.0-255,5738,38887,65,173069
29765,0.000353,172.31.40.0-255,66,38953,65,173069
29766,0.000359,172.217.194.0-255,5738,44691,65,173069
29767,0.000361,172.31.40.0-255,66,44757,65,173069
29768,0.00038,172.217.194.0-255,3961,48718,65,173069
29769,0.000383,172.31.40.0-255,66,48784,65,173069
29770,0.000572,172.217.194.0-255,646,49430,65,173069
29771,0.000577,172.31.40.0-255,66,49496,65,173069
29772,0.000665,172.217.194.0-255,1484,50980,65,173069
29773,0.000671,172.217.194.0-255,1484,52464,65,173069
29774,0.000674,172.31.40.0-255,66,52530,65,173069
29775,0.000692,172.217.194.0-255,1484,54014,65,173069
29776,0.000698,172.217.194.0-255,5738,59752,65,173069
29777,0.000701,172.31.40.0-255,66,59818,65,173069
29778,0.000757,172.31.40.0-255,66,59884,65,173069
29779,0.000765,172.217.194.0-255,7156,67040,65,173069
29780,0.000767,172.31.40.0-255,66,67106,65,173069
29781,0.000781,172.217.194.0-255,3602,70708,65,173069
29782,0.000784,172.31.40.0-255,66,70774,65,173069
29783,0.000836,172.217.194.0-255,1484,72258,65,173069
29784,0.000851,172.217.194.0-255,2902,75160,65,173069
29785,0.000855,172.31.40.0-255,66,75226,65,173069
29786,0.00086,172.217.194.0-255,4320,79546,65,173069
29787,0.000862,172.31.40.0-255,66,79612,65,173069
29788,0.000875,172.217.194.0-255,1484,81096,65,173069
29789,0.000883,172.217.194.0-255,5738,86834,65,173069
29790,0.000885,172.31.40.0-255,66,86900,65,173069
29791,0.000906,172.217.194.0-255,4320,91220,65,173069
29792,0.000909,172.31.40.0-255,66,91286,65,173069
29793,0.000969,172.217.194.0-255,5738,97024,65,173069
29794,0.000972,172.31.40.0-255,66,97090,65,173069
29795,0.000995,172.31.40.0-255,66,97156,65,173069
29796,0.001011,172.31.40.0-255,66,97222,65,173069
29797,0.001023,172.31.40.0-255,66,97288,65,173069
29798,0.001058,172.31.40.0-255,66,97354,65,173069
29799,0.00107,172.31.40.0-255,66,97420,65,173069
29800,0.001073,172.217.194.0-255,1484,98904,65,173069
29801,0.001111,172.31.40.0-255,66,98970,65,173069
29802,0.001127,172.217.194.0-255,4320,103290,65,173069
29803,0.00113,172.31.40.0-255,66,103356,65,173069
29804,0.001133,172.217.194.0-255,766,104122,65,173069
29805,0.00122,172.217.194.0-255,1484,105606,65,173069
29806,0.001224,172.31.40.0-255,66,105672,65,173069
29807,0.001229,172.217.194.0-255,2902,108574,65,173069
29808,0.001231,172.31.40.0-255,66,108640,65,173069
29809,0.001235,172.217.194.0-255,2902,111542,65,173069
29810,0.001237,172.31.40.0-255,66,111608,65,173069
29811,0.001257,172.217.194.0-255,2902,114510,65,173069
29812,0.00126,172.31.40.0-255,66,114576,65,173069
29813,0.001266,172.217.194.0-255,5738,120314,65,173069
29814,0.001268,172.31.40.0-255,66,120380,65,173069
29815,0.001282,172.31.40.0-255,66,120446,65,173069
29816,0.001342,172.217.194.0-255,5020,125466,65,173069
29817,0.001345,172.31.40.0-255,66,125532,65,173069
29818,0.001545,172.217.194.0-255,1484,127016,65,173069
29819,0.001566,172.217.194.0-255,2902,129918,65,173069
29820,0.00157,172.31.40.0-255,66,129984,65,173069
29821,0.001575,172.217.194.0-255,2902,132886,65,173069
29822,0.001577,172.31.40.0-255,66,132952,65,173069
29823,0.001595,172.217.194.0-255,2902,135854,65,173069
29824,0.001598,172.31.40.0-255,66,135920,65,173069
29825,0.001615,172.31.40.0-255,66,135986,65,173069
29826,0.001633,172.217.194.0-255,1484,137470,65,173069
29827,0.001645,172.31.40.0-255,66,137536,65,173069
29828,0.001659,172.217.194.0-255,1484,139020,65,173069
29829,0.00168,172.217.194.0-255,2902,141922,65,173069
29830,0.001682,172.31.40.0-255,66,141988,65,173069
29831,0.001688,172.217.194.0-255,5738,147726,65,173069
29832,0.00169,172.31.40.0-255,66,147792,65,173069
29833,0.001714,172.31.40.0-255,66,147858,65,173069
29834,0.001742,172.217.194.0-255,2902,150760,65,173069
29835,0.001745,172.31.40.0-255,66,150826,65,173069
29836,0.001757,172.31.40.0-255,66,150892,65,173069
29837,0.001798,172.217.194.0-255,1484,152376,65,173069
29838,0.001802,172.217.194.0-255,2902,155278,65,173069
29839,0.001805,172.31.40.0-255,66,155344,65,173069
29840,0.00181,172.217.194.0-255,5738,161082,65,173069
29841,0.001813,172.31.40.0-255,66,161148,65,173069
29842,0.001882,172.31.40.0-255,66,161214,65,173069
29843,0.001893,172.31.40.0-255,66,161280,65,173069
29844,0.001927,172.31.40.0-255,66,161346,65,173069
29845,0.001931,172.217.194.0-255,2902,164248,65,173069
29846,0.001933,172.31.40.0-255,66,164314,65,173069
29847,0.001952,172.31.40.0-255,66,164380,65,173069
29848,0.001981,172.217.194.0-255,4320,168700,65,173069
29849,0.001983,172.31.40.0-255,66,168766,65,173069
29850,0.002008,172.31.40.0-255,66,168832,65,173069
29851,0.002038,172.217.194.0-255,2902,171734,65,173069
29852,0.002041,172.31.40.0-255,66,171800,65,173069
29853,0.00207,172.31.40.0-255,66,171866,65,173069
29854,0.002087,172.31.40.0-255,66,171932,65,173069
29855,0.00209,172.217.194.0-255,105,172037,65,173069
29856,0.002093,172.217.194.0-255,129,172166,65,173069
29857,0.013296,172.217.194.0-255,129,172295,65,173069
29858,0.013315,172.31.40.0-255,78,172373,65,173069
29859,0.014414,172.31.40.0-255,105,172478,65,173069
29860,0.014458,172.31.40.0-255,105,172583,65,173069
29861,0.014704,172.31.40.0-255,90,172673,65,173069
29862,0.014713,172.31.40.0-255,66,172739,65,173069
29863,0.017009,172.217.194.0-255,66,172805,65,173069
29864,0.017026,172.217.194.0-255,66,172871,65,173069
29865,0.017266,172.217.194.0-255,66,172937,65,173069
29866,0.017301,172.217.194.0-255,66,173003,65,173069
29867,0.017314,172.31.40.0-255,66,173069,65,173069
29868,0.0,74.125.68.0-255,153,153,65,334031
29869,2.1e-05,172.31.40.0-255,66,219,65,334031
29870,2.7e-05,74.125.68.0-255,1484,1703,65,334031
29871,3.1e-05,172.31.40.0-255,66,1769,65,334031
29872,6.6e-05,74.125.68.0-255,2902,4671,65,334031
29873,7e-05,172.31.40.0-255,66,4737,65,334031
29874,7.8e-05,74.125.68.0-255,5738,10475,65,334031
29875,8.1e-05,172.31.40.0-255,66,10541,65,334031
29876,0.000127,74.125.68.0-255,3429,13970,65,334031
29877,0.000129,172.31.40.0-255,66,14036,65,334031
29878,0.000263,74.125.68.0-255,1484,15520,65,334031
29879,0.000269,172.31.40.0-255,66,15586,65,334031
29880,0.000273,74.125.68.0-255,1484,17070,65,334031
29881,0.000274,172.31.40.0-255,66,17136,65,334031
29882,0.000312,74.125.68.0-255,2902,20038,65,334031
29883,0.000314,172.31.40.0-255,66,20104,65,334031
29884,0.000321,74.125.68.0-255,5738,25842,65,334031
29885,0.000324,172.31.40.0-255,66,25908,65,334031
29886,0.000327,74.125.68.0-255,1484,27392,65,334031
29887,0.000333,172.31.40.0-255,66,27458,65,334031
29888,0.000383,74.125.68.0-255,2902,30360,65,334031
29889,0.000386,172.31.40.0-255,66,30426,65,334031
29890,0.00042,74.125.68.0-255,3961,34387,65,334031
29891,0.000423,172.31.40.0-255,66,34453,65,334031
29892,0.000431,74.125.68.0-255,7156,41609,65,334031
29893,0.000433,172.31.40.0-255,66,41675,65,334031
29894,0.000443,74.125.68.0-255,4320,45995,65,334031
29895,0.000445,172.31.40.0-255,66,46061,65,334031
29896,0.000451,74.125.68.0-255,4320,50381,65,334031
29897,0.000454,172.31.40.0-255,66,50447,65,334031
29898,0.000474,74.125.68.0-255,1484,51931,65,334031
29899,0.000476,172.31.40.0-255,66,51997,65,334031
29900,0.000507,74.125.68.0-255,7156,59153,65,334031
29901,0.000535,74.125.68.0-255,4320,63473,65,334031
29902,0.000549,74.125.68.0-255,2184,65657,65,334031
29903,0.000551,74.125.68.0-255,402,66059,65,334031
29904,0.000574,172.31.40.0-255,66,66125,65,334031
29905,0.000602,74.125.68.0-255,113,66238,65,334031
29906,0.000687,74.125.68.0-255,1484,67722,65,334031
29907,0.000694,74.125.68.0-255,2902,70624,65,334031
29908,0.00071,74.125.68.0-255,1484,72108,65,334031
29909,0.000728,74.125.68.0-255,4320,76428,65,334031
29910,0.000732,74.125.68.0-255,1484,77912,65,334031
29911,0.000738,172.31.40.0-255,66,77978,65,334031
29912,0.000769,74.125.68.0-255,4320,82298,65,334031
29913,0.000777,74.125.68.0-255,7156,89454,65,334031
29914,0.00078,74.125.68.0-255,1484,90938,65,334031
29915,0.00079,172.31.40.0-255,66,91004,65,334031
29916,0.00081,172.31.40.0-255,66,91070,65,334031
29917,0.000816,74.125.68.0-255,327,91397,65,334031
29918,0.000993,74.125.68.0-255,1484,92881,65,334031
29919,0.001,74.125.68.0-255,2902,95783,65,334031
29920,0.001029,74.125.68.0-255,5738,101521,65,334031
29921,0.001034,74.125.68.0-255,4320,105841,65,334031
29922,0.001069,172.31.40.0-255,66,105907,65,334031
29923,0.001101,74.125.68.0-255,5738,111645,65,334031
29924,0.001116,74.125.68.0-255,2184,113829,65,334031
29925,0.001133,172.31.40.0-255,66,113895,65,334031
29926,0.001167,74.125.68.0-255,1484,115379,65,334031
29927,0.001182,74.125.68.0-255,2902,118281,65,334031
29928,0.001193,172.31.40.0-255,66,118347,65,334031
29929,0.0012,74.125.68.0-255,1484,119831,65,334031
29930,0.001217,74.125.68.0-255,4320,124151,65,334031
29931,0.001227,74.125.68.0-255,1484,125635,65,334031
29932,0.00124,172.31.40.0-255,66,125701,65,334031
29933,0.001251,74.125.68.0-255,4320,130021,65,334031
29934,0.001256,172.31.40.0-255,66,130087,65,334031
29935,0.001286,74.125.68.0-255,1484,131571,65,334031
29936,0.001295,74.125.68.0-255,7156,138727,65,334031
29937,0.001302,74.125.68.0-255,7156,145883,65,334031
29938,0.001308,172.31.40.0-255,66,145949,65,334031
29939,0.001317,74.125.68.0-255,2184,148133,65,334031
29940,0.001341,172.31.40.0-255,66,148199,65,334031
29941,0.001394,74.125.68.0-255,1484,149683,65,334031
29942,0.001415,74.125.68.0-255,2902,152585,65,334031
29943,0.001429,74.125.68.0-255,2902,155487,65,334031
29944,0.001441,74.125.68.0-255,2902,158389,65,334031
29945,0.001448,172.31.40.0-255,66,158455,65,334031
29946,0.001471,74.125.68.0-255,5738,164193,65,334031
29947,0.001479,74.125.68.0-255,7156,171349,65,334031
29948,0.001487,172.31.40.0-255,66,171415,65,334031
29949,0.001495,74.125.68.0-255,1484,172899,65,334031
29950,0.001537,74.125.68.0-255,766,173665,65,334031
29951,0.001555,172.31.40.0-255,66,173731,65,334031
29952,0.001582,74.125.68.0-255,1484,175215,65,334031
29953,0.001596,74.125.68.0-255,2902,178117,65,334031
29954,0.00161,74.125.68.0-255,2902,181019,65,334031
29955,0.001621,74.125.68.0-255,1484,182503,65,334031
29956,0.001624,172.31.40.0-255,66,182569,65,334031
29957,0.001634,74.125.68.0-255,2902,185471,65,334031
29958,0.00166,74.125.68.0-255,5738,191209,65,334031
29959,0.001664,74.125.68.0-255,2902,194111,65,334031
29960,0.00168,74.125.68.0-255,5738,199849,65,334031
29961,0.001685,172.31.40.0-255,66,199915,65,334031
29962,0.001696,74.125.68.0-255,5738,205653,65,334031
29963,0.0017,172.31.40.0-255,66,205719,65,334031
29964,0.001715,74.125.68.0-255,1484,207203,65,334031
29965,0.001717,74.125.68.0-255,766,207969,65,334031
29966,0.001737,172.31.40.0-255,66,208035,65,334031
29967,0.001745,74.125.68.0-255,1484,209519,65,334031
29968,0.001763,74.125.68.0-255,2902,212421,65,334031
29969,0.001781,74.125.68.0-255,2902,215323,65,334031
29970,0.001784,172.31.40.0-255,66,215389,65,334031
29971,0.001794,74.125.68.0-255,2902,218291,65,334031
29972,0.001809,74.125.68.0-255,2902,221193,65,334031
29973,0.001813,172.31.40.0-255,66,221259,65,334031
29974,0.001856,74.125.68.0-255,4320,225579,65,334031
29975,0.001861,74.125.68.0-255,2902,228481,65,334031
29976,0.001866,74.125.68.0-255,4320,232801,65,334031
29977,0.001882,172.31.40.0-255,66,232867,65,334031
29978,0.001905,74.125.68.0-255,7156,240023,65,334031
29979,0.001917,74.125.68.0-255,1484,241507,65,334031
29980,0.001932,74.125.68.0-255,766,242273,65,334031
29981,0.001938,172.31.40.0-255,66,242339,65,334031
29982,0.001973,74.125.68.0-255,1484,243823,65,334031
29983,0.002005,74.125.68.0-255,4320,248143,65,334031
29984,0.002009,74.125.68.0-255,1484,249627,65,334031
29985,0.002013,74.125.68.0-255,2902,252529,65,334031
29986,0.002035,74.125.68.0-255,5738,258267,65,334031
29987,0.002052,172.31.40.0-255,66,258333,65,334031
29988,0.002055,74.125.68.0-255,1484,259817,65,334031
29989,0.002088,74.125.68.0-255,5738,265555,65,334031
29990,0.002128,74.125.68.0-255,7156,272711,65,334031
29991,0.002142,74.125.68.0-255,1484,274195,65,334031
29992,0.002146,74.125.68.0-255,2184,276379,65,334031
29993,0.002155,172.31.40.0-255,66,276445,65,334031
29994,0.002205,74.125.68.0-255,1484,277929,65,334031
29995,0.002222,74.125.68.0-255,2902,280831,65,334031
29996,0.002244,74.125.68.0-255,2902,283733,65,334031
29997,0.002264,172.31.40.0-255,66,283799,65,334031
29998,0.002269,74.125.68.0-255,2902,286701,65,334031
29999,0.00227,74.125.68.0-255,1484,288185,65,334031
30000,0.002274,74.125.68.0-255,2902,291087,65,334031
30001,0.002285,172.31.40.0-255,66,291153,65,334031
30002,0.002318,74.125.68.0-255,5738,296891,65,334031
30003,0.002326,74.125.68.0-255,7156,304047,65,334031
30004,0.002358,74.125.68.0-255,2902,306949,65,334031
30005,0.002372,74.125.68.0-255,3602,310551,65,334031
30006,0.002445,74.125.68.0-255,1484,312035,65,334031
30007,0.002464,74.125.68.0-255,2902,314937,65,334031
30008,0.00249,74.125.68.0-255,2902,317839,65,334031
30009,0.010112,172.31.40.0-255,66,317905,65,334031
30010,0.01262,74.125.68.0-255,5738,323643,65,334031
30011,0.012633,172.31.40.0-255,66,323709,65,334031
30012,0.015108,74.125.68.0-255,4320,328029,65,334031
30013,0.015116,172.31.40.0-255,66,328095,65,334031
30014,0.015145,74.125.68.0-255,1484,329579,65,334031
30015,0.017586,74.125.68.0-255,2902,332481,65,334031
30016,0.017601,74.125.68.0-255,1484,333965,65,334031
30017,0.018022,172.31.40.0-255,66,334031,65,334031
30018,0.0,172.253.118.0-255,300,300,65,250993
30019,2.3e-05,172.31.40.0-255,66,366,65,250993
30020,4.9e-05,172.253.118.0-255,1484,1850,65,250993
30021,5.5e-05,172.31.40.0-255,66,1916,65,250993
30022,6.1e-05,172.253.118.0-255,4320,6236,65,250993
30023,6.4e-05,172.31.40.0-255,66,6302,65,250993
30024,7.2e-05,172.253.118.0-255,7156,13458,65,250993
30025,7.5e-05,172.31.40.0-255,66,13524,65,250993
30026,7.8e-05,172.253.118.0-255,495,14019,65,250993
30027,8.1e-05,172.31.40.0-255,66,14085,65,250993
30028,0.000327,172.253.118.0-255,1484,15569,65,250993
30029,0.000333,172.31.40.0-255,66,15635,65,250993
30030,0.000339,172.253.118.0-255,2902,18537,65,250993
30031,0.000342,172.31.40.0-255,66,18603,65,250993
30032,0.000348,172.253.118.0-255,5738,24341,65,250993
30033,0.00035,172.31.40.0-255,66,24407,65,250993
30034,0.000403,172.253.118.0-255,6797,31204,65,250993
30035,0.000407,172.31.40.0-255,66,31270,65,250993
30036,0.000442,172.253.118.0-255,1484,32754,65,250993
30037,0.000444,172.31.40.0-255,66,32820,65,250993
30038,0.000473,172.253.118.0-255,2902,35722,65,250993
30039,0.000476,172.31.40.0-255,66,35788,65,250993
30040,0.000482,172.253.118.0-255,5738,41526,65,250993
30041,0.000485,172.31.40.0-255,66,41592,65,250993
30042,0.000489,172.253.118.0-255,2902,44494,65,250993
30043,0.000491,172.31.40.0-255,66,44560,65,250993
30044,0.00052,172.253.118.0-255,3961,48521,65,250993
30045,0.000523,172.31.40.0-255,66,48587,65,250993
30046,0.002514,172.253.118.0-255,1484,50071,65,250993
30047,0.002523,172.31.40.0-255,66,50137,65,250993
30048,0.002531,172.253.118.0-255,2902,53039,65,250993
30049,0.002533,172.31.40.0-255,66,53105,65,250993
30050,0.002545,172.253.118.0-255,5738,58843,65,250993
30051,0.002548,172.31.40.0-255,66,58909,65,250993
30052,0.002551,172.253.118.0-255,1484,60393,65,250993
30053,0.002584,172.253.118.0-255,5379,65772,65,250993
30054,0.002586,172.31.40.0-255,66,65838,65,250993
30055,0.002589,172.253.118.0-255,646,66484,65,250993
30056,0.002782,172.253.118.0-255,1484,67968,65,250993
30057,0.002784,172.31.40.0-255,66,68034,65,250993
30058,0.002797,172.253.118.0-255,2902,70936,65,250993
30059,0.0028,172.31.40.0-255,66,71002,65,250993
30060,0.002808,172.253.118.0-255,2902,73904,65,250993
30061,0.00281,172.31.40.0-255,66,73970,65,250993
30062,0.002849,172.253.118.0-255,2902,76872,65,250993
30063,0.002851,172.31.40.0-255,66,76938,65,250993
30064,0.002857,172.253.118.0-255,4320,81258,65,250993
30065,0.002859,172.31.40.0-255,66,81324,65,250993
30066,0.002863,172.253.118.0-255,2543,83867,65,250993
30067,0.002865,172.31.40.0-255,66,83933,65,250993
30068,0.002868,172.253.118.0-255,1484,85417,65,250993
30069,0.002873,172.253.118.0-255,2902,88319,65,250993
30070,0.002875,172.31.40.0-255,66,88385,65,250993
30071,0.002909,172.253.118.0-255,4320,92705,65,250993
30072,0.002911,172.31.40.0-255,66,92771,65,250993
30073,0.002923,172.31.40.0-255,66,92837,65,250993
30074,0.003234,172.253.118.0-255,1484,94321,65,250993
30075,0.003248,172.253.118.0-255,2902,97223,65,250993
30076,0.00325,172.31.40.0-255,66,97289,65,250993
30077,0.003274,172.253.118.0-255,2902,100191,65,250993
30078,0.003276,172.31.40.0-255,66,100257,65,250993
30079,0.0033,172.253.118.0-255,2902,103159,65,250993
30080,0.003303,172.31.40.0-255,66,103225,65,250993
30081,0.003307,172.253.118.0-255,2902,106127,65,250993
30082,0.003309,172.31.40.0-255,66,106193,65,250993
30083,0.003321,172.31.40.0-255,66,106259,65,250993
30084,0.003343,172.253.118.0-255,2902,109161,65,250993
30085,0.003346,172.31.40.0-255,66,109227,65,250993
30086,0.003384,172.31.40.0-255,66,109293,65,250993
30087,0.004271,172.253.118.0-255,1484,110777,65,250993
30088,0.004279,172.253.118.0-255,2902,113679,65,250993
30089,0.004284,172.31.40.0-255,66,113745,65,250993
30090,0.004291,172.253.118.0-255,5738,119483,65,250993
30091,0.004294,172.31.40.0-255,66,119549,65,250993
30092,0.004307,172.253.118.0-255,7156,126705,65,250993
30093,0.00431,172.31.40.0-255,66,126771,65,250993
30094,0.004366,172.31.40.0-255,66,126837,65,250993
30095,0.00437,172.253.118.0-255,2184,129021,65,250993
30096,0.004372,172.31.40.0-255,66,129087,65,250993
30097,0.004947,172.253.118.0-255,1484,130571,65,250993
30098,0.004955,172.253.118.0-255,2902,133473,65,250993
30099,0.004959,172.31.40.0-255,66,133539,65,250993
30100,0.004967,172.253.118.0-255,5738,139277,65,250993
30101,0.004969,172.31.40.0-255,66,139343,65,250993
30102,0.004993,172.253.118.0-255,5738,145081,65,250993
30103,0.004995,172.31.40.0-255,66,145147,65,250993
30104,0.005034,172.253.118.0-255,7156,152303,65,250993
30105,0.005037,172.31.40.0-255,66,152369,65,250993
30106,0.005048,172.31.40.0-255,66,152435,65,250993
30107,0.005052,172.253.118.0-255,2184,154619,65,250993
30108,0.005054,172.31.40.0-255,66,154685,65,250993
30109,0.005143,172.253.118.0-255,1484,156169,65,250993
30110,0.005157,172.253.118.0-255,2902,159071,65,250993
30111,0.00516,172.31.40.0-255,66,159137,65,250993
30112,0.005165,172.253.118.0-255,2902,162039,65,250993
30113,0.005167,172.31.40.0-255,66,162105,65,250993
30114,0.005192,172.253.118.0-255,2902,165007,65,250993
30115,0.005195,172.31.40.0-255,66,165073,65,250993
30116,0.005215,172.31.40.0-255,66,165139,65,250993
30117,0.005222,172.253.118.0-255,7156,172295,65,250993
30118,0.005225,172.31.40.0-255,66,172361,65,250993
30119,0.00526,172.31.40.0-255,66,172427,65,250993
30120,0.005299,172.31.40.0-255,66,172493,65,250993
30121,0.005314,172.31.40.0-255,66,172559,65,250993
30122,0.00532,172.253.118.0-255,3602,176161,65,250993
30123,0.005323,172.31.40.0-255,66,176227,65,250993
30124,0.005564,172.253.118.0-255,1484,177711,65,250993
30125,0.005571,172.253.118.0-255,2902,180613,65,250993
30126,0.005574,172.31.40.0-255,66,180679,65,250993
30127,0.005603,172.253.118.0-255,5738,186417,65,250993
30128,0.005606,172.31.40.0-255,66,186483,65,250993
30129,0.005612,172.253.118.0-255,4320,190803,65,250993
30130,0.005615,172.31.40.0-255,66,190869,65,250993
30131,0.005659,172.31.40.0-255,66,190935,65,250993
30132,0.005671,172.31.40.0-255,66,191001,65,250993
30133,0.005675,172.253.118.0-255,2184,193185,65,250993
30134,0.005678,172.31.40.0-255,66,193251,65,250993
30135,0.0059,172.253.118.0-255,1484,194735,65,250993
30136,0.005921,172.253.118.0-255,2902,197637,65,250993
30137,0.005924,172.253.118.0-255,1484,199121,65,250993
30138,0.005931,172.31.40.0-255,66,199187,65,250993
30139,0.005946,172.253.118.0-255,4320,203507,65,250993
30140,0.005949,172.31.40.0-255,66,203573,65,250993
30141,0.005979,172.31.40.0-255,66,203639,65,250993
30142,0.005984,172.253.118.0-255,4320,207959,65,250993
30143,0.005986,172.31.40.0-255,66,208025,65,250993
30144,0.006034,172.253.118.0-255,5738,213763,65,250993
30145,0.006037,172.31.40.0-255,66,213829,65,250993
30146,0.006076,172.31.40.0-255,66,213895,65,250993
30147,0.006083,172.253.118.0-255,7156,221051,65,250993
30148,0.006087,172.31.40.0-255,66,221117,65,250993
30149,0.006116,172.31.40.0-255,66,221183,65,250993
30150,0.006121,172.253.118.0-255,4320,225503,65,250993
30151,0.006124,172.31.40.0-255,66,225569,65,250993
30152,0.006126,172.253.118.0-255,1484,227053,65,250993
30153,0.006155,172.253.118.0-255,766,227819,65,250993
30154,0.006158,172.31.40.0-255,66,227885,65,250993
30155,0.006344,172.253.118.0-255,1484,229369,65,250993
30156,0.006348,172.253.118.0-255,1484,230853,65,250993
30157,0.006353,172.31.40.0-255,66,230919,65,250993
30158,0.006362,172.253.118.0-255,1484,232403,65,250993
30159,0.006387,172.253.118.0-255,5738,238141,65,250993
30160,0.006389,172.31.40.0-255,66,238207,65,250993
30161,0.006394,172.253.118.0-255,2902,241109,65,250993
30162,0.006396,172.31.40.0-255,66,241175,65,250993
30163,0.006462,172.31.40.0-255,66,241241,65,250993
30164,0.006467,172.253.118.0-255,2902,244143,65,250993
30165,0.006469,172.31.40.0-255,66,244209,65,250993
30166,0.006499,172.253.118.0-255,5738,249947,65,250993
30167,0.006502,172.31.40.0-255,66,250013,65,250993
30168,0.006512,172.253.118.0-255,539,250552,65,250993
30169,0.006636,172.253.118.0-255,105,250657,65,250993
30170,0.007181,172.253.118.0-255,129,250786,65,250993
30171,0.017162,172.253.118.0-255,129,250915,65,250993
30172,0.017183,172.31.40.0-255,78,250993,65,250993
30173,0.0,172.31.40.0-255,105,105,65,459
30174,0.000232,172.31.40.0-255,90,195,65,459
30175,0.000243,172.31.40.0-255,66,261,65,459
30176,0.00277,74.125.24.0-255,66,327,65,459
30177,0.002791,74.125.24.0-255,66,393,65,459
30178,0.002805,172.31.40.0-255,66,459,65,459
30179,0.0,74.125.200.0-255,148,148,65,219183
30180,2.4e-05,172.31.40.0-255,66,214,65,219183
30181,3.2e-05,74.125.200.0-255,1484,1698,65,219183
30182,3.7e-05,172.31.40.0-255,66,1764,65,219183
30183,4.3e-05,74.125.200.0-255,2902,4666,65,219183
30184,4.6e-05,172.31.40.0-255,66,4732,65,219183
30185,5.2e-05,74.125.200.0-255,4320,9052,65,219183
30186,5.5e-05,172.31.40.0-255,66,9118,65,219183
30187,6.1e-05,74.125.200.0-255,4994,14112,65,219183
30188,6.4e-05,172.31.40.0-255,66,14178,65,219183
30189,7.2e-05,74.125.200.0-255,7156,21334,65,219183
30190,7.5e-05,172.31.40.0-255,66,21400,65,219183
30191,9.9e-05,74.125.200.0-255,4320,25720,65,219183
30192,0.000101,172.31.40.0-255,66,25786,65,219183
30193,0.000118,74.125.200.0-255,5379,31165,65,219183
30194,0.000121,172.31.40.0-255,66,31231,65,219183
30195,0.000204,74.125.200.0-255,1484,32715,65,219183
30196,0.000208,172.31.40.0-255,66,32781,65,219183
30197,0.000211,74.125.200.0-255,1484,34265,65,219183
30198,0.000213,172.31.40.0-255,66,34331,65,219183
30199,0.00023,74.125.200.0-255,2902,37233,65,219183
30200,0.000232,172.31.40.0-255,66,37299,65,219183
30201,0.000235,74.125.200.0-255,1484,38783,65,219183
30202,0.000237,172.31.40.0-255,66,38849,65,219183
30203,0.000263,74.125.200.0-255,4320,43169,65,219183
30204,0.000266,172.31.40.0-255,66,43235,65,219183
30205,0.000277,172.31.40.0-255,66,43301,65,219183
30206,0.000302,172.31.40.0-255,66,43367,65,219183
30207,0.000329,74.125.200.0-255,5651,49018,65,219183
30208,0.000332,172.31.40.0-255,66,49084,65,219183
30209,0.000335,74.125.200.0-255,132,49216,65,219183
30210,0.000361,74.125.200.0-255,349,49565,65,219183
30211,0.000554,74.125.200.0-255,1484,51049,65,219183
30212,0.000567,172.31.40.0-255,66,51115,65,219183
30213,0.000573,74.125.200.0-255,2902,54017,65,219183
30214,0.000575,172.31.40.0-255,66,54083,65,219183
30215,0.000601,74.125.200.0-255,4320,58403,65,219183
30216,0.000604,172.31.40.0-255,66,58469,65,219183
30217,0.000615,172.31.40.0-255,66,58535,65,219183
30218,0.000621,74.125.200.0-255,4320,62855,65,219183
30219,0.000623,172.31.40.0-255,66,62921,65,219183
30220,0.00064,74.125.200.0-255,1484,64405,65,219183
30221,0.000648,74.125.200.0-255,7156,71561,65,219183
30222,0.000651,172.31.40.0-255,66,71627,65,219183
30223,0.000674,74.125.200.0-255,3602,75229,65,219183
30224,0.000677,172.31.40.0-255,66,75295,65,219183
30225,0.001081,74.125.200.0-255,1484,76779,65,219183
30226,0.001086,74.125.200.0-255,1484,78263,65,219183
30227,0.001089,172.31.40.0-255,66,78329,65,219183
30228,0.001109,74.125.200.0-255,1484,79813,65,219183
30229,0.001116,74.125.200.0-255,5738,85551,65,219183
30230,0.001119,172.31.40.0-255,66,85617,65,219183
30231,0.001124,74.125.200.0-255,4320,89937,65,219183
30232,0.001126,172.31.40.0-255,66,90003,65,219183
30233,0.001147,74.125.200.0-255,2902,92905,65,219183
30234,0.001149,172.31.40.0-255,66,92971,65,219183
30235,0.001159,172.31.40.0-255,66,93037,65,219183
30236,0.001212,172.31.40.0-255,66,93103,65,219183
30237,0.001595,74.125.200.0-255,1484,94587,65,219183
30238,0.001601,74.125.200.0-255,2902,97489,65,219183
30239,0.001605,172.31.40.0-255,66,97555,65,219183
30240,0.001611,74.125.200.0-255,2902,100457,65,219183
30241,0.001613,172.31.40.0-255,66,100523,65,219183
30242,0.001629,74.125.200.0-255,2902,103425,65,219183
30243,0.001632,172.31.40.0-255,66,103491,65,219183
30244,0.001636,74.125.200.0-255,2902,106393,65,219183
30245,0.001637,172.31.40.0-255,66,106459,65,219183
30246,0.001643,74.125.200.0-255,4320,110779,65,219183
30247,0.001645,172.31.40.0-255,66,110845,65,219183
30248,0.00168,172.31.40.0-255,66,110911,65,219183
30249,0.00169,172.31.40.0-255,66,110977,65,219183
30250,0.001805,74.125.200.0-255,1484,112461,65,219183
30251,0.001822,74.125.200.0-255,2902,115363,65,219183
30252,0.001824,172.31.40.0-255,66,115429,65,219183
30253,0.001827,74.125.200.0-255,1484,116913,65,219183
30254,0.001849,74.125.200.0-255,2902,119815,65,219183
30255,0.001855,74.125.200.0-255,5738,125553,65,219183
30256,0.001859,172.31.40.0-255,66,125619,65,219183
30257,0.001862,172.31.40.0-255,66,125685,65,219183
30258,0.001888,74.125.200.0-255,7156,132841,65,219183
30259,0.001891,172.31.40.0-255,66,132907,65,219183
30260,0.00191,74.125.200.0-255,5738,138645,65,219183
30261,0.001913,172.31.40.0-255,66,138711,65,219183
30262,0.001942,74.125.200.0-255,6438,145149,65,219183
30263,0.001945,172.31.40.0-255,66,145215,65,219183
30264,0.001981,74.125.200.0-255,7156,152371,65,219183
30265,0.001985,172.31.40.0-255,66,152437,65,219183
30266,0.001991,74.125.200.0-255,5738,158175,65,219183
30267,0.001993,172.31.40.0-255,66,158241,65,219183
30268,0.002023,74.125.200.0-255,7156,165397,65,219183
30269,0.002026,172.31.40.0-255,66,165463,65,219183
30270,0.002033,74.125.200.0-255,7156,172619,65,219183
30271,0.002036,172.31.40.0-255,66,172685,65,219183
30272,0.002057,74.125.200.0-255,1484,174169,65,219183
30273,0.004036,74.125.200.0-255,4320,178489,65,219183
30274,0.004044,172.31.40.0-255,66,178555,65,219183
30275,0.006033,74.125.200.0-255,5738,184293,65,219183
30276,0.006037,172.31.40.0-255,66,184359,65,219183
30277,0.008041,74.125.200.0-255,5738,190097,65,219183
30278,0.008046,172.31.40.0-255,66,190163,65,219183
30279,0.010049,74.125.200.0-255,5738,195901,65,219183
30280,0.010055,172.31.40.0-255,66,195967,65,219183
30281,0.012054,74.125.200.0-255,5738,201705,65,219183
30282,0.012064,172.31.40.0-255,66,201771,65,219183
30283,0.014075,74.125.200.0-255,5738,207509,65,219183
30284,0.014093,172.31.40.0-255,66,207575,65,219183
30285,0.016102,74.125.200.0-255,5738,213313,65,219183
30286,0.016115,172.31.40.0-255,66,213379,65,219183
30287,0.018122,74.125.200.0-255,5738,219117,65,219183
30288,0.018132,172.31.40.0-255,66,219183,65,219183
30289,0.0,172.217.194.0-255,153,153,65,160879
30290,2.3e-05,172.31.40.0-255,66,219,65,160879
30291,3.1e-05,172.217.194.0-255,1484,1703,65,160879
30292,3.6e-05,172.31.40.0-255,66,1769,65,160879
30293,4.1e-05,172.217.194.0-255,2902,4671,65,160879
30294,4.5e-05,172.31.40.0-255,66,4737,65,160879
30295,5.3e-05,172.217.194.0-255,7156,11893,65,160879
30296,5.7e-05,172.31.40.0-255,66,11959,65,160879
30297,6e-05,172.217.194.0-255,1982,13941,65,160879
30298,6.4e-05,172.31.40.0-255,66,14007,65,160879
30299,9.8e-05,172.217.194.0-255,2902,16909,65,160879
30300,0.000101,172.31.40.0-255,66,16975,65,160879
30301,0.000124,172.217.194.0-255,1484,18459,65,160879
30302,0.000126,172.31.40.0-255,66,18525,65,160879
30303,0.000133,172.217.194.0-255,5738,24263,65,160879
30304,0.000135,172.31.40.0-255,66,24329,65,160879
30305,0.00017,172.217.194.0-255,6797,31126,65,160879
30306,0.000173,172.31.40.0-255,66,31192,65,160879
30307,0.000198,172.217.194.0-255,1484,32676,65,160879
30308,0.0002,172.31.40.0-255,66,32742,65,160879
30309,0.000224,172.217.194.0-255,2902,35644,65,160879
30310,0.000226,172.31.40.0-255,66,35710,65,160879
30311,0.000232,172.217.194.0-255,5738,41448,65,160879
30312,0.000234,172.31.40.0-255,66,41514,65,160879
30313,0.000255,172.217.194.0-255,4320,45834,65,160879
30314,0.000258,172.31.40.0-255,66,45900,65,160879
30315,0.000281,172.217.194.0-255,2543,48443,65,160879
30316,0.000283,172.31.40.0-255,66,48509,65,160879
30317,0.000458,172.217.194.0-255,1484,49993,65,160879
30318,0.000463,172.31.40.0-255,66,50059,65,160879
30319,0.000467,172.217.194.0-255,1484,51543,65,160879
30320,0.000469,172.31.40.0-255,66,51609,65,160879
30321,0.000492,172.217.194.0-255,1484,53093,65,160879
30322,0.0005,172.217.194.0-255,5738,58831,65,160879
30323,0.000503,172.31.40.0-255,66,58897,65,160879
30324,0.000525,172.31.40.0-255,66,58963,65,160879
30325,0.000745,172.217.194.0-255,1484,60447,65,160879
30326,0.000763,172.217.194.0-255,2902,63349,65,160879
30327,0.000766,172.31.40.0-255,66,63415,65,160879
30328,0.000772,172.217.194.0-255,4320,67735,65,160879
30329,0.000773,172.31.40.0-255,66,67801,65,160879
30330,0.000788,172.217.194.0-255,1484,69285,65,160879
30331,0.000797,172.217.194.0-255,6797,76082,65,160879
30332,0.000799,172.31.40.0-255,66,76148,65,160879
30333,0.000864,172.217.194.0-255,1484,77632,65,160879
30334,0.000895,172.217.194.0-255,1484,79116,65,160879
30335,0.000898,172.31.40.0-255,66,79182,65,160879
30336,0.000924,172.217.194.0-255,1484,80666,65,160879
30337,0.000931,172.217.194.0-255,5738,86404,65,160879
30338,0.000934,172.31.40.0-255,66,86470,65,160879
30339,0.000941,172.217.194.0-255,6797,93267,65,160879
30340,0.000944,172.31.40.0-255,66,93333,65,160879
30341,0.001378,172.217.194.0-255,1484,94817,65,160879
30342,0.001385,172.217.194.0-255,2902,97719,65,160879
30343,0.001389,172.31.40.0-255,66,97785,65,160879
30344,0.001395,172.217.194.0-255,4320,102105,65,160879
30345,0.001397,172.31.40.0-255,66,102171,65,160879
30346,0.001411,172.217.194.0-255,1484,103655,65,160879
30347,0.001414,172.217.194.0-255,1484,105139,65,160879
30348,0.001416,172.31.40.0-255,66,105205,65,160879
30349,0.001456,172.31.40.0-255,66,105271,65,160879
30350,0.001469,172.31.40.0-255,66,105337,65,160879
30351,0.002076,172.217.194.0-255,1484,106821,65,160879
30352,0.002087,172.217.194.0-255,2902,109723,65,160879
30353,0.002092,172.31.40.0-255,66,109789,65,160879
30354,0.002101,172.217.194.0-255,5738,115527,65,160879
30355,0.002103,172.31.40.0-255,66,115593,65,160879
30356,0.002109,172.217.194.0-255,4320,119913,65,160879
30357,0.002112,172.31.40.0-255,66,119979,65,160879
30358,0.002159,172.217.194.0-255,2902,122881,65,160879
30359,0.002162,172.31.40.0-255,66,122947,65,160879
30360,0.002177,172.31.40.0-255,66,123013,65,160879
30361,0.002181,172.217.194.0-255,2184,125197,65,160879
30362,0.002183,172.31.40.0-255,66,125263,65,160879
30363,0.004758,172.217.194.0-255,2902,128165,65,160879
30364,0.004766,172.31.40.0-255,66,128231,65,160879
30365,0.004791,172.217.194.0-255,2902,131133,65,160879
30366,0.004794,172.31.40.0-255,66,131199,65,160879
30367,0.007349,172.217.194.0-255,2902,134101,65,160879
30368,0.007355,172.31.40.0-255,66,134167,65,160879
30369,0.007379,172.217.194.0-255,2902,137069,65,160879
30370,0.007382,172.31.40.0-255,66,137135,65,160879
30371,0.009945,172.217.194.0-255,2902,140037,65,160879
30372,0.009953,172.31.40.0-255,66,140103,65,160879
30373,0.010009,172.217.194.0-255,2902,143005,65,160879
30374,0.010013,172.31.40.0-255,66,143071,65,160879
30375,0.012557,172.217.194.0-255,2902,145973,65,160879
30376,0.012566,172.31.40.0-255,66,146039,65,160879
30377,0.012593,172.217.194.0-255,2902,148941,65,160879
30378,0.012595,172.31.40.0-255,66,149007,65,160879
30379,0.015151,172.217.194.0-255,2902,151909,65,160879
30380,0.015159,172.31.40.0-255,66,151975,65,160879
30381,0.015186,172.217.194.0-255,2902,154877,65,160879
30382,0.015189,172.31.40.0-255,66,154943,65,160879
30383,0.01775,172.217.194.0-255,2902,157845,65,160879
30384,0.017759,172.31.40.0-255,66,157911,65,160879
30385,0.017782,172.217.194.0-255,2902,160813,65,160879
30386,0.017784,172.31.40.0-255,66,160879,65,160879
30387,0.0,74.125.24.0-255,297,297,65,171176
30388,1.5e-05,172.31.40.0-255,66,363,65,171176
30389,2.1e-05,74.125.24.0-255,1484,1847,65,171176
30390,2.5e-05,172.31.40.0-255,66,1913,65,171176
30391,3.2e-05,74.125.24.0-255,4320,6233,65,171176
30392,4.4e-05,172.31.40.0-255,66,6299,65,171176
30393,9.4e-05,172.31.40.0-255,66,6365,65,171176
30394,9.9e-05,74.125.24.0-255,2902,9267,65,171176
30395,0.000101,172.31.40.0-255,66,9333,65,171176
30396,0.000144,172.31.40.0-255,66,9399,65,171176
30397,0.000163,74.125.24.0-255,2543,11942,65,171176
30398,0.000166,172.31.40.0-255,66,12008,65,171176
30399,0.00027,74.125.24.0-255,1484,13492,65,171176
30400,0.000274,172.31.40.0-255,66,13558,65,171176
30401,0.000279,74.125.24.0-255,2902,16460,65,171176
30402,0.000281,172.31.40.0-255,66,16526,65,171176
30403,0.000311,74.125.24.0-255,5738,22264,65,171176
30404,0.000314,172.31.40.0-255,66,22330,65,171176
30405,0.000329,74.125.24.0-255,4320,26650,65,171176
30406,0.000331,172.31.40.0-255,66,26716,65,171176
30407,0.00036,74.125.24.0-255,2543,29259,65,171176
30408,0.000363,172.31.40.0-255,66,29325,65,171176
30409,0.000369,74.125.24.0-255,7156,36481,65,171176
30410,0.000372,172.31.40.0-255,66,36547,65,171176
30411,0.000388,172.31.40.0-255,66,36613,65,171176
30412,0.00039,74.125.24.0-255,349,36962,65,171176
30413,0.000393,172.31.40.0-255,66,37028,65,171176
30414,0.0005,74.125.24.0-255,1484,38512,65,171176
30415,0.000503,172.31.40.0-255,66,38578,65,171176
30416,0.00051,74.125.24.0-255,2902,41480,65,171176
30417,0.000512,172.31.40.0-255,66,41546,65,171176
30418,0.000534,74.125.24.0-255,5738,47284,65,171176
30419,0.000537,172.31.40.0-255,66,47350,65,171176
30420,0.000567,74.125.24.0-255,4320,51670,65,171176
30421,0.00057,172.31.40.0-255,66,51736,65,171176
30422,0.000609,172.31.40.0-255,66,51802,65,171176
30423,0.000614,74.125.24.0-255,4320,56122,65,171176
30424,0.000617,172.31.40.0-255,66,56188,65,171176
30425,0.000639,74.125.24.0-255,5379,61567,65,171176
30426,0.000642,172.31.40.0-255,66,61633,65,171176
30427,0.001582,74.125.24.0-255,1484,63117,65,171176
30428,0.001591,74.125.24.0-255,2902,66019,65,171176
30429,0.001595,172.31.40.0-255,66,66085,65,171176
30430,0.001602,74.125.24.0-255,5738,71823,65,171176
30431,0.001603,172.31.40.0-255,66,71889,65,171176
30432,0.001642,172.31.40.0-255,66,71955,65,171176
30433,0.001653,172.31.40.0-255,66,72021,65,171176
30434,0.001678,74.125.24.0-255,766,72787,65,171176
30435,0.001797,74.125.24.0-255,1484,74271,65,171176
30436,0.001801,172.31.40.0-255,66,74337,65,171176
30437,0.001806,74.125.24.0-255,2902,77239,65,171176
30438,0.001808,172.31.40.0-255,66,77305,65,171176
30439,0.001815,74.125.24.0-255,5738,83043,65,171176
30440,0.001817,172.31.40.0-255,66,83109,65,171176
30441,0.001858,172.31.40.0-255,66,83175,65,171176
30442,0.001865,74.125.24.0-255,7156,90331,65,171176
30443,0.001866,172.31.40.0-255,66,90397,65,171176
30444,0.001887,74.125.24.0-255,1484,91881,65,171176
30445,0.001904,74.125.24.0-255,2184,94065,65,171176
30446,0.001906,172.31.40.0-255,66,94131,65,171176
30447,0.002047,74.125.24.0-255,1484,95615,65,171176
30448,0.002054,74.125.24.0-255,2902,98517,65,171176
30449,0.002058,172.31.40.0-255,66,98583,65,171176
30450,0.002065,74.125.24.0-255,4320,102903,65,171176
30451,0.002067,172.31.40.0-255,66,102969,65,171176
30452,0.0021,74.125.24.0-255,1484,104453,65,171176
30453,0.002114,172.31.40.0-255,66,104519,65,171176
30454,0.00212,74.125.24.0-255,5738,110257,65,171176
30455,0.002122,172.31.40.0-255,66,110323,65,171176
30456,0.00215,74.125.24.0-255,2902,113225,65,171176
30457,0.002152,172.31.40.0-255,66,113291,65,171176
30458,0.002178,74.125.24.0-255,2184,115475,65,171176
30459,0.00218,172.31.40.0-255,66,115541,65,171176
30460,0.002262,74.125.24.0-255,1484,117025,65,171176
30461,0.002267,74.125.24.0-255,2902,119927,65,171176
30462,0.002271,172.31.40.0-255,66,119993,65,171176
30463,0.002297,74.125.24.0-255,5738,125731,65,171176
30464,0.0023,172.31.40.0-255,66,125797,65,171176
30465,0.002329,74.125.24.0-255,2902,128699,65,171176
30466,0.002331,172.31.40.0-255,66,128765,65,171176
30467,0.002352,74.125.24.0-255,2902,131667,65,171176
30468,0.002355,172.31.40.0-255,66,131733,65,171176
30469,0.004626,74.125.24.0-255,5738,137471,65,171176
30470,0.004645,172.31.40.0-255,66,137537,65,171176
30471,0.006911,74.125.24.0-255,5738,143275,65,171176
30472,0.006928,172.31.40.0-255,66,143341,65,171176
30473,0.009187,74.125.24.0-255,4320,147661,65,171176
30474,0.00919,172.31.40.0-255,66,147727,65,171176
30475,0.009202,74.125.24.0-255,1484,149211,65,171176
30476,0.010881,172.31.40.0-255,101,149312,65,171176
30477,0.011485,74.125.24.0-255,4320,153632,65,171176
30478,0.01149,172.31.40.0-255,66,153698,65,171176
30479,0.013148,74.125.24.0-255,1484,155182,65,171176
30480,0.013783,74.125.24.0-255,4320,159502,65,171176
30481,0.013792,172.31.40.0-255,66,159568,65,171176
30482,0.016092,74.125.24.0-255,5738,165306,65,171176
30483,0.016124,172.31.40.0-255,66,165372,65,171176
30484,0.018393,74.125.24.0-255,5738,171110,65,171176
30485,0.0184,172.31.40.0-255,66,171176,65,171176
30486,0.0,172.217.194.0-255,146,146,65,105349
30487,4.7e-05,172.31.40.0-255,66,212,65,105349
30488,5.4e-05,172.217.194.0-255,1484,1696,65,105349
30489,5.9e-05,172.31.40.0-255,66,1762,65,105349
30490,6.3e-05,172.217.194.0-255,2902,4664,65,105349
30491,6.6e-05,172.31.40.0-255,66,4730,65,105349
30492,8e-05,172.217.194.0-255,7156,11886,65,105349
30493,8.2e-05,172.31.40.0-255,66,11952,65,105349
30494,8.5e-05,172.217.194.0-255,1484,13436,65,105349
30495,8.7e-05,172.31.40.0-255,66,13502,65,105349
30496,0.000103,172.217.194.0-255,7156,20658,65,105349
30497,0.000107,172.31.40.0-255,66,20724,65,105349
30498,0.00013,172.217.194.0-255,3486,24210,65,105349
30499,0.000137,172.31.40.0-255,66,24276,65,105349
30500,0.00015,172.31.40.0-255,66,24342,65,105349
30501,0.0002,172.31.40.0-255,66,24408,65,105349
30502,0.000722,172.217.194.0-255,1484,25892,65,105349
30503,0.000727,172.31.40.0-255,66,25958,65,105349
30504,0.000735,172.217.194.0-255,2902,28860,65,105349
30505,0.000738,172.31.40.0-255,66,28926,65,105349
30506,0.00075,172.217.194.0-255,5738,34664,65,105349
30507,0.000752,172.31.40.0-255,66,34730,65,105349
30508,0.000759,172.217.194.0-255,7049,41779,65,105349
30509,0.000761,172.31.40.0-255,66,41845,65,105349
30510,0.000789,172.217.194.0-255,114,41959,65,105349
30511,0.000797,172.31.40.0-255,66,42025,65,105349
30512,0.002087,172.217.194.0-255,1484,43509,65,105349
30513,0.002094,172.31.40.0-255,66,43575,65,105349
30514,0.0021,172.217.194.0-255,2902,46477,65,105349
30515,0.002101,172.31.40.0-255,66,46543,65,105349
30516,0.002104,172.217.194.0-255,1484,48027,65,105349
30517,0.002131,172.217.194.0-255,4320,52347,65,105349
30518,0.002176,172.217.194.0-255,1484,53831,65,105349
30519,0.002189,172.217.194.0-255,1484,55315,65,105349
30520,0.002199,172.217.194.0-255,1484,56799,65,105349
30521,0.002212,172.217.194.0-255,5738,62537,65,105349
30522,0.002243,172.217.194.0-255,4320,66857,65,105349
30523,0.002257,172.217.194.0-255,2902,69759,65,105349
30524,0.002289,172.217.194.0-255,4320,74079,65,105349
30525,0.002298,172.217.194.0-255,2184,76263,65,105349
30526,0.006285,172.31.40.0-255,66,76329,65,105349
30527,0.00882,172.217.194.0-255,5738,82067,65,105349
30528,0.008827,172.31.40.0-255,66,82133,65,105349
30529,0.011382,172.217.194.0-255,5738,87871,65,105349
30530,0.011389,172.31.40.0-255,66,87937,65,105349
30531,0.013971,172.217.194.0-255,5738,93675,65,105349
30532,0.013981,172.31.40.0-255,66,93741,65,105349
30533,0.016536,172.217.194.0-255,5738,99479,65,105349
30534,0.016546,172.31.40.0-255,66,99545,65,105349
30535,0.019094,172.217.194.0-255,5738,105283,65,105349
30536,0.019102,172.31.40.0-255,66,105349,65,105349
30537,0.0,172.217.27.0-255,291,291,65,212163
30538,2.4e-05,172.31.40.0-255,66,357,65,212163
30539,3.1e-05,172.217.27.0-255,1484,1841,65,212163
30540,3.5e-05,172.31.40.0-255,66,1907,65,212163
30541,4.1e-05,172.217.27.0-255,4320,6227,65,212163
30542,4.5e-05,172.31.40.0-255,66,6293,65,212163
30543,5.8e-05,172.31.40.0-255,66,6359,65,212163
30544,7.1e-05,172.31.40.0-255,66,6425,65,212163
30545,9.7e-05,172.217.27.0-255,5379,11804,65,212163
30546,0.0001,172.31.40.0-255,66,11870,65,212163
30547,0.000167,172.217.27.0-255,1484,13354,65,212163
30548,0.000171,172.31.40.0-255,66,13420,65,212163
30549,0.000188,172.217.27.0-255,2902,16322,65,212163
30550,0.000195,172.217.27.0-255,5738,22060,65,212163
30551,0.000199,172.31.40.0-255,66,22126,65,212163
30552,0.000201,172.31.40.0-255,66,22192,65,212163
30553,0.000225,172.217.27.0-255,6797,28989,65,212163
30554,0.000228,172.31.40.0-255,66,29055,65,212163
30555,0.000253,172.31.40.0-255,66,29121,65,212163
30556,0.000257,172.217.27.0-255,2543,31664,65,212163
30557,0.00026,172.31.40.0-255,66,31730,65,212163
30558,0.000281,172.217.27.0-255,391,32121,65,212163
30559,0.000283,172.31.40.0-255,66,32187,65,212163
30560,0.000622,172.217.27.0-255,120,32307,65,212163
30561,0.000629,172.31.40.0-255,66,32373,65,212163
30562,0.000717,172.217.27.0-255,1484,33857,65,212163
30563,0.000721,172.31.40.0-255,66,33923,65,212163
30564,0.000727,172.217.27.0-255,2902,36825,65,212163
30565,0.000729,172.31.40.0-255,66,36891,65,212163
30566,0.000736,172.217.27.0-255,5738,42629,65,212163
30567,0.000738,172.31.40.0-255,66,42695,65,212163
30568,0.000741,172.217.27.0-255,1484,44179,65,212163
30569,0.000761,172.217.27.0-255,4320,48499,65,212163
30570,0.000763,172.31.40.0-255,66,48565,65,212163
30571,0.000766,172.217.27.0-255,1484,50049,65,212163
30572,0.000786,172.217.27.0-255,5379,55428,65,212163
30573,0.000789,172.31.40.0-255,66,55494,65,212163
30574,0.000795,172.217.27.0-255,5738,61232,65,212163
30575,0.000798,172.31.40.0-255,66,61298,65,212163
30576,0.000823,172.217.27.0-255,5379,66677,65,212163
30577,0.000826,172.31.40.0-255,66,66743,65,212163
30578,0.001076,172.217.27.0-255,1484,68227,65,212163
30579,0.001082,172.217.27.0-255,2902,71129,65,212163
30580,0.001086,172.31.40.0-255,66,71195,65,212163
30581,0.001091,172.217.27.0-255,2902,74097,65,212163
30582,0.001093,172.31.40.0-255,66,74163,65,212163
30583,0.001134,172.217.27.0-255,4320,78483,65,212163
30584,0.001137,172.31.40.0-255,66,78549,65,212163
30585,0.001147,172.31.40.0-255,66,78615,65,212163
30586,0.001152,172.217.27.0-255,4320,82935,65,212163
30587,0.001154,172.31.40.0-255,66,83001,65,212163
30588,0.001182,172.217.27.0-255,5738,88739,65,212163
30589,0.001185,172.31.40.0-255,66,88805,65,212163
30590,0.001204,172.217.27.0-255,3602,92407,65,212163
30591,0.001207,172.31.40.0-255,66,92473,65,212163
30592,0.001256,172.217.27.0-255,1484,93957,65,212163
30593,0.001262,172.217.27.0-255,2902,96859,65,212163
30594,0.001265,172.31.40.0-255,66,96925,65,212163
30595,0.001268,172.217.27.0-255,1484,98409,65,212163
30596,0.001287,172.217.27.0-255,4320,102729,65,212163
30597,0.001289,172.31.40.0-255,66,102795,65,212163
30598,0.001336,172.31.40.0-255,66,102861,65,212163
30599,0.001343,172.217.27.0-255,7156,110017,65,212163
30600,0.001345,172.31.40.0-255,66,110083,65,212163
30601,0.001364,172.217.27.0-255,5020,115103,65,212163
30602,0.001367,172.31.40.0-255,66,115169,65,212163
30603,0.00142,172.217.27.0-255,1484,116653,65,212163
30604,0.001426,172.217.27.0-255,2902,119555,65,212163
30605,0.001429,172.31.40.0-255,66,119621,65,212163
30606,0.001454,172.217.27.0-255,5738,125359,65,212163
30607,0.001457,172.31.40.0-255,66,125425,65,212163
30608,0.001461,172.217.27.0-255,4320,129745,65,212163
30609,0.001463,172.31.40.0-255,66,129811,65,212163
30610,0.001469,172.217.27.0-255,5738,135549,65,212163
30611,0.001472,172.31.40.0-255,66,135615,65,212163
30612,0.001504,172.31.40.0-255,66,135681,65,212163
30613,0.001508,172.217.27.0-255,2184,137865,65,212163
30614,0.00151,172.31.40.0-255,66,137931,65,212163
30615,0.001613,172.217.27.0-255,1484,139415,65,212163
30616,0.001618,172.217.27.0-255,2902,142317,65,212163
30617,0.001622,172.31.40.0-255,66,142383,65,212163
30618,0.001647,172.217.27.0-255,5738,148121,65,212163
30619,0.00165,172.31.40.0-255,66,148187,65,212163
30620,0.003266,172.217.27.0-255,5738,153925,65,212163
30621,0.003275,172.31.40.0-255,66,153991,65,212163
30622,0.004896,172.217.27.0-255,5738,159729,65,212163
30623,0.004899,172.31.40.0-255,66,159795,65,212163
30624,0.006519,172.217.27.0-255,5738,165533,65,212163
30625,0.006527,172.31.40.0-255,66,165599,65,212163
30626,0.008155,172.217.27.0-255,5738,171337,65,212163
30627,0.008162,172.31.40.0-255,66,171403,65,212163
30628,0.009775,172.217.27.0-255,2902,174305,65,212163
30629,0.00978,172.31.40.0-255,66,174371,65,212163
30630,0.0098,172.217.27.0-255,2902,177273,65,212163
30631,0.009802,172.31.40.0-255,66,177339,65,212163
30632,0.011409,172.217.27.0-255,5738,183077,65,212163
30633,0.011415,172.31.40.0-255,66,183143,65,212163
30634,0.013049,172.217.27.0-255,5738,188881,65,212163
30635,0.013056,172.31.40.0-255,66,188947,65,212163
30636,0.014677,172.217.27.0-255,5738,194685,65,212163
30637,0.014684,172.31.40.0-255,66,194751,65,212163
30638,0.016318,172.217.27.0-255,5738,200489,65,212163
30639,0.016326,172.31.40.0-255,66,200555,65,212163
30640,0.017943,172.217.27.0-255,5738,206293,65,212163
30641,0.01795,172.31.40.0-255,66,206359,65,212163
30642,0.019577,172.217.27.0-255,5738,212097,65,212163
30643,0.019584,172.31.40.0-255,66,212163,65,212163
30644,0.0,74.125.24.0-255,153,153,65,109962
30645,2.4e-05,172.31.40.0-255,66,219,65,109962
30646,3.1e-05,74.125.24.0-255,1484,1703,65,109962
30647,3.6e-05,172.31.40.0-255,66,1769,65,109962
30648,4.9e-05,74.125.24.0-255,2902,4671,65,109962
30649,5.3e-05,172.31.40.0-255,66,4737,65,109962
30650,6e-05,74.125.24.0-255,7156,11893,65,109962
30651,6.4e-05,172.31.40.0-255,66,11959,65,109962
30652,0.00015,74.125.24.0-255,2128,14087,65,109962
30653,0.000154,172.31.40.0-255,66,14153,65,109962
30654,0.000179,74.125.24.0-255,2902,17055,65,109962
30655,0.000182,172.31.40.0-255,66,17121,65,109962
30656,0.000228,74.125.24.0-255,7156,24277,65,109962
30657,0.000232,172.31.40.0-255,66,24343,65,109962
30658,0.000333,74.125.24.0-255,6797,31140,65,109962
30659,0.000337,172.31.40.0-255,66,31206,65,109962
30660,0.000438,74.125.24.0-255,2902,34108,65,109962
30661,0.000441,172.31.40.0-255,66,34174,65,109962
30662,0.00047,74.125.24.0-255,4320,38494,65,109962
30663,0.000472,172.31.40.0-255,66,38560,65,109962
30664,0.000548,74.125.24.0-255,4320,42880,65,109962
30665,0.000553,172.31.40.0-255,66,42946,65,109962
30666,0.000582,172.31.40.0-255,66,43012,65,109962
30667,0.000769,172.31.40.0-255,66,43078,65,109962
30668,0.000786,74.125.24.0-255,2543,45621,65,109962
30669,0.000788,172.31.40.0-255,66,45687,65,109962
30670,0.000906,74.125.24.0-255,411,46098,65,109962
30671,0.000909,172.31.40.0-255,66,46164,65,109962
30672,0.000913,74.125.24.0-255,332,46496,65,109962
30673,0.000915,172.31.40.0-255,66,46562,65,109962
30674,0.001054,74.125.24.0-255,1484,48046,65,109962
30675,0.001077,74.125.24.0-255,2902,50948,65,109962
30676,0.001081,172.31.40.0-255,66,51014,65,109962
30677,0.001111,74.125.24.0-255,4320,55334,65,109962
30678,0.001122,74.125.24.0-255,1484,56818,65,109962
30679,0.001133,172.31.40.0-255,66,56884,65,109962
30680,0.001181,74.125.24.0-255,5738,62622,65,109962
30681,0.001188,172.31.40.0-255,66,62688,65,109962
30682,0.001246,172.31.40.0-255,66,62754,65,109962
30683,0.001388,74.125.24.0-255,7156,69910,65,109962
30684,0.001392,172.31.40.0-255,66,69976,65,109962
30685,0.00142,74.125.24.0-255,2543,72519,65,109962
30686,0.001434,172.31.40.0-255,66,72585,65,109962
30687,0.001522,74.125.24.0-255,1484,74069,65,109962
30688,0.00155,172.31.40.0-255,66,74135,65,109962
30689,0.00169,74.125.24.0-255,4320,78455,65,109962
30690,0.001694,172.31.40.0-255,66,78521,65,109962
30691,0.00173,172.31.40.0-255,66,78587,65,109962
30692,0.001951,74.125.24.0-255,5020,83607,65,109962
30693,0.001955,172.31.40.0-255,66,83673,65,109962
30694,0.002038,74.125.24.0-255,4320,87993,65,109962
30695,0.002054,172.31.40.0-255,66,88059,65,109962
30696,0.002088,172.31.40.0-255,66,88125,65,109962
30697,0.002419,172.31.40.0-255,66,88191,65,109962
30698,0.003031,74.125.24.0-255,7156,95347,65,109962
30699,0.003049,74.125.24.0-255,4320,99667,65,109962
30700,0.003193,74.125.24.0-255,2902,102569,65,109962
30701,0.004876,74.125.24.0-255,7156,109725,65,109962
30702,0.00548,172.31.40.0-255,66,109791,65,109962
30703,0.013152,172.31.40.0-255,105,109896,65,109962
30704,0.01553,74.125.24.0-255,66,109962,65,109962
30705,0.0,172.217.194.0-255,146,146,65,186147
30706,2.2e-05,172.31.40.0-255,66,212,65,186147
30707,2.9e-05,172.217.194.0-255,1484,1696,65,186147
30708,3.3e-05,172.31.40.0-255,66,1762,65,186147
30709,3.8e-05,172.217.194.0-255,2902,4664,65,186147
30710,5e-05,172.31.40.0-255,66,4730,65,186147
30711,5.8e-05,172.217.194.0-255,7156,11886,65,186147
30712,6e-05,172.31.40.0-255,66,11952,65,186147
30713,6.4e-05,172.217.194.0-255,2155,14107,65,186147
30714,6.7e-05,172.31.40.0-255,66,14173,65,186147
30715,0.000168,172.217.194.0-255,1484,15657,65,186147
30716,0.000171,172.31.40.0-255,66,15723,65,186147
30717,0.000175,172.217.194.0-255,1484,17207,65,186147
30718,0.000177,172.31.40.0-255,66,17273,65,186147
30719,0.0002,172.217.194.0-255,1484,18757,65,186147
30720,0.000202,172.31.40.0-255,66,18823,65,186147
30721,0.000214,172.217.194.0-255,5738,24561,65,186147
30722,0.000216,172.31.40.0-255,66,24627,65,186147
30723,0.00022,172.217.194.0-255,2902,27529,65,186147
30724,0.000222,172.31.40.0-255,66,27595,65,186147
30725,0.000265,172.31.40.0-255,66,27661,65,186147
30726,0.000278,172.31.40.0-255,66,27727,65,186147
30727,0.000289,172.31.40.0-255,66,27793,65,186147
30728,0.000346,172.31.40.0-255,66,27859,65,186147
30729,0.000393,172.217.194.0-255,119,27978,65,186147
30730,0.000396,172.31.40.0-255,66,28044,65,186147
30731,0.000437,172.217.194.0-255,380,28424,65,186147
30732,0.00044,172.31.40.0-255,66,28490,65,186147
30733,0.000868,172.217.194.0-255,1484,29974,65,186147
30734,0.000873,172.217.194.0-255,1484,31458,65,186147
30735,0.000877,172.31.40.0-255,66,31524,65,186147
30736,0.000894,172.217.194.0-255,1484,33008,65,186147
30737,0.000897,172.217.194.0-255,1484,34492,65,186147
30738,0.0009,172.31.40.0-255,66,34558,65,186147
30739,0.000922,172.217.194.0-255,4320,38878,65,186147
30740,0.000924,172.31.40.0-255,66,38944,65,186147
30741,0.000936,172.31.40.0-255,66,39010,65,186147
30742,0.000976,172.31.40.0-255,66,39076,65,186147
30743,0.001048,172.217.194.0-255,1484,40560,65,186147
30744,0.001054,172.217.194.0-255,2902,43462,65,186147
30745,0.001057,172.31.40.0-255,66,43528,65,186147
30746,0.00106,172.217.194.0-255,1484,45012,65,186147
30747,0.001075,172.217.194.0-255,1484,46496,65,186147
30748,0.001077,172.31.40.0-255,66,46562,65,186147
30749,0.001085,172.217.194.0-255,7156,53718,65,186147
30750,0.001087,172.31.40.0-255,66,53784,65,186147
30751,0.001111,172.217.194.0-255,4320,58104,65,186147
30752,0.001113,172.31.40.0-255,66,58170,65,186147
30753,0.001154,172.31.40.0-255,66,58236,65,186147
30754,0.001158,172.217.194.0-255,1484,59720,65,186147
30755,0.001177,172.217.194.0-255,2184,61904,65,186147
30756,0.00118,172.31.40.0-255,66,61970,65,186147
30757,0.001207,172.217.194.0-255,2902,64872,65,186147
30758,0.001209,172.31.40.0-255,66,64938,65,186147
30759,0.001236,172.217.194.0-255,2902,67840,65,186147
30760,0.001238,172.31.40.0-255,66,67906,65,186147
30761,0.001242,172.217.194.0-255,2902,70808,65,186147
30762,0.001244,172.31.40.0-255,66,70874,65,186147
30763,0.001267,172.217.194.0-255,1484,72358,65,186147
30764,0.00128,172.31.40.0-255,66,72424,65,186147
30765,0.001287,172.217.194.0-255,7156,79580,65,186147
30766,0.001291,172.31.40.0-255,66,79646,65,186147
30767,0.001335,172.217.194.0-255,4320,83966,65,186147
30768,0.001339,172.31.40.0-255,66,84032,65,186147
30769,0.001363,172.217.194.0-255,3602,87634,65,186147
30770,0.001365,172.31.40.0-255,66,87700,65,186147
30771,0.001411,172.217.194.0-255,1484,89184,65,186147
30772,0.001427,172.217.194.0-255,2902,92086,65,186147
30773,0.001431,172.31.40.0-255,66,92152,65,186147
30774,0.001435,172.217.194.0-255,2902,95054,65,186147
30775,0.001437,172.31.40.0-255,66,95120,65,186147
30776,0.00146,172.217.194.0-255,2902,98022,65,186147
30777,0.001463,172.31.40.0-255,66,98088,65,186147
30778,0.001469,172.217.194.0-255,5738,103826,65,186147
30779,0.001475,172.31.40.0-255,66,103892,65,186147
30780,0.001509,172.217.194.0-255,7156,111048,65,186147
30781,0.001512,172.31.40.0-255,66,111114,65,186147
30782,0.001525,172.31.40.0-255,66,111180,65,186147
30783,0.001553,172.217.194.0-255,1484,112664,65,186147
30784,0.00157,172.217.194.0-255,2902,115566,65,186147
30785,0.001573,172.31.40.0-255,66,115632,65,186147
30786,0.001603,172.217.194.0-255,4320,119952,65,186147
30787,0.001606,172.31.40.0-255,66,120018,65,186147
30788,0.001609,172.217.194.0-255,1484,121502,65,186147
30789,0.001636,172.217.194.0-255,7156,128658,65,186147
30790,0.001639,172.31.40.0-255,66,128724,65,186147
30791,0.001653,172.31.40.0-255,66,128790,65,186147
30792,0.001706,172.31.40.0-255,66,128856,65,186147
30793,0.001728,172.31.40.0-255,66,128922,65,186147
30794,0.001797,172.31.40.0-255,66,128988,65,186147
30795,0.001802,172.217.194.0-255,2902,131890,65,186147
30796,0.001804,172.31.40.0-255,66,131956,65,186147
30797,0.001809,172.217.194.0-255,2902,134858,65,186147
30798,0.001811,172.31.40.0-255,66,134924,65,186147
30799,0.001843,172.217.194.0-255,1484,136408,65,186147
30800,0.001856,172.217.194.0-255,5738,142146,65,186147
30801,0.001867,172.31.40.0-255,66,142212,65,186147
30802,0.00187,172.31.40.0-255,66,142278,65,186147
30803,0.001915,172.31.40.0-255,66,142344,65,186147
30804,0.001956,172.217.194.0-255,1484,143828,65,186147
30805,0.001969,172.217.194.0-255,2902,146730,65,186147
30806,0.001972,172.31.40.0-255,66,146796,65,186147
30807,0.002003,172.217.194.0-255,5738,152534,65,186147
30808,0.002006,172.31.40.0-255,66,152600,65,186147
30809,0.002012,172.217.194.0-255,4320,156920,65,186147
30810,0.002014,172.31.40.0-255,66,156986,65,186147
30811,0.002043,172.217.194.0-255,5738,162724,65,186147
30812,0.002046,172.31.40.0-255,66,162790,65,186147
30813,0.00205,172.217.194.0-255,2902,165692,65,186147
30814,0.002052,172.31.40.0-255,66,165758,65,186147
30815,0.002085,172.31.40.0-255,66,165824,65,186147
30816,0.00209,172.217.194.0-255,4320,170144,65,186147
30817,0.002092,172.31.40.0-255,66,170210,65,186147
30818,0.002134,172.217.194.0-255,4320,174530,65,186147
30819,0.00214,172.31.40.0-255,66,174596,65,186147
30820,0.002142,172.31.40.0-255,66,174662,65,186147
30821,0.002175,172.31.40.0-255,66,174728,65,186147
30822,0.002198,172.217.194.0-255,6438,181166,65,186147
30823,0.002203,172.31.40.0-255,66,181232,65,186147
30824,0.002242,172.31.40.0-255,66,181298,65,186147
30825,0.002246,172.217.194.0-255,2902,184200,65,186147
30826,0.002248,172.31.40.0-255,66,184266,65,186147
30827,0.002276,172.31.40.0-255,66,184332,65,186147
30828,0.002279,172.217.194.0-255,1356,185688,65,186147
30829,0.002313,172.217.194.0-255,105,185793,65,186147
30830,0.011482,172.217.194.0-255,105,185898,65,186147
30831,0.0115,172.31.40.0-255,78,185976,65,186147
30832,0.011845,172.31.40.0-255,105,186081,65,186147
30833,0.014086,172.217.194.0-255,66,186147,65,186147
30834,0.0,172.31.40.0-255,105,105,65,459
30835,0.000265,172.31.40.0-255,90,195,65,459
30836,0.000274,172.31.40.0-255,66,261,65,459
30837,0.002786,74.125.68.0-255,66,327,65,459
30838,0.002813,74.125.68.0-255,66,393,65,459
30839,0.002835,172.31.40.0-255,66,459,65,459
30840,0.0,74.125.24.0-255,153,153,65,194388
30841,2.5e-05,172.31.40.0-255,66,219,65,194388
30842,3.2e-05,74.125.24.0-255,1484,1703,65,194388
30843,3.7e-05,172.31.40.0-255,66,1769,65,194388
30844,4.2e-05,74.125.24.0-255,2902,4671,65,194388
30845,4.6e-05,172.31.40.0-255,66,4737,65,194388
30846,6e-05,74.125.24.0-255,7156,11893,65,194388
30847,6.3e-05,172.31.40.0-255,66,11959,65,194388
30848,9.7e-05,74.125.24.0-255,2067,14026,65,194388
30849,0.000103,172.31.40.0-255,66,14092,65,194388
30850,0.000115,172.31.40.0-255,66,14158,65,194388
30851,0.000166,74.125.24.0-255,1484,15642,65,194388
30852,0.000168,172.31.40.0-255,66,15708,65,194388
30853,0.000187,74.125.24.0-255,3961,19669,65,194388
30854,0.000189,172.31.40.0-255,66,19735,65,194388
30855,0.000213,74.125.24.0-255,1484,21219,65,194388
30856,0.000216,172.31.40.0-255,66,21285,65,194388
30857,0.00022,74.125.24.0-255,2902,24187,65,194388
30858,0.000222,172.31.40.0-255,66,24253,65,194388
30859,0.00025,74.125.24.0-255,4320,28573,65,194388
30860,0.000252,172.31.40.0-255,66,28639,65,194388
30861,0.000281,74.125.24.0-255,1484,30123,65,194388
30862,0.000283,172.31.40.0-255,66,30189,65,194388
30863,0.000289,74.125.24.0-255,5738,35927,65,194388
30864,0.000291,172.31.40.0-255,66,35993,65,194388
30865,0.000317,74.125.24.0-255,7156,43149,65,194388
30866,0.000319,172.31.40.0-255,66,43215,65,194388
30867,0.000372,74.125.24.0-255,1484,44699,65,194388
30868,0.000375,172.31.40.0-255,66,44765,65,194388
30869,0.000413,172.31.40.0-255,66,44831,65,194388
30870,0.000521,74.125.24.0-255,1484,46315,65,194388
30871,0.000526,74.125.24.0-255,2902,49217,65,194388
30872,0.000529,172.31.40.0-255,66,49283,65,194388
30873,0.000551,74.125.24.0-255,5738,55021,65,194388
30874,0.000553,172.31.40.0-255,66,55087,65,194388
30875,0.000576,74.125.24.0-255,1484,56571,65,194388
30876,0.000603,172.31.40.0-255,66,56637,65,194388
30877,0.000679,172.31.40.0-255,66,56703,65,194388
30878,0.000698,74.125.24.0-255,1484,58187,65,194388
30879,0.000718,74.125.24.0-255,216,58403,65,194388
30880,0.000721,172.31.40.0-255,66,58469,65,194388
30881,0.000787,74.125.24.0-255,1484,59953,65,194388
30882,0.00079,74.125.24.0-255,1484,61437,65,194388
30883,0.000793,172.31.40.0-255,66,61503,65,194388
30884,0.000824,74.125.24.0-255,1484,62987,65,194388
30885,0.00083,74.125.24.0-255,5738,68725,65,194388
30886,0.000833,172.31.40.0-255,66,68791,65,194388
30887,0.00086,74.125.24.0-255,4320,73111,65,194388
30888,0.000862,172.31.40.0-255,66,73177,65,194388
30889,0.000876,74.125.24.0-255,5738,78915,65,194388
30890,0.000878,172.31.40.0-255,66,78981,65,194388
30891,0.000908,74.125.24.0-255,5738,84719,65,194388
30892,0.000911,172.31.40.0-255,66,84785,65,194388
30893,0.000954,74.125.24.0-255,2902,87687,65,194388
30894,0.000956,172.31.40.0-255,66,87753,65,194388
30895,0.000983,74.125.24.0-255,5020,92773,65,194388
30896,0.000987,172.31.40.0-255,66,92839,65,194388
30897,0.001002,74.125.24.0-255,4320,97159,65,194388
30898,0.001005,172.31.40.0-255,66,97225,65,194388
30899,0.001024,74.125.24.0-255,4320,101545,65,194388
30900,0.001027,172.31.40.0-255,66,101611,65,194388
30901,0.001074,74.125.24.0-255,5738,107349,65,194388
30902,0.001078,172.31.40.0-255,66,107415,65,194388
30903,0.00111,74.125.24.0-255,2902,110317,65,194388
30904,0.001113,172.31.40.0-255,66,110383,65,194388
30905,0.001159,172.31.40.0-255,66,110449,65,194388
30906,0.001203,74.125.24.0-255,6438,116887,65,194388
30907,0.001206,172.31.40.0-255,66,116953,65,194388
30908,0.001258,74.125.24.0-255,7156,124109,65,194388
30909,0.001261,172.31.40.0-255,66,124175,65,194388
30910,0.001326,172.31.40.0-255,66,124241,65,194388
30911,0.001408,74.125.24.0-255,5738,129979,65,194388
30912,0.001412,172.31.40.0-255,66,130045,65,194388
30913,0.001437,74.125.24.0-255,2902,132947,65,194388
30914,0.00144,172.31.40.0-255,66,133013,65,194388
30915,0.001468,74.125.24.0-255,2184,135197,65,194388
30916,0.001471,172.31.40.0-255,66,135263,65,194388
30917,0.001519,172.31.40.0-255,66,135329,65,194388
30918,0.001594,74.125.24.0-255,5738,141067,65,194388
30919,0.001597,172.31.40.0-255,66,141133,65,194388
30920,0.001639,172.31.40.0-255,66,141199,65,194388
30921,0.001784,74.125.24.0-255,1484,142683,65,194388
30922,0.001824,172.31.40.0-255,66,142749,65,194388
30923,0.001858,172.31.40.0-255,66,142815,65,194388
30924,0.001967,74.125.24.0-255,4320,147135,65,194388
30925,0.00197,172.31.40.0-255,66,147201,65,194388
30926,0.002012,172.31.40.0-255,66,147267,65,194388
30927,0.002177,74.125.24.0-255,7156,154423,65,194388
30928,0.002181,172.31.40.0-255,66,154489,65,194388
30929,0.002235,172.31.40.0-255,66,154555,65,194388
30930,0.002451,74.125.24.0-255,5738,160293,65,194388
30931,0.002457,172.31.40.0-255,66,160359,65,194388
30932,0.002553,172.31.40.0-255,66,160425,65,194388
30933,0.004604,74.125.24.0-255,5738,166163,65,194388
30934,0.00461,172.31.40.0-255,66,166229,65,194388
30935,0.006647,74.125.24.0-255,2902,169131,65,194388
30936,0.006651,172.31.40.0-255,66,169197,65,194388
30937,0.006664,74.125.24.0-255,2902,172099,65,194388
30938,0.006667,172.31.40.0-255,66,172165,65,194388
30939,0.008702,74.125.24.0-255,2902,175067,65,194388
30940,0.008707,172.31.40.0-255,66,175133,65,194388
30941,0.008738,74.125.24.0-255,2902,178035,65,194388
30942,0.008741,172.31.40.0-255,66,178101,65,194388
30943,0.010787,74.125.24.0-255,5738,183839,65,194388
30944,0.010802,172.31.40.0-255,66,183905,65,194388
30945,0.012842,74.125.24.0-255,5738,189643,65,194388
30946,0.012854,172.31.40.0-255,66,189709,65,194388
30947,0.014923,74.125.24.0-255,3917,193626,65,194388
30948,0.014933,172.31.40.0-255,66,193692,65,194388
30949,0.015178,172.31.40.0-255,105,193797,65,194388
30950,0.015209,172.31.40.0-255,105,193902,65,194388
30951,0.015474,172.31.40.0-255,90,193992,65,194388
30952,0.015482,172.31.40.0-255,66,194058,65,194388
30953,0.017197,74.125.24.0-255,66,194124,65,194388
30954,0.01721,74.125.24.0-255,66,194190,65,194388
30955,0.017485,74.125.24.0-255,66,194256,65,194388
30956,0.017531,74.125.24.0-255,66,194322,65,194388
30957,0.017541,172.31.40.0-255,66,194388,65,194388
30958,0.0,172.217.194.0-255,476,476,65,210332
30959,1.7e-05,172.31.40.0-255,66,542,65,210332
30960,2.4e-05,172.217.194.0-255,1484,2026,65,210332
30961,2.9e-05,172.31.40.0-255,66,2092,65,210332
30962,3.6e-05,172.217.194.0-255,4320,6412,65,210332
30963,3.8e-05,172.31.40.0-255,66,6478,65,210332
30964,7.9e-05,172.31.40.0-255,66,6544,65,210332
30965,8.5e-05,172.217.194.0-255,5738,12282,65,210332
30966,8.8e-05,172.31.40.0-255,66,12348,65,210332
30967,0.000113,172.217.194.0-255,2902,15250,65,210332
30968,0.000116,172.31.40.0-255,66,15316,65,210332
30969,0.000134,172.217.194.0-255,6797,22113,65,210332
30970,0.000137,172.31.40.0-255,66,22179,65,210332
30971,0.000228,172.217.194.0-255,1484,23663,65,210332
30972,0.000232,172.31.40.0-255,66,23729,65,210332
30973,0.000237,172.217.194.0-255,2902,26631,65,210332
30974,0.00024,172.31.40.0-255,66,26697,65,210332
30975,0.000269,172.217.194.0-255,5738,32435,65,210332
30976,0.000272,172.31.40.0-255,66,32501,65,210332
30977,0.000277,172.217.194.0-255,2902,35403,65,210332
30978,0.000279,172.31.40.0-255,66,35469,65,210332
30979,0.000305,172.217.194.0-255,4320,39789,65,210332
30980,0.000308,172.31.40.0-255,66,39855,65,210332
30981,0.000326,172.217.194.0-255,6797,46652,65,210332
30982,0.000329,172.31.40.0-255,66,46718,65,210332
30983,0.000334,172.217.194.0-255,4320,51038,65,210332
30984,0.000336,172.31.40.0-255,66,51104,65,210332
30985,0.000379,172.217.194.0-255,4320,55424,65,210332
30986,0.000382,172.31.40.0-255,66,55490,65,210332
30987,0.000393,172.217.194.0-255,1715,57205,65,210332
30988,0.000395,172.31.40.0-255,66,57271,65,210332
30989,0.000475,172.217.194.0-255,1484,58755,65,210332
30990,0.000482,172.217.194.0-255,2902,61657,65,210332
30991,0.000518,172.217.194.0-255,5738,67395,65,210332
30992,0.000576,172.217.194.0-255,2184,69579,65,210332
30993,0.000625,172.31.40.0-255,66,69645,65,210332
30994,0.000783,172.217.194.0-255,1484,71129,65,210332
30995,0.000788,172.217.194.0-255,1484,72613,65,210332
30996,0.0008,172.217.194.0-255,1484,74097,65,210332
30997,0.000803,172.217.194.0-255,1484,75581,65,210332
30998,0.000808,172.31.40.0-255,66,75647,65,210332
30999,0.000826,172.217.194.0-255,4320,79967,65,210332
31000,0.000861,172.217.194.0-255,2902,82869,65,210332
31001,0.000865,172.31.40.0-255,66,82935,65,210332
31002,0.00087,172.31.40.0-255,66,83001,65,210332
31003,0.00089,172.217.194.0-255,2184,85185,65,210332
31004,0.000913,172.31.40.0-255,66,85251,65,210332
31005,0.000967,172.217.194.0-255,1484,86735,65,210332
31006,0.000971,172.217.194.0-255,1484,88219,65,210332
31007,0.000985,172.217.194.0-255,1484,89703,65,210332
31008,0.000992,172.217.194.0-255,5738,95441,65,210332
31009,0.001007,172.31.40.0-255,66,95507,65,210332
31010,0.001018,172.217.194.0-255,5738,101245,65,210332
31011,0.001023,172.31.40.0-255,66,101311,65,210332
31012,0.001038,172.217.194.0-255,7156,108467,65,210332
31013,0.001043,172.217.194.0-255,2902,111369,65,210332
31014,0.001069,172.31.40.0-255,66,111435,65,210332
31015,0.001086,172.217.194.0-255,1484,112919,65,210332
31016,0.001091,172.217.194.0-255,2902,115821,65,210332
31017,0.001111,172.217.194.0-255,5738,121559,65,210332
31018,0.001115,172.31.40.0-255,66,121625,65,210332
31019,0.001166,172.217.194.0-255,4320,125945,65,210332
31020,0.001178,172.31.40.0-255,66,126011,65,210332
31021,0.001194,172.217.194.0-255,7156,133167,65,210332
31022,0.001198,172.217.194.0-255,2184,135351,65,210332
31023,0.001218,172.31.40.0-255,66,135417,65,210332
31024,0.001263,172.217.194.0-255,4320,139737,65,210332
31025,0.001278,172.217.194.0-255,5738,145475,65,210332
31026,0.001292,172.31.40.0-255,66,145541,65,210332
31027,0.001303,172.217.194.0-255,2902,148443,65,210332
31028,0.001434,172.31.40.0-255,66,148509,65,210332
31029,0.001477,172.217.194.0-255,1484,149993,65,210332
31030,0.001493,172.217.194.0-255,2902,152895,65,210332
31031,0.001496,172.217.194.0-255,1484,154379,65,210332
31032,0.001502,172.31.40.0-255,66,154445,65,210332
31033,0.001515,172.217.194.0-255,4320,158765,65,210332
31034,0.001518,172.217.194.0-255,1484,160249,65,210332
31035,0.00153,172.31.40.0-255,66,160315,65,210332
31036,0.001583,172.31.40.0-255,66,160381,65,210332
31037,0.001631,172.217.194.0-255,1484,161865,65,210332
31038,0.001645,172.217.194.0-255,2902,164767,65,210332
31039,0.001666,172.217.194.0-255,5738,170505,65,210332
31040,0.001672,172.31.40.0-255,66,170571,65,210332
31041,0.001711,172.217.194.0-255,1484,172055,65,210332
31042,0.00173,172.31.40.0-255,66,172121,65,210332
31043,0.001747,172.217.194.0-255,2184,174305,65,210332
31044,0.001769,172.217.194.0-255,2902,177207,65,210332
31045,0.001783,172.31.40.0-255,66,177273,65,210332
31046,0.00179,172.217.194.0-255,7156,184429,65,210332
31047,0.001796,172.217.194.0-255,5738,190167,65,210332
31048,0.001803,172.31.40.0-255,66,190233,65,210332
31049,0.001821,172.217.194.0-255,2902,193135,65,210332
31050,0.001862,172.217.194.0-255,4320,197455,65,210332
31051,0.001866,172.31.40.0-255,66,197521,65,210332
31052,0.001879,172.217.194.0-255,5738,203259,65,210332
31053,0.001884,172.31.40.0-255,66,203325,65,210332
31054,0.001912,172.217.194.0-255,5738,209063,65,210332
31055,0.001919,172.31.40.0-255,66,209129,65,210332
31056,0.00194,172.31.40.0-255,66,209195,65,210332
31057,0.001958,172.217.194.0-255,105,209300,65,210332
31058,0.001961,172.217.194.0-255,129,209429,65,210332
31059,0.011081,172.217.194.0-255,129,209558,65,210332
31060,0.0111,172.31.40.0-255,78,209636,65,210332
31061,0.014413,172.31.40.0-255,105,209741,65,210332
31062,0.014452,172.31.40.0-255,105,209846,65,210332
31063,0.014685,172.31.40.0-255,90,209936,65,210332
31064,0.014695,172.31.40.0-255,66,210002,65,210332
31065,0.01664,172.217.194.0-255,66,210068,65,210332
31066,0.016678,172.217.194.0-255,66,210134,65,210332
31067,0.016934,172.217.194.0-255,66,210200,65,210332
31068,0.01695,172.217.194.0-255,66,210266,65,210332
31069,0.016956,172.31.40.0-255,66,210332,65,210332
31070,0.0,172.31.40.0-255,66,66,65,66
31071,0.0,172.31.40.0-255,66,66,65,66
31072,0.0,74.125.68.0-255,297,297,65,153815
31073,2.3e-05,172.31.40.0-255,66,363,65,153815
31074,3e-05,74.125.68.0-255,1484,1847,65,153815
31075,3.5e-05,172.31.40.0-255,66,1913,65,153815
31076,4e-05,74.125.68.0-255,2902,4815,65,153815
31077,4.3e-05,172.31.40.0-255,66,4881,65,153815
31078,5e-05,74.125.68.0-255,5738,10619,65,153815
31079,5.3e-05,172.31.40.0-255,66,10685,65,153815
31080,9.3e-05,74.125.68.0-255,4605,15290,65,153815
31081,9.7e-05,172.31.40.0-255,66,15356,65,153815
31082,0.000103,74.125.68.0-255,5738,21094,65,153815
31083,0.000105,172.31.40.0-255,66,21160,65,153815
31084,0.000123,74.125.68.0-255,4320,25480,65,153815
31085,0.000126,172.31.40.0-255,66,25546,65,153815
31086,0.000154,74.125.68.0-255,5379,30925,65,153815
31087,0.000156,172.31.40.0-255,66,30991,65,153815
31088,0.000264,74.125.68.0-255,1484,32475,65,153815
31089,0.000267,172.31.40.0-255,66,32541,65,153815
31090,0.000272,74.125.68.0-255,1484,34025,65,153815
31091,0.000273,172.31.40.0-255,66,34091,65,153815
31092,0.000278,74.125.68.0-255,2902,36993,65,153815
31093,0.000281,172.31.40.0-255,66,37059,65,153815
31094,0.000299,74.125.68.0-255,2902,39961,65,153815
31095,0.000302,172.31.40.0-255,66,40027,65,153815
31096,0.000325,74.125.68.0-255,2902,42929,65,153815
31097,0.000328,172.31.40.0-255,66,42995,65,153815
31098,0.000333,74.125.68.0-255,4320,47315,65,153815
31099,0.000335,172.31.40.0-255,66,47381,65,153815
31100,0.000387,74.125.68.0-255,1125,48506,65,153815
31101,0.00039,172.31.40.0-255,66,48572,65,153815
31102,0.000418,74.125.68.0-255,1484,50056,65,153815
31103,0.000421,172.31.40.0-255,66,50122,65,153815
31104,0.000439,74.125.68.0-255,1484,51606,65,153815
31105,0.000456,74.125.68.0-255,1484,53090,65,153815
31106,0.000459,172.31.40.0-255,66,53156,65,153815
31107,0.000465,74.125.68.0-255,4320,57476,65,153815
31108,0.000467,172.31.40.0-255,66,57542,65,153815
31109,0.000472,74.125.68.0-255,4320,61862,65,153815
31110,0.000475,172.31.40.0-255,66,61928,65,153815
31111,0.000518,74.125.68.0-255,2902,64830,65,153815
31112,0.000521,172.31.40.0-255,66,64896,65,153815
31113,0.000539,74.125.68.0-255,1706,66602,65,153815
31114,0.000541,172.31.40.0-255,66,66668,65,153815
31115,0.000727,74.125.68.0-255,1484,68152,65,153815
31116,0.000747,74.125.68.0-255,2902,71054,65,153815
31117,0.000752,172.31.40.0-255,66,71120,65,153815
31118,0.000783,74.125.68.0-255,5738,76858,65,153815
31119,0.000787,172.31.40.0-255,66,76924,65,153815
31120,0.000793,74.125.68.0-255,5738,82662,65,153815
31121,0.000796,172.31.40.0-255,66,82728,65,153815
31122,0.000798,74.125.68.0-255,575,83303,65,153815
31123,0.00134,172.31.40.0-255,66,83369,65,153815
31124,0.00138,74.125.68.0-255,1484,84853,65,153815
31125,0.001406,74.125.68.0-255,2902,87755,65,153815
31126,0.001409,172.31.40.0-255,66,87821,65,153815
31127,0.00143,74.125.68.0-255,5738,93559,65,153815
31128,0.001433,172.31.40.0-255,66,93625,65,153815
31129,0.001447,74.125.68.0-255,1484,95109,65,153815
31130,0.001463,74.125.68.0-255,2902,98011,65,153815
31131,0.001466,172.31.40.0-255,66,98077,65,153815
31132,0.001502,74.125.68.0-255,2543,100620,65,153815
31133,0.001505,172.31.40.0-255,66,100686,65,153815
31134,0.003487,74.125.68.0-255,2902,103588,65,153815
31135,0.003496,172.31.40.0-255,66,103654,65,153815
31136,0.003525,74.125.68.0-255,2902,106556,65,153815
31137,0.003528,172.31.40.0-255,66,106622,65,153815
31138,0.005504,74.125.68.0-255,2902,109524,65,153815
31139,0.005511,172.31.40.0-255,66,109590,65,153815
31140,0.005544,74.125.68.0-255,2902,112492,65,153815
31141,0.005547,172.31.40.0-255,66,112558,65,153815
31142,0.007526,74.125.68.0-255,2902,115460,65,153815
31143,0.007531,172.31.40.0-255,66,115526,65,153815
31144,0.007568,74.125.68.0-255,2902,118428,65,153815
31145,0.007571,172.31.40.0-255,66,118494,65,153815
31146,0.007649,172.31.40.0-255,101,118595,65,153815
31147,0.009548,74.125.68.0-255,2902,121497,65,153815
31148,0.009556,172.31.40.0-255,66,121563,65,153815
31149,0.009574,74.125.68.0-255,1484,123047,65,153815
31150,0.009586,74.125.68.0-255,1484,124531,65,153815
31151,0.009588,172.31.40.0-255,66,124597,65,153815
31152,0.009613,74.125.68.0-255,66,124663,65,153815
31153,0.011569,74.125.68.0-255,2902,127565,65,153815
31154,0.011579,172.31.40.0-255,66,127631,65,153815
31155,0.011599,74.125.68.0-255,2902,130533,65,153815
31156,0.011603,172.31.40.0-255,66,130599,65,153815
31157,0.013599,74.125.68.0-255,5738,136337,65,153815
31158,0.013606,172.31.40.0-255,66,136403,65,153815
31159,0.015627,74.125.68.0-255,5738,142141,65,153815
31160,0.015636,172.31.40.0-255,66,142207,65,153815
31161,0.017654,74.125.68.0-255,5738,147945,65,153815
31162,0.017666,172.31.40.0-255,66,148011,65,153815
31163,0.019691,74.125.68.0-255,5738,153749,65,153815
31164,0.019699,172.31.40.0-255,66,153815,65,153815
31165,0.0,74.125.68.0-255,150,150,65,205597
31166,2.1e-05,172.31.40.0-255,66,216,65,205597
31167,2.7e-05,74.125.68.0-255,1484,1700,65,205597
31168,3.2e-05,172.31.40.0-255,66,1766,65,205597
31169,3.9e-05,74.125.68.0-255,2902,4668,65,205597
31170,5.1e-05,172.31.40.0-255,66,4734,65,205597
31171,5.9e-05,74.125.68.0-255,7156,11890,65,205597
31172,6.3e-05,172.31.40.0-255,66,11956,65,205597
31173,8.7e-05,74.125.68.0-255,2137,14093,65,205597
31174,9e-05,172.31.40.0-255,66,14159,65,205597
31175,0.000123,74.125.68.0-255,2902,17061,65,205597
31176,0.000126,172.31.40.0-255,66,17127,65,205597
31177,0.000133,74.125.68.0-255,7156,24283,65,205597
31178,0.000136,172.31.40.0-255,66,24349,65,205597
31179,0.00014,74.125.68.0-255,2902,27251,65,205597
31180,0.000147,172.31.40.0-255,66,27317,65,205597
31181,0.000193,74.125.68.0-255,3961,31278,65,205597
31182,0.000196,172.31.40.0-255,66,31344,65,205597
31183,0.00026,74.125.68.0-255,1484,32828,65,205597
31184,0.000264,172.31.40.0-255,66,32894,65,205597
31185,0.000269,74.125.68.0-255,2902,35796,65,205597
31186,0.000272,172.31.40.0-255,66,35862,65,205597
31187,0.000304,74.125.68.0-255,4320,40182,65,205597
31188,0.000307,172.31.40.0-255,66,40248,65,205597
31189,0.000313,74.125.68.0-255,5738,45986,65,205597
31190,0.000316,172.31.40.0-255,66,46052,65,205597
31191,0.000354,74.125.68.0-255,7156,53208,65,205597
31192,0.000357,172.31.40.0-255,66,53274,65,205597
31193,0.000383,74.125.68.0-255,3961,57235,65,205597
31194,0.000385,172.31.40.0-255,66,57301,65,205597
31195,0.000433,172.31.40.0-255,66,57367,65,205597
31196,0.000436,74.125.68.0-255,381,57748,65,205597
31197,0.000538,74.125.68.0-255,1484,59232,65,205597
31198,0.000543,172.31.40.0-255,66,59298,65,205597
31199,0.000569,74.125.68.0-255,2902,62200,65,205597
31200,0.000573,172.31.40.0-255,66,62266,65,205597
31201,0.000578,74.125.68.0-255,5738,68004,65,205597
31202,0.000581,172.31.40.0-255,66,68070,65,205597
31203,0.000619,74.125.68.0-255,1484,69554,65,205597
31204,0.000644,74.125.68.0-255,7156,76710,65,205597
31205,0.000647,74.125.68.0-255,1484,78194,65,205597
31206,0.000663,74.125.68.0-255,5379,83573,65,205597
31207,0.000723,172.31.40.0-255,66,83639,65,205597
31208,0.001397,74.125.68.0-255,1484,85123,65,205597
31209,0.001421,74.125.68.0-255,2902,88025,65,205597
31210,0.001425,172.31.40.0-255,66,88091,65,205597
31211,0.001429,74.125.68.0-255,1484,89575,65,205597
31212,0.001453,74.125.68.0-255,2902,92477,65,205597
31213,0.001455,172.31.40.0-255,66,92543,65,205597
31214,0.00146,74.125.68.0-255,2902,95445,65,205597
31215,0.001462,172.31.40.0-255,66,95511,65,205597
31216,0.001487,74.125.68.0-255,2902,98413,65,205597
31217,0.001489,172.31.40.0-255,66,98479,65,205597
31218,0.001501,74.125.68.0-255,7156,105635,65,205597
31219,0.001504,172.31.40.0-255,66,105701,65,205597
31220,0.001511,74.125.68.0-255,5738,111439,65,205597
31221,0.001513,172.31.40.0-255,66,111505,65,205597
31222,0.001542,74.125.68.0-255,2902,114407,65,205597
31223,0.001545,172.31.40.0-255,66,114473,65,205597
31224,0.00155,74.125.68.0-255,3602,118075,65,205597
31225,0.001552,172.31.40.0-255,66,118141,65,205597
31226,0.001675,74.125.68.0-255,1484,119625,65,205597
31227,0.001691,74.125.68.0-255,2902,122527,65,205597
31228,0.001695,172.31.40.0-255,66,122593,65,205597
31229,0.001715,74.125.68.0-255,4320,126913,65,205597
31230,0.001717,172.31.40.0-255,66,126979,65,205597
31231,0.001741,74.125.68.0-255,1484,128463,65,205597
31232,0.001748,74.125.68.0-255,5738,134201,65,205597
31233,0.00175,172.31.40.0-255,66,134267,65,205597
31234,0.001778,74.125.68.0-255,7156,141423,65,205597
31235,0.001783,172.31.40.0-255,66,141489,65,205597
31236,0.001828,172.31.40.0-255,66,141555,65,205597
31237,0.001983,74.125.68.0-255,1484,143039,65,205597
31238,0.002001,74.125.68.0-255,2902,145941,65,205597
31239,0.002005,172.31.40.0-255,66,146007,65,205597
31240,0.002033,74.125.68.0-255,5738,151745,65,205597
31241,0.002036,172.31.40.0-255,66,151811,65,205597
31242,0.002064,172.31.40.0-255,66,151877,65,205597
31243,0.002068,74.125.68.0-255,1484,153361,65,205597
31244,0.002097,74.125.68.0-255,5738,159099,65,205597
31245,0.00211,172.31.40.0-255,66,159165,65,205597
31246,0.004181,74.125.68.0-255,5738,164903,65,205597
31247,0.004189,172.31.40.0-255,66,164969,65,205597
31248,0.006247,74.125.68.0-255,5738,170707,65,205597
31249,0.006253,172.31.40.0-255,66,170773,65,205597
31250,0.00831,74.125.68.0-255,5738,176511,65,205597
31251,0.008317,172.31.40.0-255,66,176577,65,205597
31252,0.010376,74.125.68.0-255,5738,182315,65,205597
31253,0.010383,172.31.40.0-255,66,182381,65,205597
31254,0.012448,74.125.68.0-255,5738,188119,65,205597
31255,0.012457,172.31.40.0-255,66,188185,65,205597
31256,0.014541,74.125.68.0-255,5738,193923,65,205597
31257,0.014551,172.31.40.0-255,66,193989,65,205597
31258,0.016619,74.125.68.0-255,5738,199727,65,205597
31259,0.016632,172.31.40.0-255,66,199793,65,205597
31260,0.018758,74.125.68.0-255,5738,205531,65,205597
31261,0.018766,172.31.40.0-255,66,205597,65,205597
31262,0.0,74.125.68.0-255,153,153,65,224123
31263,1.5e-05,172.31.40.0-255,66,219,65,224123
31264,2.2e-05,74.125.68.0-255,1484,1703,65,224123
31265,2.7e-05,172.31.40.0-255,66,1769,65,224123
31266,3.3e-05,74.125.68.0-255,2902,4671,65,224123
31267,3.7e-05,172.31.40.0-255,66,4737,65,224123
31268,4.1e-05,74.125.68.0-255,2902,7639,65,224123
31269,4.4e-05,172.31.40.0-255,66,7705,65,224123
31270,6.2e-05,74.125.68.0-255,1484,9189,65,224123
31271,6.5e-05,172.31.40.0-255,66,9255,65,224123
31272,6.8e-05,74.125.68.0-255,1484,10739,65,224123
31273,7e-05,172.31.40.0-255,66,10805,65,224123
31274,9e-05,172.31.40.0-255,66,10871,65,224123
31275,0.000123,172.31.40.0-255,66,10937,65,224123
31276,0.000127,74.125.68.0-255,2543,13480,65,224123
31277,0.000129,172.31.40.0-255,66,13546,65,224123
31278,0.000501,74.125.68.0-255,1484,15030,65,224123
31279,0.000509,172.31.40.0-255,66,15096,65,224123
31280,0.000515,74.125.68.0-255,2902,17998,65,224123
31281,0.000517,172.31.40.0-255,66,18064,65,224123
31282,0.000522,74.125.68.0-255,2902,20966,65,224123
31283,0.000524,172.31.40.0-255,66,21032,65,224123
31284,0.000555,74.125.68.0-255,2902,23934,65,224123
31285,0.000558,172.31.40.0-255,66,24000,65,224123
31286,0.000564,74.125.68.0-255,4320,28320,65,224123
31287,0.000566,172.31.40.0-255,66,28386,65,224123
31288,0.00057,74.125.68.0-255,2902,31288,65,224123
31289,0.000573,172.31.40.0-255,66,31354,65,224123
31290,0.000593,74.125.68.0-255,2543,33897,65,224123
31291,0.000595,172.31.40.0-255,66,33963,65,224123
31292,0.000606,172.31.40.0-255,66,34029,65,224123
31293,0.000645,74.125.68.0-255,5649,39678,65,224123
31294,0.000648,172.31.40.0-255,66,39744,65,224123
31295,0.000651,74.125.68.0-255,139,39883,65,224123
31296,0.000798,74.125.68.0-255,1484,41367,65,224123
31297,0.000802,172.31.40.0-255,66,41433,65,224123
31298,0.000808,74.125.68.0-255,2902,44335,65,224123
31299,0.000811,172.31.40.0-255,66,44401,65,224123
31300,0.000815,74.125.68.0-255,2902,47303,65,224123
31301,0.000817,172.31.40.0-255,66,47369,65,224123
31302,0.000842,74.125.68.0-255,2902,50271,65,224123
31303,0.000845,172.31.40.0-255,66,50337,65,224123
31304,0.000853,74.125.68.0-255,6494,56831,65,224123
31305,0.000856,172.31.40.0-255,66,56897,65,224123
31306,0.000912,74.125.68.0-255,1484,58381,65,224123
31307,0.000929,74.125.68.0-255,2902,61283,65,224123
31308,0.000934,74.125.68.0-255,4320,65603,65,224123
31309,0.000938,172.31.40.0-255,66,65669,65,224123
31310,0.000946,172.31.40.0-255,66,65735,65,224123
31311,0.000951,74.125.68.0-255,4320,70055,65,224123
31312,0.000954,172.31.40.0-255,66,70121,65,224123
31313,0.000969,74.125.68.0-255,1484,71605,65,224123
31314,0.000984,74.125.68.0-255,1484,73089,65,224123
31315,0.000987,172.31.40.0-255,66,73155,65,224123
31316,0.001018,172.31.40.0-255,66,73221,65,224123
31317,0.001038,74.125.68.0-255,2902,76123,65,224123
31318,0.00104,172.31.40.0-255,66,76189,65,224123
31319,0.001059,74.125.68.0-255,5020,81209,65,224123
31320,0.001061,172.31.40.0-255,66,81275,65,224123
31321,0.001106,74.125.68.0-255,2902,84177,65,224123
31322,0.001109,172.31.40.0-255,66,84243,65,224123
31323,0.001136,74.125.68.0-255,5738,89981,65,224123
31324,0.00114,172.31.40.0-255,66,90047,65,224123
31325,0.001152,172.31.40.0-255,66,90113,65,224123
31326,0.001162,172.31.40.0-255,66,90179,65,224123
31327,0.00119,74.125.68.0-255,5020,95199,65,224123
31328,0.001193,172.31.40.0-255,66,95265,65,224123
31329,0.001231,74.125.68.0-255,5738,101003,65,224123
31330,0.001235,172.31.40.0-255,66,101069,65,224123
31331,0.001238,74.125.68.0-255,1484,102553,65,224123
31332,0.001254,74.125.68.0-255,2902,105455,65,224123
31333,0.001257,172.31.40.0-255,66,105521,65,224123
31334,0.001266,74.125.68.0-255,2902,108423,65,224123
31335,0.001269,172.31.40.0-255,66,108489,65,224123
31336,0.001282,74.125.68.0-255,2902,111391,65,224123
31337,0.001284,172.31.40.0-255,66,111457,65,224123
31338,0.001308,74.125.68.0-255,4320,115777,65,224123
31339,0.001311,172.31.40.0-255,66,115843,65,224123
31340,0.001337,74.125.68.0-255,7156,122999,65,224123
31341,0.00134,172.31.40.0-255,66,123065,65,224123
31342,0.001344,74.125.68.0-255,2902,125967,65,224123
31343,0.001346,172.31.40.0-255,66,126033,65,224123
31344,0.001361,74.125.68.0-255,3602,129635,65,224123
31345,0.001364,172.31.40.0-255,66,129701,65,224123
31346,0.001805,74.125.68.0-255,1484,131185,65,224123
31347,0.001833,74.125.68.0-255,1484,132669,65,224123
31348,0.001837,172.31.40.0-255,66,132735,65,224123
31349,0.001869,74.125.68.0-255,2902,135637,65,224123
31350,0.001872,172.31.40.0-255,66,135703,65,224123
31351,0.001898,74.125.68.0-255,1484,137187,65,224123
31352,0.001912,74.125.68.0-255,2902,140089,65,224123
31353,0.001915,172.31.40.0-255,66,140155,65,224123
31354,0.001938,74.125.68.0-255,2902,143057,65,224123
31355,0.00194,172.31.40.0-255,66,143123,65,224123
31356,0.002002,74.125.68.0-255,4320,147443,65,224123
31357,0.00201,172.31.40.0-255,66,147509,65,224123
31358,0.002027,74.125.68.0-255,4320,151829,65,224123
31359,0.00203,172.31.40.0-255,66,151895,65,224123
31360,0.00206,74.125.68.0-255,1484,153379,65,224123
31361,0.002065,74.125.68.0-255,2902,156281,65,224123
31362,0.002068,172.31.40.0-255,66,156347,65,224123
31363,0.002074,74.125.68.0-255,4320,160667,65,224123
31364,0.002076,172.31.40.0-255,66,160733,65,224123
31365,0.002101,74.125.68.0-255,3602,164335,65,224123
31366,0.002103,172.31.40.0-255,66,164401,65,224123
31367,0.002308,74.125.68.0-255,1484,165885,65,224123
31368,0.002314,74.125.68.0-255,2902,168787,65,224123
31369,0.002317,172.31.40.0-255,66,168853,65,224123
31370,0.00234,74.125.68.0-255,5738,174591,65,224123
31371,0.002342,172.31.40.0-255,66,174657,65,224123
31372,0.002373,74.125.68.0-255,7156,181813,65,224123
31373,0.002376,172.31.40.0-255,66,181879,65,224123
31374,0.00238,74.125.68.0-255,2902,184781,65,224123
31375,0.002382,172.31.40.0-255,66,184847,65,224123
31376,0.004739,74.125.68.0-255,5738,190585,65,224123
31377,0.004746,172.31.40.0-255,66,190651,65,224123
31378,0.007099,74.125.68.0-255,4320,194971,65,224123
31379,0.007106,172.31.40.0-255,66,195037,65,224123
31380,0.00712,74.125.68.0-255,1484,196521,65,224123
31381,0.009473,74.125.68.0-255,4320,200841,65,224123
31382,0.009491,172.31.40.0-255,66,200907,65,224123
31383,0.011874,74.125.68.0-255,5738,206645,65,224123
31384,0.011887,172.31.40.0-255,66,206711,65,224123
31385,0.014306,74.125.68.0-255,5738,212449,65,224123
31386,0.014316,172.31.40.0-255,66,212515,65,224123
31387,0.016678,74.125.68.0-255,5738,218253,65,224123
31388,0.016692,172.31.40.0-255,66,218319,65,224123
31389,0.019103,74.125.68.0-255,5738,224057,65,224123
31390,0.019117,172.31.40.0-255,66,224123,65,224123
31391,0.0,172.217.194.0-255,156,156,65,173358
31392,2.3e-05,172.31.40.0-255,66,222,65,173358
31393,3e-05,172.217.194.0-255,1484,1706,65,173358
31394,3.5e-05,172.31.40.0-255,66,1772,65,173358
31395,4e-05,172.217.194.0-255,2902,4674,65,173358
31396,4.3e-05,172.31.40.0-255,66,4740,65,173358
31397,5.1e-05,172.217.194.0-255,7156,11896,65,173358
31398,5.5e-05,172.31.40.0-255,66,11962,65,173358
31399,6.7e-05,172.31.40.0-255,66,12028,65,173358
31400,0.000126,172.31.40.0-255,66,12094,65,173358
31401,0.000173,172.217.194.0-255,1484,13578,65,173358
31402,0.000175,172.31.40.0-255,66,13644,65,173358
31403,0.00018,172.217.194.0-255,2902,16546,65,173358
31404,0.000182,172.31.40.0-255,66,16612,65,173358
31405,0.000207,172.217.194.0-255,5738,22350,65,173358
31406,0.00021,172.31.40.0-255,66,22416,65,173358
31407,0.00023,172.217.194.0-255,2902,25318,65,173358
31408,0.000232,172.31.40.0-255,66,25384,65,173358
31409,0.000257,172.31.40.0-255,66,25450,65,173358
31410,0.000269,172.31.40.0-255,66,25516,65,173358
31411,0.000313,172.217.194.0-255,118,25634,65,173358
31412,0.000316,172.31.40.0-255,66,25700,65,173358
31413,0.000401,172.217.194.0-255,1484,27184,65,173358
31414,0.000404,172.31.40.0-255,66,27250,65,173358
31415,0.000408,172.217.194.0-255,1484,28734,65,173358
31416,0.000409,172.31.40.0-255,66,28800,65,173358
31417,0.000425,172.217.194.0-255,1484,30284,65,173358
31418,0.000428,172.31.40.0-255,66,30350,65,173358
31419,0.000435,172.217.194.0-255,5738,36088,65,173358
31420,0.000505,172.217.194.0-255,5738,41826,65,173358
31421,0.000521,172.217.194.0-255,5379,47205,65,173358
31422,0.000558,172.31.40.0-255,66,47271,65,173358
31423,0.000674,172.217.194.0-255,1484,48755,65,173358
31424,0.000681,172.217.194.0-255,2902,51657,65,173358
31425,0.000684,172.217.194.0-255,1484,53141,65,173358
31426,0.000707,172.31.40.0-255,66,53207,65,173358
31427,0.000713,172.217.194.0-255,4320,57527,65,173358
31428,0.000731,172.31.40.0-255,66,57593,65,173358
31429,0.000753,172.217.194.0-255,1484,59077,65,173358
31430,0.000778,172.217.194.0-255,7156,66233,65,173358
31431,0.000787,172.31.40.0-255,66,66299,65,173358
31432,0.000797,172.217.194.0-255,4320,70619,65,173358
31433,0.000802,172.31.40.0-255,66,70685,65,173358
31434,0.000816,172.217.194.0-255,4320,75005,65,173358
31435,0.000831,172.31.40.0-255,66,75071,65,173358
31436,0.000884,172.217.194.0-255,4320,79391,65,173358
31437,0.000891,172.217.194.0-255,7156,86547,65,173358
31438,0.0009,172.31.40.0-255,66,86613,65,173358
31439,0.000923,172.217.194.0-255,3602,90215,65,173358
31440,0.000951,172.217.194.0-255,4320,94535,65,173358
31441,0.000958,172.31.40.0-255,66,94601,65,173358
31442,0.000976,172.217.194.0-255,5738,100339,65,173358
31443,0.000979,172.217.194.0-255,1484,101823,65,173358
31444,0.001008,172.31.40.0-255,66,101889,65,173358
31445,0.001025,172.217.194.0-255,1484,103373,65,173358
31446,0.001069,172.31.40.0-255,66,103439,65,173358
31447,0.001623,172.217.194.0-255,381,103820,65,173358
31448,0.001662,172.217.194.0-255,1484,105304,65,173358
31449,0.001666,172.31.40.0-255,66,105370,65,173358
31450,0.001672,172.217.194.0-255,4320,109690,65,173358
31451,0.001687,172.217.194.0-255,5738,115428,65,173358
31452,0.001691,172.31.40.0-255,66,115494,65,173358
31453,0.001705,172.217.194.0-255,2902,118396,65,173358
31454,0.001765,172.31.40.0-255,66,118462,65,173358
31455,0.001825,172.31.40.0-255,66,118528,65,173358
31456,0.001839,172.217.194.0-255,2902,121430,65,173358
31457,0.001874,172.217.194.0-255,5738,127168,65,173358
31458,0.00188,172.31.40.0-255,66,127234,65,173358
31459,0.001903,172.217.194.0-255,5738,132972,65,173358
31460,0.00191,172.217.194.0-255,4320,137292,65,173358
31461,0.001914,172.217.194.0-255,4320,141612,65,173358
31462,0.001919,172.31.40.0-255,66,141678,65,173358
31463,0.001949,172.217.194.0-255,766,142444,65,173358
31464,0.001971,172.31.40.0-255,66,142510,65,173358
31465,0.001997,172.217.194.0-255,1484,143994,65,173358
31466,0.00202,172.217.194.0-255,2902,146896,65,173358
31467,0.002027,172.217.194.0-255,5738,152634,65,173358
31468,0.00203,172.217.194.0-255,1484,154118,65,173358
31469,0.002064,172.217.194.0-255,5738,159856,65,173358
31470,0.002067,172.31.40.0-255,66,159922,65,173358
31471,0.002081,172.31.40.0-255,66,159988,65,173358
31472,0.002087,172.217.194.0-255,5020,165008,65,173358
31473,0.002117,172.217.194.0-255,7156,172164,65,173358
31474,0.00212,172.31.40.0-255,66,172230,65,173358
31475,0.002125,172.31.40.0-255,66,172296,65,173358
31476,0.002155,172.31.40.0-255,66,172362,65,173358
31477,0.002188,172.217.194.0-255,105,172467,65,173358
31478,0.002203,172.31.40.0-255,66,172533,65,173358
31479,0.002217,172.217.194.0-255,129,172662,65,173358
31480,0.00445,172.31.40.0-255,105,172767,65,173358
31481,0.004491,172.31.40.0-255,105,172872,65,173358
31482,0.004723,172.31.40.0-255,90,172962,65,173358
31483,0.004734,172.31.40.0-255,66,173028,65,173358
31484,0.006796,172.217.194.0-255,66,173094,65,173358
31485,0.006813,172.217.194.0-255,66,173160,65,173358
31486,0.007022,172.217.194.0-255,66,173226,65,173358
31487,0.007326,172.217.194.0-255,66,173292,65,173358
31488,0.007341,172.31.40.0-255,66,173358,65,173358
31489,0.0,74.125.200.0-255,150,150,65,222763
31490,1.6e-05,172.31.40.0-255,66,216,65,222763
31491,2.3e-05,74.125.200.0-255,1484,1700,65,222763
31492,2.7e-05,172.31.40.0-255,66,1766,65,222763
31493,3.4e-05,74.125.200.0-255,2902,4668,65,222763
31494,4.4e-05,172.31.40.0-255,66,4734,65,222763
31495,8.2e-05,74.125.200.0-255,5738,10472,65,222763
31496,8.6e-05,172.31.40.0-255,66,10538,65,222763
31497,9.2e-05,74.125.200.0-255,3396,13934,65,222763
31498,9.4e-05,172.31.40.0-255,66,14000,65,222763
31499,9.9e-05,74.125.200.0-255,4320,18320,65,222763
31500,0.000102,172.31.40.0-255,66,18386,65,222763
31501,0.000131,74.125.200.0-255,7156,25542,65,222763
31502,0.000133,172.31.40.0-255,66,25608,65,222763
31503,0.000145,74.125.200.0-255,1484,27092,65,222763
31504,0.000147,172.31.40.0-255,66,27158,65,222763
31505,0.000179,74.125.200.0-255,3961,31119,65,222763
31506,0.000182,172.31.40.0-255,66,31185,65,222763
31507,0.000287,74.125.200.0-255,1484,32669,65,222763
31508,0.000291,172.31.40.0-255,66,32735,65,222763
31509,0.000296,74.125.200.0-255,2902,35637,65,222763
31510,0.000298,172.31.40.0-255,66,35703,65,222763
31511,0.000303,74.125.200.0-255,2902,38605,65,222763
31512,0.000305,172.31.40.0-255,66,38671,65,222763
31513,0.000315,74.125.200.0-255,4320,42991,65,222763
31514,0.000318,172.31.40.0-255,66,43057,65,222763
31515,0.000322,74.125.200.0-255,2902,45959,65,222763
31516,0.000324,172.31.40.0-255,66,46025,65,222763
31517,0.000364,74.125.200.0-255,6797,52822,65,222763
31518,0.000367,172.31.40.0-255,66,52888,65,222763
31519,0.000378,172.31.40.0-255,66,52954,65,222763
31520,0.000382,74.125.200.0-255,2816,55770,65,222763
31521,0.000385,172.31.40.0-255,66,55836,65,222763
31522,0.000586,74.125.200.0-255,131,55967,65,222763
31523,0.000722,74.125.200.0-255,1484,57451,65,222763
31524,0.000727,172.31.40.0-255,66,57517,65,222763
31525,0.000731,74.125.200.0-255,1484,59001,65,222763
31526,0.000753,74.125.200.0-255,1484,60485,65,222763
31527,0.000756,172.31.40.0-255,66,60551,65,222763
31528,0.000763,74.125.200.0-255,5738,66289,65,222763
31529,0.000765,172.31.40.0-255,66,66355,65,222763
31530,0.000805,172.31.40.0-255,66,66421,65,222763
31531,0.000817,172.31.40.0-255,66,66487,65,222763
31532,0.000847,74.125.200.0-255,6797,73284,65,222763
31533,0.00085,172.31.40.0-255,66,73350,65,222763
31534,0.00088,74.125.200.0-255,2902,76252,65,222763
31535,0.000885,172.31.40.0-255,66,76318,65,222763
31536,0.000912,74.125.200.0-255,4320,80638,65,222763
31537,0.000914,172.31.40.0-255,66,80704,65,222763
31538,0.000925,172.31.40.0-255,66,80770,65,222763
31539,0.000927,74.125.200.0-255,827,81597,65,222763
31540,0.001142,74.125.200.0-255,1484,83081,65,222763
31541,0.001149,172.31.40.0-255,66,83147,65,222763
31542,0.001178,74.125.200.0-255,2902,86049,65,222763
31543,0.001183,172.31.40.0-255,66,86115,65,222763
31544,0.00119,74.125.200.0-255,5738,91853,65,222763
31545,0.001192,172.31.40.0-255,66,91919,65,222763
31546,0.001197,74.125.200.0-255,2902,94821,65,222763
31547,0.001199,172.31.40.0-255,66,94887,65,222763
31548,0.001204,74.125.200.0-255,2902,97789,65,222763
31549,0.001207,172.31.40.0-255,66,97855,65,222763
31550,0.001243,74.125.200.0-255,7156,105011,65,222763
31551,0.001246,172.31.40.0-255,66,105077,65,222763
31552,0.001259,172.31.40.0-255,66,105143,65,222763
31553,0.001704,74.125.200.0-255,1484,106627,65,222763
31554,0.001711,74.125.200.0-255,1484,108111,65,222763
31555,0.001715,172.31.40.0-255,66,108177,65,222763
31556,0.001747,74.125.200.0-255,1484,109661,65,222763
31557,0.001752,74.125.200.0-255,4320,113981,65,222763
31558,0.001756,172.31.40.0-255,66,114047,65,222763
31559,0.001791,74.125.200.0-255,5738,119785,65,222763
31560,0.001794,172.31.40.0-255,66,119851,65,222763
31561,0.0018,74.125.200.0-255,5738,125589,65,222763
31562,0.001802,172.31.40.0-255,66,125655,65,222763
31563,0.001839,74.125.200.0-255,7156,132811,65,222763
31564,0.001843,172.31.40.0-255,66,132877,65,222763
31565,0.001847,74.125.200.0-255,2902,135779,65,222763
31566,0.001849,172.31.40.0-255,66,135845,65,222763
31567,0.001854,74.125.200.0-255,3602,139447,65,222763
31568,0.001857,172.31.40.0-255,66,139513,65,222763
31569,0.001912,74.125.200.0-255,1484,140997,65,222763
31570,0.001937,74.125.200.0-255,2902,143899,65,222763
31571,0.001939,172.31.40.0-255,66,143965,65,222763
31572,0.001943,74.125.200.0-255,1484,145449,65,222763
31573,0.001947,74.125.200.0-255,2902,148351,65,222763
31574,0.001949,172.31.40.0-255,66,148417,65,222763
31575,0.001953,74.125.200.0-255,2902,151319,65,222763
31576,0.001955,172.31.40.0-255,66,151385,65,222763
31577,0.00198,74.125.200.0-255,2902,154287,65,222763
31578,0.001983,172.31.40.0-255,66,154353,65,222763
31579,0.001989,74.125.200.0-255,4320,158673,65,222763
31580,0.001991,172.31.40.0-255,66,158739,65,222763
31581,0.002031,172.31.40.0-255,66,158805,65,222763
31582,0.002046,74.125.200.0-255,4320,163125,65,222763
31583,0.002048,172.31.40.0-255,66,163191,65,222763
31584,0.002073,74.125.200.0-255,2184,165375,65,222763
31585,0.002075,172.31.40.0-255,66,165441,65,222763
31586,0.00214,74.125.200.0-255,1484,166925,65,222763
31587,0.002157,74.125.200.0-255,2902,169827,65,222763
31588,0.00216,172.31.40.0-255,66,169893,65,222763
31589,0.002164,74.125.200.0-255,2902,172795,65,222763
31590,0.002166,172.31.40.0-255,66,172861,65,222763
31591,0.002196,74.125.200.0-255,2902,175763,65,222763
31592,0.002203,74.125.200.0-255,7156,182919,65,222763
31593,0.002208,74.125.200.0-255,2902,185821,65,222763
31594,0.002237,74.125.200.0-255,5738,191559,65,222763
31595,0.002243,74.125.200.0-255,5738,197297,65,222763
31596,0.002264,74.125.200.0-255,2184,199481,65,222763
31597,0.009085,172.31.40.0-255,66,199547,65,222763
31598,0.011361,74.125.200.0-255,5738,205285,65,222763
31599,0.011373,172.31.40.0-255,66,205351,65,222763
31600,0.013631,74.125.200.0-255,5738,211089,65,222763
31601,0.01364,172.31.40.0-255,66,211155,65,222763
31602,0.015883,74.125.200.0-255,5738,216893,65,222763
31603,0.015892,172.31.40.0-255,66,216959,65,222763
31604,0.018142,74.125.200.0-255,5738,222697,65,222763
31605,0.018151,172.31.40.0-255,66,222763,65,222763
31606,0.0,172.217.27.0-255,150,150,65,150343
31607,2.5e-05,172.31.40.0-255,66,216,65,150343
31608,3.2e-05,172.217.27.0-255,1484,1700,65,150343
31609,3.7e-05,172.31.40.0-255,66,1766,65,150343
31610,4.9e-05,172.217.27.0-255,2902,4668,65,150343
31611,5.3e-05,172.31.40.0-255,66,4734,65,150343
31612,5.9e-05,172.217.27.0-255,4320,9054,65,150343
31613,6.3e-05,172.31.40.0-255,66,9120,65,150343
31614,6.5e-05,172.217.27.0-255,1484,10604,65,150343
31615,6.9e-05,172.31.40.0-255,66,10670,65,150343
31616,8.1e-05,172.31.40.0-255,66,10736,65,150343
31617,8.3e-05,172.217.27.0-255,1484,12220,65,150343
31618,8.6e-05,172.31.40.0-255,66,12286,65,150343
31619,9.3e-05,172.217.27.0-255,5738,18024,65,150343
31620,9.5e-05,172.31.40.0-255,66,18090,65,150343
31621,0.000134,172.217.27.0-255,5379,23469,65,150343
31622,0.000138,172.31.40.0-255,66,23535,65,150343
31623,0.000214,172.217.27.0-255,1484,25019,65,150343
31624,0.000216,172.31.40.0-255,66,25085,65,150343
31625,0.000221,172.217.27.0-255,2902,27987,65,150343
31626,0.000223,172.31.40.0-255,66,28053,65,150343
31627,0.000258,172.217.27.0-255,5738,33791,65,150343
31628,0.000261,172.31.40.0-255,66,33857,65,150343
31629,0.000265,172.217.27.0-255,1484,35341,65,150343
31630,0.000267,172.31.40.0-255,66,35407,65,150343
31631,0.000313,172.31.40.0-255,66,35473,65,150343
31632,0.000324,172.31.40.0-255,66,35539,65,150343
31633,0.000332,172.217.27.0-255,1394,36933,65,150343
31634,0.000334,172.31.40.0-255,66,36999,65,150343
31635,0.000732,172.217.27.0-255,385,37384,65,150343
31636,0.000769,172.217.27.0-255,1484,38868,65,150343
31637,0.000774,172.31.40.0-255,66,38934,65,150343
31638,0.000802,172.217.27.0-255,2902,41836,65,150343
31639,0.000807,172.217.27.0-255,4320,46156,65,150343
31640,0.000818,172.31.40.0-255,66,46222,65,150343
31641,0.000865,172.31.40.0-255,66,46288,65,150343
31642,0.000876,172.217.27.0-255,7156,53444,65,150343
31643,0.000891,172.31.40.0-255,66,53510,65,150343
31644,0.000894,172.217.27.0-255,1484,54994,65,150343
31645,0.000901,172.217.27.0-255,5738,60732,65,150343
31646,0.000924,172.31.40.0-255,66,60798,65,150343
31647,0.000942,172.217.27.0-255,2543,63341,65,150343
31648,0.000984,172.217.27.0-255,2902,66243,65,150343
31649,0.000988,172.217.27.0-255,1484,67727,65,150343
31650,0.000992,172.217.27.0-255,2902,70629,65,150343
31651,0.000995,172.217.27.0-255,1484,72113,65,150343
31652,0.001005,172.31.40.0-255,66,72179,65,150343
31653,0.001011,172.217.27.0-255,4320,76499,65,150343
31654,0.00102,172.31.40.0-255,66,76565,65,150343
31655,0.001077,172.31.40.0-255,66,76631,65,150343
31656,0.001199,172.217.27.0-255,1484,78115,65,150343
31657,0.001205,172.217.27.0-255,2902,81017,65,150343
31658,0.00122,172.31.40.0-255,66,81083,65,150343
31659,0.001227,172.217.27.0-255,5738,86821,65,150343
31660,0.001232,172.31.40.0-255,66,86887,65,150343
31661,0.00129,172.31.40.0-255,66,86953,65,150343
31662,0.001294,172.217.27.0-255,2184,89137,65,150343
31663,0.001299,172.31.40.0-255,66,89203,65,150343
31664,0.002967,172.217.27.0-255,5738,94941,65,150343
31665,0.002974,172.31.40.0-255,66,95007,65,150343
31666,0.00463,172.217.27.0-255,4320,99327,65,150343
31667,0.004634,172.31.40.0-255,66,99393,65,150343
31668,0.004656,172.217.27.0-255,1484,100877,65,150343
31669,0.006287,172.217.27.0-255,4320,105197,65,150343
31670,0.006293,172.31.40.0-255,66,105263,65,150343
31671,0.007946,172.217.27.0-255,4320,109583,65,150343
31672,0.007951,172.31.40.0-255,66,109649,65,150343
31673,0.007983,172.217.27.0-255,1484,111133,65,150343
31674,0.009614,172.217.27.0-255,4320,115453,65,150343
31675,0.00962,172.31.40.0-255,66,115519,65,150343
31676,0.011282,172.217.27.0-255,5738,121257,65,150343
31677,0.011289,172.31.40.0-255,66,121323,65,150343
31678,0.012959,172.217.27.0-255,5738,127061,65,150343
31679,0.012966,172.31.40.0-255,66,127127,65,150343
31680,0.014643,172.217.27.0-255,5738,132865,65,150343
31681,0.01465,172.31.40.0-255,66,132931,65,150343
31682,0.016309,172.217.27.0-255,5738,138669,65,150343
31683,0.016317,172.31.40.0-255,66,138735,65,150343
31684,0.017982,172.217.27.0-255,5738,144473,65,150343
31685,0.017989,172.31.40.0-255,66,144539,65,150343
31686,0.019649,172.217.27.0-255,5738,150277,65,150343
31687,0.019656,172.31.40.0-255,66,150343,65,150343
31688,0.0,172.217.194.0-255,154,154,65,111871
31689,1.9e-05,172.31.40.0-255,66,220,65,111871
31690,2.7e-05,172.217.194.0-255,1484,1704,65,111871
31691,3.2e-05,172.31.40.0-255,66,1770,65,111871
31692,4.5e-05,172.217.194.0-255,2902,4672,65,111871
31693,5e-05,172.31.40.0-255,66,4738,65,111871
31694,5.8e-05,172.217.194.0-255,5738,10476,65,111871
31695,6.1e-05,172.31.40.0-255,66,10542,65,111871
31696,0.000112,172.31.40.0-255,66,10608,65,111871
31697,0.000143,172.217.194.0-255,5738,16346,65,111871
31698,0.000145,172.31.40.0-255,66,16412,65,111871
31699,0.000172,172.217.194.0-255,3961,20373,65,111871
31700,0.000174,172.31.40.0-255,66,20439,65,111871
31701,0.00019,172.217.194.0-255,5738,26177,65,111871
31702,0.000196,172.31.40.0-255,66,26243,65,111871
31703,0.000223,172.217.194.0-255,2902,29145,65,111871
31704,0.000225,172.31.40.0-255,66,29211,65,111871
31705,0.000241,172.31.40.0-255,66,29277,65,111871
31706,0.000285,172.31.40.0-255,66,29343,65,111871
31707,0.000304,172.217.194.0-255,1125,30468,65,111871
31708,0.000307,172.31.40.0-255,66,30534,65,111871
31709,0.000309,172.217.194.0-255,342,30876,65,111871
31710,0.000312,172.31.40.0-255,66,30942,65,111871
31711,0.000341,172.217.194.0-255,117,31059,65,111871
31712,0.000343,172.31.40.0-255,66,31125,65,111871
31713,0.000486,172.217.194.0-255,380,31505,65,111871
31714,0.00049,172.31.40.0-255,66,31571,65,111871
31715,0.000819,172.217.194.0-255,1484,33055,65,111871
31716,0.000823,172.31.40.0-255,66,33121,65,111871
31717,0.000829,172.217.194.0-255,2902,36023,65,111871
31718,0.000831,172.31.40.0-255,66,36089,65,111871
31719,0.000869,172.217.194.0-255,5738,41827,65,111871
31720,0.000872,172.31.40.0-255,66,41893,65,111871
31721,0.000878,172.217.194.0-255,5738,47631,65,111871
31722,0.00088,172.31.40.0-255,66,47697,65,111871
31723,0.000915,172.217.194.0-255,7156,54853,65,111871
31724,0.000919,172.31.40.0-255,66,54919,65,111871
31725,0.000932,172.31.40.0-255,66,54985,65,111871
31726,0.000964,172.217.194.0-255,1484,56469,65,111871
31727,0.000969,172.217.194.0-255,1484,57953,65,111871
31728,0.000971,172.31.40.0-255,66,58019,65,111871
31729,0.000984,172.217.194.0-255,1484,59503,65,111871
31730,0.001011,172.217.194.0-255,5738,65241,65,111871
31731,0.001015,172.31.40.0-255,66,65307,65,111871
31732,0.001029,172.31.40.0-255,66,65373,65,111871
31733,0.001073,172.31.40.0-255,66,65439,65,111871
31734,0.003364,172.217.194.0-255,5738,71177,65,111871
31735,0.003373,172.31.40.0-255,66,71243,65,111871
31736,0.005605,172.217.194.0-255,5738,76981,65,111871
31737,0.005609,172.31.40.0-255,66,77047,65,111871
31738,0.007852,172.217.194.0-255,5738,82785,65,111871
31739,0.007858,172.31.40.0-255,66,82851,65,111871
31740,0.010128,172.217.194.0-255,5738,88589,65,111871
31741,0.010135,172.31.40.0-255,66,88655,65,111871
31742,0.012393,172.217.194.0-255,5738,94393,65,111871
31743,0.012402,172.31.40.0-255,66,94459,65,111871
31744,0.014683,172.217.194.0-255,5738,100197,65,111871
31745,0.01469,172.31.40.0-255,66,100263,65,111871
31746,0.016981,172.217.194.0-255,5738,106001,65,111871
31747,0.01699,172.31.40.0-255,66,106067,65,111871
31748,0.019242,172.217.194.0-255,5738,111805,65,111871
31749,0.019252,172.31.40.0-255,66,111871,65,111871
31750,0.0,74.125.200.0-255,151,151,65,160813
31751,1.5e-05,172.31.40.0-255,66,217,65,160813
31752,2e-05,74.125.200.0-255,1484,1701,65,160813
31753,2.4e-05,172.31.40.0-255,66,1767,65,160813
31754,5.1e-05,74.125.200.0-255,2902,4669,65,160813
31755,5.4e-05,172.31.40.0-255,66,4735,65,160813
31756,6.1e-05,74.125.200.0-255,5738,10473,65,160813
31757,6.4e-05,172.31.40.0-255,66,10539,65,160813
31758,8.8e-05,74.125.200.0-255,1484,12023,65,160813
31759,9.1e-05,172.31.40.0-255,66,12089,65,160813
31760,9.6e-05,74.125.200.0-255,1990,14079,65,160813
31761,9.8e-05,172.31.40.0-255,66,14145,65,160813
31762,0.000103,74.125.200.0-255,2902,17047,65,160813
31763,0.000105,172.31.40.0-255,66,17113,65,160813
31764,0.00011,74.125.200.0-255,4320,21433,65,160813
31765,0.000113,172.31.40.0-255,66,21499,65,160813
31766,0.000141,74.125.200.0-255,2902,24401,65,160813
31767,0.000144,172.31.40.0-255,66,24467,65,160813
31768,0.000147,74.125.200.0-255,1484,25951,65,160813
31769,0.000149,172.31.40.0-255,66,26017,65,160813
31770,0.000171,74.125.200.0-255,2902,28919,65,160813
31771,0.000174,172.31.40.0-255,66,28985,65,160813
31772,0.000201,74.125.200.0-255,2543,31528,65,160813
31773,0.000204,172.31.40.0-255,66,31594,65,160813
31774,0.000243,74.125.200.0-255,1484,33078,65,160813
31775,0.000247,172.31.40.0-255,66,33144,65,160813
31776,0.000259,74.125.200.0-255,1484,34628,65,160813
31777,0.000261,172.31.40.0-255,66,34694,65,160813
31778,0.000293,74.125.200.0-255,1484,36178,65,160813
31779,0.000296,172.31.40.0-255,66,36244,65,160813
31780,0.000301,74.125.200.0-255,2902,39146,65,160813
31781,0.000303,172.31.40.0-255,66,39212,65,160813
31782,0.000309,74.125.200.0-255,4320,43532,65,160813
31783,0.000311,172.31.40.0-255,66,43598,65,160813
31784,0.000322,172.31.40.0-255,66,43664,65,160813
31785,0.000347,74.125.200.0-255,1125,44789,65,160813
31786,0.000354,74.125.200.0-255,4320,49109,65,160813
31787,0.000356,172.31.40.0-255,66,49175,65,160813
31788,0.000383,74.125.200.0-255,5738,54913,65,160813
31789,0.000385,172.31.40.0-255,66,54979,65,160813
31790,0.000405,74.125.200.0-255,2857,57836,65,160813
31791,0.000408,172.31.40.0-255,66,57902,65,160813
31792,0.00041,74.125.200.0-255,372,58274,65,160813
31793,0.000505,74.125.200.0-255,1484,59758,65,160813
31794,0.000509,172.31.40.0-255,66,59824,65,160813
31795,0.000514,74.125.200.0-255,2902,62726,65,160813
31796,0.000516,172.31.40.0-255,66,62792,65,160813
31797,0.000522,74.125.200.0-255,4320,67112,65,160813
31798,0.000529,172.31.40.0-255,66,67178,65,160813
31799,0.000561,74.125.200.0-255,5738,72916,65,160813
31800,0.000564,172.31.40.0-255,66,72982,65,160813
31801,0.000603,172.31.40.0-255,66,73048,65,160813
31802,0.000638,74.125.200.0-255,6797,79845,65,160813
31803,0.000641,172.31.40.0-255,66,79911,65,160813
31804,0.001216,74.125.200.0-255,1484,81395,65,160813
31805,0.001246,74.125.200.0-255,1484,82879,65,160813
31806,0.00125,172.31.40.0-255,66,82945,65,160813
31807,0.001254,74.125.200.0-255,1484,84429,65,160813
31808,0.001278,74.125.200.0-255,1484,85913,65,160813
31809,0.001281,172.31.40.0-255,66,85979,65,160813
31810,0.001288,74.125.200.0-255,5738,91717,65,160813
31811,0.00129,172.31.40.0-255,66,91783,65,160813
31812,0.001329,74.125.200.0-255,7156,98939,65,160813
31813,0.001332,172.31.40.0-255,66,99005,65,160813
31814,0.001345,172.31.40.0-255,66,99071,65,160813
31815,0.001374,74.125.200.0-255,2902,101973,65,160813
31816,0.001376,172.31.40.0-255,66,102039,65,160813
31817,0.001382,74.125.200.0-255,3602,105641,65,160813
31818,0.001384,172.31.40.0-255,66,105707,65,160813
31819,0.002021,74.125.200.0-255,1484,107191,65,160813
31820,0.002031,74.125.200.0-255,2902,110093,65,160813
31821,0.002036,172.31.40.0-255,66,110159,65,160813
31822,0.002042,74.125.200.0-255,1484,111643,65,160813
31823,0.002065,74.125.200.0-255,1484,113127,65,160813
31824,0.002068,172.31.40.0-255,66,113193,65,160813
31825,0.002071,74.125.200.0-255,1484,114677,65,160813
31826,0.004061,74.125.200.0-255,1484,116161,65,160813
31827,0.004068,172.31.40.0-255,66,116227,65,160813
31828,0.004098,74.125.200.0-255,2902,119129,65,160813
31829,0.004101,172.31.40.0-255,66,119195,65,160813
31830,0.006093,74.125.200.0-255,2902,122097,65,160813
31831,0.006096,172.31.40.0-255,66,122163,65,160813
31832,0.006119,74.125.200.0-255,2902,125065,65,160813
31833,0.006122,172.31.40.0-255,66,125131,65,160813
31834,0.008129,74.125.200.0-255,2902,128033,65,160813
31835,0.008138,172.31.40.0-255,66,128099,65,160813
31836,0.008178,74.125.200.0-255,2902,131001,65,160813
31837,0.008181,172.31.40.0-255,66,131067,65,160813
31838,0.01017,74.125.200.0-255,2902,133969,65,160813
31839,0.010177,172.31.40.0-255,66,134035,65,160813
31840,0.01021,74.125.200.0-255,2902,136937,65,160813
31841,0.010213,172.31.40.0-255,66,137003,65,160813
31842,0.012219,74.125.200.0-255,2902,139905,65,160813
31843,0.012225,172.31.40.0-255,66,139971,65,160813
31844,0.012254,74.125.200.0-255,2902,142873,65,160813
31845,0.012258,172.31.40.0-255,66,142939,65,160813
31846,0.014246,74.125.200.0-255,2902,145841,65,160813
31847,0.014253,172.31.40.0-255,66,145907,65,160813
31848,0.014317,74.125.200.0-255,2902,148809,65,160813
31849,0.01432,172.31.40.0-255,66,148875,65,160813
31850,0.016276,74.125.200.0-255,2902,151777,65,160813
31851,0.016283,172.31.40.0-255,66,151843,65,160813
31852,0.016349,74.125.200.0-255,2902,154745,65,160813
31853,0.016353,172.31.40.0-255,66,154811,65,160813
31854,0.018311,74.125.200.0-255,2902,157713,65,160813
31855,0.018319,172.31.40.0-255,66,157779,65,160813
31856,0.018354,74.125.200.0-255,1484,159263,65,160813
31857,0.018372,74.125.200.0-255,1484,160747,65,160813
31858,0.018374,172.31.40.0-255,66,160813,65,160813
31859,0.0,172.217.24.0-255,153,153,65,254581
31860,2.6e-05,172.31.40.0-255,66,219,65,254581
31861,3.3e-05,172.217.24.0-255,1484,1703,65,254581
31862,3.7e-05,172.31.40.0-255,66,1769,65,254581
31863,4.2e-05,172.217.24.0-255,2902,4671,65,254581
31864,4.5e-05,172.31.40.0-255,66,4737,65,254581
31865,5.2e-05,172.217.24.0-255,7156,11893,65,254581
31866,5.4e-05,172.31.40.0-255,66,11959,65,254581
31867,6.6e-05,172.217.24.0-255,3456,15415,65,254581
31868,6.8e-05,172.31.40.0-255,66,15481,65,254581
31869,7.4e-05,172.217.24.0-255,4320,19801,65,254581
31870,7.6e-05,172.31.40.0-255,66,19867,65,254581
31871,8.8e-05,172.31.40.0-255,66,19933,65,254581
31872,9e-05,172.217.24.0-255,1125,21058,65,254581
31873,9.3e-05,172.31.40.0-255,66,21124,65,254581
31874,0.000194,172.217.24.0-255,1484,22608,65,254581
31875,0.000196,172.31.40.0-255,66,22674,65,254581
31876,0.0002,172.217.24.0-255,1484,24158,65,254581
31877,0.000202,172.31.40.0-255,66,24224,65,254581
31878,0.00023,172.217.24.0-255,1484,25708,65,254581
31879,0.000232,172.31.40.0-255,66,25774,65,254581
31880,0.000239,172.217.24.0-255,5738,31512,65,254581
31881,0.000244,172.31.40.0-255,66,31578,65,254581
31882,0.000251,172.217.24.0-255,6797,38375,65,254581
31883,0.000253,172.31.40.0-255,66,38441,65,254581
31884,0.000257,172.217.24.0-255,4320,42761,65,254581
31885,0.000259,172.31.40.0-255,66,42827,65,254581
31886,0.000289,172.217.24.0-255,2902,45729,65,254581
31887,0.000291,172.31.40.0-255,66,45795,65,254581
31888,0.000296,172.217.24.0-255,4320,50115,65,254581
31889,0.000297,172.31.40.0-255,66,50181,65,254581
31890,0.000325,172.217.24.0-255,5379,55560,65,254581
31891,0.000329,172.217.24.0-255,358,55918,65,254581
31892,0.000521,172.31.40.0-255,66,55984,65,254581
31893,0.000885,172.217.24.0-255,135,56119,65,254581
31894,0.000995,172.31.40.0-255,66,56185,65,254581
31895,0.001028,172.217.24.0-255,1484,57669,65,254581
31896,0.001034,172.217.24.0-255,2902,60571,65,254581
31897,0.001039,172.217.24.0-255,2902,63473,65,254581
31898,0.001051,172.217.24.0-255,2902,66375,65,254581
31899,0.00106,172.217.24.0-255,1484,67859,65,254581
31900,0.00108,172.217.24.0-255,7156,75015,65,254581
31901,0.001093,172.217.24.0-255,2543,77558,65,254581
31902,0.001098,172.217.24.0-255,4320,81878,65,254581
31903,0.001123,172.217.24.0-255,5738,87616,65,254581
31904,0.001137,172.31.40.0-255,66,87682,65,254581
31905,0.001149,172.217.24.0-255,2543,90225,65,254581
31906,0.001188,172.31.40.0-255,66,90291,65,254581
31907,0.001213,172.217.24.0-255,1484,91775,65,254581
31908,0.001218,172.217.24.0-255,2902,94677,65,254581
31909,0.001243,172.217.24.0-255,5738,100415,65,254581
31910,0.001248,172.217.24.0-255,4320,104735,65,254581
31911,0.001262,172.31.40.0-255,66,104801,65,254581
31912,0.001275,172.217.24.0-255,4320,109121,65,254581
31913,0.001291,172.217.24.0-255,1484,110605,65,254581
31914,0.001308,172.217.24.0-255,3602,114207,65,254581
31915,0.001316,172.31.40.0-255,66,114273,65,254581
31916,0.00135,172.217.24.0-255,2902,117175,65,254581
31917,0.001354,172.217.24.0-255,1484,118659,65,254581
31918,0.001368,172.217.24.0-255,2902,121561,65,254581
31919,0.001374,172.217.24.0-255,4320,125881,65,254581
31920,0.001378,172.31.40.0-255,66,125947,65,254581
31921,0.001398,172.217.24.0-255,4320,130267,65,254581
31922,0.001414,172.217.24.0-255,5738,136005,65,254581
31923,0.00142,172.31.40.0-255,66,136071,65,254581
31924,0.001459,172.217.24.0-255,3602,139673,65,254581
31925,0.001521,172.31.40.0-255,66,139739,65,254581
31926,0.001625,172.217.24.0-255,1484,141223,65,254581
31927,0.001631,172.217.24.0-255,2902,144125,65,254581
31928,0.00164,172.31.40.0-255,66,144191,65,254581
31929,0.001655,172.217.24.0-255,5738,149929,65,254581
31930,0.001661,172.217.24.0-255,2902,152831,65,254581
31931,0.00168,172.217.24.0-255,4320,157151,65,254581
31932,0.001688,172.31.40.0-255,66,157217,65,254581
31933,0.001725,172.217.24.0-255,2184,159401,65,254581
31934,0.001737,172.31.40.0-255,66,159467,65,254581
31935,0.001766,172.217.24.0-255,1484,160951,65,254581
31936,0.001771,172.217.24.0-255,2902,163853,65,254581
31937,0.001777,172.217.24.0-255,5738,169591,65,254581
31938,0.001786,172.31.40.0-255,66,169657,65,254581
31939,0.001798,172.217.24.0-255,7156,176813,65,254581
31940,0.001804,172.31.40.0-255,66,176879,65,254581
31941,0.001819,172.217.24.0-255,5738,182617,65,254581
31942,0.001825,172.217.24.0-255,7156,189773,65,254581
31943,0.00186,172.217.24.0-255,1484,191257,65,254581
31944,0.001864,172.31.40.0-255,66,191323,65,254581
31945,0.001875,172.217.24.0-255,2184,193507,65,254581
31946,0.001885,172.31.40.0-255,66,193573,65,254581
31947,0.001912,172.217.24.0-255,1484,195057,65,254581
31948,0.001929,172.217.24.0-255,2902,197959,65,254581
31949,0.001935,172.217.24.0-255,5738,203697,65,254581
31950,0.001956,172.31.40.0-255,66,203763,65,254581
31951,0.001961,172.217.24.0-255,4320,208083,65,254581
31952,0.001966,172.31.40.0-255,66,208149,65,254581
31953,0.00201,172.217.24.0-255,5738,213887,65,254581
31954,0.00202,172.31.40.0-255,66,213953,65,254581
31955,0.003974,172.217.24.0-255,5738,219691,65,254581
31956,0.003982,172.31.40.0-255,66,219757,65,254581
31957,0.00593,172.217.24.0-255,5738,225495,65,254581
31958,0.007966,172.31.40.0-255,66,225561,65,254581
31959,0.009903,172.217.24.0-255,5738,231299,65,254581
31960,0.009909,172.31.40.0-255,66,231365,65,254581
31961,0.01186,172.217.24.0-255,5738,237103,65,254581
31962,0.011867,172.31.40.0-255,66,237169,65,254581
31963,0.013824,172.217.24.0-255,5738,242907,65,254581
31964,0.015063,172.31.40.0-255,66,242973,65,254581
31965,0.017021,172.217.24.0-255,5738,248711,65,254581
31966,0.017031,172.31.40.0-255,66,248777,65,254581
31967,0.01898,172.217.24.0-255,5738,254515,65,254581
31968,0.018989,172.31.40.0-255,66,254581,65,254581
31969,0.0,74.125.68.0-255,156,156,65,188686
31970,2.2e-05,172.31.40.0-255,66,222,65,188686
31971,2.9e-05,74.125.68.0-255,1484,1706,65,188686
31972,3.3e-05,172.31.40.0-255,66,1772,65,188686
31973,4e-05,74.125.68.0-255,2902,4674,65,188686
31974,5.1e-05,172.31.40.0-255,66,4740,65,188686
31975,5.8e-05,74.125.68.0-255,5738,10478,65,188686
31976,6.1e-05,172.31.40.0-255,66,10544,65,188686
31977,6.7e-05,74.125.68.0-255,3461,14005,65,188686
31978,7e-05,172.31.40.0-255,66,14071,65,188686
31979,0.000112,74.125.68.0-255,2902,16973,65,188686
31980,0.000115,172.31.40.0-255,66,17039,65,188686
31981,0.000118,74.125.68.0-255,1484,18523,65,188686
31982,0.000125,172.31.40.0-255,66,18589,65,188686
31983,0.000157,74.125.68.0-255,2902,21491,65,188686
31984,0.000161,172.31.40.0-255,66,21557,65,188686
31985,0.000172,172.31.40.0-255,66,21623,65,188686
31986,0.000175,74.125.68.0-255,1125,22748,65,188686
31987,0.000177,172.31.40.0-255,66,22814,65,188686
31988,0.000741,74.125.68.0-255,1484,24298,65,188686
31989,0.000747,172.31.40.0-255,66,24364,65,188686
31990,0.000773,74.125.68.0-255,1484,25848,65,188686
31991,0.000775,172.31.40.0-255,66,25914,65,188686
31992,0.000808,74.125.68.0-255,2902,28816,65,188686
31993,0.000811,172.31.40.0-255,66,28882,65,188686
31994,0.000818,74.125.68.0-255,5738,34620,65,188686
31995,0.00082,172.31.40.0-255,66,34686,65,188686
31996,0.00083,74.125.68.0-255,2902,37588,65,188686
31997,0.000832,172.31.40.0-255,66,37654,65,188686
31998,0.000904,74.125.68.0-255,2543,40197,65,188686
31999,0.000907,172.31.40.0-255,66,40263,65,188686
32000,0.000976,74.125.68.0-255,1484,41747,65,188686
32001,0.000996,74.125.68.0-255,2902,44649,65,188686
32002,0.001,172.31.40.0-255,66,44715,65,188686
32003,0.001004,74.125.68.0-255,1484,46199,65,188686
32004,0.001032,74.125.68.0-255,2902,49101,65,188686
32005,0.001034,172.31.40.0-255,66,49167,65,188686
32006,0.001041,74.125.68.0-255,5738,54905,65,188686
32007,0.001044,172.31.40.0-255,66,54971,65,188686
32008,0.001074,74.125.68.0-255,2879,57850,65,188686
32009,0.001078,172.31.40.0-255,66,57916,65,188686
32010,0.001121,74.125.68.0-255,1484,59400,65,188686
32011,0.001133,74.125.68.0-255,1484,60884,65,188686
32012,0.001136,172.31.40.0-255,66,60950,65,188686
32013,0.001165,74.125.68.0-255,5738,66688,65,188686
32014,0.001169,172.31.40.0-255,78,66766,65,188686
32015,0.001173,74.125.68.0-255,2902,69668,65,188686
32016,0.001176,172.31.40.0-255,78,69746,65,188686
32017,0.001218,74.125.68.0-255,4215,73961,65,188686
32018,0.001221,172.31.40.0-255,78,74039,65,188686
32019,0.001299,74.125.68.0-255,1484,75523,65,188686
32020,0.001304,172.31.40.0-255,78,75601,65,188686
32021,0.001309,74.125.68.0-255,2902,78503,65,188686
32022,0.001311,172.31.40.0-255,78,78581,65,188686
32023,0.001342,74.125.68.0-255,4320,82901,65,188686
32024,0.001345,172.31.40.0-255,78,82979,65,188686
32025,0.001376,74.125.68.0-255,7156,90135,65,188686
32026,0.001379,172.31.40.0-255,78,90213,65,188686
32027,0.001405,74.125.68.0-255,1125,91338,65,188686
32028,0.001408,172.31.40.0-255,78,91416,65,188686
32029,0.001548,74.125.68.0-255,1484,92900,65,188686
32030,0.001553,172.31.40.0-255,78,92978,65,188686
32031,0.001559,74.125.68.0-255,2902,95880,65,188686
32032,0.001562,172.31.40.0-255,78,95958,65,188686
32033,0.001564,74.125.68.0-255,1484,97442,65,188686
32034,0.001567,172.31.40.0-255,78,97520,65,188686
32035,0.001599,74.125.68.0-255,2902,100422,65,188686
32036,0.001601,172.31.40.0-255,78,100500,65,188686
32037,0.001608,74.125.68.0-255,5738,106238,65,188686
32038,0.00161,172.31.40.0-255,78,106316,65,188686
32039,0.001625,172.31.40.0-255,78,106394,65,188686
32040,0.001638,74.125.68.0-255,2902,109296,65,188686
32041,0.001641,172.31.40.0-255,78,109374,65,188686
32042,0.001646,74.125.68.0-255,2902,112276,65,188686
32043,0.001648,172.31.40.0-255,78,112354,65,188686
32044,0.001678,74.125.68.0-255,1484,113838,65,188686
32045,0.001681,172.31.40.0-255,78,113916,65,188686
32046,0.001683,74.125.68.0-255,766,114682,65,188686
32047,0.001685,172.31.40.0-255,78,114760,65,188686
32048,0.001928,74.125.68.0-255,1484,116244,65,188686
32049,0.001935,172.31.40.0-255,78,116322,65,188686
32050,0.001941,74.125.68.0-255,2902,119224,65,188686
32051,0.001943,172.31.40.0-255,78,119302,65,188686
32052,0.002001,74.125.68.0-255,2902,122204,65,188686
32053,0.002005,172.31.40.0-255,78,122282,65,188686
32054,0.002009,74.125.68.0-255,1484,123766,65,188686
32055,0.002011,172.31.40.0-255,78,123844,65,188686
32056,0.002032,74.125.68.0-255,2902,126746,65,188686
32057,0.002035,172.31.40.0-255,78,126824,65,188686
32058,0.002039,74.125.68.0-255,2902,129726,65,188686
32059,0.002044,172.31.40.0-255,78,129804,65,188686
32060,0.00207,74.125.68.0-255,4320,134124,65,188686
32061,0.002073,172.31.40.0-255,78,134202,65,188686
32062,0.002088,74.125.68.0-255,4320,138522,65,188686
32063,0.002091,172.31.40.0-255,78,138600,65,188686
32064,0.002118,74.125.68.0-255,2902,141502,65,188686
32065,0.002121,172.31.40.0-255,78,141580,65,188686
32066,0.002145,74.125.68.0-255,1484,143064,65,188686
32067,0.002148,172.31.40.0-255,78,143142,65,188686
32068,0.002178,74.125.68.0-255,2902,146044,65,188686
32069,0.00218,172.31.40.0-255,78,146122,65,188686
32070,0.002183,74.125.68.0-255,1484,147606,65,188686
32071,0.002185,172.31.40.0-255,78,147684,65,188686
32072,0.002204,74.125.68.0-255,2184,149868,65,188686
32073,0.002206,172.31.40.0-255,78,149946,65,188686
32074,0.004461,74.125.68.0-255,1484,151430,65,188686
32075,0.004468,172.31.40.0-255,78,151508,65,188686
32076,0.004496,74.125.68.0-255,2902,154410,65,188686
32077,0.004499,172.31.40.0-255,78,154488,65,188686
32078,0.006741,74.125.68.0-255,1484,155972,65,188686
32079,0.006749,172.31.40.0-255,66,156038,65,188686
32080,0.006791,74.125.68.0-255,2902,158940,65,188686
32081,0.006795,172.31.40.0-255,66,159006,65,188686
32082,0.009037,74.125.68.0-255,2902,161908,65,188686
32083,0.009044,172.31.40.0-255,66,161974,65,188686
32084,0.009078,74.125.68.0-255,2902,164876,65,188686
32085,0.009081,172.31.40.0-255,66,164942,65,188686
32086,0.011332,74.125.68.0-255,2902,167844,65,188686
32087,0.01134,172.31.40.0-255,66,167910,65,188686
32088,0.01137,74.125.68.0-255,2902,170812,65,188686
32089,0.011373,172.31.40.0-255,66,170878,65,188686
32090,0.013621,74.125.68.0-255,2902,173780,65,188686
32091,0.013629,172.31.40.0-255,66,173846,65,188686
32092,0.013658,74.125.68.0-255,2902,176748,65,188686
32093,0.013661,172.31.40.0-255,66,176814,65,188686
32094,0.015937,74.125.68.0-255,2902,179716,65,188686
32095,0.015945,172.31.40.0-255,66,179782,65,188686
32096,0.016012,74.125.68.0-255,2902,182684,65,188686
32097,0.016016,172.31.40.0-255,66,182750,65,188686
32098,0.018225,74.125.68.0-255,2902,185652,65,188686
32099,0.018233,172.31.40.0-255,66,185718,65,188686
32100,0.018285,74.125.68.0-255,2902,188620,65,188686
32101,0.018288,172.31.40.0-255,66,188686,65,188686
32102,0.0,74.125.200.0-255,66,66,65,66
32103,0.0,172.217.194.0-255,152,152,65,195533
32104,2.2e-05,172.31.40.0-255,66,218,65,195533
32105,3e-05,172.217.194.0-255,1484,1702,65,195533
32106,3.5e-05,172.31.40.0-255,66,1768,65,195533
32107,4e-05,172.217.194.0-255,2902,4670,65,195533
32108,5e-05,172.31.40.0-255,66,4736,65,195533
32109,5.8e-05,172.217.194.0-255,7156,11892,65,195533
32110,6.1e-05,172.31.40.0-255,66,11958,65,195533
32111,6.5e-05,172.217.194.0-255,1992,13950,65,195533
32112,6.8e-05,172.31.40.0-255,66,14016,65,195533
32113,0.000104,172.31.40.0-255,66,14082,65,195533
32114,0.000128,172.217.194.0-255,2902,16984,65,195533
32115,0.000131,172.31.40.0-255,66,17050,65,195533
32116,0.000138,172.217.194.0-255,5379,22429,65,195533
32117,0.00014,172.31.40.0-255,66,22495,65,195533
32118,0.000234,172.217.194.0-255,1484,23979,65,195533
32119,0.000236,172.31.40.0-255,66,24045,65,195533
32120,0.000262,172.217.194.0-255,2902,26947,65,195533
32121,0.000265,172.31.40.0-255,66,27013,65,195533
32122,0.00027,172.217.194.0-255,5738,32751,65,195533
32123,0.000272,172.31.40.0-255,66,32817,65,195533
32124,0.0003,172.31.40.0-255,66,32883,65,195533
32125,0.000325,172.217.194.0-255,3961,36844,65,195533
32126,0.000328,172.31.40.0-255,66,36910,65,195533
32127,0.000337,172.31.40.0-255,66,36976,65,195533
32128,0.000358,172.217.194.0-255,1448,38424,65,195533
32129,0.000359,172.31.40.0-255,66,38490,65,195533
32130,0.000384,172.217.194.0-255,363,38853,65,195533
32131,0.000386,172.31.40.0-255,66,38919,65,195533
32132,0.000526,172.217.194.0-255,1484,40403,65,195533
32133,0.000532,172.217.194.0-255,2902,43305,65,195533
32134,0.000537,172.217.194.0-255,4320,47625,65,195533
32135,0.000541,172.31.40.0-255,66,47691,65,195533
32136,0.000549,172.217.194.0-255,1484,49175,65,195533
32137,0.000555,172.217.194.0-255,7156,56331,65,195533
32138,0.000576,172.217.194.0-255,5738,62069,65,195533
32139,0.000603,172.31.40.0-255,66,62135,65,195533
32140,0.000621,172.217.194.0-255,2184,64319,65,195533
32141,0.000632,172.31.40.0-255,66,64385,65,195533
32142,0.001047,172.217.194.0-255,1484,65869,65,195533
32143,0.001061,172.217.194.0-255,2902,68771,65,195533
32144,0.001064,172.31.40.0-255,66,68837,65,195533
32145,0.00107,172.217.194.0-255,4320,73157,65,195533
32146,0.001075,172.31.40.0-255,66,73223,65,195533
32147,0.001089,172.217.194.0-255,1484,74707,65,195533
32148,0.00116,172.217.194.0-255,766,75473,65,195533
32149,0.001169,172.31.40.0-255,66,75539,65,195533
32150,0.001351,172.217.194.0-255,1484,77023,65,195533
32151,0.001356,172.217.194.0-255,2902,79925,65,195533
32152,0.001359,172.31.40.0-255,66,79991,65,195533
32153,0.001387,172.217.194.0-255,5738,85729,65,195533
32154,0.001393,172.217.194.0-255,5738,91467,65,195533
32155,0.001398,172.31.40.0-255,66,91533,65,195533
32156,0.001415,172.217.194.0-255,7156,98689,65,195533
32157,0.001429,172.217.194.0-255,4320,103009,65,195533
32158,0.001438,172.31.40.0-255,66,103075,65,195533
32159,0.001448,172.217.194.0-255,6438,109513,65,195533
32160,0.001456,172.31.40.0-255,66,109579,65,195533
32161,0.001468,172.217.194.0-255,1484,111063,65,195533
32162,0.001487,172.217.194.0-255,2902,113965,65,195533
32163,0.001493,172.217.194.0-255,5738,119703,65,195533
32164,0.00151,172.217.194.0-255,4320,124023,65,195533
32165,0.001538,172.217.194.0-255,5738,129761,65,195533
32166,0.001546,172.31.40.0-255,66,129827,65,195533
32167,0.001549,172.217.194.0-255,2902,132729,65,195533
32168,0.001554,172.31.40.0-255,66,132795,65,195533
32169,0.001577,172.217.194.0-255,4320,137115,65,195533
32170,0.001584,172.31.40.0-255,66,137181,65,195533
32171,0.001611,172.217.194.0-255,3602,140783,65,195533
32172,0.001623,172.217.194.0-255,2902,143685,65,195533
32173,0.001627,172.31.40.0-255,66,143751,65,195533
32174,0.001657,172.217.194.0-255,766,144517,65,195533
32175,0.001663,172.31.40.0-255,66,144583,65,195533
32176,0.001708,172.31.40.0-255,66,144649,65,195533
32177,0.001729,172.217.194.0-255,7156,151805,65,195533
32178,0.001732,172.217.194.0-255,1484,153289,65,195533
32179,0.001735,172.217.194.0-255,1484,154773,65,195533
32180,0.001749,172.31.40.0-255,66,154839,65,195533
32181,0.001784,172.31.40.0-255,66,154905,65,195533
32182,0.003787,172.217.194.0-255,5738,160643,65,195533
32183,0.003795,172.31.40.0-255,66,160709,65,195533
32184,0.005809,172.217.194.0-255,5738,166447,65,195533
32185,0.008604,172.31.40.0-255,66,166513,65,195533
32186,0.010603,172.217.194.0-255,5738,172251,65,195533
32187,0.010612,172.31.40.0-255,66,172317,65,195533
32188,0.012616,172.217.194.0-255,5738,178055,65,195533
32189,0.012624,172.31.40.0-255,66,178121,65,195533
32190,0.014619,172.217.194.0-255,5738,183859,65,195533
32191,0.014629,172.31.40.0-255,66,183925,65,195533
32192,0.016621,172.217.194.0-255,5738,189663,65,195533
32193,0.016628,172.31.40.0-255,66,189729,65,195533
32194,0.018665,172.217.194.0-255,5738,195467,65,195533
32195,0.018671,172.31.40.0-255,66,195533,65,195533
32196,0.0,172.31.40.0-255,105,105,65,525
32197,0.00023,172.31.40.0-255,90,195,65,525
32198,0.000238,172.31.40.0-255,66,261,65,525
32199,0.002456,172.217.194.0-255,66,327,65,525
32200,0.002477,172.217.194.0-255,66,393,65,525
32201,0.00249,172.31.40.0-255,66,459,65,525
32202,0.002512,172.217.194.0-255,66,525,65,525
32203,0.0,74.125.130.0-255,153,153,65,194639
32204,2.3e-05,172.31.40.0-255,66,219,65,194639
32205,3e-05,74.125.130.0-255,1484,1703,65,194639
32206,3.5e-05,172.31.40.0-255,66,1769,65,194639
32207,4e-05,74.125.130.0-255,2902,4671,65,194639
32208,4.3e-05,172.31.40.0-255,66,4737,65,194639
32209,5.7e-05,74.125.130.0-255,5738,10475,65,194639
32210,6.1e-05,172.31.40.0-255,66,10541,65,194639
32211,6.5e-05,74.125.130.0-255,2902,13443,65,194639
32212,6.9e-05,172.31.40.0-255,66,13509,65,194639
32213,0.000102,74.125.130.0-255,612,14121,65,194639
32214,0.000105,172.31.40.0-255,66,14187,65,194639
32215,0.000131,74.125.130.0-255,1484,15671,65,194639
32216,0.000133,172.31.40.0-255,66,15737,65,194639
32217,0.000138,74.125.130.0-255,2902,18639,65,194639
32218,0.00014,172.31.40.0-255,66,18705,65,194639
32219,0.000175,74.125.130.0-255,4320,23025,65,194639
32220,0.000178,172.31.40.0-255,66,23091,65,194639
32221,0.000182,74.125.130.0-255,2902,25993,65,194639
32222,0.000184,172.31.40.0-255,66,26059,65,194639
32223,0.000204,74.125.130.0-255,2902,28961,65,194639
32224,0.000207,172.31.40.0-255,66,29027,65,194639
32225,0.00025,74.125.130.0-255,2543,31570,65,194639
32226,0.000253,172.31.40.0-255,66,31636,65,194639
32227,0.000358,74.125.130.0-255,1484,33120,65,194639
32228,0.000362,172.31.40.0-255,66,33186,65,194639
32229,0.000368,74.125.130.0-255,2902,36088,65,194639
32230,0.00037,172.31.40.0-255,66,36154,65,194639
32231,0.000415,74.125.130.0-255,2902,39056,65,194639
32232,0.000417,172.31.40.0-255,66,39122,65,194639
32233,0.000446,74.125.130.0-255,4320,43442,65,194639
32234,0.000449,172.31.40.0-255,66,43508,65,194639
32235,0.000476,74.125.130.0-255,4320,47828,65,194639
32236,0.000479,172.31.40.0-255,66,47894,65,194639
32237,0.000514,74.125.130.0-255,2543,50437,65,194639
32238,0.000517,172.31.40.0-255,66,50503,65,194639
32239,0.000524,74.125.130.0-255,7156,57659,65,194639
32240,0.000527,172.31.40.0-255,66,57725,65,194639
32241,0.000543,172.31.40.0-255,66,57791,65,194639
32242,0.000713,74.125.130.0-255,645,58436,65,194639
32243,0.000888,74.125.130.0-255,1484,59920,65,194639
32244,0.000893,172.31.40.0-255,66,59986,65,194639
32245,0.000897,74.125.130.0-255,1484,61470,65,194639
32246,0.000922,74.125.130.0-255,1484,62954,65,194639
32247,0.000925,172.31.40.0-255,66,63020,65,194639
32248,0.000932,74.125.130.0-255,5738,68758,65,194639
32249,0.000934,172.31.40.0-255,66,68824,65,194639
32250,0.000944,74.125.130.0-255,5738,74562,65,194639
32251,0.000946,172.31.40.0-255,66,74628,65,194639
32252,0.000954,74.125.130.0-255,7156,81784,65,194639
32253,0.000956,172.31.40.0-255,66,81850,65,194639
32254,0.001007,172.31.40.0-255,66,81916,65,194639
32255,0.001035,74.125.130.0-255,2184,84100,65,194639
32256,0.001038,172.31.40.0-255,66,84166,65,194639
32257,0.00104,74.125.130.0-255,1484,85650,65,194639
32258,0.001043,74.125.130.0-255,1484,87134,65,194639
32259,0.001045,172.31.40.0-255,66,87200,65,194639
32260,0.001065,74.125.130.0-255,1484,88684,65,194639
32261,0.001085,74.125.130.0-255,2902,91586,65,194639
32262,0.001087,172.31.40.0-255,66,91652,65,194639
32263,0.001113,74.125.130.0-255,1484,93136,65,194639
32264,0.001119,74.125.130.0-255,5738,98874,65,194639
32265,0.001122,172.31.40.0-255,66,98940,65,194639
32266,0.001157,74.125.130.0-255,1995,100935,65,194639
32267,0.001161,172.31.40.0-255,66,101001,65,194639
32268,0.00124,74.125.130.0-255,1484,102485,65,194639
32269,0.001259,74.125.130.0-255,2902,105387,65,194639
32270,0.001262,172.31.40.0-255,66,105453,65,194639
32271,0.001292,74.125.130.0-255,5738,111191,65,194639
32272,0.001295,172.31.40.0-255,66,111257,65,194639
32273,0.0013,74.125.130.0-255,2902,114159,65,194639
32274,0.001302,172.31.40.0-255,66,114225,65,194639
32275,0.001306,74.125.130.0-255,1484,115709,65,194639
32276,0.001337,74.125.130.0-255,2902,118611,65,194639
32277,0.00134,172.31.40.0-255,66,118677,65,194639
32278,0.001343,172.31.40.0-255,66,118743,65,194639
32279,0.001354,74.125.130.0-255,7156,125899,65,194639
32280,0.001362,172.31.40.0-255,66,125965,65,194639
32281,0.001365,74.125.130.0-255,766,126731,65,194639
32282,0.00158,74.125.130.0-255,1484,128215,65,194639
32283,0.001584,172.31.40.0-255,66,128281,65,194639
32284,0.00162,74.125.130.0-255,2902,131183,65,194639
32285,0.001623,172.31.40.0-255,66,131249,65,194639
32286,0.001627,74.125.130.0-255,2902,134151,65,194639
32287,0.001629,172.31.40.0-255,66,134217,65,194639
32288,0.001662,74.125.130.0-255,2902,137119,65,194639
32289,0.001665,172.31.40.0-255,66,137185,65,194639
32290,0.001677,172.31.40.0-255,66,137251,65,194639
32291,0.001688,74.125.130.0-255,5738,142989,65,194639
32292,0.00169,172.31.40.0-255,66,143055,65,194639
32293,0.001722,74.125.130.0-255,6438,149493,65,194639
32294,0.001725,172.31.40.0-255,66,149559,65,194639
32295,0.003791,74.125.130.0-255,4320,153879,65,194639
32296,0.003797,172.31.40.0-255,66,153945,65,194639
32297,0.003812,74.125.130.0-255,1484,155429,65,194639
32298,0.005876,74.125.130.0-255,4320,159749,65,194639
32299,0.005882,172.31.40.0-255,66,159815,65,194639
32300,0.00795,74.125.130.0-255,5738,165553,65,194639
32301,0.007957,172.31.40.0-255,66,165619,65,194639
32302,0.010029,74.125.130.0-255,5738,171357,65,194639
32303,0.010036,172.31.40.0-255,66,171423,65,194639
32304,0.012139,74.125.130.0-255,5738,177161,65,194639
32305,0.012146,172.31.40.0-255,66,177227,65,194639
32306,0.014222,74.125.130.0-255,5738,182965,65,194639
32307,0.01423,172.31.40.0-255,66,183031,65,194639
32308,0.016304,74.125.130.0-255,5738,188769,65,194639
32309,0.016312,172.31.40.0-255,66,188835,65,194639
32310,0.018376,74.125.130.0-255,5738,194573,65,194639
32311,0.018382,172.31.40.0-255,66,194639,65,194639
32312,0.0,172.217.194.0-255,153,153,65,228312
32313,2.2e-05,172.31.40.0-255,66,219,65,228312
32314,2.9e-05,172.217.194.0-255,1484,1703,65,228312
32315,3.4e-05,172.31.40.0-255,66,1769,65,228312
32316,4.1e-05,172.217.194.0-255,2902,4671,65,228312
32317,4.5e-05,172.31.40.0-255,66,4737,65,228312
32318,4.8e-05,172.217.194.0-255,1484,6221,65,228312
32319,5e-05,172.31.40.0-255,66,6287,65,228312
32320,5.4e-05,172.217.194.0-255,1484,7771,65,228312
32321,5.6e-05,172.31.40.0-255,66,7837,65,228312
32322,7.6e-05,172.217.194.0-255,1484,9321,65,228312
32323,7.8e-05,172.31.40.0-255,66,9387,65,228312
32324,8.9e-05,172.217.194.0-255,1484,10871,65,228312
32325,9.1e-05,172.31.40.0-255,66,10937,65,228312
32326,0.000109,172.217.194.0-255,3529,14466,65,228312
32327,0.000112,172.31.40.0-255,66,14532,65,228312
32328,0.000158,172.217.194.0-255,2902,17434,65,228312
32329,0.000161,172.31.40.0-255,66,17500,65,228312
32330,0.000167,172.217.194.0-255,4320,21820,65,228312
32331,0.000169,172.31.40.0-255,66,21886,65,228312
32332,0.000192,172.31.40.0-255,66,21952,65,228312
32333,0.000195,172.217.194.0-255,1125,23077,65,228312
32334,0.000197,172.31.40.0-255,66,23143,65,228312
32335,0.000297,172.217.194.0-255,1484,24627,65,228312
32336,0.000302,172.31.40.0-255,66,24693,65,228312
32337,0.000308,172.217.194.0-255,2902,27595,65,228312
32338,0.00031,172.31.40.0-255,66,27661,65,228312
32339,0.000313,172.217.194.0-255,1484,29145,65,228312
32340,0.000316,172.31.40.0-255,66,29211,65,228312
32341,0.000339,172.217.194.0-255,4320,33531,65,228312
32342,0.000342,172.31.40.0-255,66,33597,65,228312
32343,0.00037,172.217.194.0-255,6797,40394,65,228312
32344,0.000373,172.31.40.0-255,66,40460,65,228312
32345,0.000381,172.217.194.0-255,7156,47616,65,228312
32346,0.000383,172.31.40.0-255,66,47682,65,228312
32347,0.000412,172.31.40.0-255,66,47748,65,228312
32348,0.000511,172.217.194.0-255,647,48395,65,228312
32349,0.000623,172.217.194.0-255,1484,49879,65,228312
32350,0.000629,172.31.40.0-255,66,49945,65,228312
32351,0.000635,172.217.194.0-255,2902,52847,65,228312
32352,0.000637,172.31.40.0-255,66,52913,65,228312
32353,0.000644,172.217.194.0-255,5738,58651,65,228312
32354,0.000646,172.31.40.0-255,66,58717,65,228312
32355,0.000652,172.217.194.0-255,4320,63037,65,228312
32356,0.000655,172.31.40.0-255,66,63103,65,228312
32357,0.000678,172.217.194.0-255,2543,65646,65,228312
32358,0.000681,172.31.40.0-255,66,65712,65,228312
32359,0.00073,172.217.194.0-255,2902,68614,65,228312
32360,0.000734,172.31.40.0-255,66,68680,65,228312
32361,0.000766,172.31.40.0-255,66,68746,65,228312
32362,0.00077,172.217.194.0-255,1993,70739,65,228312
32363,0.000772,172.31.40.0-255,66,70805,65,228312
32364,0.001203,172.217.194.0-255,1484,72289,65,228312
32365,0.001209,172.217.194.0-255,2902,75191,65,228312
32366,0.001213,172.31.40.0-255,66,75257,65,228312
32367,0.001236,172.217.194.0-255,5738,80995,65,228312
32368,0.001239,172.31.40.0-255,66,81061,65,228312
32369,0.001243,172.217.194.0-255,1484,82545,65,228312
32370,0.001258,172.217.194.0-255,7156,89701,65,228312
32371,0.001261,172.31.40.0-255,66,89767,65,228312
32372,0.001289,172.217.194.0-255,4320,94087,65,228312
32373,0.001301,172.217.194.0-255,1484,95571,65,228312
32374,0.001304,172.31.40.0-255,66,95637,65,228312
32375,0.001311,172.31.40.0-255,66,95703,65,228312
32376,0.001317,172.217.194.0-255,2902,98605,65,228312
32377,0.00132,172.31.40.0-255,66,98671,65,228312
32378,0.001322,172.217.194.0-255,1484,100155,65,228312
32379,0.001338,172.217.194.0-255,4320,104475,65,228312
32380,0.00134,172.31.40.0-255,66,104541,65,228312
32381,0.001381,172.31.40.0-255,66,104607,65,228312
32382,0.001393,172.31.40.0-255,66,104673,65,228312
32383,0.001413,172.217.194.0-255,766,105439,65,228312
32384,0.001458,172.217.194.0-255,1484,106923,65,228312
32385,0.001461,172.31.40.0-255,66,106989,65,228312
32386,0.001484,172.217.194.0-255,2902,109891,65,228312
32387,0.001487,172.31.40.0-255,66,109957,65,228312
32388,0.001494,172.217.194.0-255,5738,115695,65,228312
32389,0.001497,172.31.40.0-255,66,115761,65,228312
32390,0.0015,172.217.194.0-255,1484,117245,65,228312
32391,0.001537,172.31.40.0-255,66,117311,65,228312
32392,0.001548,172.31.40.0-255,66,117377,65,228312
32393,0.001551,172.217.194.0-255,766,118143,65,228312
32394,0.001862,172.217.194.0-255,1484,119627,65,228312
32395,0.001867,172.217.194.0-255,2902,122529,65,228312
32396,0.001875,172.31.40.0-255,101,122630,65,228312
32397,0.001884,172.217.194.0-255,2902,125532,65,228312
32398,0.001894,172.31.40.0-255,66,125598,65,228312
32399,0.001898,172.31.40.0-255,66,125664,65,228312
32400,0.001903,172.217.194.0-255,2902,128566,65,228312
32401,0.001905,172.31.40.0-255,66,128632,65,228312
32402,0.001913,172.217.194.0-255,7156,135788,65,228312
32403,0.001915,172.31.40.0-255,66,135854,65,228312
32404,0.001926,172.31.40.0-255,66,135920,65,228312
32405,0.00195,172.217.194.0-255,5738,141658,65,228312
32406,0.001954,172.217.194.0-255,2184,143842,65,228312
32407,0.001957,172.31.40.0-255,66,143908,65,228312
32408,0.00196,172.31.40.0-255,66,143974,65,228312
32409,0.002003,172.217.194.0-255,1484,145458,65,228312
32410,0.002008,172.217.194.0-255,1484,146942,65,228312
32411,0.00201,172.31.40.0-255,66,147008,65,228312
32412,0.002027,172.217.194.0-255,1484,148492,65,228312
32413,0.002034,172.217.194.0-255,5738,154230,65,228312
32414,0.002037,172.31.40.0-255,66,154296,65,228312
32415,0.00208,172.217.194.0-255,2902,157198,65,228312
32416,0.002082,172.31.40.0-255,66,157264,65,228312
32417,0.002121,172.217.194.0-255,7156,164420,65,228312
32418,0.002127,172.31.40.0-255,66,164486,65,228312
32419,0.002153,172.217.194.0-255,1484,165970,65,228312
32420,0.002157,172.217.194.0-255,2902,168872,65,228312
32421,0.002171,172.217.194.0-255,2902,171774,65,228312
32422,0.002194,172.217.194.0-255,2902,174676,65,228312
32423,0.0022,172.217.194.0-255,5738,180414,65,228312
32424,0.002215,172.217.194.0-255,4320,184734,65,228312
32425,0.002227,172.217.194.0-255,2902,187636,65,228312
32426,0.002254,172.217.194.0-255,766,188402,65,228312
32427,0.002256,172.217.194.0-255,1484,189886,65,228312
32428,0.002261,172.217.194.0-255,4320,194206,65,228312
32429,0.002323,172.217.194.0-255,2902,197108,65,228312
32430,0.002393,172.217.194.0-255,7156,204264,65,228312
32431,0.002416,172.217.194.0-255,6438,210702,65,228312
32432,0.004188,172.217.194.0-255,66,210768,65,228312
32433,0.011081,172.31.40.0-255,66,210834,65,228312
32434,0.011591,172.217.194.0-255,1484,212318,65,228312
32435,0.013401,172.217.194.0-255,4320,216638,65,228312
32436,0.013408,172.31.40.0-255,66,216704,65,228312
32437,0.015732,172.217.194.0-255,5738,222442,65,228312
32438,0.015749,172.31.40.0-255,66,222508,65,228312
32439,0.018103,172.217.194.0-255,5738,228246,65,228312
32440,0.018111,172.31.40.0-255,66,228312,65,228312
32441,0.0,172.31.40.0-255,105,105,65,276
32442,0.001754,157.240.24.0-255,105,210,65,276
32443,0.001768,172.31.40.0-255,66,276,65,276
32444,0.0,74.125.68.0-255,298,298,65,119830
32445,1.8e-05,172.31.40.0-255,66,364,65,119830
32446,2.4e-05,74.125.68.0-255,1484,1848,65,119830
32447,2.8e-05,172.31.40.0-255,66,1914,65,119830
32448,3.4e-05,74.125.68.0-255,2902,4816,65,119830
32449,3.7e-05,172.31.40.0-255,66,4882,65,119830
32450,5e-05,74.125.68.0-255,5738,10620,65,119830
32451,5.3e-05,172.31.40.0-255,66,10686,65,119830
32452,9.2e-05,74.125.68.0-255,3221,13907,65,119830
32453,9.4e-05,172.31.40.0-255,66,13973,65,119830
32454,0.000328,74.125.68.0-255,1484,15457,65,119830
32455,0.000333,172.31.40.0-255,66,15523,65,119830
32456,0.000338,74.125.68.0-255,2902,18425,65,119830
32457,0.000341,172.31.40.0-255,66,18491,65,119830
32458,0.000356,74.125.68.0-255,1484,19975,65,119830
32459,0.000358,172.31.40.0-255,66,20041,65,119830
32460,0.000375,74.125.68.0-255,4320,24361,65,119830
32461,0.000377,172.31.40.0-255,66,24427,65,119830
32462,0.000381,74.125.68.0-255,2902,27329,65,119830
32463,0.000383,172.31.40.0-255,66,27395,65,119830
32464,0.000388,74.125.68.0-255,3961,31356,65,119830
32465,0.00039,172.31.40.0-255,66,31422,65,119830
32466,0.000443,172.31.40.0-255,66,31488,65,119830
32467,0.000478,172.31.40.0-255,66,31554,65,119830
32468,0.000482,74.125.68.0-255,2902,34456,65,119830
32469,0.000484,172.31.40.0-255,66,34522,65,119830
32470,0.000522,172.31.40.0-255,66,34588,65,119830
32471,0.000527,74.125.68.0-255,3936,38524,65,119830
32472,0.000529,172.31.40.0-255,66,38590,65,119830
32473,0.001237,74.125.68.0-255,108,38698,65,119830
32474,0.001439,74.125.68.0-255,1484,40182,65,119830
32475,0.001444,172.31.40.0-255,66,40248,65,119830
32476,0.001451,74.125.68.0-255,2902,43150,65,119830
32477,0.001452,172.31.40.0-255,66,43216,65,119830
32478,0.001486,74.125.68.0-255,2902,46118,65,119830
32479,0.001488,172.31.40.0-255,66,46184,65,119830
32480,0.001494,74.125.68.0-255,4320,50504,65,119830
32481,0.001496,172.31.40.0-255,66,50570,65,119830
32482,0.001499,74.125.68.0-255,1484,52054,65,119830
32483,0.001522,74.125.68.0-255,7156,59210,65,119830
32484,0.001524,172.31.40.0-255,66,59276,65,119830
32485,0.00153,74.125.68.0-255,4320,63596,65,119830
32486,0.001532,172.31.40.0-255,66,63662,65,119830
32487,0.001538,74.125.68.0-255,5738,69400,65,119830
32488,0.00154,172.31.40.0-255,66,69466,65,119830
32489,0.001567,74.125.68.0-255,3602,73068,65,119830
32490,0.00157,172.31.40.0-255,66,73134,65,119830
32491,0.003645,74.125.68.0-255,5738,78872,65,119830
32492,0.003652,172.31.40.0-255,66,78938,65,119830
32493,0.005715,74.125.68.0-255,5738,84676,65,119830
32494,0.005722,172.31.40.0-255,66,84742,65,119830
32495,0.00779,74.125.68.0-255,2902,87644,65,119830
32496,0.007796,172.31.40.0-255,66,87710,65,119830
32497,0.007827,74.125.68.0-255,2902,90612,65,119830
32498,0.00783,172.31.40.0-255,66,90678,65,119830
32499,0.009868,74.125.68.0-255,2902,93580,65,119830
32500,0.009877,172.31.40.0-255,66,93646,65,119830
32501,0.009911,74.125.68.0-255,2902,96548,65,119830
32502,0.009914,172.31.40.0-255,66,96614,65,119830
32503,0.011975,74.125.68.0-255,5738,102352,65,119830
32504,0.011983,172.31.40.0-255,66,102418,65,119830
32505,0.014054,74.125.68.0-255,5738,108156,65,119830
32506,0.014065,172.31.40.0-255,66,108222,65,119830
32507,0.016127,74.125.68.0-255,5738,113960,65,119830
32508,0.016138,172.31.40.0-255,66,114026,65,119830
32509,0.0182,74.125.68.0-255,5738,119764,65,119830
32510,0.018208,172.31.40.0-255,66,119830,65,119830
32511,0.0,172.217.27.0-255,296,296,65,114604
32512,1.3e-05,172.31.40.0-255,66,362,65,114604
32513,1.8e-05,172.217.27.0-255,1484,1846,65,114604
32514,2.2e-05,172.31.40.0-255,66,1912,65,114604
32515,2.7e-05,172.217.27.0-255,2902,4814,65,114604
32516,2.9e-05,172.31.40.0-255,66,4880,65,114604
32517,5.2e-05,172.217.27.0-255,1484,6364,65,114604
32518,5.4e-05,172.31.40.0-255,66,6430,65,114604
32519,6.8e-05,172.31.40.0-255,66,6496,65,114604
32520,0.000137,172.217.27.0-255,1484,7980,65,114604
32521,0.00014,172.31.40.0-255,66,8046,65,114604
32522,0.000143,172.217.27.0-255,1484,9530,65,114604
32523,0.000144,172.31.40.0-255,66,9596,65,114604
32524,0.00018,172.217.27.0-255,2902,12498,65,114604
32525,0.000183,172.31.40.0-255,66,12564,65,114604
32526,0.000188,172.217.27.0-255,5738,18302,65,114604
32527,0.00019,172.31.40.0-255,66,18368,65,114604
32528,0.000218,172.217.27.0-255,5379,23747,65,114604
32529,0.000221,172.31.40.0-255,66,23813,65,114604
32530,0.000251,172.217.27.0-255,5738,29551,65,114604
32531,0.000253,172.31.40.0-255,66,29617,65,114604
32532,0.000257,172.217.27.0-255,2902,32519,65,114604
32533,0.000258,172.31.40.0-255,66,32585,65,114604
32534,0.000291,172.31.40.0-255,66,32651,65,114604
32535,0.001565,172.217.27.0-255,1484,34135,65,114604
32536,0.001573,172.31.40.0-255,66,34201,65,114604
32537,0.001581,172.217.27.0-255,2902,37103,65,114604
32538,0.001584,172.31.40.0-255,66,37169,65,114604
32539,0.001598,172.217.27.0-255,5738,42907,65,114604
32540,0.0016,172.31.40.0-255,66,42973,65,114604
32541,0.001649,172.217.27.0-255,4320,47293,65,114604
32542,0.001652,172.31.40.0-255,66,47359,65,114604
32543,0.00168,172.217.27.0-255,2543,49902,65,114604
32544,0.001682,172.31.40.0-255,66,49968,65,114604
32545,0.003304,172.217.27.0-255,2902,52870,65,114604
32546,0.003309,172.31.40.0-255,66,52936,65,114604
32547,0.003335,172.217.27.0-255,2902,55838,65,114604
32548,0.003337,172.31.40.0-255,66,55904,65,114604
32549,0.004959,172.217.27.0-255,2902,58806,65,114604
32550,0.004961,172.31.40.0-255,66,58872,65,114604
32551,0.004989,172.217.27.0-255,2902,61774,65,114604
32552,0.004991,172.31.40.0-255,66,61840,65,114604
32553,0.006613,172.217.27.0-255,2902,64742,65,114604
32554,0.006619,172.31.40.0-255,66,64808,65,114604
32555,0.00665,172.217.27.0-255,2902,67710,65,114604
32556,0.006652,172.31.40.0-255,66,67776,65,114604
32557,0.008269,172.217.27.0-255,2902,70678,65,114604
32558,0.008275,172.31.40.0-255,66,70744,65,114604
32559,0.00831,172.217.27.0-255,2902,73646,65,114604
32560,0.008312,172.31.40.0-255,66,73712,65,114604
32561,0.009933,172.217.27.0-255,2902,76614,65,114604
32562,0.00994,172.31.40.0-255,66,76680,65,114604
32563,0.009967,172.217.27.0-255,2902,79582,65,114604
32564,0.00997,172.31.40.0-255,66,79648,65,114604
32565,0.011598,172.217.27.0-255,2902,82550,65,114604
32566,0.011605,172.31.40.0-255,66,82616,65,114604
32567,0.011624,172.217.27.0-255,2902,85518,65,114604
32568,0.011626,172.31.40.0-255,66,85584,65,114604
32569,0.013277,172.217.27.0-255,5738,91322,65,114604
32570,0.013284,172.31.40.0-255,66,91388,65,114604
32571,0.01496,172.217.27.0-255,5738,97126,65,114604
32572,0.014966,172.31.40.0-255,66,97192,65,114604
32573,0.016625,172.217.27.0-255,5738,102930,65,114604
32574,0.016632,172.31.40.0-255,66,102996,65,114604
32575,0.018301,172.217.27.0-255,5738,108734,65,114604
32576,0.018309,172.31.40.0-255,66,108800,65,114604
32577,0.019969,172.217.27.0-255,5738,114538,65,114604
32578,0.019976,172.31.40.0-255,66,114604,65,114604
32579,0.0,74.125.130.0-255,150,150,65,192099
32580,2.3e-05,172.31.40.0-255,66,216,65,192099
32581,3.1e-05,74.125.130.0-255,1484,1700,65,192099
32582,3.6e-05,172.31.40.0-255,66,1766,65,192099
32583,4.9e-05,74.125.130.0-255,2902,4668,65,192099
32584,5.3e-05,172.31.40.0-255,66,4734,65,192099
32585,5.9e-05,74.125.130.0-255,4320,9054,65,192099
32586,6.2e-05,172.31.40.0-255,66,9120,65,192099
32587,9.6e-05,74.125.130.0-255,4876,13996,65,192099
32588,9.9e-05,172.31.40.0-255,66,14062,65,192099
32589,0.000121,74.125.130.0-255,5738,19800,65,192099
32590,0.000124,172.31.40.0-255,66,19866,65,192099
32591,0.000154,74.125.130.0-255,7156,27022,65,192099
32592,0.000157,172.31.40.0-255,66,27088,65,192099
32593,0.000187,74.125.130.0-255,3961,31049,65,192099
32594,0.000189,172.31.40.0-255,66,31115,65,192099
32595,0.000361,74.125.130.0-255,1484,32599,65,192099
32596,0.000366,172.31.40.0-255,66,32665,65,192099
32597,0.000371,74.125.130.0-255,2902,35567,65,192099
32598,0.000374,172.31.40.0-255,66,35633,65,192099
32599,0.000405,74.125.130.0-255,2902,38535,65,192099
32600,0.000408,172.31.40.0-255,66,38601,65,192099
32601,0.000414,74.125.130.0-255,4320,42921,65,192099
32602,0.000416,172.31.40.0-255,66,42987,65,192099
32603,0.000461,172.31.40.0-255,66,43053,65,192099
32604,0.000472,172.31.40.0-255,66,43119,65,192099
32605,0.000487,74.125.130.0-255,1484,44603,65,192099
32606,0.000489,172.31.40.0-255,66,44669,65,192099
32607,0.000498,74.125.130.0-255,2796,47465,65,192099
32608,0.000501,172.31.40.0-255,66,47531,65,192099
32609,0.000504,74.125.130.0-255,118,47649,65,192099
32610,0.000858,74.125.130.0-255,382,48031,65,192099
32611,0.001047,74.125.130.0-255,1484,49515,65,192099
32612,0.001052,172.31.40.0-255,66,49581,65,192099
32613,0.001058,74.125.130.0-255,2902,52483,65,192099
32614,0.00106,172.31.40.0-255,66,52549,65,192099
32615,0.001089,74.125.130.0-255,5738,58287,65,192099
32616,0.001091,172.31.40.0-255,66,58353,65,192099
32617,0.001095,74.125.130.0-255,1484,59837,65,192099
32618,0.0011,74.125.130.0-255,2902,62739,65,192099
32619,0.001102,172.31.40.0-255,66,62805,65,192099
32620,0.001145,74.125.130.0-255,2543,65348,65,192099
32621,0.001148,172.31.40.0-255,66,65414,65,192099
32622,0.001154,74.125.130.0-255,2902,68316,65,192099
32623,0.001156,172.31.40.0-255,66,68382,65,192099
32624,0.001198,74.125.130.0-255,7156,75538,65,192099
32625,0.001201,172.31.40.0-255,66,75604,65,192099
32626,0.001208,74.125.130.0-255,6797,82401,65,192099
32627,0.00121,172.31.40.0-255,66,82467,65,192099
32628,0.001467,74.125.130.0-255,1484,83951,65,192099
32629,0.001485,74.125.130.0-255,2902,86853,65,192099
32630,0.001488,172.31.40.0-255,66,86919,65,192099
32631,0.001496,74.125.130.0-255,5738,92657,65,192099
32632,0.001498,172.31.40.0-255,66,92723,65,192099
32633,0.001502,74.125.130.0-255,2902,95625,65,192099
32634,0.001509,172.31.40.0-255,66,95691,65,192099
32635,0.001554,172.31.40.0-255,66,95757,65,192099
32636,0.001561,74.125.130.0-255,7156,102913,65,192099
32637,0.001563,172.31.40.0-255,66,102979,65,192099
32638,0.001586,74.125.130.0-255,2902,105881,65,192099
32639,0.001588,172.31.40.0-255,66,105947,65,192099
32640,0.001595,74.125.130.0-255,766,106713,65,192099
32641,0.001729,74.125.130.0-255,1484,108197,65,192099
32642,0.001733,172.31.40.0-255,66,108263,65,192099
32643,0.001738,74.125.130.0-255,2902,111165,65,192099
32644,0.00174,172.31.40.0-255,66,111231,65,192099
32645,0.00176,74.125.130.0-255,2902,114133,65,192099
32646,0.001763,172.31.40.0-255,66,114199,65,192099
32647,0.001768,74.125.130.0-255,4320,118519,65,192099
32648,0.001775,172.31.40.0-255,66,118585,65,192099
32649,0.001789,74.125.130.0-255,4320,122905,65,192099
32650,0.001791,172.31.40.0-255,66,122971,65,192099
32651,0.001816,74.125.130.0-255,4320,127291,65,192099
32652,0.001819,172.31.40.0-255,66,127357,65,192099
32653,0.001826,74.125.130.0-255,5738,133095,65,192099
32654,0.001828,172.31.40.0-255,66,133161,65,192099
32655,0.00184,74.125.130.0-255,7156,140317,65,192099
32656,0.001842,172.31.40.0-255,66,140383,65,192099
32657,0.001845,74.125.130.0-255,766,141149,65,192099
32658,0.002246,172.31.40.0-255,66,141215,65,192099
32659,0.003798,74.125.130.0-255,4320,145535,65,192099
32660,0.003805,172.31.40.0-255,66,145601,65,192099
32661,0.004201,74.125.130.0-255,1484,147085,65,192099
32662,0.005764,74.125.130.0-255,4320,151405,65,192099
32663,0.005769,172.31.40.0-255,66,151471,65,192099
32664,0.007731,74.125.130.0-255,5738,157209,65,192099
32665,0.007736,172.31.40.0-255,66,157275,65,192099
32666,0.009694,74.125.130.0-255,5738,163013,65,192099
32667,0.009701,172.31.40.0-255,66,163079,65,192099
32668,0.011664,74.125.130.0-255,5738,168817,65,192099
32669,0.011671,172.31.40.0-255,66,168883,65,192099
32670,0.013643,74.125.130.0-255,5738,174621,65,192099
32671,0.013651,172.31.40.0-255,66,174687,65,192099
32672,0.015612,74.125.130.0-255,5738,180425,65,192099
32673,0.01562,172.31.40.0-255,66,180491,65,192099
32674,0.017591,74.125.130.0-255,5738,186229,65,192099
32675,0.017598,172.31.40.0-255,66,186295,65,192099
32676,0.019566,74.125.130.0-255,5738,192033,65,192099
32677,0.019576,172.31.40.0-255,66,192099,65,192099
32678,0.0,74.125.68.0-255,150,150,65,225711
32679,2.4e-05,172.31.40.0-255,66,216,65,225711
32680,3.2e-05,74.125.68.0-255,1484,1700,65,225711
32681,3.6e-05,172.31.40.0-255,66,1766,65,225711
32682,4.2e-05,74.125.68.0-255,2902,4668,65,225711
32683,4.6e-05,172.31.40.0-255,66,4734,65,225711
32684,5.2e-05,74.125.68.0-255,4320,9054,65,225711
32685,5.6e-05,172.31.40.0-255,66,9120,65,225711
32686,6.2e-05,74.125.68.0-255,4847,13967,65,225711
32687,6.5e-05,172.31.40.0-255,66,14033,65,225711
32688,7.2e-05,74.125.68.0-255,7156,21189,65,225711
32689,7.5e-05,172.31.40.0-255,66,21255,65,225711
32690,8e-05,74.125.68.0-255,2902,24157,65,225711
32691,8.2e-05,172.31.40.0-255,66,24223,65,225711
32692,0.000115,74.125.68.0-255,5738,29961,65,225711
32693,0.000118,172.31.40.0-255,66,30027,65,225711
32694,0.000121,74.125.68.0-255,1125,31152,65,225711
32695,0.000123,172.31.40.0-255,66,31218,65,225711
32696,0.000393,74.125.68.0-255,1484,32702,65,225711
32697,0.000398,172.31.40.0-255,66,32768,65,225711
32698,0.000404,74.125.68.0-255,2902,35670,65,225711
32699,0.000407,172.31.40.0-255,66,35736,65,225711
32700,0.000413,74.125.68.0-255,5738,41474,65,225711
32701,0.000416,172.31.40.0-255,66,41540,65,225711
32702,0.000461,74.125.68.0-255,6797,48337,65,225711
32703,0.000464,172.31.40.0-255,66,48403,65,225711
32704,0.00047,74.125.68.0-255,5738,54141,65,225711
32705,0.000472,172.31.40.0-255,66,54207,65,225711
32706,0.000501,74.125.68.0-255,5738,59945,65,225711
32707,0.000504,172.31.40.0-255,66,60011,65,225711
32708,0.000545,74.125.68.0-255,2902,62913,65,225711
32709,0.00055,172.31.40.0-255,66,62979,65,225711
32710,0.000566,74.125.68.0-255,2890,65869,65,225711
32711,0.000568,172.31.40.0-255,66,65935,65,225711
32712,0.000727,74.125.68.0-255,332,66267,65,225711
32713,0.000894,74.125.68.0-255,1484,67751,65,225711
32714,0.000899,172.31.40.0-255,66,67817,65,225711
32715,0.000905,74.125.68.0-255,2902,70719,65,225711
32716,0.000907,172.31.40.0-255,66,70785,65,225711
32717,0.00091,74.125.68.0-255,1484,72269,65,225711
32718,0.000936,74.125.68.0-255,2902,75171,65,225711
32719,0.000939,172.31.40.0-255,66,75237,65,225711
32720,0.000943,74.125.68.0-255,2902,78139,65,225711
32721,0.000945,172.31.40.0-255,66,78205,65,225711
32722,0.000958,74.125.68.0-255,2902,81107,65,225711
32723,0.000961,172.31.40.0-255,66,81173,65,225711
32724,0.000986,74.125.68.0-255,2543,83716,65,225711
32725,0.000988,172.31.40.0-255,66,83782,65,225711
32726,0.001087,74.125.68.0-255,1484,85266,65,225711
32727,0.001091,74.125.68.0-255,1484,86750,65,225711
32728,0.001094,172.31.40.0-255,66,86816,65,225711
32729,0.001106,74.125.68.0-255,1484,88300,65,225711
32730,0.001114,74.125.68.0-255,5738,94038,65,225711
32731,0.001116,172.31.40.0-255,66,94104,65,225711
32732,0.00112,74.125.68.0-255,2902,97006,65,225711
32733,0.001122,172.31.40.0-255,66,97072,65,225711
32734,0.001148,74.125.68.0-255,3961,101033,65,225711
32735,0.00115,172.31.40.0-255,66,101099,65,225711
32736,0.001818,74.125.68.0-255,1484,102583,65,225711
32737,0.001828,74.125.68.0-255,2902,105485,65,225711
32738,0.001832,172.31.40.0-255,66,105551,65,225711
32739,0.001838,74.125.68.0-255,2902,108453,65,225711
32740,0.00184,172.31.40.0-255,66,108519,65,225711
32741,0.001859,74.125.68.0-255,2902,111421,65,225711
32742,0.001861,172.31.40.0-255,66,111487,65,225711
32743,0.001866,74.125.68.0-255,2902,114389,65,225711
32744,0.001868,172.31.40.0-255,66,114455,65,225711
32745,0.001873,74.125.68.0-255,4320,118775,65,225711
32746,0.001875,172.31.40.0-255,66,118841,65,225711
32747,0.001896,74.125.68.0-255,2902,121743,65,225711
32748,0.001899,172.31.40.0-255,66,121809,65,225711
32749,0.001921,74.125.68.0-255,5738,127547,65,225711
32750,0.001924,172.31.40.0-255,66,127613,65,225711
32751,0.001938,74.125.68.0-255,2902,130515,65,225711
32752,0.001941,172.31.40.0-255,66,130581,65,225711
32753,0.001958,74.125.68.0-255,2902,133483,65,225711
32754,0.00196,172.31.40.0-255,66,133549,65,225711
32755,0.001965,74.125.68.0-255,2184,135733,65,225711
32756,0.001967,172.31.40.0-255,66,135799,65,225711
32757,0.002032,74.125.68.0-255,1484,137283,65,225711
32758,0.002037,74.125.68.0-255,1484,138767,65,225711
32759,0.00204,172.31.40.0-255,66,138833,65,225711
32760,0.002059,74.125.68.0-255,1484,140317,65,225711
32761,0.002062,74.125.68.0-255,1484,141801,65,225711
32762,0.002065,172.31.40.0-255,66,141867,65,225711
32763,0.002071,74.125.68.0-255,4320,146187,65,225711
32764,0.002073,172.31.40.0-255,66,146253,65,225711
32765,0.002084,74.125.68.0-255,1484,147737,65,225711
32766,0.0021,74.125.68.0-255,5738,153475,65,225711
32767,0.002103,172.31.40.0-255,66,153541,65,225711
32768,0.002128,74.125.68.0-255,7156,160697,65,225711
32769,0.002131,172.31.40.0-255,66,160763,65,225711
32770,0.002137,74.125.68.0-255,4320,165083,65,225711
32771,0.002139,172.31.40.0-255,66,165149,65,225711
32772,0.002171,74.125.68.0-255,5020,170169,65,225711
32773,0.002175,172.31.40.0-255,66,170235,65,225711
32774,0.002257,74.125.68.0-255,5738,175973,65,225711
32775,0.002262,172.31.40.0-255,66,176039,65,225711
32776,0.002265,74.125.68.0-255,1484,177523,65,225711
32777,0.002276,172.31.40.0-255,66,177589,65,225711
32778,0.002288,172.31.40.0-255,66,177655,65,225711
32779,0.002304,74.125.68.0-255,2902,180557,65,225711
32780,0.002306,172.31.40.0-255,66,180623,65,225711
32781,0.002318,74.125.68.0-255,2902,183525,65,225711
32782,0.00232,172.31.40.0-255,66,183591,65,225711
32783,0.002342,74.125.68.0-255,2184,185775,65,225711
32784,0.002345,172.31.40.0-255,66,185841,65,225711
32785,0.004648,74.125.68.0-255,2902,188743,65,225711
32786,0.004656,172.31.40.0-255,66,188809,65,225711
32787,0.004674,74.125.68.0-255,2902,191711,65,225711
32788,0.004676,172.31.40.0-255,66,191777,65,225711
32789,0.00695,74.125.68.0-255,2902,194679,65,225711
32790,0.006955,172.31.40.0-255,66,194745,65,225711
32791,0.006967,74.125.68.0-255,1484,196229,65,225711
32792,0.006979,74.125.68.0-255,1484,197713,65,225711
32793,0.006981,172.31.40.0-255,66,197779,65,225711
32794,0.009272,74.125.68.0-255,5738,203517,65,225711
32795,0.00928,172.31.40.0-255,66,203583,65,225711
32796,0.011594,74.125.68.0-255,2902,206485,65,225711
32797,0.0116,172.31.40.0-255,66,206551,65,225711
32798,0.011646,74.125.68.0-255,2902,209453,65,225711
32799,0.011648,172.31.40.0-255,66,209519,65,225711
32800,0.013909,74.125.68.0-255,2902,212421,65,225711
32801,0.013918,172.31.40.0-255,66,212487,65,225711
32802,0.013939,74.125.68.0-255,2902,215389,65,225711
32803,0.013942,172.31.40.0-255,66,215455,65,225711
32804,0.016228,74.125.68.0-255,4320,219775,65,225711
32805,0.016234,172.31.40.0-255,66,219841,65,225711
32806,0.016252,74.125.68.0-255,1484,221325,65,225711
32807,0.018542,74.125.68.0-255,4320,225645,65,225711
32808,0.018549,172.31.40.0-255,66,225711,65,225711
32809,0.0,74.125.24.0-255,150,150,65,140600
32810,2.2e-05,172.31.40.0-255,66,216,65,140600
32811,2.9e-05,74.125.24.0-255,1484,1700,65,140600
32812,3.4e-05,172.31.40.0-255,66,1766,65,140600
32813,4.1e-05,74.125.24.0-255,2902,4668,65,140600
32814,4.4e-05,172.31.40.0-255,66,4734,65,140600
32815,5e-05,74.125.24.0-255,5738,10472,65,140600
32816,5.3e-05,172.31.40.0-255,66,10538,65,140600
32817,8.1e-05,74.125.24.0-255,3400,13938,65,140600
32818,8.5e-05,172.31.40.0-255,66,14004,65,140600
32819,0.000124,74.125.24.0-255,1484,15488,65,140600
32820,0.000126,172.31.40.0-255,66,15554,65,140600
32821,0.00014,74.125.24.0-255,2902,18456,65,140600
32822,0.000142,172.31.40.0-255,66,18522,65,140600
32823,0.000149,74.125.24.0-255,5738,24260,65,140600
32824,0.000151,172.31.40.0-255,66,24326,65,140600
32825,0.000178,74.125.24.0-255,6797,31123,65,140600
32826,0.000181,172.31.40.0-255,66,31189,65,140600
32827,0.000184,74.125.24.0-255,1484,32673,65,140600
32828,0.000186,172.31.40.0-255,66,32739,65,140600
32829,0.000203,74.125.24.0-255,5738,38477,65,140600
32830,0.000206,172.31.40.0-255,66,38543,65,140600
32831,0.000219,74.125.24.0-255,2902,41445,65,140600
32832,0.000221,172.31.40.0-255,66,41511,65,140600
32833,0.000244,74.125.24.0-255,6797,48308,65,140600
32834,0.000246,172.31.40.0-255,66,48374,65,140600
32835,0.000632,74.125.24.0-255,1484,49858,65,140600
32836,0.000637,172.31.40.0-255,66,49924,65,140600
32837,0.000643,74.125.24.0-255,2902,52826,65,140600
32838,0.000646,172.31.40.0-255,66,52892,65,140600
32839,0.000653,74.125.24.0-255,5738,58630,65,140600
32840,0.000655,172.31.40.0-255,66,58696,65,140600
32841,0.000708,74.125.24.0-255,5738,64434,65,140600
32842,0.000719,74.125.24.0-255,1470,65904,65,140600
32843,0.000721,74.125.24.0-255,332,66236,65,140600
32844,0.000726,172.31.40.0-255,66,66302,65,140600
32845,0.001005,74.125.24.0-255,1484,67786,65,140600
32846,0.001019,74.125.24.0-255,2902,70688,65,140600
32847,0.001021,74.125.24.0-255,1484,72172,65,140600
32848,0.001026,172.31.40.0-255,66,72238,65,140600
32849,0.00105,74.125.24.0-255,4320,76558,65,140600
32850,0.001057,74.125.24.0-255,5738,82296,65,140600
32851,0.001063,74.125.24.0-255,7156,89452,65,140600
32852,0.001068,172.31.40.0-255,66,89518,65,140600
32853,0.001089,74.125.24.0-255,1484,91002,65,140600
32854,0.001137,172.31.40.0-255,66,91068,65,140600
32855,0.00129,74.125.24.0-255,1484,92552,65,140600
32856,0.001296,74.125.24.0-255,2902,95454,65,140600
32857,0.001299,172.31.40.0-255,66,95520,65,140600
32858,0.00132,74.125.24.0-255,5738,101258,65,140600
32859,0.001335,172.31.40.0-255,66,101324,65,140600
32860,0.001366,74.125.24.0-255,4320,105644,65,140600
32861,0.001393,172.31.40.0-255,66,105710,65,140600
32862,0.001435,172.31.40.0-255,66,105776,65,140600
32863,0.003738,74.125.24.0-255,5738,111514,65,140600
32864,0.003745,172.31.40.0-255,66,111580,65,140600
32865,0.006083,74.125.24.0-255,5738,117318,65,140600
32866,0.007934,172.31.40.0-255,66,117384,65,140600
32867,0.010256,74.125.24.0-255,5738,123122,65,140600
32868,0.010265,172.31.40.0-255,66,123188,65,140600
32869,0.012588,74.125.24.0-255,5738,128926,65,140600
32870,0.013806,172.31.40.0-255,66,128992,65,140600
32871,0.016106,74.125.24.0-255,5738,134730,65,140600
32872,0.016116,172.31.40.0-255,66,134796,65,140600
32873,0.01844,74.125.24.0-255,5738,140534,65,140600
32874,0.018447,172.31.40.0-255,66,140600,65,140600
32875,0.0,74.125.130.0-255,150,150,65,250501
32876,2e-05,172.31.40.0-255,66,216,65,250501
32877,2.7e-05,74.125.130.0-255,1484,1700,65,250501
32878,3.3e-05,172.31.40.0-255,66,1766,65,250501
32879,5.5e-05,74.125.130.0-255,2902,4668,65,250501
32880,5.9e-05,172.31.40.0-255,66,4734,65,250501
32881,6.5e-05,74.125.130.0-255,5738,10472,65,250501
32882,6.9e-05,172.31.40.0-255,66,10538,65,250501
32883,7.3e-05,74.125.130.0-255,2902,13440,65,250501
32884,7.5e-05,172.31.40.0-255,66,13506,65,250501
32885,0.000102,74.125.130.0-255,3451,16957,65,250501
32886,0.000104,172.31.40.0-255,66,17023,65,250501
32887,0.000133,172.31.40.0-255,66,17089,65,250501
32888,0.000181,74.125.130.0-255,5379,22468,65,250501
32889,0.000185,172.31.40.0-255,66,22534,65,250501
32890,0.00051,74.125.130.0-255,1484,24018,65,250501
32891,0.000516,172.31.40.0-255,66,24084,65,250501
32892,0.000522,74.125.130.0-255,2902,26986,65,250501
32893,0.000524,172.31.40.0-255,66,27052,65,250501
32894,0.000536,74.125.130.0-255,1484,28536,65,250501
32895,0.000538,172.31.40.0-255,66,28602,65,250501
32896,0.000552,74.125.130.0-255,2902,31504,65,250501
32897,0.000555,172.31.40.0-255,66,31570,65,250501
32898,0.000592,74.125.130.0-255,5738,37308,65,250501
32899,0.000595,172.31.40.0-255,66,37374,65,250501
32900,0.00061,74.125.130.0-255,2543,39917,65,250501
32901,0.000613,172.31.40.0-255,66,39983,65,250501
32902,0.000644,74.125.130.0-255,7156,47139,65,250501
32903,0.000647,172.31.40.0-255,66,47205,65,250501
32904,0.000668,74.125.130.0-255,1484,48689,65,250501
32905,0.00067,172.31.40.0-255,66,48755,65,250501
32906,0.000693,74.125.130.0-255,7156,55911,65,250501
32907,0.000696,172.31.40.0-255,66,55977,65,250501
32908,0.000699,74.125.130.0-255,1383,57360,65,250501
32909,0.00073,74.125.130.0-255,119,57479,65,250501
32910,0.000852,74.125.130.0-255,1484,58963,65,250501
32911,0.000857,172.31.40.0-255,66,59029,65,250501
32912,0.000871,74.125.130.0-255,2902,61931,65,250501
32913,0.000874,74.125.130.0-255,1484,63415,65,250501
32914,0.000879,172.31.40.0-255,66,63481,65,250501
32915,0.000896,74.125.130.0-255,2902,66383,65,250501
32916,0.000899,172.31.40.0-255,66,66449,65,250501
32917,0.000918,74.125.130.0-255,5738,72187,65,250501
32918,0.000921,172.31.40.0-255,66,72253,65,250501
32919,0.000946,74.125.130.0-255,5738,77991,65,250501
32920,0.00095,172.31.40.0-255,66,78057,65,250501
32921,0.000969,74.125.130.0-255,2902,80959,65,250501
32922,0.000972,172.31.40.0-255,66,81025,65,250501
32923,0.000986,74.125.130.0-255,4320,85345,65,250501
32924,0.000989,172.31.40.0-255,66,85411,65,250501
32925,0.000996,74.125.130.0-255,6438,91849,65,250501
32926,0.000998,172.31.40.0-255,66,91915,65,250501
32927,0.001124,74.125.130.0-255,1484,93399,65,250501
32928,0.001129,74.125.130.0-255,1484,94883,65,250501
32929,0.001132,172.31.40.0-255,66,94949,65,250501
32930,0.001147,74.125.130.0-255,1484,96433,65,250501
32931,0.001154,74.125.130.0-255,5738,102171,65,250501
32932,0.001156,172.31.40.0-255,66,102237,65,250501
32933,0.00119,74.125.130.0-255,4320,106557,65,250501
32934,0.001193,172.31.40.0-255,66,106623,65,250501
32935,0.001211,74.125.130.0-255,7156,113779,65,250501
32936,0.001213,172.31.40.0-255,66,113845,65,250501
32937,0.001243,172.31.40.0-255,66,113911,65,250501
32938,0.001255,74.125.130.0-255,766,114677,65,250501
32939,0.001319,74.125.130.0-255,1484,116161,65,250501
32940,0.001322,172.31.40.0-255,66,116227,65,250501
32941,0.001346,74.125.130.0-255,2902,119129,65,250501
32942,0.001348,172.31.40.0-255,66,119195,65,250501
32943,0.001353,74.125.130.0-255,4320,123515,65,250501
32944,0.001355,172.31.40.0-255,66,123581,65,250501
32945,0.001406,172.31.40.0-255,66,123647,65,250501
32946,0.00141,74.125.130.0-255,2902,126549,65,250501
32947,0.001412,172.31.40.0-255,66,126615,65,250501
32948,0.001451,172.31.40.0-255,66,126681,65,250501
32949,0.001453,74.125.130.0-255,766,127447,65,250501
32950,0.001545,74.125.130.0-255,1484,128931,65,250501
32951,0.001549,172.31.40.0-255,66,128997,65,250501
32952,0.001554,74.125.130.0-255,2902,131899,65,250501
32953,0.001556,172.31.40.0-255,66,131965,65,250501
32954,0.001575,74.125.130.0-255,2902,134867,65,250501
32955,0.001577,172.31.40.0-255,66,134933,65,250501
32956,0.001598,74.125.130.0-255,2902,137835,65,250501
32957,0.0016,172.31.40.0-255,66,137901,65,250501
32958,0.001606,74.125.130.0-255,5738,143639,65,250501
32959,0.001608,172.31.40.0-255,66,143705,65,250501
32960,0.00163,74.125.130.0-255,7156,150861,65,250501
32961,0.001633,172.31.40.0-255,66,150927,65,250501
32962,0.001655,74.125.130.0-255,4320,155247,65,250501
32963,0.001657,172.31.40.0-255,66,155313,65,250501
32964,0.001687,74.125.130.0-255,6438,161751,65,250501
32965,0.00169,172.31.40.0-255,66,161817,65,250501
32966,0.001826,74.125.130.0-255,1484,163301,65,250501
32967,0.001832,74.125.130.0-255,2902,166203,65,250501
32968,0.001835,172.31.40.0-255,66,166269,65,250501
32969,0.001856,74.125.130.0-255,4320,170589,65,250501
32970,0.001859,172.31.40.0-255,66,170655,65,250501
32971,0.001881,74.125.130.0-255,5738,176393,65,250501
32972,0.001883,172.31.40.0-255,66,176459,65,250501
32973,0.001908,74.125.130.0-255,2902,179361,65,250501
32974,0.001912,172.31.40.0-255,66,179427,65,250501
32975,0.001924,74.125.130.0-255,5738,185165,65,250501
32976,0.001927,172.31.40.0-255,66,185231,65,250501
32977,0.001964,172.31.40.0-255,66,185297,65,250501
32978,0.001982,74.125.130.0-255,1484,186781,65,250501
32979,0.001985,74.125.130.0-255,766,187547,65,250501
32980,0.001988,172.31.40.0-255,66,187613,65,250501
32981,0.002195,74.125.130.0-255,1484,189097,65,250501
32982,0.002215,74.125.130.0-255,1484,190581,65,250501
32983,0.002218,172.31.40.0-255,66,190647,65,250501
32984,0.002224,74.125.130.0-255,2902,193549,65,250501
32985,0.002226,172.31.40.0-255,66,193615,65,250501
32986,0.002241,74.125.130.0-255,4320,197935,65,250501
32987,0.002245,172.31.40.0-255,66,198001,65,250501
32988,0.002257,74.125.130.0-255,1484,199485,65,250501
32989,0.002261,74.125.130.0-255,1484,200969,65,250501
32990,0.002263,172.31.40.0-255,66,201035,65,250501
32991,0.002294,74.125.130.0-255,5738,206773,65,250501
32992,0.002297,172.31.40.0-255,66,206839,65,250501
32993,0.002308,172.31.40.0-255,66,206905,65,250501
32994,0.002312,74.125.130.0-255,2902,209807,65,250501
32995,0.002314,172.31.40.0-255,66,209873,65,250501
32996,0.004586,74.125.130.0-255,5738,215611,65,250501
32997,0.004593,172.31.40.0-255,66,215677,65,250501
32998,0.006877,74.125.130.0-255,5738,221415,65,250501
32999,0.006883,172.31.40.0-255,66,221481,65,250501
33000,0.009172,74.125.130.0-255,5738,227219,65,250501
33001,0.009179,172.31.40.0-255,66,227285,65,250501
33002,0.011462,74.125.130.0-255,5738,233023,65,250501
33003,0.011469,172.31.40.0-255,66,233089,65,250501
33004,0.013754,74.125.130.0-255,5738,238827,65,250501
33005,0.013762,172.31.40.0-255,66,238893,65,250501
33006,0.016052,74.125.130.0-255,5738,244631,65,250501
33007,0.016059,172.31.40.0-255,66,244697,65,250501
33008,0.018365,74.125.130.0-255,5738,250435,65,250501
33009,0.018374,172.31.40.0-255,66,250501,65,250501
33010,0.0,74.125.130.0-255,153,153,65,130841
33011,2.2e-05,172.31.40.0-255,66,219,65,130841
33012,2.9e-05,74.125.130.0-255,1484,1703,65,130841
33013,3.3e-05,172.31.40.0-255,66,1769,65,130841
33014,3.9e-05,74.125.130.0-255,2902,4671,65,130841
33015,4.2e-05,172.31.40.0-255,66,4737,65,130841
33016,5.4e-05,74.125.130.0-255,2902,7639,65,130841
33017,5.8e-05,172.31.40.0-255,66,7705,65,130841
33018,8.5e-05,74.125.130.0-255,2902,10607,65,130841
33019,8.9e-05,172.31.40.0-255,66,10673,65,130841
33020,9.4e-05,74.125.130.0-255,3416,14089,65,130841
33021,9.7e-05,172.31.40.0-255,66,14155,65,130841
33022,0.000102,74.125.130.0-255,4320,18475,65,130841
33023,0.000105,172.31.40.0-255,66,18541,65,130841
33024,0.000147,172.31.40.0-255,66,18607,65,130841
33025,0.000161,172.31.40.0-255,66,18673,65,130841
33026,0.000191,172.31.40.0-255,66,18739,65,130841
33027,0.000224,74.125.130.0-255,2902,21641,65,130841
33028,0.000226,172.31.40.0-255,66,21707,65,130841
33029,0.000264,74.125.130.0-255,5738,27445,65,130841
33030,0.000266,172.31.40.0-255,66,27511,65,130841
33031,0.000278,172.31.40.0-255,66,27577,65,130841
33032,0.000706,74.125.130.0-255,1484,29061,65,130841
33033,0.000711,172.31.40.0-255,66,29127,65,130841
33034,0.000718,74.125.130.0-255,2902,32029,65,130841
33035,0.00072,172.31.40.0-255,66,32095,65,130841
33036,0.000731,74.125.130.0-255,5738,37833,65,130841
33037,0.000734,172.31.40.0-255,66,37899,65,130841
33038,0.000739,74.125.130.0-255,4320,42219,65,130841
33039,0.000741,172.31.40.0-255,66,42285,65,130841
33040,0.000748,74.125.130.0-255,5738,48023,65,130841
33041,0.000751,172.31.40.0-255,66,48089,65,130841
33042,0.000797,172.31.40.0-255,66,48155,65,130841
33043,0.000802,74.125.130.0-255,2184,50339,65,130841
33044,0.000804,172.31.40.0-255,66,50405,65,130841
33045,0.000975,74.125.130.0-255,1484,51889,65,130841
33046,0.000982,74.125.130.0-255,2902,54791,65,130841
33047,0.000986,172.31.40.0-255,66,54857,65,130841
33048,0.000992,74.125.130.0-255,4320,59177,65,130841
33049,0.000994,172.31.40.0-255,66,59243,65,130841
33050,0.00103,172.31.40.0-255,66,59309,65,130841
33051,0.001065,172.31.40.0-255,66,59375,65,130841
33052,0.001098,172.31.40.0-255,66,59441,65,130841
33053,0.001299,74.125.130.0-255,1484,60925,65,130841
33054,0.001305,74.125.130.0-255,2902,63827,65,130841
33055,0.001309,172.31.40.0-255,66,63893,65,130841
33056,0.001335,74.125.130.0-255,5738,69631,65,130841
33057,0.001338,172.31.40.0-255,66,69697,65,130841
33058,0.001352,74.125.130.0-255,4320,74017,65,130841
33059,0.001358,172.31.40.0-255,66,74083,65,130841
33060,0.001363,74.125.130.0-255,2902,76985,65,130841
33061,0.001365,172.31.40.0-255,66,77051,65,130841
33062,0.001396,74.125.130.0-255,2902,79953,65,130841
33063,0.0014,172.31.40.0-255,66,80019,65,130841
33064,0.001412,172.31.40.0-255,66,80085,65,130841
33065,0.001417,74.125.130.0-255,2184,82269,65,130841
33066,0.001422,172.31.40.0-255,66,82335,65,130841
33067,0.001534,74.125.130.0-255,1484,83819,65,130841
33068,0.001537,74.125.130.0-255,1484,85303,65,130841
33069,0.001541,172.31.40.0-255,66,85369,65,130841
33070,0.00156,74.125.130.0-255,1484,86853,65,130841
33071,0.001566,74.125.130.0-255,5738,92591,65,130841
33072,0.001568,172.31.40.0-255,66,92657,65,130841
33073,0.001603,172.31.40.0-255,66,92723,65,130841
33074,0.001635,74.125.130.0-255,4320,97043,65,130841
33075,0.001638,172.31.40.0-255,66,97109,65,130841
33076,0.001649,172.31.40.0-255,66,97175,65,130841
33077,0.001681,172.31.40.0-255,66,97241,65,130841
33078,0.001718,172.31.40.0-255,66,97307,65,130841
33079,0.001759,172.31.40.0-255,66,97373,65,130841
33080,0.001787,74.125.130.0-255,766,98139,65,130841
33081,0.001817,74.125.130.0-255,2902,101041,65,130841
33082,0.001821,74.125.130.0-255,4320,105361,65,130841
33083,0.001823,74.125.130.0-255,1484,106845,65,130841
33084,0.001829,172.31.40.0-255,66,106911,65,130841
33085,0.001836,172.31.40.0-255,66,106977,65,130841
33086,0.001838,172.31.40.0-255,66,107043,65,130841
33087,0.001841,172.31.40.0-255,66,107109,65,130841
33088,0.001852,74.125.130.0-255,7156,114265,65,130841
33089,0.001854,172.31.40.0-255,66,114331,65,130841
33090,0.001857,74.125.130.0-255,1484,115815,65,130841
33091,0.001902,172.31.40.0-255,66,115881,65,130841
33092,0.00191,74.125.130.0-255,4320,120201,65,130841
33093,0.001912,172.31.40.0-255,66,120267,65,130841
33094,0.001947,172.31.40.0-255,66,120333,65,130841
33095,0.00199,172.31.40.0-255,66,120399,65,130841
33096,0.002007,172.31.40.0-255,66,120465,65,130841
33097,0.002038,74.125.130.0-255,4320,124785,65,130841
33098,0.002041,172.31.40.0-255,66,124851,65,130841
33099,0.002096,172.31.40.0-255,66,124917,65,130841
33100,0.002116,172.31.40.0-255,66,124983,65,130841
33101,0.002142,74.125.130.0-255,5020,130003,65,130841
33102,0.002144,172.31.40.0-255,66,130069,65,130841
33103,0.002146,74.125.130.0-255,430,130499,65,130841
33104,0.002165,74.125.130.0-255,105,130604,65,130841
33105,0.004,172.31.40.0-255,66,130670,65,130841
33106,0.004033,172.31.40.0-255,105,130775,65,130841
33107,0.006342,74.125.130.0-255,66,130841,65,130841
33108,0.0,74.125.68.0-255,146,146,65,103754
33109,2e-05,172.31.40.0-255,66,212,65,103754
33110,2.6e-05,74.125.68.0-255,1484,1696,65,103754
33111,3.2e-05,172.31.40.0-255,66,1762,65,103754
33112,3.7e-05,74.125.68.0-255,2902,4664,65,103754
33113,4.1e-05,172.31.40.0-255,66,4730,65,103754
33114,9e-05,74.125.68.0-255,5738,10468,65,103754
33115,9.3e-05,172.31.40.0-255,66,10534,65,103754
33116,0.000192,74.125.68.0-255,1484,12018,65,103754
33117,0.000196,172.31.40.0-255,66,12084,65,103754
33118,0.0002,74.125.68.0-255,1484,13568,65,103754
33119,0.000203,172.31.40.0-255,66,13634,65,103754
33120,0.000223,74.125.68.0-255,6322,19956,65,103754
33121,0.000226,172.31.40.0-255,66,20022,65,103754
33122,0.00035,74.125.68.0-255,5738,25760,65,103754
33123,0.000355,172.31.40.0-255,66,25826,65,103754
33124,0.000378,74.125.68.0-255,5379,31205,65,103754
33125,0.000381,172.31.40.0-255,66,31271,65,103754
33126,0.000552,74.125.68.0-255,5738,37009,65,103754
33127,0.000557,172.31.40.0-255,66,37075,65,103754
33128,0.00065,74.125.68.0-255,4320,41395,65,103754
33129,0.000655,172.31.40.0-255,66,41461,65,103754
33130,0.000674,74.125.68.0-255,2902,44363,65,103754
33131,0.000677,172.31.40.0-255,66,44429,65,103754
33132,0.000789,172.31.40.0-255,66,44495,65,103754
33133,0.000803,74.125.68.0-255,5738,50233,65,103754
33134,0.000806,172.31.40.0-255,66,50299,65,103754
33135,0.001039,74.125.68.0-255,4320,54619,65,103754
33136,0.001045,172.31.40.0-255,66,54685,65,103754
33137,0.001065,74.125.68.0-255,2184,56869,65,103754
33138,0.001068,172.31.40.0-255,66,56935,65,103754
33139,0.00114,74.125.68.0-255,427,57362,65,103754
33140,0.001159,74.125.68.0-255,5738,63100,65,103754
33141,0.001175,74.125.68.0-255,2902,66002,65,103754
33142,0.001352,74.125.68.0-255,7156,73158,65,103754
33143,0.001512,172.31.40.0-255,66,73224,65,103754
33144,0.001654,74.125.68.0-255,6720,79944,65,103754
33145,0.001662,172.31.40.0-255,66,80010,65,103754
33146,0.001773,74.125.68.0-255,5738,85748,65,103754
33147,0.001787,172.31.40.0-255,66,85814,65,103754
33148,0.001814,172.31.40.0-255,66,85880,65,103754
33149,0.001843,172.31.40.0-255,66,85946,65,103754
33150,0.002386,74.125.68.0-255,5738,91684,65,103754
33151,0.00239,172.31.40.0-255,66,91750,65,103754
33152,0.002522,172.31.40.0-255,66,91816,65,103754
33153,0.002573,172.31.40.0-255,66,91882,65,103754
33154,0.003259,172.31.40.0-255,66,91948,65,103754
33155,0.003293,172.31.40.0-255,66,92014,65,103754
33156,0.003616,172.31.40.0-255,66,92080,65,103754
33157,0.008451,172.31.40.0-255,66,92146,65,103754
33158,0.011011,74.125.68.0-255,5738,97884,65,103754
33159,0.011018,172.31.40.0-255,66,97950,65,103754
33160,0.013577,74.125.68.0-255,5738,103688,65,103754
33161,0.018138,172.31.40.0-255,66,103754,65,103754
33162,0.0,74.125.200.0-255,151,151,65,105181
33163,2.5e-05,172.31.40.0-255,66,217,65,105181
33164,3.3e-05,74.125.200.0-255,1484,1701,65,105181
33165,3.8e-05,172.31.40.0-255,66,1767,65,105181
33166,4.3e-05,74.125.200.0-255,2902,4669,65,105181
33167,4.6e-05,172.31.40.0-255,66,4735,65,105181
33168,4.9e-05,74.125.200.0-255,1484,6219,65,105181
33169,5.1e-05,172.31.40.0-255,66,6285,65,105181
33170,5.7e-05,74.125.200.0-255,2902,9187,65,105181
33171,6e-05,172.31.40.0-255,66,9253,65,105181
33172,8.5e-05,74.125.200.0-255,4899,14152,65,105181
33173,8.8e-05,172.31.40.0-255,66,14218,65,105181
33174,0.000166,74.125.200.0-255,1484,15702,65,105181
33175,0.000169,172.31.40.0-255,66,15768,65,105181
33176,0.000186,74.125.200.0-255,2902,18670,65,105181
33177,0.000188,172.31.40.0-255,66,18736,65,105181
33178,0.000211,74.125.200.0-255,5738,24474,65,105181
33179,0.000213,172.31.40.0-255,66,24540,65,105181
33180,0.000239,74.125.200.0-255,5738,30278,65,105181
33181,0.000242,172.31.40.0-255,66,30344,65,105181
33182,0.000273,74.125.200.0-255,1125,31469,65,105181
33183,0.000275,172.31.40.0-255,66,31535,65,105181
33184,0.00109,74.125.200.0-255,1484,33019,65,105181
33185,0.001097,172.31.40.0-255,66,33085,65,105181
33186,0.001107,74.125.200.0-255,2902,35987,65,105181
33187,0.00111,172.31.40.0-255,66,36053,65,105181
33188,0.001117,74.125.200.0-255,4320,40373,65,105181
33189,0.001118,172.31.40.0-255,66,40439,65,105181
33190,0.001137,74.125.200.0-255,1484,41923,65,105181
33191,0.00114,172.31.40.0-255,66,41989,65,105181
33192,0.001148,74.125.200.0-255,6797,48786,65,105181
33193,0.00115,172.31.40.0-255,66,48852,65,105181
33194,0.001177,74.125.200.0-255,7156,56008,65,105181
33195,0.001179,172.31.40.0-255,66,56074,65,105181
33196,0.001184,74.125.200.0-255,2902,58976,65,105181
33197,0.001186,172.31.40.0-255,66,59042,65,105181
33198,0.001214,74.125.200.0-255,6797,65839,65,105181
33199,0.001218,172.31.40.0-255,66,65905,65,105181
33200,0.003833,74.125.200.0-255,5738,71643,65,105181
33201,0.003839,172.31.40.0-255,66,71709,65,105181
33202,0.006449,74.125.200.0-255,5738,77447,65,105181
33203,0.006456,172.31.40.0-255,66,77513,65,105181
33204,0.009056,74.125.200.0-255,4320,81833,65,105181
33205,0.009064,172.31.40.0-255,66,81899,65,105181
33206,0.009083,74.125.200.0-255,1484,83383,65,105181
33207,0.011663,74.125.200.0-255,4320,87703,65,105181
33208,0.011671,172.31.40.0-255,66,87769,65,105181
33209,0.014294,74.125.200.0-255,5738,93507,65,105181
33210,0.014303,172.31.40.0-255,66,93573,65,105181
33211,0.016925,74.125.200.0-255,5738,99311,65,105181
33212,0.016939,172.31.40.0-255,66,99377,65,105181
33213,0.019558,74.125.200.0-255,5738,105115,65,105181
33214,0.019572,172.31.40.0-255,66,105181,65,105181
33215,0.0,74.125.24.0-255,156,156,65,230520
33216,2.7e-05,172.31.40.0-255,66,222,65,230520
33217,3.3e-05,74.125.24.0-255,1484,1706,65,230520
33218,3.9e-05,172.31.40.0-255,66,1772,65,230520
33219,5.2e-05,74.125.24.0-255,2902,4674,65,230520
33220,5.6e-05,172.31.40.0-255,66,4740,65,230520
33221,6.2e-05,74.125.24.0-255,4320,9060,65,230520
33222,6.5e-05,172.31.40.0-255,66,9126,65,230520
33223,9.5e-05,74.125.24.0-255,2902,12028,65,230520
33224,9.8e-05,172.31.40.0-255,66,12094,65,230520
33225,0.000136,172.31.40.0-255,66,12160,65,230520
33226,0.000169,172.31.40.0-255,66,12226,65,230520
33227,0.000193,74.125.24.0-255,1125,13351,65,230520
33228,0.000195,172.31.40.0-255,66,13417,65,230520
33229,0.000258,74.125.24.0-255,1484,14901,65,230520
33230,0.00026,172.31.40.0-255,66,14967,65,230520
33231,0.000265,74.125.24.0-255,2902,17869,65,230520
33232,0.000268,172.31.40.0-255,66,17935,65,230520
33233,0.000278,74.125.24.0-255,4320,22255,65,230520
33234,0.000281,172.31.40.0-255,66,22321,65,230520
33235,0.000305,74.125.24.0-255,1484,23805,65,230520
33236,0.000308,172.31.40.0-255,66,23871,65,230520
33237,0.000311,74.125.24.0-255,1484,25355,65,230520
33238,0.000313,172.31.40.0-255,66,25421,65,230520
33239,0.000357,172.31.40.0-255,66,25487,65,230520
33240,0.000363,74.125.24.0-255,5738,31225,65,230520
33241,0.000366,172.31.40.0-255,66,31291,65,230520
33242,0.00043,74.125.24.0-255,2902,34193,65,230520
33243,0.000434,172.31.40.0-255,66,34259,65,230520
33244,0.000457,74.125.24.0-255,1401,35660,65,230520
33245,0.000549,74.125.24.0-255,127,35787,65,230520
33246,0.000656,74.125.24.0-255,1484,37271,65,230520
33247,0.000665,172.31.40.0-255,66,37337,65,230520
33248,0.00067,74.125.24.0-255,1484,38821,65,230520
33249,0.000688,74.125.24.0-255,1484,40305,65,230520
33250,0.000691,172.31.40.0-255,66,40371,65,230520
33251,0.000696,74.125.24.0-255,2902,43273,65,230520
33252,0.000698,172.31.40.0-255,66,43339,65,230520
33253,0.000703,74.125.24.0-255,4320,47659,65,230520
33254,0.000706,172.31.40.0-255,66,47725,65,230520
33255,0.000732,74.125.24.0-255,2902,50627,65,230520
33256,0.000734,172.31.40.0-255,66,50693,65,230520
33257,0.000754,74.125.24.0-255,5738,56431,65,230520
33258,0.000756,172.31.40.0-255,66,56497,65,230520
33259,0.000786,172.31.40.0-255,66,56563,65,230520
33260,0.000812,74.125.24.0-255,2543,59106,65,230520
33261,0.000814,172.31.40.0-255,66,59172,65,230520
33262,0.000852,74.125.24.0-255,2902,62074,65,230520
33263,0.000855,172.31.40.0-255,66,62140,65,230520
33264,0.000858,74.125.24.0-255,1484,63624,65,230520
33265,0.000885,74.125.24.0-255,5738,69362,65,230520
33266,0.000888,172.31.40.0-255,66,69428,65,230520
33267,0.000893,74.125.24.0-255,4320,73748,65,230520
33268,0.000895,172.31.40.0-255,66,73814,65,230520
33269,0.000924,74.125.24.0-255,7156,80970,65,230520
33270,0.000927,172.31.40.0-255,66,81036,65,230520
33271,0.000933,74.125.24.0-255,4320,85356,65,230520
33272,0.000935,172.31.40.0-255,66,85422,65,230520
33273,0.000969,172.31.40.0-255,66,85488,65,230520
33274,0.001032,74.125.24.0-255,1484,86972,65,230520
33275,0.001036,74.125.24.0-255,2902,89874,65,230520
33276,0.001039,172.31.40.0-255,66,89940,65,230520
33277,0.001046,74.125.24.0-255,5738,95678,65,230520
33278,0.001049,172.31.40.0-255,66,95744,65,230520
33279,0.001057,74.125.24.0-255,1484,97228,65,230520
33280,0.001089,172.31.40.0-255,66,97294,65,230520
33281,0.001106,172.31.40.0-255,66,97360,65,230520
33282,0.001335,74.125.24.0-255,1484,98844,65,230520
33283,0.001341,74.125.24.0-255,1484,100328,65,230520
33284,0.001345,172.31.40.0-255,66,100394,65,230520
33285,0.00137,74.125.24.0-255,1484,101878,65,230520
33286,0.001378,74.125.24.0-255,5738,107616,65,230520
33287,0.001381,172.31.40.0-255,66,107682,65,230520
33288,0.001421,172.31.40.0-255,66,107748,65,230520
33289,0.001434,172.31.40.0-255,66,107814,65,230520
33290,0.001438,74.125.24.0-255,2184,109998,65,230520
33291,0.001443,172.31.40.0-255,66,110064,65,230520
33292,0.001581,74.125.24.0-255,1484,111548,65,230520
33293,0.001587,74.125.24.0-255,2902,114450,65,230520
33294,0.001604,74.125.24.0-255,2902,117352,65,230520
33295,0.001624,74.125.24.0-255,2902,120254,65,230520
33296,0.001694,74.125.24.0-255,5738,125992,65,230520
33297,0.00171,74.125.24.0-255,5020,131012,65,230520
33298,0.001732,74.125.24.0-255,1484,132496,65,230520
33299,0.001746,74.125.24.0-255,4320,136816,65,230520
33300,0.001749,74.125.24.0-255,1484,138300,65,230520
33301,0.001762,74.125.24.0-255,1484,139784,65,230520
33302,0.001778,74.125.24.0-255,4320,144104,65,230520
33303,0.0018,74.125.24.0-255,5738,149842,65,230520
33304,0.001803,74.125.24.0-255,1484,151326,65,230520
33305,0.001847,74.125.24.0-255,2184,153510,65,230520
33306,0.002094,74.125.24.0-255,1484,154994,65,230520
33307,0.0021,74.125.24.0-255,2902,157896,65,230520
33308,0.002105,74.125.24.0-255,2902,160798,65,230520
33309,0.002127,74.125.24.0-255,2902,163700,65,230520
33310,0.002158,74.125.24.0-255,2902,166602,65,230520
33311,0.002282,74.125.24.0-255,1484,168086,65,230520
33312,0.002307,74.125.24.0-255,2902,170988,65,230520
33313,0.002311,74.125.24.0-255,1484,172472,65,230520
33314,0.002333,74.125.24.0-255,4320,176792,65,230520
33315,0.002377,74.125.24.0-255,1484,178276,65,230520
33316,0.002416,74.125.24.0-255,5020,183296,65,230520
33317,0.002418,74.125.24.0-255,1484,184780,65,230520
33318,0.002435,74.125.24.0-255,4320,189100,65,230520
33319,0.002439,74.125.24.0-255,2902,192002,65,230520
33320,0.002455,74.125.24.0-255,2902,194904,65,230520
33321,0.00514,172.31.40.0-255,66,194970,65,230520
33322,0.007564,74.125.24.0-255,5738,200708,65,230520
33323,0.007583,172.31.40.0-255,66,200774,65,230520
33324,0.009971,74.125.24.0-255,2902,203676,65,230520
33325,0.009978,172.31.40.0-255,66,203742,65,230520
33326,0.010007,74.125.24.0-255,2902,206644,65,230520
33327,0.01001,172.31.40.0-255,66,206710,65,230520
33328,0.012325,74.125.24.0-255,2902,209612,65,230520
33329,0.012328,172.31.40.0-255,66,209678,65,230520
33330,0.012381,74.125.24.0-255,2902,212580,65,230520
33331,0.012383,172.31.40.0-255,66,212646,65,230520
33332,0.014682,74.125.24.0-255,2902,215548,65,230520
33333,0.014697,172.31.40.0-255,66,215614,65,230520
33334,0.014733,74.125.24.0-255,2902,218516,65,230520
33335,0.014735,172.31.40.0-255,66,218582,65,230520
33336,0.017079,74.125.24.0-255,2902,221484,65,230520
33337,0.017089,172.31.40.0-255,66,221550,65,230520
33338,0.017163,74.125.24.0-255,1484,223034,65,230520
33339,0.017182,74.125.24.0-255,1484,224518,65,230520
33340,0.017185,172.31.40.0-255,66,224584,65,230520
33341,0.01953,74.125.24.0-255,2902,227486,65,230520
33342,0.019547,172.31.40.0-255,66,227552,65,230520
33343,0.01965,74.125.24.0-255,2902,230454,65,230520
33344,0.019655,172.31.40.0-255,66,230520,65,230520
33345,0.0,172.217.194.0-255,153,153,65,212480
33346,2.2e-05,172.31.40.0-255,66,219,65,212480
33347,2.8e-05,172.217.194.0-255,1484,1703,65,212480
33348,3.2e-05,172.31.40.0-255,66,1769,65,212480
33349,3.8e-05,172.217.194.0-255,2902,4671,65,212480
33350,4.2e-05,172.31.40.0-255,66,4737,65,212480
33351,5e-05,172.217.194.0-255,7156,11893,65,212480
33352,5.3e-05,172.31.40.0-255,66,11959,65,212480
33353,5.7e-05,172.217.194.0-255,1999,13958,65,212480
33354,5.9e-05,172.31.40.0-255,66,14024,65,212480
33355,8.7e-05,172.217.194.0-255,4320,18344,65,212480
33356,9e-05,172.31.40.0-255,66,18410,65,212480
33357,0.000118,172.217.194.0-255,7156,25566,65,212480
33358,0.000121,172.31.40.0-255,66,25632,65,212480
33359,0.000127,172.217.194.0-255,5379,31011,65,212480
33360,0.000129,172.31.40.0-255,66,31077,65,212480
33361,0.000147,172.217.194.0-255,1484,32561,65,212480
33362,0.000149,172.31.40.0-255,66,32627,65,212480
33363,0.00018,172.217.194.0-255,4320,36947,65,212480
33364,0.000182,172.31.40.0-255,66,37013,65,212480
33365,0.00019,172.217.194.0-255,7156,44169,65,212480
33366,0.000192,172.31.40.0-255,66,44235,65,212480
33367,0.000195,172.217.194.0-255,1484,45719,65,212480
33368,0.000197,172.31.40.0-255,66,45785,65,212480
33369,0.00022,172.217.194.0-255,2543,48328,65,212480
33370,0.000222,172.31.40.0-255,66,48394,65,212480
33371,0.000795,172.217.194.0-255,1484,49878,65,212480
33372,0.0008,172.31.40.0-255,66,49944,65,212480
33373,0.000805,172.217.194.0-255,2902,52846,65,212480
33374,0.000808,172.31.40.0-255,66,52912,65,212480
33375,0.000811,172.217.194.0-255,1484,54396,65,212480
33376,0.000813,172.31.40.0-255,66,54462,65,212480
33377,0.00083,172.217.194.0-255,4320,58782,65,212480
33378,0.000832,172.31.40.0-255,66,58848,65,212480
33379,0.000835,172.217.194.0-255,1484,60332,65,212480
33380,0.000875,172.31.40.0-255,66,60398,65,212480
33381,0.000887,172.31.40.0-255,66,60464,65,212480
33382,0.00089,172.217.194.0-255,1484,61948,65,212480
33383,0.000927,172.31.40.0-255,66,62014,65,212480
33384,0.000938,172.31.40.0-255,66,62080,65,212480
33385,0.001056,172.217.194.0-255,1484,63564,65,212480
33386,0.001061,172.217.194.0-255,1484,65048,65,212480
33387,0.001063,172.31.40.0-255,66,65114,65,212480
33388,0.001083,172.217.194.0-255,1484,66598,65,212480
33389,0.00109,172.217.194.0-255,5738,72336,65,212480
33390,0.001093,172.31.40.0-255,66,72402,65,212480
33391,0.001122,172.31.40.0-255,66,72468,65,212480
33392,0.00114,172.217.194.0-255,2902,75370,65,212480
33393,0.001142,172.31.40.0-255,66,75436,65,212480
33394,0.001156,172.31.40.0-255,66,75502,65,212480
33395,0.001384,172.217.194.0-255,1484,76986,65,212480
33396,0.00139,172.217.194.0-255,2902,79888,65,212480
33397,0.001393,172.31.40.0-255,66,79954,65,212480
33398,0.001399,172.217.194.0-255,4320,84274,65,212480
33399,0.001402,172.31.40.0-255,66,84340,65,212480
33400,0.001415,172.217.194.0-255,1484,85824,65,212480
33401,0.001449,172.31.40.0-255,66,85890,65,212480
33402,0.001452,172.217.194.0-255,1484,87374,65,212480
33403,0.00149,172.217.194.0-255,5738,93112,65,212480
33404,0.001493,172.31.40.0-255,66,93178,65,212480
33405,0.001512,172.217.194.0-255,3602,96780,65,212480
33406,0.001514,172.31.40.0-255,66,96846,65,212480
33407,0.00199,172.217.194.0-255,1484,98330,65,212480
33408,0.001997,172.217.194.0-255,2902,101232,65,212480
33409,0.002,172.31.40.0-255,66,101298,65,212480
33410,0.002005,172.217.194.0-255,2902,104200,65,212480
33411,0.002007,172.31.40.0-255,66,104266,65,212480
33412,0.002032,172.217.194.0-255,7156,111422,65,212480
33413,0.002035,172.31.40.0-255,66,111488,65,212480
33414,0.002077,172.31.40.0-255,66,111554,65,212480
33415,0.0021,172.217.194.0-255,4320,115874,65,212480
33416,0.002102,172.31.40.0-255,66,115940,65,212480
33417,0.002107,172.217.194.0-255,3602,119542,65,212480
33418,0.00211,172.31.40.0-255,66,119608,65,212480
33419,0.002134,172.217.194.0-255,1484,121092,65,212480
33420,0.002157,172.217.194.0-255,2902,123994,65,212480
33421,0.002159,172.31.40.0-255,66,124060,65,212480
33422,0.002177,172.217.194.0-255,5738,129798,65,212480
33423,0.00218,172.31.40.0-255,66,129864,65,212480
33424,0.002185,172.217.194.0-255,4320,134184,65,212480
33425,0.002187,172.31.40.0-255,66,134250,65,212480
33426,0.00222,172.31.40.0-255,66,134316,65,212480
33427,0.002251,172.31.40.0-255,66,134382,65,212480
33428,0.002326,172.217.194.0-255,1484,135866,65,212480
33429,0.002332,172.217.194.0-255,2902,138768,65,212480
33430,0.002335,172.31.40.0-255,66,138834,65,212480
33431,0.002358,172.217.194.0-255,5738,144572,65,212480
33432,0.00236,172.31.40.0-255,66,144638,65,212480
33433,0.002376,172.217.194.0-255,1484,146122,65,212480
33434,0.002415,172.31.40.0-255,66,146188,65,212480
33435,0.002422,172.217.194.0-255,7156,153344,65,212480
33436,0.002425,172.31.40.0-255,66,153410,65,212480
33437,0.002446,172.217.194.0-255,3602,157012,65,212480
33438,0.002448,172.31.40.0-255,66,157078,65,212480
33439,0.002551,172.217.194.0-255,1484,158562,65,212480
33440,0.002557,172.217.194.0-255,2902,161464,65,212480
33441,0.00256,172.31.40.0-255,66,161530,65,212480
33442,0.002566,172.217.194.0-255,4320,165850,65,212480
33443,0.002568,172.31.40.0-255,66,165916,65,212480
33444,0.00258,172.217.194.0-255,1484,167400,65,212480
33445,0.002593,172.217.194.0-255,4320,171720,65,212480
33446,0.002596,172.31.40.0-255,66,171786,65,212480
33447,0.002628,172.31.40.0-255,66,171852,65,212480
33448,0.002635,172.217.194.0-255,5738,177590,65,212480
33449,0.002637,172.31.40.0-255,66,177656,65,212480
33450,0.005241,172.217.194.0-255,5738,183394,65,212480
33451,0.005248,172.31.40.0-255,66,183460,65,212480
33452,0.007853,172.217.194.0-255,5738,189198,65,212480
33453,0.007859,172.31.40.0-255,66,189264,65,212480
33454,0.010463,172.217.194.0-255,5738,195002,65,212480
33455,0.010471,172.31.40.0-255,66,195068,65,212480
33456,0.013131,172.217.194.0-255,5738,200806,65,212480
33457,0.01314,172.31.40.0-255,66,200872,65,212480
33458,0.015728,172.217.194.0-255,5738,206610,65,212480
33459,0.015734,172.31.40.0-255,66,206676,65,212480
33460,0.018344,172.217.194.0-255,5738,212414,65,212480
33461,0.018352,172.31.40.0-255,66,212480,65,212480
33462,0.0,74.125.200.0-255,297,297,65,198124
33463,2.2e-05,172.31.40.0-255,66,363,65,198124
33464,2.9e-05,74.125.200.0-255,1484,1847,65,198124
33465,3.3e-05,172.31.40.0-255,66,1913,65,198124
33466,4.9e-05,74.125.200.0-255,4320,6233,65,198124
33467,5.2e-05,172.31.40.0-255,66,6299,65,198124
33468,5.5e-05,74.125.200.0-255,1484,7783,65,198124
33469,5.7e-05,172.31.40.0-255,66,7849,65,198124
33470,6.2e-05,74.125.200.0-255,2902,10751,65,198124
33471,6.4e-05,172.31.40.0-255,66,10817,65,198124
33472,9.7e-05,74.125.200.0-255,3321,14138,65,198124
33473,0.0001,172.31.40.0-255,66,14204,65,198124
33474,0.000137,74.125.200.0-255,4320,18524,65,198124
33475,0.00014,172.31.40.0-255,66,18590,65,198124
33476,0.000155,74.125.200.0-255,4320,22910,65,198124
33477,0.000162,172.31.40.0-255,66,22976,65,198124
33478,0.000185,74.125.200.0-255,1484,24460,65,198124
33479,0.000187,172.31.40.0-255,66,24526,65,198124
33480,0.000192,74.125.200.0-255,2902,27428,65,198124
33481,0.000194,172.31.40.0-255,66,27494,65,198124
33482,0.000217,74.125.200.0-255,3961,31455,65,198124
33483,0.00022,172.31.40.0-255,66,31521,65,198124
33484,0.000354,74.125.200.0-255,1484,33005,65,198124
33485,0.000356,172.31.40.0-255,66,33071,65,198124
33486,0.00036,74.125.200.0-255,1484,34555,65,198124
33487,0.000362,172.31.40.0-255,66,34621,65,198124
33488,0.00039,74.125.200.0-255,1484,36105,65,198124
33489,0.000393,172.31.40.0-255,66,36171,65,198124
33490,0.0004,74.125.200.0-255,5738,41909,65,198124
33491,0.000402,172.31.40.0-255,66,41975,65,198124
33492,0.000429,74.125.200.0-255,6797,48772,65,198124
33493,0.000431,172.31.40.0-255,66,48838,65,198124
33494,0.000463,74.125.200.0-255,2902,51740,65,198124
33495,0.000465,172.31.40.0-255,66,51806,65,198124
33496,0.000469,74.125.200.0-255,1484,53290,65,198124
33497,0.000491,74.125.200.0-255,2902,56192,65,198124
33498,0.000494,172.31.40.0-255,66,56258,65,198124
33499,0.000501,74.125.200.0-255,5738,61996,65,198124
33500,0.000503,172.31.40.0-255,66,62062,65,198124
33501,0.000528,74.125.200.0-255,1484,63546,65,198124
33502,0.000547,74.125.200.0-255,2851,66397,65,198124
33503,0.000549,172.31.40.0-255,66,66463,65,198124
33504,0.000571,74.125.200.0-255,110,66573,65,198124
33505,0.000673,74.125.200.0-255,1484,68057,65,198124
33506,0.000676,172.31.40.0-255,66,68123,65,198124
33507,0.000702,74.125.200.0-255,2902,71025,65,198124
33508,0.000705,172.31.40.0-255,66,71091,65,198124
33509,0.000709,74.125.200.0-255,2902,73993,65,198124
33510,0.000711,172.31.40.0-255,66,74059,65,198124
33511,0.000716,74.125.200.0-255,2902,76961,65,198124
33512,0.000718,172.31.40.0-255,66,77027,65,198124
33513,0.000743,74.125.200.0-255,1484,78511,65,198124
33514,0.00075,74.125.200.0-255,5067,83578,65,198124
33515,0.000753,172.31.40.0-255,66,83644,65,198124
33516,0.000967,74.125.200.0-255,1484,85128,65,198124
33517,0.000971,74.125.200.0-255,1484,86612,65,198124
33518,0.000973,172.31.40.0-255,66,86678,65,198124
33519,0.001001,74.125.200.0-255,1484,88162,65,198124
33520,0.001008,74.125.200.0-255,5738,93900,65,198124
33521,0.001011,172.31.40.0-255,66,93966,65,198124
33522,0.001024,172.31.40.0-255,66,94032,65,198124
33523,0.00107,172.31.40.0-255,66,94098,65,198124
33524,0.001491,74.125.200.0-255,1484,95582,65,198124
33525,0.001506,74.125.200.0-255,1484,97066,65,198124
33526,0.001509,172.31.40.0-255,66,97132,65,198124
33527,0.001541,74.125.200.0-255,1484,98616,65,198124
33528,0.001547,74.125.200.0-255,4320,102936,65,198124
33529,0.00155,172.31.40.0-255,66,103002,65,198124
33530,0.001554,74.125.200.0-255,2902,105904,65,198124
33531,0.001556,172.31.40.0-255,66,105970,65,198124
33532,0.001582,74.125.200.0-255,5738,111708,65,198124
33533,0.001584,172.31.40.0-255,66,111774,65,198124
33534,0.001595,74.125.200.0-255,7156,118930,65,198124
33535,0.001598,172.31.40.0-255,66,118996,65,198124
33536,0.001638,172.31.40.0-255,66,119062,65,198124
33537,0.00164,74.125.200.0-255,766,119828,65,198124
33538,0.002022,74.125.200.0-255,1484,121312,65,198124
33539,0.002025,172.31.40.0-255,66,121378,65,198124
33540,0.002031,74.125.200.0-255,2902,124280,65,198124
33541,0.002033,172.31.40.0-255,66,124346,65,198124
33542,0.002036,74.125.200.0-255,1484,125830,65,198124
33543,0.002059,74.125.200.0-255,4320,130150,65,198124
33544,0.002062,172.31.40.0-255,66,130216,65,198124
33545,0.00207,74.125.200.0-255,2902,133118,65,198124
33546,0.002073,172.31.40.0-255,66,133184,65,198124
33547,0.002079,74.125.200.0-255,4320,137504,65,198124
33548,0.002081,172.31.40.0-255,66,137570,65,198124
33549,0.002088,74.125.200.0-255,5738,143308,65,198124
33550,0.002091,172.31.40.0-255,66,143374,65,198124
33551,0.002123,74.125.200.0-255,2902,146276,65,198124
33552,0.002126,172.31.40.0-255,66,146342,65,198124
33553,0.002133,74.125.200.0-255,7156,153498,65,198124
33554,0.002136,172.31.40.0-255,66,153564,65,198124
33555,0.002139,74.125.200.0-255,766,154330,65,198124
33556,0.002251,74.125.200.0-255,1484,155814,65,198124
33557,0.002253,172.31.40.0-255,66,155880,65,198124
33558,0.002258,74.125.200.0-255,2902,158782,65,198124
33559,0.002261,172.31.40.0-255,66,158848,65,198124
33560,0.004513,74.125.200.0-255,5738,164586,65,198124
33561,0.00452,172.31.40.0-255,66,164652,65,198124
33562,0.006775,74.125.200.0-255,5738,170390,65,198124
33563,0.006782,172.31.40.0-255,66,170456,65,198124
33564,0.009047,74.125.200.0-255,5738,176194,65,198124
33565,0.009054,172.31.40.0-255,66,176260,65,198124
33566,0.011316,74.125.200.0-255,5738,181998,65,198124
33567,0.011323,172.31.40.0-255,66,182064,65,198124
33568,0.013578,74.125.200.0-255,5738,187802,65,198124
33569,0.013586,172.31.40.0-255,66,187868,65,198124
33570,0.015842,74.125.200.0-255,4320,192188,65,198124
33571,0.01585,172.31.40.0-255,66,192254,65,198124
33572,0.01588,74.125.200.0-255,1484,193738,65,198124
33573,0.018106,74.125.200.0-255,4320,198058,65,198124
33574,0.018116,172.31.40.0-255,66,198124,65,198124
33575,0.0,172.217.194.0-255,156,156,65,171950
33576,2.3e-05,172.31.40.0-255,66,222,65,171950
33577,3e-05,172.217.194.0-255,1484,1706,65,171950
33578,3.5e-05,172.31.40.0-255,66,1772,65,171950
33579,4.1e-05,172.217.194.0-255,2902,4674,65,171950
33580,4.5e-05,172.31.40.0-255,66,4740,65,171950
33581,5.3e-05,172.217.194.0-255,7156,11896,65,171950
33582,5.7e-05,172.31.40.0-255,66,11962,65,171950
33583,6.2e-05,172.217.194.0-255,3438,15400,65,171950
33584,6.5e-05,172.31.40.0-255,66,15466,65,171950
33585,8.2e-05,172.217.194.0-255,2902,18368,65,171950
33586,8.6e-05,172.31.40.0-255,66,18434,65,171950
33587,0.00012,172.31.40.0-255,66,18500,65,171950
33588,0.000125,172.217.194.0-255,2543,21043,65,171950
33589,0.000127,172.31.40.0-255,66,21109,65,171950
33590,0.000192,172.217.194.0-255,1484,22593,65,171950
33591,0.000194,172.31.40.0-255,66,22659,65,171950
33592,0.000209,172.217.194.0-255,2902,25561,65,171950
33593,0.000212,172.31.40.0-255,66,25627,65,171950
33594,0.000228,172.217.194.0-255,1484,27111,65,171950
33595,0.000231,172.31.40.0-255,66,27177,65,171950
33596,0.000245,172.217.194.0-255,4320,31497,65,171950
33597,0.000248,172.31.40.0-255,66,31563,65,171950
33598,0.000251,172.217.194.0-255,1484,33047,65,171950
33599,0.000253,172.31.40.0-255,66,33113,65,171950
33600,0.000301,172.31.40.0-255,66,33179,65,171950
33601,0.000311,172.31.40.0-255,66,33245,65,171950
33602,0.000314,172.217.194.0-255,1399,34644,65,171950
33603,0.000315,172.31.40.0-255,66,34710,65,171950
33604,0.00039,172.217.194.0-255,114,34824,65,171950
33605,0.000402,172.217.194.0-255,386,35210,65,171950
33606,0.000612,172.217.194.0-255,1484,36694,65,171950
33607,0.000616,172.217.194.0-255,1484,38178,65,171950
33608,0.000622,172.31.40.0-255,66,38244,65,171950
33609,0.000632,172.217.194.0-255,1484,39728,65,171950
33610,0.000635,172.31.40.0-255,66,39794,65,171950
33611,0.000642,172.217.194.0-255,5738,45532,65,171950
33612,0.000644,172.31.40.0-255,66,45598,65,171950
33613,0.000681,172.31.40.0-255,66,45664,65,171950
33614,0.00071,172.31.40.0-255,66,45730,65,171950
33615,0.00114,172.217.194.0-255,1484,47214,65,171950
33616,0.001147,172.217.194.0-255,2902,50116,65,171950
33617,0.00115,172.31.40.0-255,66,50182,65,171950
33618,0.001156,172.217.194.0-255,4320,54502,65,171950
33619,0.001158,172.31.40.0-255,66,54568,65,171950
33620,0.001171,172.217.194.0-255,1484,56052,65,171950
33621,0.001175,172.217.194.0-255,2902,58954,65,171950
33622,0.001178,172.31.40.0-255,66,59020,65,171950
33623,0.001204,172.31.40.0-255,66,59086,65,171950
33624,0.001238,172.217.194.0-255,2902,61988,65,171950
33625,0.001241,172.31.40.0-255,66,62054,65,171950
33626,0.001269,172.31.40.0-255,66,62120,65,171950
33627,0.0016,172.217.194.0-255,1484,63604,65,171950
33628,0.001615,172.217.194.0-255,1484,65088,65,171950
33629,0.001619,172.31.40.0-255,66,65154,65,171950
33630,0.00164,172.217.194.0-255,1484,66638,65,171950
33631,0.001648,172.217.194.0-255,5738,72376,65,171950
33632,0.00165,172.31.40.0-255,66,72442,65,171950
33633,0.001694,172.31.40.0-255,66,72508,65,171950
33634,0.001702,172.217.194.0-255,1484,73992,65,171950
33635,0.001735,172.31.40.0-255,66,74058,65,171950
33636,0.002118,172.217.194.0-255,1484,75542,65,171950
33637,0.002124,172.217.194.0-255,2902,78444,65,171950
33638,0.002127,172.31.40.0-255,66,78510,65,171950
33639,0.002131,172.217.194.0-255,1484,79994,65,171950
33640,0.00215,172.217.194.0-255,4320,84314,65,171950
33641,0.002152,172.31.40.0-255,66,84380,65,171950
33642,0.002158,172.217.194.0-255,4320,88700,65,171950
33643,0.00216,172.31.40.0-255,66,88766,65,171950
33644,0.002185,172.217.194.0-255,5738,94504,65,171950
33645,0.002188,172.31.40.0-255,66,94570,65,171950
33646,0.002231,172.31.40.0-255,66,94636,65,171950
33647,0.00225,172.217.194.0-255,3602,98238,65,171950
33648,0.002253,172.31.40.0-255,66,98304,65,171950
33649,0.002267,172.217.194.0-255,2902,101206,65,171950
33650,0.002269,172.31.40.0-255,66,101272,65,171950
33651,0.002282,172.217.194.0-255,2902,104174,65,171950
33652,0.002285,172.31.40.0-255,66,104240,65,171950
33653,0.00229,172.217.194.0-255,4320,108560,65,171950
33654,0.002292,172.31.40.0-255,66,108626,65,171950
33655,0.002315,172.217.194.0-255,2902,111528,65,171950
33656,0.002317,172.31.40.0-255,66,111594,65,171950
33657,0.00233,172.217.194.0-255,2902,114496,65,171950
33658,0.002332,172.31.40.0-255,66,114562,65,171950
33659,0.002353,172.217.194.0-255,7156,121718,65,171950
33660,0.002355,172.31.40.0-255,66,121784,65,171950
33661,0.002378,172.217.194.0-255,4320,126104,65,171950
33662,0.002384,172.217.194.0-255,6438,132542,65,171950
33663,0.002388,172.31.40.0-255,66,132608,65,171950
33664,0.002394,172.31.40.0-255,66,132674,65,171950
33665,0.004693,172.217.194.0-255,4320,136994,65,171950
33666,0.004701,172.31.40.0-255,66,137060,65,171950
33667,0.004719,172.217.194.0-255,1484,138544,65,171950
33668,0.006999,172.217.194.0-255,4320,142864,65,171950
33669,0.007004,172.31.40.0-255,66,142930,65,171950
33670,0.009321,172.217.194.0-255,5738,148668,65,171950
33671,0.009328,172.31.40.0-255,66,148734,65,171950
33672,0.011651,172.217.194.0-255,5738,154472,65,171950
33673,0.011669,172.31.40.0-255,66,154538,65,171950
33674,0.014,172.217.194.0-255,5738,160276,65,171950
33675,0.014014,172.31.40.0-255,66,160342,65,171950
33676,0.016325,172.217.194.0-255,5738,166080,65,171950
33677,0.01634,172.31.40.0-255,66,166146,65,171950
33678,0.018633,172.217.194.0-255,5738,171884,65,171950
33679,0.018646,172.31.40.0-255,66,171950,65,171950
33680,0.0,74.125.200.0-255,150,150,65,211627
33681,2.3e-05,172.31.40.0-255,66,216,65,211627
33682,3e-05,74.125.200.0-255,1484,1700,65,211627
33683,3.4e-05,172.31.40.0-255,66,1766,65,211627
33684,3.9e-05,74.125.200.0-255,2902,4668,65,211627
33685,4.2e-05,172.31.40.0-255,66,4734,65,211627
33686,4.8e-05,74.125.200.0-255,7156,11890,65,211627
33687,5.2e-05,172.31.40.0-255,66,11956,65,211627
33688,7.8e-05,74.125.200.0-255,2045,14001,65,211627
33689,8.1e-05,172.31.40.0-255,66,14067,65,211627
33690,0.000119,74.125.200.0-255,1484,15551,65,211627
33691,0.000121,172.31.40.0-255,66,15617,65,211627
33692,0.000137,74.125.200.0-255,2902,18519,65,211627
33693,0.000139,172.31.40.0-255,66,18585,65,211627
33694,0.000141,74.125.200.0-255,1484,20069,65,211627
33695,0.000143,172.31.40.0-255,66,20135,65,211627
33696,0.000169,74.125.200.0-255,4320,24455,65,211627
33697,0.000172,74.125.200.0-255,2902,27357,65,211627
33698,0.000176,74.125.200.0-255,3961,31318,65,211627
33699,0.00018,172.31.40.0-255,66,31384,65,211627
33700,0.000182,172.31.40.0-255,66,31450,65,211627
33701,0.000185,172.31.40.0-255,66,31516,65,211627
33702,0.000826,74.125.200.0-255,1484,33000,65,211627
33703,0.000833,172.31.40.0-255,66,33066,65,211627
33704,0.000842,74.125.200.0-255,2902,35968,65,211627
33705,0.000844,172.31.40.0-255,66,36034,65,211627
33706,0.000867,74.125.200.0-255,1484,37518,65,211627
33707,0.000869,172.31.40.0-255,66,37584,65,211627
33708,0.000889,74.125.200.0-255,2902,40486,65,211627
33709,0.000891,172.31.40.0-255,66,40552,65,211627
33710,0.000894,74.125.200.0-255,1484,42036,65,211627
33711,0.000896,172.31.40.0-255,66,42102,65,211627
33712,0.000918,74.125.200.0-255,4320,46422,65,211627
33713,0.00092,172.31.40.0-255,66,46488,65,211627
33714,0.000925,74.125.200.0-255,3961,50449,65,211627
33715,0.000927,172.31.40.0-255,66,50515,65,211627
33716,0.000966,74.125.200.0-255,4320,54835,65,211627
33717,0.000968,172.31.40.0-255,66,54901,65,211627
33718,0.000979,172.31.40.0-255,66,54967,65,211627
33719,0.000982,74.125.200.0-255,1402,56369,65,211627
33720,0.001057,74.125.200.0-255,380,56749,65,211627
33721,0.001061,172.31.40.0-255,66,56815,65,211627
33722,0.001209,74.125.200.0-255,1484,58299,65,211627
33723,0.001216,74.125.200.0-255,2902,61201,65,211627
33724,0.00122,172.31.40.0-255,66,61267,65,211627
33725,0.001224,74.125.200.0-255,1484,62751,65,211627
33726,0.001248,74.125.200.0-255,2902,65653,65,211627
33727,0.001252,172.31.40.0-255,66,65719,65,211627
33728,0.001257,74.125.200.0-255,4320,70039,65,211627
33729,0.00126,172.31.40.0-255,66,70105,65,211627
33730,0.001275,74.125.200.0-255,1484,71589,65,211627
33731,0.001281,74.125.200.0-255,2902,74491,65,211627
33732,0.001283,172.31.40.0-255,66,74557,65,211627
33733,0.001288,74.125.200.0-255,4320,78877,65,211627
33734,0.001291,172.31.40.0-255,66,78943,65,211627
33735,0.001325,172.31.40.0-255,66,79009,65,211627
33736,0.00133,74.125.200.0-255,3602,82611,65,211627
33737,0.001333,172.31.40.0-255,66,82677,65,211627
33738,0.001424,74.125.200.0-255,1484,84161,65,211627
33739,0.001429,74.125.200.0-255,1484,85645,65,211627
33740,0.001432,172.31.40.0-255,66,85711,65,211627
33741,0.001449,74.125.200.0-255,1484,87195,65,211627
33742,0.001456,74.125.200.0-255,5738,92933,65,211627
33743,0.001459,172.31.40.0-255,66,92999,65,211627
33744,0.001494,172.31.40.0-255,66,93065,65,211627
33745,0.001512,74.125.200.0-255,1484,94549,65,211627
33746,0.001527,172.31.40.0-255,66,94615,65,211627
33747,0.001676,74.125.200.0-255,1484,96099,65,211627
33748,0.001684,74.125.200.0-255,2902,99001,65,211627
33749,0.001687,172.31.40.0-255,66,99067,65,211627
33750,0.001694,74.125.200.0-255,4320,103387,65,211627
33751,0.001697,172.31.40.0-255,66,103453,65,211627
33752,0.001719,74.125.200.0-255,1484,104937,65,211627
33753,0.001753,172.31.40.0-255,66,105003,65,211627
33754,0.001779,74.125.200.0-255,1484,106487,65,211627
33755,0.001808,172.31.40.0-255,66,106553,65,211627
33756,0.001848,74.125.200.0-255,1484,108037,65,211627
33757,0.001853,74.125.200.0-255,2902,110939,65,211627
33758,0.001856,172.31.40.0-255,66,111005,65,211627
33759,0.001861,74.125.200.0-255,2902,113907,65,211627
33760,0.001864,172.31.40.0-255,66,113973,65,211627
33761,0.001879,74.125.200.0-255,2902,116875,65,211627
33762,0.001882,172.31.40.0-255,66,116941,65,211627
33763,0.001886,74.125.200.0-255,2902,119843,65,211627
33764,0.001888,172.31.40.0-255,66,119909,65,211627
33765,0.001902,74.125.200.0-255,1484,121393,65,211627
33766,0.001909,74.125.200.0-255,5738,127131,65,211627
33767,0.001911,172.31.40.0-255,66,127197,65,211627
33768,0.001949,172.31.40.0-255,66,127263,65,211627
33769,0.002016,172.31.40.0-255,66,127329,65,211627
33770,0.002028,172.31.40.0-255,66,127395,65,211627
33771,0.002033,74.125.200.0-255,4320,131715,65,211627
33772,0.002035,172.31.40.0-255,66,131781,65,211627
33773,0.002062,74.125.200.0-255,5738,137519,65,211627
33774,0.002066,172.31.40.0-255,66,137585,65,211627
33775,0.002084,74.125.200.0-255,1484,139069,65,211627
33776,0.002115,172.31.40.0-255,66,139135,65,211627
33777,0.002182,74.125.200.0-255,1484,140619,65,211627
33778,0.002196,74.125.200.0-255,2902,143521,65,211627
33779,0.002198,172.31.40.0-255,66,143587,65,211627
33780,0.00222,74.125.200.0-255,5738,149325,65,211627
33781,0.002223,172.31.40.0-255,66,149391,65,211627
33782,0.002238,74.125.200.0-255,2902,152293,65,211627
33783,0.002241,172.31.40.0-255,66,152359,65,211627
33784,0.00227,74.125.200.0-255,5738,158097,65,211627
33785,0.002273,172.31.40.0-255,66,158163,65,211627
33786,0.002285,172.31.40.0-255,66,158229,65,211627
33787,0.002291,74.125.200.0-255,5020,163249,65,211627
33788,0.002293,172.31.40.0-255,66,163315,65,211627
33789,0.002333,74.125.200.0-255,1484,164799,65,211627
33790,0.002336,74.125.200.0-255,1484,166283,65,211627
33791,0.002338,172.31.40.0-255,66,166349,65,211627
33792,0.002355,74.125.200.0-255,1484,167833,65,211627
33793,0.002359,74.125.200.0-255,2902,170735,65,211627
33794,0.002362,172.31.40.0-255,66,170801,65,211627
33795,0.004659,74.125.200.0-255,1484,172285,65,211627
33796,0.004684,74.125.200.0-255,1484,173769,65,211627
33797,0.004687,172.31.40.0-255,66,173835,65,211627
33798,0.004706,74.125.200.0-255,2902,176737,65,211627
33799,0.004708,172.31.40.0-255,66,176803,65,211627
33800,0.007075,74.125.200.0-255,5738,182541,65,211627
33801,0.007085,172.31.40.0-255,66,182607,65,211627
33802,0.009443,74.125.200.0-255,5738,188345,65,211627
33803,0.009467,172.31.40.0-255,66,188411,65,211627
33804,0.011843,74.125.200.0-255,5738,194149,65,211627
33805,0.011862,172.31.40.0-255,66,194215,65,211627
33806,0.014194,74.125.200.0-255,5738,199953,65,211627
33807,0.014202,172.31.40.0-255,66,200019,65,211627
33808,0.016569,74.125.200.0-255,5738,205757,65,211627
33809,0.016586,172.31.40.0-255,66,205823,65,211627
33810,0.018933,74.125.200.0-255,5738,211561,65,211627
33811,0.01894,172.31.40.0-255,66,211627,65,211627
33812,0.0,172.31.40.0-255,105,105,65,459
33813,0.000297,172.31.40.0-255,90,195,65,459
33814,0.000308,172.31.40.0-255,66,261,65,459
33815,0.00262,74.125.24.0-255,66,327,65,459
33816,0.002643,74.125.24.0-255,66,393,65,459
33817,0.002659,172.31.40.0-255,66,459,65,459
33818,0.0,74.125.24.0-255,153,153,65,157895
33819,2.1e-05,172.31.40.0-255,66,219,65,157895
33820,2.9e-05,74.125.24.0-255,1484,1703,65,157895
33821,3.3e-05,172.31.40.0-255,66,1769,65,157895
33822,4.2e-05,74.125.24.0-255,2902,4671,65,157895
33823,4.8e-05,172.31.40.0-255,66,4737,65,157895
33824,7.1e-05,74.125.24.0-255,5738,10475,65,157895
33825,7.4e-05,172.31.40.0-255,66,10541,65,157895
33826,9.7e-05,74.125.24.0-255,4320,14861,65,157895
33827,0.0001,172.31.40.0-255,66,14927,65,157895
33828,0.000129,74.125.24.0-255,6280,21207,65,157895
33829,0.000131,172.31.40.0-255,66,21273,65,157895
33830,0.000144,172.31.40.0-255,66,21339,65,157895
33831,0.000146,74.125.24.0-255,1484,22823,65,157895
33832,0.000148,172.31.40.0-255,66,22889,65,157895
33833,0.000185,172.31.40.0-255,66,22955,65,157895
33834,0.000196,74.125.24.0-255,1484,24439,65,157895
33835,0.000199,172.31.40.0-255,66,24505,65,157895
33836,0.000222,74.125.24.0-255,7156,31661,65,157895
33837,0.000225,172.31.40.0-255,66,31727,65,157895
33838,0.000273,74.125.24.0-255,5738,37465,65,157895
33839,0.000276,172.31.40.0-255,66,37531,65,157895
33840,0.000307,74.125.24.0-255,2882,40413,65,157895
33841,0.000309,172.31.40.0-255,66,40479,65,157895
33842,0.001155,74.125.24.0-255,1484,41963,65,157895
33843,0.001158,172.31.40.0-255,66,42029,65,157895
33844,0.001164,74.125.24.0-255,2902,44931,65,157895
33845,0.001166,172.31.40.0-255,66,44997,65,157895
33846,0.001186,74.125.24.0-255,5738,50735,65,157895
33847,0.001188,172.31.40.0-255,66,50801,65,157895
33848,0.001227,74.125.24.0-255,5738,56539,65,157895
33849,0.001229,172.31.40.0-255,66,56605,65,157895
33850,0.001258,74.125.24.0-255,7156,63761,65,157895
33851,0.00126,172.31.40.0-255,66,63827,65,157895
33852,0.001267,74.125.24.0-255,7156,70983,65,157895
33853,0.001269,172.31.40.0-255,66,71049,65,157895
33854,0.001274,74.125.24.0-255,3602,74651,65,157895
33855,0.001276,172.31.40.0-255,66,74717,65,157895
33856,0.0015,74.125.24.0-255,1484,76201,65,157895
33857,0.001506,74.125.24.0-255,2902,79103,65,157895
33858,0.001509,172.31.40.0-255,66,79169,65,157895
33859,0.001512,74.125.24.0-255,1484,80653,65,157895
33860,0.001532,74.125.24.0-255,4320,84973,65,157895
33861,0.001534,172.31.40.0-255,66,85039,65,157895
33862,0.001565,74.125.24.0-255,4320,89359,65,157895
33863,0.001567,172.31.40.0-255,66,89425,65,157895
33864,0.001591,172.31.40.0-255,66,89491,65,157895
33865,0.001605,74.125.24.0-255,4320,93811,65,157895
33866,0.001607,172.31.40.0-255,66,93877,65,157895
33867,0.001644,172.31.40.0-255,66,93943,65,157895
33868,0.001656,172.31.40.0-255,66,94009,65,157895
33869,0.001672,74.125.24.0-255,5738,99747,65,157895
33870,0.001674,172.31.40.0-255,66,99813,65,157895
33871,0.001679,74.125.24.0-255,2902,102715,65,157895
33872,0.001681,172.31.40.0-255,66,102781,65,157895
33873,0.001711,172.31.40.0-255,66,102847,65,157895
33874,0.001756,74.125.24.0-255,1484,104331,65,157895
33875,0.001851,74.125.24.0-255,6438,110769,65,157895
33876,0.001881,74.125.24.0-255,2184,112953,65,157895
33877,0.001905,74.125.24.0-255,5738,118691,65,157895
33878,0.001918,74.125.24.0-255,1484,120175,65,157895
33879,0.001936,74.125.24.0-255,1484,121659,65,157895
33880,0.001952,74.125.24.0-255,7156,128815,65,157895
33881,0.002016,74.125.24.0-255,2184,130999,65,157895
33882,0.002048,74.125.24.0-255,2902,133901,65,157895
33883,0.002062,74.125.24.0-255,7156,141057,65,157895
33884,0.002082,74.125.24.0-255,5738,146795,65,157895
33885,0.002098,74.125.24.0-255,5738,152533,65,157895
33886,0.002119,74.125.24.0-255,5020,157553,65,157895
33887,0.002245,74.125.24.0-255,105,157658,65,157895
33888,0.002588,172.31.40.0-255,66,157724,65,157895
33889,0.005436,172.31.40.0-255,105,157829,65,157895
33890,0.007677,74.125.24.0-255,66,157895,65,157895
33891,0.0,172.217.194.0-255,163,163,65,193513
33892,2.3e-05,172.31.40.0-255,66,229,65,193513
33893,3e-05,172.217.194.0-255,1484,1713,65,193513
33894,3.4e-05,172.31.40.0-255,66,1779,65,193513
33895,4e-05,172.217.194.0-255,2902,4681,65,193513
33896,5e-05,172.31.40.0-255,66,4747,65,193513
33897,5.7e-05,172.217.194.0-255,5738,10485,65,193513
33898,6.1e-05,172.31.40.0-255,66,10551,65,193513
33899,6.6e-05,172.217.194.0-255,3358,13909,65,193513
33900,6.9e-05,172.31.40.0-255,66,13975,65,193513
33901,0.000282,172.217.194.0-255,1484,15459,65,193513
33902,0.000288,172.31.40.0-255,66,15525,65,193513
33903,0.000294,172.217.194.0-255,2902,18427,65,193513
33904,0.000296,172.31.40.0-255,66,18493,65,193513
33905,0.000308,172.217.194.0-255,5738,24231,65,193513
33906,0.000311,172.31.40.0-255,66,24297,65,193513
33907,0.000351,172.217.194.0-255,6797,31094,65,193513
33908,0.000355,172.31.40.0-255,66,31160,65,193513
33909,0.000415,172.217.194.0-255,1484,32644,65,193513
33910,0.000417,172.31.40.0-255,66,32710,65,193513
33911,0.000423,172.217.194.0-255,2902,35612,65,193513
33912,0.000424,172.31.40.0-255,66,35678,65,193513
33913,0.000458,172.217.194.0-255,5738,41416,65,193513
33914,0.000461,172.31.40.0-255,66,41482,65,193513
33915,0.000465,172.217.194.0-255,1484,42966,65,193513
33916,0.000467,172.31.40.0-255,66,43032,65,193513
33917,0.000505,172.31.40.0-255,66,43098,65,193513
33918,0.000517,172.31.40.0-255,66,43164,65,193513
33919,0.000522,172.217.194.0-255,3961,47125,65,193513
33920,0.000524,172.31.40.0-255,66,47191,65,193513
33921,0.000807,172.217.194.0-255,363,47554,65,193513
33922,0.000879,172.217.194.0-255,1484,49038,65,193513
33923,0.000884,172.31.40.0-255,66,49104,65,193513
33924,0.000889,172.217.194.0-255,2902,52006,65,193513
33925,0.000891,172.31.40.0-255,66,52072,65,193513
33926,0.000902,172.217.194.0-255,5738,57810,65,193513
33927,0.000904,172.31.40.0-255,66,57876,65,193513
33928,0.000945,172.31.40.0-255,66,57942,65,193513
33929,0.000957,172.31.40.0-255,66,58008,65,193513
33930,0.000964,172.217.194.0-255,381,58389,65,193513
33931,0.001325,172.217.194.0-255,1484,59873,65,193513
33932,0.00133,172.31.40.0-255,66,59939,65,193513
33933,0.001335,172.217.194.0-255,2902,62841,65,193513
33934,0.001338,172.31.40.0-255,66,62907,65,193513
33935,0.001372,172.217.194.0-255,5738,68645,65,193513
33936,0.001379,172.217.194.0-255,7156,75801,65,193513
33937,0.001383,172.31.40.0-255,66,75867,65,193513
33938,0.001389,172.31.40.0-255,66,75933,65,193513
33939,0.001396,172.217.194.0-255,5738,81671,65,193513
33940,0.001403,172.31.40.0-255,66,81737,65,193513
33941,0.001415,172.31.40.0-255,66,81803,65,193513
33942,0.001727,172.217.194.0-255,1484,83287,65,193513
33943,0.001731,172.217.194.0-255,1484,84771,65,193513
33944,0.001734,172.31.40.0-255,66,84837,65,193513
33945,0.001762,172.217.194.0-255,1484,86321,65,193513
33946,0.001769,172.217.194.0-255,5738,92059,65,193513
33947,0.001771,172.217.194.0-255,1484,93543,65,193513
33948,0.001783,172.31.40.0-255,66,93609,65,193513
33949,0.001786,172.31.40.0-255,66,93675,65,193513
33950,0.001809,172.217.194.0-255,4320,97995,65,193513
33951,0.001811,172.31.40.0-255,66,98061,65,193513
33952,0.00185,172.31.40.0-255,66,98127,65,193513
33953,0.00187,172.31.40.0-255,66,98193,65,193513
33954,0.001884,172.31.40.0-255,66,98259,65,193513
33955,0.001921,172.217.194.0-255,5020,103279,65,193513
33956,0.001924,172.31.40.0-255,66,103345,65,193513
33957,0.00196,172.217.194.0-255,1484,104829,65,193513
33958,0.001981,172.217.194.0-255,2902,107731,65,193513
33959,0.001985,172.31.40.0-255,66,107797,65,193513
33960,0.00199,172.217.194.0-255,2902,110699,65,193513
33961,0.001992,172.31.40.0-255,66,110765,65,193513
33962,0.00202,172.217.194.0-255,2902,113667,65,193513
33963,0.002023,172.31.40.0-255,66,113733,65,193513
33964,0.002026,172.217.194.0-255,1484,115217,65,193513
33965,0.002044,172.31.40.0-255,66,115283,65,193513
33966,0.002083,172.31.40.0-255,66,115349,65,193513
33967,0.002108,172.217.194.0-255,1484,116833,65,193513
33968,0.002112,172.217.194.0-255,2902,119735,65,193513
33969,0.002115,172.31.40.0-255,66,119801,65,193513
33970,0.002142,172.217.194.0-255,5738,125539,65,193513
33971,0.002149,172.31.40.0-255,66,125605,65,193513
33972,0.002177,172.31.40.0-255,66,125671,65,193513
33973,0.002207,172.217.194.0-255,2902,128573,65,193513
33974,0.00221,172.31.40.0-255,66,128639,65,193513
33975,0.002228,172.31.40.0-255,66,128705,65,193513
33976,0.002255,172.217.194.0-255,2902,131607,65,193513
33977,0.002257,172.31.40.0-255,66,131673,65,193513
33978,0.002283,172.217.194.0-255,2902,134575,65,193513
33979,0.002286,172.31.40.0-255,66,134641,65,193513
33980,0.002293,172.217.194.0-255,7156,141797,65,193513
33981,0.002296,172.31.40.0-255,66,141863,65,193513
33982,0.002314,172.31.40.0-255,66,141929,65,193513
33983,0.002322,172.217.194.0-255,6438,148367,65,193513
33984,0.002324,172.31.40.0-255,66,148433,65,193513
33985,0.002329,172.217.194.0-255,4320,152753,65,193513
33986,0.002332,172.31.40.0-255,66,152819,65,193513
33987,0.004627,172.217.194.0-255,1484,154303,65,193513
33988,0.004655,172.217.194.0-255,4320,158623,65,193513
33989,0.004661,172.31.40.0-255,66,158689,65,193513
33990,0.006998,172.217.194.0-255,5738,164427,65,193513
33991,0.007013,172.31.40.0-255,66,164493,65,193513
33992,0.00935,172.217.194.0-255,5738,170231,65,193513
33993,0.009361,172.31.40.0-255,66,170297,65,193513
33994,0.011679,172.217.194.0-255,5738,176035,65,193513
33995,0.011683,172.31.40.0-255,66,176101,65,193513
33996,0.013969,172.217.194.0-255,5738,181839,65,193513
33997,0.013976,172.31.40.0-255,66,181905,65,193513
33998,0.016291,172.217.194.0-255,5738,187643,65,193513
33999,0.016305,172.31.40.0-255,66,187709,65,193513
34000,0.018594,172.217.194.0-255,5738,193447,65,193513
34001,0.018601,172.31.40.0-255,66,193513,65,193513
34002,0.0,74.125.24.0-255,297,297,65,161452
34003,2.3e-05,172.31.40.0-255,66,363,65,161452
34004,3e-05,74.125.24.0-255,1484,1847,65,161452
34005,3.5e-05,172.31.40.0-255,66,1913,65,161452
34006,4.3e-05,74.125.24.0-255,4320,6233,65,161452
34007,4.7e-05,172.31.40.0-255,66,6299,65,161452
34008,6.8e-05,172.31.40.0-255,66,6365,65,161452
34009,7.4e-05,74.125.24.0-255,5738,12103,65,161452
34010,7.8e-05,172.31.40.0-255,66,12169,65,161452
34011,0.0001,74.125.24.0-255,2902,15071,65,161452
34012,0.000103,172.31.40.0-255,66,15137,65,161452
34013,0.00013,172.31.40.0-255,66,15203,65,161452
34014,0.000965,74.125.24.0-255,1484,16687,65,161452
34015,0.000972,172.31.40.0-255,66,16753,65,161452
34016,0.000982,74.125.24.0-255,2902,19655,65,161452
34017,0.000984,172.31.40.0-255,66,19721,65,161452
34018,0.000997,74.125.24.0-255,5738,25459,65,161452
34019,0.001,172.31.40.0-255,66,25525,65,161452
34020,0.001015,74.125.24.0-255,4320,29845,65,161452
34021,0.001018,172.31.40.0-255,66,29911,65,161452
34022,0.001051,74.125.24.0-255,5379,35290,65,161452
34023,0.001053,172.31.40.0-255,66,35356,65,161452
34024,0.001065,172.31.40.0-255,66,35422,65,161452
34025,0.001071,74.125.24.0-255,4234,39656,65,161452
34026,0.001074,172.31.40.0-255,66,39722,65,161452
34027,0.001467,74.125.24.0-255,381,40103,65,161452
34028,0.001474,172.31.40.0-255,66,40169,65,161452
34029,0.001503,74.125.24.0-255,1484,41653,65,161452
34030,0.001506,172.31.40.0-255,66,41719,65,161452
34031,0.001513,74.125.24.0-255,4320,46039,65,161452
34032,0.001517,172.31.40.0-255,66,46105,65,161452
34033,0.00152,74.125.24.0-255,1484,47589,65,161452
34034,0.00156,74.125.24.0-255,5738,53327,65,161452
34035,0.001564,172.31.40.0-255,66,53393,65,161452
34036,0.001594,74.125.24.0-255,3961,57354,65,161452
34037,0.001597,172.31.40.0-255,66,57420,65,161452
34038,0.001676,74.125.24.0-255,1484,58904,65,161452
34039,0.001693,74.125.24.0-255,2902,61806,65,161452
34040,0.001698,172.31.40.0-255,66,61872,65,161452
34041,0.001706,74.125.24.0-255,5738,67610,65,161452
34042,0.001708,172.31.40.0-255,66,67676,65,161452
34043,0.001732,74.125.24.0-255,4320,71996,65,161452
34044,0.001735,172.31.40.0-255,66,72062,65,161452
34045,0.00176,74.125.24.0-255,3961,76023,65,161452
34046,0.001763,172.31.40.0-255,66,76089,65,161452
34047,0.001771,74.125.24.0-255,7156,83245,65,161452
34048,0.001774,172.31.40.0-255,66,83311,65,161452
34049,0.001806,74.125.24.0-255,1484,84795,65,161452
34050,0.00181,74.125.24.0-255,1484,86279,65,161452
34051,0.001813,172.31.40.0-255,66,86345,65,161452
34052,0.001849,172.31.40.0-255,66,86411,65,161452
34053,0.001864,172.31.40.0-255,66,86477,65,161452
34054,0.001888,74.125.24.0-255,2184,88661,65,161452
34055,0.00189,172.31.40.0-255,66,88727,65,161452
34056,0.001919,74.125.24.0-255,1484,90211,65,161452
34057,0.001928,74.125.24.0-255,2902,93113,65,161452
34058,0.001931,172.31.40.0-255,66,93179,65,161452
34059,0.001938,74.125.24.0-255,5738,98917,65,161452
34060,0.00194,172.31.40.0-255,66,98983,65,161452
34061,0.001995,172.31.40.0-255,66,99049,65,161452
34062,0.002002,74.125.24.0-255,5738,104787,65,161452
34063,0.002004,172.31.40.0-255,66,104853,65,161452
34064,0.002026,74.125.24.0-255,2902,107755,65,161452
34065,0.002029,172.31.40.0-255,66,107821,65,161452
34066,0.002033,74.125.24.0-255,2184,110005,65,161452
34067,0.002036,172.31.40.0-255,66,110071,65,161452
34068,0.002132,74.125.24.0-255,1484,111555,65,161452
34069,0.002151,74.125.24.0-255,2902,114457,65,161452
34070,0.002155,172.31.40.0-255,66,114523,65,161452
34071,0.002162,74.125.24.0-255,5738,120261,65,161452
34072,0.002164,172.31.40.0-255,66,120327,65,161452
34073,0.002199,172.31.40.0-255,66,120393,65,161452
34074,0.002241,172.31.40.0-255,66,120459,65,161452
34075,0.002281,172.31.40.0-255,66,120525,65,161452
34076,0.002292,172.31.40.0-255,66,120591,65,161452
34077,0.002367,172.31.40.0-255,66,120657,65,161452
34078,0.004667,74.125.24.0-255,5738,126395,65,161452
34079,0.004671,172.31.40.0-255,66,126461,65,161452
34080,0.006857,172.31.40.0-255,101,126562,65,161452
34081,0.006961,74.125.24.0-255,5738,132300,65,161452
34082,0.006965,172.31.40.0-255,66,132366,65,161452
34083,0.009117,74.125.24.0-255,66,132432,65,161452
34084,0.009274,74.125.24.0-255,5738,138170,65,161452
34085,0.009285,172.31.40.0-255,66,138236,65,161452
34086,0.011566,74.125.24.0-255,5738,143974,65,161452
34087,0.011573,172.31.40.0-255,66,144040,65,161452
34088,0.013861,74.125.24.0-255,5738,149778,65,161452
34089,0.013871,172.31.40.0-255,66,149844,65,161452
34090,0.016168,74.125.24.0-255,5738,155582,65,161452
34091,0.016181,172.31.40.0-255,66,155648,65,161452
34092,0.018477,74.125.24.0-255,5738,161386,65,161452
34093,0.018496,172.31.40.0-255,66,161452,65,161452
34094,0.0,172.217.27.0-255,150,150,65,206051
34095,2.5e-05,172.31.40.0-255,66,216,65,206051
34096,3.3e-05,172.217.27.0-255,1484,1700,65,206051
34097,3.8e-05,172.31.40.0-255,66,1766,65,206051
34098,4.4e-05,172.217.27.0-255,2902,4668,65,206051
34099,4.8e-05,172.31.40.0-255,66,4734,65,206051
34100,5.4e-05,172.217.27.0-255,5738,10472,65,206051
34101,5.8e-05,172.31.40.0-255,66,10538,65,206051
34102,6.1e-05,172.217.27.0-255,1484,12022,65,206051
34103,6.4e-05,172.31.40.0-255,66,12088,65,206051
34104,9.8e-05,172.31.40.0-255,66,12154,65,206051
34105,0.000129,172.217.27.0-255,6797,18951,65,206051
34106,0.000131,172.31.40.0-255,66,19017,65,206051
34107,0.000151,172.217.27.0-255,5738,24755,65,206051
34108,0.000153,172.31.40.0-255,66,24821,65,206051
34109,0.000166,172.217.27.0-255,1484,26305,65,206051
34110,0.000169,172.31.40.0-255,66,26371,65,206051
34111,0.000177,172.217.27.0-255,7156,33527,65,206051
34112,0.000179,172.31.40.0-255,66,33593,65,206051
34113,0.000213,172.217.27.0-255,2543,36136,65,206051
34114,0.000215,172.31.40.0-255,66,36202,65,206051
34115,0.000241,172.217.27.0-255,2902,39104,65,206051
34116,0.000243,172.31.40.0-255,66,39170,65,206051
34117,0.000247,172.217.27.0-255,1484,40654,65,206051
34118,0.000248,172.31.40.0-255,66,40720,65,206051
34119,0.000269,172.217.27.0-255,5738,46458,65,206051
34120,0.000271,172.31.40.0-255,66,46524,65,206051
34121,0.000276,172.217.27.0-255,4320,50844,65,206051
34122,0.000279,172.31.40.0-255,66,50910,65,206051
34123,0.000314,172.217.27.0-255,2835,53745,65,206051
34124,0.000317,172.31.40.0-255,66,53811,65,206051
34125,0.000633,172.217.27.0-255,385,54196,65,206051
34126,0.000722,172.217.27.0-255,1484,55680,65,206051
34127,0.000726,172.31.40.0-255,66,55746,65,206051
34128,0.000732,172.217.27.0-255,2902,58648,65,206051
34129,0.000735,172.31.40.0-255,66,58714,65,206051
34130,0.00074,172.217.27.0-255,2902,61616,65,206051
34131,0.000743,172.31.40.0-255,66,61682,65,206051
34132,0.000759,172.217.27.0-255,2902,64584,65,206051
34133,0.000761,172.31.40.0-255,66,64650,65,206051
34134,0.000789,172.217.27.0-255,6248,70898,65,206051
34135,0.000799,172.31.40.0-255,66,70964,65,206051
34136,0.000849,172.217.27.0-255,1484,72448,65,206051
34137,0.000885,172.217.27.0-255,1484,73932,65,206051
34138,0.000888,172.31.40.0-255,66,73998,65,206051
34139,0.000904,172.217.27.0-255,1484,75482,65,206051
34140,0.000911,172.217.27.0-255,5738,81220,65,206051
34141,0.000914,172.31.40.0-255,66,81286,65,206051
34142,0.000919,172.217.27.0-255,4320,85606,65,206051
34143,0.000921,172.31.40.0-255,66,85672,65,206051
34144,0.000926,172.217.27.0-255,2543,88215,65,206051
34145,0.000928,172.31.40.0-255,66,88281,65,206051
34146,0.000983,172.217.27.0-255,1484,89765,65,206051
34147,0.000997,172.217.27.0-255,2902,92667,65,206051
34148,0.001001,172.31.40.0-255,66,92733,65,206051
34149,0.001009,172.217.27.0-255,1484,94217,65,206051
34150,0.001023,172.217.27.0-255,4320,98537,65,206051
34151,0.001026,172.31.40.0-255,66,98603,65,206051
34152,0.001058,172.31.40.0-255,66,98669,65,206051
34153,0.001083,172.217.27.0-255,2902,101571,65,206051
34154,0.001086,172.31.40.0-255,66,101637,65,206051
34155,0.001108,172.31.40.0-255,66,101703,65,206051
34156,0.001265,172.217.27.0-255,1484,103187,65,206051
34157,0.001271,172.217.27.0-255,2902,106089,65,206051
34158,0.001274,172.31.40.0-255,66,106155,65,206051
34159,0.001279,172.217.27.0-255,2902,109057,65,206051
34160,0.001281,172.31.40.0-255,66,109123,65,206051
34161,0.001303,172.217.27.0-255,4320,113443,65,206051
34162,0.001306,172.31.40.0-255,66,113509,65,206051
34163,0.001317,172.31.40.0-255,66,113575,65,206051
34164,0.001356,172.31.40.0-255,66,113641,65,206051
34165,0.001371,172.217.27.0-255,2184,115825,65,206051
34166,0.001374,172.31.40.0-255,66,115891,65,206051
34167,0.001517,172.217.27.0-255,1484,117375,65,206051
34168,0.001522,172.217.27.0-255,2902,120277,65,206051
34169,0.001527,172.31.40.0-255,66,120343,65,206051
34170,0.001547,172.217.27.0-255,2902,123245,65,206051
34171,0.001551,172.31.40.0-255,66,123311,65,206051
34172,0.001556,172.217.27.0-255,4320,127631,65,206051
34173,0.001558,172.31.40.0-255,66,127697,65,206051
34174,0.001561,172.217.27.0-255,1484,129181,65,206051
34175,0.001591,172.217.27.0-255,7156,136337,65,206051
34176,0.00161,172.217.27.0-255,5738,142075,65,206051
34177,0.001621,172.31.40.0-255,66,142141,65,206051
34178,0.001641,172.31.40.0-255,66,142207,65,206051
34179,0.003288,172.217.27.0-255,5738,147945,65,206051
34180,0.003299,172.31.40.0-255,66,148011,65,206051
34181,0.004934,172.217.27.0-255,5738,153749,65,206051
34182,0.004939,172.31.40.0-255,66,153815,65,206051
34183,0.006591,172.217.27.0-255,5738,159553,65,206051
34184,0.006598,172.31.40.0-255,66,159619,65,206051
34185,0.008244,172.217.27.0-255,5738,165357,65,206051
34186,0.00825,172.31.40.0-255,66,165423,65,206051
34187,0.009899,172.217.27.0-255,5738,171161,65,206051
34188,0.009906,172.31.40.0-255,66,171227,65,206051
34189,0.011556,172.217.27.0-255,5738,176965,65,206051
34190,0.011565,172.31.40.0-255,66,177031,65,206051
34191,0.013216,172.217.27.0-255,5738,182769,65,206051
34192,0.013226,172.31.40.0-255,66,182835,65,206051
34193,0.01488,172.217.27.0-255,5738,188573,65,206051
34194,0.014887,172.31.40.0-255,66,188639,65,206051
34195,0.016548,172.217.27.0-255,5738,194377,65,206051
34196,0.016555,172.31.40.0-255,66,194443,65,206051
34197,0.018208,172.217.27.0-255,5738,200181,65,206051
34198,0.018222,172.31.40.0-255,66,200247,65,206051
34199,0.019876,172.217.27.0-255,5738,205985,65,206051
34200,0.019894,172.31.40.0-255,66,206051,65,206051
34201,0.0,172.217.194.0-255,156,156,65,107108
34202,1.7e-05,172.31.40.0-255,66,222,65,107108
34203,2.3e-05,172.217.194.0-255,1484,1706,65,107108
34204,2.8e-05,172.31.40.0-255,66,1772,65,107108
34205,3.3e-05,172.217.194.0-255,2902,4674,65,107108
34206,3.6e-05,172.31.40.0-255,66,4740,65,107108
34207,4.1e-05,172.217.194.0-255,2902,7642,65,107108
34208,4.3e-05,172.31.40.0-255,66,7708,65,107108
34209,6.5e-05,172.217.194.0-255,2902,10610,65,107108
34210,6.8e-05,172.31.40.0-255,66,10676,65,107108
34211,7.2e-05,172.217.194.0-255,2902,13578,65,107108
34212,7.4e-05,172.31.40.0-255,66,13644,65,107108
34213,9.9e-05,172.217.194.0-255,555,14199,65,107108
34214,0.0001,172.31.40.0-255,66,14265,65,107108
34215,0.000241,172.217.194.0-255,1484,15749,65,107108
34216,0.000245,172.31.40.0-255,66,15815,65,107108
34217,0.00025,172.217.194.0-255,2902,18717,65,107108
34218,0.000253,172.31.40.0-255,66,18783,65,107108
34219,0.000255,172.217.194.0-255,1484,20267,65,107108
34220,0.000257,172.31.40.0-255,66,20333,65,107108
34221,0.000309,172.217.194.0-255,4320,24653,65,107108
34222,0.000312,172.31.40.0-255,66,24719,65,107108
34223,0.000318,172.217.194.0-255,6797,31516,65,107108
34224,0.00032,172.31.40.0-255,66,31582,65,107108
34225,0.000508,172.217.194.0-255,1484,33066,65,107108
34226,0.000511,172.31.40.0-255,66,33132,65,107108
34227,0.000516,172.217.194.0-255,2902,36034,65,107108
34228,0.000518,172.31.40.0-255,66,36100,65,107108
34229,0.000522,172.217.194.0-255,2902,39002,65,107108
34230,0.000524,172.31.40.0-255,66,39068,65,107108
34231,0.000541,172.217.194.0-255,2902,41970,65,107108
34232,0.000543,172.217.194.0-255,1484,43454,65,107108
34233,0.000547,172.31.40.0-255,66,43520,65,107108
34234,0.00057,172.217.194.0-255,5379,48899,65,107108
34235,0.000572,172.31.40.0-255,66,48965,65,107108
34236,0.001911,172.217.194.0-255,1484,50449,65,107108
34237,0.00192,172.217.194.0-255,2902,53351,65,107108
34238,0.001925,172.31.40.0-255,66,53417,65,107108
34239,0.001932,172.217.194.0-255,2902,56319,65,107108
34240,0.001934,172.31.40.0-255,66,56385,65,107108
34241,0.001951,172.217.194.0-255,2902,59287,65,107108
34242,0.001953,172.31.40.0-255,66,59353,65,107108
34243,0.001974,172.217.194.0-255,4320,63673,65,107108
34244,0.001976,172.31.40.0-255,66,63739,65,107108
34245,0.002006,172.217.194.0-255,2543,66282,65,107108
34246,0.002008,172.31.40.0-255,66,66348,65,107108
34247,0.004312,172.217.194.0-255,2902,69250,65,107108
34248,0.004316,172.31.40.0-255,66,69316,65,107108
34249,0.004334,172.217.194.0-255,2902,72218,65,107108
34250,0.004336,172.31.40.0-255,66,72284,65,107108
34251,0.006667,172.217.194.0-255,5738,78022,65,107108
34252,0.006674,172.31.40.0-255,66,78088,65,107108
34253,0.009011,172.217.194.0-255,5738,83826,65,107108
34254,0.009018,172.31.40.0-255,66,83892,65,107108
34255,0.011375,172.217.194.0-255,5738,89630,65,107108
34256,0.011383,172.31.40.0-255,66,89696,65,107108
34257,0.013766,172.217.194.0-255,5738,95434,65,107108
34258,0.013776,172.31.40.0-255,66,95500,65,107108
34259,0.016136,172.217.194.0-255,5738,101238,65,107108
34260,0.016144,172.31.40.0-255,66,101304,65,107108
34261,0.018567,172.217.194.0-255,5738,107042,65,107108
34262,0.018579,172.31.40.0-255,66,107108,65,107108
34263,0.0,74.125.24.0-255,297,297,65,155997
34264,2.2e-05,172.31.40.0-255,66,363,65,155997
34265,2.8e-05,74.125.24.0-255,1484,1847,65,155997
34266,3.2e-05,172.31.40.0-255,66,1913,65,155997
34267,3.8e-05,74.125.24.0-255,4320,6233,65,155997
34268,4.2e-05,172.31.40.0-255,66,6299,65,155997
34269,5.3e-05,172.31.40.0-255,66,6365,65,155997
34270,6e-05,74.125.24.0-255,7156,13521,65,155997
34271,6.2e-05,172.31.40.0-255,66,13587,65,155997
34272,9.5e-05,74.125.24.0-255,7156,20743,65,155997
34273,9.8e-05,172.31.40.0-255,66,20809,65,155997
34274,0.000108,74.125.24.0-255,1125,21934,65,155997
34275,0.00011,172.31.40.0-255,66,22000,65,155997
34276,0.000135,74.125.24.0-255,1484,23484,65,155997
34277,0.000137,172.31.40.0-255,66,23550,65,155997
34278,0.000155,74.125.24.0-255,2902,26452,65,155997
34279,0.000157,172.31.40.0-255,66,26518,65,155997
34280,0.000162,74.125.24.0-255,2902,29420,65,155997
34281,0.000164,172.31.40.0-255,66,29486,65,155997
34282,0.000185,74.125.24.0-255,2902,32388,65,155997
34283,0.000191,74.125.24.0-255,6797,39185,65,155997
34284,0.000193,74.125.24.0-255,1484,40669,65,155997
34285,0.000196,172.31.40.0-255,66,40735,65,155997
34286,0.0002,172.31.40.0-255,66,40801,65,155997
34287,0.000202,172.31.40.0-255,66,40867,65,155997
34288,0.000223,74.125.24.0-255,5738,46605,65,155997
34289,0.000225,172.31.40.0-255,66,46671,65,155997
34290,0.00024,74.125.24.0-255,2902,49573,65,155997
34291,0.000242,172.31.40.0-255,66,49639,65,155997
34292,0.000262,74.125.24.0-255,7137,56776,65,155997
34293,0.000264,172.31.40.0-255,66,56842,65,155997
34294,0.000357,74.125.24.0-255,347,57189,65,155997
34295,0.000887,172.31.40.0-255,66,57255,65,155997
34296,0.001576,74.125.24.0-255,1484,58739,65,155997
34297,0.001585,74.125.24.0-255,2902,61641,65,155997
34298,0.001589,172.31.40.0-255,66,61707,65,155997
34299,0.001597,74.125.24.0-255,5738,67445,65,155997
34300,0.001599,172.31.40.0-255,66,67511,65,155997
34301,0.001621,172.31.40.0-255,66,67577,65,155997
34302,0.001641,74.125.24.0-255,2902,70479,65,155997
34303,0.001644,172.31.40.0-255,66,70545,65,155997
34304,0.001665,74.125.24.0-255,4320,74865,65,155997
34305,0.001667,172.31.40.0-255,66,74931,65,155997
34306,0.001693,172.31.40.0-255,66,74997,65,155997
34307,0.002055,74.125.24.0-255,1484,76481,65,155997
34308,0.002061,74.125.24.0-255,2902,79383,65,155997
34309,0.002063,172.31.40.0-255,66,79449,65,155997
34310,0.00208,74.125.24.0-255,5738,85187,65,155997
34311,0.002082,172.31.40.0-255,66,85253,65,155997
34312,0.002104,74.125.24.0-255,5738,90991,65,155997
34313,0.002106,172.31.40.0-255,66,91057,65,155997
34314,0.002125,74.125.24.0-255,7156,98213,65,155997
34315,0.002126,172.31.40.0-255,66,98279,65,155997
34316,0.002159,172.31.40.0-255,66,98345,65,155997
34317,0.002178,74.125.24.0-255,1484,99829,65,155997
34318,0.002181,74.125.24.0-255,766,100595,65,155997
34319,0.002182,172.31.40.0-255,66,100661,65,155997
34320,0.00227,74.125.24.0-255,1484,102145,65,155997
34321,0.002284,74.125.24.0-255,2902,105047,65,155997
34322,0.002287,172.31.40.0-255,66,105113,65,155997
34323,0.002309,74.125.24.0-255,5738,110851,65,155997
34324,0.002311,172.31.40.0-255,66,110917,65,155997
34325,0.002324,74.125.24.0-255,4320,115237,65,155997
34326,0.002326,172.31.40.0-255,66,115303,65,155997
34327,0.002348,172.31.40.0-255,66,115369,65,155997
34328,0.004662,74.125.24.0-255,5738,121107,65,155997
34329,0.004665,172.31.40.0-255,66,121173,65,155997
34330,0.006969,74.125.24.0-255,5738,126911,65,155997
34331,0.006976,172.31.40.0-255,66,126977,65,155997
34332,0.009289,74.125.24.0-255,5738,132715,65,155997
34333,0.009296,172.31.40.0-255,66,132781,65,155997
34334,0.011594,74.125.24.0-255,5738,138519,65,155997
34335,0.011601,172.31.40.0-255,66,138585,65,155997
34336,0.013912,74.125.24.0-255,5738,144323,65,155997
34337,0.01392,172.31.40.0-255,66,144389,65,155997
34338,0.016243,74.125.24.0-255,5738,150127,65,155997
34339,0.016255,172.31.40.0-255,66,150193,65,155997
34340,0.018555,74.125.24.0-255,5738,155931,65,155997
34341,0.018566,172.31.40.0-255,66,155997,65,155997
34342,0.0,74.125.24.0-255,153,153,65,247683
34343,2.1e-05,172.31.40.0-255,66,219,65,247683
34344,2.8e-05,74.125.24.0-255,1484,1703,65,247683
34345,3.3e-05,172.31.40.0-255,66,1769,65,247683
34346,4.5e-05,74.125.24.0-255,2902,4671,65,247683
34347,4.8e-05,172.31.40.0-255,66,4737,65,247683
34348,5.6e-05,74.125.24.0-255,7156,11893,65,247683
34349,6e-05,172.31.40.0-255,66,11959,65,247683
34350,9.4e-05,74.125.24.0-255,6371,18330,65,247683
34351,9.7e-05,172.31.40.0-255,66,18396,65,247683
34352,0.000104,74.125.24.0-255,7156,25552,65,247683
34353,0.000106,172.31.40.0-255,66,25618,65,247683
34354,0.00014,74.125.24.0-255,5379,30997,65,247683
34355,0.000143,172.31.40.0-255,66,31063,65,247683
34356,0.000243,74.125.24.0-255,1484,32547,65,247683
34357,0.000247,172.31.40.0-255,66,32613,65,247683
34358,0.000252,74.125.24.0-255,2902,35515,65,247683
34359,0.000255,172.31.40.0-255,66,35581,65,247683
34360,0.00029,74.125.24.0-255,5738,41319,65,247683
34361,0.000293,172.31.40.0-255,66,41385,65,247683
34362,0.000299,74.125.24.0-255,6797,48182,65,247683
34363,0.000302,172.31.40.0-255,66,48248,65,247683
34364,0.00032,74.125.24.0-255,1484,49732,65,247683
34365,0.000322,172.31.40.0-255,66,49798,65,247683
34366,0.00036,172.31.40.0-255,66,49864,65,247683
34367,0.000389,74.125.24.0-255,7105,56969,65,247683
34368,0.000392,172.31.40.0-255,66,57035,65,247683
34369,0.000395,74.125.24.0-255,113,57148,65,247683
34370,0.000397,172.31.40.0-255,66,57214,65,247683
34371,0.000533,74.125.24.0-255,1484,58698,65,247683
34372,0.000537,172.31.40.0-255,66,58764,65,247683
34373,0.000543,74.125.24.0-255,2902,61666,65,247683
34374,0.000545,172.31.40.0-255,66,61732,65,247683
34375,0.000556,74.125.24.0-255,5738,67470,65,247683
34376,0.000559,172.31.40.0-255,66,67536,65,247683
34377,0.000565,74.125.24.0-255,4320,71856,65,247683
34378,0.000567,172.31.40.0-255,66,71922,65,247683
34379,0.00061,172.31.40.0-255,66,71988,65,247683
34380,0.000617,74.125.24.0-255,7156,79144,65,247683
34381,0.00062,172.31.40.0-255,66,79210,65,247683
34382,0.000628,74.125.24.0-255,2786,81996,65,247683
34383,0.00063,172.31.40.0-255,66,82062,65,247683
34384,0.001232,74.125.24.0-255,1484,83546,65,247683
34385,0.001239,74.125.24.0-255,1484,85030,65,247683
34386,0.001244,172.31.40.0-255,66,85096,65,247683
34387,0.001249,74.125.24.0-255,2902,87998,65,247683
34388,0.001251,172.31.40.0-255,66,88064,65,247683
34389,0.001284,74.125.24.0-255,5738,93802,65,247683
34390,0.001288,172.31.40.0-255,66,93868,65,247683
34391,0.001316,172.31.40.0-255,66,93934,65,247683
34392,0.001333,74.125.24.0-255,4320,98254,65,247683
34393,0.001336,172.31.40.0-255,66,98320,65,247683
34394,0.001371,172.31.40.0-255,66,98386,65,247683
34395,0.001438,74.125.24.0-255,1484,99870,65,247683
34396,0.001452,74.125.24.0-255,2902,102772,65,247683
34397,0.001455,172.31.40.0-255,66,102838,65,247683
34398,0.001496,74.125.24.0-255,5738,108576,65,247683
34399,0.001501,172.31.40.0-255,66,108642,65,247683
34400,0.001512,172.31.40.0-255,66,108708,65,247683
34401,0.00159,74.125.24.0-255,5738,114446,65,247683
34402,0.001593,172.31.40.0-255,66,114512,65,247683
34403,0.001625,172.31.40.0-255,66,114578,65,247683
34404,0.001768,74.125.24.0-255,1484,116062,65,247683
34405,0.001783,74.125.24.0-255,2902,118964,65,247683
34406,0.001786,172.31.40.0-255,66,119030,65,247683
34407,0.00179,74.125.24.0-255,1484,120514,65,247683
34408,0.001817,74.125.24.0-255,4320,124834,65,247683
34409,0.00182,172.31.40.0-255,66,124900,65,247683
34410,0.001828,74.125.24.0-255,7156,132056,65,247683
34411,0.00183,172.31.40.0-255,66,132122,65,247683
34412,0.001845,172.31.40.0-255,66,132188,65,247683
34413,0.001882,74.125.24.0-255,5738,137926,65,247683
34414,0.001885,172.31.40.0-255,66,137992,65,247683
34415,0.001889,74.125.24.0-255,2184,140176,65,247683
34416,0.00189,172.31.40.0-255,66,140242,65,247683
34417,0.001914,74.125.24.0-255,5738,145980,65,247683
34418,0.001916,172.31.40.0-255,66,146046,65,247683
34419,0.001923,74.125.24.0-255,7156,153202,65,247683
34420,0.001925,172.31.40.0-255,66,153268,65,247683
34421,0.001967,172.31.40.0-255,66,153334,65,247683
34422,0.001973,74.125.24.0-255,6438,159772,65,247683
34423,0.001975,172.31.40.0-255,66,159838,65,247683
34424,0.002061,74.125.24.0-255,1484,161322,65,247683
34425,0.002085,74.125.24.0-255,2902,164224,65,247683
34426,0.002088,172.31.40.0-255,66,164290,65,247683
34427,0.002094,74.125.24.0-255,5738,170028,65,247683
34428,0.002096,172.31.40.0-255,66,170094,65,247683
34429,0.0021,74.125.24.0-255,2902,172996,65,247683
34430,0.002102,172.31.40.0-255,66,173062,65,247683
34431,0.002137,172.31.40.0-255,66,173128,65,247683
34432,0.002158,74.125.24.0-255,5738,178866,65,247683
34433,0.00216,172.31.40.0-255,66,178932,65,247683
34434,0.002187,74.125.24.0-255,5020,183952,65,247683
34435,0.00219,172.31.40.0-255,66,184018,65,247683
34436,0.002235,74.125.24.0-255,1484,185502,65,247683
34437,0.00224,74.125.24.0-255,2902,188404,65,247683
34438,0.002242,172.31.40.0-255,66,188470,65,247683
34439,0.002273,74.125.24.0-255,5738,194208,65,247683
34440,0.002276,172.31.40.0-255,66,194274,65,247683
34441,0.002313,74.125.24.0-255,4320,198594,65,247683
34442,0.002326,172.31.40.0-255,66,198660,65,247683
34443,0.002357,74.125.24.0-255,6438,205098,65,247683
34444,0.002363,172.31.40.0-255,66,205164,65,247683
34445,0.002411,74.125.24.0-255,1484,206648,65,247683
34446,0.002425,74.125.24.0-255,2902,209550,65,247683
34447,0.002428,74.125.24.0-255,1484,211034,65,247683
34448,0.002444,74.125.24.0-255,4320,215354,65,247683
34449,0.002446,172.31.40.0-255,66,215420,65,247683
34450,0.002451,172.31.40.0-255,66,215486,65,247683
34451,0.002465,74.125.24.0-255,5738,221224,65,247683
34452,0.002493,74.125.24.0-255,5738,226962,65,247683
34453,0.002505,172.31.40.0-255,66,227028,65,247683
34454,0.002511,172.31.40.0-255,66,227094,65,247683
34455,0.002579,74.125.24.0-255,7156,234250,65,247683
34456,0.00259,74.125.24.0-255,4320,238570,65,247683
34457,0.002621,172.31.40.0-255,66,238636,65,247683
34458,0.002631,74.125.24.0-255,1484,240120,65,247683
34459,0.002653,74.125.24.0-255,4320,244440,65,247683
34460,0.002662,172.31.40.0-255,66,244506,65,247683
34461,0.002666,74.125.24.0-255,2668,247174,65,247683
34462,0.002673,172.31.40.0-255,66,247240,65,247683
34463,0.003173,172.31.40.0-255,101,247341,65,247683
34464,0.005231,74.125.24.0-255,105,247446,65,247683
34465,0.005748,74.125.24.0-255,66,247512,65,247683
34466,0.013939,172.31.40.0-255,105,247617,65,247683
34467,0.016543,74.125.24.0-255,66,247683,65,247683
34468,0.0,172.217.194.0-255,293,293,65,117791
34469,2.7e-05,172.31.40.0-255,66,359,65,117791
34470,3.4e-05,172.217.194.0-255,1484,1843,65,117791
34471,3.9e-05,172.31.40.0-255,66,1909,65,117791
34472,5.3e-05,172.217.194.0-255,4320,6229,65,117791
34473,5.7e-05,172.31.40.0-255,66,6295,65,117791
34474,6.9e-05,172.31.40.0-255,66,6361,65,117791
34475,0.000105,172.217.194.0-255,4320,10681,65,117791
34476,0.000107,172.31.40.0-255,66,10747,65,117791
34477,0.000137,172.217.194.0-255,4320,15067,65,117791
34478,0.00014,172.31.40.0-255,66,15133,65,117791
34479,0.000165,172.31.40.0-255,66,15199,65,117791
34480,0.000299,172.217.194.0-255,1484,16683,65,117791
34481,0.000303,172.31.40.0-255,66,16749,65,117791
34482,0.000309,172.217.194.0-255,2902,19651,65,117791
34483,0.000312,172.31.40.0-255,66,19717,65,117791
34484,0.000315,172.217.194.0-255,1484,21201,65,117791
34485,0.000317,172.31.40.0-255,66,21267,65,117791
34486,0.000357,172.217.194.0-255,4320,25587,65,117791
34487,0.000361,172.31.40.0-255,66,25653,65,117791
34488,0.000375,172.31.40.0-255,66,25719,65,117791
34489,0.000387,172.31.40.0-255,66,25785,65,117791
34490,0.00042,172.217.194.0-255,361,26146,65,117791
34491,0.000423,172.31.40.0-255,66,26212,65,117791
34492,0.000656,172.217.194.0-255,381,26593,65,117791
34493,0.000662,172.31.40.0-255,66,26659,65,117791
34494,0.001047,172.217.194.0-255,1484,28143,65,117791
34495,0.001054,172.31.40.0-255,66,28209,65,117791
34496,0.00106,172.217.194.0-255,2902,31111,65,117791
34497,0.001062,172.31.40.0-255,66,31177,65,117791
34498,0.001074,172.217.194.0-255,5738,36915,65,117791
34499,0.001077,172.31.40.0-255,66,36981,65,117791
34500,0.001083,172.217.194.0-255,5738,42719,65,117791
34501,0.001086,172.31.40.0-255,66,42785,65,117791
34502,0.001143,172.31.40.0-255,66,42851,65,117791
34503,0.001149,172.217.194.0-255,5020,47871,65,117791
34504,0.001151,172.31.40.0-255,66,47937,65,117791
34505,0.001458,172.217.194.0-255,1484,49421,65,117791
34506,0.001465,172.217.194.0-255,2902,52323,65,117791
34507,0.00147,172.31.40.0-255,66,52389,65,117791
34508,0.001478,172.217.194.0-255,5738,58127,65,117791
34509,0.001481,172.31.40.0-255,66,58193,65,117791
34510,0.001527,172.31.40.0-255,66,58259,65,117791
34511,0.001538,172.31.40.0-255,66,58325,65,117791
34512,0.001557,172.217.194.0-255,766,59091,65,117791
34513,0.00199,172.31.40.0-255,66,59157,65,117791
34514,0.002144,172.217.194.0-255,1484,60641,65,117791
34515,0.002153,172.217.194.0-255,2902,63543,65,117791
34516,0.002156,172.31.40.0-255,66,63609,65,117791
34517,0.002164,172.217.194.0-255,5738,69347,65,117791
34518,0.002165,172.31.40.0-255,66,69413,65,117791
34519,0.00219,172.31.40.0-255,66,69479,65,117791
34520,0.002213,172.217.194.0-255,4320,73799,65,117791
34521,0.002215,172.31.40.0-255,66,73865,65,117791
34522,0.002225,172.31.40.0-255,66,73931,65,117791
34523,0.002278,172.31.40.0-255,66,73997,65,117791
34524,0.002311,172.31.40.0-255,66,74063,65,117791
34525,0.002317,172.217.194.0-255,4320,78383,65,117791
34526,0.002319,172.31.40.0-255,66,78449,65,117791
34527,0.002355,172.31.40.0-255,66,78515,65,117791
34528,0.004764,172.217.194.0-255,5738,84253,65,117791
34529,0.00477,172.31.40.0-255,66,84319,65,117791
34530,0.007157,172.217.194.0-255,5738,90057,65,117791
34531,0.007165,172.31.40.0-255,66,90123,65,117791
34532,0.009553,172.217.194.0-255,4320,94443,65,117791
34533,0.009561,172.31.40.0-255,66,94509,65,117791
34534,0.009589,172.217.194.0-255,1484,95993,65,117791
34535,0.01195,172.217.194.0-255,4320,100313,65,117791
34536,0.011957,172.31.40.0-255,66,100379,65,117791
34537,0.014348,172.217.194.0-255,5738,106117,65,117791
34538,0.014357,172.31.40.0-255,66,106183,65,117791
34539,0.01674,172.217.194.0-255,5738,111921,65,117791
34540,0.016749,172.31.40.0-255,66,111987,65,117791
34541,0.019131,172.217.194.0-255,5738,117725,65,117791
34542,0.01914,172.31.40.0-255,66,117791,65,117791
34543,0.0,172.217.194.0-255,153,153,65,225310
34544,2.4e-05,172.31.40.0-255,66,219,65,225310
34545,3.1e-05,172.217.194.0-255,1484,1703,65,225310
34546,3.6e-05,172.31.40.0-255,66,1769,65,225310
34547,4.1e-05,172.217.194.0-255,2902,4671,65,225310
34548,5.2e-05,172.31.40.0-255,66,4737,65,225310
34549,5.9e-05,172.217.194.0-255,5738,10475,65,225310
34550,6.2e-05,172.31.40.0-255,66,10541,65,225310
34551,9.9e-05,172.217.194.0-255,3420,13961,65,225310
34552,0.000102,172.31.40.0-255,66,14027,65,225310
34553,0.000167,172.217.194.0-255,1484,15511,65,225310
34554,0.00017,172.31.40.0-255,66,15577,65,225310
34555,0.000198,172.217.194.0-255,2902,18479,65,225310
34556,0.000201,172.31.40.0-255,66,18545,65,225310
34557,0.000206,172.217.194.0-255,4320,22865,65,225310
34558,0.000209,172.31.40.0-255,66,22931,65,225310
34559,0.000226,172.217.194.0-255,1484,24415,65,225310
34560,0.00023,172.31.40.0-255,66,24481,65,225310
34561,0.000258,172.217.194.0-255,6797,31278,65,225310
34562,0.000261,172.31.40.0-255,66,31344,65,225310
34563,0.000333,172.217.194.0-255,1484,32828,65,225310
34564,0.000336,172.31.40.0-255,66,32894,65,225310
34565,0.000342,172.217.194.0-255,2902,35796,65,225310
34566,0.000344,172.31.40.0-255,66,35862,65,225310
34567,0.000356,172.217.194.0-255,5738,41600,65,225310
34568,0.000359,172.31.40.0-255,66,41666,65,225310
34569,0.000402,172.31.40.0-255,66,41732,65,225310
34570,0.000439,172.31.40.0-255,66,41798,65,225310
34571,0.000471,172.217.194.0-255,99,41897,65,225310
34572,0.000473,172.31.40.0-255,66,41963,65,225310
34573,0.000513,172.217.194.0-255,364,42327,65,225310
34574,0.000813,172.217.194.0-255,1484,43811,65,225310
34575,0.000818,172.31.40.0-255,66,43877,65,225310
34576,0.000826,172.217.194.0-255,2902,46779,65,225310
34577,0.000828,172.31.40.0-255,66,46845,65,225310
34578,0.00084,172.217.194.0-255,5738,52583,65,225310
34579,0.000843,172.31.40.0-255,66,52649,65,225310
34580,0.000874,172.217.194.0-255,4320,56969,65,225310
34581,0.000877,172.31.40.0-255,66,57035,65,225310
34582,0.000905,172.217.194.0-255,5738,62773,65,225310
34583,0.000907,172.31.40.0-255,66,62839,65,225310
34584,0.000912,172.217.194.0-255,2902,65741,65,225310
34585,0.000918,172.31.40.0-255,66,65807,65,225310
34586,0.000975,172.31.40.0-255,66,65873,65,225310
34587,0.001081,172.217.194.0-255,1484,67357,65,225310
34588,0.001087,172.217.194.0-255,2902,70259,65,225310
34589,0.00109,172.31.40.0-255,66,70325,65,225310
34590,0.00112,172.217.194.0-255,5738,76063,65,225310
34591,0.001124,172.31.40.0-255,66,76129,65,225310
34592,0.001127,172.217.194.0-255,1484,77613,65,225310
34593,0.001158,172.31.40.0-255,66,77679,65,225310
34594,0.00117,172.31.40.0-255,66,77745,65,225310
34595,0.001202,172.217.194.0-255,5020,82765,65,225310
34596,0.001205,172.31.40.0-255,66,82831,65,225310
34597,0.001234,172.217.194.0-255,1484,84315,65,225310
34598,0.001251,172.217.194.0-255,2902,87217,65,225310
34599,0.001254,172.31.40.0-255,66,87283,65,225310
34600,0.001282,172.217.194.0-255,5738,93021,65,225310
34601,0.001285,172.31.40.0-255,66,93087,65,225310
34602,0.001293,172.217.194.0-255,7156,100243,65,225310
34603,0.001295,172.31.40.0-255,66,100309,65,225310
34604,0.001325,172.217.194.0-255,5738,106047,65,225310
34605,0.001327,172.31.40.0-255,66,106113,65,225310
34606,0.001345,172.31.40.0-255,66,106179,65,225310
34607,0.001367,172.217.194.0-255,4320,110499,65,225310
34608,0.001369,172.31.40.0-255,66,110565,65,225310
34609,0.001376,172.217.194.0-255,5738,116303,65,225310
34610,0.001379,172.31.40.0-255,66,116369,65,225310
34611,0.001381,172.217.194.0-255,1484,117853,65,225310
34612,0.001424,172.31.40.0-255,66,117919,65,225310
34613,0.001442,172.31.40.0-255,66,117985,65,225310
34614,0.001568,172.217.194.0-255,1484,119469,65,225310
34615,0.001574,172.217.194.0-255,2902,122371,65,225310
34616,0.001577,172.31.40.0-255,66,122437,65,225310
34617,0.001584,172.217.194.0-255,5738,128175,65,225310
34618,0.001587,172.31.40.0-255,66,128241,65,225310
34619,0.001603,172.31.40.0-255,66,128307,65,225310
34620,0.001637,172.217.194.0-255,4320,132627,65,225310
34621,0.00164,172.31.40.0-255,66,132693,65,225310
34622,0.00166,172.31.40.0-255,66,132759,65,225310
34623,0.001749,172.217.194.0-255,1484,134243,65,225310
34624,0.001755,172.217.194.0-255,2902,137145,65,225310
34625,0.001758,172.31.40.0-255,66,137211,65,225310
34626,0.001769,172.217.194.0-255,1484,138695,65,225310
34627,0.001792,172.217.194.0-255,1484,140179,65,225310
34628,0.001795,172.31.40.0-255,66,140245,65,225310
34629,0.001801,172.217.194.0-255,4320,144565,65,225310
34630,0.001803,172.31.40.0-255,66,144631,65,225310
34631,0.001824,172.31.40.0-255,66,144697,65,225310
34632,0.001829,172.217.194.0-255,2902,147599,65,225310
34633,0.001832,172.31.40.0-255,66,147665,65,225310
34634,0.001915,172.217.194.0-255,4320,151985,65,225310
34635,0.001918,172.31.40.0-255,66,152051,65,225310
34636,0.001945,172.217.194.0-255,6438,158489,65,225310
34637,0.001948,172.31.40.0-255,66,158555,65,225310
34638,0.00197,172.217.194.0-255,1484,160039,65,225310
34639,0.002004,172.217.194.0-255,2902,162941,65,225310
34640,0.002007,172.31.40.0-255,66,163007,65,225310
34641,0.00201,172.217.194.0-255,1484,164491,65,225310
34642,0.002029,172.217.194.0-255,4320,168811,65,225310
34643,0.002032,172.31.40.0-255,66,168877,65,225310
34644,0.002045,172.31.40.0-255,66,168943,65,225310
34645,0.002069,172.217.194.0-255,1484,170427,65,225310
34646,0.002082,172.217.194.0-255,7156,177583,65,225310
34647,0.002085,172.31.40.0-255,66,177649,65,225310
34648,0.002112,172.217.194.0-255,3602,181251,65,225310
34649,0.002114,172.31.40.0-255,66,181317,65,225310
34650,0.002118,172.217.194.0-255,1484,182801,65,225310
34651,0.002141,172.217.194.0-255,2902,185703,65,225310
34652,0.002144,172.31.40.0-255,66,185769,65,225310
34653,0.002152,172.217.194.0-255,7156,192925,65,225310
34654,0.002154,172.31.40.0-255,66,192991,65,225310
34655,0.002173,172.217.194.0-255,2902,195893,65,225310
34656,0.002175,172.31.40.0-255,66,195959,65,225310
34657,0.002179,172.217.194.0-255,2902,198861,65,225310
34658,0.002182,172.31.40.0-255,66,198927,65,225310
34659,0.002196,172.217.194.0-255,2902,201829,65,225310
34660,0.002199,172.31.40.0-255,66,201895,65,225310
34661,0.002236,172.31.40.0-255,66,201961,65,225310
34662,0.00224,172.217.194.0-255,2902,204863,65,225310
34663,0.002242,172.31.40.0-255,66,204929,65,225310
34664,0.002273,172.31.40.0-255,66,204995,65,225310
34665,0.002284,172.217.194.0-255,7156,212151,65,225310
34666,0.002287,172.31.40.0-255,66,212217,65,225310
34667,0.002311,172.217.194.0-255,2902,215119,65,225310
34668,0.002314,172.31.40.0-255,66,215185,65,225310
34669,0.002357,172.217.194.0-255,7156,222341,65,225310
34670,0.002362,172.31.40.0-255,66,222407,65,225310
34671,0.002365,172.31.40.0-255,66,222473,65,225310
34672,0.002395,172.31.40.0-255,66,222539,65,225310
34673,0.002407,172.31.40.0-255,66,222605,65,225310
34674,0.002411,172.217.194.0-255,2534,225139,65,225310
34675,0.002414,172.31.40.0-255,66,225205,65,225310
34676,0.002451,172.217.194.0-255,105,225310,65,225310
34677,0.0,74.125.24.0-255,153,153,65,127050
34678,2.5e-05,172.31.40.0-255,66,219,65,127050
34679,3.2e-05,74.125.24.0-255,1484,1703,65,127050
34680,3.7e-05,172.31.40.0-255,66,1769,65,127050
34681,5e-05,74.125.24.0-255,2902,4671,65,127050
34682,5.4e-05,172.31.40.0-255,66,4737,65,127050
34683,6.1e-05,74.125.24.0-255,5738,10475,65,127050
34684,6.4e-05,172.31.40.0-255,66,10541,65,127050
34685,0.000105,172.31.40.0-255,66,10607,65,127050
34686,0.000113,74.125.24.0-255,6797,17404,65,127050
34687,0.000116,172.31.40.0-255,66,17470,65,127050
34688,0.000171,74.125.24.0-255,1484,18954,65,127050
34689,0.000174,172.31.40.0-255,66,19020,65,127050
34690,0.000179,74.125.24.0-255,2902,21922,65,127050
34691,0.000181,172.31.40.0-255,66,21988,65,127050
34692,0.000189,74.125.24.0-255,5738,27726,65,127050
34693,0.000192,172.31.40.0-255,66,27792,65,127050
34694,0.000198,74.125.24.0-255,4320,32112,65,127050
34695,0.0002,172.31.40.0-255,66,32178,65,127050
34696,0.00024,74.125.24.0-255,2543,34721,65,127050
34697,0.000243,172.31.40.0-255,66,34787,65,127050
34698,0.000251,74.125.24.0-255,7156,41943,65,127050
34699,0.000253,172.31.40.0-255,66,42009,65,127050
34700,0.000265,172.31.40.0-255,66,42075,65,127050
34701,0.000268,74.125.24.0-255,126,42201,65,127050
34702,0.00027,172.31.40.0-255,66,42267,65,127050
34703,0.000356,74.125.24.0-255,353,42620,65,127050
34704,0.000359,172.31.40.0-255,66,42686,65,127050
34705,0.00112,74.125.24.0-255,1484,44170,65,127050
34706,0.001127,172.31.40.0-255,66,44236,65,127050
34707,0.001133,74.125.24.0-255,2902,47138,65,127050
34708,0.001135,172.31.40.0-255,66,47204,65,127050
34709,0.001142,74.125.24.0-255,5738,52942,65,127050
34710,0.001149,172.31.40.0-255,66,53008,65,127050
34711,0.001203,172.31.40.0-255,66,53074,65,127050
34712,0.001216,172.31.40.0-255,66,53140,65,127050
34713,0.001856,74.125.24.0-255,1484,54624,65,127050
34714,0.001868,74.125.24.0-255,2902,57526,65,127050
34715,0.001873,172.31.40.0-255,66,57592,65,127050
34716,0.001881,74.125.24.0-255,5738,63330,65,127050
34717,0.001883,172.31.40.0-255,66,63396,65,127050
34718,0.001916,172.31.40.0-255,66,63462,65,127050
34719,0.001942,74.125.24.0-255,1484,64946,65,127050
34720,0.001956,172.31.40.0-255,66,65012,65,127050
34721,0.002137,74.125.24.0-255,1484,66496,65,127050
34722,0.002145,74.125.24.0-255,2902,69398,65,127050
34723,0.002148,172.31.40.0-255,66,69464,65,127050
34724,0.002152,74.125.24.0-255,1484,70948,65,127050
34725,0.002167,74.125.24.0-255,4320,75268,65,127050
34726,0.00217,172.31.40.0-255,66,75334,65,127050
34727,0.00219,172.31.40.0-255,66,75400,65,127050
34728,0.002194,74.125.24.0-255,2902,78302,65,127050
34729,0.002196,172.31.40.0-255,66,78368,65,127050
34730,0.002246,74.125.24.0-255,4320,82688,65,127050
34731,0.002249,172.31.40.0-255,66,82754,65,127050
34732,0.002268,74.125.24.0-255,3602,86356,65,127050
34733,0.00227,172.31.40.0-255,66,86422,65,127050
34734,0.004568,74.125.24.0-255,5738,92160,65,127050
34735,0.004575,172.31.40.0-255,66,92226,65,127050
34736,0.006863,74.125.24.0-255,5738,97964,65,127050
34737,0.006869,172.31.40.0-255,66,98030,65,127050
34738,0.0092,74.125.24.0-255,5738,103768,65,127050
34739,0.009207,172.31.40.0-255,66,103834,65,127050
34740,0.011489,74.125.24.0-255,5738,109572,65,127050
34741,0.011497,172.31.40.0-255,66,109638,65,127050
34742,0.013834,74.125.24.0-255,5738,115376,65,127050
34743,0.013841,172.31.40.0-255,66,115442,65,127050
34744,0.016175,74.125.24.0-255,5738,121180,65,127050
34745,0.016185,172.31.40.0-255,66,121246,65,127050
34746,0.018507,74.125.24.0-255,5738,126984,65,127050
34747,0.018514,172.31.40.0-255,66,127050,65,127050
34748,0.0,172.31.40.0-255,105,105,65,459
34749,0.000236,172.31.40.0-255,90,195,65,459
34750,0.000247,172.31.40.0-255,66,261,65,459
34751,0.002518,74.125.24.0-255,66,327,65,459
34752,0.002549,74.125.24.0-255,66,393,65,459
34753,0.002572,172.31.40.0-255,66,459,65,459
34754,0.0,74.125.130.0-255,149,149,65,201765
34755,1.8e-05,172.31.40.0-255,66,215,65,201765
34756,2.4e-05,74.125.130.0-255,1484,1699,65,201765
34757,2.8e-05,172.31.40.0-255,66,1765,65,201765
34758,3.1e-05,74.125.130.0-255,1484,3249,65,201765
34759,3.4e-05,172.31.40.0-255,66,3315,65,201765
34760,5.6e-05,74.125.130.0-255,1484,4799,65,201765
34761,5.9e-05,172.31.40.0-255,66,4865,65,201765
34762,8.8e-05,74.125.130.0-255,4320,9185,65,201765
34763,9e-05,172.31.40.0-255,66,9251,65,201765
34764,9.6e-05,74.125.130.0-255,1484,10735,65,201765
34765,9.8e-05,172.31.40.0-255,66,10801,65,201765
34766,0.000119,74.125.130.0-255,3436,14237,65,201765
34767,0.000124,172.31.40.0-255,66,14303,65,201765
34768,0.000293,74.125.130.0-255,1484,15787,65,201765
34769,0.000297,172.31.40.0-255,66,15853,65,201765
34770,0.000301,74.125.130.0-255,1484,17337,65,201765
34771,0.000303,172.31.40.0-255,66,17403,65,201765
34772,0.000331,74.125.130.0-255,1484,18887,65,201765
34773,0.000334,172.31.40.0-255,66,18953,65,201765
34774,0.00034,74.125.130.0-255,5738,24691,65,201765
34775,0.000341,172.31.40.0-255,66,24757,65,201765
34776,0.000376,74.125.130.0-255,6797,31554,65,201765
34777,0.000378,172.31.40.0-255,66,31620,65,201765
34778,0.000415,74.125.130.0-255,7156,38776,65,201765
34779,0.000418,172.31.40.0-255,66,38842,65,201765
34780,0.000421,74.125.130.0-255,2902,41744,65,201765
34781,0.000423,172.31.40.0-255,66,41810,65,201765
34782,0.000428,74.125.130.0-255,4320,46130,65,201765
34783,0.000434,172.31.40.0-255,66,46196,65,201765
34784,0.000459,74.125.130.0-255,2543,48739,65,201765
34785,0.000462,172.31.40.0-255,66,48805,65,201765
34786,0.000569,74.125.130.0-255,1484,50289,65,201765
34787,0.000574,74.125.130.0-255,2902,53191,65,201765
34788,0.000591,74.125.130.0-255,1484,54675,65,201765
34789,0.000597,172.31.40.0-255,66,54741,65,201765
34790,0.000607,74.125.130.0-255,4320,59061,65,201765
34791,0.00061,74.125.130.0-255,2902,61963,65,201765
34792,0.000618,74.125.130.0-255,3961,65924,65,201765
34793,0.000629,172.31.40.0-255,66,65990,65,201765
34794,0.000645,74.125.130.0-255,346,66336,65,201765
34795,0.000845,74.125.130.0-255,397,66733,65,201765
34796,0.000882,74.125.130.0-255,1484,68217,65,201765
34797,0.000888,172.31.40.0-255,66,68283,65,201765
34798,0.000916,74.125.130.0-255,2902,71185,65,201765
34799,0.000927,172.31.40.0-255,66,71251,65,201765
34800,0.000939,74.125.130.0-255,4320,75571,65,201765
34801,0.000958,172.31.40.0-255,66,75637,65,201765
34802,0.000969,74.125.130.0-255,4320,79957,65,201765
34803,0.00099,74.125.130.0-255,2902,82859,65,201765
34804,0.001002,172.31.40.0-255,66,82925,65,201765
34805,0.001005,74.125.130.0-255,1125,84050,65,201765
34806,0.001036,74.125.130.0-255,1484,85534,65,201765
34807,0.001039,172.31.40.0-255,66,85600,65,201765
34808,0.001058,74.125.130.0-255,4320,89920,65,201765
34809,0.001062,74.125.130.0-255,2902,92822,65,201765
34810,0.001077,74.125.130.0-255,4320,97142,65,201765
34811,0.001092,172.31.40.0-255,66,97208,65,201765
34812,0.001122,74.125.130.0-255,3961,101169,65,201765
34813,0.001127,172.31.40.0-255,66,101235,65,201765
34814,0.001502,74.125.130.0-255,1484,102719,65,201765
34815,0.001508,74.125.130.0-255,2902,105621,65,201765
34816,0.001512,172.31.40.0-255,66,105687,65,201765
34817,0.001542,74.125.130.0-255,4320,110007,65,201765
34818,0.001545,74.125.130.0-255,1484,111491,65,201765
34819,0.001559,172.31.40.0-255,66,111557,65,201765
34820,0.001567,74.125.130.0-255,7156,118713,65,201765
34821,0.001577,74.125.130.0-255,5738,124451,65,201765
34822,0.001581,74.125.130.0-255,2902,127353,65,201765
34823,0.001588,172.31.40.0-255,66,127419,65,201765
34824,0.001608,74.125.130.0-255,4320,131739,65,201765
34825,0.001612,74.125.130.0-255,1484,133223,65,201765
34826,0.001629,74.125.130.0-255,2184,135407,65,201765
34827,0.001634,172.31.40.0-255,66,135473,65,201765
34828,0.001748,74.125.130.0-255,1484,136957,65,201765
34829,0.001768,74.125.130.0-255,2902,139859,65,201765
34830,0.001771,172.31.40.0-255,66,139925,65,201765
34831,0.001793,74.125.130.0-255,4320,144245,65,201765
34832,0.0018,172.31.40.0-255,66,144311,65,201765
34833,0.001829,74.125.130.0-255,4320,148631,65,201765
34834,0.001834,172.31.40.0-255,66,148697,65,201765
34835,0.001863,74.125.130.0-255,5738,154435,65,201765
34836,0.00187,172.31.40.0-255,66,154501,65,201765
34837,0.001899,74.125.130.0-255,6438,160939,65,201765
34838,0.001909,172.31.40.0-255,66,161005,65,201765
34839,0.002028,74.125.130.0-255,1484,162489,65,201765
34840,0.003927,74.125.130.0-255,4320,166809,65,201765
34841,0.003934,172.31.40.0-255,66,166875,65,201765
34842,0.005958,74.125.130.0-255,2902,169777,65,201765
34843,0.005977,74.125.130.0-255,2902,172679,65,201765
34844,0.008029,172.31.40.0-255,66,172745,65,201765
34845,0.010077,74.125.130.0-255,5738,178483,65,201765
34846,0.010084,172.31.40.0-255,66,178549,65,201765
34847,0.012108,74.125.130.0-255,5738,184287,65,201765
34848,0.012117,172.31.40.0-255,66,184353,65,201765
34849,0.01415,74.125.130.0-255,5738,190091,65,201765
34850,0.014157,172.31.40.0-255,66,190157,65,201765
34851,0.016192,74.125.130.0-255,5738,195895,65,201765
34852,0.016198,172.31.40.0-255,66,195961,65,201765
34853,0.018223,74.125.130.0-255,5738,201699,65,201765
34854,0.01823,172.31.40.0-255,66,201765,65,201765
34855,0.0,172.31.40.0-255,105,105,65,276
34856,0.001768,157.240.24.0-255,105,210,65,276
34857,0.001779,172.31.40.0-255,66,276,65,276
