,TIME,SRC,PACKET_SIZE,CUMULATIVE_PACKET_SIZE,PAGE_NUMBER,TOTAL_PACKET_SIZE
0,0.0,172.253.118.0-255,296,296,63,198382
1,1.6e-05,172.31.40.0-255,66,362,63,198382
2,2.3e-05,172.253.118.0-255,1484,1846,63,198382
3,2.7e-05,172.31.40.0-255,66,1912,63,198382
4,4e-05,172.253.118.0-255,4320,6232,63,198382
5,4.4e-05,172.31.40.0-255,66,6298,63,198382
6,5.5e-05,172.31.40.0-255,66,6364,63,198382
7,9.3e-05,172.253.118.0-255,1484,7848,63,198382
8,9.6e-05,172.31.40.0-255,66,7914,63,198382
9,0.000125,172.253.118.0-255,2902,10816,63,198382
10,0.000127,172.31.40.0-255,66,10882,63,198382
11,0.000148,172.253.118.0-255,4320,15202,63,198382
12,0.00015,172.31.40.0-255,66,15268,63,198382
13,0.000156,172.253.118.0-255,4320,19588,63,198382
14,0.000158,172.31.40.0-255,66,19654,63,198382
15,0.00018,172.253.118.0-255,1484,21138,63,198382
16,0.000182,172.31.40.0-255,66,21204,63,198382
17,0.000187,172.253.118.0-255,2543,23747,63,198382
18,0.000195,172.31.40.0-255,66,23813,63,198382
19,0.000376,172.253.118.0-255,1484,25297,63,198382
20,0.000381,172.31.40.0-255,66,25363,63,198382
21,0.000409,172.253.118.0-255,2902,28265,63,198382
22,0.000413,172.31.40.0-255,66,28331,63,198382
23,0.000419,172.253.118.0-255,5738,34069,63,198382
24,0.000422,172.31.40.0-255,66,34135,63,198382
25,0.000458,172.253.118.0-255,6797,40932,63,198382
26,0.000461,172.31.40.0-255,66,40998,63,198382
27,0.000468,172.253.118.0-255,7156,48154,63,198382
28,0.00047,172.31.40.0-255,66,48220,63,198382
29,0.000516,172.31.40.0-255,66,48286,63,198382
30,0.000518,172.253.118.0-255,402,48688,63,198382
31,0.0006,172.253.118.0-255,342,49030,63,198382
32,0.000821,172.253.118.0-255,1484,50514,63,198382
33,0.000827,172.31.40.0-255,66,50580,63,198382
34,0.000833,172.253.118.0-255,2902,53482,63,198382
35,0.000835,172.31.40.0-255,66,53548,63,198382
36,0.000845,172.253.118.0-255,2902,56450,63,198382
37,0.000847,172.31.40.0-255,66,56516,63,198382
38,0.000864,172.253.118.0-255,5738,62254,63,198382
39,0.000866,172.31.40.0-255,66,62320,63,198382
40,0.000894,172.253.118.0-255,1484,63804,63,198382
41,0.0009,172.253.118.0-255,3961,67765,63,198382
42,0.000902,172.31.40.0-255,66,67831,63,198382
43,0.000908,172.253.118.0-255,4320,72151,63,198382
44,0.00091,172.31.40.0-255,66,72217,63,198382
45,0.000914,172.253.118.0-255,2902,75119,63,198382
46,0.000917,172.31.40.0-255,66,75185,63,198382
47,0.000955,172.253.118.0-255,7156,82341,63,198382
48,0.000959,172.31.40.0-255,66,82407,63,198382
49,0.000961,172.253.118.0-255,1125,83532,63,198382
50,0.001537,172.31.40.0-255,66,83598,63,198382
51,0.001747,172.253.118.0-255,1484,85082,63,198382
52,0.001755,172.253.118.0-255,1484,86566,63,198382
53,0.001759,172.31.40.0-255,66,86632,63,198382
54,0.001773,172.253.118.0-255,1484,88116,63,198382
55,0.001785,172.253.118.0-255,5738,93854,63,198382
56,0.001787,172.31.40.0-255,66,93920,63,198382
57,0.00183,172.31.40.0-255,66,93986,63,198382
58,0.00186,172.253.118.0-255,5738,99724,63,198382
59,0.001862,172.31.40.0-255,66,99790,63,198382
60,0.001889,172.253.118.0-255,5020,104810,63,198382
61,0.001891,172.31.40.0-255,66,104876,63,198382
62,0.001912,172.253.118.0-255,5738,110614,63,198382
63,0.001916,172.31.40.0-255,66,110680,63,198382
64,0.001923,172.253.118.0-255,7156,117836,63,198382
65,0.001925,172.31.40.0-255,66,117902,63,198382
66,0.001973,172.31.40.0-255,66,117968,63,198382
67,0.001981,172.253.118.0-255,6438,124406,63,198382
68,0.001983,172.31.40.0-255,66,124472,63,198382
69,0.002019,172.253.118.0-255,1484,125956,63,198382
70,0.002039,172.253.118.0-255,2902,128858,63,198382
71,0.002041,172.31.40.0-255,66,128924,63,198382
72,0.002046,172.253.118.0-255,2902,131826,63,198382
73,0.002048,172.31.40.0-255,66,131892,63,198382
74,0.002052,172.253.118.0-255,1484,133376,63,198382
75,0.002075,172.253.118.0-255,2902,136278,63,198382
76,0.002077,172.31.40.0-255,66,136344,63,198382
77,0.002094,172.31.40.0-255,66,136410,63,198382
78,0.002139,172.31.40.0-255,66,136476,63,198382
79,0.002194,172.253.118.0-255,1484,137960,63,198382
80,0.002209,172.253.118.0-255,2902,140862,63,198382
81,0.002212,172.31.40.0-255,66,140928,63,198382
82,0.002218,172.253.118.0-255,5738,146666,63,198382
83,0.002221,172.31.40.0-255,66,146732,63,198382
84,0.002264,172.31.40.0-255,66,146798,63,198382
85,0.002271,172.253.118.0-255,7156,153954,63,198382
86,0.002274,172.31.40.0-255,66,154020,63,198382
87,0.002302,172.253.118.0-255,3602,157622,63,198382
88,0.002304,172.31.40.0-255,66,157688,63,198382
89,0.004539,172.253.118.0-255,1484,159172,63,198382
90,0.00456,172.253.118.0-255,4320,163492,63,198382
91,0.004566,172.31.40.0-255,66,163558,63,198382
92,0.006869,172.253.118.0-255,5738,169296,63,198382
93,0.006875,172.31.40.0-255,66,169362,63,198382
94,0.009212,172.253.118.0-255,5738,175100,63,198382
95,0.009219,172.31.40.0-255,66,175166,63,198382
96,0.011521,172.253.118.0-255,5738,180904,63,198382
97,0.011541,172.31.40.0-255,66,180970,63,198382
98,0.013842,172.253.118.0-255,5738,186708,63,198382
99,0.013856,172.31.40.0-255,66,186774,63,198382
100,0.016155,172.253.118.0-255,5738,192512,63,198382
101,0.016168,172.31.40.0-255,66,192578,63,198382
102,0.018455,172.253.118.0-255,5738,198316,63,198382
103,0.018462,172.31.40.0-255,66,198382,63,198382
104,0.0,172.217.194.0-255,150,150,63,190706
105,1.8e-05,172.31.40.0-255,66,216,63,190706
106,2.5e-05,172.217.194.0-255,1484,1700,63,190706
107,3e-05,172.31.40.0-255,66,1766,63,190706
108,3.5e-05,172.217.194.0-255,2902,4668,63,190706
109,3.9e-05,172.31.40.0-255,66,4734,63,190706
110,4.4e-05,172.217.194.0-255,4320,9054,63,190706
111,4.8e-05,172.31.40.0-255,66,9120,63,190706
112,8.1e-05,172.31.40.0-255,66,9186,63,190706
113,0.000125,172.31.40.0-255,66,9252,63,190706
114,0.000164,172.217.194.0-255,1484,10736,63,190706
115,0.000167,172.31.40.0-255,66,10802,63,190706
116,0.000172,172.217.194.0-255,2902,13704,63,190706
117,0.000174,172.31.40.0-255,66,13770,63,190706
118,0.000191,172.217.194.0-255,5738,19508,63,190706
119,0.000194,172.31.40.0-255,66,19574,63,190706
120,0.000201,172.217.194.0-255,6797,26371,63,190706
121,0.000204,172.31.40.0-255,66,26437,63,190706
122,0.000261,172.217.194.0-255,2902,29339,63,190706
123,0.000265,172.31.40.0-255,66,29405,63,190706
124,0.000298,172.31.40.0-255,66,29471,63,190706
125,0.000452,172.217.194.0-255,381,29852,63,190706
126,0.000457,172.31.40.0-255,66,29918,63,190706
127,0.000716,172.217.194.0-255,1484,31402,63,190706
128,0.000721,172.31.40.0-255,66,31468,63,190706
129,0.000726,172.217.194.0-255,2902,34370,63,190706
130,0.000729,172.31.40.0-255,66,34436,63,190706
131,0.000734,172.217.194.0-255,2902,37338,63,190706
132,0.000736,172.31.40.0-255,66,37404,63,190706
133,0.000753,172.217.194.0-255,2902,40306,63,190706
134,0.000755,172.31.40.0-255,66,40372,63,190706
135,0.000762,172.217.194.0-255,6797,47169,63,190706
136,0.000764,172.31.40.0-255,66,47235,63,190706
137,0.000804,172.217.194.0-255,5738,52973,63,190706
138,0.000808,172.31.40.0-255,66,53039,63,190706
139,0.000828,172.217.194.0-255,2902,55941,63,190706
140,0.000831,172.31.40.0-255,66,56007,63,190706
141,0.000859,172.217.194.0-255,4320,60327,63,190706
142,0.000862,172.31.40.0-255,66,60393,63,190706
143,0.000882,172.217.194.0-255,3961,64354,63,190706
144,0.000884,172.31.40.0-255,66,64420,63,190706
145,0.001317,172.217.194.0-255,1484,65904,63,190706
146,0.001322,172.217.194.0-255,2902,68806,63,190706
147,0.001324,172.217.194.0-255,1484,70290,63,190706
148,0.001332,172.31.40.0-255,66,70356,63,190706
149,0.001343,172.217.194.0-255,4320,74676,63,190706
150,0.001346,172.31.40.0-255,66,74742,63,190706
151,0.001364,172.217.194.0-255,5738,80480,63,190706
152,0.001367,172.31.40.0-255,66,80546,63,190706
153,0.00139,172.217.194.0-255,7156,87702,63,190706
154,0.001392,172.31.40.0-255,66,87768,63,190706
155,0.001412,172.217.194.0-255,4320,92088,63,190706
156,0.001414,172.31.40.0-255,66,92154,63,190706
157,0.001436,172.217.194.0-255,6438,98592,63,190706
158,0.001439,172.31.40.0-255,66,98658,63,190706
159,0.001743,172.217.194.0-255,1484,100142,63,190706
160,0.001748,172.217.194.0-255,2902,103044,63,190706
161,0.001752,172.31.40.0-255,66,103110,63,190706
162,0.001775,172.217.194.0-255,5738,108848,63,190706
163,0.001777,172.31.40.0-255,66,108914,63,190706
164,0.001803,172.31.40.0-255,66,108980,63,190706
165,0.001817,172.217.194.0-255,2902,111882,63,190706
166,0.00182,172.31.40.0-255,66,111948,63,190706
167,0.001847,172.217.194.0-255,4320,116268,63,190706
168,0.00185,172.31.40.0-255,66,116334,63,190706
169,0.001874,172.31.40.0-255,66,116400,63,190706
170,0.002084,172.217.194.0-255,1484,117884,63,190706
171,0.002088,172.217.194.0-255,1484,119368,63,190706
172,0.002091,172.31.40.0-255,66,119434,63,190706
173,0.002109,172.217.194.0-255,1484,120918,63,190706
174,0.002116,172.217.194.0-255,5738,126656,63,190706
175,0.002118,172.31.40.0-255,66,126722,63,190706
176,0.00215,172.31.40.0-255,66,126788,63,190706
177,0.002157,172.217.194.0-255,7156,133944,63,190706
178,0.002159,172.31.40.0-255,66,134010,63,190706
179,0.002201,172.217.194.0-255,3602,137612,63,190706
180,0.002204,172.31.40.0-255,66,137678,63,190706
181,0.002235,172.217.194.0-255,4320,141998,63,190706
182,0.002237,172.31.40.0-255,66,142064,63,190706
183,0.002252,172.217.194.0-255,4320,146384,63,190706
184,0.002254,172.31.40.0-255,66,146450,63,190706
185,0.002269,172.217.194.0-255,2902,149352,63,190706
186,0.002272,172.31.40.0-255,66,149418,63,190706
187,0.004493,172.217.194.0-255,2902,152320,63,190706
188,0.0045,172.31.40.0-255,66,152386,63,190706
189,0.004522,172.217.194.0-255,2902,155288,63,190706
190,0.004524,172.31.40.0-255,66,155354,63,190706
191,0.00669,172.217.194.0-255,2902,158256,63,190706
192,0.006693,172.31.40.0-255,66,158322,63,190706
193,0.006738,172.217.194.0-255,2902,161224,63,190706
194,0.00674,172.31.40.0-255,66,161290,63,190706
195,0.008894,172.217.194.0-255,2902,164192,63,190706
196,0.008901,172.31.40.0-255,66,164258,63,190706
197,0.008954,172.217.194.0-255,2902,167160,63,190706
198,0.008958,172.31.40.0-255,66,167226,63,190706
199,0.011128,172.217.194.0-255,2902,170128,63,190706
200,0.011135,172.31.40.0-255,66,170194,63,190706
201,0.011167,172.217.194.0-255,2902,173096,63,190706
202,0.011169,172.31.40.0-255,66,173162,63,190706
203,0.013339,172.217.194.0-255,2902,176064,63,190706
204,0.013348,172.31.40.0-255,66,176130,63,190706
205,0.013394,172.217.194.0-255,2902,179032,63,190706
206,0.013398,172.31.40.0-255,66,179098,63,190706
207,0.015601,172.217.194.0-255,5738,184836,63,190706
208,0.01561,172.31.40.0-255,66,184902,63,190706
209,0.017824,172.217.194.0-255,5738,190640,63,190706
210,0.017832,172.31.40.0-255,66,190706,63,190706
211,0.0,172.217.194.0-255,153,153,63,183196
212,2e-05,172.31.40.0-255,66,219,63,183196
213,2.7e-05,172.217.194.0-255,1484,1703,63,183196
214,3.2e-05,172.31.40.0-255,66,1769,63,183196
215,3.8e-05,172.217.194.0-255,2902,4671,63,183196
216,4.1e-05,172.31.40.0-255,66,4737,63,183196
217,4.8e-05,172.217.194.0-255,5738,10475,63,183196
218,5.1e-05,172.31.40.0-255,66,10541,63,183196
219,7.8e-05,172.217.194.0-255,6323,16864,63,183196
220,8.1e-05,172.31.40.0-255,66,16930,63,183196
221,8.7e-05,172.217.194.0-255,2902,19832,63,183196
222,8.9e-05,172.31.40.0-255,66,19898,63,183196
223,0.000113,172.217.194.0-255,4320,24218,63,183196
224,0.000116,172.31.40.0-255,66,24284,63,183196
225,0.000143,172.217.194.0-255,1484,25768,63,183196
226,0.000145,172.31.40.0-255,66,25834,63,183196
227,0.000169,172.217.194.0-255,5379,31213,63,183196
228,0.000172,172.31.40.0-255,66,31279,63,183196
229,0.000234,172.217.194.0-255,1484,32763,63,183196
230,0.000237,172.31.40.0-255,66,32829,63,183196
231,0.000242,172.217.194.0-255,2902,35731,63,183196
232,0.000244,172.31.40.0-255,66,35797,63,183196
233,0.000249,172.217.194.0-255,2902,38699,63,183196
234,0.000252,172.31.40.0-255,66,38765,63,183196
235,0.000269,172.217.194.0-255,2902,41667,63,183196
236,0.000272,172.31.40.0-255,66,41733,63,183196
237,0.000293,172.217.194.0-255,5738,47471,63,183196
238,0.000295,172.31.40.0-255,66,47537,63,183196
239,0.000319,172.31.40.0-255,66,47603,63,183196
240,0.00035,172.31.40.0-255,66,47669,63,183196
241,0.000383,172.217.194.0-255,115,47784,63,183196
242,0.000636,172.217.194.0-255,388,48172,63,183196
243,0.000945,172.217.194.0-255,1484,49656,63,183196
244,0.00095,172.31.40.0-255,66,49722,63,183196
245,0.000955,172.217.194.0-255,2902,52624,63,183196
246,0.000957,172.31.40.0-255,66,52690,63,183196
247,0.000962,172.217.194.0-255,4320,57010,63,183196
248,0.000964,172.31.40.0-255,66,57076,63,183196
249,0.000979,172.217.194.0-255,1484,58560,63,183196
250,0.000981,172.217.194.0-255,1484,60044,63,183196
251,0.000983,172.31.40.0-255,66,60110,63,183196
252,0.001022,172.31.40.0-255,66,60176,63,183196
253,0.001028,172.217.194.0-255,5738,65914,63,183196
254,0.001029,172.31.40.0-255,66,65980,63,183196
255,0.001051,172.217.194.0-255,2902,68882,63,183196
256,0.001053,172.31.40.0-255,66,68948,63,183196
257,0.001072,172.217.194.0-255,2184,71132,63,183196
258,0.001075,172.31.40.0-255,66,71198,63,183196
259,0.001166,172.217.194.0-255,1484,72682,63,183196
260,0.001179,172.217.194.0-255,2902,75584,63,183196
261,0.001181,172.31.40.0-255,66,75650,63,183196
262,0.001184,172.217.194.0-255,1484,77134,63,183196
263,0.001202,172.217.194.0-255,4320,81454,63,183196
264,0.001204,172.31.40.0-255,66,81520,63,183196
265,0.001209,172.217.194.0-255,5738,87258,63,183196
266,0.001211,172.31.40.0-255,66,87324,63,183196
267,0.001233,172.217.194.0-255,2902,90226,63,183196
268,0.001236,172.31.40.0-255,66,90292,63,183196
269,0.00128,172.31.40.0-255,66,90358,63,183196
270,0.001296,172.217.194.0-255,766,91124,63,183196
271,0.001439,172.217.194.0-255,1484,92608,63,183196
272,0.001443,172.31.40.0-255,66,92674,63,183196
273,0.001461,172.217.194.0-255,2902,95576,63,183196
274,0.001462,172.31.40.0-255,66,95642,63,183196
275,0.001466,172.217.194.0-255,2902,98544,63,183196
276,0.001468,172.31.40.0-255,66,98610,63,183196
277,0.001496,172.217.194.0-255,2902,101512,63,183196
278,0.001498,172.31.40.0-255,66,101578,63,183196
279,0.001508,172.31.40.0-255,66,101644,63,183196
280,0.001523,172.217.194.0-255,4320,105964,63,183196
281,0.001529,172.217.194.0-255,7156,113120,63,183196
282,0.001532,172.31.40.0-255,66,113186,63,183196
283,0.001537,172.31.40.0-255,66,113252,63,183196
284,0.001562,172.217.194.0-255,4320,117572,63,183196
285,0.001565,172.31.40.0-255,66,117638,63,183196
286,0.001587,172.217.194.0-255,5020,122658,63,183196
287,0.00159,172.31.40.0-255,66,122724,63,183196
288,0.0016,172.31.40.0-255,66,122790,63,183196
289,0.00165,172.31.40.0-255,66,122856,63,183196
290,0.001652,172.217.194.0-255,766,123622,63,183196
291,0.001692,172.217.194.0-255,1484,125106,63,183196
292,0.001695,172.31.40.0-255,66,125172,63,183196
293,0.0017,172.217.194.0-255,4320,129492,63,183196
294,0.001702,172.31.40.0-255,66,129558,63,183196
295,0.001714,172.217.194.0-255,4320,133878,63,183196
296,0.001717,172.31.40.0-255,66,133944,63,183196
297,0.001741,172.31.40.0-255,66,134010,63,183196
298,0.00176,172.217.194.0-255,1484,135494,63,183196
299,0.001802,172.31.40.0-255,66,135560,63,183196
300,0.001823,172.217.194.0-255,5738,141298,63,183196
301,0.001826,172.31.40.0-255,66,141364,63,183196
302,0.00185,172.31.40.0-255,66,141430,63,183196
303,0.001868,172.31.40.0-255,66,141496,63,183196
304,0.001882,172.217.194.0-255,1484,142980,63,183196
305,0.001886,172.217.194.0-255,3602,146582,63,183196
306,0.001888,172.31.40.0-255,66,146648,63,183196
307,0.001932,172.217.194.0-255,1484,148132,63,183196
308,0.001935,172.217.194.0-255,1484,149616,63,183196
309,0.001938,172.31.40.0-255,66,149682,63,183196
310,0.001952,172.217.194.0-255,1484,151166,63,183196
311,0.001958,172.217.194.0-255,5738,156904,63,183196
312,0.00196,172.31.40.0-255,66,156970,63,183196
313,0.001986,172.217.194.0-255,7156,164126,63,183196
314,0.001988,172.31.40.0-255,66,164192,63,183196
315,0.002012,172.217.194.0-255,5738,169930,63,183196
316,0.002014,172.31.40.0-255,66,169996,63,183196
317,0.002026,172.31.40.0-255,66,170062,63,183196
318,0.00203,172.217.194.0-255,2902,172964,63,183196
319,0.002032,172.31.40.0-255,66,173030,63,183196
320,0.002075,172.31.40.0-255,66,173096,63,183196
321,0.002089,172.31.40.0-255,66,173162,63,183196
322,0.0021,172.31.40.0-255,66,173228,63,183196
323,0.002123,172.217.194.0-255,766,173994,63,183196
324,0.002136,172.31.40.0-255,66,174060,63,183196
325,0.002149,172.31.40.0-255,66,174126,63,183196
326,0.002221,172.217.194.0-255,5738,179864,63,183196
327,0.002225,172.31.40.0-255,66,179930,63,183196
328,0.002253,172.31.40.0-255,66,179996,63,183196
329,0.002269,172.31.40.0-255,66,180062,63,183196
330,0.002291,172.217.194.0-255,2629,182691,63,183196
331,0.002294,172.31.40.0-255,66,182757,63,183196
332,0.002297,172.217.194.0-255,97,182854,63,183196
333,0.002299,172.217.194.0-255,105,182959,63,183196
334,0.004006,172.31.40.0-255,66,183025,63,183196
335,0.00404,172.31.40.0-255,105,183130,63,183196
336,0.006315,172.217.194.0-255,66,183196,63,183196
337,0.0,74.125.68.0-255,148,148,63,357455
338,1.5e-05,172.31.40.0-255,66,214,63,357455
339,3.1e-05,74.125.68.0-255,1484,1698,63,357455
340,4.1e-05,172.31.40.0-255,66,1764,63,357455
341,4.4e-05,74.125.68.0-255,1484,3248,63,357455
342,4.6e-05,172.31.40.0-255,66,3314,63,357455
343,7.5e-05,74.125.68.0-255,2902,6216,63,357455
344,7.8e-05,172.31.40.0-255,66,6282,63,357455
345,0.000119,74.125.68.0-255,5738,12020,63,357455
346,0.000122,172.31.40.0-255,66,12086,63,357455
347,0.000127,74.125.68.0-255,2134,14220,63,357455
348,0.000129,172.31.40.0-255,66,14286,63,357455
349,0.000167,74.125.68.0-255,1484,15770,63,357455
350,0.000171,172.31.40.0-255,66,15836,63,357455
351,0.000202,74.125.68.0-255,2902,18738,63,357455
352,0.000205,172.31.40.0-255,66,18804,63,357455
353,0.000209,74.125.68.0-255,2902,21706,63,357455
354,0.000212,172.31.40.0-255,66,21772,63,357455
355,0.000217,74.125.68.0-255,4320,26092,63,357455
356,0.000221,172.31.40.0-255,66,26158,63,357455
357,0.000266,74.125.68.0-255,5379,31537,63,357455
358,0.000269,172.31.40.0-255,66,31603,63,357455
359,0.000276,74.125.68.0-255,5738,37341,63,357455
360,0.000279,172.31.40.0-255,66,37407,63,357455
361,0.000311,172.31.40.0-255,66,37473,63,357455
362,0.000324,74.125.68.0-255,2543,40016,63,357455
363,0.000332,172.31.40.0-255,66,40082,63,357455
364,0.000335,74.125.68.0-255,1484,41566,63,357455
365,0.000337,172.31.40.0-255,66,41632,63,357455
366,0.000368,74.125.68.0-255,2902,44534,63,357455
367,0.000372,172.31.40.0-255,66,44600,63,357455
368,0.000379,74.125.68.0-255,5738,50338,63,357455
369,0.000413,74.125.68.0-255,6797,57135,63,357455
370,0.000451,74.125.68.0-255,679,57814,63,357455
371,0.000716,74.125.68.0-255,1484,59298,63,357455
372,0.000734,74.125.68.0-255,2902,62200,63,357455
373,0.000754,74.125.68.0-255,5738,67938,63,357455
374,0.000812,74.125.68.0-255,4320,72258,63,357455
375,0.000843,74.125.68.0-255,4320,76578,63,357455
376,0.000865,74.125.68.0-255,6438,83016,63,357455
377,0.001479,74.125.68.0-255,1484,84500,63,357455
378,0.001486,74.125.68.0-255,2902,87402,63,357455
379,0.001518,74.125.68.0-255,5738,93140,63,357455
380,0.001525,74.125.68.0-255,2902,96042,63,357455
381,0.001539,74.125.68.0-255,2902,98944,63,357455
382,0.001582,74.125.68.0-255,4320,103264,63,357455
383,0.001606,74.125.68.0-255,7156,110420,63,357455
384,0.001641,74.125.68.0-255,2902,113322,63,357455
385,0.001658,74.125.68.0-255,3602,116924,63,357455
386,0.001787,74.125.68.0-255,1484,118408,63,357455
387,0.001794,74.125.68.0-255,2902,121310,63,357455
388,0.001821,74.125.68.0-255,5738,127048,63,357455
389,0.001843,74.125.68.0-255,1484,128532,63,357455
390,0.001861,74.125.68.0-255,2902,131434,63,357455
391,0.001864,74.125.68.0-255,1484,132918,63,357455
392,0.001882,74.125.68.0-255,4320,137238,63,357455
393,0.001904,74.125.68.0-255,4320,141558,63,357455
394,0.001916,74.125.68.0-255,2902,144460,63,357455
395,0.001932,74.125.68.0-255,4320,148780,63,357455
396,0.001949,74.125.68.0-255,2184,150964,63,357455
397,0.002109,74.125.68.0-255,1484,152448,63,357455
398,0.00213,74.125.68.0-255,2902,155350,63,357455
399,0.002193,74.125.68.0-255,1484,156834,63,357455
400,0.002206,74.125.68.0-255,2902,159736,63,357455
401,0.002216,74.125.68.0-255,1484,161220,63,357455
402,0.002232,74.125.68.0-255,4320,165540,63,357455
403,0.002236,74.125.68.0-255,2902,168442,63,357455
404,0.002252,74.125.68.0-255,4320,172762,63,357455
405,0.002278,74.125.68.0-255,1484,174246,63,357455
406,0.002305,74.125.68.0-255,7156,181402,63,357455
407,0.002311,74.125.68.0-255,3602,185004,63,357455
408,0.002497,74.125.68.0-255,1484,186488,63,357455
409,0.002516,74.125.68.0-255,1484,187972,63,357455
410,0.002523,74.125.68.0-255,4320,192292,63,357455
411,0.002543,74.125.68.0-255,4320,196612,63,357455
412,0.002561,74.125.68.0-255,5738,202350,63,357455
413,0.002564,74.125.68.0-255,1484,203834,63,357455
414,0.002566,74.125.68.0-255,1484,205318,63,357455
415,0.002582,74.125.68.0-255,1484,206802,63,357455
416,0.002588,74.125.68.0-255,5738,212540,63,357455
417,0.002608,74.125.68.0-255,5738,218278,63,357455
418,0.00261,74.125.68.0-255,766,219044,63,357455
419,0.002634,74.125.68.0-255,1484,220528,63,357455
420,0.002646,74.125.68.0-255,1484,222012,63,357455
421,0.002678,74.125.68.0-255,2902,224914,63,357455
422,0.002701,74.125.68.0-255,5738,230652,63,357455
423,0.002707,74.125.68.0-255,5738,236390,63,357455
424,0.002762,74.125.68.0-255,7156,243546,63,357455
425,0.002769,74.125.68.0-255,5738,249284,63,357455
426,0.002788,74.125.68.0-255,3602,252886,63,357455
427,0.002831,74.125.68.0-255,1484,254370,63,357455
428,0.002844,74.125.68.0-255,2902,257272,63,357455
429,0.00286,74.125.68.0-255,2902,260174,63,357455
430,0.002878,74.125.68.0-255,2902,263076,63,357455
431,0.002893,74.125.68.0-255,4320,267396,63,357455
432,0.002913,74.125.68.0-255,7156,274552,63,357455
433,0.002969,74.125.68.0-255,1484,276036,63,357455
434,0.002995,74.125.68.0-255,7156,283192,63,357455
435,0.003002,74.125.68.0-255,3602,286794,63,357455
436,0.003026,74.125.68.0-255,1484,288278,63,357455
437,0.003043,74.125.68.0-255,2902,291180,63,357455
438,0.00305,74.125.68.0-255,5738,296918,63,357455
439,0.003054,74.125.68.0-255,2902,299820,63,357455
440,0.003087,74.125.68.0-255,2902,302722,63,357455
441,0.003099,74.125.68.0-255,4320,307042,63,357455
442,0.003116,74.125.68.0-255,2902,309944,63,357455
443,0.003142,74.125.68.0-255,5738,315682,63,357455
444,0.00316,74.125.68.0-255,2902,318584,63,357455
445,0.003204,74.125.68.0-255,1484,320068,63,357455
446,0.003242,74.125.68.0-255,5020,325088,63,357455
447,0.003247,74.125.68.0-255,2902,327990,63,357455
448,0.003293,74.125.68.0-255,5020,333010,63,357455
449,0.003319,74.125.68.0-255,1484,334494,63,357455
450,0.003335,74.125.68.0-255,1484,335978,63,357455
451,0.003354,74.125.68.0-255,1484,337462,63,357455
452,0.00336,74.125.68.0-255,5738,343200,63,357455
453,0.003368,74.125.68.0-255,7156,350356,63,357455
454,0.003388,74.125.68.0-255,5738,356094,63,357455
455,0.00342,74.125.68.0-255,1019,357113,63,357455
456,0.003463,74.125.68.0-255,105,357218,63,357455
457,0.003786,172.31.40.0-255,66,357284,63,357455
458,0.015129,172.31.40.0-255,105,357389,63,357455
459,0.017459,74.125.68.0-255,66,357455,63,357455
460,0.0,74.125.200.0-255,153,153,63,187526
461,2.3e-05,172.31.40.0-255,66,219,63,187526
462,3e-05,74.125.200.0-255,1484,1703,63,187526
463,3.4e-05,172.31.40.0-255,66,1769,63,187526
464,3.9e-05,74.125.200.0-255,2902,4671,63,187526
465,4.2e-05,172.31.40.0-255,66,4737,63,187526
466,6.7e-05,74.125.200.0-255,5738,10475,63,187526
467,7e-05,172.31.40.0-255,66,10541,63,187526
468,7.6e-05,74.125.200.0-255,3437,13978,63,187526
469,7.8e-05,172.31.40.0-255,66,14044,63,187526
470,8.2e-05,74.125.200.0-255,1484,15528,63,187526
471,8.4e-05,172.31.40.0-255,66,15594,63,187526
472,0.000107,74.125.200.0-255,2902,18496,63,187526
473,0.00011,172.31.40.0-255,66,18562,63,187526
474,0.000113,74.125.200.0-255,1484,20046,63,187526
475,0.000115,172.31.40.0-255,66,20112,63,187526
476,0.000141,172.31.40.0-255,66,20178,63,187526
477,0.000145,74.125.200.0-255,2543,22721,63,187526
478,0.000147,172.31.40.0-255,66,22787,63,187526
479,0.000298,74.125.200.0-255,1484,24271,63,187526
480,0.000303,172.31.40.0-255,66,24337,63,187526
481,0.000335,74.125.200.0-255,2902,27239,63,187526
482,0.000337,172.31.40.0-255,66,27305,63,187526
483,0.000342,74.125.200.0-255,2902,30207,63,187526
484,0.000344,172.31.40.0-255,66,30273,63,187526
485,0.000346,74.125.200.0-255,1484,31757,63,187526
486,0.000348,172.31.40.0-255,66,31823,63,187526
487,0.000362,74.125.200.0-255,2902,34725,63,187526
488,0.000365,172.31.40.0-255,66,34791,63,187526
489,0.000383,74.125.200.0-255,5738,40529,63,187526
490,0.000385,172.31.40.0-255,66,40595,63,187526
491,0.000398,74.125.200.0-255,1484,42079,63,187526
492,0.000403,74.125.200.0-255,1484,43563,63,187526
493,0.000405,172.31.40.0-255,66,43629,63,187526
494,0.000434,74.125.200.0-255,7156,50785,63,187526
495,0.000437,172.31.40.0-255,66,50851,63,187526
496,0.000444,74.125.200.0-255,6438,57289,63,187526
497,0.000446,172.31.40.0-255,66,57355,63,187526
498,0.000448,74.125.200.0-255,364,57719,63,187526
499,0.000753,74.125.200.0-255,131,57850,63,187526
500,0.001014,74.125.200.0-255,1484,59334,63,187526
501,0.001019,172.31.40.0-255,66,59400,63,187526
502,0.001039,74.125.200.0-255,2902,62302,63,187526
503,0.001042,172.31.40.0-255,66,62368,63,187526
504,0.001044,74.125.200.0-255,1484,63852,63,187526
505,0.001063,74.125.200.0-255,4320,68172,63,187526
506,0.001065,172.31.40.0-255,66,68238,63,187526
507,0.00107,74.125.200.0-255,4320,72558,63,187526
508,0.001072,172.31.40.0-255,66,72624,63,187526
509,0.001092,74.125.200.0-255,2902,75526,63,187526
510,0.001095,172.31.40.0-255,66,75592,63,187526
511,0.001101,74.125.200.0-255,5738,81330,63,187526
512,0.001102,172.31.40.0-255,66,81396,63,187526
513,0.001124,74.125.200.0-255,2902,84298,63,187526
514,0.001126,172.31.40.0-255,66,84364,63,187526
515,0.001136,172.31.40.0-255,66,84430,63,187526
516,0.0016,74.125.200.0-255,1484,85914,63,187526
517,0.001609,74.125.200.0-255,2902,88816,63,187526
518,0.001612,172.31.40.0-255,66,88882,63,187526
519,0.001616,74.125.200.0-255,1484,90366,63,187526
520,0.001637,74.125.200.0-255,2902,93268,63,187526
521,0.001638,172.31.40.0-255,66,93334,63,187526
522,0.001642,74.125.200.0-255,2902,96236,63,187526
523,0.001644,172.31.40.0-255,66,96302,63,187526
524,0.001657,74.125.200.0-255,2902,99204,63,187526
525,0.001659,172.31.40.0-255,66,99270,63,187526
526,0.001673,74.125.200.0-255,1484,100754,63,187526
527,0.001687,74.125.200.0-255,5738,106492,63,187526
528,0.001689,172.31.40.0-255,66,106558,63,187526
529,0.001705,74.125.200.0-255,4320,110878,63,187526
530,0.001707,172.31.40.0-255,66,110944,63,187526
531,0.001748,172.31.40.0-255,66,111010,63,187526
532,0.001778,74.125.200.0-255,1484,112494,63,187526
533,0.001794,74.125.200.0-255,1484,113978,63,187526
534,0.001796,172.31.40.0-255,66,114044,63,187526
535,0.001816,74.125.200.0-255,1484,115528,63,187526
536,0.001821,74.125.200.0-255,5738,121266,63,187526
537,0.001823,172.31.40.0-255,66,121332,63,187526
538,0.001827,74.125.200.0-255,2902,124234,63,187526
539,0.001828,172.31.40.0-255,66,124300,63,187526
540,0.001852,74.125.200.0-255,4320,128620,63,187526
541,0.001854,172.31.40.0-255,66,128686,63,187526
542,0.001863,172.31.40.0-255,66,128752,63,187526
543,0.001901,172.31.40.0-255,66,128818,63,187526
544,0.002245,74.125.200.0-255,1484,130302,63,187526
545,0.002265,74.125.200.0-255,2902,133204,63,187526
546,0.002269,172.31.40.0-255,66,133270,63,187526
547,0.002274,74.125.200.0-255,4320,137590,63,187526
548,0.002276,172.31.40.0-255,66,137656,63,187526
549,0.002288,74.125.200.0-255,1484,139140,63,187526
550,0.002291,74.125.200.0-255,1484,140624,63,187526
551,0.002293,172.31.40.0-255,66,140690,63,187526
552,0.002311,74.125.200.0-255,5738,146428,63,187526
553,0.002313,172.31.40.0-255,66,146494,63,187526
554,0.002326,74.125.200.0-255,2902,149396,63,187526
555,0.002328,172.31.40.0-255,66,149462,63,187526
556,0.002355,172.31.40.0-255,66,149528,63,187526
557,0.002371,74.125.200.0-255,1484,151012,63,187526
558,0.002382,74.125.200.0-255,766,151778,63,187526
559,0.002384,172.31.40.0-255,66,151844,63,187526
560,0.004873,74.125.200.0-255,1484,153328,63,187526
561,0.004889,74.125.200.0-255,1484,154812,63,187526
562,0.004892,172.31.40.0-255,66,154878,63,187526
563,0.004907,74.125.200.0-255,2902,157780,63,187526
564,0.004909,172.31.40.0-255,66,157846,63,187526
565,0.007422,74.125.200.0-255,2902,160748,63,187526
566,0.007434,172.31.40.0-255,66,160814,63,187526
567,0.007491,74.125.200.0-255,2902,163716,63,187526
568,0.007494,172.31.40.0-255,66,163782,63,187526
569,0.00997,74.125.200.0-255,2902,166684,63,187526
570,0.009977,172.31.40.0-255,66,166750,63,187526
571,0.010007,74.125.200.0-255,2902,169652,63,187526
572,0.010009,172.31.40.0-255,66,169718,63,187526
573,0.012523,74.125.200.0-255,2902,172620,63,187526
574,0.012531,172.31.40.0-255,66,172686,63,187526
575,0.012553,74.125.200.0-255,2902,175588,63,187526
576,0.012555,172.31.40.0-255,66,175654,63,187526
577,0.015074,74.125.200.0-255,2902,178556,63,187526
578,0.015086,172.31.40.0-255,66,178622,63,187526
579,0.015111,74.125.200.0-255,2902,181524,63,187526
580,0.015113,172.31.40.0-255,66,181590,63,187526
581,0.017622,74.125.200.0-255,2902,184492,63,187526
582,0.01763,172.31.40.0-255,66,184558,63,187526
583,0.017653,74.125.200.0-255,2902,187460,63,187526
584,0.017656,172.31.40.0-255,66,187526,63,187526
585,0.0,172.217.194.0-255,150,150,63,214111
586,1.5e-05,172.31.40.0-255,66,216,63,214111
587,2.2e-05,172.217.194.0-255,1484,1700,63,214111
588,2.6e-05,172.31.40.0-255,66,1766,63,214111
589,3.2e-05,172.217.194.0-255,2902,4668,63,214111
590,3.6e-05,172.31.40.0-255,66,4734,63,214111
591,4.3e-05,172.217.194.0-255,7156,11890,63,214111
592,4.7e-05,172.31.40.0-255,66,11956,63,214111
593,5.1e-05,172.217.194.0-255,2031,13987,63,214111
594,5.3e-05,172.31.40.0-255,66,14053,63,214111
595,9.1e-05,172.31.40.0-255,66,14119,63,214111
596,0.000111,172.217.194.0-255,1484,15603,63,214111
597,0.000113,172.31.40.0-255,66,15669,63,214111
598,0.00012,172.217.194.0-255,5379,21048,63,214111
599,0.000122,172.31.40.0-255,66,21114,63,214111
600,0.000221,172.217.194.0-255,1484,22598,63,214111
601,0.000225,172.31.40.0-255,66,22664,63,214111
602,0.00023,172.217.194.0-255,2902,25566,63,214111
603,0.000233,172.31.40.0-255,66,25632,63,214111
604,0.000239,172.217.194.0-255,5738,31370,63,214111
605,0.000241,172.31.40.0-255,66,31436,63,214111
606,0.00027,172.217.194.0-255,6797,38233,63,214111
607,0.000273,172.31.40.0-255,66,38299,63,214111
608,0.000443,172.217.194.0-255,1484,39783,63,214111
609,0.000448,172.31.40.0-255,66,39849,63,214111
610,0.000462,172.217.194.0-255,2902,42751,63,214111
611,0.000465,172.31.40.0-255,66,42817,63,214111
612,0.000468,172.217.194.0-255,1484,44301,63,214111
613,0.00047,172.31.40.0-255,66,44367,63,214111
614,0.000492,172.217.194.0-255,4320,48687,63,214111
615,0.000496,172.31.40.0-255,66,48753,63,214111
616,0.000514,172.217.194.0-255,1484,50237,63,214111
617,0.000541,172.217.194.0-255,5674,55911,63,214111
618,0.000544,172.31.40.0-255,66,55977,63,214111
619,0.000589,172.217.194.0-255,1484,57461,63,214111
620,0.000602,172.217.194.0-255,2902,60363,63,214111
621,0.000605,172.31.40.0-255,66,60429,63,214111
622,0.000619,172.217.194.0-255,2902,63331,63,214111
623,0.000622,172.31.40.0-255,66,63397,63,214111
624,0.000638,172.217.194.0-255,2902,66299,63,214111
625,0.000641,172.31.40.0-255,66,66365,63,214111
626,0.000668,172.31.40.0-255,66,66431,63,214111
627,0.000691,172.217.194.0-255,1484,67915,63,214111
628,0.000698,172.217.194.0-255,5738,73653,63,214111
629,0.000701,172.31.40.0-255,66,73719,63,214111
630,0.000729,172.217.194.0-255,2902,76621,63,214111
631,0.000732,172.31.40.0-255,66,76687,63,214111
632,0.000752,172.217.194.0-255,2184,78871,63,214111
633,0.000754,172.31.40.0-255,66,78937,63,214111
634,0.000785,172.217.194.0-255,3218,82155,63,214111
635,0.000788,172.31.40.0-255,66,82221,63,214111
636,0.000793,172.217.194.0-255,4320,86541,63,214111
637,0.000796,172.31.40.0-255,66,86607,63,214111
638,0.000806,172.31.40.0-255,66,86673,63,214111
639,0.000818,172.217.194.0-255,1484,88157,63,214111
640,0.000824,172.217.194.0-255,4320,92477,63,214111
641,0.000826,172.31.40.0-255,66,92543,63,214111
642,0.00085,172.31.40.0-255,66,92609,63,214111
643,0.000872,172.217.194.0-255,3602,96211,63,214111
644,0.000875,172.31.40.0-255,66,96277,63,214111
645,0.000946,172.217.194.0-255,1484,97761,63,214111
646,0.000951,172.217.194.0-255,2902,100663,63,214111
647,0.000954,172.31.40.0-255,66,100729,63,214111
648,0.000976,172.217.194.0-255,2902,103631,63,214111
649,0.000982,172.31.40.0-255,66,103697,63,214111
650,0.000993,172.217.194.0-255,4320,108017,63,214111
651,0.000995,172.31.40.0-255,66,108083,63,214111
652,0.001001,172.217.194.0-255,5738,113821,63,214111
653,0.001003,172.31.40.0-255,66,113887,63,214111
654,0.001034,172.217.194.0-255,2902,116789,63,214111
655,0.001036,172.31.40.0-255,66,116855,63,214111
656,0.001044,172.217.194.0-255,7156,124011,63,214111
657,0.001046,172.31.40.0-255,66,124077,63,214111
658,0.001074,172.217.194.0-255,6438,130515,63,214111
659,0.001076,172.31.40.0-255,66,130581,63,214111
660,0.001151,172.217.194.0-255,5738,136319,63,214111
661,0.001154,172.31.40.0-255,66,136385,63,214111
662,0.001179,172.217.194.0-255,1484,137869,63,214111
663,0.001185,172.217.194.0-255,4320,142189,63,214111
664,0.001187,172.31.40.0-255,66,142255,63,214111
665,0.0012,172.31.40.0-255,66,142321,63,214111
666,0.001212,172.31.40.0-255,66,142387,63,214111
667,0.001234,172.217.194.0-255,7156,149543,63,214111
668,0.001236,172.31.40.0-255,66,149609,63,214111
669,0.001265,172.217.194.0-255,2902,152511,63,214111
670,0.001268,172.31.40.0-255,66,152577,63,214111
671,0.001281,172.31.40.0-255,66,152643,63,214111
672,0.001286,172.217.194.0-255,4320,156963,63,214111
673,0.001288,172.31.40.0-255,66,157029,63,214111
674,0.001314,172.31.40.0-255,66,157095,63,214111
675,0.001344,172.31.40.0-255,66,157161,63,214111
676,0.001355,172.217.194.0-255,4320,161481,63,214111
677,0.001358,172.31.40.0-255,66,161547,63,214111
678,0.001392,172.31.40.0-255,66,161613,63,214111
679,0.001412,172.217.194.0-255,3602,165215,63,214111
680,0.001414,172.31.40.0-255,66,165281,63,214111
681,0.001419,172.217.194.0-255,2902,168183,63,214111
682,0.001422,172.31.40.0-255,66,168249,63,214111
683,0.001436,172.217.194.0-255,1484,169733,63,214111
684,0.00145,172.217.194.0-255,2902,172635,63,214111
685,0.001463,172.31.40.0-255,66,172701,63,214111
686,0.001481,172.217.194.0-255,1484,174185,63,214111
687,0.001502,172.217.194.0-255,6438,180623,63,214111
688,0.00152,172.31.40.0-255,66,180689,63,214111
689,0.001549,172.217.194.0-255,1484,182173,63,214111
690,0.001562,172.217.194.0-255,2902,185075,63,214111
691,0.001572,172.31.40.0-255,66,185141,63,214111
692,0.001596,172.217.194.0-255,5738,190879,63,214111
693,0.001602,172.217.194.0-255,5738,196617,63,214111
694,0.001611,172.31.40.0-255,66,196683,63,214111
695,0.001615,172.217.194.0-255,2902,199585,63,214111
696,0.001645,172.31.40.0-255,66,199651,63,214111
697,0.001658,172.217.194.0-255,1484,201135,63,214111
698,0.001665,172.217.194.0-255,5020,206155,63,214111
699,0.001696,172.217.194.0-255,5738,211893,63,214111
700,0.00171,172.31.40.0-255,66,211959,63,214111
701,0.001721,172.31.40.0-255,66,212025,63,214111
702,0.001846,172.217.194.0-255,1024,213049,63,214111
703,0.001849,172.31.40.0-255,66,213115,63,214111
704,0.001868,172.31.40.0-255,66,213181,63,214111
705,0.001884,172.217.194.0-255,105,213286,63,214111
706,0.001946,172.217.194.0-255,129,213415,63,214111
707,0.008294,172.31.40.0-255,105,213520,63,214111
708,0.008326,172.31.40.0-255,105,213625,63,214111
709,0.00851,172.31.40.0-255,90,213715,63,214111
710,0.008517,172.31.40.0-255,66,213781,63,214111
711,0.010793,172.217.194.0-255,66,213847,63,214111
712,0.01084,172.217.194.0-255,66,213913,63,214111
713,0.011014,172.217.194.0-255,66,213979,63,214111
714,0.01105,172.217.194.0-255,66,214045,63,214111
715,0.011058,172.31.40.0-255,66,214111,63,214111
716,0.0,74.125.200.0-255,305,305,63,290237
717,3.4e-05,172.31.40.0-255,66,371,63,290237
718,4.1e-05,74.125.200.0-255,1484,1855,63,290237
719,4.4e-05,172.31.40.0-255,66,1921,63,290237
720,5.1e-05,74.125.200.0-255,4320,6241,63,290237
721,5.4e-05,172.31.40.0-255,66,6307,63,290237
722,6e-05,74.125.200.0-255,5738,12045,63,290237
723,6.3e-05,172.31.40.0-255,66,12111,63,290237
724,6.5e-05,74.125.200.0-255,1484,13595,63,290237
725,6.7e-05,172.31.40.0-255,66,13661,63,290237
726,9e-05,74.125.200.0-255,4668,18329,63,290237
727,9.3e-05,172.31.40.0-255,66,18395,63,290237
728,9.8e-05,74.125.200.0-255,2902,21297,63,290237
729,0.0001,172.31.40.0-255,66,21363,63,290237
730,0.000128,74.125.200.0-255,7156,28519,63,290237
731,0.000131,172.31.40.0-255,66,28585,63,290237
732,0.000146,74.125.200.0-255,2543,31128,63,290237
733,0.000148,172.31.40.0-255,66,31194,63,290237
734,0.000206,74.125.200.0-255,1484,32678,63,290237
735,0.000209,172.31.40.0-255,66,32744,63,290237
736,0.000215,74.125.200.0-255,2902,35646,63,290237
737,0.000217,172.31.40.0-255,66,35712,63,290237
738,0.000251,74.125.200.0-255,5738,41450,63,290237
739,0.000254,172.31.40.0-255,66,41516,63,290237
740,0.00026,74.125.200.0-255,4320,45836,63,290237
741,0.000262,172.31.40.0-255,66,45902,63,290237
742,0.000297,74.125.200.0-255,2543,48445,63,290237
743,0.0003,172.31.40.0-255,66,48511,63,290237
744,0.000381,74.125.200.0-255,1484,49995,63,290237
745,0.000385,172.31.40.0-255,66,50061,63,290237
746,0.000399,74.125.200.0-255,2902,52963,63,290237
747,0.000403,172.31.40.0-255,66,53029,63,290237
748,0.000406,74.125.200.0-255,1484,54513,63,290237
749,0.00041,74.125.200.0-255,1484,55997,63,290237
750,0.000415,172.31.40.0-255,66,56063,63,290237
751,0.000428,74.125.200.0-255,1484,57547,63,290237
752,0.000453,74.125.200.0-255,5738,63285,63,290237
753,0.000456,172.31.40.0-255,66,63351,63,290237
754,0.000459,74.125.200.0-255,1484,64835,63,290237
755,0.000481,74.125.200.0-255,1472,66307,63,290237
756,0.000484,172.31.40.0-255,66,66373,63,290237
757,0.000506,74.125.200.0-255,330,66703,63,290237
758,0.000696,74.125.200.0-255,1484,68187,63,290237
759,0.000699,172.31.40.0-255,66,68253,63,290237
760,0.000705,74.125.200.0-255,2902,71155,63,290237
761,0.000707,172.31.40.0-255,66,71221,63,290237
762,0.000731,74.125.200.0-255,4320,75541,63,290237
763,0.000734,172.31.40.0-255,66,75607,63,290237
764,0.000778,172.31.40.0-255,66,75673,63,290237
765,0.000788,172.31.40.0-255,66,75739,63,290237
766,0.000837,172.31.40.0-255,66,75805,63,290237
767,0.000855,74.125.200.0-255,1484,77289,63,290237
768,0.000881,74.125.200.0-255,7156,84445,63,290237
769,0.000885,172.31.40.0-255,66,84511,63,290237
770,0.000905,74.125.200.0-255,7156,91667,63,290237
771,0.000908,172.31.40.0-255,66,91733,63,290237
772,0.000935,74.125.200.0-255,1994,93727,63,290237
773,0.000939,172.31.40.0-255,66,93793,63,290237
774,0.000942,74.125.200.0-255,7156,100949,63,290237
775,0.000944,172.31.40.0-255,66,101015,63,290237
776,0.000956,172.31.40.0-255,66,101081,63,290237
777,0.000966,74.125.200.0-255,1484,102565,63,290237
778,0.000981,74.125.200.0-255,5738,108303,63,290237
779,0.000984,172.31.40.0-255,66,108369,63,290237
780,0.000999,74.125.200.0-255,5738,114107,63,290237
781,0.001002,172.31.40.0-255,66,114173,63,290237
782,0.001047,74.125.200.0-255,3602,117775,63,290237
783,0.001051,172.31.40.0-255,66,117841,63,290237
784,0.00108,74.125.200.0-255,1484,119325,63,290237
785,0.001091,74.125.200.0-255,2902,122227,63,290237
786,0.001094,172.31.40.0-255,66,122293,63,290237
787,0.001113,74.125.200.0-255,5738,128031,63,290237
788,0.001117,172.31.40.0-255,66,128097,63,290237
789,0.00113,74.125.200.0-255,2902,130999,63,290237
790,0.001132,172.31.40.0-255,66,131065,63,290237
791,0.001137,74.125.200.0-255,4320,135385,63,290237
792,0.001139,172.31.40.0-255,66,135451,63,290237
793,0.00117,172.31.40.0-255,66,135517,63,290237
794,0.001174,74.125.200.0-255,2902,138419,63,290237
795,0.001176,172.31.40.0-255,66,138485,63,290237
796,0.001181,74.125.200.0-255,4320,142805,63,290237
797,0.001183,172.31.40.0-255,66,142871,63,290237
798,0.001204,74.125.200.0-255,766,143637,63,290237
799,0.001278,74.125.200.0-255,1484,145121,63,290237
800,0.001281,172.31.40.0-255,66,145187,63,290237
801,0.001289,74.125.200.0-255,1484,146671,63,290237
802,0.0013,74.125.200.0-255,1484,148155,63,290237
803,0.001302,172.31.40.0-255,66,148221,63,290237
804,0.001307,74.125.200.0-255,5738,153959,63,290237
805,0.001309,172.31.40.0-255,66,154025,63,290237
806,0.001314,74.125.200.0-255,2902,156927,63,290237
807,0.001315,172.31.40.0-255,66,156993,63,290237
808,0.001338,74.125.200.0-255,4320,161313,63,290237
809,0.001341,172.31.40.0-255,66,161379,63,290237
810,0.001344,74.125.200.0-255,1484,162863,63,290237
811,0.001362,74.125.200.0-255,7156,170019,63,290237
812,0.001364,172.31.40.0-255,66,170085,63,290237
813,0.001395,172.31.40.0-255,66,170151,63,290237
814,0.001434,74.125.200.0-255,1484,171635,63,290237
815,0.001446,74.125.200.0-255,2902,174537,63,290237
816,0.001448,172.31.40.0-255,66,174603,63,290237
817,0.001472,74.125.200.0-255,4320,178923,63,290237
818,0.001475,172.31.40.0-255,66,178989,63,290237
819,0.00149,74.125.200.0-255,1484,180473,63,290237
820,0.00151,74.125.200.0-255,4320,184793,63,290237
821,0.001512,172.31.40.0-255,66,184859,63,290237
822,0.001515,74.125.200.0-255,1484,186343,63,290237
823,0.001532,74.125.200.0-255,4320,190663,63,290237
824,0.001534,172.31.40.0-255,66,190729,63,290237
825,0.001556,74.125.200.0-255,7156,197885,63,290237
826,0.001559,172.31.40.0-255,66,197951,63,290237
827,0.001584,74.125.200.0-255,4320,202271,63,290237
828,0.001587,172.31.40.0-255,66,202337,63,290237
829,0.00162,74.125.200.0-255,2184,204521,63,290237
830,0.001624,172.31.40.0-255,66,204587,63,290237
831,0.001685,74.125.200.0-255,1484,206071,63,290237
832,0.001691,74.125.200.0-255,2902,208973,63,290237
833,0.001693,172.31.40.0-255,66,209039,63,290237
834,0.001713,74.125.200.0-255,5738,214777,63,290237
835,0.001716,172.31.40.0-255,66,214843,63,290237
836,0.001718,74.125.200.0-255,1484,216327,63,290237
837,0.001735,74.125.200.0-255,2902,219229,63,290237
838,0.001737,172.31.40.0-255,66,219295,63,290237
839,0.001767,74.125.200.0-255,5738,225033,63,290237
840,0.001769,172.31.40.0-255,66,225099,63,290237
841,0.001772,74.125.200.0-255,1484,226583,63,290237
842,0.001787,74.125.200.0-255,2902,229485,63,290237
843,0.001789,172.31.40.0-255,66,229551,63,290237
844,0.001813,74.125.200.0-255,2902,232453,63,290237
845,0.001815,172.31.40.0-255,66,232519,63,290237
846,0.001831,74.125.200.0-255,2902,235421,63,290237
847,0.001834,172.31.40.0-255,66,235487,63,290237
848,0.001838,74.125.200.0-255,2902,238389,63,290237
849,0.001839,172.31.40.0-255,66,238455,63,290237
850,0.001862,74.125.200.0-255,766,239221,63,290237
851,0.002332,172.31.40.0-255,66,239287,63,290237
852,0.003779,74.125.200.0-255,1484,240771,63,290237
853,0.003798,74.125.200.0-255,2902,243673,63,290237
854,0.003802,172.31.40.0-255,66,243739,63,290237
855,0.004281,74.125.200.0-255,1484,245223,63,290237
856,0.005751,74.125.200.0-255,4320,249543,63,290237
857,0.005755,172.31.40.0-255,66,249609,63,290237
858,0.007724,74.125.200.0-255,5738,255347,63,290237
859,0.007735,172.31.40.0-255,66,255413,63,290237
860,0.009714,74.125.200.0-255,5738,261151,63,290237
861,0.009729,172.31.40.0-255,66,261217,63,290237
862,0.011697,74.125.200.0-255,5738,266955,63,290237
863,0.011708,172.31.40.0-255,66,267021,63,290237
864,0.013711,74.125.200.0-255,5738,272759,63,290237
865,0.013723,172.31.40.0-255,66,272825,63,290237
866,0.01569,74.125.200.0-255,5738,278563,63,290237
867,0.015698,172.31.40.0-255,66,278629,63,290237
868,0.017723,74.125.200.0-255,5738,284367,63,290237
869,0.01773,172.31.40.0-255,66,284433,63,290237
870,0.019688,74.125.200.0-255,5738,290171,63,290237
871,0.019695,172.31.40.0-255,66,290237,63,290237
872,0.0,74.125.24.0-255,153,153,63,211727
873,2.1e-05,172.31.40.0-255,66,219,63,211727
874,2.8e-05,74.125.24.0-255,1484,1703,63,211727
875,3.2e-05,172.31.40.0-255,66,1769,63,211727
876,3.7e-05,74.125.24.0-255,2902,4671,63,211727
877,4e-05,172.31.40.0-255,66,4737,63,211727
878,5.3e-05,74.125.24.0-255,7156,11893,63,211727
879,5.6e-05,172.31.40.0-255,66,11959,63,211727
880,5.8e-05,74.125.24.0-255,1484,13443,63,211727
881,6e-05,172.31.40.0-255,66,13509,63,211727
882,0.0001,172.31.40.0-255,66,13575,63,211727
883,0.000138,74.125.24.0-255,3961,17536,63,211727
884,0.000141,172.31.40.0-255,66,17602,63,211727
885,0.000146,74.125.24.0-255,4320,21922,63,211727
886,0.000149,172.31.40.0-255,66,21988,63,211727
887,0.000163,172.31.40.0-255,66,22054,63,211727
888,0.000166,74.125.24.0-255,1125,23179,63,211727
889,0.00017,172.31.40.0-255,66,23245,63,211727
890,0.00033,74.125.24.0-255,1484,24729,63,211727
891,0.000334,172.31.40.0-255,66,24795,63,211727
892,0.000339,74.125.24.0-255,2902,27697,63,211727
893,0.000341,172.31.40.0-255,66,27763,63,211727
894,0.000345,74.125.24.0-255,2902,30665,63,211727
895,0.000348,172.31.40.0-255,66,30731,63,211727
896,0.000379,74.125.24.0-255,2902,33633,63,211727
897,0.000384,172.31.40.0-255,66,33699,63,211727
898,0.000392,74.125.24.0-255,6797,40496,63,211727
899,0.000394,172.31.40.0-255,66,40562,63,211727
900,0.000396,74.125.24.0-255,395,40957,63,211727
901,0.000398,172.31.40.0-255,66,41023,63,211727
902,0.00044,74.125.24.0-255,351,41374,63,211727
903,0.000743,74.125.24.0-255,1484,42858,63,211727
904,0.000748,74.125.24.0-255,2902,45760,63,211727
905,0.000753,172.31.40.0-255,66,45826,63,211727
906,0.000757,172.31.40.0-255,66,45892,63,211727
907,0.000767,74.125.24.0-255,4320,50212,63,211727
908,0.000769,172.31.40.0-255,66,50278,63,211727
909,0.000793,74.125.24.0-255,1484,51762,63,211727
910,0.000797,74.125.24.0-255,2902,54664,63,211727
911,0.000799,172.31.40.0-255,66,54730,63,211727
912,0.000829,172.31.40.0-255,66,54796,63,211727
913,0.000831,74.125.24.0-255,1484,56280,63,211727
914,0.000874,74.125.24.0-255,4320,60600,63,211727
915,0.000877,172.31.40.0-255,66,60666,63,211727
916,0.000894,74.125.24.0-255,3961,64627,63,211727
917,0.000897,172.31.40.0-255,66,64693,63,211727
918,0.001087,74.125.24.0-255,1484,66177,63,211727
919,0.0011,74.125.24.0-255,2902,69079,63,211727
920,0.001102,74.125.24.0-255,1484,70563,63,211727
921,0.001105,172.31.40.0-255,66,70629,63,211727
922,0.00113,74.125.24.0-255,4320,74949,63,211727
923,0.001133,172.31.40.0-255,66,75015,63,211727
924,0.001139,74.125.24.0-255,7156,82171,63,211727
925,0.001141,172.31.40.0-255,66,82237,63,211727
926,0.001145,74.125.24.0-255,2902,85139,63,211727
927,0.001147,172.31.40.0-255,66,85205,63,211727
928,0.001189,172.31.40.0-255,66,85271,63,211727
929,0.001192,74.125.24.0-255,2184,87455,63,211727
930,0.001194,172.31.40.0-255,66,87521,63,211727
931,0.001198,74.125.24.0-255,2902,90423,63,211727
932,0.0012,172.31.40.0-255,66,90489,63,211727
933,0.001231,74.125.24.0-255,5738,96227,63,211727
934,0.001232,172.31.40.0-255,66,96293,63,211727
935,0.001262,74.125.24.0-255,1484,97777,63,211727
936,0.001276,172.31.40.0-255,66,97843,63,211727
937,0.001285,172.31.40.0-255,66,97909,63,211727
938,0.001323,172.31.40.0-255,66,97975,63,211727
939,0.001334,172.31.40.0-255,66,98041,63,211727
940,0.001356,74.125.24.0-255,5738,103779,63,211727
941,0.001362,172.31.40.0-255,66,103845,63,211727
942,0.001376,74.125.24.0-255,2902,106747,63,211727
943,0.001378,172.31.40.0-255,66,106813,63,211727
944,0.001407,74.125.24.0-255,3602,110415,63,211727
945,0.00141,172.31.40.0-255,66,110481,63,211727
946,0.001507,74.125.24.0-255,1484,111965,63,211727
947,0.001523,74.125.24.0-255,2902,114867,63,211727
948,0.001526,172.31.40.0-255,66,114933,63,211727
949,0.001532,74.125.24.0-255,5738,120671,63,211727
950,0.001533,172.31.40.0-255,66,120737,63,211727
951,0.001563,172.31.40.0-255,66,120803,63,211727
952,0.001575,74.125.24.0-255,1484,122287,63,211727
953,0.001596,172.31.40.0-255,66,122353,63,211727
954,0.00162,74.125.24.0-255,5738,128091,63,211727
955,0.001622,172.31.40.0-255,66,128157,63,211727
956,0.00164,74.125.24.0-255,5738,133895,63,211727
957,0.001649,172.31.40.0-255,66,133961,63,211727
958,0.001666,172.31.40.0-255,66,134027,63,211727
959,0.00169,74.125.24.0-255,7156,141183,63,211727
960,0.001696,172.31.40.0-255,66,141249,63,211727
961,0.001711,74.125.24.0-255,2184,143433,63,211727
962,0.001713,172.31.40.0-255,66,143499,63,211727
963,0.001757,172.31.40.0-255,66,143565,63,211727
964,0.001762,74.125.24.0-255,5738,149303,63,211727
965,0.001764,172.31.40.0-255,66,149369,63,211727
966,0.001777,172.31.40.0-255,66,149435,63,211727
967,0.001806,74.125.24.0-255,4320,153755,63,211727
968,0.001809,172.31.40.0-255,66,153821,63,211727
969,0.001812,74.125.24.0-255,766,154587,63,211727
970,0.001814,74.125.24.0-255,1484,156071,63,211727
971,0.001816,172.31.40.0-255,66,156137,63,211727
972,0.00182,74.125.24.0-255,4320,160457,63,211727
973,0.001822,172.31.40.0-255,66,160523,63,211727
974,0.001825,74.125.24.0-255,1484,162007,63,211727
975,0.001852,74.125.24.0-255,4320,166327,63,211727
976,0.001855,172.31.40.0-255,66,166393,63,211727
977,0.001861,74.125.24.0-255,7156,173549,63,211727
978,0.001863,172.31.40.0-255,66,173615,63,211727
979,0.001898,74.125.24.0-255,2902,176517,63,211727
980,0.0019,172.31.40.0-255,66,176583,63,211727
981,0.00194,172.31.40.0-255,66,176649,63,211727
982,0.001943,74.125.24.0-255,766,177415,63,211727
983,0.001963,74.125.24.0-255,1484,178899,63,211727
984,0.001965,172.31.40.0-255,66,178965,63,211727
985,0.001969,74.125.24.0-255,2902,181867,63,211727
986,0.001972,172.31.40.0-255,66,181933,63,211727
987,0.001976,74.125.24.0-255,2902,184835,63,211727
988,0.001978,172.31.40.0-255,66,184901,63,211727
989,0.001995,74.125.24.0-255,2902,187803,63,211727
990,0.001997,172.31.40.0-255,66,187869,63,211727
991,0.002006,74.125.24.0-255,4320,192189,63,211727
992,0.002009,172.31.40.0-255,66,192255,63,211727
993,0.002022,172.31.40.0-255,66,192321,63,211727
994,0.002065,172.31.40.0-255,66,192387,63,211727
995,0.00208,74.125.24.0-255,4320,196707,63,211727
996,0.002082,172.31.40.0-255,66,196773,63,211727
997,0.002113,74.125.24.0-255,4320,201093,63,211727
998,0.002116,172.31.40.0-255,66,201159,63,211727
999,0.002122,74.125.24.0-255,5738,206897,63,211727
1000,0.002124,172.31.40.0-255,66,206963,63,211727
1001,0.002144,172.31.40.0-255,66,207029,63,211727
1002,0.002149,74.125.24.0-255,4191,211220,63,211727
1003,0.002152,172.31.40.0-255,66,211286,63,211727
1004,0.002183,74.125.24.0-255,105,211391,63,211727
1005,0.002186,74.125.24.0-255,129,211520,63,211727
1006,0.012367,74.125.24.0-255,129,211649,63,211727
1007,0.012388,172.31.40.0-255,78,211727,63,211727
1008,0.0,74.125.24.0-255,146,146,63,193836
1009,2.4e-05,172.31.40.0-255,66,212,63,193836
1010,3.1e-05,74.125.24.0-255,1484,1696,63,193836
1011,3.5e-05,172.31.40.0-255,66,1762,63,193836
1012,4.3e-05,74.125.24.0-255,2902,4664,63,193836
1013,4.6e-05,172.31.40.0-255,66,4730,63,193836
1014,5.3e-05,74.125.24.0-255,7156,11886,63,193836
1015,5.6e-05,172.31.40.0-255,66,11952,63,193836
1016,6e-05,74.125.24.0-255,2038,13990,63,193836
1017,6.4e-05,172.31.40.0-255,66,14056,63,193836
1018,0.000119,172.31.40.0-255,66,14122,63,193836
1019,0.000131,74.125.24.0-255,1484,15606,63,193836
1020,0.000133,172.31.40.0-255,66,15672,63,193836
1021,0.000155,74.125.24.0-255,4320,19992,63,193836
1022,0.000157,172.31.40.0-255,66,20058,63,193836
1023,0.000175,74.125.24.0-255,1125,21183,63,193836
1024,0.000177,172.31.40.0-255,66,21249,63,193836
1025,0.000253,74.125.24.0-255,1484,22733,63,193836
1026,0.000257,172.31.40.0-255,66,22799,63,193836
1027,0.000262,74.125.24.0-255,2902,25701,63,193836
1028,0.000265,172.31.40.0-255,66,25767,63,193836
1029,0.00027,74.125.24.0-255,4320,30087,63,193836
1030,0.000272,172.31.40.0-255,66,30153,63,193836
1031,0.000292,74.125.24.0-255,1484,31637,63,193836
1032,0.000294,172.31.40.0-255,66,31703,63,193836
1033,0.000317,74.125.24.0-255,1484,33187,63,193836
1034,0.00032,172.31.40.0-255,66,33253,63,193836
1035,0.000344,74.125.24.0-255,5379,38632,63,193836
1036,0.000347,172.31.40.0-255,66,38698,63,193836
1037,0.000354,74.125.24.0-255,7156,45854,63,193836
1038,0.000356,172.31.40.0-255,66,45920,63,193836
1039,0.000377,74.125.24.0-255,2902,48822,63,193836
1040,0.000379,172.31.40.0-255,66,48888,63,193836
1041,0.000397,74.125.24.0-255,7091,55979,63,193836
1042,0.0004,172.31.40.0-255,66,56045,63,193836
1043,0.000416,74.125.24.0-255,383,56428,63,193836
1044,0.00061,74.125.24.0-255,1484,57912,63,193836
1045,0.000618,172.31.40.0-255,66,57978,63,193836
1046,0.000623,74.125.24.0-255,2902,60880,63,193836
1047,0.000626,172.31.40.0-255,66,60946,63,193836
1048,0.000644,74.125.24.0-255,5738,66684,63,193836
1049,0.000647,172.31.40.0-255,66,66750,63,193836
1050,0.000684,172.31.40.0-255,66,66816,63,193836
1051,0.00069,74.125.24.0-255,4320,71136,63,193836
1052,0.000692,172.31.40.0-255,66,71202,63,193836
1053,0.000717,74.125.24.0-255,7156,78358,63,193836
1054,0.00072,172.31.40.0-255,66,78424,63,193836
1055,0.000732,74.125.24.0-255,1484,79908,63,193836
1056,0.000772,172.31.40.0-255,66,79974,63,193836
1057,0.000779,74.125.24.0-255,7156,87130,63,193836
1058,0.000781,172.31.40.0-255,66,87196,63,193836
1059,0.000801,172.31.40.0-255,66,87262,63,193836
1060,0.000811,172.31.40.0-255,66,87328,63,193836
1061,0.000863,74.125.24.0-255,7156,94484,63,193836
1062,0.000866,172.31.40.0-255,66,94550,63,193836
1063,0.000898,172.31.40.0-255,66,94616,63,193836
1064,0.000923,74.125.24.0-255,5738,100354,63,193836
1065,0.000926,172.31.40.0-255,66,100420,63,193836
1066,0.000967,74.125.24.0-255,2184,102604,63,193836
1067,0.00097,172.31.40.0-255,66,102670,63,193836
1068,0.000981,172.31.40.0-255,66,102736,63,193836
1069,0.000999,172.31.40.0-255,66,102802,63,193836
1070,0.001003,74.125.24.0-255,2902,105704,63,193836
1071,0.001006,172.31.40.0-255,66,105770,63,193836
1072,0.001011,74.125.24.0-255,3602,109372,63,193836
1073,0.001013,172.31.40.0-255,66,109438,63,193836
1074,0.001018,74.125.24.0-255,4320,113758,63,193836
1075,0.00102,172.31.40.0-255,66,113824,63,193836
1076,0.001095,172.31.40.0-255,66,113890,63,193836
1077,0.001108,172.31.40.0-255,66,113956,63,193836
1078,0.001111,74.125.24.0-255,1484,115440,63,193836
1079,0.001133,74.125.24.0-255,5020,120460,63,193836
1080,0.001158,74.125.24.0-255,1484,121944,63,193836
1081,0.001162,74.125.24.0-255,2902,124846,63,193836
1082,0.001165,74.125.24.0-255,1484,126330,63,193836
1083,0.001172,172.31.40.0-255,66,126396,63,193836
1084,0.001185,74.125.24.0-255,4320,130716,63,193836
1085,0.001202,74.125.24.0-255,2902,133618,63,193836
1086,0.001233,172.31.40.0-255,66,133684,63,193836
1087,0.00124,74.125.24.0-255,1484,135168,63,193836
1088,0.001277,74.125.24.0-255,1484,136652,63,193836
1089,0.001284,172.31.40.0-255,66,136718,63,193836
1090,0.0013,74.125.24.0-255,2902,139620,63,193836
1091,0.001322,74.125.24.0-255,5738,145358,63,193836
1092,0.001327,172.31.40.0-255,66,145424,63,193836
1093,0.001346,74.125.24.0-255,7156,152580,63,193836
1094,0.001348,74.125.24.0-255,1484,154064,63,193836
1095,0.001359,172.31.40.0-255,66,154130,63,193836
1096,0.001381,74.125.24.0-255,2184,156314,63,193836
1097,0.001404,172.31.40.0-255,66,156380,63,193836
1098,0.00149,74.125.24.0-255,1484,157864,63,193836
1099,0.001495,74.125.24.0-255,2902,160766,63,193836
1100,0.001502,172.31.40.0-255,66,160832,63,193836
1101,0.00153,74.125.24.0-255,5738,166570,63,193836
1102,0.001542,74.125.24.0-255,2902,169472,63,193836
1103,0.001557,74.125.24.0-255,4320,173792,63,193836
1104,0.001562,172.31.40.0-255,66,173858,63,193836
1105,0.001602,74.125.24.0-255,5020,178878,63,193836
1106,0.001625,74.125.24.0-255,4320,183198,63,193836
1107,0.001659,172.31.40.0-255,66,183264,63,193836
1108,0.001669,74.125.24.0-255,1484,184748,63,193836
1109,0.001693,172.31.40.0-255,66,184814,63,193836
1110,0.001776,74.125.24.0-255,7156,191970,63,193836
1111,0.001781,74.125.24.0-255,1524,193494,63,193836
1112,0.001784,74.125.24.0-255,105,193599,63,193836
1113,0.0018,172.31.40.0-255,66,193665,63,193836
1114,0.009797,172.31.40.0-255,105,193770,63,193836
1115,0.012045,74.125.24.0-255,66,193836,63,193836
1116,0.0,74.125.24.0-255,153,153,63,175233
1117,1.9e-05,172.31.40.0-255,66,219,63,175233
1118,2.7e-05,74.125.24.0-255,1484,1703,63,175233
1119,3.1e-05,172.31.40.0-255,66,1769,63,175233
1120,3.6e-05,74.125.24.0-255,2902,4671,63,175233
1121,4.9e-05,172.31.40.0-255,66,4737,63,175233
1122,5.7e-05,74.125.24.0-255,7156,11893,63,175233
1123,6.1e-05,172.31.40.0-255,66,11959,63,175233
1124,6.5e-05,74.125.24.0-255,1936,13895,63,175233
1125,6.8e-05,172.31.40.0-255,66,13961,63,175233
1126,7.6e-05,74.125.24.0-255,5738,19699,63,175233
1127,7.9e-05,172.31.40.0-255,66,19765,63,175233
1128,0.000121,74.125.24.0-255,5738,25503,63,175233
1129,0.000124,172.31.40.0-255,66,25569,63,175233
1130,0.000131,74.125.24.0-255,5379,30948,63,175233
1131,0.000134,172.31.40.0-255,66,31014,63,175233
1132,0.000361,74.125.24.0-255,1484,32498,63,175233
1133,0.000366,172.31.40.0-255,66,32564,63,175233
1134,0.000373,74.125.24.0-255,2902,35466,63,175233
1135,0.000375,172.31.40.0-255,66,35532,63,175233
1136,0.000381,74.125.24.0-255,4320,39852,63,175233
1137,0.000389,172.31.40.0-255,66,39918,63,175233
1138,0.000419,74.125.24.0-255,1484,41402,63,175233
1139,0.000421,172.31.40.0-255,66,41468,63,175233
1140,0.000425,74.125.24.0-255,1484,42952,63,175233
1141,0.000427,172.31.40.0-255,66,43018,63,175233
1142,0.000447,172.31.40.0-255,66,43084,63,175233
1143,0.000457,172.31.40.0-255,66,43150,63,175233
1144,0.000523,74.125.24.0-255,397,43547,63,175233
1145,0.000526,172.31.40.0-255,66,43613,63,175233
1146,0.000579,74.125.24.0-255,347,43960,63,175233
1147,0.000646,74.125.24.0-255,1484,45444,63,175233
1148,0.000651,172.31.40.0-255,66,45510,63,175233
1149,0.000655,74.125.24.0-255,1484,46994,63,175233
1150,0.000676,74.125.24.0-255,1484,48478,63,175233
1151,0.000679,172.31.40.0-255,66,48544,63,175233
1152,0.000686,74.125.24.0-255,5738,54282,63,175233
1153,0.000689,172.31.40.0-255,66,54348,63,175233
1154,0.000713,74.125.24.0-255,4320,58668,63,175233
1155,0.000716,172.31.40.0-255,66,58734,63,175233
1156,0.000745,74.125.24.0-255,1993,60727,63,175233
1157,0.000747,172.31.40.0-255,66,60793,63,175233
1158,0.000853,74.125.24.0-255,1484,62277,63,175233
1159,0.000859,74.125.24.0-255,2902,65179,63,175233
1160,0.000862,172.31.40.0-255,66,65245,63,175233
1161,0.000867,74.125.24.0-255,2902,68147,63,175233
1162,0.000869,172.31.40.0-255,66,68213,63,175233
1163,0.000899,74.125.24.0-255,2902,71115,63,175233
1164,0.000902,172.31.40.0-255,66,71181,63,175233
1165,0.000915,172.31.40.0-255,66,71247,63,175233
1166,0.000932,172.31.40.0-255,66,71313,63,175233
1167,0.001,74.125.24.0-255,1484,72797,63,175233
1168,0.001006,74.125.24.0-255,2902,75699,63,175233
1169,0.001008,172.31.40.0-255,66,75765,63,175233
1170,0.001041,74.125.24.0-255,5738,81503,63,175233
1171,0.001044,172.31.40.0-255,66,81569,63,175233
1172,0.001055,172.31.40.0-255,66,81635,63,175233
1173,0.001095,74.125.24.0-255,5738,87373,63,175233
1174,0.0011,172.31.40.0-255,66,87439,63,175233
1175,0.001131,172.31.40.0-255,66,87505,63,175233
1176,0.001148,172.31.40.0-255,66,87571,63,175233
1177,0.0012,172.31.40.0-255,66,87637,63,175233
1178,0.001229,74.125.24.0-255,2902,90539,63,175233
1179,0.001237,172.31.40.0-255,66,90605,63,175233
1180,0.001243,74.125.24.0-255,5020,95625,63,175233
1181,0.001245,172.31.40.0-255,66,95691,63,175233
1182,0.001326,74.125.24.0-255,1484,97175,63,175233
1183,0.001343,74.125.24.0-255,2902,100077,63,175233
1184,0.001349,172.31.40.0-255,66,100143,63,175233
1185,0.00136,74.125.24.0-255,2902,103045,63,175233
1186,0.001366,172.31.40.0-255,66,103111,63,175233
1187,0.001394,74.125.24.0-255,2902,106013,63,175233
1188,0.001396,172.31.40.0-255,66,106079,63,175233
1189,0.00141,172.31.40.0-255,66,106145,63,175233
1190,0.001434,74.125.24.0-255,1484,107629,63,175233
1191,0.001447,172.31.40.0-255,66,107695,63,175233
1192,0.001459,172.31.40.0-255,66,107761,63,175233
1193,0.001476,172.31.40.0-255,66,107827,63,175233
1194,0.001525,172.31.40.0-255,66,107893,63,175233
1195,0.002188,74.125.24.0-255,1484,109377,63,175233
1196,0.002212,74.125.24.0-255,2902,112279,63,175233
1197,0.002216,172.31.40.0-255,66,112345,63,175233
1198,0.002221,74.125.24.0-255,2902,115247,63,175233
1199,0.002223,172.31.40.0-255,66,115313,63,175233
1200,0.002251,74.125.24.0-255,2902,118215,63,175233
1201,0.002254,172.31.40.0-255,66,118281,63,175233
1202,0.002268,172.31.40.0-255,66,118347,63,175233
1203,0.002275,74.125.24.0-255,5738,124085,63,175233
1204,0.002276,172.31.40.0-255,66,124151,63,175233
1205,0.002297,172.31.40.0-255,66,124217,63,175233
1206,0.002304,74.125.24.0-255,1484,125701,63,175233
1207,0.002322,74.125.24.0-255,4320,130021,63,175233
1208,0.002324,172.31.40.0-255,66,130087,63,175233
1209,0.002353,74.125.24.0-255,4320,134407,63,175233
1210,0.002356,172.31.40.0-255,66,134473,63,175233
1211,0.002371,172.31.40.0-255,66,134539,63,175233
1212,0.002411,172.31.40.0-255,66,134605,63,175233
1213,0.004718,74.125.24.0-255,5738,140343,63,175233
1214,0.004736,172.31.40.0-255,66,140409,63,175233
1215,0.007027,74.125.24.0-255,5738,146147,63,175233
1216,0.007042,172.31.40.0-255,66,146213,63,175233
1217,0.009343,74.125.24.0-255,5738,151951,63,175233
1218,0.009359,172.31.40.0-255,66,152017,63,175233
1219,0.011613,74.125.24.0-255,5738,157755,63,175233
1220,0.011625,172.31.40.0-255,66,157821,63,175233
1221,0.013893,74.125.24.0-255,5738,163559,63,175233
1222,0.0139,172.31.40.0-255,66,163625,63,175233
1223,0.016276,74.125.24.0-255,5738,169363,63,175233
1224,0.016282,172.31.40.0-255,66,169429,63,175233
1225,0.018542,74.125.24.0-255,5738,175167,63,175233
1226,0.018549,172.31.40.0-255,66,175233,63,175233
1227,0.0,74.125.24.0-255,153,153,63,205686
1228,1.6e-05,172.31.40.0-255,66,219,63,205686
1229,2.3e-05,74.125.24.0-255,1484,1703,63,205686
1230,2.6e-05,172.31.40.0-255,66,1769,63,205686
1231,3.1e-05,74.125.24.0-255,2902,4671,63,205686
1232,3.4e-05,172.31.40.0-255,66,4737,63,205686
1233,5.6e-05,74.125.24.0-255,7156,11893,63,205686
1234,5.8e-05,172.31.40.0-255,66,11959,63,205686
1235,6.1e-05,74.125.24.0-255,1484,13443,63,205686
1236,6.3e-05,172.31.40.0-255,66,13509,63,205686
1237,0.000101,172.31.40.0-255,66,13575,63,205686
1238,0.000106,74.125.24.0-255,5738,19313,63,205686
1239,0.000108,172.31.40.0-255,66,19379,63,205686
1240,0.000119,74.125.24.0-255,1125,20504,63,205686
1241,0.000121,172.31.40.0-255,66,20570,63,205686
1242,0.000195,74.125.24.0-255,1484,22054,63,205686
1243,0.000198,172.31.40.0-255,66,22120,63,205686
1244,0.000213,74.125.24.0-255,2902,25022,63,205686
1245,0.000216,172.31.40.0-255,66,25088,63,205686
1246,0.000219,74.125.24.0-255,1484,26572,63,205686
1247,0.000221,172.31.40.0-255,66,26638,63,205686
1248,0.00024,74.125.24.0-255,4320,30958,63,205686
1249,0.000242,172.31.40.0-255,66,31024,63,205686
1250,0.000246,74.125.24.0-255,2902,33926,63,205686
1251,0.000248,172.31.40.0-255,66,33992,63,205686
1252,0.000277,172.31.40.0-255,66,34058,63,205686
1253,0.000295,74.125.24.0-255,1484,35542,63,205686
1254,0.000297,172.31.40.0-255,66,35608,63,205686
1255,0.000302,74.125.24.0-255,5738,41346,63,205686
1256,0.000304,172.31.40.0-255,66,41412,63,205686
1257,0.000361,74.125.24.0-255,4320,45732,63,205686
1258,0.000375,74.125.24.0-255,1376,47108,63,205686
1259,0.000402,172.31.40.0-255,66,47174,63,205686
1260,0.000477,74.125.24.0-255,1484,48658,63,205686
1261,0.000489,74.125.24.0-255,2902,51560,63,205686
1262,0.0005,74.125.24.0-255,2902,54462,63,205686
1263,0.000505,172.31.40.0-255,66,54528,63,205686
1264,0.000518,74.125.24.0-255,2902,57430,63,205686
1265,0.000523,74.125.24.0-255,4320,61750,63,205686
1266,0.000532,172.31.40.0-255,66,61816,63,205686
1267,0.000556,74.125.24.0-255,7156,68972,63,205686
1268,0.000562,172.31.40.0-255,66,69038,63,205686
1269,0.000588,74.125.24.0-255,4320,73358,63,205686
1270,0.000606,172.31.40.0-255,66,73424,63,205686
1271,0.000718,74.125.24.0-255,1484,74908,63,205686
1272,0.000722,74.125.24.0-255,1484,76392,63,205686
1273,0.000737,74.125.24.0-255,1484,77876,63,205686
1274,0.000744,74.125.24.0-255,5738,83614,63,205686
1275,0.000754,172.31.40.0-255,66,83680,63,205686
1276,0.000763,74.125.24.0-255,1484,85164,63,205686
1277,0.000793,74.125.24.0-255,5738,90902,63,205686
1278,0.000797,172.31.40.0-255,66,90968,63,205686
1279,0.000807,74.125.24.0-255,1484,92452,63,205686
1280,0.000832,74.125.24.0-255,4320,96772,63,205686
1281,0.000864,172.31.40.0-255,66,96838,63,205686
1282,0.000873,74.125.24.0-255,3602,100440,63,205686
1283,0.000939,172.31.40.0-255,66,100506,63,205686
1284,0.001054,74.125.24.0-255,1484,101990,63,205686
1285,0.001068,74.125.24.0-255,2902,104892,63,205686
1286,0.001078,172.31.40.0-255,66,104958,63,205686
1287,0.001091,74.125.24.0-255,5738,110696,63,205686
1288,0.001106,172.31.40.0-255,66,110762,63,205686
1289,0.001119,74.125.24.0-255,2902,113664,63,205686
1290,0.001129,172.31.40.0-255,66,113730,63,205686
1291,0.001159,74.125.24.0-255,5738,119468,63,205686
1292,0.001171,172.31.40.0-255,66,119534,63,205686
1293,0.001181,74.125.24.0-255,4320,123854,63,205686
1294,0.001185,172.31.40.0-255,66,123920,63,205686
1295,0.001192,74.125.24.0-255,766,124686,63,205686
1296,0.001317,74.125.24.0-255,1484,126170,63,205686
1297,0.001322,74.125.24.0-255,2902,129072,63,205686
1298,0.001333,74.125.24.0-255,2902,131974,63,205686
1299,0.001345,74.125.24.0-255,4320,136294,63,205686
1300,0.001352,172.31.40.0-255,66,136360,63,205686
1301,0.001362,74.125.24.0-255,2902,139262,63,205686
1302,0.001373,74.125.24.0-255,2902,142164,63,205686
1303,0.00138,172.31.40.0-255,66,142230,63,205686
1304,0.0014,74.125.24.0-255,3602,145832,63,205686
1305,0.001416,172.31.40.0-255,66,145898,63,205686
1306,0.001457,74.125.24.0-255,5738,151636,63,205686
1307,0.001469,74.125.24.0-255,4320,155956,63,205686
1308,0.001479,172.31.40.0-255,66,156022,63,205686
1309,0.001498,74.125.24.0-255,4320,160342,63,205686
1310,0.001503,172.31.40.0-255,66,160408,63,205686
1311,0.001535,172.31.40.0-255,66,160474,63,205686
1312,0.001583,74.125.24.0-255,1484,161958,63,205686
1313,0.0016,74.125.24.0-255,2902,164860,63,205686
1314,0.001622,172.31.40.0-255,66,164926,63,205686
1315,0.001628,74.125.24.0-255,5738,170664,63,205686
1316,0.001636,172.31.40.0-255,66,170730,63,205686
1317,0.001678,172.31.40.0-255,66,170796,63,205686
1318,0.001735,172.31.40.0-255,66,170862,63,205686
1319,0.003782,74.125.24.0-255,5738,176600,63,205686
1320,0.003789,172.31.40.0-255,66,176666,63,205686
1321,0.005846,74.125.24.0-255,5738,182404,63,205686
1322,0.009332,172.31.40.0-255,66,182470,63,205686
1323,0.011396,74.125.24.0-255,5738,188208,63,205686
1324,0.011406,172.31.40.0-255,66,188274,63,205686
1325,0.01348,74.125.24.0-255,5738,194012,63,205686
1326,0.014299,172.31.40.0-255,66,194078,63,205686
1327,0.016409,74.125.24.0-255,5738,199816,63,205686
1328,0.016418,172.31.40.0-255,66,199882,63,205686
1329,0.018457,74.125.24.0-255,5738,205620,63,205686
1330,0.018467,172.31.40.0-255,66,205686,63,205686
1331,0.0,216.58.203.0-255,153,153,63,235015
1332,2.2e-05,172.31.40.0-255,66,219,63,235015
1333,2.9e-05,216.58.203.0-255,1484,1703,63,235015
1334,3.3e-05,172.31.40.0-255,66,1769,63,235015
1335,4e-05,216.58.203.0-255,2902,4671,63,235015
1336,4.4e-05,172.31.40.0-255,66,4737,63,235015
1337,5.1e-05,216.58.203.0-255,7156,11893,63,235015
1338,5.4e-05,172.31.40.0-255,66,11959,63,235015
1339,5.9e-05,216.58.203.0-255,4863,16822,63,235015
1340,6.3e-05,172.31.40.0-255,66,16888,63,235015
1341,6.6e-05,216.58.203.0-255,1484,18372,63,235015
1342,6.9e-05,172.31.40.0-255,66,18438,63,235015
1343,0.000109,216.58.203.0-255,4320,22758,63,235015
1344,0.000111,172.31.40.0-255,66,22824,63,235015
1345,0.000122,172.31.40.0-255,66,22890,63,235015
1346,0.000153,216.58.203.0-255,2902,25792,63,235015
1347,0.000156,172.31.40.0-255,66,25858,63,235015
1348,0.000181,216.58.203.0-255,4320,30178,63,235015
1349,0.000192,172.31.40.0-255,66,30244,63,235015
1350,0.000195,172.31.40.0-255,66,30310,63,235015
1351,0.000222,216.58.203.0-255,1125,31435,63,235015
1352,0.000225,172.31.40.0-255,66,31501,63,235015
1353,0.0003,216.58.203.0-255,1484,32985,63,235015
1354,0.000304,172.31.40.0-255,66,33051,63,235015
1355,0.00031,216.58.203.0-255,2902,35953,63,235015
1356,0.000312,172.31.40.0-255,66,36019,63,235015
1357,0.000315,216.58.203.0-255,1484,37503,63,235015
1358,0.000318,172.31.40.0-255,66,37569,63,235015
1359,0.000344,216.58.203.0-255,4320,41889,63,235015
1360,0.000346,172.31.40.0-255,66,41955,63,235015
1361,0.00037,216.58.203.0-255,7129,49084,63,235015
1362,0.000373,172.31.40.0-255,66,49150,63,235015
1363,0.000561,216.58.203.0-255,115,49265,63,235015
1364,0.000697,216.58.203.0-255,1484,50749,63,235015
1365,0.000702,172.31.40.0-255,66,50815,63,235015
1366,0.000707,216.58.203.0-255,1484,52299,63,235015
1367,0.000711,216.58.203.0-255,1484,53783,63,235015
1368,0.000713,172.31.40.0-255,66,53849,63,235015
1369,0.00073,216.58.203.0-255,1484,55333,63,235015
1370,0.000737,216.58.203.0-255,5738,61071,63,235015
1371,0.00074,172.31.40.0-255,66,61137,63,235015
1372,0.000762,216.58.203.0-255,6797,67934,63,235015
1373,0.000765,172.31.40.0-255,66,68000,63,235015
1374,0.000772,216.58.203.0-255,7156,75156,63,235015
1375,0.000774,172.31.40.0-255,66,75222,63,235015
1376,0.000817,216.58.203.0-255,7156,82378,63,235015
1377,0.000821,172.31.40.0-255,66,82444,63,235015
1378,0.000839,216.58.203.0-255,1387,83831,63,235015
1379,0.000992,216.58.203.0-255,1484,85315,63,235015
1380,0.000997,172.31.40.0-255,66,85381,63,235015
1381,0.001001,216.58.203.0-255,2902,88283,63,235015
1382,0.001003,172.31.40.0-255,66,88349,63,235015
1383,0.001021,216.58.203.0-255,4320,92669,63,235015
1384,0.001026,172.31.40.0-255,66,92735,63,235015
1385,0.001043,216.58.203.0-255,1484,94219,63,235015
1386,0.00105,216.58.203.0-255,7156,101375,63,235015
1387,0.001052,172.31.40.0-255,66,101441,63,235015
1388,0.001066,172.31.40.0-255,66,101507,63,235015
1389,0.001084,216.58.203.0-255,1484,102991,63,235015
1390,0.001087,216.58.203.0-255,1484,104475,63,235015
1391,0.00109,172.31.40.0-255,66,104541,63,235015
1392,0.001093,216.58.203.0-255,766,105307,63,235015
1393,0.001149,216.58.203.0-255,1484,106791,63,235015
1394,0.001153,172.31.40.0-255,66,106857,63,235015
1395,0.001157,216.58.203.0-255,2902,109759,63,235015
1396,0.00116,172.31.40.0-255,66,109825,63,235015
1397,0.001162,216.58.203.0-255,1484,111309,63,235015
1398,0.001178,216.58.203.0-255,2902,114211,63,235015
1399,0.00118,172.31.40.0-255,66,114277,63,235015
1400,0.001187,216.58.203.0-255,5738,120015,63,235015
1401,0.001189,172.31.40.0-255,66,120081,63,235015
1402,0.001208,216.58.203.0-255,2902,122983,63,235015
1403,0.001211,172.31.40.0-255,66,123049,63,235015
1404,0.001214,216.58.203.0-255,1484,124533,63,235015
1405,0.001246,172.31.40.0-255,66,124599,63,235015
1406,0.001324,216.58.203.0-255,1484,126083,63,235015
1407,0.001328,216.58.203.0-255,1484,127567,63,235015
1408,0.001332,172.31.40.0-255,66,127633,63,235015
1409,0.001355,216.58.203.0-255,1484,129117,63,235015
1410,0.001362,216.58.203.0-255,5738,134855,63,235015
1411,0.001367,216.58.203.0-255,5738,140593,63,235015
1412,0.001371,172.31.40.0-255,66,140659,63,235015
1413,0.001379,172.31.40.0-255,66,140725,63,235015
1414,0.001387,216.58.203.0-255,5738,146463,63,235015
1415,0.001389,172.31.40.0-255,66,146529,63,235015
1416,0.001394,216.58.203.0-255,2902,149431,63,235015
1417,0.001395,172.31.40.0-255,66,149497,63,235015
1418,0.001429,172.31.40.0-255,66,149563,63,235015
1419,0.001445,216.58.203.0-255,1484,151047,63,235015
1420,0.00145,216.58.203.0-255,2902,153949,63,235015
1421,0.001453,172.31.40.0-255,66,154015,63,235015
1422,0.00146,216.58.203.0-255,5738,159753,63,235015
1423,0.001462,172.31.40.0-255,66,159819,63,235015
1424,0.001468,216.58.203.0-255,4320,164139,63,235015
1425,0.00147,172.31.40.0-255,66,164205,63,235015
1426,0.001475,216.58.203.0-255,4320,168525,63,235015
1427,0.001478,172.31.40.0-255,66,168591,63,235015
1428,0.001506,216.58.203.0-255,1484,170075,63,235015
1429,0.001521,172.31.40.0-255,66,170141,63,235015
1430,0.001557,216.58.203.0-255,2184,172325,63,235015
1431,0.00156,172.31.40.0-255,66,172391,63,235015
1432,0.00315,216.58.203.0-255,2902,175293,63,235015
1433,0.003157,172.31.40.0-255,66,175359,63,235015
1434,0.003179,216.58.203.0-255,2902,178261,63,235015
1435,0.003181,172.31.40.0-255,66,178327,63,235015
1436,0.004782,216.58.203.0-255,4320,182647,63,235015
1437,0.004788,172.31.40.0-255,66,182713,63,235015
1438,0.004829,216.58.203.0-255,1484,184197,63,235015
1439,0.006407,216.58.203.0-255,4320,188517,63,235015
1440,0.00641,172.31.40.0-255,66,188583,63,235015
1441,0.008053,216.58.203.0-255,5738,194321,63,235015
1442,0.008067,172.31.40.0-255,66,194387,63,235015
1443,0.009699,216.58.203.0-255,5738,200125,63,235015
1444,0.009707,172.31.40.0-255,66,200191,63,235015
1445,0.011347,216.58.203.0-255,5738,205929,63,235015
1446,0.011361,172.31.40.0-255,66,205995,63,235015
1447,0.012995,216.58.203.0-255,5738,211733,63,235015
1448,0.013003,172.31.40.0-255,66,211799,63,235015
1449,0.014632,216.58.203.0-255,5738,217537,63,235015
1450,0.014641,172.31.40.0-255,66,217603,63,235015
1451,0.016276,216.58.203.0-255,5738,223341,63,235015
1452,0.016286,172.31.40.0-255,66,223407,63,235015
1453,0.017941,216.58.203.0-255,5738,229145,63,235015
1454,0.01795,172.31.40.0-255,66,229211,63,235015
1455,0.019586,216.58.203.0-255,5738,234949,63,235015
1456,0.019595,172.31.40.0-255,66,235015,63,235015
1457,0.0,74.125.68.0-255,160,160,63,167725
1458,1.5e-05,172.31.40.0-255,66,226,63,167725
1459,2.2e-05,74.125.68.0-255,1484,1710,63,167725
1460,2.7e-05,172.31.40.0-255,66,1776,63,167725
1461,3.2e-05,74.125.68.0-255,2902,4678,63,167725
1462,3.5e-05,172.31.40.0-255,66,4744,63,167725
1463,5.1e-05,74.125.68.0-255,5738,10482,63,167725
1464,5.4e-05,172.31.40.0-255,66,10548,63,167725
1465,9.1e-05,74.125.68.0-255,3519,14067,63,167725
1466,9.4e-05,172.31.40.0-255,66,14133,63,167725
1467,0.0001,74.125.68.0-255,4320,18453,63,167725
1468,0.000102,172.31.40.0-255,66,18519,63,167725
1469,0.000142,172.31.40.0-255,66,18585,63,167725
1470,0.000155,172.31.40.0-255,66,18651,63,167725
1471,0.00018,74.125.68.0-255,2902,21553,63,167725
1472,0.000182,172.31.40.0-255,66,21619,63,167725
1473,0.000216,172.31.40.0-255,66,21685,63,167725
1474,0.000428,74.125.68.0-255,1484,23169,63,167725
1475,0.000433,172.31.40.0-255,66,23235,63,167725
1476,0.00044,74.125.68.0-255,2902,26137,63,167725
1477,0.000442,172.31.40.0-255,66,26203,63,167725
1478,0.000445,74.125.68.0-255,1484,27687,63,167725
1479,0.000447,172.31.40.0-255,66,27753,63,167725
1480,0.000479,74.125.68.0-255,4320,32073,63,167725
1481,0.000482,172.31.40.0-255,66,32139,63,167725
1482,0.000489,74.125.68.0-255,5738,37877,63,167725
1483,0.000491,172.31.40.0-255,66,37943,63,167725
1484,0.000515,74.125.68.0-255,1478,39421,63,167725
1485,0.000518,172.31.40.0-255,66,39487,63,167725
1486,0.001877,74.125.68.0-255,1484,40971,63,167725
1487,0.00189,74.125.68.0-255,2902,43873,63,167725
1488,0.001894,172.31.40.0-255,66,43939,63,167725
1489,0.001902,74.125.68.0-255,4320,48259,63,167725
1490,0.001938,74.125.68.0-255,2902,51161,63,167725
1491,0.001963,74.125.68.0-255,5738,56899,63,167725
1492,0.001966,74.125.68.0-255,1484,58383,63,167725
1493,0.001981,74.125.68.0-255,2902,61285,63,167725
1494,0.00199,74.125.68.0-255,1484,62769,63,167725
1495,0.001997,74.125.68.0-255,5738,68507,63,167725
1496,0.002015,74.125.68.0-255,1484,69991,63,167725
1497,0.002021,74.125.68.0-255,3602,73593,63,167725
1498,0.002221,74.125.68.0-255,1484,75077,63,167725
1499,0.002237,74.125.68.0-255,2902,77979,63,167725
1500,0.002288,74.125.68.0-255,4320,82299,63,167725
1501,0.002316,74.125.68.0-255,5738,88037,63,167725
1502,0.002334,74.125.68.0-255,4320,92357,63,167725
1503,0.002347,74.125.68.0-255,2902,95259,63,167725
1504,0.002353,74.125.68.0-255,2902,98161,63,167725
1505,0.00238,74.125.68.0-255,1484,99645,63,167725
1506,0.002397,74.125.68.0-255,2184,101829,63,167725
1507,0.002408,74.125.68.0-255,1484,103313,63,167725
1508,0.002428,74.125.68.0-255,2902,106215,63,167725
1509,0.002449,74.125.68.0-255,5738,111953,63,167725
1510,0.002467,74.125.68.0-255,4320,116273,63,167725
1511,0.002491,74.125.68.0-255,5738,122011,63,167725
1512,0.002506,74.125.68.0-255,1484,123495,63,167725
1513,0.00252,74.125.68.0-255,2902,126397,63,167725
1514,0.00254,74.125.68.0-255,6438,132835,63,167725
1515,0.003804,172.31.40.0-255,66,132901,63,167725
1516,0.00632,74.125.68.0-255,5738,138639,63,167725
1517,0.006325,172.31.40.0-255,66,138705,63,167725
1518,0.008831,74.125.68.0-255,5738,144443,63,167725
1519,0.008838,172.31.40.0-255,66,144509,63,167725
1520,0.01135,74.125.68.0-255,5738,150247,63,167725
1521,0.011376,172.31.40.0-255,66,150313,63,167725
1522,0.013877,74.125.68.0-255,5738,156051,63,167725
1523,0.013887,172.31.40.0-255,66,156117,63,167725
1524,0.016386,74.125.68.0-255,5738,161855,63,167725
1525,0.016397,172.31.40.0-255,66,161921,63,167725
1526,0.018904,74.125.68.0-255,5738,167659,63,167725
1527,0.01891,172.31.40.0-255,66,167725,63,167725
1528,0.0,172.217.194.0-255,226,226,63,89258
1529,2.3e-05,172.31.40.0-255,66,292,63,89258
1530,3e-05,172.217.194.0-255,1484,1776,63,89258
1531,3.4e-05,172.31.40.0-255,66,1842,63,89258
1532,4.1e-05,172.217.194.0-255,4320,6162,63,89258
1533,4.4e-05,172.31.40.0-255,66,6228,63,89258
1534,0.000205,172.217.194.0-255,2902,9130,63,89258
1535,0.000211,172.31.40.0-255,66,9196,63,89258
1536,0.00023,172.217.194.0-255,5001,14197,63,89258
1537,0.000233,172.31.40.0-255,66,14263,63,89258
1538,0.000523,172.217.194.0-255,1484,15747,63,89258
1539,0.000528,172.31.40.0-255,66,15813,63,89258
1540,0.000583,172.217.194.0-255,2902,18715,63,89258
1541,0.000585,172.31.40.0-255,66,18781,63,89258
1542,0.0007,172.217.194.0-255,5738,24519,63,89258
1543,0.000704,172.31.40.0-255,66,24585,63,89258
1544,0.000942,172.217.194.0-255,6797,31382,63,89258
1545,0.000947,172.31.40.0-255,66,31448,63,89258
1546,0.001212,172.217.194.0-255,4320,35768,63,89258
1547,0.001219,172.31.40.0-255,66,35834,63,89258
1548,0.002054,172.217.194.0-255,2902,38736,63,89258
1549,0.002059,172.31.40.0-255,66,38802,63,89258
1550,0.003251,172.217.194.0-255,2902,41704,63,89258
1551,0.003256,172.31.40.0-255,66,41770,63,89258
1552,0.004105,172.217.194.0-255,2902,44672,63,89258
1553,0.004111,172.31.40.0-255,66,44738,63,89258
1554,0.005292,172.217.194.0-255,2902,47640,63,89258
1555,0.005299,172.31.40.0-255,66,47706,63,89258
1556,0.006218,172.217.194.0-255,2902,50608,63,89258
1557,0.006225,172.31.40.0-255,66,50674,63,89258
1558,0.007348,172.217.194.0-255,2902,53576,63,89258
1559,0.007354,172.31.40.0-255,66,53642,63,89258
1560,0.008266,172.217.194.0-255,2902,56544,63,89258
1561,0.008273,172.31.40.0-255,66,56610,63,89258
1562,0.009409,172.217.194.0-255,2902,59512,63,89258
1563,0.009416,172.31.40.0-255,66,59578,63,89258
1564,0.010315,172.217.194.0-255,2902,62480,63,89258
1565,0.010321,172.31.40.0-255,66,62546,63,89258
1566,0.011468,172.217.194.0-255,2902,65448,63,89258
1567,0.011475,172.31.40.0-255,66,65514,63,89258
1568,0.012352,172.217.194.0-255,2902,68416,63,89258
1569,0.012359,172.31.40.0-255,66,68482,63,89258
1570,0.013524,172.217.194.0-255,2902,71384,63,89258
1571,0.013531,172.31.40.0-255,66,71450,63,89258
1572,0.014381,172.217.194.0-255,2902,74352,63,89258
1573,0.014388,172.31.40.0-255,66,74418,63,89258
1574,0.015588,172.217.194.0-255,2902,77320,63,89258
1575,0.015595,172.31.40.0-255,66,77386,63,89258
1576,0.016448,172.217.194.0-255,2902,80288,63,89258
1577,0.016456,172.31.40.0-255,66,80354,63,89258
1578,0.017629,172.217.194.0-255,2902,83256,63,89258
1579,0.017636,172.31.40.0-255,66,83322,63,89258
1580,0.018494,172.217.194.0-255,2902,86224,63,89258
1581,0.018502,172.31.40.0-255,66,86290,63,89258
1582,0.019658,172.217.194.0-255,2902,89192,63,89258
1583,0.019666,172.31.40.0-255,66,89258,63,89258
1584,0.0,74.125.24.0-255,153,153,63,183465
1585,2.5e-05,172.31.40.0-255,66,219,63,183465
1586,3.2e-05,74.125.24.0-255,1484,1703,63,183465
1587,3.7e-05,172.31.40.0-255,66,1769,63,183465
1588,4.3e-05,74.125.24.0-255,2902,4671,63,183465
1589,5.4e-05,172.31.40.0-255,66,4737,63,183465
1590,6.1e-05,74.125.24.0-255,7156,11893,63,183465
1591,6.5e-05,172.31.40.0-255,66,11959,63,183465
1592,6.9e-05,74.125.24.0-255,2023,13982,63,183465
1593,7.2e-05,172.31.40.0-255,66,14048,63,183465
1594,0.000147,74.125.24.0-255,1484,15532,63,183465
1595,0.000149,172.31.40.0-255,66,15598,63,183465
1596,0.000155,74.125.24.0-255,2902,18500,63,183465
1597,0.000158,172.31.40.0-255,66,18566,63,183465
1598,0.000169,74.125.24.0-255,5738,24304,63,183465
1599,0.000172,172.31.40.0-255,66,24370,63,183465
1600,0.000219,74.125.24.0-255,5738,30108,63,183465
1601,0.000222,172.31.40.0-255,66,30174,63,183465
1602,0.000246,74.125.24.0-255,1125,31299,63,183465
1603,0.000248,172.31.40.0-255,66,31365,63,183465
1604,0.000256,74.125.24.0-255,7156,38521,63,183465
1605,0.000259,172.31.40.0-255,66,38587,63,183465
1606,0.000297,172.31.40.0-255,66,38653,63,183465
1607,0.000336,74.125.24.0-255,5738,44391,63,183465
1608,0.000338,172.31.40.0-255,66,44457,63,183465
1609,0.000346,74.125.24.0-255,7156,51613,63,183465
1610,0.000349,172.31.40.0-255,66,51679,63,183465
1611,0.000358,74.125.24.0-255,3961,55640,63,183465
1612,0.000361,172.31.40.0-255,66,55706,63,183465
1613,0.000396,74.125.24.0-255,430,56136,63,183465
1614,0.000398,172.31.40.0-255,66,56202,63,183465
1615,0.000741,74.125.24.0-255,346,56548,63,183465
1616,0.000937,74.125.24.0-255,1484,58032,63,183465
1617,0.000942,172.31.40.0-255,66,58098,63,183465
1618,0.000952,74.125.24.0-255,2902,61000,63,183465
1619,0.000954,172.31.40.0-255,66,61066,63,183465
1620,0.000957,74.125.24.0-255,1484,62550,63,183465
1621,0.00098,74.125.24.0-255,4320,66870,63,183465
1622,0.000982,172.31.40.0-255,66,66936,63,183465
1623,0.001014,74.125.24.0-255,7156,74092,63,183465
1624,0.001016,172.31.40.0-255,66,74158,63,183465
1625,0.001045,74.125.24.0-255,6797,80955,63,183465
1626,0.001047,172.31.40.0-255,66,81021,63,183465
1627,0.001057,172.31.40.0-255,66,81087,63,183465
1628,0.001512,74.125.24.0-255,1484,82571,63,183465
1629,0.00152,74.125.24.0-255,2902,85473,63,183465
1630,0.001523,172.31.40.0-255,66,85539,63,183465
1631,0.001531,74.125.24.0-255,5738,91277,63,183465
1632,0.001532,172.31.40.0-255,66,91343,63,183465
1633,0.001574,172.31.40.0-255,66,91409,63,183465
1634,0.001578,74.125.24.0-255,2902,94311,63,183465
1635,0.00158,172.31.40.0-255,66,94377,63,183465
1636,0.001618,172.31.40.0-255,66,94443,63,183465
1637,0.001776,74.125.24.0-255,1484,95927,63,183465
1638,0.001783,74.125.24.0-255,2902,98829,63,183465
1639,0.001787,172.31.40.0-255,66,98895,63,183465
1640,0.00182,74.125.24.0-255,5738,104633,63,183465
1641,0.001823,172.31.40.0-255,66,104699,63,183465
1642,0.001841,172.31.40.0-255,66,104765,63,183465
1643,0.00185,74.125.24.0-255,7156,111921,63,183465
1644,0.001852,172.31.40.0-255,66,111987,63,183465
1645,0.001912,74.125.24.0-255,3602,115589,63,183465
1646,0.001915,172.31.40.0-255,66,115655,63,183465
1647,0.00194,74.125.24.0-255,1484,117139,63,183465
1648,0.001945,74.125.24.0-255,2902,120041,63,183465
1649,0.001948,172.31.40.0-255,66,120107,63,183465
1650,0.001953,74.125.24.0-255,2902,123009,63,183465
1651,0.001955,172.31.40.0-255,66,123075,63,183465
1652,0.001977,74.125.24.0-255,2902,125977,63,183465
1653,0.00198,172.31.40.0-255,66,126043,63,183465
1654,0.001998,172.31.40.0-255,66,126109,63,183465
1655,0.002009,172.31.40.0-255,66,126175,63,183465
1656,0.00205,74.125.24.0-255,2184,128359,63,183465
1657,0.002053,172.31.40.0-255,66,128425,63,183465
1658,0.002106,74.125.24.0-255,1484,129909,63,183465
1659,0.002112,74.125.24.0-255,2902,132811,63,183465
1660,0.002115,172.31.40.0-255,66,132877,63,183465
1661,0.002119,74.125.24.0-255,1484,134361,63,183465
1662,0.002149,74.125.24.0-255,4320,138681,63,183465
1663,0.002152,172.31.40.0-255,66,138747,63,183465
1664,0.002163,172.31.40.0-255,66,138813,63,183465
1665,0.002223,172.31.40.0-255,66,138879,63,183465
1666,0.002327,74.125.24.0-255,1484,140363,63,183465
1667,0.002332,74.125.24.0-255,1484,141847,63,183465
1668,0.002336,172.31.40.0-255,66,141913,63,183465
1669,0.00449,74.125.24.0-255,2902,144815,63,183465
1670,0.004497,172.31.40.0-255,66,144881,63,183465
1671,0.004619,74.125.24.0-255,2902,147783,63,183465
1672,0.004623,172.31.40.0-255,66,147849,63,183465
1673,0.00678,74.125.24.0-255,2902,150751,63,183465
1674,0.006785,172.31.40.0-255,66,150817,63,183465
1675,0.006889,74.125.24.0-255,2902,153719,63,183465
1676,0.006893,172.31.40.0-255,66,153785,63,183465
1677,0.009094,74.125.24.0-255,2902,156687,63,183465
1678,0.009101,172.31.40.0-255,66,156753,63,183465
1679,0.009181,74.125.24.0-255,2902,159655,63,183465
1680,0.009185,172.31.40.0-255,66,159721,63,183465
1681,0.011388,74.125.24.0-255,2902,162623,63,183465
1682,0.011395,172.31.40.0-255,66,162689,63,183465
1683,0.011485,74.125.24.0-255,2902,165591,63,183465
1684,0.011489,172.31.40.0-255,66,165657,63,183465
1685,0.013702,74.125.24.0-255,2902,168559,63,183465
1686,0.013712,172.31.40.0-255,66,168625,63,183465
1687,0.013761,74.125.24.0-255,2902,171527,63,183465
1688,0.013765,172.31.40.0-255,66,171593,63,183465
1689,0.015998,74.125.24.0-255,2902,174495,63,183465
1690,0.016005,172.31.40.0-255,66,174561,63,183465
1691,0.016058,74.125.24.0-255,2902,177463,63,183465
1692,0.016062,172.31.40.0-255,66,177529,63,183465
1693,0.018309,74.125.24.0-255,2902,180431,63,183465
1694,0.018316,172.31.40.0-255,66,180497,63,183465
1695,0.018346,74.125.24.0-255,2902,183399,63,183465
1696,0.018349,172.31.40.0-255,66,183465,63,183465
1697,0.0,74.125.24.0-255,149,149,63,170120
1698,3.4e-05,172.31.40.0-255,66,215,63,170120
1699,4.1e-05,74.125.24.0-255,1484,1699,63,170120
1700,4.5e-05,172.31.40.0-255,66,1765,63,170120
1701,5e-05,74.125.24.0-255,2902,4667,63,170120
1702,5.3e-05,172.31.40.0-255,66,4733,63,170120
1703,6e-05,74.125.24.0-255,4320,9053,63,170120
1704,6.2e-05,172.31.40.0-255,66,9119,63,170120
1705,0.000103,74.125.24.0-255,4819,13938,63,170120
1706,0.000106,172.31.40.0-255,66,14004,63,170120
1707,0.000168,74.125.24.0-255,1484,15488,63,170120
1708,0.000171,172.31.40.0-255,66,15554,63,170120
1709,0.000175,74.125.24.0-255,2902,18456,63,170120
1710,0.00018,172.31.40.0-255,66,18522,63,170120
1711,0.000188,74.125.24.0-255,5738,24260,63,170120
1712,0.000191,172.31.40.0-255,66,24326,63,170120
1713,0.000221,74.125.24.0-255,6797,31123,63,170120
1714,0.000224,172.31.40.0-255,66,31189,63,170120
1715,0.000238,172.31.40.0-255,66,31255,63,170120
1716,0.000261,74.125.24.0-255,2902,34157,63,170120
1717,0.000263,172.31.40.0-255,66,34223,63,170120
1718,0.000281,172.31.40.0-255,66,34289,63,170120
1719,0.000357,74.125.24.0-255,4320,38609,63,170120
1720,0.000361,172.31.40.0-255,66,38675,63,170120
1721,0.000374,74.125.24.0-255,1145,39820,63,170120
1722,0.000377,172.31.40.0-255,66,39886,63,170120
1723,0.000402,74.125.24.0-255,1484,41370,63,170120
1724,0.000405,172.31.40.0-255,66,41436,63,170120
1725,0.00041,74.125.24.0-255,2902,44338,63,170120
1726,0.000412,172.31.40.0-255,66,44404,63,170120
1727,0.000434,74.125.24.0-255,5738,50142,63,170120
1728,0.000438,172.31.40.0-255,66,50208,63,170120
1729,0.000481,172.31.40.0-255,66,50274,63,170120
1730,0.000484,74.125.24.0-255,1484,51758,63,170120
1731,0.000522,172.31.40.0-255,66,51824,63,170120
1732,0.000633,74.125.24.0-255,1484,53308,63,170120
1733,0.000638,74.125.24.0-255,2902,56210,63,170120
1734,0.000642,172.31.40.0-255,66,56276,63,170120
1735,0.000664,74.125.24.0-255,5738,62014,63,170120
1736,0.000666,172.31.40.0-255,66,62080,63,170120
1737,0.000703,172.31.40.0-255,66,62146,63,170120
1738,0.000715,172.31.40.0-255,66,62212,63,170120
1739,0.000728,74.125.24.0-255,766,62978,63,170120
1740,0.000765,74.125.24.0-255,7156,70134,63,170120
1741,0.000769,172.31.40.0-255,66,70200,63,170120
1742,0.000793,172.31.40.0-255,66,70266,63,170120
1743,0.000809,74.125.24.0-255,766,71032,63,170120
1744,0.000811,172.31.40.0-255,66,71098,63,170120
1745,0.000925,74.125.24.0-255,1484,72582,63,170120
1746,0.000929,172.31.40.0-255,66,72648,63,170120
1747,0.000934,74.125.24.0-255,2902,75550,63,170120
1748,0.000937,172.31.40.0-255,66,75616,63,170120
1749,0.001046,74.125.24.0-255,5738,81354,63,170120
1750,0.00105,172.31.40.0-255,66,81420,63,170120
1751,0.001054,74.125.24.0-255,1484,82904,63,170120
1752,0.001067,172.31.40.0-255,66,82970,63,170120
1753,0.001082,172.31.40.0-255,66,83036,63,170120
1754,0.001086,74.125.24.0-255,7156,90192,63,170120
1755,0.001088,172.31.40.0-255,66,90258,63,170120
1756,0.001133,74.125.24.0-255,1484,91742,63,170120
1757,0.001153,74.125.24.0-255,7156,98898,63,170120
1758,0.001156,172.31.40.0-255,66,98964,63,170120
1759,0.00117,172.31.40.0-255,66,99030,63,170120
1760,0.001176,74.125.24.0-255,5020,104050,63,170120
1761,0.001178,172.31.40.0-255,66,104116,63,170120
1762,0.001236,74.125.24.0-255,1484,105600,63,170120
1763,0.001252,74.125.24.0-255,2902,108502,63,170120
1764,0.001255,172.31.40.0-255,66,108568,63,170120
1765,0.001262,74.125.24.0-255,5738,114306,63,170120
1766,0.001264,172.31.40.0-255,66,114372,63,170120
1767,0.001288,74.125.24.0-255,7156,121528,63,170120
1768,0.001292,172.31.40.0-255,66,121594,63,170120
1769,0.001318,74.125.24.0-255,2902,124496,63,170120
1770,0.001321,172.31.40.0-255,66,124562,63,170120
1771,0.001333,172.31.40.0-255,66,124628,63,170120
1772,0.001347,74.125.24.0-255,3602,128230,63,170120
1773,0.001351,172.31.40.0-255,66,128296,63,170120
1774,0.001371,74.125.24.0-255,4320,132616,63,170120
1775,0.001374,172.31.40.0-255,66,132682,63,170120
1776,0.001397,74.125.24.0-255,5738,138420,63,170120
1777,0.0014,172.31.40.0-255,66,138486,63,170120
1778,0.001431,172.31.40.0-255,66,138552,63,170120
1779,0.001435,74.125.24.0-255,1484,140036,63,170120
1780,0.001465,74.125.24.0-255,1484,141520,63,170120
1781,0.00147,172.31.40.0-255,66,141586,63,170120
1782,0.001514,172.31.40.0-255,66,141652,63,170120
1783,0.001527,172.31.40.0-255,66,141718,63,170120
1784,0.001541,172.31.40.0-255,66,141784,63,170120
1785,0.00159,172.31.40.0-255,66,141850,63,170120
1786,0.001623,172.31.40.0-255,66,141916,63,170120
1787,0.001636,172.31.40.0-255,66,141982,63,170120
1788,0.001641,74.125.24.0-255,5020,147002,63,170120
1789,0.001643,172.31.40.0-255,66,147068,63,170120
1790,0.002003,74.125.24.0-255,1484,148552,63,170120
1791,0.00201,74.125.24.0-255,1484,150036,63,170120
1792,0.002015,172.31.40.0-255,66,150102,63,170120
1793,0.002027,74.125.24.0-255,1484,151586,63,170120
1794,0.002035,74.125.24.0-255,5738,157324,63,170120
1795,0.002037,172.31.40.0-255,66,157390,63,170120
1796,0.002041,74.125.24.0-255,2902,160292,63,170120
1797,0.002044,172.31.40.0-255,66,160358,63,170120
1798,0.002049,74.125.24.0-255,2902,163260,63,170120
1799,0.002051,172.31.40.0-255,66,163326,63,170120
1800,0.002072,74.125.24.0-255,1484,164810,63,170120
1801,0.002099,172.31.40.0-255,66,164876,63,170120
1802,0.002103,74.125.24.0-255,3602,168478,63,170120
1803,0.002106,172.31.40.0-255,66,168544,63,170120
1804,0.002161,74.125.24.0-255,1234,169778,63,170120
1805,0.002177,74.125.24.0-255,105,169883,63,170120
1806,0.007993,172.31.40.0-255,66,169949,63,170120
1807,0.008022,172.31.40.0-255,105,170054,63,170120
1808,0.010002,74.125.24.0-255,66,170120,63,170120
1809,0.0,74.125.200.0-255,150,150,63,158468
1810,1.6e-05,172.31.40.0-255,66,216,63,158468
1811,2.3e-05,74.125.200.0-255,1484,1700,63,158468
1812,2.8e-05,172.31.40.0-255,66,1766,63,158468
1813,3.3e-05,74.125.200.0-255,2902,4668,63,158468
1814,3.6e-05,172.31.40.0-255,66,4734,63,158468
1815,4.3e-05,74.125.200.0-255,5738,10472,63,158468
1816,4.7e-05,172.31.40.0-255,66,10538,63,158468
1817,7e-05,74.125.200.0-255,3583,14121,63,158468
1818,7.3e-05,172.31.40.0-255,66,14187,63,158468
1819,9.6e-05,74.125.200.0-255,1484,15671,63,158468
1820,9.8e-05,172.31.40.0-255,66,15737,63,158468
1821,0.000118,74.125.200.0-255,2902,18639,63,158468
1822,0.00012,172.31.40.0-255,66,18705,63,158468
1823,0.000151,74.125.200.0-255,2902,21607,63,158468
1824,0.000153,172.31.40.0-255,66,21673,63,158468
1825,0.000168,74.125.200.0-255,4320,25993,63,158468
1826,0.000171,172.31.40.0-255,66,26059,63,158468
1827,0.000225,74.125.200.0-255,4320,30379,63,158468
1828,0.000228,172.31.40.0-255,66,30445,63,158468
1829,0.000254,74.125.200.0-255,3961,34406,63,158468
1830,0.000257,172.31.40.0-255,66,34472,63,158468
1831,0.000319,74.125.200.0-255,2902,37374,63,158468
1832,0.000322,172.31.40.0-255,66,37440,63,158468
1833,0.000345,74.125.200.0-255,2902,40342,63,158468
1834,0.000348,172.31.40.0-255,66,40408,63,158468
1835,0.000374,172.31.40.0-255,66,40474,63,158468
1836,0.000457,74.125.200.0-255,1484,41958,63,158468
1837,0.000461,172.31.40.0-255,66,42024,63,158468
1838,0.000479,74.125.200.0-255,2902,44926,63,158468
1839,0.000481,172.31.40.0-255,66,44992,63,158468
1840,0.000506,74.125.200.0-255,1484,46476,63,158468
1841,0.000522,74.125.200.0-255,4320,50796,63,158468
1842,0.000537,172.31.40.0-255,66,50862,63,158468
1843,0.000564,74.125.200.0-255,1484,52346,63,158468
1844,0.000595,74.125.200.0-255,5379,57725,63,158468
1845,0.000607,172.31.40.0-255,66,57791,63,158468
1846,0.000644,74.125.200.0-255,1484,59275,63,158468
1847,0.000656,74.125.200.0-255,2902,62177,63,158468
1848,0.000672,172.31.40.0-255,66,62243,63,158468
1849,0.00069,74.125.200.0-255,5738,67981,63,158468
1850,0.000736,172.31.40.0-255,66,68047,63,158468
1851,0.000748,74.125.200.0-255,1484,69531,63,158468
1852,0.000794,172.31.40.0-255,66,69597,63,158468
1853,0.000897,74.125.200.0-255,4320,73917,63,158468
1854,0.000912,74.125.200.0-255,1484,75401,63,158468
1855,0.000914,172.31.40.0-255,66,75467,63,158468
1856,0.000955,74.125.200.0-255,4542,80009,63,158468
1857,0.000977,172.31.40.0-255,66,80075,63,158468
1858,0.001028,74.125.200.0-255,1484,81559,63,158468
1859,0.001049,172.31.40.0-255,66,81625,63,158468
1860,0.001145,74.125.200.0-255,7156,88781,63,158468
1861,0.001157,172.31.40.0-255,66,88847,63,158468
1862,0.001162,74.125.200.0-255,2902,91749,63,158468
1863,0.001166,172.31.40.0-255,66,91815,63,158468
1864,0.001249,74.125.200.0-255,2902,94717,63,158468
1865,0.001257,172.31.40.0-255,66,94783,63,158468
1866,0.001274,172.31.40.0-255,66,94849,63,158468
1867,0.001368,74.125.200.0-255,7156,102005,63,158468
1868,0.001373,172.31.40.0-255,66,102071,63,158468
1869,0.001444,74.125.200.0-255,2902,104973,63,158468
1870,0.001458,74.125.200.0-255,4320,109293,63,158468
1871,0.001467,172.31.40.0-255,66,109359,63,158468
1872,0.001524,172.31.40.0-255,66,109425,63,158468
1873,0.001771,74.125.200.0-255,7156,116581,63,158468
1874,0.001786,74.125.200.0-255,2902,119483,63,158468
1875,0.002444,74.125.200.0-255,4320,123803,63,158468
1876,0.002513,74.125.200.0-255,7156,130959,63,158468
1877,0.00295,74.125.200.0-255,7156,138115,63,158468
1878,0.003159,74.125.200.0-255,4320,142435,63,158468
1879,0.003177,74.125.200.0-255,7156,149591,63,158468
1880,0.003192,74.125.200.0-255,7156,156747,63,158468
1881,0.003822,74.125.200.0-255,1484,158231,63,158468
1882,0.007365,172.31.40.0-255,66,158297,63,158468
1883,0.009948,172.31.40.0-255,105,158402,63,158468
1884,0.012454,74.125.200.0-255,66,158468,63,158468
1885,0.0,74.125.24.0-255,66,66,63,66
1886,0.0,172.217.194.0-255,154,154,63,223138
1887,1.7e-05,172.31.40.0-255,66,220,63,223138
1888,2.4e-05,172.217.194.0-255,1484,1704,63,223138
1889,2.9e-05,172.31.40.0-255,66,1770,63,223138
1890,3.5e-05,172.217.194.0-255,2902,4672,63,223138
1891,4.6e-05,172.31.40.0-255,66,4738,63,223138
1892,5.4e-05,172.217.194.0-255,7156,11894,63,223138
1893,5.7e-05,172.31.40.0-255,66,11960,63,223138
1894,6.3e-05,172.217.194.0-255,3418,15378,63,223138
1895,6.5e-05,172.31.40.0-255,66,15444,63,223138
1896,6.9e-05,172.217.194.0-255,1484,16928,63,223138
1897,7.1e-05,172.31.40.0-255,66,16994,63,223138
1898,0.00012,172.31.40.0-255,66,17060,63,223138
1899,0.000125,172.217.194.0-255,2543,19603,63,223138
1900,0.000127,172.31.40.0-255,66,19669,63,223138
1901,0.000198,172.217.194.0-255,1484,21153,63,223138
1902,0.000202,172.31.40.0-255,66,21219,63,223138
1903,0.000207,172.217.194.0-255,2902,24121,63,223138
1904,0.000209,172.31.40.0-255,66,24187,63,223138
1905,0.000213,172.217.194.0-255,2902,27089,63,223138
1906,0.000216,172.31.40.0-255,66,27155,63,223138
1907,0.000234,172.217.194.0-255,2902,30057,63,223138
1908,0.000241,172.31.40.0-255,66,30123,63,223138
1909,0.000244,172.217.194.0-255,1484,31607,63,223138
1910,0.000246,172.31.40.0-255,66,31673,63,223138
1911,0.000286,172.217.194.0-255,5379,37052,63,223138
1912,0.000289,172.31.40.0-255,66,37118,63,223138
1913,0.000297,172.217.194.0-255,7156,44274,63,223138
1914,0.000299,172.31.40.0-255,66,44340,63,223138
1915,0.000317,172.31.40.0-255,66,44406,63,223138
1916,0.000541,172.217.194.0-255,98,44504,63,223138
1917,0.000576,172.217.194.0-255,1484,45988,63,223138
1918,0.00058,172.31.40.0-255,66,46054,63,223138
1919,0.000586,172.217.194.0-255,2902,48956,63,223138
1920,0.000589,172.31.40.0-255,66,49022,63,223138
1921,0.000592,172.217.194.0-255,1484,50506,63,223138
1922,0.000615,172.217.194.0-255,2902,53408,63,223138
1923,0.000621,172.31.40.0-255,66,53474,63,223138
1924,0.000654,172.217.194.0-255,4320,57794,63,223138
1925,0.000658,172.31.40.0-255,66,57860,63,223138
1926,0.000685,172.217.194.0-255,4257,62117,63,223138
1927,0.000688,172.31.40.0-255,66,62183,63,223138
1928,0.000727,172.217.194.0-255,1484,63667,63,223138
1929,0.000748,172.217.194.0-255,2902,66569,63,223138
1930,0.000751,172.31.40.0-255,66,66635,63,223138
1931,0.000756,172.217.194.0-255,4320,70955,63,223138
1932,0.000758,172.31.40.0-255,66,71021,63,223138
1933,0.000777,172.217.194.0-255,1484,72505,63,223138
1934,0.00078,172.217.194.0-255,1484,73989,63,223138
1935,0.000782,172.31.40.0-255,66,74055,63,223138
1936,0.000819,172.31.40.0-255,66,74121,63,223138
1937,0.000831,172.31.40.0-255,66,74187,63,223138
1938,0.000859,172.217.194.0-255,5020,79207,63,223138
1939,0.000866,172.31.40.0-255,66,79273,63,223138
1940,0.000878,172.31.40.0-255,66,79339,63,223138
1941,0.00092,172.217.194.0-255,2543,81882,63,223138
1942,0.000923,172.31.40.0-255,66,81948,63,223138
1943,0.000942,172.31.40.0-255,66,82014,63,223138
1944,0.000953,172.31.40.0-255,66,82080,63,223138
1945,0.00099,172.217.194.0-255,4320,86400,63,223138
1946,0.000994,172.31.40.0-255,66,86466,63,223138
1947,0.001026,172.217.194.0-255,6438,92904,63,223138
1948,0.001031,172.31.40.0-255,66,92970,63,223138
1949,0.001086,172.217.194.0-255,1484,94454,63,223138
1950,0.0011,172.217.194.0-255,2902,97356,63,223138
1951,0.001103,172.31.40.0-255,66,97422,63,223138
1952,0.001107,172.217.194.0-255,1484,98906,63,223138
1953,0.001127,172.217.194.0-255,4320,103226,63,223138
1954,0.00113,172.31.40.0-255,66,103292,63,223138
1955,0.001158,172.217.194.0-255,5738,109030,63,223138
1956,0.001161,172.31.40.0-255,66,109096,63,223138
1957,0.001189,172.217.194.0-255,7156,116252,63,223138
1958,0.001194,172.217.194.0-255,4320,120572,63,223138
1959,0.001198,172.31.40.0-255,66,120638,63,223138
1960,0.001205,172.31.40.0-255,66,120704,63,223138
1961,0.001228,172.217.194.0-255,6438,127142,63,223138
1962,0.001235,172.31.40.0-255,66,127208,63,223138
1963,0.001267,172.217.194.0-255,7156,134364,63,223138
1964,0.00127,172.31.40.0-255,66,134430,63,223138
1965,0.001278,172.217.194.0-255,7156,141586,63,223138
1966,0.00128,172.31.40.0-255,66,141652,63,223138
1967,0.001335,172.31.40.0-255,66,141718,63,223138
1968,0.001367,172.217.194.0-255,2902,144620,63,223138
1969,0.001371,172.31.40.0-255,66,144686,63,223138
1970,0.001388,172.31.40.0-255,66,144752,63,223138
1971,0.001407,172.31.40.0-255,66,144818,63,223138
1972,0.00146,172.31.40.0-255,66,144884,63,223138
1973,0.001463,172.217.194.0-255,1484,146368,63,223138
1974,0.001467,172.217.194.0-255,2902,149270,63,223138
1975,0.001469,172.31.40.0-255,66,149336,63,223138
1976,0.001476,172.217.194.0-255,5738,155074,63,223138
1977,0.001478,172.31.40.0-255,66,155140,63,223138
1978,0.001484,172.217.194.0-255,5738,160878,63,223138
1979,0.001486,172.31.40.0-255,66,160944,63,223138
1980,0.001517,172.217.194.0-255,4320,165264,63,223138
1981,0.001521,172.217.194.0-255,2902,168166,63,223138
1982,0.001528,172.31.40.0-255,66,168232,63,223138
1983,0.001559,172.217.194.0-255,2184,170416,63,223138
1984,0.001579,172.217.194.0-255,1484,171900,63,223138
1985,0.001583,172.217.194.0-255,2902,174802,63,223138
1986,0.001585,172.31.40.0-255,66,174868,63,223138
1987,0.001595,172.217.194.0-255,2902,177770,63,223138
1988,0.00161,172.217.194.0-255,2902,180672,63,223138
1989,0.001613,172.217.194.0-255,1484,182156,63,223138
1990,0.001615,172.31.40.0-255,66,182222,63,223138
1991,0.00166,172.31.40.0-255,66,182288,63,223138
1992,0.0017,172.217.194.0-255,5020,187308,63,223138
1993,0.001712,172.217.194.0-255,2902,190210,63,223138
1994,0.001725,172.217.194.0-255,2902,193112,63,223138
1995,0.001733,172.217.194.0-255,7156,200268,63,223138
1996,0.001776,172.31.40.0-255,66,200334,63,223138
1997,0.001815,172.217.194.0-255,6438,206772,63,223138
1998,0.00182,172.217.194.0-255,4320,211092,63,223138
1999,0.001827,172.31.40.0-255,66,211158,63,223138
2000,0.001874,172.217.194.0-255,4320,215478,63,223138
2001,0.001888,172.31.40.0-255,66,215544,63,223138
2002,0.001905,172.217.194.0-255,6438,221982,63,223138
2003,0.001907,172.217.194.0-255,814,222796,63,223138
2004,0.001925,172.217.194.0-255,105,222901,63,223138
2005,0.001948,172.31.40.0-255,66,222967,63,223138
2006,0.004691,172.31.40.0-255,105,223072,63,223138
2007,0.00697,172.217.194.0-255,66,223138,63,223138
2008,0.0,74.125.68.0-255,226,226,63,76102
2009,1.4e-05,172.31.40.0-255,66,292,63,76102
2010,3.4e-05,74.125.68.0-255,1484,1776,63,76102
2011,3.8e-05,172.31.40.0-255,66,1842,63,76102
2012,5.5e-05,74.125.68.0-255,2902,4744,63,76102
2013,5.7e-05,172.31.40.0-255,66,4810,63,76102
2014,0.000153,74.125.68.0-255,2902,7712,63,76102
2015,0.000156,172.31.40.0-255,66,7778,63,76102
2016,0.000168,74.125.68.0-255,2902,10680,63,76102
2017,0.00017,172.31.40.0-255,66,10746,63,76102
2018,0.000373,74.125.68.0-255,3519,14265,63,76102
2019,0.000378,172.31.40.0-255,66,14331,63,76102
2020,0.000515,172.31.40.0-255,66,14397,63,76102
2021,0.000534,74.125.68.0-255,2902,17299,63,76102
2022,0.000536,172.31.40.0-255,66,17365,63,76102
2023,0.000953,74.125.68.0-255,5379,22744,63,76102
2024,0.00096,172.31.40.0-255,66,22810,63,76102
2025,0.002928,74.125.68.0-255,5738,28548,63,76102
2026,0.002935,172.31.40.0-255,66,28614,63,76102
2027,0.004911,74.125.68.0-255,5738,34352,63,76102
2028,0.004918,172.31.40.0-255,66,34418,63,76102
2029,0.006885,74.125.68.0-255,2902,37320,63,76102
2030,0.006892,172.31.40.0-255,66,37386,63,76102
2031,0.006924,74.125.68.0-255,1484,38870,63,76102
2032,0.006926,172.31.40.0-255,66,38936,63,76102
2033,0.006942,74.125.68.0-255,1484,40420,63,76102
2034,0.006944,172.31.40.0-255,66,40486,63,76102
2035,0.008868,74.125.68.0-255,2902,43388,63,76102
2036,0.008876,172.31.40.0-255,66,43454,63,76102
2037,0.008899,74.125.68.0-255,2902,46356,63,76102
2038,0.008902,172.31.40.0-255,66,46422,63,76102
2039,0.01084,74.125.68.0-255,2902,49324,63,76102
2040,0.010846,172.31.40.0-255,66,49390,63,76102
2041,0.010882,74.125.68.0-255,2902,52292,63,76102
2042,0.010885,172.31.40.0-255,66,52358,63,76102
2043,0.012816,74.125.68.0-255,2902,55260,63,76102
2044,0.012826,172.31.40.0-255,66,55326,63,76102
2045,0.012851,74.125.68.0-255,2902,58228,63,76102
2046,0.012853,172.31.40.0-255,66,58294,63,76102
2047,0.01484,74.125.68.0-255,2902,61196,63,76102
2048,0.014847,172.31.40.0-255,66,61262,63,76102
2049,0.014867,74.125.68.0-255,2902,64164,63,76102
2050,0.01487,172.31.40.0-255,66,64230,63,76102
2051,0.016819,74.125.68.0-255,2902,67132,63,76102
2052,0.016825,172.31.40.0-255,66,67198,63,76102
2053,0.016861,74.125.68.0-255,2902,70100,63,76102
2054,0.016863,172.31.40.0-255,66,70166,63,76102
2055,0.018804,74.125.68.0-255,2902,73068,63,76102
2056,0.018815,172.31.40.0-255,66,73134,63,76102
2057,0.018836,74.125.68.0-255,2902,76036,63,76102
2058,0.018838,172.31.40.0-255,66,76102,63,76102
2059,0.0,74.125.24.0-255,156,156,63,196046
2060,2.3e-05,172.31.40.0-255,66,222,63,196046
2061,3.1e-05,74.125.24.0-255,1484,1706,63,196046
2062,3.5e-05,172.31.40.0-255,66,1772,63,196046
2063,4e-05,74.125.24.0-255,2902,4674,63,196046
2064,5.2e-05,172.31.40.0-255,66,4740,63,196046
2065,5.9e-05,74.125.24.0-255,7156,11896,63,196046
2066,6.2e-05,172.31.40.0-255,66,11962,63,196046
2067,6.6e-05,74.125.24.0-255,2164,14126,63,196046
2068,6.9e-05,172.31.40.0-255,66,14192,63,196046
2069,8.4e-05,172.31.40.0-255,66,14258,63,196046
2070,0.000114,74.125.24.0-255,5379,19637,63,196046
2071,0.000117,172.31.40.0-255,66,19703,63,196046
2072,0.000202,74.125.24.0-255,1484,21187,63,196046
2073,0.000205,172.31.40.0-255,66,21253,63,196046
2074,0.000209,74.125.24.0-255,1484,22737,63,196046
2075,0.000211,172.31.40.0-255,66,22803,63,196046
2076,0.000238,74.125.24.0-255,1484,24287,63,196046
2077,0.000244,74.125.24.0-255,5738,30025,63,196046
2078,0.00025,74.125.24.0-255,4320,34345,63,196046
2079,0.000258,172.31.40.0-255,66,34411,63,196046
2080,0.000266,172.31.40.0-255,66,34477,63,196046
2081,0.000268,172.31.40.0-255,66,34543,63,196046
2082,0.000286,74.125.24.0-255,2902,37445,63,196046
2083,0.000289,172.31.40.0-255,66,37511,63,196046
2084,0.000325,172.31.40.0-255,66,37577,63,196046
2085,0.000332,74.125.24.0-255,6797,44374,63,196046
2086,0.000334,172.31.40.0-255,66,44440,63,196046
2087,0.000373,74.125.24.0-255,646,45086,63,196046
2088,0.000375,172.31.40.0-255,66,45152,63,196046
2089,0.00045,74.125.24.0-255,1484,46636,63,196046
2090,0.000457,74.125.24.0-255,2902,49538,63,196046
2091,0.00046,172.31.40.0-255,66,49604,63,196046
2092,0.000465,74.125.24.0-255,2902,52506,63,196046
2093,0.000467,172.31.40.0-255,66,52572,63,196046
2094,0.000488,74.125.24.0-255,2902,55474,63,196046
2095,0.000495,172.31.40.0-255,66,55540,63,196046
2096,0.0005,74.125.24.0-255,4320,59860,63,196046
2097,0.000502,172.31.40.0-255,66,59926,63,196046
2098,0.000536,172.31.40.0-255,66,59992,63,196046
2099,0.000543,74.125.24.0-255,7156,67148,63,196046
2100,0.000546,172.31.40.0-255,66,67214,63,196046
2101,0.000551,74.125.24.0-255,3053,70267,63,196046
2102,0.000554,172.31.40.0-255,66,70333,63,196046
2103,0.00059,74.125.24.0-255,2902,73235,63,196046
2104,0.000597,172.31.40.0-255,66,73301,63,196046
2105,0.000613,74.125.24.0-255,1484,74785,63,196046
2106,0.000629,74.125.24.0-255,1484,76269,63,196046
2107,0.000633,172.31.40.0-255,66,76335,63,196046
2108,0.000641,74.125.24.0-255,7156,83491,63,196046
2109,0.000643,172.31.40.0-255,66,83557,63,196046
2110,0.000646,74.125.24.0-255,1484,85041,63,196046
2111,0.000675,74.125.24.0-255,2529,87570,63,196046
2112,0.000678,172.31.40.0-255,66,87636,63,196046
2113,0.000905,74.125.24.0-255,1484,89120,63,196046
2114,0.000912,74.125.24.0-255,2902,92022,63,196046
2115,0.000916,172.31.40.0-255,66,92088,63,196046
2116,0.000921,74.125.24.0-255,1484,93572,63,196046
2117,0.000944,74.125.24.0-255,4320,97892,63,196046
2118,0.000947,172.31.40.0-255,66,97958,63,196046
2119,0.000985,172.31.40.0-255,66,98024,63,196046
2120,0.001015,74.125.24.0-255,4320,102344,63,196046
2121,0.001018,172.31.40.0-255,66,102410,63,196046
2122,0.001048,74.125.24.0-255,6438,108848,63,196046
2123,0.001051,172.31.40.0-255,66,108914,63,196046
2124,0.001219,74.125.24.0-255,1484,110398,63,196046
2125,0.001224,74.125.24.0-255,2902,113300,63,196046
2126,0.001228,172.31.40.0-255,66,113366,63,196046
2127,0.001257,74.125.24.0-255,5738,119104,63,196046
2128,0.001259,172.31.40.0-255,66,119170,63,196046
2129,0.001264,74.125.24.0-255,2902,122072,63,196046
2130,0.001266,172.31.40.0-255,66,122138,63,196046
2131,0.001311,172.31.40.0-255,66,122204,63,196046
2132,0.001316,74.125.24.0-255,4320,126524,63,196046
2133,0.001318,172.31.40.0-255,66,126590,63,196046
2134,0.001345,74.125.24.0-255,1484,128074,63,196046
2135,0.001389,74.125.24.0-255,3988,132062,63,196046
2136,0.001392,172.31.40.0-255,66,132128,63,196046
2137,0.001475,74.125.24.0-255,1484,133612,63,196046
2138,0.001492,74.125.24.0-255,2902,136514,63,196046
2139,0.001496,172.31.40.0-255,66,136580,63,196046
2140,0.001499,74.125.24.0-255,1484,138064,63,196046
2141,0.001525,74.125.24.0-255,4320,142384,63,196046
2142,0.001529,74.125.24.0-255,2902,145286,63,196046
2143,0.001532,172.31.40.0-255,66,145352,63,196046
2144,0.001535,172.31.40.0-255,66,145418,63,196046
2145,0.001559,172.31.40.0-255,66,145484,63,196046
2146,0.001596,74.125.24.0-255,1484,146968,63,196046
2147,0.00161,172.31.40.0-255,66,147034,63,196046
2148,0.002357,74.125.24.0-255,1484,148518,63,196046
2149,0.002363,74.125.24.0-255,2902,151420,63,196046
2150,0.002367,172.31.40.0-255,66,151486,63,196046
2151,0.002401,74.125.24.0-255,5738,157224,63,196046
2152,0.002405,172.31.40.0-255,66,157290,63,196046
2153,0.002409,74.125.24.0-255,2902,160192,63,196046
2154,0.00241,172.31.40.0-255,66,160258,63,196046
2155,0.002425,172.31.40.0-255,66,160324,63,196046
2156,0.002446,74.125.24.0-255,1484,161808,63,196046
2157,0.00246,172.31.40.0-255,66,161874,63,196046
2158,0.002489,74.125.24.0-255,766,162640,63,196046
2159,0.005082,74.125.24.0-255,4320,166960,63,196046
2160,0.005096,172.31.40.0-255,66,167026,63,196046
2161,0.007707,74.125.24.0-255,5738,172764,63,196046
2162,0.007711,172.31.40.0-255,66,172830,63,196046
2163,0.010341,74.125.24.0-255,5738,178568,63,196046
2164,0.010348,172.31.40.0-255,66,178634,63,196046
2165,0.012954,74.125.24.0-255,5738,184372,63,196046
2166,0.012962,172.31.40.0-255,66,184438,63,196046
2167,0.015643,74.125.24.0-255,5738,190176,63,196046
2168,0.015651,172.31.40.0-255,66,190242,63,196046
2169,0.018697,74.125.24.0-255,5738,195980,63,196046
2170,0.018706,172.31.40.0-255,66,196046,63,196046
2171,0.0,74.125.130.0-255,151,151,63,216660
2172,1.4e-05,172.31.40.0-255,66,217,63,216660
2173,2.1e-05,74.125.130.0-255,1484,1701,63,216660
2174,2.5e-05,172.31.40.0-255,66,1767,63,216660
2175,3.2e-05,74.125.130.0-255,2902,4669,63,216660
2176,4.4e-05,172.31.40.0-255,66,4735,63,216660
2177,5.1e-05,74.125.130.0-255,7156,11891,63,216660
2178,5.4e-05,172.31.40.0-255,66,11957,63,216660
2179,5.9e-05,74.125.130.0-255,2029,13986,63,216660
2180,6.2e-05,172.31.40.0-255,66,14052,63,216660
2181,0.000104,172.31.40.0-255,66,14118,63,216660
2182,0.00013,74.125.130.0-255,1484,15602,63,216660
2183,0.000133,172.31.40.0-255,66,15668,63,216660
2184,0.000139,74.125.130.0-255,5379,21047,63,216660
2185,0.000142,172.31.40.0-255,66,21113,63,216660
2186,0.000209,74.125.130.0-255,1484,22597,63,216660
2187,0.000211,172.31.40.0-255,66,22663,63,216660
2188,0.000218,74.125.130.0-255,2902,25565,63,216660
2189,0.00022,172.31.40.0-255,66,25631,63,216660
2190,0.00025,74.125.130.0-255,5738,31369,63,216660
2191,0.000253,172.31.40.0-255,66,31435,63,216660
2192,0.000291,172.31.40.0-255,66,31501,63,216660
2193,0.000326,74.125.130.0-255,4320,35821,63,216660
2194,0.000328,172.31.40.0-255,66,35887,63,216660
2195,0.000358,74.125.130.0-255,7084,42971,63,216660
2196,0.00036,172.31.40.0-255,66,43037,63,216660
2197,0.000364,74.125.130.0-255,367,43404,63,216660
2198,0.000366,172.31.40.0-255,66,43470,63,216660
2199,0.000427,74.125.130.0-255,1484,44954,63,216660
2200,0.000431,172.31.40.0-255,66,45020,63,216660
2201,0.000452,74.125.130.0-255,2902,47922,63,216660
2202,0.000454,172.31.40.0-255,66,47988,63,216660
2203,0.000461,74.125.130.0-255,5738,53726,63,216660
2204,0.000464,172.31.40.0-255,66,53792,63,216660
2205,0.000469,74.125.130.0-255,4320,58112,63,216660
2206,0.000471,172.31.40.0-255,66,58178,63,216660
2207,0.000528,74.125.130.0-255,5379,63557,63,216660
2208,0.000531,172.31.40.0-255,66,63623,63,216660
2209,0.000537,74.125.130.0-255,4320,67943,63,216660
2210,0.000539,172.31.40.0-255,66,68009,63,216660
2211,0.000557,74.125.130.0-255,1484,69493,63,216660
2212,0.000561,74.125.130.0-255,1484,70977,63,216660
2213,0.000564,172.31.40.0-255,66,71043,63,216660
2214,0.0006,74.125.130.0-255,6797,77840,63,216660
2215,0.000603,172.31.40.0-255,66,77906,63,216660
2216,0.000751,74.125.130.0-255,1484,79390,63,216660
2217,0.000769,74.125.130.0-255,2902,82292,63,216660
2218,0.000773,172.31.40.0-255,66,82358,63,216660
2219,0.000778,74.125.130.0-255,2902,85260,63,216660
2220,0.00078,172.31.40.0-255,66,85326,63,216660
2221,0.000783,74.125.130.0-255,1484,86810,63,216660
2222,0.000812,74.125.130.0-255,2902,89712,63,216660
2223,0.000825,172.31.40.0-255,66,89778,63,216660
2224,0.000827,172.31.40.0-255,66,89844,63,216660
2225,0.000835,74.125.130.0-255,1484,91328,63,216660
2226,0.000873,172.31.40.0-255,66,91394,63,216660
2227,0.000877,74.125.130.0-255,766,92160,63,216660
2228,0.000899,74.125.130.0-255,1484,93644,63,216660
2229,0.000901,172.31.40.0-255,66,93710,63,216660
2230,0.000908,74.125.130.0-255,4320,98030,63,216660
2231,0.00091,172.31.40.0-255,66,98096,63,216660
2232,0.000948,172.31.40.0-255,66,98162,63,216660
2233,0.00096,172.31.40.0-255,66,98228,63,216660
2234,0.000985,74.125.130.0-255,7156,105384,63,216660
2235,0.000987,172.31.40.0-255,66,105450,63,216660
2236,0.001009,74.125.130.0-255,2184,107634,63,216660
2237,0.001011,172.31.40.0-255,66,107700,63,216660
2238,0.001266,74.125.130.0-255,1484,109184,63,216660
2239,0.00127,74.125.130.0-255,2902,112086,63,216660
2240,0.001276,172.31.40.0-255,66,112152,63,216660
2241,0.001284,74.125.130.0-255,1484,113636,63,216660
2242,0.001323,74.125.130.0-255,4320,117956,63,216660
2243,0.001326,172.31.40.0-255,66,118022,63,216660
2244,0.001338,172.31.40.0-255,66,118088,63,216660
2245,0.001348,172.31.40.0-255,66,118154,63,216660
2246,0.001375,74.125.130.0-255,766,118920,63,216660
2247,0.001404,74.125.130.0-255,1484,120404,63,216660
2248,0.001406,172.31.40.0-255,66,120470,63,216660
2249,0.00141,74.125.130.0-255,1484,121954,63,216660
2250,0.001423,74.125.130.0-255,2902,124856,63,216660
2251,0.001425,172.31.40.0-255,66,124922,63,216660
2252,0.00146,172.31.40.0-255,66,124988,63,216660
2253,0.001467,74.125.130.0-255,7156,132144,63,216660
2254,0.001469,172.31.40.0-255,66,132210,63,216660
2255,0.001498,74.125.130.0-255,4320,136530,63,216660
2256,0.0015,172.31.40.0-255,66,136596,63,216660
2257,0.001507,74.125.130.0-255,6438,143034,63,216660
2258,0.00151,172.31.40.0-255,66,143100,63,216660
2259,0.001545,74.125.130.0-255,2902,146002,63,216660
2260,0.001547,172.31.40.0-255,66,146068,63,216660
2261,0.001553,74.125.130.0-255,4320,150388,63,216660
2262,0.001556,172.31.40.0-255,66,150454,63,216660
2263,0.001586,172.31.40.0-255,66,150520,63,216660
2264,0.001629,172.31.40.0-255,66,150586,63,216660
2265,0.001663,74.125.130.0-255,1484,152070,63,216660
2266,0.001692,74.125.130.0-255,6438,158508,63,216660
2267,0.001695,172.31.40.0-255,66,158574,63,216660
2268,0.001725,74.125.130.0-255,1484,160058,63,216660
2269,0.00173,74.125.130.0-255,2902,162960,63,216660
2270,0.001733,172.31.40.0-255,66,163026,63,216660
2271,0.001763,74.125.130.0-255,5738,168764,63,216660
2272,0.001766,172.31.40.0-255,66,168830,63,216660
2273,0.001771,74.125.130.0-255,2902,171732,63,216660
2274,0.001773,172.31.40.0-255,66,171798,63,216660
2275,0.001817,172.31.40.0-255,66,171864,63,216660
2276,0.001829,172.31.40.0-255,66,171930,63,216660
2277,0.001916,74.125.130.0-255,1484,173414,63,216660
2278,0.001922,74.125.130.0-255,2902,176316,63,216660
2279,0.001924,172.31.40.0-255,66,176382,63,216660
2280,0.00193,74.125.130.0-255,2902,179284,63,216660
2281,0.001932,172.31.40.0-255,66,179350,63,216660
2282,0.001955,74.125.130.0-255,1484,180834,63,216660
2283,0.001965,74.125.130.0-255,5738,186572,63,216660
2284,0.001968,172.31.40.0-255,66,186638,63,216660
2285,0.001971,74.125.130.0-255,1484,188122,63,216660
2286,0.002008,172.31.40.0-255,66,188188,63,216660
2287,0.002018,172.31.40.0-255,66,188254,63,216660
2288,0.002038,74.125.130.0-255,1484,189738,63,216660
2289,0.002057,74.125.130.0-255,2902,192640,63,216660
2290,0.002059,172.31.40.0-255,66,192706,63,216660
2291,0.002065,74.125.130.0-255,4320,197026,63,216660
2292,0.002068,172.31.40.0-255,66,197092,63,216660
2293,0.002086,74.125.130.0-255,1484,198576,63,216660
2294,0.00209,74.125.130.0-255,2902,201478,63,216660
2295,0.002093,172.31.40.0-255,66,201544,63,216660
2296,0.002128,172.31.40.0-255,66,201610,63,216660
2297,0.002131,74.125.130.0-255,1484,203094,63,216660
2298,0.002139,74.125.130.0-255,7156,210250,63,216660
2299,0.002141,172.31.40.0-255,66,210316,63,216660
2300,0.002174,172.31.40.0-255,66,210382,63,216660
2301,0.002189,172.31.40.0-255,66,210448,63,216660
2302,0.002215,74.125.130.0-255,5738,216186,63,216660
2303,0.002218,172.31.40.0-255,66,216252,63,216660
2304,0.002257,172.31.40.0-255,66,216318,63,216660
2305,0.002261,74.125.130.0-255,105,216423,63,216660
2306,0.013027,172.31.40.0-255,66,216489,63,216660
2307,0.013076,172.31.40.0-255,105,216594,63,216660
2308,0.015331,74.125.130.0-255,66,216660,63,216660
2309,0.0,74.125.24.0-255,153,153,63,183436
2310,1.5e-05,172.31.40.0-255,66,219,63,183436
2311,2.1e-05,74.125.24.0-255,1484,1703,63,183436
2312,2.5e-05,172.31.40.0-255,66,1769,63,183436
2313,3e-05,74.125.24.0-255,2902,4671,63,183436
2314,4e-05,172.31.40.0-255,66,4737,63,183436
2315,4.9e-05,74.125.24.0-255,7156,11893,63,183436
2316,5.3e-05,172.31.40.0-255,66,11959,63,183436
2317,5.7e-05,74.125.24.0-255,2002,13961,63,183436
2318,6.1e-05,172.31.40.0-255,66,14027,63,183436
2319,7.7e-05,74.125.24.0-255,1484,15511,63,183436
2320,8e-05,172.31.40.0-255,66,15577,63,183436
2321,0.000109,74.125.24.0-255,1484,17061,63,183436
2322,0.000112,172.31.40.0-255,66,17127,63,183436
2323,0.00012,74.125.24.0-255,7156,24283,63,183436
2324,0.000123,172.31.40.0-255,66,24349,63,183436
2325,0.000136,74.125.24.0-255,6797,31146,63,183436
2326,0.000138,172.31.40.0-255,66,31212,63,183436
2327,0.000159,74.125.24.0-255,1484,32696,63,183436
2328,0.000161,172.31.40.0-255,66,32762,63,183436
2329,0.000192,74.125.24.0-255,2902,35664,63,183436
2330,0.000194,172.31.40.0-255,66,35730,63,183436
2331,0.000201,74.125.24.0-255,5738,41468,63,183436
2332,0.000203,172.31.40.0-255,66,41534,63,183436
2333,0.000235,74.125.24.0-255,6797,48331,63,183436
2334,0.000238,172.31.40.0-255,66,48397,63,183436
2335,0.000297,74.125.24.0-255,1484,49881,63,183436
2336,0.0003,172.31.40.0-255,66,49947,63,183436
2337,0.000304,74.125.24.0-255,2902,52849,63,183436
2338,0.000307,172.31.40.0-255,66,52915,63,183436
2339,0.00031,74.125.24.0-255,1484,54399,63,183436
2340,0.000316,172.31.40.0-255,66,54465,63,183436
2341,0.000347,74.125.24.0-255,4320,58785,63,183436
2342,0.00035,172.31.40.0-255,66,58851,63,183436
2343,0.000357,74.125.24.0-255,7128,65979,63,183436
2344,0.000359,172.31.40.0-255,66,66045,63,183436
2345,0.000381,74.125.24.0-255,379,66424,63,183436
2346,0.000618,74.125.24.0-255,1484,67908,63,183436
2347,0.000623,172.31.40.0-255,66,67974,63,183436
2348,0.000629,74.125.24.0-255,2902,70876,63,183436
2349,0.000632,172.31.40.0-255,66,70942,63,183436
2350,0.000642,74.125.24.0-255,5738,76680,63,183436
2351,0.000645,172.31.40.0-255,66,76746,63,183436
2352,0.000658,172.31.40.0-255,66,76812,63,183436
2353,0.000684,74.125.24.0-255,2902,79714,63,183436
2354,0.000687,172.31.40.0-255,66,79780,63,183436
2355,0.000698,74.125.24.0-255,5738,85518,63,183436
2356,0.0007,172.31.40.0-255,66,85584,63,183436
2357,0.000706,74.125.24.0-255,5020,90604,63,183436
2358,0.000709,172.31.40.0-255,66,90670,63,183436
2359,0.001157,74.125.24.0-255,1484,92154,63,183436
2360,0.001164,74.125.24.0-255,2902,95056,63,183436
2361,0.001168,172.31.40.0-255,66,95122,63,183436
2362,0.001174,74.125.24.0-255,2902,98024,63,183436
2363,0.001176,172.31.40.0-255,66,98090,63,183436
2364,0.001212,74.125.24.0-255,2902,100992,63,183436
2365,0.001216,172.31.40.0-255,66,101058,63,183436
2366,0.001234,172.31.40.0-255,66,101124,63,183436
2367,0.001246,172.31.40.0-255,66,101190,63,183436
2368,0.001393,74.125.24.0-255,1484,102674,63,183436
2369,0.001407,74.125.24.0-255,2902,105576,63,183436
2370,0.001411,172.31.40.0-255,66,105642,63,183436
2371,0.001416,74.125.24.0-255,2902,108544,63,183436
2372,0.001417,172.31.40.0-255,66,108610,63,183436
2373,0.001437,74.125.24.0-255,2902,111512,63,183436
2374,0.001444,172.31.40.0-255,66,111578,63,183436
2375,0.001448,74.125.24.0-255,2902,114480,63,183436
2376,0.00145,172.31.40.0-255,66,114546,63,183436
2377,0.001495,172.31.40.0-255,66,114612,63,183436
2378,0.001512,172.31.40.0-255,66,114678,63,183436
2379,0.002109,74.125.24.0-255,1484,116162,63,183436
2380,0.002115,74.125.24.0-255,2902,119064,63,183436
2381,0.002118,172.31.40.0-255,66,119130,63,183436
2382,0.00214,74.125.24.0-255,5738,124868,63,183436
2383,0.002143,172.31.40.0-255,66,124934,63,183436
2384,0.002177,74.125.24.0-255,4320,129254,63,183436
2385,0.002179,172.31.40.0-255,66,129320,63,183436
2386,0.002219,172.31.40.0-255,66,129386,63,183436
2387,0.002236,172.31.40.0-255,66,129452,63,183436
2388,0.00224,74.125.24.0-255,1484,130936,63,183436
2389,0.002244,74.125.24.0-255,2902,133838,63,183436
2390,0.002246,172.31.40.0-255,66,133904,63,183436
2391,0.002252,74.125.24.0-255,5738,139642,63,183436
2392,0.002256,172.31.40.0-255,66,139708,63,183436
2393,0.00226,74.125.24.0-255,2902,142610,63,183436
2394,0.002263,172.31.40.0-255,66,142676,63,183436
2395,0.002308,172.31.40.0-255,66,142742,63,183436
2396,0.002326,172.31.40.0-255,66,142808,63,183436
2397,0.004587,74.125.24.0-255,5738,148546,63,183436
2398,0.004595,172.31.40.0-255,66,148612,63,183436
2399,0.006862,74.125.24.0-255,5738,154350,63,183436
2400,0.006869,172.31.40.0-255,66,154416,63,183436
2401,0.009156,74.125.24.0-255,5738,160154,63,183436
2402,0.009162,172.31.40.0-255,66,160220,63,183436
2403,0.011433,74.125.24.0-255,5738,165958,63,183436
2404,0.011452,172.31.40.0-255,66,166024,63,183436
2405,0.013739,74.125.24.0-255,5738,171762,63,183436
2406,0.013753,172.31.40.0-255,66,171828,63,183436
2407,0.016044,74.125.24.0-255,5738,177566,63,183436
2408,0.016062,172.31.40.0-255,66,177632,63,183436
2409,0.018342,74.125.24.0-255,5738,183370,63,183436
2410,0.018358,172.31.40.0-255,66,183436,63,183436
2411,0.0,74.125.24.0-255,150,150,63,113898
2412,1.7e-05,172.31.40.0-255,66,216,63,113898
2413,2.4e-05,74.125.24.0-255,1484,1700,63,113898
2414,2.9e-05,172.31.40.0-255,66,1766,63,113898
2415,4.1e-05,74.125.24.0-255,2902,4668,63,113898
2416,4.6e-05,172.31.40.0-255,66,4734,63,113898
2417,5.1e-05,74.125.24.0-255,4320,9054,63,113898
2418,5.5e-05,172.31.40.0-255,66,9120,63,113898
2419,6.1e-05,74.125.24.0-255,5738,14858,63,113898
2420,6.4e-05,172.31.40.0-255,66,14924,63,113898
2421,0.000105,74.125.24.0-255,3410,18334,63,113898
2422,0.000108,172.31.40.0-255,66,18400,63,113898
2423,0.000125,172.31.40.0-255,66,18466,63,113898
2424,0.000129,74.125.24.0-255,2543,21009,63,113898
2425,0.000131,172.31.40.0-255,66,21075,63,113898
2426,0.000172,74.125.24.0-255,2902,23977,63,113898
2427,0.000175,172.31.40.0-255,66,24043,63,113898
2428,0.000206,74.125.24.0-255,4320,28363,63,113898
2429,0.000209,172.31.40.0-255,66,28429,63,113898
2430,0.00022,172.31.40.0-255,66,28495,63,113898
2431,0.000228,74.125.24.0-255,1125,29620,63,113898
2432,0.00023,172.31.40.0-255,66,29686,63,113898
2433,0.000233,74.125.24.0-255,1484,31170,63,113898
2434,0.000235,172.31.40.0-255,66,31236,63,113898
2435,0.000275,74.125.24.0-255,4320,35556,63,113898
2436,0.000278,172.31.40.0-255,66,35622,63,113898
2437,0.000294,172.31.40.0-255,66,35688,63,113898
2438,0.000297,74.125.24.0-255,1437,37125,63,113898
2439,0.0003,172.31.40.0-255,66,37191,63,113898
2440,0.000848,74.125.24.0-255,108,37299,63,113898
2441,0.000874,74.125.24.0-255,1484,38783,63,113898
2442,0.000878,172.31.40.0-255,66,38849,63,113898
2443,0.000883,74.125.24.0-255,1484,40333,63,113898
2444,0.000899,74.125.24.0-255,1484,41817,63,113898
2445,0.000901,172.31.40.0-255,66,41883,63,113898
2446,0.000908,74.125.24.0-255,5738,47621,63,113898
2447,0.00091,172.31.40.0-255,66,47687,63,113898
2448,0.000944,74.125.24.0-255,4320,52007,63,113898
2449,0.000947,172.31.40.0-255,66,52073,63,113898
2450,0.000974,74.125.24.0-255,2543,54616,63,113898
2451,0.000977,172.31.40.0-255,66,54682,63,113898
2452,0.001563,74.125.24.0-255,1484,56166,63,113898
2453,0.001573,74.125.24.0-255,2902,59068,63,113898
2454,0.001577,172.31.40.0-255,66,59134,63,113898
2455,0.001586,74.125.24.0-255,5738,64872,63,113898
2456,0.001589,172.31.40.0-255,66,64938,63,113898
2457,0.001613,172.31.40.0-255,66,65004,63,113898
2458,0.001646,74.125.24.0-255,1484,66488,63,113898
2459,0.001654,74.125.24.0-255,7156,73644,63,113898
2460,0.001656,172.31.40.0-255,66,73710,63,113898
2461,0.001671,74.125.24.0-255,3602,77312,63,113898
2462,0.001677,172.31.40.0-255,66,77378,63,113898
2463,0.001708,74.125.24.0-255,4320,81698,63,113898
2464,0.001711,172.31.40.0-255,66,81764,63,113898
2465,0.00174,74.125.24.0-255,2902,84666,63,113898
2466,0.001743,172.31.40.0-255,66,84732,63,113898
2467,0.001753,172.31.40.0-255,66,84798,63,113898
2468,0.001812,172.31.40.0-255,66,84864,63,113898
2469,0.001834,74.125.24.0-255,7156,92020,63,113898
2470,0.001838,172.31.40.0-255,66,92086,63,113898
2471,0.00188,172.31.40.0-255,66,92152,63,113898
2472,0.001896,172.31.40.0-255,66,92218,63,113898
2473,0.001903,74.125.24.0-255,1484,93702,63,113898
2474,0.001964,172.31.40.0-255,66,93768,63,113898
2475,0.001984,172.31.40.0-255,66,93834,63,113898
2476,0.001998,172.31.40.0-255,66,93900,63,113898
2477,0.002042,172.31.40.0-255,66,93966,63,113898
2478,0.002062,172.31.40.0-255,66,94032,63,113898
2479,0.00211,172.31.40.0-255,66,94098,63,113898
2480,0.002123,172.31.40.0-255,66,94164,63,113898
2481,0.002146,172.31.40.0-255,66,94230,63,113898
2482,0.002183,172.31.40.0-255,66,94296,63,113898
2483,0.002228,74.125.24.0-255,1484,95780,63,113898
2484,0.002272,172.31.40.0-255,66,95846,63,113898
2485,0.002283,172.31.40.0-255,66,95912,63,113898
2486,0.002306,172.31.40.0-255,66,95978,63,113898
2487,0.00694,172.31.40.0-255,66,96044,63,113898
2488,0.009218,74.125.24.0-255,5738,101782,63,113898
2489,0.009224,172.31.40.0-255,66,101848,63,113898
2490,0.011497,74.125.24.0-255,5738,107586,63,113898
2491,0.011503,172.31.40.0-255,66,107652,63,113898
2492,0.013786,74.125.24.0-255,5738,113390,63,113898
2493,0.013794,172.31.40.0-255,66,113456,63,113898
2494,0.01606,74.125.24.0-255,205,113661,63,113898
2495,0.016574,172.31.40.0-255,66,113727,63,113898
2496,0.016609,172.31.40.0-255,105,113832,63,113898
2497,0.018842,74.125.24.0-255,66,113898,63,113898
2498,0.0,74.125.68.0-255,150,150,63,97085
2499,2.8e-05,172.31.40.0-255,66,216,63,97085
2500,3.5e-05,74.125.68.0-255,1484,1700,63,97085
2501,4e-05,172.31.40.0-255,66,1766,63,97085
2502,4.5e-05,74.125.68.0-255,2902,4668,63,97085
2503,4.8e-05,172.31.40.0-255,66,4734,63,97085
2504,5.4e-05,74.125.68.0-255,5738,10472,63,97085
2505,5.6e-05,172.31.40.0-255,66,10538,63,97085
2506,8.5e-05,74.125.68.0-255,3467,14005,63,97085
2507,8.7e-05,172.31.40.0-255,66,14071,63,97085
2508,0.000258,74.125.68.0-255,1484,15555,63,97085
2509,0.000262,172.31.40.0-255,66,15621,63,97085
2510,0.000266,74.125.68.0-255,1484,17105,63,97085
2511,0.000268,172.31.40.0-255,66,17171,63,97085
2512,0.000284,74.125.68.0-255,2902,20073,63,97085
2513,0.000287,172.31.40.0-255,66,20139,63,97085
2514,0.000291,74.125.68.0-255,1484,21623,63,97085
2515,0.000293,172.31.40.0-255,66,21689,63,97085
2516,0.000317,74.125.68.0-255,4320,26009,63,97085
2517,0.00032,172.31.40.0-255,66,26075,63,97085
2518,0.000326,74.125.68.0-255,5379,31454,63,97085
2519,0.000329,172.31.40.0-255,66,31520,63,97085
2520,0.000358,74.125.68.0-255,5738,37258,63,97085
2521,0.000361,172.31.40.0-255,66,37324,63,97085
2522,0.000386,74.125.68.0-255,7156,44480,63,97085
2523,0.000388,172.31.40.0-255,66,44546,63,97085
2524,0.000399,74.125.68.0-255,2902,47448,63,97085
2525,0.000401,172.31.40.0-255,66,47514,63,97085
2526,0.000404,74.125.68.0-255,1484,48998,63,97085
2527,0.000406,172.31.40.0-255,66,49064,63,97085
2528,0.000448,172.31.40.0-255,66,49130,63,97085
2529,0.000453,74.125.68.0-255,4320,53450,63,97085
2530,0.000455,172.31.40.0-255,66,53516,63,97085
2531,0.000476,74.125.68.0-255,2184,55700,63,97085
2532,0.000478,172.31.40.0-255,66,55766,63,97085
2533,0.000868,74.125.68.0-255,361,56127,63,97085
2534,0.000902,74.125.68.0-255,132,56259,63,97085
2535,0.001055,172.31.40.0-255,66,56325,63,97085
2536,0.003382,74.125.68.0-255,1484,57809,63,97085
2537,0.00369,74.125.68.0-255,4320,62129,63,97085
2538,0.003695,172.31.40.0-255,66,62195,63,97085
2539,0.006318,74.125.68.0-255,1484,63679,63,97085
2540,0.00634,74.125.68.0-255,4320,67999,63,97085
2541,0.006343,172.31.40.0-255,66,68065,63,97085
2542,0.008991,74.125.68.0-255,5738,73803,63,97085
2543,0.008998,172.31.40.0-255,66,73869,63,97085
2544,0.011641,74.125.68.0-255,5738,79607,63,97085
2545,0.011649,172.31.40.0-255,66,79673,63,97085
2546,0.014289,74.125.68.0-255,5738,85411,63,97085
2547,0.014297,172.31.40.0-255,66,85477,63,97085
2548,0.016961,74.125.68.0-255,5738,91215,63,97085
2549,0.016975,172.31.40.0-255,66,91281,63,97085
2550,0.019622,74.125.68.0-255,5738,97019,63,97085
2551,0.019633,172.31.40.0-255,66,97085,63,97085
2552,0.0,172.217.194.0-255,153,153,63,179930
2553,2.4e-05,172.31.40.0-255,66,219,63,179930
2554,3.1e-05,172.217.194.0-255,1484,1703,63,179930
2555,3.5e-05,172.31.40.0-255,66,1769,63,179930
2556,4.8e-05,172.217.194.0-255,2902,4671,63,179930
2557,5.2e-05,172.31.40.0-255,66,4737,63,179930
2558,6e-05,172.217.194.0-255,7156,11893,63,179930
2559,6.3e-05,172.31.40.0-255,66,11959,63,179930
2560,8.1e-05,172.31.40.0-255,66,12025,63,179930
2561,8.4e-05,172.217.194.0-255,1484,13509,63,179930
2562,8.7e-05,172.31.40.0-255,66,13575,63,179930
2563,0.000114,172.217.194.0-255,1125,14700,63,179930
2564,0.000121,172.31.40.0-255,66,14766,63,179930
2565,0.000147,172.217.194.0-255,1484,16250,63,179930
2566,0.000149,172.31.40.0-255,66,16316,63,179930
2567,0.000154,172.217.194.0-255,2902,19218,63,179930
2568,0.000156,172.31.40.0-255,66,19284,63,179930
2569,0.00019,172.217.194.0-255,5738,25022,63,179930
2570,0.000193,172.31.40.0-255,66,25088,63,179930
2571,0.000199,172.217.194.0-255,5738,30826,63,179930
2572,0.000202,172.31.40.0-255,66,30892,63,179930
2573,0.000243,172.31.40.0-255,66,30958,63,179930
2574,0.000253,172.31.40.0-255,66,31024,63,179930
2575,0.000262,172.217.194.0-255,1745,32769,63,179930
2576,0.000264,172.31.40.0-255,66,32835,63,179930
2577,0.000302,172.217.194.0-255,2902,35737,63,179930
2578,0.000305,172.31.40.0-255,66,35803,63,179930
2579,0.00031,172.217.194.0-255,2902,38705,63,179930
2580,0.000312,172.31.40.0-255,66,38771,63,179930
2581,0.000345,172.217.194.0-255,4320,43091,63,179930
2582,0.000348,172.31.40.0-255,66,43157,63,179930
2583,0.000365,172.31.40.0-255,66,43223,63,179930
2584,0.000399,172.217.194.0-255,5738,48961,63,179930
2585,0.000401,172.31.40.0-255,66,49027,63,179930
2586,0.00043,172.217.194.0-255,6438,55465,63,179930
2587,0.000433,172.31.40.0-255,66,55531,63,179930
2588,0.000526,172.217.194.0-255,1484,57015,63,179930
2589,0.00056,172.217.194.0-255,2902,59917,63,179930
2590,0.000564,172.31.40.0-255,66,59983,63,179930
2591,0.000571,172.217.194.0-255,5738,65721,63,179930
2592,0.000574,172.31.40.0-255,66,65787,63,179930
2593,0.000591,172.31.40.0-255,66,65853,63,179930
2594,0.000603,172.31.40.0-255,66,65919,63,179930
2595,0.000631,172.217.194.0-255,3053,68972,63,179930
2596,0.000633,172.31.40.0-255,66,69038,63,179930
2597,0.000637,172.217.194.0-255,1484,70522,63,179930
2598,0.000645,172.217.194.0-255,2902,73424,63,179930
2599,0.000648,172.31.40.0-255,66,73490,63,179930
2600,0.000655,172.217.194.0-255,5738,79228,63,179930
2601,0.000657,172.31.40.0-255,66,79294,63,179930
2602,0.000664,172.217.194.0-255,7156,86450,63,179930
2603,0.000667,172.31.40.0-255,66,86516,63,179930
2604,0.000693,172.217.194.0-255,5738,92254,63,179930
2605,0.000696,172.31.40.0-255,66,92320,63,179930
2606,0.000713,172.31.40.0-255,66,92386,63,179930
2607,0.000741,172.217.194.0-255,1484,93870,63,179930
2608,0.000746,172.217.194.0-255,2902,96772,63,179930
2609,0.000748,172.31.40.0-255,66,96838,63,179930
2610,0.000755,172.217.194.0-255,5738,102576,63,179930
2611,0.000757,172.31.40.0-255,66,102642,63,179930
2612,0.00079,172.31.40.0-255,66,102708,63,179930
2613,0.00082,172.217.194.0-255,1484,104192,63,179930
2614,0.00088,172.217.194.0-255,2902,107094,63,179930
2615,0.000932,172.217.194.0-255,5738,112832,63,179930
2616,0.000985,172.217.194.0-255,5738,118570,63,179930
2617,0.001029,172.217.194.0-255,4320,122890,63,179930
2618,0.001074,172.217.194.0-255,7156,130046,63,179930
2619,0.0011,172.217.194.0-255,4320,134366,63,179930
2620,0.001102,172.217.194.0-255,1484,135850,63,179930
2621,0.001119,172.31.40.0-255,66,135916,63,179930
2622,0.001125,172.31.40.0-255,66,135982,63,179930
2623,0.001143,172.217.194.0-255,1484,137466,63,179930
2624,0.001147,172.217.194.0-255,2902,140368,63,179930
2625,0.001157,172.217.194.0-255,5738,146106,63,179930
2626,0.001191,172.217.194.0-255,7156,153262,63,179930
2627,0.001208,172.217.194.0-255,3602,156864,63,179930
2628,0.001211,172.31.40.0-255,66,156930,63,179930
2629,0.001215,172.31.40.0-255,66,156996,63,179930
2630,0.001239,172.217.194.0-255,5738,162734,63,179930
2631,0.001252,172.217.194.0-255,7156,169890,63,179930
2632,0.001266,172.31.40.0-255,66,169956,63,179930
2633,0.001324,172.31.40.0-255,66,170022,63,179930
2634,0.001337,172.217.194.0-255,5738,175760,63,179930
2635,0.001354,172.31.40.0-255,66,175826,63,179930
2636,0.001391,172.217.194.0-255,3762,179588,63,179930
2637,0.001393,172.217.194.0-255,105,179693,63,179930
2638,0.0014,172.31.40.0-255,66,179759,63,179930
2639,0.004172,172.31.40.0-255,105,179864,63,179930
2640,0.006134,172.217.194.0-255,66,179930,63,179930
2641,0.0,172.31.40.0-255,105,105,63,276
2642,0.001843,157.240.24.0-255,105,210,63,276
2643,0.001857,172.31.40.0-255,66,276,63,276
2644,0.0,74.125.24.0-255,295,295,63,155210
2645,2.2e-05,172.31.40.0-255,66,361,63,155210
2646,2.9e-05,74.125.24.0-255,1484,1845,63,155210
2647,3.3e-05,172.31.40.0-255,66,1911,63,155210
2648,4.9e-05,74.125.24.0-255,4320,6231,63,155210
2649,5.3e-05,172.31.40.0-255,66,6297,63,155210
2650,6.5e-05,172.31.40.0-255,66,6363,63,155210
2651,0.000208,74.125.24.0-255,1484,7847,63,155210
2652,0.000213,172.31.40.0-255,66,7913,63,155210
2653,0.000217,74.125.24.0-255,1484,9397,63,155210
2654,0.000219,172.31.40.0-255,66,9463,63,155210
2655,0.00024,74.125.24.0-255,1484,10947,63,155210
2656,0.000242,172.31.40.0-255,66,11013,63,155210
2657,0.000253,74.125.24.0-255,5738,16751,63,155210
2658,0.000256,172.31.40.0-255,66,16817,63,155210
2659,0.000263,74.125.24.0-255,6797,23614,63,155210
2660,0.000266,172.31.40.0-255,66,23680,63,155210
2661,0.000307,74.125.24.0-255,5738,29418,63,155210
2662,0.00031,172.31.40.0-255,66,29484,63,155210
2663,0.000318,74.125.24.0-255,7156,36640,63,155210
2664,0.00032,172.31.40.0-255,66,36706,63,155210
2665,0.000348,74.125.24.0-255,3961,40667,63,155210
2666,0.00035,172.31.40.0-255,66,40733,63,155210
2667,0.00039,74.125.24.0-255,1484,42217,63,155210
2668,0.000392,172.31.40.0-255,66,42283,63,155210
2669,0.000397,74.125.24.0-255,2902,45185,63,155210
2670,0.0004,172.31.40.0-255,66,45251,63,155210
2671,0.000417,74.125.24.0-255,1484,46735,63,155210
2672,0.00042,172.31.40.0-255,66,46801,63,155210
2673,0.00045,74.125.24.0-255,4320,51121,63,155210
2674,0.000453,172.31.40.0-255,66,51187,63,155210
2675,0.000461,74.125.24.0-255,7136,58323,63,155210
2676,0.000463,172.31.40.0-255,66,58389,63,155210
2677,0.00047,74.125.24.0-255,347,58736,63,155210
2678,0.000754,74.125.24.0-255,1484,60220,63,155210
2679,0.00076,172.31.40.0-255,66,60286,63,155210
2680,0.000774,74.125.24.0-255,2902,63188,63,155210
2681,0.000781,172.31.40.0-255,66,63254,63,155210
2682,0.000788,74.125.24.0-255,5738,68992,63,155210
2683,0.00079,172.31.40.0-255,66,69058,63,155210
2684,0.000859,74.125.24.0-255,5738,74796,63,155210
2685,0.000864,172.31.40.0-255,66,74862,63,155210
2686,0.000866,172.31.40.0-255,66,74928,63,155210
2687,0.000878,74.125.24.0-255,5020,79948,63,155210
2688,0.000884,172.31.40.0-255,66,80014,63,155210
2689,0.001457,74.125.24.0-255,1484,81498,63,155210
2690,0.001463,74.125.24.0-255,2902,84400,63,155210
2691,0.001467,172.31.40.0-255,66,84466,63,155210
2692,0.001474,74.125.24.0-255,5738,90204,63,155210
2693,0.001476,172.31.40.0-255,66,90270,63,155210
2694,0.001488,74.125.24.0-255,7156,97426,63,155210
2695,0.00149,172.31.40.0-255,66,97492,63,155210
2696,0.001505,172.31.40.0-255,66,97558,63,155210
2697,0.001508,74.125.24.0-255,2184,99742,63,155210
2698,0.001511,172.31.40.0-255,66,99808,63,155210
2699,0.002284,74.125.24.0-255,1484,101292,63,155210
2700,0.002295,74.125.24.0-255,1484,102776,63,155210
2701,0.002299,172.31.40.0-255,66,102842,63,155210
2702,0.002328,74.125.24.0-255,1484,104326,63,155210
2703,0.002336,74.125.24.0-255,5738,110064,63,155210
2704,0.002338,172.31.40.0-255,66,110130,63,155210
2705,0.002345,74.125.24.0-255,5738,115868,63,155210
2706,0.002347,172.31.40.0-255,66,115934,63,155210
2707,0.004673,74.125.24.0-255,5738,121672,63,155210
2708,0.004681,172.31.40.0-255,66,121738,63,155210
2709,0.006996,74.125.24.0-255,4320,126058,63,155210
2710,0.007,172.31.40.0-255,66,126124,63,155210
2711,0.007023,74.125.24.0-255,1484,127608,63,155210
2712,0.009307,74.125.24.0-255,4320,131928,63,155210
2713,0.009314,172.31.40.0-255,66,131994,63,155210
2714,0.011637,74.125.24.0-255,5738,137732,63,155210
2715,0.011647,172.31.40.0-255,66,137798,63,155210
2716,0.013981,74.125.24.0-255,5738,143536,63,155210
2717,0.01399,172.31.40.0-255,66,143602,63,155210
2718,0.016341,74.125.24.0-255,5738,149340,63,155210
2719,0.01635,172.31.40.0-255,66,149406,63,155210
2720,0.01871,74.125.24.0-255,5738,155144,63,155210
2721,0.018724,172.31.40.0-255,66,155210,63,155210
2722,0.0,74.125.24.0-255,153,153,63,199947
2723,1.9e-05,172.31.40.0-255,66,219,63,199947
2724,2.5e-05,74.125.24.0-255,1484,1703,63,199947
2725,3e-05,172.31.40.0-255,66,1769,63,199947
2726,3.6e-05,74.125.24.0-255,2902,4671,63,199947
2727,4.1e-05,172.31.40.0-255,66,4737,63,199947
2728,5.6e-05,74.125.24.0-255,1484,6221,63,199947
2729,5.8e-05,172.31.40.0-255,66,6287,63,199947
2730,6.2e-05,74.125.24.0-255,1484,7771,63,199947
2731,6.4e-05,172.31.40.0-255,66,7837,63,199947
2732,8.6e-05,74.125.24.0-255,1484,9321,63,199947
2733,8.9e-05,172.31.40.0-255,66,9387,63,199947
2734,0.000107,74.125.24.0-255,1484,10871,63,199947
2735,0.00011,172.31.40.0-255,66,10937,63,199947
2736,0.000126,74.125.24.0-255,4898,15835,63,199947
2737,0.000129,172.31.40.0-255,66,15901,63,199947
2738,0.000135,74.125.24.0-255,7156,23057,63,199947
2739,0.000138,172.31.40.0-255,66,23123,63,199947
2740,0.000157,74.125.24.0-255,4320,27443,63,199947
2741,0.000159,172.31.40.0-255,66,27509,63,199947
2742,0.000171,74.125.24.0-255,2902,30411,63,199947
2743,0.000174,172.31.40.0-255,66,30477,63,199947
2744,0.000192,74.125.24.0-255,1125,31602,63,199947
2745,0.000194,172.31.40.0-255,66,31668,63,199947
2746,0.000276,74.125.24.0-255,1484,33152,63,199947
2747,0.00028,172.31.40.0-255,66,33218,63,199947
2748,0.000286,74.125.24.0-255,2902,36120,63,199947
2749,0.000289,172.31.40.0-255,66,36186,63,199947
2750,0.000292,74.125.24.0-255,1484,37670,63,199947
2751,0.000294,172.31.40.0-255,66,37736,63,199947
2752,0.000318,74.125.24.0-255,4320,42056,63,199947
2753,0.000321,172.31.40.0-255,66,42122,63,199947
2754,0.000327,74.125.24.0-255,4320,46442,63,199947
2755,0.000329,172.31.40.0-255,66,46508,63,199947
2756,0.000402,74.125.24.0-255,4320,50828,63,199947
2757,0.000405,172.31.40.0-255,66,50894,63,199947
2758,0.000432,172.31.40.0-255,66,50960,63,199947
2759,0.000439,74.125.24.0-255,6797,57757,63,199947
2760,0.000441,172.31.40.0-255,66,57823,63,199947
2761,0.000444,74.125.24.0-255,366,58189,63,199947
2762,0.00056,74.125.24.0-255,130,58319,63,199947
2763,0.000693,74.125.24.0-255,1484,59803,63,199947
2764,0.000699,172.31.40.0-255,66,59869,63,199947
2765,0.000704,74.125.24.0-255,2902,62771,63,199947
2766,0.000707,172.31.40.0-255,66,62837,63,199947
2767,0.00071,74.125.24.0-255,1484,64321,63,199947
2768,0.000742,74.125.24.0-255,4320,68641,63,199947
2769,0.000745,172.31.40.0-255,66,68707,63,199947
2770,0.00075,74.125.24.0-255,4320,73027,63,199947
2771,0.000753,172.31.40.0-255,66,73093,63,199947
2772,0.000791,74.125.24.0-255,2902,75995,63,199947
2773,0.000795,172.31.40.0-255,66,76061,63,199947
2774,0.000806,74.125.24.0-255,4320,80381,63,199947
2775,0.000808,172.31.40.0-255,66,80447,63,199947
2776,0.000822,74.125.24.0-255,3961,84408,63,199947
2777,0.000827,172.31.40.0-255,66,84474,63,199947
2778,0.000839,74.125.24.0-255,2902,87376,63,199947
2779,0.000841,172.31.40.0-255,66,87442,63,199947
2780,0.000867,74.125.24.0-255,5379,92821,63,199947
2781,0.000871,172.31.40.0-255,66,92887,63,199947
2782,0.001159,74.125.24.0-255,1484,94371,63,199947
2783,0.001162,74.125.24.0-255,1484,95855,63,199947
2784,0.001168,172.31.40.0-255,66,95921,63,199947
2785,0.001177,74.125.24.0-255,1484,97405,63,199947
2786,0.001183,74.125.24.0-255,5738,103143,63,199947
2787,0.001185,172.31.40.0-255,66,103209,63,199947
2788,0.001208,74.125.24.0-255,2902,106111,63,199947
2789,0.001211,172.31.40.0-255,66,106177,63,199947
2790,0.001239,172.31.40.0-255,66,106243,63,199947
2791,0.001242,74.125.24.0-255,1484,107727,63,199947
2792,0.00127,74.125.24.0-255,5738,113465,63,199947
2793,0.001273,172.31.40.0-255,66,113531,63,199947
2794,0.001296,74.125.24.0-255,3602,117133,63,199947
2795,0.001298,172.31.40.0-255,66,117199,63,199947
2796,0.001312,172.31.40.0-255,66,117265,63,199947
2797,0.001314,74.125.24.0-255,1484,118749,63,199947
2798,0.001369,172.31.40.0-255,66,118815,63,199947
2799,0.001372,74.125.24.0-255,1484,120299,63,199947
2800,0.001374,74.125.24.0-255,766,121065,63,199947
2801,0.001376,172.31.40.0-255,66,121131,63,199947
2802,0.00156,74.125.24.0-255,1484,122615,63,199947
2803,0.001575,74.125.24.0-255,2902,125517,63,199947
2804,0.001578,172.31.40.0-255,66,125583,63,199947
2805,0.001595,74.125.24.0-255,5738,131321,63,199947
2806,0.001597,172.31.40.0-255,66,131387,63,199947
2807,0.001605,74.125.24.0-255,5738,137125,63,199947
2808,0.001607,172.31.40.0-255,66,137191,63,199947
2809,0.001625,74.125.24.0-255,4320,141511,63,199947
2810,0.001627,172.31.40.0-255,66,141577,63,199947
2811,0.001642,74.125.24.0-255,5738,147315,63,199947
2812,0.001645,172.31.40.0-255,66,147381,63,199947
2813,0.001672,172.31.40.0-255,66,147447,63,199947
2814,0.001696,172.31.40.0-255,66,147513,63,199947
2815,0.001714,74.125.24.0-255,4320,151833,63,199947
2816,0.001717,172.31.40.0-255,66,151899,63,199947
2817,0.001728,172.31.40.0-255,66,151965,63,199947
2818,0.00174,74.125.24.0-255,1484,153449,63,199947
2819,0.001804,172.31.40.0-255,66,153515,63,199947
2820,0.003878,74.125.24.0-255,5738,159253,63,199947
2821,0.003884,172.31.40.0-255,66,159319,63,199947
2822,0.005952,74.125.24.0-255,5738,165057,63,199947
2823,0.005955,172.31.40.0-255,66,165123,63,199947
2824,0.00803,74.125.24.0-255,5738,170861,63,199947
2825,0.008037,172.31.40.0-255,66,170927,63,199947
2826,0.010141,74.125.24.0-255,5738,176665,63,199947
2827,0.010157,172.31.40.0-255,66,176731,63,199947
2828,0.01225,74.125.24.0-255,5738,182469,63,199947
2829,0.012264,172.31.40.0-255,66,182535,63,199947
2830,0.014339,74.125.24.0-255,5738,188273,63,199947
2831,0.014352,172.31.40.0-255,66,188339,63,199947
2832,0.016443,74.125.24.0-255,5738,194077,63,199947
2833,0.016454,172.31.40.0-255,66,194143,63,199947
2834,0.018524,74.125.24.0-255,5738,199881,63,199947
2835,0.01853,172.31.40.0-255,66,199947,63,199947
2836,0.0,216.58.203.0-255,146,146,63,152232
2837,2.6e-05,172.31.40.0-255,66,212,63,152232
2838,3.6e-05,216.58.203.0-255,1484,1696,63,152232
2839,4.2e-05,172.31.40.0-255,66,1762,63,152232
2840,5.6e-05,216.58.203.0-255,2902,4664,63,152232
2841,7.4e-05,172.31.40.0-255,66,4730,63,152232
2842,8.3e-05,216.58.203.0-255,7156,11886,63,152232
2843,8.6e-05,172.31.40.0-255,66,11952,63,152232
2844,9.1e-05,216.58.203.0-255,2101,14053,63,152232
2845,9.4e-05,172.31.40.0-255,66,14119,63,152232
2846,9.9e-05,216.58.203.0-255,2902,17021,63,152232
2847,0.000102,172.31.40.0-255,66,17087,63,152232
2848,0.00011,216.58.203.0-255,7156,24243,63,152232
2849,0.000113,172.31.40.0-255,66,24309,63,152232
2850,0.00012,216.58.203.0-255,6797,31106,63,152232
2851,0.000123,172.31.40.0-255,66,31172,63,152232
2852,0.000201,216.58.203.0-255,1484,32656,63,152232
2853,0.000204,172.31.40.0-255,66,32722,63,152232
2854,0.00021,216.58.203.0-255,2902,35624,63,152232
2855,0.000213,172.31.40.0-255,66,35690,63,152232
2856,0.000241,216.58.203.0-255,5738,41428,63,152232
2857,0.000244,172.31.40.0-255,66,41494,63,152232
2858,0.000283,172.31.40.0-255,66,41560,63,152232
2859,0.000293,172.31.40.0-255,66,41626,63,152232
2860,0.000344,216.58.203.0-255,1125,42751,63,152232
2861,0.000346,172.31.40.0-255,66,42817,63,152232
2862,0.000575,216.58.203.0-255,397,43214,63,152232
2863,0.00058,172.31.40.0-255,66,43280,63,152232
2864,0.0007,216.58.203.0-255,114,43394,63,152232
2865,0.000704,172.31.40.0-255,66,43460,63,152232
2866,0.000873,216.58.203.0-255,1484,44944,63,152232
2867,0.00088,216.58.203.0-255,2902,47846,63,152232
2868,0.000883,172.31.40.0-255,66,47912,63,152232
2869,0.000889,216.58.203.0-255,5738,53650,63,152232
2870,0.000892,172.31.40.0-255,66,53716,63,152232
2871,0.000943,172.31.40.0-255,66,53782,63,152232
2872,0.000954,172.31.40.0-255,66,53848,63,152232
2873,0.000978,216.58.203.0-255,1390,55238,63,152232
2874,0.001252,216.58.203.0-255,1484,56722,63,152232
2875,0.001257,172.31.40.0-255,66,56788,63,152232
2876,0.001262,216.58.203.0-255,2902,59690,63,152232
2877,0.001265,172.31.40.0-255,66,59756,63,152232
2878,0.001268,216.58.203.0-255,1484,61240,63,152232
2879,0.001298,216.58.203.0-255,4320,65560,63,152232
2880,0.001301,172.31.40.0-255,66,65626,63,152232
2881,0.001307,216.58.203.0-255,4320,69946,63,152232
2882,0.001309,172.31.40.0-255,66,70012,63,152232
2883,0.00132,216.58.203.0-255,5738,75750,63,152232
2884,0.001322,172.31.40.0-255,66,75816,63,152232
2885,0.001328,216.58.203.0-255,5738,81554,63,152232
2886,0.00133,172.31.40.0-255,66,81620,63,152232
2887,0.001351,216.58.203.0-255,1484,83104,63,152232
2888,0.001354,216.58.203.0-255,1484,84588,63,152232
2889,0.001356,172.31.40.0-255,66,84654,63,152232
2890,0.001394,216.58.203.0-255,5020,89674,63,152232
2891,0.001397,172.31.40.0-255,66,89740,63,152232
2892,0.00304,216.58.203.0-255,5738,95478,63,152232
2893,0.003048,172.31.40.0-255,66,95544,63,152232
2894,0.004695,216.58.203.0-255,4320,99864,63,152232
2895,0.0047,172.31.40.0-255,66,99930,63,152232
2896,0.004725,216.58.203.0-255,1484,101414,63,152232
2897,0.006336,216.58.203.0-255,4320,105734,63,152232
2898,0.00634,172.31.40.0-255,66,105800,63,152232
2899,0.007983,216.58.203.0-255,5738,111538,63,152232
2900,0.007992,172.31.40.0-255,66,111604,63,152232
2901,0.009657,216.58.203.0-255,5738,117342,63,152232
2902,0.009664,172.31.40.0-255,66,117408,63,152232
2903,0.011319,216.58.203.0-255,5738,123146,63,152232
2904,0.01133,172.31.40.0-255,66,123212,63,152232
2905,0.012986,216.58.203.0-255,5738,128950,63,152232
2906,0.012996,172.31.40.0-255,66,129016,63,152232
2907,0.014658,216.58.203.0-255,5738,134754,63,152232
2908,0.014671,172.31.40.0-255,66,134820,63,152232
2909,0.016327,216.58.203.0-255,5738,140558,63,152232
2910,0.016337,172.31.40.0-255,66,140624,63,152232
2911,0.01799,216.58.203.0-255,5738,146362,63,152232
2912,0.018001,172.31.40.0-255,66,146428,63,152232
2913,0.019656,216.58.203.0-255,5738,152166,63,152232
2914,0.019666,172.31.40.0-255,66,152232,63,152232
2915,0.0,74.125.24.0-255,153,153,63,180301
2916,2.7e-05,172.31.40.0-255,66,219,63,180301
2917,3.5e-05,74.125.24.0-255,1484,1703,63,180301
2918,4e-05,172.31.40.0-255,66,1769,63,180301
2919,5.3e-05,74.125.24.0-255,2902,4671,63,180301
2920,5.6e-05,172.31.40.0-255,66,4737,63,180301
2921,6.4e-05,74.125.24.0-255,7156,11893,63,180301
2922,6.8e-05,172.31.40.0-255,66,11959,63,180301
2923,7.2e-05,74.125.24.0-255,2038,13997,63,180301
2924,7.4e-05,172.31.40.0-255,66,14063,63,180301
2925,7.9e-05,74.125.24.0-255,2902,16965,63,180301
2926,8.1e-05,172.31.40.0-255,66,17031,63,180301
2927,0.000105,74.125.24.0-255,4320,21351,63,180301
2928,0.000107,172.31.40.0-255,66,21417,63,180301
2929,0.000124,172.31.40.0-255,66,21483,63,180301
2930,0.000126,74.125.24.0-255,1125,22608,63,180301
2931,0.000129,172.31.40.0-255,66,22674,63,180301
2932,0.00021,74.125.24.0-255,1484,24158,63,180301
2933,0.000213,172.31.40.0-255,66,24224,63,180301
2934,0.000218,74.125.24.0-255,2902,27126,63,180301
2935,0.00022,172.31.40.0-255,66,27192,63,180301
2936,0.000252,74.125.24.0-255,4320,31512,63,180301
2937,0.000255,172.31.40.0-255,66,31578,63,180301
2938,0.000262,74.125.24.0-255,5738,37316,63,180301
2939,0.000264,172.31.40.0-255,66,37382,63,180301
2940,0.000283,172.31.40.0-255,66,37448,63,180301
2941,0.000291,74.125.24.0-255,6797,44245,63,180301
2942,0.000293,172.31.40.0-255,66,44311,63,180301
2943,0.000648,74.125.24.0-255,648,44959,63,180301
2944,0.000653,172.31.40.0-255,66,45025,63,180301
2945,0.000779,74.125.24.0-255,1484,46509,63,180301
2946,0.000799,74.125.24.0-255,2902,49411,63,180301
2947,0.000806,74.125.24.0-255,5738,55149,63,180301
2948,0.000814,172.31.40.0-255,66,55215,63,180301
2949,0.000824,74.125.24.0-255,2902,58117,63,180301
2950,0.000828,172.31.40.0-255,66,58183,63,180301
2951,0.000877,74.125.24.0-255,7156,65339,63,180301
2952,0.000881,74.125.24.0-255,1992,67331,63,180301
2953,0.00089,172.31.40.0-255,66,67397,63,180301
2954,0.00142,74.125.24.0-255,1484,68881,63,180301
2955,0.001443,74.125.24.0-255,2902,71783,63,180301
2956,0.001446,172.31.40.0-255,66,71849,63,180301
2957,0.001453,74.125.24.0-255,5738,77587,63,180301
2958,0.001458,74.125.24.0-255,4320,81907,63,180301
2959,0.001515,74.125.24.0-255,2184,84091,63,180301
2960,0.00152,172.31.40.0-255,66,84157,63,180301
2961,0.001688,74.125.24.0-255,1484,85641,63,180301
2962,0.001692,74.125.24.0-255,1484,87125,63,180301
2963,0.001703,172.31.40.0-255,66,87191,63,180301
2964,0.001706,74.125.24.0-255,1484,88675,63,180301
2965,0.001712,74.125.24.0-255,5738,94413,63,180301
2966,0.001723,172.31.40.0-255,66,94479,63,180301
2967,0.001776,172.31.40.0-255,66,94545,63,180301
2968,0.001809,74.125.24.0-255,1484,96029,63,180301
2969,0.001829,74.125.24.0-255,2902,98931,63,180301
2970,0.001831,74.125.24.0-255,1484,100415,63,180301
2971,0.001847,74.125.24.0-255,4320,104735,63,180301
2972,0.001854,74.125.24.0-255,5738,110473,63,180301
2973,0.001869,172.31.40.0-255,66,110539,63,180301
2974,0.001872,74.125.24.0-255,1484,112023,63,180301
2975,0.001894,74.125.24.0-255,2184,114207,63,180301
2976,0.0019,172.31.40.0-255,66,114273,63,180301
2977,0.001977,74.125.24.0-255,1484,115757,63,180301
2978,0.001982,74.125.24.0-255,2902,118659,63,180301
2979,0.001988,172.31.40.0-255,66,118725,63,180301
2980,0.002017,74.125.24.0-255,5738,124463,63,180301
2981,0.002025,74.125.24.0-255,7156,131619,63,180301
2982,0.002031,172.31.40.0-255,66,131685,63,180301
2983,0.002058,74.125.24.0-255,5738,137423,63,180301
2984,0.002088,172.31.40.0-255,66,137489,63,180301
2985,0.00245,74.125.24.0-255,1484,138973,63,180301
2986,0.002472,74.125.24.0-255,2902,141875,63,180301
2987,0.002476,172.31.40.0-255,66,141941,63,180301
2988,0.002482,74.125.24.0-255,5738,147679,63,180301
2989,0.002536,74.125.24.0-255,7156,154835,63,180301
2990,0.002543,172.31.40.0-255,66,154901,63,180301
2991,0.002578,74.125.24.0-255,5738,160639,63,180301
2992,0.002596,74.125.24.0-255,7156,167795,63,180301
2993,0.002638,74.125.24.0-255,766,168561,63,180301
2994,0.013165,172.31.40.0-255,66,168627,63,180301
2995,0.013932,74.125.24.0-255,1484,170111,63,180301
2996,0.015715,74.125.24.0-255,4320,174431,63,180301
2997,0.01572,172.31.40.0-255,66,174497,63,180301
2998,0.018324,74.125.24.0-255,5738,180235,63,180301
2999,0.01842,172.31.40.0-255,66,180301,63,180301
3000,0.0,172.217.27.0-255,152,152,63,191291
3001,1.8e-05,172.31.40.0-255,66,218,63,191291
3002,2.5e-05,172.217.27.0-255,1484,1702,63,191291
3003,3e-05,172.31.40.0-255,66,1768,63,191291
3004,3.3e-05,172.217.27.0-255,1484,3252,63,191291
3005,4.2e-05,172.31.40.0-255,66,3318,63,191291
3006,4.8e-05,172.217.27.0-255,2902,6220,63,191291
3007,5.1e-05,172.31.40.0-255,66,6286,63,191291
3008,5.7e-05,172.217.27.0-255,5738,12024,63,191291
3009,6.1e-05,172.31.40.0-255,66,12090,63,191291
3010,6.7e-05,172.217.27.0-255,2137,14227,63,191291
3011,6.9e-05,172.31.40.0-255,66,14293,63,191291
3012,0.000155,172.217.27.0-255,1484,15777,63,191291
3013,0.00016,172.31.40.0-255,66,15843,63,191291
3014,0.000165,172.217.27.0-255,2902,18745,63,191291
3015,0.000168,172.31.40.0-255,66,18811,63,191291
3016,0.000172,172.217.27.0-255,2902,21713,63,191291
3017,0.000174,172.31.40.0-255,66,21779,63,191291
3018,0.000202,172.217.27.0-255,2902,24681,63,191291
3019,0.000204,172.31.40.0-255,66,24747,63,191291
3020,0.000227,172.217.27.0-255,1484,26231,63,191291
3021,0.00023,172.31.40.0-255,66,26297,63,191291
3022,0.000236,172.217.27.0-255,5379,31676,63,191291
3023,0.000239,172.31.40.0-255,66,31742,63,191291
3024,0.000505,172.217.27.0-255,1484,33226,63,191291
3025,0.000511,172.31.40.0-255,66,33292,63,191291
3026,0.000517,172.217.27.0-255,2902,36194,63,191291
3027,0.00052,172.31.40.0-255,66,36260,63,191291
3028,0.000525,172.217.27.0-255,4320,40580,63,191291
3029,0.000534,172.31.40.0-255,66,40646,63,191291
3030,0.000545,172.217.27.0-255,1484,42130,63,191291
3031,0.000547,172.31.40.0-255,66,42196,63,191291
3032,0.000555,172.217.27.0-255,6797,48993,63,191291
3033,0.000562,172.31.40.0-255,66,49059,63,191291
3034,0.000711,172.217.27.0-255,1484,50543,63,191291
3035,0.000729,172.217.27.0-255,2902,53445,63,191291
3036,0.000733,172.31.40.0-255,66,53511,63,191291
3037,0.000737,172.217.27.0-255,1484,54995,63,191291
3038,0.000765,172.217.27.0-255,2902,57897,63,191291
3039,0.000771,172.31.40.0-255,66,57963,63,191291
3040,0.000807,172.217.27.0-255,5738,63701,63,191291
3041,0.000809,172.31.40.0-255,66,63767,63,191291
3042,0.000836,172.217.27.0-255,2832,66599,63,191291
3043,0.000839,172.31.40.0-255,66,66665,63,191291
3044,0.001041,172.217.27.0-255,135,66800,63,191291
3045,0.001082,172.217.27.0-255,1484,68284,63,191291
3046,0.001085,172.31.40.0-255,66,68350,63,191291
3047,0.001089,172.217.27.0-255,1484,69834,63,191291
3048,0.001117,172.217.27.0-255,2902,72736,63,191291
3049,0.001119,172.31.40.0-255,66,72802,63,191291
3050,0.001125,172.217.27.0-255,5738,78540,63,191291
3051,0.001127,172.31.40.0-255,66,78606,63,191291
3052,0.001163,172.217.27.0-255,2902,81508,63,191291
3053,0.001166,172.31.40.0-255,66,81574,63,191291
3054,0.00119,172.217.27.0-255,2543,84117,63,191291
3055,0.001193,172.31.40.0-255,66,84183,63,191291
3056,0.001219,172.217.27.0-255,1484,85667,63,191291
3057,0.001232,172.217.27.0-255,2902,88569,63,191291
3058,0.001234,172.31.40.0-255,66,88635,63,191291
3059,0.001238,172.217.27.0-255,1484,90119,63,191291
3060,0.001265,172.217.27.0-255,4320,94439,63,191291
3061,0.001267,172.31.40.0-255,66,94505,63,191291
3062,0.001275,172.217.27.0-255,6797,101302,63,191291
3063,0.001277,172.31.40.0-255,66,101368,63,191291
3064,0.00128,172.217.27.0-255,349,101717,63,191291
3065,0.001459,172.217.27.0-255,1484,103201,63,191291
3066,0.001463,172.31.40.0-255,66,103267,63,191291
3067,0.001469,172.217.27.0-255,2902,106169,63,191291
3068,0.001471,172.31.40.0-255,66,106235,63,191291
3069,0.001474,172.217.27.0-255,1484,107719,63,191291
3070,0.001516,172.217.27.0-255,4320,112039,63,191291
3071,0.001519,172.31.40.0-255,66,112105,63,191291
3072,0.001526,172.217.27.0-255,7156,119261,63,191291
3073,0.001528,172.31.40.0-255,66,119327,63,191291
3074,0.001544,172.31.40.0-255,66,119393,63,191291
3075,0.001548,172.217.27.0-255,2902,122295,63,191291
3076,0.001551,172.31.40.0-255,66,122361,63,191291
3077,0.001588,172.217.27.0-255,5020,127381,63,191291
3078,0.001591,172.31.40.0-255,66,127447,63,191291
3079,0.00324,172.217.27.0-255,5738,133185,63,191291
3080,0.003248,172.31.40.0-255,66,133251,63,191291
3081,0.004869,172.217.27.0-255,5738,138989,63,191291
3082,0.004874,172.31.40.0-255,66,139055,63,191291
3083,0.006489,172.217.27.0-255,5738,144793,63,191291
3084,0.006492,172.31.40.0-255,66,144859,63,191291
3085,0.008117,172.217.27.0-255,5738,150597,63,191291
3086,0.008124,172.31.40.0-255,66,150663,63,191291
3087,0.00975,172.217.27.0-255,5738,156401,63,191291
3088,0.009757,172.31.40.0-255,66,156467,63,191291
3089,0.011398,172.217.27.0-255,5738,162205,63,191291
3090,0.011406,172.31.40.0-255,66,162271,63,191291
3091,0.013038,172.217.27.0-255,5738,168009,63,191291
3092,0.013046,172.31.40.0-255,66,168075,63,191291
3093,0.014674,172.217.27.0-255,5738,173813,63,191291
3094,0.014683,172.31.40.0-255,66,173879,63,191291
3095,0.016311,172.217.27.0-255,5738,179617,63,191291
3096,0.01632,172.31.40.0-255,66,179683,63,191291
3097,0.017951,172.217.27.0-255,5738,185421,63,191291
3098,0.017958,172.31.40.0-255,66,185487,63,191291
3099,0.019582,172.217.27.0-255,5738,191225,63,191291
3100,0.019589,172.31.40.0-255,66,191291,63,191291
3101,0.0,74.125.200.0-255,150,150,63,281605
3102,2.3e-05,172.31.40.0-255,66,216,63,281605
3103,3.1e-05,74.125.200.0-255,1484,1700,63,281605
3104,3.5e-05,172.31.40.0-255,66,1766,63,281605
3105,4e-05,74.125.200.0-255,2902,4668,63,281605
3106,5.1e-05,172.31.40.0-255,66,4734,63,281605
3107,5.7e-05,74.125.200.0-255,5738,10472,63,281605
3108,6.2e-05,172.31.40.0-255,66,10538,63,281605
3109,6.7e-05,74.125.200.0-255,4320,14858,63,281605
3110,6.9e-05,172.31.40.0-255,66,14924,63,281605
3111,0.000105,74.125.200.0-255,2135,17059,63,281605
3112,0.000109,172.31.40.0-255,66,17125,63,281605
3113,0.000122,172.31.40.0-255,66,17191,63,281605
3114,0.00016,74.125.200.0-255,2543,19734,63,281605
3115,0.000162,172.31.40.0-255,66,19800,63,281605
3116,0.000196,74.125.200.0-255,1484,21284,63,281605
3117,0.000199,172.31.40.0-255,66,21350,63,281605
3118,0.000203,74.125.200.0-255,2902,24252,63,281605
3119,0.000206,172.31.40.0-255,66,24318,63,281605
3120,0.000237,74.125.200.0-255,5738,30056,63,281605
3121,0.00024,172.31.40.0-255,66,30122,63,281605
3122,0.000253,74.125.200.0-255,4320,34442,63,281605
3123,0.000258,172.31.40.0-255,66,34508,63,281605
3124,0.000285,74.125.200.0-255,3961,38469,63,281605
3125,0.000289,172.31.40.0-255,66,38535,63,281605
3126,0.0003,172.31.40.0-255,66,38601,63,281605
3127,0.000307,74.125.200.0-255,7069,45670,63,281605
3128,0.00031,172.31.40.0-255,66,45736,63,281605
3129,0.000348,74.125.200.0-255,384,46120,63,281605
3130,0.000351,172.31.40.0-255,66,46186,63,281605
3131,0.000496,74.125.200.0-255,1484,47670,63,281605
3132,0.000512,74.125.200.0-255,2902,50572,63,281605
3133,0.000515,172.31.40.0-255,66,50638,63,281605
3134,0.000519,74.125.200.0-255,1484,52122,63,281605
3135,0.000542,74.125.200.0-255,4320,56442,63,281605
3136,0.000544,172.31.40.0-255,66,56508,63,281605
3137,0.000571,172.31.40.0-255,66,56574,63,281605
3138,0.000601,74.125.200.0-255,1484,58058,63,281605
3139,0.000614,172.31.40.0-255,66,58124,63,281605
3140,0.000618,74.125.200.0-255,1634,59758,63,281605
3141,0.000621,172.31.40.0-255,66,59824,63,281605
3142,0.000871,74.125.200.0-255,1484,61308,63,281605
3143,0.000879,74.125.200.0-255,2902,64210,63,281605
3144,0.000884,172.31.40.0-255,66,64276,63,281605
3145,0.000889,74.125.200.0-255,2902,67178,63,281605
3146,0.000904,74.125.200.0-255,2902,70080,63,281605
3147,0.000914,74.125.200.0-255,4320,74400,63,281605
3148,0.00092,74.125.200.0-255,5738,80138,63,281605
3149,0.000981,74.125.200.0-255,2184,82322,63,281605
3150,0.001003,74.125.200.0-255,2902,85224,63,281605
3151,0.001018,74.125.200.0-255,1484,86708,63,281605
3152,0.001031,74.125.200.0-255,2902,89610,63,281605
3153,0.00105,74.125.200.0-255,5738,95348,63,281605
3154,0.001067,74.125.200.0-255,2902,98250,63,281605
3155,0.001071,74.125.200.0-255,2902,101152,63,281605
3156,0.001086,74.125.200.0-255,4320,105472,63,281605
3157,0.001119,74.125.200.0-255,2184,107656,63,281605
3158,0.00119,74.125.200.0-255,1484,109140,63,281605
3159,0.001203,172.31.40.0-255,66,109206,63,281605
3160,0.001211,74.125.200.0-255,1484,110690,63,281605
3161,0.001228,74.125.200.0-255,2902,113592,63,281605
3162,0.001251,74.125.200.0-255,5738,119330,63,281605
3163,0.001256,74.125.200.0-255,4320,123650,63,281605
3164,0.001267,74.125.200.0-255,1484,125134,63,281605
3165,0.001273,74.125.200.0-255,4320,129454,63,281605
3166,0.001282,172.31.40.0-255,66,129520,63,281605
3167,0.001293,74.125.200.0-255,2902,132422,63,281605
3168,0.001337,172.31.40.0-255,66,132488,63,281605
3169,0.001415,74.125.200.0-255,1484,133972,63,281605
3170,0.001419,74.125.200.0-255,1484,135456,63,281605
3171,0.001427,172.31.40.0-255,66,135522,63,281605
3172,0.001436,74.125.200.0-255,1484,137006,63,281605
3173,0.001438,74.125.200.0-255,1484,138490,63,281605
3174,0.00146,74.125.200.0-255,4320,142810,63,281605
3175,0.001465,74.125.200.0-255,4320,147130,63,281605
3176,0.001488,74.125.200.0-255,5738,152868,63,281605
3177,0.001491,172.31.40.0-255,66,152934,63,281605
3178,0.001496,172.31.40.0-255,66,153000,63,281605
3179,0.001526,74.125.200.0-255,5738,158738,63,281605
3180,0.00154,74.125.200.0-255,1484,160222,63,281605
3181,0.001551,172.31.40.0-255,66,160288,63,281605
3182,0.001558,74.125.200.0-255,5738,166026,63,281605
3183,0.00156,74.125.200.0-255,766,166792,63,281605
3184,0.001576,172.31.40.0-255,66,166858,63,281605
3185,0.001686,74.125.200.0-255,1484,168342,63,281605
3186,0.00169,74.125.200.0-255,1484,169826,63,281605
3187,0.001709,74.125.200.0-255,1484,171310,63,281605
3188,0.001714,74.125.200.0-255,2902,174212,63,281605
3189,0.001717,74.125.200.0-255,1484,175696,63,281605
3190,0.001729,74.125.200.0-255,2902,178598,63,281605
3191,0.001739,74.125.200.0-255,1484,180082,63,281605
3192,0.00175,172.31.40.0-255,66,180148,63,281605
3193,0.001774,74.125.200.0-255,7156,187304,63,281605
3194,0.001779,74.125.200.0-255,2902,190206,63,281605
3195,0.001783,74.125.200.0-255,4320,194526,63,281605
3196,0.001808,74.125.200.0-255,2902,197428,63,281605
3197,0.001826,74.125.200.0-255,3602,201030,63,281605
3198,0.001829,74.125.200.0-255,1484,202514,63,281605
3199,0.001831,172.31.40.0-255,66,202580,63,281605
3200,0.001845,74.125.200.0-255,5738,208318,63,281605
3201,0.001853,172.31.40.0-255,66,208384,63,281605
3202,0.001865,74.125.200.0-255,2902,211286,63,281605
3203,0.0019,172.31.40.0-255,66,211352,63,281605
3204,0.001986,172.31.40.0-255,66,211418,63,281605
3205,0.002047,74.125.200.0-255,1484,212902,63,281605
3206,0.002069,74.125.200.0-255,1484,214386,63,281605
3207,0.002074,74.125.200.0-255,2902,217288,63,281605
3208,0.002084,172.31.40.0-255,66,217354,63,281605
3209,0.00209,74.125.200.0-255,5738,223092,63,281605
3210,0.002095,172.31.40.0-255,66,223158,63,281605
3211,0.002108,74.125.200.0-255,1484,224642,63,281605
3212,0.002159,172.31.40.0-255,66,224708,63,281605
3213,0.002172,74.125.200.0-255,7156,231864,63,281605
3214,0.002186,172.31.40.0-255,66,231930,63,281605
3215,0.002191,74.125.200.0-255,2184,234114,63,281605
3216,0.002218,74.125.200.0-255,1484,235598,63,281605
3217,0.00223,74.125.200.0-255,2902,238500,63,281605
3218,0.002238,172.31.40.0-255,66,238566,63,281605
3219,0.00224,74.125.200.0-255,1484,240050,63,281605
3220,0.002251,172.31.40.0-255,66,240116,63,281605
3221,0.00226,74.125.200.0-255,4320,244436,63,281605
3222,0.002264,74.125.200.0-255,2902,247338,63,281605
3223,0.002289,74.125.200.0-255,4320,251658,63,281605
3224,0.002293,74.125.200.0-255,1484,253142,63,281605
3225,0.002304,172.31.40.0-255,66,253208,63,281605
3226,0.002322,74.125.200.0-255,7156,260364,63,281605
3227,0.002328,74.125.200.0-255,5738,266102,63,281605
3228,0.002339,172.31.40.0-255,66,266168,63,281605
3229,0.002355,74.125.200.0-255,1484,267652,63,281605
3230,0.004639,74.125.200.0-255,4320,271972,63,281605
3231,0.004645,172.31.40.0-255,66,272038,63,281605
3232,0.006964,74.125.200.0-255,5738,277776,63,281605
3233,0.006982,172.31.40.0-255,66,277842,63,281605
3234,0.009302,74.125.200.0-255,3697,281539,63,281605
3235,0.009318,172.31.40.0-255,66,281605,63,281605
3236,0.0,74.125.24.0-255,150,150,63,199636
3237,2.2e-05,172.31.40.0-255,66,216,63,199636
3238,3e-05,74.125.24.0-255,1484,1700,63,199636
3239,3.5e-05,172.31.40.0-255,66,1766,63,199636
3240,4.1e-05,74.125.24.0-255,2902,4668,63,199636
3241,4.5e-05,172.31.40.0-255,66,4734,63,199636
3242,6.1e-05,74.125.24.0-255,7156,11890,63,199636
3243,6.5e-05,172.31.40.0-255,66,11956,63,199636
3244,6.9e-05,74.125.24.0-255,2127,14083,63,199636
3245,7.1e-05,172.31.40.0-255,66,14149,63,199636
3246,9.8e-05,74.125.24.0-255,2902,17051,63,199636
3247,0.000101,172.31.40.0-255,66,17117,63,199636
3248,0.000111,74.125.24.0-255,4320,21437,63,199636
3249,0.000114,172.31.40.0-255,66,21503,63,199636
3250,0.000158,172.31.40.0-255,66,21569,63,199636
3251,0.00016,74.125.24.0-255,1125,22694,63,199636
3252,0.000162,172.31.40.0-255,66,22760,63,199636
3253,0.00023,74.125.24.0-255,1484,24244,63,199636
3254,0.000233,172.31.40.0-255,66,24310,63,199636
3255,0.000238,74.125.24.0-255,2902,27212,63,199636
3256,0.00024,172.31.40.0-255,66,27278,63,199636
3257,0.000246,74.125.24.0-255,5738,33016,63,199636
3258,0.000248,172.31.40.0-255,66,33082,63,199636
3259,0.000257,74.125.24.0-255,4320,37402,63,199636
3260,0.000259,172.31.40.0-255,66,37468,63,199636
3261,0.000302,74.125.24.0-255,2543,40011,63,199636
3262,0.000305,172.31.40.0-255,66,40077,63,199636
3263,0.000331,74.125.24.0-255,2902,42979,63,199636
3264,0.000334,172.31.40.0-255,66,43045,63,199636
3265,0.000337,74.125.24.0-255,1484,44529,63,199636
3266,0.000339,172.31.40.0-255,66,44595,63,199636
3267,0.000369,74.125.24.0-255,5738,50333,63,199636
3268,0.000372,172.31.40.0-255,66,50399,63,199636
3269,0.000379,74.125.24.0-255,6797,57196,63,199636
3270,0.000381,172.31.40.0-255,66,57262,63,199636
3271,0.000384,74.125.24.0-255,362,57624,63,199636
3272,0.000432,74.125.24.0-255,127,57751,63,199636
3273,0.000463,74.125.24.0-255,352,58103,63,199636
3274,0.000668,74.125.24.0-255,1484,59587,63,199636
3275,0.000674,172.31.40.0-255,66,59653,63,199636
3276,0.00068,74.125.24.0-255,2902,62555,63,199636
3277,0.000683,172.31.40.0-255,66,62621,63,199636
3278,0.000695,74.125.24.0-255,5738,68359,63,199636
3279,0.000697,172.31.40.0-255,66,68425,63,199636
3280,0.0007,74.125.24.0-255,1484,69909,63,199636
3281,0.000733,74.125.24.0-255,5738,75647,63,199636
3282,0.000737,172.31.40.0-255,66,75713,63,199636
3283,0.000756,172.31.40.0-255,66,75779,63,199636
3284,0.000792,74.125.24.0-255,7156,82935,63,199636
3285,0.000795,172.31.40.0-255,66,83001,63,199636
3286,0.000825,74.125.24.0-255,3602,86603,63,199636
3287,0.000827,172.31.40.0-255,66,86669,63,199636
3288,0.000838,172.31.40.0-255,66,86735,63,199636
3289,0.000866,74.125.24.0-255,1484,88219,63,199636
3290,0.000871,74.125.24.0-255,2902,91121,63,199636
3291,0.000874,172.31.40.0-255,66,91187,63,199636
3292,0.000878,74.125.24.0-255,2902,94089,63,199636
3293,0.00088,172.31.40.0-255,66,94155,63,199636
3294,0.000901,74.125.24.0-255,2902,97057,63,199636
3295,0.000904,172.31.40.0-255,66,97123,63,199636
3296,0.000911,74.125.24.0-255,1484,98607,63,199636
3297,0.000939,74.125.24.0-255,5379,103986,63,199636
3298,0.000942,172.31.40.0-255,66,104052,63,199636
3299,0.001653,74.125.24.0-255,1484,105536,63,199636
3300,0.001659,74.125.24.0-255,2902,108438,63,199636
3301,0.001663,172.31.40.0-255,66,108504,63,199636
3302,0.001692,74.125.24.0-255,5738,114242,63,199636
3303,0.001695,172.31.40.0-255,66,114308,63,199636
3304,0.001712,172.31.40.0-255,66,114374,63,199636
3305,0.001739,74.125.24.0-255,1484,115858,63,199636
3306,0.001752,172.31.40.0-255,66,115924,63,199636
3307,0.00178,74.125.24.0-255,7156,123080,63,199636
3308,0.001783,172.31.40.0-255,66,123146,63,199636
3309,0.001794,172.31.40.0-255,66,123212,63,199636
3310,0.001809,74.125.24.0-255,5738,128950,63,199636
3311,0.001811,172.31.40.0-255,66,129016,63,199636
3312,0.001853,172.31.40.0-255,66,129082,63,199636
3313,0.001855,74.125.24.0-255,766,129848,63,199636
3314,0.002065,74.125.24.0-255,1484,131332,63,199636
3315,0.002069,172.31.40.0-255,66,131398,63,199636
3316,0.002075,74.125.24.0-255,2902,134300,63,199636
3317,0.002077,172.31.40.0-255,66,134366,63,199636
3318,0.002086,74.125.24.0-255,2902,137268,63,199636
3319,0.002088,172.31.40.0-255,66,137334,63,199636
3320,0.002123,74.125.24.0-255,2902,140236,63,199636
3321,0.002148,172.31.40.0-255,66,140302,63,199636
3322,0.002156,172.31.40.0-255,66,140368,63,199636
3323,0.002159,172.31.40.0-255,66,140434,63,199636
3324,0.002382,74.125.24.0-255,1484,141918,63,199636
3325,0.002388,74.125.24.0-255,2902,144820,63,199636
3326,0.002391,172.31.40.0-255,66,144886,63,199636
3327,0.002395,74.125.24.0-255,1484,146370,63,199636
3328,0.002421,74.125.24.0-255,4320,150690,63,199636
3329,0.002424,172.31.40.0-255,66,150756,63,199636
3330,0.002448,172.31.40.0-255,66,150822,63,199636
3331,0.002476,74.125.24.0-255,2902,153724,63,199636
3332,0.002478,172.31.40.0-255,66,153790,63,199636
3333,0.002486,74.125.24.0-255,7156,160946,63,199636
3334,0.002488,172.31.40.0-255,66,161012,63,199636
3335,0.002492,74.125.24.0-255,3602,164614,63,199636
3336,0.002494,172.31.40.0-255,66,164680,63,199636
3337,0.005044,74.125.24.0-255,1484,166164,63,199636
3338,0.005069,74.125.24.0-255,4320,170484,63,199636
3339,0.005074,172.31.40.0-255,66,170550,63,199636
3340,0.007654,74.125.24.0-255,5738,176288,63,199636
3341,0.00766,172.31.40.0-255,66,176354,63,199636
3342,0.010253,74.125.24.0-255,5738,182092,63,199636
3343,0.010258,172.31.40.0-255,66,182158,63,199636
3344,0.012856,74.125.24.0-255,5738,187896,63,199636
3345,0.012874,172.31.40.0-255,66,187962,63,199636
3346,0.015478,74.125.24.0-255,5738,193700,63,199636
3347,0.015488,172.31.40.0-255,66,193766,63,199636
3348,0.018064,74.125.24.0-255,1484,195250,63,199636
3349,0.018087,74.125.24.0-255,4320,199570,63,199636
3350,0.018092,172.31.40.0-255,66,199636,63,199636
3351,0.0,74.125.200.0-255,155,155,63,125842
3352,2.3e-05,172.31.40.0-255,66,221,63,125842
3353,3e-05,74.125.200.0-255,1484,1705,63,125842
3354,3.4e-05,172.31.40.0-255,66,1771,63,125842
3355,4.1e-05,74.125.200.0-255,2902,4673,63,125842
3356,4.5e-05,172.31.40.0-255,66,4739,63,125842
3357,5.7e-05,74.125.200.0-255,2902,7641,63,125842
3358,5.9e-05,172.31.40.0-255,66,7707,63,125842
3359,6.5e-05,74.125.200.0-255,4320,12027,63,125842
3360,6.8e-05,172.31.40.0-255,66,12093,63,125842
3361,0.000102,74.125.200.0-255,2077,14170,63,125842
3362,0.000104,172.31.40.0-255,66,14236,63,125842
3363,0.000314,74.125.200.0-255,1484,15720,63,125842
3364,0.000319,172.31.40.0-255,66,15786,63,125842
3365,0.000325,74.125.200.0-255,2902,18688,63,125842
3366,0.000327,172.31.40.0-255,66,18754,63,125842
3367,0.00033,74.125.200.0-255,1484,20238,63,125842
3368,0.000337,172.31.40.0-255,66,20304,63,125842
3369,0.000373,74.125.200.0-255,2902,23206,63,125842
3370,0.000377,172.31.40.0-255,66,23272,63,125842
3371,0.000384,74.125.200.0-255,5738,29010,63,125842
3372,0.000386,172.31.40.0-255,66,29076,63,125842
3373,0.000388,74.125.200.0-255,1484,30560,63,125842
3374,0.000393,172.31.40.0-255,66,30626,63,125842
3375,0.000431,74.125.200.0-255,1125,31751,63,125842
3376,0.000433,172.31.40.0-255,66,31817,63,125842
3377,0.000535,74.125.200.0-255,1484,33301,63,125842
3378,0.000538,172.31.40.0-255,66,33367,63,125842
3379,0.000541,74.125.200.0-255,1484,34851,63,125842
3380,0.000543,172.31.40.0-255,66,34917,63,125842
3381,0.000546,74.125.200.0-255,1484,36401,63,125842
3382,0.000548,172.31.40.0-255,66,36467,63,125842
3383,0.000567,74.125.200.0-255,1484,37951,63,125842
3384,0.000575,74.125.200.0-255,5738,43689,63,125842
3385,0.000578,74.125.200.0-255,1484,45173,63,125842
3386,0.000605,74.125.200.0-255,2902,48075,63,125842
3387,0.000623,172.31.40.0-255,66,48141,63,125842
3388,0.000645,74.125.200.0-255,5379,53520,63,125842
3389,0.000666,74.125.200.0-255,5738,59258,63,125842
3390,0.000669,172.31.40.0-255,66,59324,63,125842
3391,0.000674,172.31.40.0-255,66,59390,63,125842
3392,0.000689,74.125.200.0-255,5738,65128,63,125842
3393,0.000728,172.31.40.0-255,66,65194,63,125842
3394,0.000731,74.125.200.0-255,1418,66612,63,125842
3395,0.00092,74.125.200.0-255,131,66743,63,125842
3396,0.001097,74.125.200.0-255,1484,68227,63,125842
3397,0.001104,74.125.200.0-255,2902,71129,63,125842
3398,0.00111,74.125.200.0-255,5738,76867,63,125842
3399,0.001134,74.125.200.0-255,1484,78351,63,125842
3400,0.001156,74.125.200.0-255,5379,83730,63,125842
3401,0.001159,74.125.200.0-255,1484,85214,63,125842
3402,0.001175,74.125.200.0-255,5738,90952,63,125842
3403,0.005124,172.31.40.0-255,66,91018,63,125842
3404,0.007222,74.125.200.0-255,5738,96756,63,125842
3405,0.007232,172.31.40.0-255,66,96822,63,125842
3406,0.009294,74.125.200.0-255,5738,102560,63,125842
3407,0.009304,172.31.40.0-255,66,102626,63,125842
3408,0.011377,74.125.200.0-255,5738,108364,63,125842
3409,0.012965,172.31.40.0-255,66,108430,63,125842
3410,0.015055,74.125.200.0-255,5738,114168,63,125842
3411,0.01507,172.31.40.0-255,66,114234,63,125842
3412,0.01714,74.125.200.0-255,5738,119972,63,125842
3413,0.017151,172.31.40.0-255,66,120038,63,125842
3414,0.019229,74.125.200.0-255,5738,125776,63,125842
3415,0.01924,172.31.40.0-255,66,125842,63,125842
3416,0.0,74.125.130.0-255,157,157,63,258397
3417,2.1e-05,172.31.40.0-255,66,223,63,258397
3418,2.8e-05,74.125.130.0-255,1484,1707,63,258397
3419,3.3e-05,172.31.40.0-255,66,1773,63,258397
3420,3.9e-05,74.125.130.0-255,2902,4675,63,258397
3421,4.1e-05,172.31.40.0-255,66,4741,63,258397
3422,5.6e-05,74.125.130.0-255,7156,11897,63,258397
3423,6e-05,172.31.40.0-255,66,11963,63,258397
3424,6.4e-05,74.125.130.0-255,2034,13997,63,258397
3425,6.6e-05,172.31.40.0-255,66,14063,63,258397
3426,0.000225,74.125.130.0-255,1484,15547,63,258397
3427,0.00023,172.31.40.0-255,66,15613,63,258397
3428,0.000236,74.125.130.0-255,2902,18515,63,258397
3429,0.000239,172.31.40.0-255,66,18581,63,258397
3430,0.000243,74.125.130.0-255,2902,21483,63,258397
3431,0.00025,172.31.40.0-255,66,21549,63,258397
3432,0.000254,74.125.130.0-255,1484,23033,63,258397
3433,0.000256,172.31.40.0-255,66,23099,63,258397
3434,0.000283,74.125.130.0-255,2902,26001,63,258397
3435,0.000286,172.31.40.0-255,66,26067,63,258397
3436,0.000316,74.125.130.0-255,5379,31446,63,258397
3437,0.000319,172.31.40.0-255,66,31512,63,258397
3438,0.000324,74.125.130.0-255,4320,35832,63,258397
3439,0.000326,172.31.40.0-255,66,35898,63,258397
3440,0.000353,74.125.130.0-255,1484,37382,63,258397
3441,0.000356,172.31.40.0-255,66,37448,63,258397
3442,0.000367,172.31.40.0-255,66,37514,63,258397
3443,0.00041,172.31.40.0-255,66,37580,63,258397
3444,0.000421,172.31.40.0-255,66,37646,63,258397
3445,0.000429,74.125.130.0-255,367,38013,63,258397
3446,0.000523,74.125.130.0-255,1484,39497,63,258397
3447,0.000529,172.31.40.0-255,66,39563,63,258397
3448,0.000542,74.125.130.0-255,2902,42465,63,258397
3449,0.00055,74.125.130.0-255,2902,45367,63,258397
3450,0.000566,74.125.130.0-255,1484,46851,63,258397
3451,0.00057,74.125.130.0-255,2902,49753,63,258397
3452,0.000585,172.31.40.0-255,66,49819,63,258397
3453,0.000589,74.125.130.0-255,2902,52721,63,258397
3454,0.000593,172.31.40.0-255,66,52787,63,258397
3455,0.000612,74.125.130.0-255,2831,55618,63,258397
3456,0.000635,172.31.40.0-255,66,55684,63,258397
3457,0.000646,74.125.130.0-255,2902,58586,63,258397
3458,0.000665,74.125.130.0-255,1484,60070,63,258397
3459,0.000676,74.125.130.0-255,2902,62972,63,258397
3460,0.000687,74.125.130.0-255,2902,65874,63,258397
3461,0.000695,172.31.40.0-255,66,65940,63,258397
3462,0.000703,74.125.130.0-255,2902,68842,63,258397
3463,0.000707,74.125.130.0-255,2902,71744,63,258397
3464,0.000715,172.31.40.0-255,66,71810,63,258397
3465,0.000753,74.125.130.0-255,1125,72935,63,258397
3466,0.00112,74.125.130.0-255,1484,74419,63,258397
3467,0.001124,172.31.40.0-255,66,74485,63,258397
3468,0.00113,74.125.130.0-255,2902,77387,63,258397
3469,0.001131,172.31.40.0-255,66,77453,63,258397
3470,0.001151,74.125.130.0-255,2902,80355,63,258397
3471,0.001153,172.31.40.0-255,66,80421,63,258397
3472,0.001181,74.125.130.0-255,2902,83323,63,258397
3473,0.001185,74.125.130.0-255,2902,86225,63,258397
3474,0.001203,74.125.130.0-255,4320,90545,63,258397
3475,0.001205,74.125.130.0-255,1484,92029,63,258397
3476,0.00121,172.31.40.0-255,66,92095,63,258397
3477,0.001217,74.125.130.0-255,1484,93579,63,258397
3478,0.001221,74.125.130.0-255,2902,96481,63,258397
3479,0.001236,74.125.130.0-255,1484,97965,63,258397
3480,0.001241,172.31.40.0-255,66,98031,63,258397
3481,0.001248,74.125.130.0-255,1484,99515,63,258397
3482,0.00125,172.31.40.0-255,66,99581,63,258397
3483,0.001273,74.125.130.0-255,7156,106737,63,258397
3484,0.001276,74.125.130.0-255,766,107503,63,258397
3485,0.001284,172.31.40.0-255,66,107569,63,258397
3486,0.001369,74.125.130.0-255,1484,109053,63,258397
3487,0.001381,74.125.130.0-255,2902,111955,63,258397
3488,0.00139,172.31.40.0-255,66,112021,63,258397
3489,0.001404,74.125.130.0-255,5738,117759,63,258397
3490,0.001407,74.125.130.0-255,1484,119243,63,258397
3491,0.001429,74.125.130.0-255,4320,123563,63,258397
3492,0.00144,172.31.40.0-255,66,123629,63,258397
3493,0.00146,74.125.130.0-255,7156,130785,63,258397
3494,0.001477,74.125.130.0-255,7156,137941,63,258397
3495,0.001479,172.31.40.0-255,66,138007,63,258397
3496,0.001484,172.31.40.0-255,66,138073,63,258397
3497,0.00151,74.125.130.0-255,3602,141675,63,258397
3498,0.001551,172.31.40.0-255,66,141741,63,258397
3499,0.001634,74.125.130.0-255,1484,143225,63,258397
3500,0.001669,74.125.130.0-255,2902,146127,63,258397
3501,0.001672,172.31.40.0-255,66,146193,63,258397
3502,0.001696,74.125.130.0-255,2902,149095,63,258397
3503,0.001716,172.31.40.0-255,66,149161,63,258397
3504,0.001733,74.125.130.0-255,4320,153481,63,258397
3505,0.001743,172.31.40.0-255,66,153547,63,258397
3506,0.001757,74.125.130.0-255,2902,156449,63,258397
3507,0.001769,74.125.130.0-255,2902,159351,63,258397
3508,0.001777,172.31.40.0-255,66,159417,63,258397
3509,0.001788,74.125.130.0-255,2902,162319,63,258397
3510,0.001812,74.125.130.0-255,4320,166639,63,258397
3511,0.001818,74.125.130.0-255,4320,170959,63,258397
3512,0.001824,74.125.130.0-255,5020,175979,63,258397
3513,0.001831,172.31.40.0-255,66,176045,63,258397
3514,0.002071,74.125.130.0-255,1484,177529,63,258397
3515,0.002098,74.125.130.0-255,1484,179013,63,258397
3516,0.002101,172.31.40.0-255,66,179079,63,258397
3517,0.002129,74.125.130.0-255,1484,180563,63,258397
3518,0.002133,74.125.130.0-255,2902,183465,63,258397
3519,0.002137,172.31.40.0-255,66,183531,63,258397
3520,0.002145,74.125.130.0-255,1484,185015,63,258397
3521,0.002169,74.125.130.0-255,2902,187917,63,258397
3522,0.002174,74.125.130.0-255,5738,193655,63,258397
3523,0.002187,74.125.130.0-255,2902,196557,63,258397
3524,0.00219,172.31.40.0-255,66,196623,63,258397
3525,0.002194,172.31.40.0-255,66,196689,63,258397
3526,0.002204,74.125.130.0-255,2902,199591,63,258397
3527,0.002213,172.31.40.0-255,66,199657,63,258397
3528,0.002241,74.125.130.0-255,7156,206813,63,258397
3529,0.002245,74.125.130.0-255,3602,210415,63,258397
3530,0.00225,74.125.130.0-255,4320,214735,63,258397
3531,0.00226,172.31.40.0-255,66,214801,63,258397
3532,0.002296,172.31.40.0-255,66,214867,63,258397
3533,0.002308,74.125.130.0-255,4320,219187,63,258397
3534,0.00233,74.125.130.0-255,5738,224925,63,258397
3535,0.002334,74.125.130.0-255,2902,227827,63,258397
3536,0.002337,74.125.130.0-255,1484,229311,63,258397
3537,0.006289,172.31.40.0-255,66,229377,63,258397
3538,0.008578,74.125.130.0-255,5738,235115,63,258397
3539,0.008585,172.31.40.0-255,66,235181,63,258397
3540,0.010875,74.125.130.0-255,5738,240919,63,258397
3541,0.010882,172.31.40.0-255,66,240985,63,258397
3542,0.013186,74.125.130.0-255,5738,246723,63,258397
3543,0.013193,172.31.40.0-255,66,246789,63,258397
3544,0.015481,74.125.130.0-255,5738,252527,63,258397
3545,0.015493,172.31.40.0-255,66,252593,63,258397
3546,0.017788,74.125.130.0-255,5738,258331,63,258397
3547,0.017796,172.31.40.0-255,66,258397,63,258397
3548,0.0,172.217.194.0-255,153,153,63,163669
3549,1.9e-05,172.31.40.0-255,66,219,63,163669
3550,2.6e-05,172.217.194.0-255,1484,1703,63,163669
3551,3e-05,172.31.40.0-255,66,1769,63,163669
3552,3.6e-05,172.217.194.0-255,2902,4671,63,163669
3553,3.9e-05,172.31.40.0-255,66,4737,63,163669
3554,4.6e-05,172.217.194.0-255,7156,11893,63,163669
3555,4.8e-05,172.31.40.0-255,66,11959,63,163669
3556,7.9e-05,172.31.40.0-255,66,12025,63,163669
3557,0.00011,172.217.194.0-255,2902,14927,63,163669
3558,0.000112,172.31.40.0-255,66,14993,63,163669
3559,0.000134,172.217.194.0-255,5379,20372,63,163669
3560,0.000137,172.31.40.0-255,66,20438,63,163669
3561,0.000146,172.31.40.0-255,66,20504,63,163669
3562,0.000176,172.31.40.0-255,66,20570,63,163669
3563,0.000187,172.217.194.0-255,1484,22054,63,163669
3564,0.000189,172.31.40.0-255,66,22120,63,163669
3565,0.00021,172.217.194.0-255,7156,29276,63,163669
3566,0.000213,172.31.40.0-255,66,29342,63,163669
3567,0.000236,172.217.194.0-255,5738,35080,63,163669
3568,0.000238,172.31.40.0-255,66,35146,63,163669
3569,0.000259,172.217.194.0-255,1484,36630,63,163669
3570,0.000261,172.31.40.0-255,66,36696,63,163669
3571,0.000264,172.217.194.0-255,1401,38097,63,163669
3572,0.000266,172.31.40.0-255,66,38163,63,163669
3573,0.000278,172.217.194.0-255,400,38563,63,163669
3574,0.00028,172.31.40.0-255,66,38629,63,163669
3575,0.000607,172.217.194.0-255,1484,40113,63,163669
3576,0.000613,172.31.40.0-255,66,40179,63,163669
3577,0.000619,172.217.194.0-255,2902,43081,63,163669
3578,0.000627,172.217.194.0-255,5738,48819,63,163669
3579,0.000656,172.217.194.0-255,2902,51721,63,163669
3580,0.000661,172.31.40.0-255,66,51787,63,163669
3581,0.000674,172.217.194.0-255,3961,55748,63,163669
3582,0.000678,172.217.194.0-255,1484,57232,63,163669
3583,0.000682,172.217.194.0-255,2902,60134,63,163669
3584,0.000686,172.217.194.0-255,2902,63036,63,163669
3585,0.0007,172.217.194.0-255,2902,65938,63,163669
3586,0.000719,172.217.194.0-255,5738,71676,63,163669
3587,0.000734,172.31.40.0-255,66,71742,63,163669
3588,0.000773,172.217.194.0-255,1125,72867,63,163669
3589,0.000853,172.217.194.0-255,1484,74351,63,163669
3590,0.000859,172.217.194.0-255,2902,77253,63,163669
3591,0.000876,172.217.194.0-255,5738,82991,63,163669
3592,0.000885,172.31.40.0-255,66,83057,63,163669
3593,0.000934,172.31.40.0-255,66,83123,63,163669
3594,0.000945,172.217.194.0-255,4320,87443,63,163669
3595,0.000973,172.217.194.0-255,4320,91763,63,163669
3596,0.000987,172.217.194.0-255,4320,96083,63,163669
3597,0.00099,172.31.40.0-255,66,96149,63,163669
3598,0.001001,172.31.40.0-255,66,96215,63,163669
3599,0.001006,172.217.194.0-255,2184,98399,63,163669
3600,0.001045,172.217.194.0-255,2902,101301,63,163669
3601,0.001047,172.217.194.0-255,1484,102785,63,163669
3602,0.001065,172.31.40.0-255,66,102851,63,163669
3603,0.001071,172.31.40.0-255,66,102917,63,163669
3604,0.00108,172.217.194.0-255,4320,107237,63,163669
3605,0.0011,172.217.194.0-255,2184,109421,63,163669
3606,0.001107,172.31.40.0-255,66,109487,63,163669
3607,0.001708,172.217.194.0-255,1484,110971,63,163669
3608,0.001713,172.217.194.0-255,2902,113873,63,163669
3609,0.001719,172.31.40.0-255,66,113939,63,163669
3610,0.001728,172.217.194.0-255,1484,115423,63,163669
3611,0.001745,172.217.194.0-255,4320,119743,63,163669
3612,0.001755,172.31.40.0-255,66,119809,63,163669
3613,0.00177,172.217.194.0-255,4320,124129,63,163669
3614,0.001811,172.31.40.0-255,66,124195,63,163669
3615,0.001817,172.31.40.0-255,66,124261,63,163669
3616,0.002465,172.217.194.0-255,1484,125745,63,163669
3617,0.002472,172.217.194.0-255,2902,128647,63,163669
3618,0.002475,172.31.40.0-255,66,128713,63,163669
3619,0.002483,172.217.194.0-255,5738,134451,63,163669
3620,0.002485,172.31.40.0-255,66,134517,63,163669
3621,0.00253,172.31.40.0-255,66,134583,63,163669
3622,0.005976,172.31.40.0-255,66,134649,63,163669
3623,0.008638,172.217.194.0-255,5738,140387,63,163669
3624,0.008645,172.31.40.0-255,66,140453,63,163669
3625,0.011228,172.217.194.0-255,5738,146191,63,163669
3626,0.011237,172.31.40.0-255,66,146257,63,163669
3627,0.013837,172.217.194.0-255,5738,151995,63,163669
3628,0.013845,172.31.40.0-255,66,152061,63,163669
3629,0.016422,172.217.194.0-255,5738,157799,63,163669
3630,0.016429,172.31.40.0-255,66,157865,63,163669
3631,0.019071,172.217.194.0-255,5738,163603,63,163669
3632,0.019087,172.31.40.0-255,66,163669,63,163669
3633,0.0,172.31.40.0-255,105,105,63,105
3634,0.0,172.217.194.0-255,343,343,63,148968
3635,2.3e-05,172.31.40.0-255,66,409,63,148968
3636,2.9e-05,172.217.194.0-255,1484,1893,63,148968
3637,3.4e-05,172.31.40.0-255,66,1959,63,148968
3638,4.1e-05,172.217.194.0-255,4320,6279,63,148968
3639,5.3e-05,172.31.40.0-255,66,6345,63,148968
3640,6.6e-05,172.31.40.0-255,66,6411,63,148968
3641,7.1e-05,172.217.194.0-255,2902,9313,63,148968
3642,7.4e-05,172.31.40.0-255,66,9379,63,148968
3643,0.000116,172.217.194.0-255,5738,15117,63,148968
3644,0.00012,172.31.40.0-255,66,15183,63,148968
3645,0.000126,172.217.194.0-255,4320,19503,63,148968
3646,0.000128,172.31.40.0-255,66,19569,63,148968
3647,0.000131,172.217.194.0-255,1484,21053,63,148968
3648,0.000138,172.31.40.0-255,66,21119,63,148968
3649,0.000168,172.217.194.0-255,2543,23662,63,148968
3650,0.000171,172.31.40.0-255,66,23728,63,148968
3651,0.000178,172.217.194.0-255,1484,25212,63,148968
3652,0.000181,172.31.40.0-255,66,25278,63,148968
3653,0.000185,172.217.194.0-255,2902,28180,63,148968
3654,0.000188,172.31.40.0-255,66,28246,63,148968
3655,0.000221,172.217.194.0-255,5738,33984,63,148968
3656,0.000224,172.31.40.0-255,66,34050,63,148968
3657,0.000227,172.217.194.0-255,1484,35534,63,148968
3658,0.000229,172.31.40.0-255,66,35600,63,148968
3659,0.000261,172.217.194.0-255,6797,42397,63,148968
3660,0.000264,172.31.40.0-255,66,42463,63,148968
3661,0.000269,172.217.194.0-255,4320,46783,63,148968
3662,0.000271,172.31.40.0-255,66,46849,63,148968
3663,0.000307,172.31.40.0-255,66,46915,63,148968
3664,0.000539,172.217.194.0-255,111,47026,63,148968
3665,0.000544,172.217.194.0-255,385,47411,63,148968
3666,0.000667,172.217.194.0-255,1484,48895,63,148968
3667,0.000672,172.31.40.0-255,66,48961,63,148968
3668,0.000678,172.217.194.0-255,2902,51863,63,148968
3669,0.000681,172.31.40.0-255,66,51929,63,148968
3670,0.000711,172.217.194.0-255,5738,57667,63,148968
3671,0.000714,172.31.40.0-255,66,57733,63,148968
3672,0.000721,172.217.194.0-255,6248,63981,63,148968
3673,0.000724,172.31.40.0-255,66,64047,63,148968
3674,0.000968,172.217.194.0-255,1484,65531,63,148968
3675,0.000994,172.217.194.0-255,2902,68433,63,148968
3676,0.000998,172.31.40.0-255,66,68499,63,148968
3677,0.001005,172.217.194.0-255,5738,74237,63,148968
3678,0.001008,172.31.40.0-255,66,74303,63,148968
3679,0.001054,172.217.194.0-255,4320,78623,63,148968
3680,0.001057,172.31.40.0-255,66,78689,63,148968
3681,0.001083,172.217.194.0-255,2543,81232,63,148968
3682,0.001085,172.31.40.0-255,66,81298,63,148968
3683,0.001479,172.217.194.0-255,1484,82782,63,148968
3684,0.001511,172.217.194.0-255,2902,85684,63,148968
3685,0.001515,172.31.40.0-255,66,85750,63,148968
3686,0.001545,172.217.194.0-255,5738,91488,63,148968
3687,0.001548,172.31.40.0-255,66,91554,63,148968
3688,0.001575,172.217.194.0-255,4320,95874,63,148968
3689,0.001577,172.31.40.0-255,66,95940,63,148968
3690,0.001604,172.217.194.0-255,2902,98842,63,148968
3691,0.001606,172.31.40.0-255,66,98908,63,148968
3692,0.001614,172.217.194.0-255,7156,106064,63,148968
3693,0.001616,172.31.40.0-255,66,106130,63,148968
3694,0.001642,172.217.194.0-255,1484,107614,63,148968
3695,0.001653,172.31.40.0-255,66,107680,63,148968
3696,0.004251,172.217.194.0-255,5738,113418,63,148968
3697,0.004257,172.31.40.0-255,66,113484,63,148968
3698,0.007341,172.217.194.0-255,5738,119222,63,148968
3699,0.007347,172.31.40.0-255,66,119288,63,148968
3700,0.009901,172.217.194.0-255,2902,122190,63,148968
3701,0.009909,172.31.40.0-255,66,122256,63,148968
3702,0.009937,172.217.194.0-255,2902,125158,63,148968
3703,0.00994,172.31.40.0-255,66,125224,63,148968
3704,0.012203,172.217.194.0-255,2902,128126,63,148968
3705,0.012211,172.31.40.0-255,66,128192,63,148968
3706,0.012241,172.217.194.0-255,2902,131094,63,148968
3707,0.012244,172.31.40.0-255,66,131160,63,148968
3708,0.014491,172.217.194.0-255,2902,134062,63,148968
3709,0.014498,172.31.40.0-255,66,134128,63,148968
3710,0.014552,172.217.194.0-255,2902,137030,63,148968
3711,0.014555,172.31.40.0-255,66,137096,63,148968
3712,0.01685,172.217.194.0-255,2902,139998,63,148968
3713,0.016858,172.31.40.0-255,66,140064,63,148968
3714,0.016888,172.217.194.0-255,2902,142966,63,148968
3715,0.016891,172.31.40.0-255,66,143032,63,148968
3716,0.019197,172.217.194.0-255,2902,145934,63,148968
3717,0.019206,172.31.40.0-255,66,146000,63,148968
3718,0.019238,172.217.194.0-255,2902,148902,63,148968
3719,0.019242,172.31.40.0-255,66,148968,63,148968
3720,0.0,172.253.118.0-255,152,152,63,244279
3721,2.4e-05,172.31.40.0-255,66,218,63,244279
3722,3.1e-05,172.253.118.0-255,1484,1702,63,244279
3723,3.6e-05,172.31.40.0-255,66,1768,63,244279
3724,5e-05,172.253.118.0-255,2902,4670,63,244279
3725,5.4e-05,172.31.40.0-255,66,4736,63,244279
3726,6.3e-05,172.253.118.0-255,7156,11892,63,244279
3727,6.7e-05,172.31.40.0-255,66,11958,63,244279
3728,7.1e-05,172.253.118.0-255,2002,13960,63,244279
3729,7.4e-05,172.31.40.0-255,66,14026,63,244279
3730,0.000108,172.253.118.0-255,1484,15510,63,244279
3731,0.000111,172.31.40.0-255,66,15576,63,244279
3732,0.000116,172.253.118.0-255,2902,18478,63,244279
3733,0.000119,172.31.40.0-255,66,18544,63,244279
3734,0.000122,172.253.118.0-255,1484,20028,63,244279
3735,0.000124,172.31.40.0-255,66,20094,63,244279
3736,0.000159,172.253.118.0-255,4320,24414,63,244279
3737,0.000162,172.31.40.0-255,66,24480,63,244279
3738,0.00017,172.253.118.0-255,6797,31277,63,244279
3739,0.000173,172.31.40.0-255,66,31343,63,244279
3740,0.000265,172.253.118.0-255,1484,32827,63,244279
3741,0.000268,172.31.40.0-255,66,32893,63,244279
3742,0.000274,172.253.118.0-255,2902,35795,63,244279
3743,0.000277,172.31.40.0-255,66,35861,63,244279
3744,0.00028,172.253.118.0-255,1484,37345,63,244279
3745,0.000282,172.31.40.0-255,66,37411,63,244279
3746,0.000314,172.253.118.0-255,4320,41731,63,244279
3747,0.000318,172.31.40.0-255,66,41797,63,244279
3748,0.000324,172.253.118.0-255,5738,47535,63,244279
3749,0.000326,172.31.40.0-255,66,47601,63,244279
3750,0.000361,172.31.40.0-255,66,47667,63,244279
3751,0.000389,172.253.118.0-255,5379,53046,63,244279
3752,0.000391,172.31.40.0-255,66,53112,63,244279
3753,0.000402,172.253.118.0-255,4270,57382,63,244279
3754,0.000405,172.31.40.0-255,66,57448,63,244279
3755,0.000407,172.253.118.0-255,376,57824,63,244279
3756,0.000668,172.253.118.0-255,1484,59308,63,244279
3757,0.000674,172.31.40.0-255,66,59374,63,244279
3758,0.000679,172.253.118.0-255,2902,62276,63,244279
3759,0.000682,172.31.40.0-255,66,62342,63,244279
3760,0.000686,172.253.118.0-255,2902,65244,63,244279
3761,0.000693,172.31.40.0-255,66,65310,63,244279
3762,0.00072,172.253.118.0-255,2902,68212,63,244279
3763,0.000723,172.31.40.0-255,66,68278,63,244279
3764,0.000741,172.31.40.0-255,66,68344,63,244279
3765,0.000794,172.31.40.0-255,66,68410,63,244279
3766,0.000901,172.253.118.0-255,1484,69894,63,244279
3767,0.000908,172.253.118.0-255,2902,72796,63,244279
3768,0.000912,172.31.40.0-255,66,72862,63,244279
3769,0.000916,172.253.118.0-255,1484,74346,63,244279
3770,0.000942,172.253.118.0-255,4320,78666,63,244279
3771,0.000944,172.31.40.0-255,66,78732,63,244279
3772,0.000952,172.253.118.0-255,7156,85888,63,244279
3773,0.000954,172.31.40.0-255,66,85954,63,244279
3774,0.000971,172.31.40.0-255,66,86020,63,244279
3775,0.001002,172.253.118.0-255,4320,90340,63,244279
3776,0.001004,172.31.40.0-255,66,90406,63,244279
3777,0.001008,172.253.118.0-255,2184,92590,63,244279
3778,0.001011,172.31.40.0-255,66,92656,63,244279
3779,0.001178,172.253.118.0-255,1484,94140,63,244279
3780,0.001199,172.253.118.0-255,2902,97042,63,244279
3781,0.001203,172.31.40.0-255,66,97108,63,244279
3782,0.001209,172.253.118.0-255,5738,102846,63,244279
3783,0.001212,172.31.40.0-255,66,102912,63,244279
3784,0.001252,172.31.40.0-255,66,102978,63,244279
3785,0.001302,172.31.40.0-255,66,103044,63,244279
3786,0.001332,172.253.118.0-255,2902,105946,63,244279
3787,0.001335,172.31.40.0-255,66,106012,63,244279
3788,0.001341,172.253.118.0-255,4320,110332,63,244279
3789,0.001343,172.31.40.0-255,66,110398,63,244279
3790,0.001389,172.253.118.0-255,1484,111882,63,244279
3791,0.001417,172.253.118.0-255,7156,119038,63,244279
3792,0.00142,172.31.40.0-255,66,119104,63,244279
3793,0.001436,172.31.40.0-255,66,119170,63,244279
3794,0.00144,172.253.118.0-255,3602,122772,63,244279
3795,0.001442,172.31.40.0-255,66,122838,63,244279
3796,0.001499,172.253.118.0-255,1484,124322,63,244279
3797,0.001504,172.253.118.0-255,2902,127224,63,244279
3798,0.001507,172.31.40.0-255,66,127290,63,244279
3799,0.001537,172.253.118.0-255,5738,133028,63,244279
3800,0.00154,172.31.40.0-255,66,133094,63,244279
3801,0.001547,172.253.118.0-255,7156,140250,63,244279
3802,0.001548,172.31.40.0-255,66,140316,63,244279
3803,0.001586,172.31.40.0-255,66,140382,63,244279
3804,0.00159,172.253.118.0-255,2184,142566,63,244279
3805,0.001592,172.31.40.0-255,66,142632,63,244279
3806,0.001696,172.253.118.0-255,1484,144116,63,244279
3807,0.001708,172.253.118.0-255,2902,147018,63,244279
3808,0.001711,172.31.40.0-255,66,147084,63,244279
3809,0.001733,172.253.118.0-255,1484,148568,63,244279
3810,0.00175,172.253.118.0-255,4320,152888,63,244279
3811,0.001752,172.31.40.0-255,66,152954,63,244279
3812,0.001758,172.253.118.0-255,4320,157274,63,244279
3813,0.00176,172.31.40.0-255,66,157340,63,244279
3814,0.00179,172.253.118.0-255,5738,163078,63,244279
3815,0.001792,172.31.40.0-255,66,163144,63,244279
3816,0.001802,172.31.40.0-255,66,163210,63,244279
3817,0.001829,172.253.118.0-255,5020,168230,63,244279
3818,0.001835,172.31.40.0-255,66,168296,63,244279
3819,0.001846,172.253.118.0-255,2902,171198,63,244279
3820,0.001852,172.31.40.0-255,66,171264,63,244279
3821,0.001883,172.253.118.0-255,7156,178420,63,244279
3822,0.001886,172.31.40.0-255,66,178486,63,244279
3823,0.001897,172.31.40.0-255,66,178552,63,244279
3824,0.001907,172.253.118.0-255,7156,185708,63,244279
3825,0.001909,172.31.40.0-255,66,185774,63,244279
3826,0.001929,172.253.118.0-255,1484,187258,63,244279
3827,0.001963,172.31.40.0-255,66,187324,63,244279
3828,0.001982,172.253.118.0-255,3602,190926,63,244279
3829,0.001985,172.31.40.0-255,66,190992,63,244279
3830,0.001987,172.253.118.0-255,1484,192476,63,244279
3831,0.002,172.31.40.0-255,66,192542,63,244279
3832,0.002034,172.253.118.0-255,5020,197562,63,244279
3833,0.002036,172.31.40.0-255,66,197628,63,244279
3834,0.002063,172.253.118.0-255,1484,199112,63,244279
3835,0.002066,172.253.118.0-255,1484,200596,63,244279
3836,0.002068,172.31.40.0-255,66,200662,63,244279
3837,0.002095,172.253.118.0-255,1484,202146,63,244279
3838,0.0021,172.253.118.0-255,2902,205048,63,244279
3839,0.002102,172.31.40.0-255,66,205114,63,244279
3840,0.002109,172.253.118.0-255,7156,212270,63,244279
3841,0.00211,172.31.40.0-255,66,212336,63,244279
3842,0.002185,172.31.40.0-255,66,212402,63,244279
3843,0.002197,172.253.118.0-255,2902,215304,63,244279
3844,0.002203,172.31.40.0-255,66,215370,63,244279
3845,0.002208,172.253.118.0-255,3602,218972,63,244279
3846,0.00221,172.31.40.0-255,66,219038,63,244279
3847,0.002241,172.253.118.0-255,1484,220522,63,244279
3848,0.002257,172.253.118.0-255,1484,222006,63,244279
3849,0.00226,172.31.40.0-255,66,222072,63,244279
3850,0.002288,172.253.118.0-255,1484,223556,63,244279
3851,0.002294,172.253.118.0-255,5738,229294,63,244279
3852,0.002297,172.31.40.0-255,66,229360,63,244279
3853,0.0023,172.253.118.0-255,2902,232262,63,244279
3854,0.002302,172.31.40.0-255,66,232328,63,244279
3855,0.002334,172.31.40.0-255,66,232394,63,244279
3856,0.002337,172.253.118.0-255,1484,233878,63,244279
3857,0.00236,172.253.118.0-255,7156,241034,63,244279
3858,0.002363,172.31.40.0-255,66,241100,63,244279
3859,0.002388,172.253.118.0-255,2771,243871,63,244279
3860,0.00239,172.31.40.0-255,66,243937,63,244279
3861,0.004685,172.253.118.0-255,105,244042,63,244279
3862,0.008915,172.31.40.0-255,66,244108,63,244279
3863,0.008959,172.31.40.0-255,105,244213,63,244279
3864,0.011215,172.253.118.0-255,66,244279,63,244279
3865,0.0,172.217.194.0-255,155,155,63,183504
3866,2e-05,172.31.40.0-255,66,221,63,183504
3867,2.8e-05,172.217.194.0-255,1484,1705,63,183504
3868,3.3e-05,172.31.40.0-255,66,1771,63,183504
3869,3.9e-05,172.217.194.0-255,2902,4673,63,183504
3870,4.9e-05,172.31.40.0-255,66,4739,63,183504
3871,5.6e-05,172.217.194.0-255,7156,11895,63,183504
3872,6e-05,172.31.40.0-255,66,11961,63,183504
3873,6.4e-05,172.217.194.0-255,2067,14028,63,183504
3874,6.6e-05,172.31.40.0-255,66,14094,63,183504
3875,0.000206,172.217.194.0-255,1484,15578,63,183504
3876,0.000211,172.31.40.0-255,66,15644,63,183504
3877,0.000215,172.217.194.0-255,1484,17128,63,183504
3878,0.000218,172.31.40.0-255,66,17194,63,183504
3879,0.000247,172.217.194.0-255,1484,18678,63,183504
3880,0.00025,172.31.40.0-255,66,18744,63,183504
3881,0.000257,172.217.194.0-255,5738,24482,63,183504
3882,0.00026,172.31.40.0-255,66,24548,63,183504
3883,0.000267,172.217.194.0-255,6797,31345,63,183504
3884,0.000269,172.31.40.0-255,66,31411,63,183504
3885,0.00031,172.217.194.0-255,1484,32895,63,183504
3886,0.000313,172.31.40.0-255,66,32961,63,183504
3887,0.000316,172.217.194.0-255,1484,34445,63,183504
3888,0.000318,172.31.40.0-255,66,34511,63,183504
3889,0.000349,172.217.194.0-255,1484,35995,63,183504
3890,0.000352,172.31.40.0-255,66,36061,63,183504
3891,0.000358,172.217.194.0-255,5738,41799,63,183504
3892,0.00036,172.31.40.0-255,66,41865,63,183504
3893,0.000367,172.217.194.0-255,6797,48662,63,183504
3894,0.000369,172.31.40.0-255,66,48728,63,183504
3895,0.000424,172.31.40.0-255,66,48794,63,183504
3896,0.000429,172.217.194.0-255,2543,51337,63,183504
3897,0.000431,172.31.40.0-255,66,51403,63,183504
3898,0.000435,172.217.194.0-255,341,51744,63,183504
3899,0.000472,172.217.194.0-255,434,52178,63,183504
3900,0.000725,172.217.194.0-255,1484,53662,63,183504
3901,0.000732,172.31.40.0-255,66,53728,63,183504
3902,0.000738,172.217.194.0-255,2902,56630,63,183504
3903,0.000741,172.31.40.0-255,66,56696,63,183504
3904,0.000746,172.217.194.0-255,5738,62434,63,183504
3905,0.000753,172.31.40.0-255,66,62500,63,183504
3906,0.000756,172.217.194.0-255,1484,63984,63,183504
3907,0.000795,172.31.40.0-255,66,64050,63,183504
3908,0.000831,172.31.40.0-255,66,64116,63,183504
3909,0.000858,172.217.194.0-255,5020,69136,63,183504
3910,0.000861,172.31.40.0-255,66,69202,63,183504
3911,0.00097,172.217.194.0-255,1484,70686,63,183504
3912,0.000984,172.217.194.0-255,2902,73588,63,183504
3913,0.000987,172.31.40.0-255,66,73654,63,183504
3914,0.001022,172.217.194.0-255,5738,79392,63,183504
3915,0.001025,172.31.40.0-255,66,79458,63,183504
3916,0.001033,172.217.194.0-255,7156,86614,63,183504
3917,0.001035,172.31.40.0-255,66,86680,63,183504
3918,0.001041,172.217.194.0-255,4320,91000,63,183504
3919,0.001043,172.31.40.0-255,66,91066,63,183504
3920,0.001082,172.31.40.0-255,66,91132,63,183504
3921,0.001085,172.217.194.0-255,1484,92616,63,183504
3922,0.001088,172.217.194.0-255,766,93382,63,183504
3923,0.00109,172.31.40.0-255,66,93448,63,183504
3924,0.001149,172.217.194.0-255,1484,94932,63,183504
3925,0.001155,172.217.194.0-255,4320,99252,63,183504
3926,0.001157,172.31.40.0-255,66,99318,63,183504
3927,0.001163,172.217.194.0-255,2902,102220,63,183504
3928,0.001165,172.31.40.0-255,66,102286,63,183504
3929,0.00117,172.217.194.0-255,4320,106606,63,183504
3930,0.001172,172.31.40.0-255,66,106672,63,183504
3931,0.001175,172.217.194.0-255,1484,108156,63,183504
3932,0.001212,172.217.194.0-255,7156,115312,63,183504
3933,0.001216,172.31.40.0-255,66,115378,63,183504
3934,0.001228,172.31.40.0-255,66,115444,63,183504
3935,0.001232,172.217.194.0-255,1484,116928,63,183504
3936,0.001278,172.31.40.0-255,66,116994,63,183504
3937,0.001291,172.31.40.0-255,66,117060,63,183504
3938,0.001314,172.217.194.0-255,2902,119962,63,183504
3939,0.001316,172.31.40.0-255,66,120028,63,183504
3940,0.001349,172.31.40.0-255,66,120094,63,183504
3941,0.001352,172.217.194.0-255,1484,121578,63,183504
3942,0.001385,172.217.194.0-255,2902,124480,63,183504
3943,0.001391,172.217.194.0-255,5738,130218,63,183504
3944,0.001393,172.217.194.0-255,1484,131702,63,183504
3945,0.001398,172.31.40.0-255,66,131768,63,183504
3946,0.001401,172.31.40.0-255,66,131834,63,183504
3947,0.00143,172.31.40.0-255,66,131900,63,183504
3948,0.001441,172.31.40.0-255,66,131966,63,183504
3949,0.001468,172.217.194.0-255,2184,134150,63,183504
3950,0.001471,172.31.40.0-255,66,134216,63,183504
3951,0.001506,172.217.194.0-255,1484,135700,63,183504
3952,0.001511,172.217.194.0-255,2902,138602,63,183504
3953,0.001513,172.31.40.0-255,66,138668,63,183504
3954,0.001542,172.217.194.0-255,5738,144406,63,183504
3955,0.001544,172.31.40.0-255,66,144472,63,183504
3956,0.001583,172.217.194.0-255,7156,151628,63,183504
3957,0.001587,172.31.40.0-255,66,151694,63,183504
3958,0.001597,172.31.40.0-255,66,151760,63,183504
3959,0.001605,172.217.194.0-255,1484,153244,63,183504
3960,0.001634,172.217.194.0-255,6438,159682,63,183504
3961,0.001637,172.31.40.0-255,66,159748,63,183504
3962,0.001714,172.217.194.0-255,1484,161232,63,183504
3963,0.001719,172.217.194.0-255,2902,164134,63,183504
3964,0.001722,172.31.40.0-255,66,164200,63,183504
3965,0.001757,172.217.194.0-255,5738,169938,63,183504
3966,0.001761,172.31.40.0-255,66,170004,63,183504
3967,0.001792,172.217.194.0-255,4320,174324,63,183504
3968,0.001813,172.31.40.0-255,66,174390,63,183504
3969,0.001842,172.217.194.0-255,7156,181546,63,183504
3970,0.001849,172.31.40.0-255,66,181612,63,183504
3971,0.001892,172.31.40.0-255,66,181678,63,183504
3972,0.001947,172.217.194.0-255,1484,183162,63,183504
3973,0.001956,172.31.40.0-255,66,183228,63,183504
3974,0.002043,172.217.194.0-255,105,183333,63,183504
3975,0.002072,172.31.40.0-255,66,183399,63,183504
3976,0.019111,172.31.40.0-255,105,183504,63,183504
3977,0.0,172.217.194.0-255,152,152,63,197709
3978,2.4e-05,172.31.40.0-255,66,218,63,197709
3979,3.1e-05,172.217.194.0-255,1484,1702,63,197709
3980,3.5e-05,172.31.40.0-255,66,1768,63,197709
3981,3.9e-05,172.217.194.0-255,1484,3252,63,197709
3982,4.1e-05,172.31.40.0-255,66,3318,63,197709
3983,6.1e-05,172.217.194.0-255,1484,4802,63,197709
3984,6.4e-05,172.31.40.0-255,66,4868,63,197709
3985,7.2e-05,172.217.194.0-255,5738,10606,63,197709
3986,7.4e-05,172.31.40.0-255,66,10672,63,197709
3987,7.7e-05,172.217.194.0-255,1484,12156,63,197709
3988,7.9e-05,172.31.40.0-255,66,12222,63,197709
3989,0.0001,172.217.194.0-255,2014,14236,63,197709
3990,0.000102,172.31.40.0-255,66,14302,63,197709
3991,0.000153,172.31.40.0-255,66,14368,63,197709
3992,0.000217,172.217.194.0-255,2902,17270,63,197709
3993,0.00022,172.31.40.0-255,66,17336,63,197709
3994,0.000246,172.217.194.0-255,2543,19879,63,197709
3995,0.000249,172.31.40.0-255,66,19945,63,197709
3996,0.000602,172.217.194.0-255,1484,21429,63,197709
3997,0.000607,172.31.40.0-255,66,21495,63,197709
3998,0.000613,172.217.194.0-255,2902,24397,63,197709
3999,0.000616,172.31.40.0-255,66,24463,63,197709
4000,0.000622,172.217.194.0-255,5738,30201,63,197709
4001,0.000624,172.31.40.0-255,66,30267,63,197709
4002,0.000647,172.217.194.0-255,5738,36005,63,197709
4003,0.000649,172.31.40.0-255,66,36071,63,197709
4004,0.000672,172.217.194.0-255,4320,40391,63,197709
4005,0.000676,172.31.40.0-255,66,40457,63,197709
4006,0.000707,172.217.194.0-255,5738,46195,63,197709
4007,0.00071,172.31.40.0-255,66,46261,63,197709
4008,0.000745,172.31.40.0-255,66,46327,63,197709
4009,0.000903,172.217.194.0-255,341,46668,63,197709
4010,0.000923,172.217.194.0-255,121,46789,63,197709
4011,0.001069,172.31.40.0-255,66,46855,63,197709
4012,0.001109,172.217.194.0-255,1484,48339,63,197709
4013,0.001122,172.217.194.0-255,2902,51241,63,197709
4014,0.001125,172.31.40.0-255,66,51307,63,197709
4015,0.001139,172.217.194.0-255,2902,54209,63,197709
4016,0.001141,172.31.40.0-255,66,54275,63,197709
4017,0.001167,172.217.194.0-255,2902,57177,63,197709
4018,0.00117,172.31.40.0-255,66,57243,63,197709
4019,0.001175,172.217.194.0-255,4320,61563,63,197709
4020,0.001177,172.31.40.0-255,66,61629,63,197709
4021,0.001212,172.31.40.0-255,66,61695,63,197709
4022,0.001241,172.217.194.0-255,2902,64597,63,197709
4023,0.001252,172.31.40.0-255,66,64663,63,197709
4024,0.001255,172.31.40.0-255,66,64729,63,197709
4025,0.001284,172.217.194.0-255,380,65109,63,197709
4026,0.001412,172.217.194.0-255,1484,66593,63,197709
4027,0.001416,172.31.40.0-255,66,66659,63,197709
4028,0.001441,172.217.194.0-255,1484,68143,63,197709
4029,0.001453,172.217.194.0-255,1484,69627,63,197709
4030,0.001456,172.31.40.0-255,66,69693,63,197709
4031,0.001461,172.217.194.0-255,2902,72595,63,197709
4032,0.001463,172.31.40.0-255,66,72661,63,197709
4033,0.001483,172.217.194.0-255,2902,75563,63,197709
4034,0.001486,172.31.40.0-255,66,75629,63,197709
4035,0.001492,172.217.194.0-255,4320,79949,63,197709
4036,0.001494,172.31.40.0-255,66,80015,63,197709
4037,0.001498,172.217.194.0-255,1484,81499,63,197709
4038,0.001523,172.217.194.0-255,2902,84401,63,197709
4039,0.001526,172.31.40.0-255,66,84467,63,197709
4040,0.001529,172.31.40.0-255,66,84533,63,197709
4041,0.001544,172.217.194.0-255,5020,89553,63,197709
4042,0.001546,172.31.40.0-255,66,89619,63,197709
4043,0.00162,172.217.194.0-255,1484,91103,63,197709
4044,0.001641,172.217.194.0-255,2902,94005,63,197709
4045,0.001644,172.31.40.0-255,66,94071,63,197709
4046,0.00165,172.217.194.0-255,2902,96973,63,197709
4047,0.001651,172.31.40.0-255,66,97039,63,197709
4048,0.001669,172.217.194.0-255,2902,99941,63,197709
4049,0.001672,172.31.40.0-255,66,100007,63,197709
4050,0.001677,172.217.194.0-255,4320,104327,63,197709
4051,0.00168,172.31.40.0-255,66,104393,63,197709
4052,0.001716,172.217.194.0-255,4320,108713,63,197709
4053,0.001719,172.31.40.0-255,66,108779,63,197709
4054,0.001731,172.31.40.0-255,66,108845,63,197709
4055,0.001735,172.217.194.0-255,2902,111747,63,197709
4056,0.001737,172.31.40.0-255,66,111813,63,197709
4057,0.001758,172.217.194.0-255,2184,113997,63,197709
4058,0.00176,172.31.40.0-255,66,114063,63,197709
4059,0.001834,172.217.194.0-255,1484,115547,63,197709
4060,0.001882,172.217.194.0-255,2902,118449,63,197709
4061,0.001886,172.31.40.0-255,66,118515,63,197709
4062,0.001917,172.217.194.0-255,4320,122835,63,197709
4063,0.001919,172.31.40.0-255,66,122901,63,197709
4064,0.001943,172.31.40.0-255,66,122967,63,197709
4065,0.001946,172.217.194.0-255,1484,124451,63,197709
4066,0.00203,172.31.40.0-255,66,124517,63,197709
4067,0.002111,172.217.194.0-255,1484,126001,63,197709
4068,0.002117,172.217.194.0-255,2902,128903,63,197709
4069,0.002121,172.31.40.0-255,66,128969,63,197709
4070,0.002128,172.217.194.0-255,5738,134707,63,197709
4071,0.002131,172.31.40.0-255,66,134773,63,197709
4072,0.002135,172.217.194.0-255,2902,137675,63,197709
4073,0.002137,172.31.40.0-255,66,137741,63,197709
4074,0.002158,172.217.194.0-255,4320,142061,63,197709
4075,0.00216,172.31.40.0-255,66,142127,63,197709
4076,0.002165,172.217.194.0-255,2902,145029,63,197709
4077,0.002167,172.31.40.0-255,66,145095,63,197709
4078,0.00221,172.31.40.0-255,66,145161,63,197709
4079,0.002214,172.217.194.0-255,2184,147345,63,197709
4080,0.002216,172.31.40.0-255,66,147411,63,197709
4081,0.002299,172.217.194.0-255,1484,148895,63,197709
4082,0.002305,172.217.194.0-255,2902,151797,63,197709
4083,0.002308,172.31.40.0-255,66,151863,63,197709
4084,0.002312,172.217.194.0-255,1484,153347,63,197709
4085,0.002338,172.217.194.0-255,4320,157667,63,197709
4086,0.002342,172.31.40.0-255,66,157733,63,197709
4087,0.002353,172.217.194.0-255,5738,163471,63,197709
4088,0.002355,172.31.40.0-255,66,163537,63,197709
4089,0.0024,172.31.40.0-255,66,163603,63,197709
4090,0.002406,172.217.194.0-255,5020,168623,63,197709
4091,0.002408,172.31.40.0-255,66,168689,63,197709
4092,0.004817,172.217.194.0-255,5738,174427,63,197709
4093,0.004824,172.31.40.0-255,66,174493,63,197709
4094,0.007255,172.217.194.0-255,5738,180231,63,197709
4095,0.010468,172.31.40.0-255,66,180297,63,197709
4096,0.012881,172.217.194.0-255,5738,186035,63,197709
4097,0.012891,172.31.40.0-255,66,186101,63,197709
4098,0.015304,172.217.194.0-255,5738,191839,63,197709
4099,0.015311,172.31.40.0-255,66,191905,63,197709
4100,0.017751,172.217.194.0-255,5738,197643,63,197709
4101,0.017764,172.31.40.0-255,66,197709,63,197709
4102,0.0,74.125.200.0-255,153,153,63,199319
4103,2.2e-05,172.31.40.0-255,66,219,63,199319
4104,2.9e-05,74.125.200.0-255,1484,1703,63,199319
4105,3.2e-05,172.31.40.0-255,66,1769,63,199319
4106,3.7e-05,74.125.200.0-255,2902,4671,63,199319
4107,4.7e-05,172.31.40.0-255,66,4737,63,199319
4108,5e-05,74.125.200.0-255,1484,6221,63,199319
4109,5.3e-05,172.31.40.0-255,66,6287,63,199319
4110,7.2e-05,74.125.200.0-255,1484,7771,63,199319
4111,7.4e-05,172.31.40.0-255,66,7837,63,199319
4112,8.4e-05,74.125.200.0-255,4320,12157,63,199319
4113,8.7e-05,172.31.40.0-255,66,12223,63,199319
4114,0.000112,74.125.200.0-255,2003,14226,63,199319
4115,0.000119,172.31.40.0-255,66,14292,63,199319
4116,0.000834,74.125.200.0-255,1484,15776,63,199319
4117,0.000841,172.31.40.0-255,66,15842,63,199319
4118,0.000849,74.125.200.0-255,1484,17326,63,199319
4119,0.000851,172.31.40.0-255,66,17392,63,199319
4120,0.000899,74.125.200.0-255,2902,20294,63,199319
4121,0.000902,172.31.40.0-255,66,20360,63,199319
4122,0.000908,74.125.200.0-255,5738,26098,63,199319
4123,0.00091,172.31.40.0-255,66,26164,63,199319
4124,0.00092,74.125.200.0-255,5379,31543,63,199319
4125,0.000922,172.31.40.0-255,66,31609,63,199319
4126,0.000929,74.125.200.0-255,5738,37347,63,199319
4127,0.000932,172.31.40.0-255,66,37413,63,199319
4128,0.000967,74.125.200.0-255,5738,43151,63,199319
4129,0.00097,172.31.40.0-255,66,43217,63,199319
4130,0.000976,74.125.200.0-255,7156,50373,63,199319
4131,0.000978,172.31.40.0-255,66,50439,63,199319
4132,0.001027,172.31.40.0-255,66,50505,63,199319
4133,0.001049,74.125.200.0-255,766,51271,63,199319
4134,0.001323,74.125.200.0-255,398,51669,63,199319
4135,0.001328,74.125.200.0-255,112,51781,63,199319
4136,0.0015,74.125.200.0-255,1484,53265,63,199319
4137,0.001505,172.31.40.0-255,66,53331,63,199319
4138,0.001511,74.125.200.0-255,2902,56233,63,199319
4139,0.001514,172.31.40.0-255,66,56299,63,199319
4140,0.001517,74.125.200.0-255,1484,57783,63,199319
4141,0.001548,74.125.200.0-255,2902,60685,63,199319
4142,0.001551,172.31.40.0-255,66,60751,63,199319
4143,0.001585,172.31.40.0-255,66,60817,63,199319
4144,0.001616,74.125.200.0-255,5738,66555,63,199319
4145,0.001619,172.31.40.0-255,66,66621,63,199319
4146,0.001643,74.125.200.0-255,4320,70941,63,199319
4147,0.001645,172.31.40.0-255,66,71007,63,199319
4148,0.001669,74.125.200.0-255,4320,75327,63,199319
4149,0.001672,172.31.40.0-255,66,75393,63,199319
4150,0.001695,74.125.200.0-255,2184,77577,63,199319
4151,0.001698,172.31.40.0-255,66,77643,63,199319
4152,0.001726,74.125.200.0-255,7156,84799,63,199319
4153,0.001728,172.31.40.0-255,66,84865,63,199319
4154,0.001735,74.125.200.0-255,7156,92021,63,199319
4155,0.001737,172.31.40.0-255,66,92087,63,199319
4156,0.001763,74.125.200.0-255,1484,93571,63,199319
4157,0.001768,74.125.200.0-255,4320,97891,63,199319
4158,0.00177,172.31.40.0-255,66,97957,63,199319
4159,0.001805,172.31.40.0-255,66,98023,63,199319
4160,0.001834,74.125.200.0-255,5020,103043,63,199319
4161,0.001836,172.31.40.0-255,66,103109,63,199319
4162,0.001842,74.125.200.0-255,5738,108847,63,199319
4163,0.001844,172.31.40.0-255,66,108913,63,199319
4164,0.001891,172.31.40.0-255,66,108979,63,199319
4165,0.001919,74.125.200.0-255,2902,111881,63,199319
4166,0.001921,172.31.40.0-255,66,111947,63,199319
4167,0.001952,74.125.200.0-255,7156,119103,63,199319
4168,0.001954,172.31.40.0-255,66,119169,63,199319
4169,0.001979,74.125.200.0-255,6438,125607,63,199319
4170,0.001981,172.31.40.0-255,66,125673,63,199319
4171,0.002108,74.125.200.0-255,1484,127157,63,199319
4172,0.002123,74.125.200.0-255,2902,130059,63,199319
4173,0.002125,172.31.40.0-255,66,130125,63,199319
4174,0.002161,74.125.200.0-255,5738,135863,63,199319
4175,0.002164,172.31.40.0-255,66,135929,63,199319
4176,0.002168,74.125.200.0-255,2902,138831,63,199319
4177,0.00217,172.31.40.0-255,66,138897,63,199319
4178,0.002174,74.125.200.0-255,2902,141799,63,199319
4179,0.002176,172.31.40.0-255,66,141865,63,199319
4180,0.002199,74.125.200.0-255,1484,143349,63,199319
4181,0.002205,74.125.200.0-255,5738,149087,63,199319
4182,0.002208,172.31.40.0-255,66,149153,63,199319
4183,0.002226,74.125.200.0-255,2902,152055,63,199319
4184,0.002228,172.31.40.0-255,66,152121,63,199319
4185,0.002235,74.125.200.0-255,7156,159277,63,199319
4186,0.002237,172.31.40.0-255,66,159343,63,199319
4187,0.002301,74.125.200.0-255,766,160109,63,199319
4188,0.004554,74.125.200.0-255,4320,164429,63,199319
4189,0.00456,172.31.40.0-255,66,164495,63,199319
4190,0.006872,74.125.200.0-255,5738,170233,63,199319
4191,0.006882,172.31.40.0-255,66,170299,63,199319
4192,0.009198,74.125.200.0-255,5738,176037,63,199319
4193,0.009207,172.31.40.0-255,66,176103,63,199319
4194,0.011523,74.125.200.0-255,5738,181841,63,199319
4195,0.01153,172.31.40.0-255,66,181907,63,199319
4196,0.013839,74.125.200.0-255,5738,187645,63,199319
4197,0.013849,172.31.40.0-255,66,187711,63,199319
4198,0.016165,74.125.200.0-255,5738,193449,63,199319
4199,0.016173,172.31.40.0-255,66,193515,63,199319
4200,0.018486,74.125.200.0-255,5738,199253,63,199319
4201,0.018494,172.31.40.0-255,66,199319,63,199319
4202,0.0,172.217.194.0-255,152,152,63,213199
4203,2.2e-05,172.31.40.0-255,66,218,63,213199
4204,3e-05,172.217.194.0-255,1484,1702,63,213199
4205,3.4e-05,172.31.40.0-255,66,1768,63,213199
4206,4.8e-05,172.217.194.0-255,2902,4670,63,213199
4207,5.3e-05,172.31.40.0-255,66,4736,63,213199
4208,6e-05,172.217.194.0-255,7156,11892,63,213199
4209,6.4e-05,172.31.40.0-255,66,11958,63,213199
4210,7.6e-05,172.31.40.0-255,66,12024,63,213199
4211,8.8e-05,172.31.40.0-255,66,12090,63,213199
4212,0.000111,172.217.194.0-255,2543,14633,63,213199
4213,0.000114,172.31.40.0-255,66,14699,63,213199
4214,0.00016,172.217.194.0-255,1484,16183,63,213199
4215,0.000162,172.31.40.0-255,66,16249,63,213199
4216,0.000166,172.217.194.0-255,1484,17733,63,213199
4217,0.000168,172.31.40.0-255,66,17799,63,213199
4218,0.000194,172.217.194.0-255,1484,19283,63,213199
4219,0.000197,172.31.40.0-255,66,19349,63,213199
4220,0.000209,172.217.194.0-255,5738,25087,63,213199
4221,0.000212,172.31.40.0-255,66,25153,63,213199
4222,0.000215,172.217.194.0-255,1484,26637,63,213199
4223,0.000216,172.31.40.0-255,66,26703,63,213199
4224,0.000256,172.31.40.0-255,66,26769,63,213199
4225,0.000268,172.31.40.0-255,66,26835,63,213199
4226,0.000271,172.217.194.0-255,119,26954,63,213199
4227,0.000273,172.31.40.0-255,66,27020,63,213199
4228,0.000351,172.217.194.0-255,1484,28504,63,213199
4229,0.000354,172.31.40.0-255,66,28570,63,213199
4230,0.00036,172.217.194.0-255,2902,31472,63,213199
4231,0.000362,172.31.40.0-255,66,31538,63,213199
4232,0.000388,172.217.194.0-255,5738,37276,63,213199
4233,0.000391,172.31.40.0-255,66,37342,63,213199
4234,0.000398,172.217.194.0-255,5738,43080,63,213199
4235,0.0004,172.31.40.0-255,66,43146,63,213199
4236,0.000426,172.217.194.0-255,5738,48884,63,213199
4237,0.000428,172.31.40.0-255,66,48950,63,213199
4238,0.000468,172.31.40.0-255,66,49016,63,213199
4239,0.000471,172.217.194.0-255,1484,50500,63,213199
4240,0.000476,172.217.194.0-255,2277,52777,63,213199
4241,0.000479,172.31.40.0-255,66,52843,63,213199
4242,0.000567,172.217.194.0-255,1484,54327,63,213199
4243,0.000588,172.217.194.0-255,2902,57229,63,213199
4244,0.000591,172.31.40.0-255,66,57295,63,213199
4245,0.000598,172.217.194.0-255,5738,63033,63,213199
4246,0.000601,172.31.40.0-255,66,63099,63,213199
4247,0.000612,172.217.194.0-255,7156,70255,63,213199
4248,0.000614,172.31.40.0-255,66,70321,63,213199
4249,0.000646,172.217.194.0-255,5738,76059,63,213199
4250,0.000648,172.31.40.0-255,66,76125,63,213199
4251,0.000705,172.217.194.0-255,2184,78309,63,213199
4252,0.000762,172.217.194.0-255,1484,79793,63,213199
4253,0.000805,172.217.194.0-255,7156,86949,63,213199
4254,0.000835,172.217.194.0-255,766,87715,63,213199
4255,0.000882,172.217.194.0-255,1484,89199,63,213199
4256,0.000885,172.217.194.0-255,1484,90683,63,213199
4257,0.000899,172.217.194.0-255,1484,92167,63,213199
4258,0.000904,172.217.194.0-255,2902,95069,63,213199
4259,0.000918,172.217.194.0-255,2902,97971,63,213199
4260,0.000922,172.217.194.0-255,1484,99455,63,213199
4261,0.00096,172.217.194.0-255,2902,102357,63,213199
4262,0.000964,172.217.194.0-255,2902,105259,63,213199
4263,0.001,172.217.194.0-255,7156,112415,63,213199
4264,0.001011,172.217.194.0-255,766,113181,63,213199
4265,0.001057,172.217.194.0-255,1484,114665,63,213199
4266,0.001075,172.217.194.0-255,2902,117567,63,213199
4267,0.001082,172.217.194.0-255,5738,123305,63,213199
4268,0.001101,172.217.194.0-255,4320,127625,63,213199
4269,0.001135,172.217.194.0-255,7156,134781,63,213199
4270,0.001154,172.31.40.0-255,66,134847,63,213199
4271,0.001221,172.31.40.0-255,66,134913,63,213199
4272,0.001228,172.217.194.0-255,1484,136397,63,213199
4273,0.001254,172.217.194.0-255,2902,139299,63,213199
4274,0.001261,172.217.194.0-255,5738,145037,63,213199
4275,0.001284,172.31.40.0-255,66,145103,63,213199
4276,0.001291,172.217.194.0-255,5738,150841,63,213199
4277,0.001296,172.31.40.0-255,66,150907,63,213199
4278,0.00133,172.217.194.0-255,7156,158063,63,213199
4279,0.001353,172.31.40.0-255,66,158129,63,213199
4280,0.001365,172.217.194.0-255,4320,162449,63,213199
4281,0.001382,172.217.194.0-255,766,163215,63,213199
4282,0.001389,172.217.194.0-255,5738,168953,63,213199
4283,0.001402,172.31.40.0-255,66,169019,63,213199
4284,0.001416,172.217.194.0-255,7156,176175,63,213199
4285,0.001436,172.217.194.0-255,5738,181913,63,213199
4286,0.001449,172.31.40.0-255,66,181979,63,213199
4287,0.001461,172.217.194.0-255,2902,184881,63,213199
4288,0.001502,172.31.40.0-255,66,184947,63,213199
4289,0.00151,172.217.194.0-255,1484,186431,63,213199
4290,0.001514,172.217.194.0-255,2902,189333,63,213199
4291,0.001559,172.217.194.0-255,1484,190817,63,213199
4292,0.001567,172.31.40.0-255,66,190883,63,213199
4293,0.001576,172.217.194.0-255,4320,195203,63,213199
4294,0.001602,172.217.194.0-255,766,195969,63,213199
4295,0.001617,172.217.194.0-255,1484,197453,63,213199
4296,0.00162,172.217.194.0-255,1484,198937,63,213199
4297,0.001631,172.217.194.0-255,2902,201839,63,213199
4298,0.001645,172.31.40.0-255,66,201905,63,213199
4299,0.001683,172.217.194.0-255,1484,203389,63,213199
4300,0.001697,172.31.40.0-255,66,203455,63,213199
4301,0.00171,172.217.194.0-255,5738,209193,63,213199
4302,0.00172,172.31.40.0-255,66,209259,63,213199
4303,0.001729,172.217.194.0-255,3598,212857,63,213199
4304,0.001732,172.217.194.0-255,105,212962,63,213199
4305,0.001759,172.31.40.0-255,66,213028,63,213199
4306,0.00469,172.31.40.0-255,105,213133,63,213199
4307,0.00698,172.217.194.0-255,66,213199,63,213199
4308,0.0,172.217.160.0-255,153,153,63,218037
4309,2.4e-05,172.31.40.0-255,66,219,63,218037
4310,3.1e-05,172.217.160.0-255,1484,1703,63,218037
4311,3.6e-05,172.31.40.0-255,66,1769,63,218037
4312,4.2e-05,172.217.160.0-255,2902,4671,63,218037
4313,4.6e-05,172.31.40.0-255,66,4737,63,218037
4314,5.3e-05,172.217.160.0-255,7156,11893,63,218037
4315,5.7e-05,172.31.40.0-255,66,11959,63,218037
4316,7.5e-05,172.31.40.0-255,66,12025,63,218037
4317,7.9e-05,172.217.160.0-255,2543,14568,63,218037
4318,8.2e-05,172.31.40.0-255,66,14634,63,218037
4319,0.000127,172.217.160.0-255,1484,16118,63,218037
4320,0.00013,172.31.40.0-255,66,16184,63,218037
4321,0.000135,172.217.160.0-255,2902,19086,63,218037
4322,0.000137,172.31.40.0-255,66,19152,63,218037
4323,0.00014,172.217.160.0-255,1484,20636,63,218037
4324,0.000143,172.31.40.0-255,66,20702,63,218037
4325,0.000149,172.217.160.0-255,5738,26440,63,218037
4326,0.000152,172.31.40.0-255,66,26506,63,218037
4327,0.000185,172.217.160.0-255,5379,31885,63,218037
4328,0.000188,172.31.40.0-255,66,31951,63,218037
4329,0.000207,172.217.160.0-255,2902,34853,63,218037
4330,0.000209,172.31.40.0-255,66,34919,63,218037
4331,0.000225,172.217.160.0-255,2902,37821,63,218037
4332,0.000228,172.31.40.0-255,66,37887,63,218037
4333,0.00024,172.217.160.0-255,1484,39371,63,218037
4334,0.000242,172.31.40.0-255,66,39437,63,218037
4335,0.000275,172.31.40.0-255,66,39503,63,218037
4336,0.000277,172.217.160.0-255,337,39840,63,218037
4337,0.000279,172.31.40.0-255,66,39906,63,218037
4338,0.000806,172.217.160.0-255,123,40029,63,218037
4339,0.000864,172.31.40.0-255,66,40095,63,218037
4340,0.000877,172.217.160.0-255,1484,41579,63,218037
4341,0.000896,172.217.160.0-255,2902,44481,63,218037
4342,0.000899,172.31.40.0-255,66,44547,63,218037
4343,0.000905,172.217.160.0-255,5738,50285,63,218037
4344,0.000906,172.31.40.0-255,66,50351,63,218037
4345,0.000936,172.217.160.0-255,6797,57148,63,218037
4346,0.000939,172.31.40.0-255,66,57214,63,218037
4347,0.000944,172.217.160.0-255,5738,62952,63,218037
4348,0.000946,172.31.40.0-255,66,63018,63,218037
4349,0.000957,172.217.160.0-255,1484,64502,63,218037
4350,0.00097,172.217.160.0-255,4320,68822,63,218037
4351,0.000972,172.31.40.0-255,66,68888,63,218037
4352,0.000989,172.217.160.0-255,5695,74583,63,218037
4353,0.000991,172.31.40.0-255,66,74649,63,218037
4354,0.00114,172.217.160.0-255,1484,76133,63,218037
4355,0.001145,172.217.160.0-255,2902,79035,63,218037
4356,0.001148,172.31.40.0-255,66,79101,63,218037
4357,0.001153,172.217.160.0-255,4320,83421,63,218037
4358,0.001155,172.31.40.0-255,66,83487,63,218037
4359,0.001168,172.217.160.0-255,1484,84971,63,218037
4360,0.00117,172.217.160.0-255,1484,86455,63,218037
4361,0.001172,172.31.40.0-255,66,86521,63,218037
4362,0.0012,172.31.40.0-255,66,86587,63,218037
4363,0.001238,172.31.40.0-255,66,86653,63,218037
4364,0.001254,172.217.160.0-255,766,87419,63,218037
4365,0.001301,172.217.160.0-255,1484,88903,63,218037
4366,0.001304,172.31.40.0-255,66,88969,63,218037
4367,0.001309,172.217.160.0-255,2902,91871,63,218037
4368,0.00131,172.31.40.0-255,66,91937,63,218037
4369,0.001327,172.217.160.0-255,5738,97675,63,218037
4370,0.001329,172.31.40.0-255,66,97741,63,218037
4371,0.001334,172.217.160.0-255,4320,102061,63,218037
4372,0.001336,172.31.40.0-255,66,102127,63,218037
4373,0.001355,172.217.160.0-255,2902,105029,63,218037
4374,0.001357,172.31.40.0-255,66,105095,63,218037
4375,0.001369,172.31.40.0-255,66,105161,63,218037
4376,0.001393,172.217.160.0-255,2902,108063,63,218037
4377,0.001395,172.31.40.0-255,66,108129,63,218037
4378,0.001399,172.217.160.0-255,2184,110313,63,218037
4379,0.001401,172.31.40.0-255,66,110379,63,218037
4380,0.001404,172.217.160.0-255,2902,113281,63,218037
4381,0.001406,172.31.40.0-255,66,113347,63,218037
4382,0.001412,172.217.160.0-255,7156,120503,63,218037
4383,0.001414,172.31.40.0-255,66,120569,63,218037
4384,0.001418,172.217.160.0-255,2902,123471,63,218037
4385,0.00142,172.31.40.0-255,66,123537,63,218037
4386,0.001471,172.31.40.0-255,66,123603,63,218037
4387,0.001473,172.31.40.0-255,66,123669,63,218037
4388,0.001562,172.217.160.0-255,1484,125153,63,218037
4389,0.001567,172.217.160.0-255,2902,128055,63,218037
4390,0.00157,172.31.40.0-255,66,128121,63,218037
4391,0.001589,172.217.160.0-255,5738,133859,63,218037
4392,0.001592,172.31.40.0-255,66,133925,63,218037
4393,0.001621,172.217.160.0-255,4320,138245,63,218037
4394,0.001623,172.31.40.0-255,66,138311,63,218037
4395,0.001659,172.31.40.0-255,66,138377,63,218037
4396,0.00167,172.31.40.0-255,66,138443,63,218037
4397,0.00177,172.217.160.0-255,1484,139927,63,218037
4398,0.001774,172.217.160.0-255,2902,142829,63,218037
4399,0.001778,172.31.40.0-255,66,142895,63,218037
4400,0.0018,172.217.160.0-255,5738,148633,63,218037
4401,0.001803,172.31.40.0-255,66,148699,63,218037
4402,0.00182,172.31.40.0-255,66,148765,63,218037
4403,0.001848,172.217.160.0-255,1484,150249,63,218037
4404,0.001859,172.217.160.0-255,2184,152433,63,218037
4405,0.001863,172.31.40.0-255,66,152499,63,218037
4406,0.001867,172.31.40.0-255,66,152565,63,218037
4407,0.001931,172.217.160.0-255,1484,154049,63,218037
4408,0.001936,172.217.160.0-255,2902,156951,63,218037
4409,0.00194,172.31.40.0-255,66,157017,63,218037
4410,0.001961,172.217.160.0-255,2902,159919,63,218037
4411,0.001965,172.31.40.0-255,78,159997,63,218037
4412,0.001971,172.217.160.0-255,5738,165735,63,218037
4413,0.001974,172.31.40.0-255,66,165801,63,218037
4414,0.003904,172.217.160.0-255,5738,171539,63,218037
4415,0.003911,172.31.40.0-255,66,171605,63,218037
4416,0.005862,172.217.160.0-255,5738,177343,63,218037
4417,0.005876,172.31.40.0-255,66,177409,63,218037
4418,0.007822,172.217.160.0-255,5738,183147,63,218037
4419,0.007834,172.31.40.0-255,66,183213,63,218037
4420,0.009775,172.217.160.0-255,5738,188951,63,218037
4421,0.009783,172.31.40.0-255,66,189017,63,218037
4422,0.011711,172.217.160.0-255,5738,194755,63,218037
4423,0.011714,172.31.40.0-255,66,194821,63,218037
4424,0.013649,172.217.160.0-255,5738,200559,63,218037
4425,0.013655,172.31.40.0-255,66,200625,63,218037
4426,0.015603,172.217.160.0-255,5738,206363,63,218037
4427,0.015618,172.31.40.0-255,66,206429,63,218037
4428,0.017553,172.217.160.0-255,5738,212167,63,218037
4429,0.017561,172.31.40.0-255,66,212233,63,218037
4430,0.0195,172.217.160.0-255,5738,217971,63,218037
4431,0.019507,172.31.40.0-255,66,218037,63,218037
4432,0.0,74.125.24.0-255,296,296,63,193259
4433,2.3e-05,172.31.40.0-255,66,362,63,193259
4434,3e-05,74.125.24.0-255,1484,1846,63,193259
4435,3.3e-05,172.31.40.0-255,66,1912,63,193259
4436,4.2e-05,74.125.24.0-255,4320,6232,63,193259
4437,5.4e-05,172.31.40.0-255,66,6298,63,193259
4438,5.8e-05,74.125.24.0-255,2902,9200,63,193259
4439,6.1e-05,172.31.40.0-255,66,9266,63,193259
4440,7.4e-05,172.31.40.0-255,66,9332,63,193259
4441,9.4e-05,74.125.24.0-255,4320,13652,63,193259
4442,9.8e-05,172.31.40.0-255,66,13718,63,193259
4443,0.000132,172.31.40.0-255,66,13784,63,193259
4444,0.000148,74.125.24.0-255,1484,15268,63,193259
4445,0.000155,172.31.40.0-255,66,15334,63,193259
4446,0.00016,74.125.24.0-255,2902,18236,63,193259
4447,0.000162,172.31.40.0-255,66,18302,63,193259
4448,0.000168,74.125.24.0-255,5738,24040,63,193259
4449,0.000171,172.31.40.0-255,66,24106,63,193259
4450,0.000174,74.125.24.0-255,1484,25590,63,193259
4451,0.000176,172.31.40.0-255,66,25656,63,193259
4452,0.000208,74.125.24.0-255,5738,31394,63,193259
4453,0.000211,172.31.40.0-255,66,31460,63,193259
4454,0.000226,172.31.40.0-255,66,31526,63,193259
4455,0.000231,74.125.24.0-255,2184,33710,63,193259
4456,0.000234,172.31.40.0-255,66,33776,63,193259
4457,0.000265,74.125.24.0-255,361,34137,63,193259
4458,0.000268,172.31.40.0-255,66,34203,63,193259
4459,0.000306,74.125.24.0-255,131,34334,63,193259
4460,0.000308,172.31.40.0-255,66,34400,63,193259
4461,0.000484,74.125.24.0-255,1484,35884,63,193259
4462,0.000491,74.125.24.0-255,2902,38786,63,193259
4463,0.000495,172.31.40.0-255,66,38852,63,193259
4464,0.000503,74.125.24.0-255,5738,44590,63,193259
4465,0.000505,172.31.40.0-255,66,44656,63,193259
4466,0.000542,172.31.40.0-255,66,44722,63,193259
4467,0.000595,172.31.40.0-255,66,44788,63,193259
4468,0.000862,74.125.24.0-255,1484,46272,63,193259
4469,0.000869,74.125.24.0-255,2902,49174,63,193259
4470,0.000873,172.31.40.0-255,66,49240,63,193259
4471,0.000881,74.125.24.0-255,5738,54978,63,193259
4472,0.000883,172.31.40.0-255,66,55044,63,193259
4473,0.000923,172.31.40.0-255,66,55110,63,193259
4474,0.000934,172.31.40.0-255,66,55176,63,193259
4475,0.000961,74.125.24.0-255,2184,57360,63,193259
4476,0.000964,172.31.40.0-255,66,57426,63,193259
4477,0.001054,74.125.24.0-255,1484,58910,63,193259
4478,0.00106,74.125.24.0-255,2902,61812,63,193259
4479,0.001063,172.31.40.0-255,66,61878,63,193259
4480,0.001084,74.125.24.0-255,5738,67616,63,193259
4481,0.001087,172.31.40.0-255,66,67682,63,193259
4482,0.00109,74.125.24.0-255,1484,69166,63,193259
4483,0.001095,74.125.24.0-255,2902,72068,63,193259
4484,0.001097,172.31.40.0-255,66,72134,63,193259
4485,0.001136,74.125.24.0-255,5738,77872,63,193259
4486,0.001139,172.31.40.0-255,66,77938,63,193259
4487,0.001155,172.31.40.0-255,66,78004,63,193259
4488,0.001743,74.125.24.0-255,1484,79488,63,193259
4489,0.001758,74.125.24.0-255,1484,80972,63,193259
4490,0.001762,172.31.40.0-255,66,81038,63,193259
4491,0.001789,74.125.24.0-255,1484,82522,63,193259
4492,0.001797,74.125.24.0-255,5738,88260,63,193259
4493,0.0018,172.31.40.0-255,66,88326,63,193259
4494,0.001808,74.125.24.0-255,7156,95482,63,193259
4495,0.00181,172.31.40.0-255,66,95548,63,193259
4496,0.001824,172.31.40.0-255,66,95614,63,193259
4497,0.001835,74.125.24.0-255,1484,97098,63,193259
4498,0.001844,74.125.24.0-255,2184,99282,63,193259
4499,0.001846,172.31.40.0-255,66,99348,63,193259
4500,0.002099,74.125.24.0-255,1484,100832,63,193259
4501,0.002106,74.125.24.0-255,2902,103734,63,193259
4502,0.002109,172.31.40.0-255,66,103800,63,193259
4503,0.002116,74.125.24.0-255,5738,109538,63,193259
4504,0.002118,172.31.40.0-255,66,109604,63,193259
4505,0.002189,172.31.40.0-255,66,109670,63,193259
4506,0.002203,172.31.40.0-255,66,109736,63,193259
4507,0.002241,74.125.24.0-255,6438,116174,63,193259
4508,0.002244,172.31.40.0-255,66,116240,63,193259
4509,0.002255,172.31.40.0-255,66,116306,63,193259
4510,0.002275,172.31.40.0-255,66,116372,63,193259
4511,0.002309,74.125.24.0-255,5020,121392,63,193259
4512,0.002311,172.31.40.0-255,66,121458,63,193259
4513,0.00233,172.31.40.0-255,66,121524,63,193259
4514,0.002341,172.31.40.0-255,66,121590,63,193259
4515,0.002353,172.31.40.0-255,66,121656,63,193259
4516,0.002355,74.125.24.0-255,1484,123140,63,193259
4517,0.002386,172.31.40.0-255,66,123206,63,193259
4518,0.002405,74.125.24.0-255,1484,124690,63,193259
4519,0.002408,74.125.24.0-255,1484,126174,63,193259
4520,0.00241,172.31.40.0-255,66,126240,63,193259
4521,0.002426,172.31.40.0-255,66,126306,63,193259
4522,0.002432,74.125.24.0-255,4320,130626,63,193259
4523,0.002434,172.31.40.0-255,66,130692,63,193259
4524,0.002437,74.125.24.0-255,766,131458,63,193259
4525,0.002471,74.125.24.0-255,5738,137196,63,193259
4526,0.002474,172.31.40.0-255,66,137262,63,193259
4527,0.002477,74.125.24.0-255,1484,138746,63,193259
4528,0.002506,172.31.40.0-255,66,138812,63,193259
4529,0.002512,74.125.24.0-255,5738,144550,63,193259
4530,0.002515,172.31.40.0-255,66,144616,63,193259
4531,0.002525,74.125.24.0-255,5738,150354,63,193259
4532,0.002527,172.31.40.0-255,66,150420,63,193259
4533,0.002577,74.125.24.0-255,6438,156858,63,193259
4534,0.002581,172.31.40.0-255,66,156924,63,193259
4535,0.002587,74.125.24.0-255,4320,161244,63,193259
4536,0.002589,172.31.40.0-255,66,161310,63,193259
4537,0.002592,74.125.24.0-255,1484,162794,63,193259
4538,0.0026,74.125.24.0-255,7156,169950,63,193259
4539,0.002602,172.31.40.0-255,66,170016,63,193259
4540,0.002607,74.125.24.0-255,4320,174336,63,193259
4541,0.002609,172.31.40.0-255,66,174402,63,193259
4542,0.002611,74.125.24.0-255,1484,175886,63,193259
4543,0.002652,74.125.24.0-255,7156,183042,63,193259
4544,0.002655,172.31.40.0-255,66,183108,63,193259
4545,0.002695,74.125.24.0-255,4320,187428,63,193259
4546,0.002697,172.31.40.0-255,66,187494,63,193259
4547,0.002728,74.125.24.0-255,3602,191096,63,193259
4548,0.002731,172.31.40.0-255,66,191162,63,193259
4549,0.002737,74.125.24.0-255,1689,192851,63,193259
4550,0.002739,172.31.40.0-255,66,192917,63,193259
4551,0.002742,74.125.24.0-255,105,193022,63,193259
4552,0.014253,172.31.40.0-255,66,193088,63,193259
4553,0.014303,172.31.40.0-255,105,193193,63,193259
4554,0.01659,74.125.24.0-255,66,193259,63,193259
4555,0.0,172.217.194.0-255,206,206,63,170423
4556,8e-06,172.31.40.0-255,66,272,63,170423
4557,2.4e-05,172.217.194.0-255,1484,1756,63,170423
4558,2.8e-05,172.31.40.0-255,66,1822,63,170423
4559,3.5e-05,172.217.194.0-255,4320,6142,63,170423
4560,3.7e-05,172.31.40.0-255,66,6208,63,170423
4561,0.000102,172.31.40.0-255,66,6274,63,170423
4562,0.000122,172.217.194.0-255,4320,10594,63,170423
4563,0.000124,172.31.40.0-255,66,10660,63,170423
4564,0.000128,172.217.194.0-255,2902,13562,63,170423
4565,0.00013,172.31.40.0-255,66,13628,63,170423
4566,0.00015,172.217.194.0-255,2902,16530,63,170423
4567,0.000153,172.31.40.0-255,66,16596,63,170423
4568,0.000186,172.31.40.0-255,66,16662,63,170423
4569,0.000217,172.217.194.0-255,1125,17787,63,170423
4570,0.00022,172.31.40.0-255,66,17853,63,170423
4571,0.000232,172.31.40.0-255,66,17919,63,170423
4572,0.000237,172.217.194.0-255,4320,22239,63,170423
4573,0.000238,172.31.40.0-255,66,22305,63,170423
4574,0.000243,172.217.194.0-255,5738,28043,63,170423
4575,0.000246,172.31.40.0-255,66,28109,63,170423
4576,0.000286,172.217.194.0-255,4320,32429,63,170423
4577,0.000289,172.31.40.0-255,66,32495,63,170423
4578,0.000316,172.217.194.0-255,2854,35349,63,170423
4579,0.000318,172.31.40.0-255,66,35415,63,170423
4580,0.00032,172.217.194.0-255,100,35515,63,170423
4581,0.000322,172.31.40.0-255,66,35581,63,170423
4582,0.000351,172.217.194.0-255,1484,37065,63,170423
4583,0.000353,172.31.40.0-255,66,37131,63,170423
4584,0.000357,172.217.194.0-255,2902,40033,63,170423
4585,0.000359,172.31.40.0-255,66,40099,63,170423
4586,0.000366,172.217.194.0-255,7156,47255,63,170423
4587,0.000367,172.31.40.0-255,66,47321,63,170423
4588,0.000399,172.217.194.0-255,5676,52997,63,170423
4589,0.000401,172.31.40.0-255,66,53063,63,170423
4590,0.000449,172.217.194.0-255,5738,58801,63,170423
4591,0.000452,172.31.40.0-255,66,58867,63,170423
4592,0.000459,172.217.194.0-255,7156,66023,63,170423
4593,0.000461,172.31.40.0-255,66,66089,63,170423
4594,0.000487,172.217.194.0-255,3961,70050,63,170423
4595,0.000489,172.31.40.0-255,66,70116,63,170423
4596,0.000932,172.217.194.0-255,1484,71600,63,170423
4597,0.000953,172.217.194.0-255,2902,74502,63,170423
4598,0.000957,172.31.40.0-255,66,74568,63,170423
4599,0.000961,172.217.194.0-255,1484,76052,63,170423
4600,0.000991,172.217.194.0-255,4320,80372,63,170423
4601,0.000994,172.31.40.0-255,66,80438,63,170423
4602,0.001008,172.31.40.0-255,66,80504,63,170423
4603,0.001019,172.217.194.0-255,7156,87660,63,170423
4604,0.001022,172.31.40.0-255,66,87726,63,170423
4605,0.00105,172.217.194.0-255,3602,91328,63,170423
4606,0.001052,172.31.40.0-255,66,91394,63,170423
4607,0.001512,172.217.194.0-255,1484,92878,63,170423
4608,0.001528,172.217.194.0-255,2902,95780,63,170423
4609,0.001532,172.31.40.0-255,66,95846,63,170423
4610,0.001536,172.217.194.0-255,1484,97330,63,170423
4611,0.00156,172.217.194.0-255,4320,101650,63,170423
4612,0.001562,172.31.40.0-255,66,101716,63,170423
4613,0.001572,172.217.194.0-255,7156,108872,63,170423
4614,0.001574,172.31.40.0-255,66,108938,63,170423
4615,0.00158,172.217.194.0-255,4320,113258,63,170423
4616,0.001582,172.31.40.0-255,66,113324,63,170423
4617,0.001607,172.217.194.0-255,4320,117644,63,170423
4618,0.00164,172.217.194.0-255,4320,121964,63,170423
4619,0.001645,172.31.40.0-255,66,122030,63,170423
4620,0.00166,172.31.40.0-255,66,122096,63,170423
4621,0.001665,172.217.194.0-255,3602,125698,63,170423
4622,0.001667,172.31.40.0-255,66,125764,63,170423
4623,0.001811,172.217.194.0-255,1484,127248,63,170423
4624,0.001828,172.217.194.0-255,2902,130150,63,170423
4625,0.001831,172.31.40.0-255,66,130216,63,170423
4626,0.001836,172.217.194.0-255,2902,133118,63,170423
4627,0.001838,172.31.40.0-255,66,133184,63,170423
4628,0.00186,172.217.194.0-255,2902,136086,63,170423
4629,0.001862,172.31.40.0-255,66,136152,63,170423
4630,0.001873,172.31.40.0-255,66,136218,63,170423
4631,0.001899,172.217.194.0-255,4320,140538,63,170423
4632,0.001902,172.31.40.0-255,66,140604,63,170423
4633,0.001906,172.217.194.0-255,2902,143506,63,170423
4634,0.001908,172.31.40.0-255,66,143572,63,170423
4635,0.001954,172.31.40.0-255,66,143638,63,170423
4636,0.001964,172.31.40.0-255,66,143704,63,170423
4637,0.002023,172.31.40.0-255,66,143770,63,170423
4638,0.002027,172.217.194.0-255,2902,146672,63,170423
4639,0.00203,172.31.40.0-255,66,146738,63,170423
4640,0.002063,172.31.40.0-255,66,146804,63,170423
4641,0.002083,172.31.40.0-255,66,146870,63,170423
4642,0.002088,172.217.194.0-255,3602,150472,63,170423
4643,0.00209,172.31.40.0-255,66,150538,63,170423
4644,0.00214,172.217.194.0-255,5738,156276,63,170423
4645,0.002143,172.31.40.0-255,66,156342,63,170423
4646,0.002183,172.31.40.0-255,66,156408,63,170423
4647,0.002217,172.217.194.0-255,2184,158592,63,170423
4648,0.00225,172.217.194.0-255,1484,160076,63,170423
4649,0.002285,172.217.194.0-255,4320,164396,63,170423
4650,0.00242,172.217.194.0-255,5502,169898,63,170423
4651,0.002423,172.217.194.0-255,105,170003,63,170423
4652,0.011911,172.31.40.0-255,66,170069,63,170423
4653,0.012489,172.217.194.0-255,105,170174,63,170423
4654,0.0125,172.31.40.0-255,78,170252,63,170423
4655,0.014105,172.31.40.0-255,105,170357,63,170423
4656,0.016633,172.217.194.0-255,66,170423,63,170423
4657,0.0,172.217.194.0-255,153,153,63,141073
4658,1.8e-05,172.31.40.0-255,66,219,63,141073
4659,2.4e-05,172.217.194.0-255,1484,1703,63,141073
4660,2.8e-05,172.31.40.0-255,66,1769,63,141073
4661,3.2e-05,172.217.194.0-255,2902,4671,63,141073
4662,4.4e-05,172.31.40.0-255,66,4737,63,141073
4663,5.1e-05,172.217.194.0-255,7156,11893,63,141073
4664,5.3e-05,172.31.40.0-255,66,11959,63,141073
4665,9.9e-05,172.31.40.0-255,66,12025,63,141073
4666,0.000122,172.217.194.0-255,2902,14927,63,141073
4667,0.000124,172.31.40.0-255,66,14993,63,141073
4668,0.000142,172.217.194.0-255,3961,18954,63,141073
4669,0.000145,172.31.40.0-255,66,19020,63,141073
4670,0.000178,172.217.194.0-255,1484,20504,63,141073
4671,0.00018,172.31.40.0-255,66,20570,63,141073
4672,0.000185,172.217.194.0-255,2902,23472,63,141073
4673,0.000186,172.31.40.0-255,66,23538,63,141073
4674,0.000216,172.217.194.0-255,5738,29276,63,141073
4675,0.00022,172.31.40.0-255,66,29342,63,141073
4676,0.000229,172.217.194.0-255,4320,33662,63,141073
4677,0.000231,172.31.40.0-255,66,33728,63,141073
4678,0.000268,172.31.40.0-255,66,33794,63,141073
4679,0.000297,172.217.194.0-255,4320,38114,63,141073
4680,0.000299,172.31.40.0-255,66,38180,63,141073
4681,0.000324,172.31.40.0-255,66,38246,63,141073
4682,0.000347,172.217.194.0-255,1484,39730,63,141073
4683,0.00035,172.31.40.0-255,66,39796,63,141073
4684,0.000373,172.217.194.0-255,2902,42698,63,141073
4685,0.000376,172.31.40.0-255,66,42764,63,141073
4686,0.000382,172.217.194.0-255,5738,48502,63,141073
4687,0.000383,172.31.40.0-255,66,48568,63,141073
4688,0.000435,172.217.194.0-255,5738,54306,63,141073
4689,0.000438,172.31.40.0-255,66,54372,63,141073
4690,0.000459,172.217.194.0-255,576,54948,63,141073
4691,0.000752,172.217.194.0-255,1484,56432,63,141073
4692,0.000771,172.31.40.0-255,66,56498,63,141073
4693,0.000778,172.217.194.0-255,2902,59400,63,141073
4694,0.00078,172.31.40.0-255,66,59466,63,141073
4695,0.000787,172.217.194.0-255,5738,65204,63,141073
4696,0.000789,172.31.40.0-255,66,65270,63,141073
4697,0.000801,172.217.194.0-255,7156,72426,63,141073
4698,0.000804,172.31.40.0-255,66,72492,63,141073
4699,0.000859,172.31.40.0-255,66,72558,63,141073
4700,0.000863,172.217.194.0-255,2184,74742,63,141073
4701,0.000865,172.31.40.0-255,66,74808,63,141073
4702,0.000963,172.31.40.0-255,101,74909,63,141073
4703,0.001183,172.217.194.0-255,1484,76393,63,141073
4704,0.00119,172.217.194.0-255,2902,79295,63,141073
4705,0.001194,172.31.40.0-255,66,79361,63,141073
4706,0.001216,172.217.194.0-255,5738,85099,63,141073
4707,0.001219,172.31.40.0-255,66,85165,63,141073
4708,0.001262,172.31.40.0-255,66,85231,63,141073
4709,0.001281,172.31.40.0-255,66,85297,63,141073
4710,0.001284,172.217.194.0-255,2184,87481,63,141073
4711,0.001286,172.31.40.0-255,66,87547,63,141073
4712,0.001421,172.217.194.0-255,1484,89031,63,141073
4713,0.001426,172.217.194.0-255,1484,90515,63,141073
4714,0.001429,172.31.40.0-255,66,90581,63,141073
4715,0.00146,172.217.194.0-255,1484,92065,63,141073
4716,0.001467,172.217.194.0-255,5738,97803,63,141073
4717,0.001469,172.31.40.0-255,66,97869,63,141073
4718,0.001481,172.31.40.0-255,66,97935,63,141073
4719,0.001526,172.31.40.0-255,66,98001,63,141073
4720,0.001614,172.217.194.0-255,1484,99485,63,141073
4721,0.001619,172.217.194.0-255,2902,102387,63,141073
4722,0.001622,172.31.40.0-255,66,102453,63,141073
4723,0.00166,172.217.194.0-255,5738,108191,63,141073
4724,0.001663,172.31.40.0-255,66,108257,63,141073
4725,0.001674,172.31.40.0-255,66,108323,63,141073
4726,0.001768,172.31.40.0-255,66,108389,63,141073
4727,0.001843,172.217.194.0-255,1484,109873,63,141073
4728,0.001862,172.217.194.0-255,2902,112775,63,141073
4729,0.001865,172.31.40.0-255,66,112841,63,141073
4730,0.001872,172.217.194.0-255,5738,118579,63,141073
4731,0.001874,172.31.40.0-255,66,118645,63,141073
4732,0.001877,172.217.194.0-255,1484,120129,63,141073
4733,0.001912,172.31.40.0-255,66,120195,63,141073
4734,0.00193,172.31.40.0-255,66,120261,63,141073
4735,0.001965,172.217.194.0-255,1484,121745,63,141073
4736,0.001975,172.217.194.0-255,2902,124647,63,141073
4737,0.001978,172.31.40.0-255,66,124713,63,141073
4738,0.001985,172.217.194.0-255,5738,130451,63,141073
4739,0.001988,172.31.40.0-255,66,130517,63,141073
4740,0.002023,172.31.40.0-255,66,130583,63,141073
4741,0.002061,172.31.40.0-255,66,130649,63,141073
4742,0.002092,172.217.194.0-255,2184,132833,63,141073
4743,0.002094,172.31.40.0-255,66,132899,63,141073
4744,0.002107,172.31.40.0-255,66,132965,63,141073
4745,0.002156,172.31.40.0-255,66,133031,63,141073
4746,0.002197,172.31.40.0-255,66,133097,63,141073
4747,0.002216,172.31.40.0-255,66,133163,63,141073
4748,0.002231,172.31.40.0-255,66,133229,63,141073
4749,0.002248,172.31.40.0-255,66,133295,63,141073
4750,0.002265,172.31.40.0-255,66,133361,63,141073
4751,0.002305,172.31.40.0-255,66,133427,63,141073
4752,0.002323,172.217.194.0-255,4320,137747,63,141073
4753,0.002325,172.31.40.0-255,66,137813,63,141073
4754,0.002353,172.217.194.0-255,2852,140665,63,141073
4755,0.002356,172.31.40.0-255,66,140731,63,141073
4756,0.002359,172.217.194.0-255,105,140836,63,141073
4757,0.003415,172.217.194.0-255,66,140902,63,141073
4758,0.004633,172.31.40.0-255,105,141007,63,141073
4759,0.007087,172.217.194.0-255,66,141073,63,141073
4760,0.0,74.125.24.0-255,152,152,63,246036
4761,1.2e-05,172.31.40.0-255,66,218,63,246036
4762,3.8e-05,74.125.24.0-255,1484,1702,63,246036
4763,4.3e-05,172.31.40.0-255,66,1768,63,246036
4764,4.8e-05,74.125.24.0-255,2902,4670,63,246036
4765,5.1e-05,172.31.40.0-255,66,4736,63,246036
4766,5.5e-05,74.125.24.0-255,1484,6220,63,246036
4767,5.7e-05,172.31.40.0-255,66,6286,63,246036
4768,8.3e-05,74.125.24.0-255,5738,12024,63,246036
4769,8.6e-05,172.31.40.0-255,66,12090,63,246036
4770,8.9e-05,74.125.24.0-255,2129,14219,63,246036
4771,9.1e-05,172.31.40.0-255,66,14285,63,246036
4772,0.000137,74.125.24.0-255,1484,15769,63,246036
4773,0.00014,172.31.40.0-255,66,15835,63,246036
4774,0.000154,74.125.24.0-255,1484,17319,63,246036
4775,0.000156,172.31.40.0-255,66,17385,63,246036
4776,0.000171,74.125.24.0-255,1484,18869,63,246036
4777,0.000173,172.31.40.0-255,66,18935,63,246036
4778,0.000179,74.125.24.0-255,4320,23255,63,246036
4779,0.000181,172.31.40.0-255,66,23321,63,246036
4780,0.000229,172.31.40.0-255,66,23387,63,246036
4781,0.00032,74.125.24.0-255,1484,24871,63,246036
4782,0.000324,172.31.40.0-255,66,24937,63,246036
4783,0.00033,74.125.24.0-255,2902,27839,63,246036
4784,0.000332,172.31.40.0-255,66,27905,63,246036
4785,0.000347,74.125.24.0-255,4320,32225,63,246036
4786,0.00035,172.31.40.0-255,66,32291,63,246036
4787,0.000368,74.125.24.0-255,1484,33775,63,246036
4788,0.00037,172.31.40.0-255,66,33841,63,246036
4789,0.000379,74.125.24.0-255,7156,40997,63,246036
4790,0.000382,172.31.40.0-255,66,41063,63,246036
4791,0.000404,74.125.24.0-255,5379,46442,63,246036
4792,0.000407,172.31.40.0-255,66,46508,63,246036
4793,0.000427,74.125.24.0-255,4320,50828,63,246036
4794,0.00043,172.31.40.0-255,66,50894,63,246036
4795,0.000452,74.125.24.0-255,6797,57691,63,246036
4796,0.000454,172.31.40.0-255,66,57757,63,246036
4797,0.000486,74.125.24.0-255,410,58167,63,246036
4798,0.000552,74.125.24.0-255,333,58500,63,246036
4799,0.000963,74.125.24.0-255,1484,59984,63,246036
4800,0.000968,172.31.40.0-255,66,60050,63,246036
4801,0.000975,74.125.24.0-255,2902,62952,63,246036
4802,0.000977,172.31.40.0-255,66,63018,63,246036
4803,0.000982,74.125.24.0-255,4320,67338,63,246036
4804,0.000984,172.31.40.0-255,66,67404,63,246036
4805,0.001005,74.125.24.0-255,1484,68888,63,246036
4806,0.001019,172.31.40.0-255,66,68954,63,246036
4807,0.001028,74.125.24.0-255,7156,76110,63,246036
4808,0.00103,172.31.40.0-255,66,76176,63,246036
4809,0.00105,74.125.24.0-255,1484,77660,63,246036
4810,0.001071,74.125.24.0-255,1635,79295,63,246036
4811,0.001073,172.31.40.0-255,66,79361,63,246036
4812,0.001183,74.125.24.0-255,1484,80845,63,246036
4813,0.001199,74.125.24.0-255,2902,83747,63,246036
4814,0.001203,172.31.40.0-255,66,83813,63,246036
4815,0.001209,74.125.24.0-255,4320,88133,63,246036
4816,0.001211,172.31.40.0-255,66,88199,63,246036
4817,0.001224,74.125.24.0-255,1484,89683,63,246036
4818,0.00123,74.125.24.0-255,4320,94003,63,246036
4819,0.001232,172.31.40.0-255,66,94069,63,246036
4820,0.00124,74.125.24.0-255,7156,101225,63,246036
4821,0.001242,172.31.40.0-255,66,101291,63,246036
4822,0.001291,74.125.24.0-255,4320,105611,63,246036
4823,0.001295,172.31.40.0-255,66,105677,63,246036
4824,0.001305,172.31.40.0-255,66,105743,63,246036
4825,0.001626,74.125.24.0-255,1484,107227,63,246036
4826,0.001634,74.125.24.0-255,2902,110129,63,246036
4827,0.001638,172.31.40.0-255,66,110195,63,246036
4828,0.001668,74.125.24.0-255,2902,113097,63,246036
4829,0.00167,172.31.40.0-255,66,113163,63,246036
4830,0.001692,74.125.24.0-255,2902,116065,63,246036
4831,0.001695,172.31.40.0-255,66,116131,63,246036
4832,0.001708,172.31.40.0-255,66,116197,63,246036
4833,0.001722,172.31.40.0-255,66,116263,63,246036
4834,0.001854,74.125.24.0-255,1484,117747,63,246036
4835,0.001861,74.125.24.0-255,2902,120649,63,246036
4836,0.001865,172.31.40.0-255,66,120715,63,246036
4837,0.001871,74.125.24.0-255,2902,123617,63,246036
4838,0.001873,172.31.40.0-255,66,123683,63,246036
4839,0.001886,74.125.24.0-255,2902,126585,63,246036
4840,0.001889,172.31.40.0-255,66,126651,63,246036
4841,0.001918,172.31.40.0-255,66,126717,63,246036
4842,0.001937,74.125.24.0-255,4320,131037,63,246036
4843,0.001939,172.31.40.0-255,66,131103,63,246036
4844,0.001952,172.31.40.0-255,66,131169,63,246036
4845,0.002153,74.125.24.0-255,1484,132653,63,246036
4846,0.00216,74.125.24.0-255,1484,134137,63,246036
4847,0.002163,172.31.40.0-255,66,134203,63,246036
4848,0.002186,74.125.24.0-255,1484,135687,63,246036
4849,0.002192,74.125.24.0-255,4320,140007,63,246036
4850,0.002194,172.31.40.0-255,66,140073,63,246036
4851,0.0022,74.125.24.0-255,4320,144393,63,246036
4852,0.002202,172.31.40.0-255,66,144459,63,246036
4853,0.002219,74.125.24.0-255,4320,148779,63,246036
4854,0.002222,172.31.40.0-255,66,148845,63,246036
4855,0.002239,74.125.24.0-255,2902,151747,63,246036
4856,0.002242,172.31.40.0-255,66,151813,63,246036
4857,0.00227,74.125.24.0-255,5738,157551,63,246036
4858,0.002273,172.31.40.0-255,66,157617,63,246036
4859,0.002278,74.125.24.0-255,4320,161937,63,246036
4860,0.002281,172.31.40.0-255,66,162003,63,246036
4861,0.002295,74.125.24.0-255,3602,165605,63,246036
4862,0.002297,172.31.40.0-255,66,165671,63,246036
4863,0.002335,74.125.24.0-255,4320,169991,63,246036
4864,0.002339,172.31.40.0-255,66,170057,63,246036
4865,0.002346,74.125.24.0-255,5738,175795,63,246036
4866,0.002348,172.31.40.0-255,66,175861,63,246036
4867,0.00237,74.125.24.0-255,1484,177345,63,246036
4868,0.002404,172.31.40.0-255,66,177411,63,246036
4869,0.00241,74.125.24.0-255,4320,181731,63,246036
4870,0.002412,172.31.40.0-255,66,181797,63,246036
4871,0.002439,74.125.24.0-255,4320,186117,63,246036
4872,0.002441,172.31.40.0-255,66,186183,63,246036
4873,0.00246,74.125.24.0-255,3602,189785,63,246036
4874,0.002463,172.31.40.0-255,66,189851,63,246036
4875,0.003164,74.125.24.0-255,1484,191335,63,246036
4876,0.003183,74.125.24.0-255,1484,192819,63,246036
4877,0.003187,172.31.40.0-255,66,192885,63,246036
4878,0.003207,74.125.24.0-255,1484,194369,63,246036
4879,0.003214,74.125.24.0-255,5738,200107,63,246036
4880,0.003217,172.31.40.0-255,66,200173,63,246036
4881,0.003229,172.31.40.0-255,66,200239,63,246036
4882,0.003261,172.31.40.0-255,66,200305,63,246036
4883,0.003284,74.125.24.0-255,2184,202489,63,246036
4884,0.003286,172.31.40.0-255,66,202555,63,246036
4885,0.003398,74.125.24.0-255,1484,204039,63,246036
4886,0.00341,74.125.24.0-255,2902,206941,63,246036
4887,0.003412,172.31.40.0-255,66,207007,63,246036
4888,0.003418,74.125.24.0-255,4320,211327,63,246036
4889,0.003421,172.31.40.0-255,66,211393,63,246036
4890,0.003431,74.125.24.0-255,1484,212877,63,246036
4891,0.003443,74.125.24.0-255,1484,214361,63,246036
4892,0.003445,172.31.40.0-255,66,214427,63,246036
4893,0.00347,172.31.40.0-255,66,214493,63,246036
4894,0.003516,172.31.40.0-255,66,214559,63,246036
4895,0.003537,74.125.24.0-255,2902,217461,63,246036
4896,0.00354,172.31.40.0-255,66,217527,63,246036
4897,0.003543,74.125.24.0-255,2184,219711,63,246036
4898,0.003545,172.31.40.0-255,66,219777,63,246036
4899,0.003852,74.125.24.0-255,1484,221261,63,246036
4900,0.003865,74.125.24.0-255,1484,222745,63,246036
4901,0.003867,172.31.40.0-255,66,222811,63,246036
4902,0.003881,74.125.24.0-255,1484,224295,63,246036
4903,0.003895,74.125.24.0-255,2902,227197,63,246036
4904,0.003897,172.31.40.0-255,66,227263,63,246036
4905,0.003916,74.125.24.0-255,4320,231583,63,246036
4906,0.003918,172.31.40.0-255,66,231649,63,246036
4907,0.003921,74.125.24.0-255,1484,233133,63,246036
4908,0.003946,172.31.40.0-255,66,233199,63,246036
4909,0.003951,74.125.24.0-255,2902,236101,63,246036
4910,0.003953,172.31.40.0-255,66,236167,63,246036
4911,0.003976,172.31.40.0-255,66,236233,63,246036
4912,0.003979,74.125.24.0-255,1484,237717,63,246036
4913,0.00401,74.125.24.0-255,4320,242037,63,246036
4914,0.004012,172.31.40.0-255,66,242103,63,246036
4915,0.004037,172.31.40.0-255,66,242169,63,246036
4916,0.004041,74.125.24.0-255,2902,245071,63,246036
4917,0.004044,172.31.40.0-255,66,245137,63,246036
4918,0.004076,172.31.40.0-255,66,245203,63,246036
4919,0.004079,74.125.24.0-255,390,245593,63,246036
4920,0.004165,74.125.24.0-255,105,245698,63,246036
4921,0.008455,172.31.40.0-255,101,245799,63,246036
4922,0.010148,172.31.40.0-255,105,245904,63,246036
4923,0.011057,74.125.24.0-255,66,245970,63,246036
4924,0.01273,74.125.24.0-255,66,246036,63,246036
4925,0.0,172.217.194.0-255,152,152,63,183751
4926,1.6e-05,172.31.40.0-255,66,218,63,183751
4927,2.3e-05,172.217.194.0-255,1484,1702,63,183751
4928,2.8e-05,172.31.40.0-255,66,1768,63,183751
4929,3.4e-05,172.217.194.0-255,2902,4670,63,183751
4930,3.9e-05,172.31.40.0-255,66,4736,63,183751
4931,4.2e-05,172.217.194.0-255,1484,6220,63,183751
4932,4.4e-05,172.31.40.0-255,66,6286,63,183751
4933,5e-05,172.217.194.0-255,4320,10606,63,183751
4934,5.4e-05,172.31.40.0-255,66,10672,63,183751
4935,7.8e-05,172.217.194.0-255,1484,12156,63,183751
4936,8e-05,172.31.40.0-255,66,12222,63,183751
4937,8.6e-05,172.217.194.0-255,2031,14253,63,183751
4938,8.8e-05,172.31.40.0-255,66,14319,63,183751
4939,0.000206,172.217.194.0-255,1484,15803,63,183751
4940,0.00021,172.31.40.0-255,66,15869,63,183751
4941,0.000215,172.217.194.0-255,2902,18771,63,183751
4942,0.000218,172.31.40.0-255,66,18837,63,183751
4943,0.000221,172.217.194.0-255,1484,20321,63,183751
4944,0.000223,172.31.40.0-255,66,20387,63,183751
4945,0.000239,172.217.194.0-255,4320,24707,63,183751
4946,0.000242,172.31.40.0-255,66,24773,63,183751
4947,0.000277,172.217.194.0-255,4320,29093,63,183751
4948,0.000279,172.31.40.0-255,66,29159,63,183751
4949,0.000303,172.217.194.0-255,2543,31702,63,183751
4950,0.000306,172.31.40.0-255,66,31768,63,183751
4951,0.000456,172.217.194.0-255,1484,33252,63,183751
4952,0.00046,172.31.40.0-255,66,33318,63,183751
4953,0.000466,172.217.194.0-255,2902,36220,63,183751
4954,0.000469,172.31.40.0-255,66,36286,63,183751
4955,0.00051,172.217.194.0-255,5738,42024,63,183751
4956,0.000514,172.31.40.0-255,66,42090,63,183751
4957,0.000531,172.217.194.0-255,1484,43574,63,183751
4958,0.000557,172.217.194.0-255,5379,48953,63,183751
4959,0.00056,172.31.40.0-255,66,49019,63,183751
4960,0.000573,172.31.40.0-255,66,49085,63,183751
4961,0.000599,172.217.194.0-255,2902,51987,63,183751
4962,0.000602,172.31.40.0-255,66,52053,63,183751
4963,0.000606,172.217.194.0-255,2853,54906,63,183751
4964,0.000609,172.31.40.0-255,66,54972,63,183751
4965,0.000668,172.217.194.0-255,367,55339,63,183751
4966,0.000728,172.217.194.0-255,1484,56823,63,183751
4967,0.000732,172.31.40.0-255,66,56889,63,183751
4968,0.000737,172.217.194.0-255,2902,59791,63,183751
4969,0.00074,172.31.40.0-255,66,59857,63,183751
4970,0.000762,172.217.194.0-255,5738,65595,63,183751
4971,0.000765,172.31.40.0-255,66,65661,63,183751
4972,0.000772,172.217.194.0-255,6797,72458,63,183751
4973,0.000775,172.31.40.0-255,66,72524,63,183751
4974,0.000792,172.217.194.0-255,2902,75426,63,183751
4975,0.000795,172.31.40.0-255,66,75492,63,183751
4976,0.000836,172.31.40.0-255,66,75558,63,183751
4977,0.00084,172.217.194.0-255,2543,78101,63,183751
4978,0.000843,172.31.40.0-255,66,78167,63,183751
4979,0.000941,172.217.194.0-255,1484,79651,63,183751
4980,0.000963,172.217.194.0-255,2902,82553,63,183751
4981,0.000966,172.31.40.0-255,66,82619,63,183751
4982,0.000974,172.217.194.0-255,5738,88357,63,183751
4983,0.000976,172.31.40.0-255,66,88423,63,183751
4984,0.00098,172.217.194.0-255,2902,91325,63,183751
4985,0.000982,172.31.40.0-255,66,91391,63,183751
4986,0.001022,172.31.40.0-255,66,91457,63,183751
4987,0.001036,172.31.40.0-255,66,91523,63,183751
4988,0.001261,172.217.194.0-255,1484,93007,63,183751
4989,0.001288,172.217.194.0-255,2902,95909,63,183751
4990,0.001291,172.31.40.0-255,66,95975,63,183751
4991,0.001298,172.217.194.0-255,5738,101713,63,183751
4992,0.0013,172.31.40.0-255,66,101779,63,183751
4993,0.001305,172.217.194.0-255,2902,104681,63,183751
4994,0.001308,172.31.40.0-255,66,104747,63,183751
4995,0.001335,172.31.40.0-255,66,104813,63,183751
4996,0.001348,172.31.40.0-255,66,104879,63,183751
4997,0.001799,172.217.194.0-255,1484,106363,63,183751
4998,0.001806,172.217.194.0-255,2902,109265,63,183751
4999,0.001809,172.31.40.0-255,66,109331,63,183751
5000,0.001814,172.217.194.0-255,2902,112233,63,183751
5001,0.001816,172.31.40.0-255,66,112299,63,183751
5002,0.001832,172.217.194.0-255,2902,115201,63,183751
5003,0.001834,172.31.40.0-255,66,115267,63,183751
5004,0.001866,172.217.194.0-255,2902,118169,63,183751
5005,0.001869,172.31.40.0-255,66,118235,63,183751
5006,0.001884,172.217.194.0-255,4320,122555,63,183751
5007,0.001887,172.31.40.0-255,66,122621,63,183751
5008,0.00189,172.217.194.0-255,1484,124105,63,183751
5009,0.001929,172.31.40.0-255,66,124171,63,183751
5010,0.001933,172.217.194.0-255,2184,126355,63,183751
5011,0.001935,172.31.40.0-255,66,126421,63,183751
5012,0.001987,172.217.194.0-255,1484,127905,63,183751
5013,0.001992,172.217.194.0-255,2902,130807,63,183751
5014,0.001996,172.31.40.0-255,66,130873,63,183751
5015,0.002035,172.217.194.0-255,5738,136611,63,183751
5016,0.002065,172.217.194.0-255,7156,143767,63,183751
5017,0.002101,172.31.40.0-255,66,143833,63,183751
5018,0.002114,172.217.194.0-255,3602,147435,63,183751
5019,0.002182,172.217.194.0-255,1484,148919,63,183751
5020,0.002187,172.217.194.0-255,2902,151821,63,183751
5021,0.002209,172.217.194.0-255,5738,157559,63,183751
5022,0.00222,172.217.194.0-255,1484,159043,63,183751
5023,0.002272,172.217.194.0-255,2184,161227,63,183751
5024,0.002282,172.217.194.0-255,1484,162711,63,183751
5025,0.002313,172.217.194.0-255,2902,165613,63,183751
5026,0.01114,172.217.194.0-255,1484,167097,63,183751
5027,0.012428,172.31.40.0-255,66,167163,63,183751
5028,0.012437,172.31.40.0-255,66,167229,63,183751
5029,0.012441,172.31.40.0-255,66,167295,63,183751
5030,0.012459,172.31.40.0-255,66,167361,63,183751
5031,0.012463,172.31.40.0-255,66,167427,63,183751
5032,0.012468,172.31.40.0-255,66,167493,63,183751
5033,0.012471,172.31.40.0-255,66,167559,63,183751
5034,0.012474,172.31.40.0-255,66,167625,63,183751
5035,0.012478,172.31.40.0-255,66,167691,63,183751
5036,0.012481,172.31.40.0-255,66,167757,63,183751
5037,0.014769,172.217.194.0-255,4320,172077,63,183751
5038,0.014781,172.31.40.0-255,66,172143,63,183751
5039,0.017044,172.217.194.0-255,5738,177881,63,183751
5040,0.017058,172.31.40.0-255,66,177947,63,183751
5041,0.019362,172.217.194.0-255,5738,183685,63,183751
5042,0.019371,172.31.40.0-255,66,183751,63,183751
5043,0.0,74.125.24.0-255,153,153,63,193795
5044,2.1e-05,172.31.40.0-255,66,219,63,193795
5045,2.8e-05,74.125.24.0-255,1484,1703,63,193795
5046,3.3e-05,172.31.40.0-255,66,1769,63,193795
5047,3.9e-05,74.125.24.0-255,2902,4671,63,193795
5048,4.2e-05,172.31.40.0-255,66,4737,63,193795
5049,5e-05,74.125.24.0-255,7156,11893,63,193795
5050,5.3e-05,172.31.40.0-255,66,11959,63,193795
5051,7.8e-05,74.125.24.0-255,2155,14114,63,193795
5052,8.1e-05,172.31.40.0-255,66,14180,63,193795
5053,0.000108,74.125.24.0-255,2902,17082,63,193795
5054,0.000111,172.31.40.0-255,66,17148,63,193795
5055,0.000133,74.125.24.0-255,7156,24304,63,193795
5056,0.000136,172.31.40.0-255,66,24370,63,193795
5057,0.000177,74.125.24.0-255,7156,31526,63,193795
5058,0.00018,172.31.40.0-255,66,31592,63,193795
5059,0.000202,74.125.24.0-255,5379,36971,63,193795
5060,0.000205,172.31.40.0-255,66,37037,63,193795
5061,0.000211,74.125.24.0-255,7156,44193,63,193795
5062,0.000214,172.31.40.0-255,66,44259,63,193795
5063,0.000242,74.125.24.0-255,3961,48220,63,193795
5064,0.000245,172.31.40.0-255,66,48286,63,193795
5065,0.00025,74.125.24.0-255,2902,51188,63,193795
5066,0.000252,172.31.40.0-255,66,51254,63,193795
5067,0.000264,74.125.24.0-255,1484,52738,63,193795
5068,0.000266,172.31.40.0-255,66,52804,63,193795
5069,0.000278,74.125.24.0-255,2902,55706,63,193795
5070,0.000281,172.31.40.0-255,66,55772,63,193795
5071,0.000295,74.125.24.0-255,5738,61510,63,193795
5072,0.000298,172.31.40.0-255,66,61576,63,193795
5073,0.000309,74.125.24.0-255,1484,63060,63,193795
5074,0.000311,172.31.40.0-255,66,63126,63,193795
5075,0.000316,74.125.24.0-255,2543,65669,63,193795
5076,0.000318,172.31.40.0-255,66,65735,63,193795
5077,0.000336,74.125.24.0-255,645,66380,63,193795
5078,0.000434,74.125.24.0-255,1484,67864,63,193795
5079,0.000438,172.31.40.0-255,66,67930,63,193795
5080,0.000442,74.125.24.0-255,1484,69414,63,193795
5081,0.000458,74.125.24.0-255,1484,70898,63,193795
5082,0.00046,172.31.40.0-255,66,70964,63,193795
5083,0.000467,74.125.24.0-255,5738,76702,63,193795
5084,0.00047,172.31.40.0-255,66,76768,63,193795
5085,0.000491,74.125.24.0-255,6797,83565,63,193795
5086,0.000494,172.31.40.0-255,66,83631,63,193795
5087,0.00052,74.125.24.0-255,4320,87951,63,193795
5088,0.000523,172.31.40.0-255,66,88017,63,193795
5089,0.000542,74.125.24.0-255,2902,90919,63,193795
5090,0.000544,172.31.40.0-255,66,90985,63,193795
5091,0.000547,74.125.24.0-255,1484,92469,63,193795
5092,0.000571,172.31.40.0-255,66,92535,63,193795
5093,0.000905,74.125.24.0-255,1484,94019,63,193795
5094,0.00091,74.125.24.0-255,1484,95503,63,193795
5095,0.000913,172.31.40.0-255,66,95569,63,193795
5096,0.000933,74.125.24.0-255,1484,97053,63,193795
5097,0.000941,74.125.24.0-255,5738,102791,63,193795
5098,0.000943,172.31.40.0-255,66,102857,63,193795
5099,0.001005,172.31.40.0-255,66,102923,63,193795
5100,0.001018,74.125.24.0-255,1484,104407,63,193795
5101,0.001032,172.31.40.0-255,66,104473,63,193795
5102,0.001045,172.31.40.0-255,66,104539,63,193795
5103,0.001056,172.31.40.0-255,66,104605,63,193795
5104,0.0011,172.31.40.0-255,66,104671,63,193795
5105,0.001111,172.31.40.0-255,66,104737,63,193795
5106,0.001137,172.31.40.0-255,66,104803,63,193795
5107,0.00115,172.31.40.0-255,66,104869,63,193795
5108,0.001496,74.125.24.0-255,1484,106353,63,193795
5109,0.0015,74.125.24.0-255,1484,107837,63,193795
5110,0.001504,172.31.40.0-255,66,107903,63,193795
5111,0.001523,74.125.24.0-255,1484,109387,63,193795
5112,0.001528,74.125.24.0-255,2902,112289,63,193795
5113,0.00153,172.31.40.0-255,66,112355,63,193795
5114,0.001545,74.125.24.0-255,1484,113839,63,193795
5115,0.001553,74.125.24.0-255,5738,119577,63,193795
5116,0.001555,172.31.40.0-255,66,119643,63,193795
5117,0.001588,74.125.24.0-255,1484,121127,63,193795
5118,0.001613,74.125.24.0-255,7156,128283,63,193795
5119,0.001616,172.31.40.0-255,66,128349,63,193795
5120,0.00163,74.125.24.0-255,2902,131251,63,193795
5121,0.001633,74.125.24.0-255,1484,132735,63,193795
5122,0.001636,172.31.40.0-255,66,132801,63,193795
5123,0.001667,74.125.24.0-255,6438,139239,63,193795
5124,0.00167,172.31.40.0-255,66,139305,63,193795
5125,0.001939,74.125.24.0-255,1484,140789,63,193795
5126,0.001943,74.125.24.0-255,2902,143691,63,193795
5127,0.001949,172.31.40.0-255,66,143757,63,193795
5128,0.001968,74.125.24.0-255,4320,148077,63,193795
5129,0.00197,172.31.40.0-255,66,148143,63,193795
5130,0.001978,74.125.24.0-255,7156,155299,63,193795
5131,0.00198,172.31.40.0-255,66,155365,63,193795
5132,0.002002,74.125.24.0-255,1484,156849,63,193795
5133,0.002005,74.125.24.0-255,1484,158333,63,193795
5134,0.002008,172.31.40.0-255,66,158399,63,193795
5135,0.00205,172.31.40.0-255,66,158465,63,193795
5136,0.002067,172.31.40.0-255,66,158531,63,193795
5137,0.002078,172.31.40.0-255,66,158597,63,193795
5138,0.002102,74.125.24.0-255,6438,165035,63,193795
5139,0.002105,172.31.40.0-255,66,165101,63,193795
5140,0.002185,172.31.40.0-255,66,165167,63,193795
5141,0.00219,74.125.24.0-255,4320,169487,63,193795
5142,0.002193,172.31.40.0-255,66,169553,63,193795
5143,0.002223,172.31.40.0-255,66,169619,63,193795
5144,0.002252,172.31.40.0-255,66,169685,63,193795
5145,0.002265,74.125.24.0-255,3602,173287,63,193795
5146,0.002267,172.31.40.0-255,66,173353,63,193795
5147,0.002272,74.125.24.0-255,2902,176255,63,193795
5148,0.002274,172.31.40.0-255,66,176321,63,193795
5149,0.002319,172.31.40.0-255,66,176387,63,193795
5150,0.002343,172.31.40.0-255,66,176453,63,193795
5151,0.002372,74.125.24.0-255,5738,182191,63,193795
5152,0.002375,172.31.40.0-255,66,182257,63,193795
5153,0.002395,74.125.24.0-255,5738,187995,63,193795
5154,0.002398,172.31.40.0-255,66,188061,63,193795
5155,0.002423,74.125.24.0-255,5326,193387,63,193795
5156,0.002427,172.31.40.0-255,66,193453,63,193795
5157,0.00243,74.125.24.0-255,105,193558,63,193795
5158,0.004338,172.31.40.0-255,66,193624,63,193795
5159,0.00438,172.31.40.0-255,105,193729,63,193795
5160,0.006803,74.125.24.0-255,66,193795,63,193795
5161,0.0,172.31.40.0-255,105,105,63,276
5162,0.001806,157.240.7.0-255,105,210,63,276
5163,0.001821,172.31.40.0-255,66,276,63,276
5164,0.0,172.217.194.0-255,153,153,63,116316
5165,2.4e-05,172.31.40.0-255,66,219,63,116316
5166,3.1e-05,172.217.194.0-255,1484,1703,63,116316
5167,3.6e-05,172.31.40.0-255,66,1769,63,116316
5168,4.2e-05,172.217.194.0-255,2902,4671,63,116316
5169,4.5e-05,172.31.40.0-255,66,4737,63,116316
5170,5.2e-05,172.217.194.0-255,4320,9057,63,116316
5171,5.5e-05,172.31.40.0-255,66,9123,63,116316
5172,9.4e-05,172.31.40.0-255,66,9189,63,116316
5173,0.000147,172.217.194.0-255,4320,13509,63,116316
5174,0.000149,172.31.40.0-255,66,13575,63,116316
5175,0.000168,172.217.194.0-255,4320,17895,63,116316
5176,0.00017,172.31.40.0-255,66,17961,63,116316
5177,0.000243,172.217.194.0-255,5379,23340,63,116316
5178,0.000246,172.31.40.0-255,66,23406,63,116316
5179,0.000307,172.31.40.0-255,66,23472,63,116316
5180,0.000326,172.217.194.0-255,7156,30628,63,116316
5181,0.000328,172.31.40.0-255,66,30694,63,116316
5182,0.00045,172.217.194.0-255,1125,31819,63,116316
5183,0.000454,172.31.40.0-255,66,31885,63,116316
5184,0.000495,172.31.40.0-255,66,31951,63,116316
5185,0.000737,172.217.194.0-255,648,32599,63,116316
5186,0.000741,172.31.40.0-255,66,32665,63,116316
5187,0.000842,172.217.194.0-255,1484,34149,63,116316
5188,0.000846,172.31.40.0-255,66,34215,63,116316
5189,0.000852,172.217.194.0-255,2902,37117,63,116316
5190,0.000855,172.31.40.0-255,66,37183,63,116316
5191,0.000883,172.217.194.0-255,5738,42921,63,116316
5192,0.000886,172.31.40.0-255,66,42987,63,116316
5193,0.000927,172.217.194.0-255,4320,47307,63,116316
5194,0.00093,172.31.40.0-255,66,47373,63,116316
5195,0.00096,172.31.40.0-255,66,47439,63,116316
5196,0.001063,172.217.194.0-255,7156,54595,63,116316
5197,0.001067,172.31.40.0-255,66,54661,63,116316
5198,0.001084,172.217.194.0-255,3602,58263,63,116316
5199,0.001087,172.31.40.0-255,66,58329,63,116316
5200,0.001177,172.217.194.0-255,5738,64067,63,116316
5201,0.001181,172.31.40.0-255,66,64133,63,116316
5202,0.001202,172.217.194.0-255,5738,69871,63,116316
5203,0.001204,172.31.40.0-255,66,69937,63,116316
5204,0.001297,172.31.40.0-255,66,70003,63,116316
5205,0.001332,172.31.40.0-255,66,70069,63,116316
5206,0.00232,172.217.194.0-255,1484,71553,63,116316
5207,0.002332,172.217.194.0-255,2902,74455,63,116316
5208,0.002337,172.31.40.0-255,66,74521,63,116316
5209,0.002343,172.217.194.0-255,1484,76005,63,116316
5210,0.002364,172.217.194.0-255,4320,80325,63,116316
5211,0.002366,172.31.40.0-255,66,80391,63,116316
5212,0.002394,172.217.194.0-255,1484,81875,63,116316
5213,0.002416,172.217.194.0-255,1484,83359,63,116316
5214,0.002419,172.31.40.0-255,66,83425,63,116316
5215,0.00243,172.31.40.0-255,66,83491,63,116316
5216,0.002445,172.217.194.0-255,2902,86393,63,116316
5217,0.002447,172.31.40.0-255,66,86459,63,116316
5218,0.002555,172.217.194.0-255,7156,93615,63,116316
5219,0.002559,172.31.40.0-255,66,93681,63,116316
5220,0.00262,172.217.194.0-255,1484,95165,63,116316
5221,0.002624,172.217.194.0-255,766,95931,63,116316
5222,0.002626,172.31.40.0-255,66,95997,63,116316
5223,0.002688,172.31.40.0-255,66,96063,63,116316
5224,0.002783,172.217.194.0-255,5738,101801,63,116316
5225,0.002786,172.31.40.0-255,66,101867,63,116316
5226,0.002816,172.31.40.0-255,66,101933,63,116316
5227,0.003003,172.31.40.0-255,66,101999,63,116316
5228,0.003047,172.31.40.0-255,66,102065,63,116316
5229,0.003285,172.217.194.0-255,1484,103549,63,116316
5230,0.003309,172.217.194.0-255,3602,107151,63,116316
5231,0.003338,172.217.194.0-255,2902,110053,63,116316
5232,0.003792,172.217.194.0-255,5738,115791,63,116316
5233,0.005041,172.217.194.0-255,105,115896,63,116316
5234,0.011485,172.31.40.0-255,66,115962,63,116316
5235,0.012185,172.217.194.0-255,105,116067,63,116316
5236,0.012199,172.31.40.0-255,78,116145,63,116316
5237,0.013714,172.31.40.0-255,105,116250,63,116316
5238,0.015885,172.217.194.0-255,66,116316,63,116316
5239,0.0,172.217.194.0-255,152,152,63,195901
5240,2.4e-05,172.31.40.0-255,66,218,63,195901
5241,3.1e-05,172.217.194.0-255,1484,1702,63,195901
5242,3.6e-05,172.31.40.0-255,66,1768,63,195901
5243,4.2e-05,172.217.194.0-255,2902,4670,63,195901
5244,5.4e-05,172.31.40.0-255,66,4736,63,195901
5245,6.2e-05,172.217.194.0-255,7156,11892,63,195901
5246,6.5e-05,172.31.40.0-255,66,11958,63,195901
5247,6.9e-05,172.217.194.0-255,1968,13926,63,195901
5248,7.2e-05,172.31.40.0-255,66,13992,63,195901
5249,9.3e-05,172.217.194.0-255,1484,15476,63,195901
5250,9.5e-05,172.31.40.0-255,66,15542,63,195901
5251,0.000101,172.217.194.0-255,2902,18444,63,195901
5252,0.000103,172.31.40.0-255,66,18510,63,195901
5253,0.000114,172.217.194.0-255,2902,21412,63,195901
5254,0.000117,172.31.40.0-255,66,21478,63,195901
5255,0.000135,172.217.194.0-255,2902,24380,63,195901
5256,0.000142,172.31.40.0-255,66,24446,63,195901
5257,0.000149,172.217.194.0-255,6797,31243,63,195901
5258,0.000152,172.31.40.0-255,66,31309,63,195901
5259,0.000207,172.217.194.0-255,1484,32793,63,195901
5260,0.000209,172.31.40.0-255,66,32859,63,195901
5261,0.000235,172.217.194.0-255,2902,35761,63,195901
5262,0.000238,172.31.40.0-255,66,35827,63,195901
5263,0.000245,172.217.194.0-255,5738,41565,63,195901
5264,0.000247,172.31.40.0-255,66,41631,63,195901
5265,0.000258,172.217.194.0-255,5738,47369,63,195901
5266,0.00026,172.31.40.0-255,66,47435,63,195901
5267,0.000327,172.31.40.0-255,66,47501,63,195901
5268,0.000333,172.217.194.0-255,3961,51462,63,195901
5269,0.000335,172.31.40.0-255,66,51528,63,195901
5270,0.000337,172.217.194.0-255,395,51923,63,195901
5271,0.000376,172.217.194.0-255,382,52305,63,195901
5272,0.000607,172.217.194.0-255,1484,53789,63,195901
5273,0.000614,172.217.194.0-255,2902,56691,63,195901
5274,0.000621,172.217.194.0-255,5738,62429,63,195901
5275,0.000678,172.217.194.0-255,4320,66749,63,195901
5276,0.000681,172.217.194.0-255,1484,68233,63,195901
5277,0.000686,172.31.40.0-255,66,68299,63,195901
5278,0.000746,172.31.40.0-255,66,68365,63,195901
5279,0.000824,172.217.194.0-255,1484,69849,63,195901
5280,0.00083,172.217.194.0-255,2902,72751,63,195901
5281,0.000847,172.217.194.0-255,5738,78489,63,195901
5282,0.000863,172.31.40.0-255,66,78555,63,195901
5283,0.000875,172.217.194.0-255,7156,85711,63,195901
5284,0.000881,172.31.40.0-255,66,85777,63,195901
5285,0.000919,172.217.194.0-255,5738,91515,63,195901
5286,0.000956,172.217.194.0-255,4320,95835,63,195901
5287,0.000974,172.217.194.0-255,7156,102991,63,195901
5288,0.000996,172.31.40.0-255,66,103057,63,195901
5289,0.001,172.217.194.0-255,1484,104541,63,195901
5290,0.001044,172.31.40.0-255,66,104607,63,195901
5291,0.001084,172.217.194.0-255,7156,111763,63,195901
5292,0.001091,172.31.40.0-255,66,111829,63,195901
5293,0.001166,172.31.40.0-255,66,111895,63,195901
5294,0.001226,172.217.194.0-255,1484,113379,63,195901
5295,0.001232,172.217.194.0-255,2902,116281,63,195901
5296,0.001236,172.217.194.0-255,1484,117765,63,195901
5297,0.001241,172.31.40.0-255,66,117831,63,195901
5298,0.001266,172.217.194.0-255,4320,122151,63,195901
5299,0.001294,172.31.40.0-255,66,122217,63,195901
5300,0.001385,172.31.40.0-255,66,122283,63,195901
5301,0.001767,172.217.194.0-255,1484,123767,63,195901
5302,0.001771,172.217.194.0-255,1484,125251,63,195901
5303,0.00178,172.31.40.0-255,66,125317,63,195901
5304,0.001784,172.217.194.0-255,1484,126801,63,195901
5305,0.001792,172.217.194.0-255,5738,132539,63,195901
5306,0.001805,172.217.194.0-255,1484,134023,63,195901
5307,0.001808,172.31.40.0-255,66,134089,63,195901
5308,0.001868,172.31.40.0-255,66,134155,63,195901
5309,0.001878,172.217.194.0-255,2184,136339,63,195901
5310,0.00191,172.31.40.0-255,66,136405,63,195901
5311,0.001956,172.217.194.0-255,1484,137889,63,195901
5312,0.001978,172.217.194.0-255,2902,140791,63,195901
5313,0.001984,172.217.194.0-255,5738,146529,63,195901
5314,0.001997,172.217.194.0-255,4320,150849,63,195901
5315,0.002011,172.31.40.0-255,66,150915,63,195901
5316,0.002034,172.217.194.0-255,2902,153817,63,195901
5317,0.002045,172.217.194.0-255,4320,158137,63,195901
5318,0.00206,172.217.194.0-255,3602,161739,63,195901
5319,0.002077,172.31.40.0-255,66,161805,63,195901
5320,0.002114,172.217.194.0-255,1484,163289,63,195901
5321,0.002118,172.217.194.0-255,1484,164773,63,195901
5322,0.002127,172.31.40.0-255,66,164839,63,195901
5323,0.00213,172.217.194.0-255,1484,166323,63,195901
5324,0.002151,172.217.194.0-255,1484,167807,63,195901
5325,0.002178,172.31.40.0-255,66,167873,63,195901
5326,0.002229,172.31.40.0-255,66,167939,63,195901
5327,0.002236,172.217.194.0-255,1484,169423,63,195901
5328,0.002239,172.217.194.0-255,2902,172325,63,195901
5329,0.002251,172.31.40.0-255,66,172391,63,195901
5330,0.00226,172.217.194.0-255,2902,175293,63,195901
5331,0.002281,172.217.194.0-255,2902,178195,63,195901
5332,0.002307,172.217.194.0-255,7156,185351,63,195901
5333,0.002316,172.31.40.0-255,66,185417,63,195901
5334,0.002332,172.217.194.0-255,2902,188319,63,195901
5335,0.002346,172.31.40.0-255,66,188385,63,195901
5336,0.002372,172.217.194.0-255,2184,190569,63,195901
5337,0.002385,172.31.40.0-255,66,190635,63,195901
5338,0.002435,172.31.40.0-255,66,190701,63,195901
5339,0.002447,172.217.194.0-255,1484,192185,63,195901
5340,0.002467,172.217.194.0-255,3440,195625,63,195901
5341,0.00247,172.217.194.0-255,105,195730,63,195901
5342,0.002489,172.31.40.0-255,66,195796,63,195901
5343,0.018487,172.31.40.0-255,105,195901,63,195901
5344,0.0,74.125.24.0-255,152,152,63,264273
5345,1.5e-05,172.31.40.0-255,66,218,63,264273
5346,2.1e-05,74.125.24.0-255,1484,1702,63,264273
5347,2.5e-05,172.31.40.0-255,66,1768,63,264273
5348,3.1e-05,74.125.24.0-255,2902,4670,63,264273
5349,4.1e-05,172.31.40.0-255,66,4736,63,264273
5350,4.4e-05,74.125.24.0-255,1484,6220,63,264273
5351,4.6e-05,172.31.40.0-255,66,6286,63,264273
5352,5.1e-05,74.125.24.0-255,2902,9188,63,264273
5353,5.3e-05,172.31.40.0-255,66,9254,63,264273
5354,8.3e-05,74.125.24.0-255,2902,12156,63,264273
5355,8.5e-05,172.31.40.0-255,66,12222,63,264273
5356,9.6e-05,172.31.40.0-255,66,12288,63,264273
5357,0.000135,74.125.24.0-255,4839,17127,63,264273
5358,0.000137,172.31.40.0-255,66,17193,63,264273
5359,0.000143,74.125.24.0-255,5379,22572,63,264273
5360,0.000145,172.31.40.0-255,66,22638,63,264273
5361,0.00024,74.125.24.0-255,1484,24122,63,264273
5362,0.000244,172.31.40.0-255,66,24188,63,264273
5363,0.000249,74.125.24.0-255,2902,27090,63,264273
5364,0.00025,172.31.40.0-255,66,27156,63,264273
5365,0.000277,74.125.24.0-255,5738,32894,63,264273
5366,0.00028,172.31.40.0-255,66,32960,63,264273
5367,0.000283,74.125.24.0-255,1484,34444,63,264273
5368,0.000284,172.31.40.0-255,66,34510,63,264273
5369,0.000322,172.31.40.0-255,66,34576,63,264273
5370,0.000348,74.125.24.0-255,7156,41732,63,264273
5371,0.000351,172.31.40.0-255,66,41798,63,264273
5372,0.000372,74.125.24.0-255,2853,44651,63,264273
5373,0.000374,172.31.40.0-255,66,44717,63,264273
5374,0.000377,74.125.24.0-255,345,45062,63,264273
5375,0.000508,74.125.24.0-255,1484,46546,63,264273
5376,0.000513,172.31.40.0-255,66,46612,63,264273
5377,0.00052,74.125.24.0-255,2902,49514,63,264273
5378,0.000523,172.31.40.0-255,66,49580,63,264273
5379,0.000535,74.125.24.0-255,5738,55318,63,264273
5380,0.000537,172.31.40.0-255,66,55384,63,264273
5381,0.000569,74.125.24.0-255,4320,59704,63,264273
5382,0.000575,172.31.40.0-255,66,59770,63,264273
5383,0.000593,74.125.24.0-255,2543,62313,63,264273
5384,0.000596,172.31.40.0-255,66,62379,63,264273
5385,0.000878,74.125.24.0-255,1484,63863,63,264273
5386,0.000887,74.125.24.0-255,2902,66765,63,264273
5387,0.000892,172.31.40.0-255,66,66831,63,264273
5388,0.000897,74.125.24.0-255,2902,69733,63,264273
5389,0.000899,172.31.40.0-255,66,69799,63,264273
5390,0.000932,74.125.24.0-255,7156,76955,63,264273
5391,0.000935,172.31.40.0-255,66,77021,63,264273
5392,0.000974,172.31.40.0-255,66,77087,63,264273
5393,0.000985,172.31.40.0-255,66,77153,63,264273
5394,0.001319,74.125.24.0-255,1484,78637,63,264273
5395,0.001336,74.125.24.0-255,1484,80121,63,264273
5396,0.00134,172.31.40.0-255,66,80187,63,264273
5397,0.001368,74.125.24.0-255,1484,81671,63,264273
5398,0.001375,74.125.24.0-255,5738,87409,63,264273
5399,0.001378,172.31.40.0-255,66,87475,63,264273
5400,0.001383,74.125.24.0-255,2902,90377,63,264273
5401,0.001385,172.31.40.0-255,66,90443,63,264273
5402,0.001397,172.31.40.0-255,66,90509,63,264273
5403,0.001401,74.125.24.0-255,1484,91993,63,264273
5404,0.00144,172.31.40.0-255,66,92059,63,264273
5405,0.001877,74.125.24.0-255,1484,93543,63,264273
5406,0.001883,74.125.24.0-255,2902,96445,63,264273
5407,0.001886,172.31.40.0-255,66,96511,63,264273
5408,0.00191,74.125.24.0-255,5738,102249,63,264273
5409,0.001913,172.31.40.0-255,66,102315,63,264273
5410,0.001918,74.125.24.0-255,2902,105217,63,264273
5411,0.001919,172.31.40.0-255,66,105283,63,264273
5412,0.001924,74.125.24.0-255,2902,108185,63,264273
5413,0.001926,172.31.40.0-255,66,108251,63,264273
5414,0.001965,74.125.24.0-255,7156,115407,63,264273
5415,0.001968,172.31.40.0-255,66,115473,63,264273
5416,0.001975,74.125.24.0-255,5738,121211,63,264273
5417,0.001978,172.31.40.0-255,66,121277,63,264273
5418,0.002009,74.125.24.0-255,5020,126297,63,264273
5419,0.002012,172.31.40.0-255,66,126363,63,264273
5420,0.002146,74.125.24.0-255,1484,127847,63,264273
5421,0.002164,74.125.24.0-255,2902,130749,63,264273
5422,0.002167,172.31.40.0-255,66,130815,63,264273
5423,0.002174,74.125.24.0-255,5738,136553,63,264273
5424,0.002176,172.31.40.0-255,66,136619,63,264273
5425,0.002223,172.31.40.0-255,66,136685,63,264273
5426,0.002235,172.31.40.0-255,66,136751,63,264273
5427,0.002281,74.125.24.0-255,1484,138235,63,264273
5428,0.002285,74.125.24.0-255,2902,141137,63,264273
5429,0.00229,172.31.40.0-255,66,141203,63,264273
5430,0.002315,74.125.24.0-255,1484,142687,63,264273
5431,0.00232,74.125.24.0-255,2902,145589,63,264273
5432,0.002323,172.31.40.0-255,66,145655,63,264273
5433,0.002365,74.125.24.0-255,5738,151393,63,264273
5434,0.002368,172.31.40.0-255,66,151459,63,264273
5435,0.002382,172.31.40.0-255,66,151525,63,264273
5436,0.002408,74.125.24.0-255,1484,153009,63,264273
5437,0.002412,74.125.24.0-255,1484,154493,63,264273
5438,0.002415,172.31.40.0-255,66,154559,63,264273
5439,0.00242,74.125.24.0-255,2902,157461,63,264273
5440,0.002421,172.31.40.0-255,66,157527,63,264273
5441,0.002436,74.125.24.0-255,2184,159711,63,264273
5442,0.00244,172.31.40.0-255,66,159777,63,264273
5443,0.002443,74.125.24.0-255,1484,161261,63,264273
5444,0.002447,74.125.24.0-255,2902,164163,63,264273
5445,0.002449,172.31.40.0-255,66,164229,63,264273
5446,0.002455,74.125.24.0-255,5738,169967,63,264273
5447,0.002457,172.31.40.0-255,66,170033,63,264273
5448,0.002514,172.31.40.0-255,66,170099,63,264273
5449,0.00252,74.125.24.0-255,4320,174419,63,264273
5450,0.002523,172.31.40.0-255,66,174485,63,264273
5451,0.002555,74.125.24.0-255,6438,180923,63,264273
5452,0.002558,172.31.40.0-255,66,180989,63,264273
5453,0.002592,172.31.40.0-255,66,181055,63,264273
5454,0.002599,74.125.24.0-255,5738,186793,63,264273
5455,0.002602,172.31.40.0-255,66,186859,63,264273
5456,0.00262,74.125.24.0-255,4320,191179,63,264273
5457,0.002622,172.31.40.0-255,66,191245,63,264273
5458,0.002635,172.31.40.0-255,66,191311,63,264273
5459,0.002655,74.125.24.0-255,1484,192795,63,264273
5460,0.00266,74.125.24.0-255,3602,196397,63,264273
5461,0.002663,172.31.40.0-255,66,196463,63,264273
5462,0.002906,74.125.24.0-255,1484,197947,63,264273
5463,0.002921,74.125.24.0-255,2902,200849,63,264273
5464,0.002924,172.31.40.0-255,66,200915,63,264273
5465,0.002929,74.125.24.0-255,4320,205235,63,264273
5466,0.002931,172.31.40.0-255,66,205301,63,264273
5467,0.002948,74.125.24.0-255,1484,206785,63,264273
5468,0.002951,74.125.24.0-255,1484,208269,63,264273
5469,0.002953,172.31.40.0-255,66,208335,63,264273
5470,0.002993,172.31.40.0-255,66,208401,63,264273
5471,0.003003,172.31.40.0-255,66,208467,63,264273
5472,0.003027,74.125.24.0-255,1484,209951,63,264273
5473,0.00303,74.125.24.0-255,1484,211435,63,264273
5474,0.003032,172.31.40.0-255,66,211501,63,264273
5475,0.003043,74.125.24.0-255,1484,212985,63,264273
5476,0.003051,74.125.24.0-255,2902,215887,63,264273
5477,0.003053,172.31.40.0-255,66,215953,63,264273
5478,0.003075,74.125.24.0-255,2902,218855,63,264273
5479,0.003077,172.31.40.0-255,66,218921,63,264273
5480,0.003083,74.125.24.0-255,5738,224659,63,264273
5481,0.003085,172.31.40.0-255,66,224725,63,264273
5482,0.003107,74.125.24.0-255,7156,231881,63,264273
5483,0.003109,172.31.40.0-255,66,231947,63,264273
5484,0.003139,74.125.24.0-255,5738,237685,63,264273
5485,0.003142,172.31.40.0-255,66,237751,63,264273
5486,0.003147,74.125.24.0-255,5020,242771,63,264273
5487,0.003149,172.31.40.0-255,66,242837,63,264273
5488,0.003281,74.125.24.0-255,1484,244321,63,264273
5489,0.003288,74.125.24.0-255,2902,247223,63,264273
5490,0.003291,172.31.40.0-255,66,247289,63,264273
5491,0.003328,74.125.24.0-255,5738,253027,63,264273
5492,0.003331,172.31.40.0-255,66,253093,63,264273
5493,0.003338,74.125.24.0-255,7156,260249,63,264273
5494,0.00334,172.31.40.0-255,66,260315,63,264273
5495,0.00338,74.125.24.0-255,3616,263931,63,264273
5496,0.003383,172.31.40.0-255,66,263997,63,264273
5497,0.003419,74.125.24.0-255,105,264102,63,264273
5498,0.017875,172.31.40.0-255,66,264168,63,264273
5499,0.017926,172.31.40.0-255,105,264273,63,264273
5500,0.0,74.125.24.0-255,159,159,63,194725
5501,2.4e-05,172.31.40.0-255,66,225,63,194725
5502,3.2e-05,74.125.24.0-255,1484,1709,63,194725
5503,3.6e-05,172.31.40.0-255,66,1775,63,194725
5504,4.1e-05,74.125.24.0-255,2902,4677,63,194725
5505,4.3e-05,172.31.40.0-255,66,4743,63,194725
5506,7.4e-05,74.125.24.0-255,7156,11899,63,194725
5507,7.7e-05,172.31.40.0-255,66,11965,63,194725
5508,0.0001,74.125.24.0-255,5738,17703,63,194725
5509,0.000103,172.31.40.0-255,66,17769,63,194725
5510,0.000128,74.125.24.0-255,6392,24161,63,194725
5511,0.000131,172.31.40.0-255,66,24227,63,194725
5512,0.000138,74.125.24.0-255,7156,31383,63,194725
5513,0.000141,172.31.40.0-255,66,31449,63,194725
5514,0.000211,172.31.40.0-255,66,31515,63,194725
5515,0.000239,172.31.40.0-255,66,31581,63,194725
5516,0.000265,172.31.40.0-255,66,31647,63,194725
5517,0.000268,74.125.24.0-255,380,32027,63,194725
5518,0.00027,172.31.40.0-255,66,32093,63,194725
5519,0.000397,74.125.24.0-255,1484,33577,63,194725
5520,0.000401,172.31.40.0-255,66,33643,63,194725
5521,0.000407,74.125.24.0-255,2902,36545,63,194725
5522,0.000409,172.31.40.0-255,66,36611,63,194725
5523,0.000412,74.125.24.0-255,1484,38095,63,194725
5524,0.000414,172.31.40.0-255,66,38161,63,194725
5525,0.000437,74.125.24.0-255,4320,42481,63,194725
5526,0.00044,172.31.40.0-255,66,42547,63,194725
5527,0.000447,74.125.24.0-255,7156,49703,63,194725
5528,0.000449,172.31.40.0-255,66,49769,63,194725
5529,0.000472,74.125.24.0-255,5738,55507,63,194725
5530,0.000475,172.31.40.0-255,66,55573,63,194725
5531,0.000478,74.125.24.0-255,1484,57057,63,194725
5532,0.000508,172.31.40.0-255,66,57123,63,194725
5533,0.000901,74.125.24.0-255,1484,58607,63,194725
5534,0.000936,74.125.24.0-255,2902,61509,63,194725
5535,0.00094,172.31.40.0-255,66,61575,63,194725
5536,0.000945,74.125.24.0-255,2902,64477,63,194725
5537,0.000947,172.31.40.0-255,66,64543,63,194725
5538,0.000958,74.125.24.0-255,1484,66027,63,194725
5539,0.000974,74.125.24.0-255,2902,68929,63,194725
5540,0.000976,172.31.40.0-255,66,68995,63,194725
5541,0.000982,74.125.24.0-255,4320,73315,63,194725
5542,0.000984,172.31.40.0-255,66,73381,63,194725
5543,0.001013,74.125.24.0-255,5738,79119,63,194725
5544,0.001016,172.31.40.0-255,66,79185,63,194725
5545,0.001031,74.125.24.0-255,2902,82087,63,194725
5546,0.001033,172.31.40.0-255,66,82153,63,194725
5547,0.00104,74.125.24.0-255,5738,87891,63,194725
5548,0.001042,172.31.40.0-255,66,87957,63,194725
5549,0.001073,74.125.24.0-255,3602,91559,63,194725
5550,0.001075,172.31.40.0-255,66,91625,63,194725
5551,0.001448,74.125.24.0-255,1484,93109,63,194725
5552,0.001454,74.125.24.0-255,2902,96011,63,194725
5553,0.001457,172.31.40.0-255,66,96077,63,194725
5554,0.001476,74.125.24.0-255,1484,97561,63,194725
5555,0.001493,74.125.24.0-255,4320,101881,63,194725
5556,0.001495,172.31.40.0-255,66,101947,63,194725
5557,0.001509,172.31.40.0-255,66,102013,63,194725
5558,0.001544,74.125.24.0-255,4320,106333,63,194725
5559,0.001546,172.31.40.0-255,66,106399,63,194725
5560,0.00158,172.31.40.0-255,66,106465,63,194725
5561,0.001594,172.31.40.0-255,66,106531,63,194725
5562,0.001623,74.125.24.0-255,4320,110851,63,194725
5563,0.001626,172.31.40.0-255,66,110917,63,194725
5564,0.001635,172.31.40.0-255,66,110983,63,194725
5565,0.001665,74.125.24.0-255,1484,112467,63,194725
5566,0.00167,74.125.24.0-255,2902,115369,63,194725
5567,0.001673,172.31.40.0-255,66,115435,63,194725
5568,0.001694,74.125.24.0-255,4320,119755,63,194725
5569,0.001696,172.31.40.0-255,66,119821,63,194725
5570,0.001718,74.125.24.0-255,5738,125559,63,194725
5571,0.001721,172.31.40.0-255,66,125625,63,194725
5572,0.001779,172.31.40.0-255,66,125691,63,194725
5573,0.001786,74.125.24.0-255,7156,132847,63,194725
5574,0.001789,172.31.40.0-255,66,132913,63,194725
5575,0.001805,74.125.24.0-255,2902,135815,63,194725
5576,0.001808,172.31.40.0-255,66,135881,63,194725
5577,0.001859,172.31.40.0-255,66,135947,63,194725
5578,0.001871,172.31.40.0-255,66,136013,63,194725
5579,0.001888,74.125.24.0-255,5020,141033,63,194725
5580,0.001891,172.31.40.0-255,66,141099,63,194725
5581,0.00192,172.31.40.0-255,66,141165,63,194725
5582,0.001945,74.125.24.0-255,1484,142649,63,194725
5583,0.001962,172.31.40.0-255,66,142715,63,194725
5584,0.001967,74.125.24.0-255,3602,146317,63,194725
5585,0.00197,172.31.40.0-255,66,146383,63,194725
5586,0.001991,74.125.24.0-255,2902,149285,63,194725
5587,0.001994,172.31.40.0-255,66,149351,63,194725
5588,0.00201,74.125.24.0-255,1484,150835,63,194725
5589,0.002013,74.125.24.0-255,1484,152319,63,194725
5590,0.002015,172.31.40.0-255,66,152385,63,194725
5591,0.002021,74.125.24.0-255,4320,156705,63,194725
5592,0.002023,172.31.40.0-255,66,156771,63,194725
5593,0.002041,74.125.24.0-255,2902,159673,63,194725
5594,0.002044,172.31.40.0-255,66,159739,63,194725
5595,0.002077,172.31.40.0-255,66,159805,63,194725
5596,0.002127,74.125.24.0-255,7156,166961,63,194725
5597,0.002131,172.31.40.0-255,66,167027,63,194725
5598,0.002154,74.125.24.0-255,3602,170629,63,194725
5599,0.002156,172.31.40.0-255,66,170695,63,194725
5600,0.002168,172.31.40.0-255,66,170761,63,194725
5601,0.002173,74.125.24.0-255,2902,173663,63,194725
5602,0.002175,172.31.40.0-255,66,173729,63,194725
5603,0.002218,172.31.40.0-255,66,173795,63,194725
5604,0.002222,74.125.24.0-255,766,174561,63,194725
5605,0.002265,74.125.24.0-255,4320,178881,63,194725
5606,0.002268,172.31.40.0-255,66,178947,63,194725
5607,0.002296,74.125.24.0-255,7156,186103,63,194725
5608,0.002299,172.31.40.0-255,66,186169,63,194725
5609,0.002312,172.31.40.0-255,66,186235,63,194725
5610,0.00465,74.125.24.0-255,5738,191973,63,194725
5611,0.004657,172.31.40.0-255,66,192039,63,194725
5612,0.006915,74.125.24.0-255,2449,194488,63,194725
5613,0.006926,172.31.40.0-255,66,194554,63,194725
5614,0.016385,172.31.40.0-255,105,194659,63,194725
5615,0.018647,74.125.24.0-255,66,194725,63,194725
5616,0.0,74.125.24.0-255,296,296,63,183982
5617,2.4e-05,172.31.40.0-255,66,362,63,183982
5618,3e-05,74.125.24.0-255,1484,1846,63,183982
5619,3.5e-05,172.31.40.0-255,66,1912,63,183982
5620,4.1e-05,74.125.24.0-255,2902,4814,63,183982
5621,6.6e-05,172.31.40.0-255,66,4880,63,183982
5622,7.2e-05,74.125.24.0-255,4320,9200,63,183982
5623,7.6e-05,172.31.40.0-255,66,9266,63,183982
5624,0.000101,74.125.24.0-255,4706,13972,63,183982
5625,0.00011,172.31.40.0-255,66,14038,63,183982
5626,0.000279,74.125.24.0-255,1484,15522,63,183982
5627,0.000284,172.31.40.0-255,66,15588,63,183982
5628,0.00029,74.125.24.0-255,2902,18490,63,183982
5629,0.000292,172.31.40.0-255,66,18556,63,183982
5630,0.00032,74.125.24.0-255,5738,24294,63,183982
5631,0.000323,172.31.40.0-255,66,24360,63,183982
5632,0.000327,74.125.24.0-255,2902,27262,63,183982
5633,0.000329,172.31.40.0-255,66,27328,63,183982
5634,0.000396,172.31.40.0-255,66,27394,63,183982
5635,0.000407,74.125.24.0-255,1484,28878,63,183982
5636,0.000413,172.31.40.0-255,66,28944,63,183982
5637,0.000445,74.125.24.0-255,7156,36100,63,183982
5638,0.000449,172.31.40.0-255,66,36166,63,183982
5639,0.000456,74.125.24.0-255,7156,43322,63,183982
5640,0.000458,172.31.40.0-255,66,43388,63,183982
5641,0.000493,74.125.24.0-255,5738,49126,63,183982
5642,0.000496,172.31.40.0-255,66,49192,63,183982
5643,0.000534,172.31.40.0-255,66,49258,63,183982
5644,0.000536,74.125.24.0-255,395,49653,63,183982
5645,0.000538,172.31.40.0-255,66,49719,63,183982
5646,0.000818,74.125.24.0-255,348,50067,63,183982
5647,0.000993,74.125.24.0-255,1484,51551,63,183982
5648,0.000998,172.31.40.0-255,66,51617,63,183982
5649,0.001004,74.125.24.0-255,2902,54519,63,183982
5650,0.001006,172.31.40.0-255,66,54585,63,183982
5651,0.001028,74.125.24.0-255,2902,57487,63,183982
5652,0.001031,172.31.40.0-255,66,57553,63,183982
5653,0.001053,74.125.24.0-255,2902,60455,63,183982
5654,0.001056,172.31.40.0-255,66,60521,63,183982
5655,0.001067,74.125.24.0-255,5738,66259,63,183982
5656,0.001069,172.31.40.0-255,66,66325,63,183982
5657,0.001114,172.31.40.0-255,66,66391,63,183982
5658,0.00112,74.125.24.0-255,3961,70352,63,183982
5659,0.001121,172.31.40.0-255,66,70418,63,183982
5660,0.001603,74.125.24.0-255,1484,71902,63,183982
5661,0.001611,74.125.24.0-255,2902,74804,63,183982
5662,0.001615,172.31.40.0-255,66,74870,63,183982
5663,0.001648,74.125.24.0-255,5738,80608,63,183982
5664,0.00165,172.31.40.0-255,66,80674,63,183982
5665,0.001678,74.125.24.0-255,5738,86412,63,183982
5666,0.001681,172.31.40.0-255,66,86478,63,183982
5667,0.001707,74.125.24.0-255,4320,90798,63,183982
5668,0.001709,172.31.40.0-255,66,90864,63,183982
5669,0.001743,172.31.40.0-255,66,90930,63,183982
5670,0.001783,74.125.24.0-255,2184,93114,63,183982
5671,0.001786,172.31.40.0-255,66,93180,63,183982
5672,0.001821,74.125.24.0-255,2902,96082,63,183982
5673,0.001824,172.31.40.0-255,66,96148,63,183982
5674,0.001851,74.125.24.0-255,4320,100468,63,183982
5675,0.001854,172.31.40.0-255,66,100534,63,183982
5676,0.001859,74.125.24.0-255,4320,104854,63,183982
5677,0.001861,172.31.40.0-255,66,104920,63,183982
5678,0.001882,74.125.24.0-255,4320,109240,63,183982
5679,0.001888,172.31.40.0-255,66,109306,63,183982
5680,0.0019,172.31.40.0-255,66,109372,63,183982
5681,0.00194,74.125.24.0-255,5738,115110,63,183982
5682,0.001943,172.31.40.0-255,66,115176,63,183982
5683,0.001963,74.125.24.0-255,3602,118778,63,183982
5684,0.001965,172.31.40.0-255,66,118844,63,183982
5685,0.001999,74.125.24.0-255,4320,123164,63,183982
5686,0.002003,172.31.40.0-255,66,123230,63,183982
5687,0.002009,74.125.24.0-255,4320,127550,63,183982
5688,0.002011,172.31.40.0-255,66,127616,63,183982
5689,0.002036,74.125.24.0-255,1484,129100,63,183982
5690,0.002051,74.125.24.0-255,2902,132002,63,183982
5691,0.002054,172.31.40.0-255,66,132068,63,183982
5692,0.002083,74.125.24.0-255,4320,136388,63,183982
5693,0.002087,172.31.40.0-255,66,136454,63,183982
5694,0.0021,74.125.24.0-255,2902,139356,63,183982
5695,0.002106,172.31.40.0-255,66,139422,63,183982
5696,0.002112,74.125.24.0-255,4320,143742,63,183982
5697,0.002115,172.31.40.0-255,66,143808,63,183982
5698,0.002154,172.31.40.0-255,66,143874,63,183982
5699,0.002178,74.125.24.0-255,766,144640,63,183982
5700,0.002822,172.31.40.0-255,66,144706,63,183982
5701,0.004461,74.125.24.0-255,4320,149026,63,183982
5702,0.004469,172.31.40.0-255,66,149092,63,183982
5703,0.00509,74.125.24.0-255,1484,150576,63,183982
5704,0.006767,74.125.24.0-255,4320,154896,63,183982
5705,0.006775,172.31.40.0-255,66,154962,63,183982
5706,0.009062,74.125.24.0-255,5738,160700,63,183982
5707,0.009066,172.31.40.0-255,66,160766,63,183982
5708,0.011324,74.125.24.0-255,5738,166504,63,183982
5709,0.011332,172.31.40.0-255,66,166570,63,183982
5710,0.013627,74.125.24.0-255,5738,172308,63,183982
5711,0.013636,172.31.40.0-255,66,172374,63,183982
5712,0.015918,74.125.24.0-255,5738,178112,63,183982
5713,0.015927,172.31.40.0-255,66,178178,63,183982
5714,0.01823,74.125.24.0-255,5738,183916,63,183982
5715,0.018241,172.31.40.0-255,66,183982,63,183982
5716,0.0,216.58.203.0-255,153,153,63,93872
5717,2.4e-05,172.31.40.0-255,66,219,63,93872
5718,3.1e-05,216.58.203.0-255,1484,1703,63,93872
5719,3.5e-05,172.31.40.0-255,66,1769,63,93872
5720,4e-05,216.58.203.0-255,2902,4671,63,93872
5721,4.4e-05,172.31.40.0-255,66,4737,63,93872
5722,6.2e-05,216.58.203.0-255,2902,7639,63,93872
5723,6.5e-05,172.31.40.0-255,66,7705,63,93872
5724,9.4e-05,216.58.203.0-255,4320,12025,63,93872
5725,9.7e-05,172.31.40.0-255,66,12091,63,93872
5726,0.000101,216.58.203.0-255,2067,14158,63,93872
5727,0.000103,172.31.40.0-255,66,14224,63,93872
5728,0.000509,216.58.203.0-255,1484,15708,63,93872
5729,0.000515,172.31.40.0-255,66,15774,63,93872
5730,0.000521,216.58.203.0-255,2902,18676,63,93872
5731,0.000523,172.31.40.0-255,66,18742,63,93872
5732,0.000546,216.58.203.0-255,5738,24480,63,93872
5733,0.000548,172.31.40.0-255,66,24546,63,93872
5734,0.000556,216.58.203.0-255,6797,31343,63,93872
5735,0.000559,172.31.40.0-255,66,31409,63,93872
5736,0.000989,216.58.203.0-255,1484,32893,63,93872
5737,0.000995,172.31.40.0-255,66,32959,63,93872
5738,0.001003,216.58.203.0-255,2902,35861,63,93872
5739,0.001006,172.31.40.0-255,66,35927,63,93872
5740,0.001011,216.58.203.0-255,2902,38829,63,93872
5741,0.001013,172.31.40.0-255,66,38895,63,93872
5742,0.001053,216.58.203.0-255,1484,40379,63,93872
5743,0.001056,172.31.40.0-255,66,40445,63,93872
5744,0.001064,216.58.203.0-255,5738,46183,63,93872
5745,0.001067,172.31.40.0-255,66,46249,63,93872
5746,0.001082,172.31.40.0-255,66,46315,63,93872
5747,0.001088,216.58.203.0-255,5738,52053,63,93872
5748,0.001093,216.58.203.0-255,1125,53178,63,93872
5749,0.00613,172.31.40.0-255,66,53244,63,93872
5750,0.007817,216.58.203.0-255,5738,58982,63,93872
5751,0.007824,172.31.40.0-255,66,59048,63,93872
5752,0.009493,216.58.203.0-255,5738,64786,63,93872
5753,0.010418,172.31.40.0-255,66,64852,63,93872
5754,0.012085,216.58.203.0-255,5738,70590,63,93872
5755,0.012093,172.31.40.0-255,66,70656,63,93872
5756,0.013774,216.58.203.0-255,5738,76394,63,93872
5757,0.013783,172.31.40.0-255,66,76460,63,93872
5758,0.015468,216.58.203.0-255,5738,82198,63,93872
5759,0.015476,172.31.40.0-255,66,82264,63,93872
5760,0.017151,216.58.203.0-255,5738,88002,63,93872
5761,0.017158,172.31.40.0-255,66,88068,63,93872
5762,0.018848,216.58.203.0-255,5738,93806,63,93872
5763,0.018854,172.31.40.0-255,66,93872,63,93872
5764,0.0,74.125.24.0-255,153,153,63,116300
5765,2.2e-05,172.31.40.0-255,66,219,63,116300
5766,3e-05,74.125.24.0-255,1484,1703,63,116300
5767,3.4e-05,172.31.40.0-255,66,1769,63,116300
5768,4e-05,74.125.24.0-255,2902,4671,63,116300
5769,5.2e-05,172.31.40.0-255,66,4737,63,116300
5770,6e-05,74.125.24.0-255,7156,11893,63,116300
5771,6.3e-05,172.31.40.0-255,66,11959,63,116300
5772,6.7e-05,74.125.24.0-255,1983,13942,63,116300
5773,7e-05,172.31.40.0-255,66,14008,63,116300
5774,0.000121,74.125.24.0-255,1484,15492,63,116300
5775,0.000123,172.31.40.0-255,66,15558,63,116300
5776,0.000151,74.125.24.0-255,2902,18460,63,116300
5777,0.000155,172.31.40.0-255,66,18526,63,116300
5778,0.000161,74.125.24.0-255,5738,24264,63,116300
5779,0.000164,172.31.40.0-255,66,24330,63,116300
5780,0.000211,74.125.24.0-255,6797,31127,63,116300
5781,0.000214,172.31.40.0-255,66,31193,63,116300
5782,0.000344,74.125.24.0-255,1484,32677,63,116300
5783,0.000347,172.31.40.0-255,66,32743,63,116300
5784,0.000353,74.125.24.0-255,2902,35645,63,116300
5785,0.000355,172.31.40.0-255,66,35711,63,116300
5786,0.000363,74.125.24.0-255,1484,37195,63,116300
5787,0.000366,172.31.40.0-255,66,37261,63,116300
5788,0.00038,74.125.24.0-255,4320,41581,63,116300
5789,0.000382,172.31.40.0-255,66,41647,63,116300
5790,0.000389,74.125.24.0-255,1484,43131,63,116300
5791,0.000391,172.31.40.0-255,66,43197,63,116300
5792,0.000422,74.125.24.0-255,6797,49994,63,116300
5793,0.000425,172.31.40.0-255,66,50060,63,116300
5794,0.000449,172.31.40.0-255,66,50126,63,116300
5795,0.000456,74.125.24.0-255,5738,55864,63,116300
5796,0.000458,172.31.40.0-255,66,55930,63,116300
5797,0.000482,74.125.24.0-255,1125,57055,63,116300
5798,0.000486,74.125.24.0-255,412,57467,63,116300
5799,0.000524,74.125.24.0-255,331,57798,63,116300
5800,0.000527,172.31.40.0-255,66,57864,63,116300
5801,0.000836,74.125.24.0-255,1484,59348,63,116300
5802,0.000843,74.125.24.0-255,2902,62250,63,116300
5803,0.000848,172.31.40.0-255,66,62316,63,116300
5804,0.000855,74.125.24.0-255,5738,68054,63,116300
5805,0.000857,172.31.40.0-255,66,68120,63,116300
5806,0.000925,74.125.24.0-255,2902,71022,63,116300
5807,0.000931,172.31.40.0-255,66,71088,63,116300
5808,0.000939,172.31.40.0-255,66,71154,63,116300
5809,0.000954,172.31.40.0-255,66,71220,63,116300
5810,0.003301,74.125.24.0-255,5738,76958,63,116300
5811,0.003307,172.31.40.0-255,66,77024,63,116300
5812,0.005658,74.125.24.0-255,4320,81344,63,116300
5813,0.005663,172.31.40.0-255,66,81410,63,116300
5814,0.005689,74.125.24.0-255,1484,82894,63,116300
5815,0.008006,74.125.24.0-255,4320,87214,63,116300
5816,0.008013,172.31.40.0-255,66,87280,63,116300
5817,0.010371,74.125.24.0-255,5738,93018,63,116300
5818,0.010377,172.31.40.0-255,66,93084,63,116300
5819,0.012725,74.125.24.0-255,5738,98822,63,116300
5820,0.012735,172.31.40.0-255,66,98888,63,116300
5821,0.015115,74.125.24.0-255,5738,104626,63,116300
5822,0.015125,172.31.40.0-255,66,104692,63,116300
5823,0.017463,74.125.24.0-255,5738,110430,63,116300
5824,0.017471,172.31.40.0-255,66,110496,63,116300
5825,0.019839,74.125.24.0-255,5738,116234,63,116300
5826,0.019848,172.31.40.0-255,66,116300,63,116300
5827,0.0,172.217.194.0-255,158,158,63,207388
5828,1.4e-05,172.31.40.0-255,66,224,63,207388
5829,2e-05,172.217.194.0-255,1484,1708,63,207388
5830,2.4e-05,172.31.40.0-255,66,1774,63,207388
5831,3e-05,172.217.194.0-255,2902,4676,63,207388
5832,3.9e-05,172.31.40.0-255,66,4742,63,207388
5833,4.4e-05,172.217.194.0-255,2902,7644,63,207388
5834,4.6e-05,172.31.40.0-255,66,7710,63,207388
5835,5e-05,172.217.194.0-255,1484,9194,63,207388
5836,5.2e-05,172.31.40.0-255,66,9260,63,207388
5837,8.5e-05,172.217.194.0-255,6202,15462,63,207388
5838,8.8e-05,172.31.40.0-255,66,15528,63,207388
5839,0.000125,172.31.40.0-255,66,15594,63,207388
5840,0.000152,172.217.194.0-255,6797,22391,63,207388
5841,0.000155,172.31.40.0-255,66,22457,63,207388
5842,0.000165,172.31.40.0-255,66,22523,63,207388
5843,0.000201,172.217.194.0-255,6797,29320,63,207388
5844,0.000204,172.31.40.0-255,66,29386,63,207388
5845,0.000337,172.217.194.0-255,1484,30870,63,207388
5846,0.000341,172.31.40.0-255,66,30936,63,207388
5847,0.000347,172.217.194.0-255,2902,33838,63,207388
5848,0.000349,172.31.40.0-255,66,33904,63,207388
5849,0.000354,172.217.194.0-255,4320,38224,63,207388
5850,0.000356,172.31.40.0-255,66,38290,63,207388
5851,0.00038,172.217.194.0-255,1484,39774,63,207388
5852,0.000382,172.31.40.0-255,66,39840,63,207388
5853,0.000388,172.217.194.0-255,4320,44160,63,207388
5854,0.00039,172.31.40.0-255,66,44226,63,207388
5855,0.000407,172.217.194.0-255,2841,47067,63,207388
5856,0.000409,172.31.40.0-255,66,47133,63,207388
5857,0.00045,172.217.194.0-255,380,47513,63,207388
5858,0.000658,172.217.194.0-255,1484,48997,63,207388
5859,0.000662,172.31.40.0-255,66,49063,63,207388
5860,0.000668,172.217.194.0-255,2902,51965,63,207388
5861,0.00067,172.31.40.0-255,66,52031,63,207388
5862,0.000673,172.217.194.0-255,1484,53515,63,207388
5863,0.000705,172.217.194.0-255,4320,57835,63,207388
5864,0.000707,172.31.40.0-255,66,57901,63,207388
5865,0.000711,172.217.194.0-255,2902,60803,63,207388
5866,0.000713,172.31.40.0-255,66,60869,63,207388
5867,0.000739,172.217.194.0-255,2902,63771,63,207388
5868,0.000742,172.31.40.0-255,66,63837,63,207388
5869,0.00078,172.31.40.0-255,66,63903,63,207388
5870,0.000792,172.31.40.0-255,66,63969,63,207388
5871,0.000795,172.217.194.0-255,1125,65094,63,207388
5872,0.001257,172.217.194.0-255,1484,66578,63,207388
5873,0.001264,172.31.40.0-255,66,66644,63,207388
5874,0.00127,172.217.194.0-255,2902,69546,63,207388
5875,0.001273,172.31.40.0-255,66,69612,63,207388
5876,0.001285,172.217.194.0-255,5738,75350,63,207388
5877,0.001287,172.31.40.0-255,66,75416,63,207388
5878,0.00129,172.217.194.0-255,1484,76900,63,207388
5879,0.001324,172.31.40.0-255,66,76966,63,207388
5880,0.001337,172.31.40.0-255,66,77032,63,207388
5881,0.001365,172.217.194.0-255,766,77798,63,207388
5882,0.001576,172.217.194.0-255,1484,79282,63,207388
5883,0.001583,172.31.40.0-255,66,79348,63,207388
5884,0.001589,172.217.194.0-255,2902,82250,63,207388
5885,0.001592,172.31.40.0-255,66,82316,63,207388
5886,0.001598,172.217.194.0-255,4320,86636,63,207388
5887,0.001605,172.31.40.0-255,66,86702,63,207388
5888,0.001637,172.217.194.0-255,1484,88186,63,207388
5889,0.001646,172.217.194.0-255,7156,95342,63,207388
5890,0.001649,172.31.40.0-255,66,95408,63,207388
5891,0.001685,172.217.194.0-255,4320,99728,63,207388
5892,0.001689,172.217.194.0-255,2184,101912,63,207388
5893,0.002016,172.217.194.0-255,1484,103396,63,207388
5894,0.002023,172.217.194.0-255,2902,106298,63,207388
5895,0.002027,172.217.194.0-255,1484,107782,63,207388
5896,0.00204,172.217.194.0-255,4320,112102,63,207388
5897,0.002063,172.217.194.0-255,7156,119258,63,207388
5898,0.002083,172.217.194.0-255,5738,124996,63,207388
5899,0.002086,172.217.194.0-255,1484,126480,63,207388
5900,0.002116,172.217.194.0-255,766,127246,63,207388
5901,0.002119,172.217.194.0-255,1484,128730,63,207388
5902,0.002134,172.217.194.0-255,4320,133050,63,207388
5903,0.002222,172.217.194.0-255,4320,137370,63,207388
5904,0.002247,172.217.194.0-255,6438,143808,63,207388
5905,0.002254,172.217.194.0-255,5738,149546,63,207388
5906,0.002268,172.217.194.0-255,5738,155284,63,207388
5907,0.002294,172.217.194.0-255,7156,162440,63,207388
5908,0.002322,172.217.194.0-255,2902,165342,63,207388
5909,0.002338,172.217.194.0-255,4320,169662,63,207388
5910,0.002345,172.217.194.0-255,5738,175400,63,207388
5911,0.00236,172.217.194.0-255,2902,178302,63,207388
5912,0.002377,172.217.194.0-255,5738,184040,63,207388
5913,0.009341,172.31.40.0-255,66,184106,63,207388
5914,0.010644,172.217.194.0-255,1484,185590,63,207388
5915,0.01173,172.217.194.0-255,4320,189910,63,207388
5916,0.011736,172.31.40.0-255,66,189976,63,207388
5917,0.014088,172.217.194.0-255,5738,195714,63,207388
5918,0.014098,172.31.40.0-255,66,195780,63,207388
5919,0.016474,172.217.194.0-255,5738,201518,63,207388
5920,0.016483,172.31.40.0-255,66,201584,63,207388
5921,0.018846,172.217.194.0-255,5738,207322,63,207388
5922,0.018861,172.31.40.0-255,66,207388,63,207388
5923,0.0,74.125.24.0-255,146,146,63,197957
5924,3e-05,172.31.40.0-255,66,212,63,197957
5925,3.7e-05,74.125.24.0-255,1484,1696,63,197957
5926,4.2e-05,172.31.40.0-255,66,1762,63,197957
5927,4.8e-05,74.125.24.0-255,2902,4664,63,197957
5928,5.1e-05,172.31.40.0-255,66,4730,63,197957
5929,7e-05,74.125.24.0-255,7156,11886,63,197957
5930,7.3e-05,172.31.40.0-255,66,11952,63,197957
5931,7.6e-05,74.125.24.0-255,2029,13981,63,197957
5932,8e-05,172.31.40.0-255,66,14047,63,197957
5933,9.9e-05,74.125.24.0-255,4320,18367,63,197957
5934,0.000102,172.31.40.0-255,66,18433,63,197957
5935,0.000122,74.125.24.0-255,5738,24171,63,197957
5936,0.000124,172.31.40.0-255,66,24237,63,197957
5937,0.000185,74.125.24.0-255,6797,31034,63,197957
5938,0.000188,172.31.40.0-255,66,31100,63,197957
5939,0.000237,74.125.24.0-255,1484,32584,63,197957
5940,0.00024,172.31.40.0-255,66,32650,63,197957
5941,0.000267,74.125.24.0-255,2902,35552,63,197957
5942,0.000269,172.31.40.0-255,66,35618,63,197957
5943,0.000276,74.125.24.0-255,5738,41356,63,197957
5944,0.000278,172.31.40.0-255,66,41422,63,197957
5945,0.00032,74.125.24.0-255,4320,45742,63,197957
5946,0.000323,172.31.40.0-255,66,45808,63,197957
5947,0.00035,172.31.40.0-255,66,45874,63,197957
5948,0.000362,172.31.40.0-255,66,45940,63,197957
5949,0.000585,74.125.24.0-255,646,46586,63,197957
5950,0.000591,172.31.40.0-255,66,46652,63,197957
5951,0.000653,74.125.24.0-255,1484,48136,63,197957
5952,0.000656,74.125.24.0-255,1484,49620,63,197957
5953,0.000661,172.31.40.0-255,66,49686,63,197957
5954,0.000672,74.125.24.0-255,1484,51170,63,197957
5955,0.000674,172.31.40.0-255,66,51236,63,197957
5956,0.000692,74.125.24.0-255,5738,56974,63,197957
5957,0.000695,172.31.40.0-255,66,57040,63,197957
5958,0.000715,74.125.24.0-255,5738,62778,63,197957
5959,0.000717,172.31.40.0-255,66,62844,63,197957
5960,0.000739,74.125.24.0-255,1125,63969,63,197957
5961,0.000743,74.125.24.0-255,1484,65453,63,197957
5962,0.000745,172.31.40.0-255,66,65519,63,197957
5963,0.000773,74.125.24.0-255,5738,71257,63,197957
5964,0.000776,172.31.40.0-255,66,71323,63,197957
5965,0.000782,74.125.24.0-255,4320,75643,63,197957
5966,0.000784,172.31.40.0-255,66,75709,63,197957
5967,0.000824,74.125.24.0-255,5379,81088,63,197957
5968,0.000828,172.31.40.0-255,66,81154,63,197957
5969,0.00103,74.125.24.0-255,1484,82638,63,197957
5970,0.001044,74.125.24.0-255,2902,85540,63,197957
5971,0.001047,172.31.40.0-255,66,85606,63,197957
5972,0.001054,74.125.24.0-255,5738,91344,63,197957
5973,0.001056,172.31.40.0-255,66,91410,63,197957
5974,0.001089,172.31.40.0-255,66,91476,63,197957
5975,0.001138,172.31.40.0-255,66,91542,63,197957
5976,0.001254,74.125.24.0-255,1484,93026,63,197957
5977,0.001261,74.125.24.0-255,2902,95928,63,197957
5978,0.001264,172.31.40.0-255,66,95994,63,197957
5979,0.001269,74.125.24.0-255,2902,98896,63,197957
5980,0.001271,172.31.40.0-255,66,98962,63,197957
5981,0.001274,74.125.24.0-255,1484,100446,63,197957
5982,0.00129,74.125.24.0-255,5738,106184,63,197957
5983,0.001292,172.31.40.0-255,66,106250,63,197957
5984,0.001309,74.125.24.0-255,1484,107734,63,197957
5985,0.001341,172.31.40.0-255,66,107800,63,197957
5986,0.001346,74.125.24.0-255,3602,111402,63,197957
5987,0.001349,172.31.40.0-255,66,111468,63,197957
5988,0.001531,74.125.24.0-255,1484,112952,63,197957
5989,0.001538,74.125.24.0-255,2902,115854,63,197957
5990,0.001541,172.31.40.0-255,66,115920,63,197957
5991,0.001572,74.125.24.0-255,1484,117404,63,197957
5992,0.001588,74.125.24.0-255,4320,121724,63,197957
5993,0.00159,172.31.40.0-255,66,121790,63,197957
5994,0.001598,74.125.24.0-255,7156,128946,63,197957
5995,0.0016,172.31.40.0-255,66,129012,63,197957
5996,0.001631,172.31.40.0-255,66,129078,63,197957
5997,0.001648,74.125.24.0-255,5738,134816,63,197957
5998,0.001651,172.31.40.0-255,66,134882,63,197957
5999,0.001655,74.125.24.0-255,2184,137066,63,197957
6000,0.001658,172.31.40.0-255,66,137132,63,197957
6001,0.001782,74.125.24.0-255,1484,138616,63,197957
6002,0.001787,74.125.24.0-255,1484,140100,63,197957
6003,0.00179,172.31.40.0-255,66,140166,63,197957
6004,0.001815,74.125.24.0-255,1484,141650,63,197957
6005,0.001822,74.125.24.0-255,5738,147388,63,197957
6006,0.001825,172.31.40.0-255,66,147454,63,197957
6007,0.001837,172.31.40.0-255,66,147520,63,197957
6008,0.001862,74.125.24.0-255,4320,151840,63,197957
6009,0.001866,172.31.40.0-255,66,151906,63,197957
6010,0.001876,172.31.40.0-255,66,151972,63,197957
6011,0.001968,172.31.40.0-255,66,152038,63,197957
6012,0.001982,172.31.40.0-255,66,152104,63,197957
6013,0.001987,74.125.24.0-255,4320,156424,63,197957
6014,0.00199,172.31.40.0-255,66,156490,63,197957
6015,0.001996,74.125.24.0-255,5738,162228,63,197957
6016,0.001998,172.31.40.0-255,66,162294,63,197957
6017,0.002011,172.31.40.0-255,66,162360,63,197957
6018,0.002016,74.125.24.0-255,4320,166680,63,197957
6019,0.002019,172.31.40.0-255,66,166746,63,197957
6020,0.002059,172.31.40.0-255,66,166812,63,197957
6021,0.002072,172.31.40.0-255,66,166878,63,197957
6022,0.002076,74.125.24.0-255,2902,169780,63,197957
6023,0.002079,172.31.40.0-255,66,169846,63,197957
6024,0.002135,74.125.24.0-255,766,170612,63,197957
6025,0.002149,172.31.40.0-255,66,170678,63,197957
6026,0.002157,74.125.24.0-255,1484,172162,63,197957
6027,0.002207,74.125.24.0-255,4320,176482,63,197957
6028,0.00221,74.125.24.0-255,766,177248,63,197957
6029,0.00222,172.31.40.0-255,66,177314,63,197957
6030,0.002495,74.125.24.0-255,1484,178798,63,197957
6031,0.002502,74.125.24.0-255,2902,181700,63,197957
6032,0.002505,172.31.40.0-255,66,181766,63,197957
6033,0.002511,74.125.24.0-255,4320,186086,63,197957
6034,0.002533,74.125.24.0-255,1484,187570,63,197957
6035,0.00254,74.125.24.0-255,7156,194726,63,197957
6036,0.002546,172.31.40.0-255,66,194792,63,197957
6037,0.002582,74.125.24.0-255,2184,196976,63,197957
6038,0.002598,172.31.40.0-255,66,197042,63,197957
6039,0.005147,74.125.24.0-255,678,197720,63,197957
6040,0.00986,172.31.40.0-255,66,197786,63,197957
6041,0.0099,172.31.40.0-255,105,197891,63,197957
6042,0.012402,74.125.24.0-255,66,197957,63,197957
6043,0.0,74.125.24.0-255,153,153,63,129464
6044,3e-05,172.31.40.0-255,66,219,63,129464
6045,3.9e-05,74.125.24.0-255,1484,1703,63,129464
6046,4.4e-05,172.31.40.0-255,66,1769,63,129464
6047,5.1e-05,74.125.24.0-255,2902,4671,63,129464
6048,5.5e-05,172.31.40.0-255,66,4737,63,129464
6049,6.4e-05,74.125.24.0-255,5738,10475,63,129464
6050,6.7e-05,172.31.40.0-255,66,10541,63,129464
6051,9.6e-05,74.125.24.0-255,3367,13908,63,129464
6052,0.0001,172.31.40.0-255,66,13974,63,129464
6053,0.000168,74.125.24.0-255,1484,15458,63,129464
6054,0.000171,172.31.40.0-255,66,15524,63,129464
6055,0.000177,74.125.24.0-255,2902,18426,63,129464
6056,0.000179,172.31.40.0-255,66,18492,63,129464
6057,0.000198,74.125.24.0-255,5738,24230,63,129464
6058,0.000201,172.31.40.0-255,66,24296,63,129464
6059,0.000228,74.125.24.0-255,6797,31093,63,129464
6060,0.000231,172.31.40.0-255,66,31159,63,129464
6061,0.000271,74.125.24.0-255,1484,32643,63,129464
6062,0.000274,172.31.40.0-255,66,32709,63,129464
6063,0.00028,74.125.24.0-255,2902,35611,63,129464
6064,0.000281,172.31.40.0-255,66,35677,63,129464
6065,0.00029,74.125.24.0-255,5738,41415,63,129464
6066,0.000293,172.31.40.0-255,66,41481,63,129464
6067,0.0003,74.125.24.0-255,5738,47219,63,129464
6068,0.000303,172.31.40.0-255,66,47285,63,129464
6069,0.000325,74.125.24.0-255,1125,48410,63,129464
6070,0.000327,172.31.40.0-255,66,48476,63,129464
6071,0.000362,74.125.24.0-255,1484,49960,63,129464
6072,0.000364,172.31.40.0-255,66,50026,63,129464
6073,0.000369,74.125.24.0-255,2902,52928,63,129464
6074,0.000372,172.31.40.0-255,66,52994,63,129464
6075,0.000414,74.125.24.0-255,5738,58732,63,129464
6076,0.000475,74.125.24.0-255,4320,63052,63,129464
6077,0.000491,74.125.24.0-255,2871,65923,63,129464
6078,0.00069,172.31.40.0-255,66,65989,63,129464
6079,0.001207,74.125.24.0-255,349,66338,63,129464
6080,0.001272,172.31.40.0-255,66,66404,63,129464
6081,0.001369,74.125.24.0-255,1484,67888,63,129464
6082,0.001378,74.125.24.0-255,2902,70790,63,129464
6083,0.001397,74.125.24.0-255,2902,73692,63,129464
6084,0.001425,74.125.24.0-255,2902,76594,63,129464
6085,0.001429,74.125.24.0-255,2902,79496,63,129464
6086,0.001436,74.125.24.0-255,5738,85234,63,129464
6087,0.001452,74.125.24.0-255,4320,89554,63,129464
6088,0.001456,74.125.24.0-255,2902,92456,63,129464
6089,0.00148,74.125.24.0-255,7156,99612,63,129464
6090,0.001512,74.125.24.0-255,766,100378,63,129464
6091,0.007182,172.31.40.0-255,66,100444,63,129464
6092,0.009245,74.125.24.0-255,5738,106182,63,129464
6093,0.00927,172.31.40.0-255,66,106248,63,129464
6094,0.011279,74.125.24.0-255,5738,111986,63,129464
6095,0.012579,172.31.40.0-255,66,112052,63,129464
6096,0.014599,74.125.24.0-255,5738,117790,63,129464
6097,0.01461,172.31.40.0-255,66,117856,63,129464
6098,0.016681,74.125.24.0-255,5738,123594,63,129464
6099,0.016692,172.31.40.0-255,66,123660,63,129464
6100,0.018715,74.125.24.0-255,5738,129398,63,129464
6101,0.018726,172.31.40.0-255,66,129464,63,129464
6102,0.0,74.125.24.0-255,154,154,63,204570
6103,1.8e-05,172.31.40.0-255,66,220,63,204570
6104,2.5e-05,74.125.24.0-255,1484,1704,63,204570
6105,3e-05,172.31.40.0-255,66,1770,63,204570
6106,3.6e-05,74.125.24.0-255,2902,4672,63,204570
6107,4.9e-05,172.31.40.0-255,66,4738,63,204570
6108,5.5e-05,74.125.24.0-255,4320,9058,63,204570
6109,6e-05,172.31.40.0-255,66,9124,63,204570
6110,6.6e-05,74.125.24.0-255,4804,13928,63,204570
6111,6.9e-05,172.31.40.0-255,66,13994,63,204570
6112,7.6e-05,74.125.24.0-255,5738,19732,63,204570
6113,7.8e-05,172.31.40.0-255,66,19798,63,204570
6114,0.000121,74.125.24.0-255,5738,25536,63,204570
6115,0.000124,172.31.40.0-255,66,25602,63,204570
6116,0.000131,74.125.24.0-255,5379,30981,63,204570
6117,0.000134,172.31.40.0-255,66,31047,63,204570
6118,0.000473,74.125.24.0-255,1484,32531,63,204570
6119,0.00048,172.31.40.0-255,66,32597,63,204570
6120,0.000486,74.125.24.0-255,2902,35499,63,204570
6121,0.000489,172.31.40.0-255,66,35565,63,204570
6122,0.000494,74.125.24.0-255,4320,39885,63,204570
6123,0.000502,172.31.40.0-255,66,39951,63,204570
6124,0.000529,74.125.24.0-255,1484,41435,63,204570
6125,0.000531,172.31.40.0-255,66,41501,63,204570
6126,0.000535,74.125.24.0-255,1484,42985,63,204570
6127,0.000537,172.31.40.0-255,66,43051,63,204570
6128,0.000576,172.31.40.0-255,66,43117,63,204570
6129,0.000588,172.31.40.0-255,66,43183,63,204570
6130,0.000591,74.125.24.0-255,1125,44308,63,204570
6131,0.000593,172.31.40.0-255,66,44374,63,204570
6132,0.000636,74.125.24.0-255,394,44768,63,204570
6133,0.000802,74.125.24.0-255,1484,46252,63,204570
6134,0.000806,172.31.40.0-255,66,46318,63,204570
6135,0.000812,74.125.24.0-255,2902,49220,63,204570
6136,0.000814,172.31.40.0-255,66,49286,63,204570
6137,0.000819,74.125.24.0-255,2902,52188,63,204570
6138,0.00082,172.31.40.0-255,66,52254,63,204570
6139,0.000854,74.125.24.0-255,2902,55156,63,204570
6140,0.000857,172.31.40.0-255,66,55222,63,204570
6141,0.000865,74.125.24.0-255,6797,62019,63,204570
6142,0.000867,172.31.40.0-255,66,62085,63,204570
6143,0.00088,74.125.24.0-255,7156,69241,63,204570
6144,0.000883,172.31.40.0-255,66,69307,63,204570
6145,0.000924,74.125.24.0-255,7156,76463,63,204570
6146,0.000927,172.31.40.0-255,66,76529,63,204570
6147,0.000941,172.31.40.0-255,66,76595,63,204570
6148,0.000953,74.125.24.0-255,6141,82736,63,204570
6149,0.000955,172.31.40.0-255,66,82802,63,204570
6150,0.00127,74.125.24.0-255,1484,84286,63,204570
6151,0.001291,74.125.24.0-255,2902,87188,63,204570
6152,0.001293,74.125.24.0-255,1484,88672,63,204570
6153,0.001298,172.31.40.0-255,66,88738,63,204570
6154,0.001307,74.125.24.0-255,1484,90222,63,204570
6155,0.00131,172.31.40.0-255,66,90288,63,204570
6156,0.001319,74.125.24.0-255,2902,93190,63,204570
6157,0.001321,172.31.40.0-255,66,93256,63,204570
6158,0.001351,74.125.24.0-255,4320,97576,63,204570
6159,0.001354,172.31.40.0-255,66,97642,63,204570
6160,0.001373,172.31.40.0-255,66,97708,63,204570
6161,0.001431,74.125.24.0-255,5020,102728,63,204570
6162,0.001434,172.31.40.0-255,66,102794,63,204570
6163,0.001705,74.125.24.0-255,1484,104278,63,204570
6164,0.00172,74.125.24.0-255,1484,105762,63,204570
6165,0.001724,172.31.40.0-255,66,105828,63,204570
6166,0.001754,74.125.24.0-255,1484,107312,63,204570
6167,0.001761,74.125.24.0-255,5738,113050,63,204570
6168,0.001764,172.31.40.0-255,66,113116,63,204570
6169,0.001769,74.125.24.0-255,2902,116018,63,204570
6170,0.001771,172.31.40.0-255,66,116084,63,204570
6171,0.001778,74.125.24.0-255,5738,121822,63,204570
6172,0.00178,172.31.40.0-255,66,121888,63,204570
6173,0.001824,74.125.24.0-255,4320,126208,63,204570
6174,0.001828,172.31.40.0-255,66,126274,63,204570
6175,0.001844,172.31.40.0-255,66,126340,63,204570
6176,0.001869,74.125.24.0-255,1484,127824,63,204570
6177,0.001883,74.125.24.0-255,2902,130726,63,204570
6178,0.001886,172.31.40.0-255,66,130792,63,204570
6179,0.001892,74.125.24.0-255,5738,136530,63,204570
6180,0.001894,172.31.40.0-255,66,136596,63,204570
6181,0.001897,74.125.24.0-255,1484,138080,63,204570
6182,0.001918,74.125.24.0-255,1484,139564,63,204570
6183,0.00192,172.31.40.0-255,66,139630,63,204570
6184,0.001937,172.31.40.0-255,66,139696,63,204570
6185,0.001989,74.125.24.0-255,7156,146852,63,204570
6186,0.001993,172.31.40.0-255,66,146918,63,204570
6187,0.002024,74.125.24.0-255,3602,150520,63,204570
6188,0.002027,172.31.40.0-255,66,150586,63,204570
6189,0.002111,74.125.24.0-255,1484,152070,63,204570
6190,0.002118,74.125.24.0-255,2902,154972,63,204570
6191,0.002121,172.31.40.0-255,66,155038,63,204570
6192,0.002152,74.125.24.0-255,5738,160776,63,204570
6193,0.002155,172.31.40.0-255,66,160842,63,204570
6194,0.002159,74.125.24.0-255,2902,163744,63,204570
6195,0.002161,172.31.40.0-255,66,163810,63,204570
6196,0.002208,172.31.40.0-255,66,163876,63,204570
6197,0.002234,172.31.40.0-255,66,163942,63,204570
6198,0.004616,74.125.24.0-255,5738,169680,63,204570
6199,0.004634,172.31.40.0-255,66,169746,63,204570
6200,0.007003,74.125.24.0-255,5738,175484,63,204570
6201,0.007013,172.31.40.0-255,66,175550,63,204570
6202,0.009355,74.125.24.0-255,5738,181288,63,204570
6203,0.009361,172.31.40.0-255,66,181354,63,204570
6204,0.011726,74.125.24.0-255,5738,187092,63,204570
6205,0.011742,172.31.40.0-255,66,187158,63,204570
6206,0.014094,74.125.24.0-255,5738,192896,63,204570
6207,0.014113,172.31.40.0-255,66,192962,63,204570
6208,0.016442,74.125.24.0-255,5738,198700,63,204570
6209,0.016448,172.31.40.0-255,66,198766,63,204570
6210,0.018813,74.125.24.0-255,5738,204504,63,204570
6211,0.018829,172.31.40.0-255,66,204570,63,204570
6212,0.0,74.125.68.0-255,152,152,63,266121
6213,1.7e-05,172.31.40.0-255,66,218,63,266121
6214,2.4e-05,74.125.68.0-255,1484,1702,63,266121
6215,2.8e-05,172.31.40.0-255,66,1768,63,266121
6216,4.9e-05,74.125.68.0-255,2902,4670,63,266121
6217,5.1e-05,172.31.40.0-255,66,4736,63,266121
6218,5.8e-05,74.125.68.0-255,5738,10474,63,266121
6219,6e-05,172.31.40.0-255,66,10540,63,266121
6220,7.6e-05,74.125.68.0-255,3449,13989,63,266121
6221,7.8e-05,172.31.40.0-255,66,14055,63,266121
6222,0.000104,74.125.68.0-255,4320,18375,63,266121
6223,0.000106,172.31.40.0-255,66,18441,63,266121
6224,0.000131,74.125.68.0-255,7156,25597,63,266121
6225,0.000133,172.31.40.0-255,66,25663,63,266121
6226,0.000151,74.125.68.0-255,2902,28565,63,266121
6227,0.000153,172.31.40.0-255,66,28631,63,266121
6228,0.000178,74.125.68.0-255,2543,31174,63,266121
6229,0.000181,172.31.40.0-255,66,31240,63,266121
6230,0.00026,74.125.68.0-255,1484,32724,63,266121
6231,0.000263,172.31.40.0-255,66,32790,63,266121
6232,0.000287,74.125.68.0-255,1484,34274,63,266121
6233,0.000289,172.31.40.0-255,66,34340,63,266121
6234,0.000295,74.125.68.0-255,2902,37242,63,266121
6235,0.000297,172.31.40.0-255,66,37308,63,266121
6236,0.000325,74.125.68.0-255,5738,43046,63,266121
6237,0.000327,172.31.40.0-255,66,43112,63,266121
6238,0.000333,74.125.68.0-255,5379,48491,63,266121
6239,0.000335,172.31.40.0-255,66,48557,63,266121
6240,0.000363,74.125.68.0-255,5738,54295,63,266121
6241,0.000365,172.31.40.0-255,66,54361,63,266121
6242,0.000382,74.125.68.0-255,4320,58681,63,266121
6243,0.000384,172.31.40.0-255,66,58747,63,266121
6244,0.000394,74.125.68.0-255,1484,60231,63,266121
6245,0.000431,74.125.68.0-255,4320,64551,63,266121
6246,0.000435,172.31.40.0-255,66,64617,63,266121
6247,0.000457,74.125.68.0-255,1398,66015,63,266121
6248,0.00046,74.125.68.0-255,131,66146,63,266121
6249,0.000536,74.125.68.0-255,1484,67630,63,266121
6250,0.00054,172.31.40.0-255,66,67696,63,266121
6251,0.000551,74.125.68.0-255,2902,70598,63,266121
6252,0.000554,172.31.40.0-255,66,70664,63,266121
6253,0.000583,74.125.68.0-255,1484,72148,63,266121
6254,0.000599,74.125.68.0-255,4320,76468,63,266121
6255,0.000602,172.31.40.0-255,66,76534,63,266121
6256,0.000607,74.125.68.0-255,4320,80854,63,266121
6257,0.000609,172.31.40.0-255,66,80920,63,266121
6258,0.000624,74.125.68.0-255,2902,83822,63,266121
6259,0.000626,172.31.40.0-255,66,83888,63,266121
6260,0.00063,74.125.68.0-255,2902,86790,63,266121
6261,0.000631,172.31.40.0-255,66,86856,63,266121
6262,0.000656,74.125.68.0-255,4320,91176,63,266121
6263,0.000658,172.31.40.0-255,66,91242,63,266121
6264,0.000691,74.125.68.0-255,7156,98398,63,266121
6265,0.000693,172.31.40.0-255,66,98464,63,266121
6266,0.000736,74.125.68.0-255,2184,100648,63,266121
6267,0.000739,172.31.40.0-255,66,100714,63,266121
6268,0.000795,74.125.68.0-255,1484,102198,63,266121
6269,0.000809,74.125.68.0-255,2902,105100,63,266121
6270,0.000813,172.31.40.0-255,66,105166,63,266121
6271,0.000827,74.125.68.0-255,1484,106650,63,266121
6272,0.000842,74.125.68.0-255,4320,110970,63,266121
6273,0.000844,172.31.40.0-255,66,111036,63,266121
6274,0.00087,74.125.68.0-255,7156,118192,63,266121
6275,0.000874,172.31.40.0-255,66,118258,63,266121
6276,0.000885,172.31.40.0-255,66,118324,63,266121
6277,0.000922,172.31.40.0-255,66,118390,63,266121
6278,0.001067,74.125.68.0-255,1484,119874,63,266121
6279,0.001082,74.125.68.0-255,1484,121358,63,266121
6280,0.001085,172.31.40.0-255,66,121424,63,266121
6281,0.0011,74.125.68.0-255,1484,122908,63,266121
6282,0.001105,74.125.68.0-255,4320,127228,63,266121
6283,0.001107,172.31.40.0-255,66,127294,63,266121
6284,0.001124,74.125.68.0-255,1484,128778,63,266121
6285,0.00114,74.125.68.0-255,1484,130262,63,266121
6286,0.001144,172.31.40.0-255,66,130328,63,266121
6287,0.001156,74.125.68.0-255,4320,134648,63,266121
6288,0.001158,172.31.40.0-255,66,134714,63,266121
6289,0.001179,74.125.68.0-255,1484,136198,63,266121
6290,0.001196,172.31.40.0-255,66,136264,63,266121
6291,0.001199,74.125.68.0-255,1484,137748,63,266121
6292,0.00122,74.125.68.0-255,766,138514,63,266121
6293,0.001224,172.31.40.0-255,66,138580,63,266121
6294,0.001275,74.125.68.0-255,1484,140064,63,266121
6295,0.001293,74.125.68.0-255,2902,142966,63,266121
6296,0.001296,172.31.40.0-255,66,143032,63,266121
6297,0.00131,74.125.68.0-255,4320,147352,63,266121
6298,0.001312,172.31.40.0-255,66,147418,63,266121
6299,0.001319,74.125.68.0-255,5738,153156,63,266121
6300,0.001322,172.31.40.0-255,66,153222,63,266121
6301,0.001349,74.125.68.0-255,7156,160378,63,266121
6302,0.001352,172.31.40.0-255,66,160444,63,266121
6303,0.001385,74.125.68.0-255,4320,164764,63,266121
6304,0.001388,172.31.40.0-255,66,164830,63,266121
6305,0.001391,74.125.68.0-255,1484,166314,63,266121
6306,0.001427,172.31.40.0-255,66,166380,63,266121
6307,0.001455,74.125.68.0-255,6438,172818,63,266121
6308,0.001458,172.31.40.0-255,66,172884,63,266121
6309,0.001472,172.31.40.0-255,66,172950,63,266121
6310,0.0015,74.125.68.0-255,4320,177270,63,266121
6311,0.001503,172.31.40.0-255,66,177336,63,266121
6312,0.001508,74.125.68.0-255,4320,181656,63,266121
6313,0.001511,172.31.40.0-255,66,181722,63,266121
6314,0.001519,74.125.68.0-255,5020,186742,63,266121
6315,0.001522,172.31.40.0-255,66,186808,63,266121
6316,0.001569,74.125.68.0-255,1484,188292,63,266121
6317,0.001583,74.125.68.0-255,2902,191194,63,266121
6318,0.001586,172.31.40.0-255,66,191260,63,266121
6319,0.001615,74.125.68.0-255,5738,196998,63,266121
6320,0.001618,172.31.40.0-255,66,197064,63,266121
6321,0.001622,74.125.68.0-255,2902,199966,63,266121
6322,0.001624,172.31.40.0-255,66,200032,63,266121
6323,0.001634,74.125.68.0-255,4320,204352,63,266121
6324,0.001636,172.31.40.0-255,66,204418,63,266121
6325,0.001675,172.31.40.0-255,66,204484,63,266121
6326,0.00168,74.125.68.0-255,4320,208804,63,266121
6327,0.001683,172.31.40.0-255,66,208870,63,266121
6328,0.001723,74.125.68.0-255,3602,212472,63,266121
6329,0.001726,172.31.40.0-255,66,212538,63,266121
6330,0.001754,74.125.68.0-255,4320,216858,63,266121
6331,0.001757,172.31.40.0-255,66,216924,63,266121
6332,0.001762,74.125.68.0-255,4320,221244,63,266121
6333,0.001765,172.31.40.0-255,66,221310,63,266121
6334,0.001794,74.125.68.0-255,5738,227048,63,266121
6335,0.001797,172.31.40.0-255,66,227114,63,266121
6336,0.00183,172.31.40.0-255,66,227180,63,266121
6337,0.001835,74.125.68.0-255,4320,231500,63,266121
6338,0.001837,172.31.40.0-255,66,231566,63,266121
6339,0.0019,74.125.68.0-255,7156,238722,63,266121
6340,0.001903,172.31.40.0-255,66,238788,63,266121
6341,0.001947,74.125.68.0-255,4320,243108,63,266121
6342,0.001983,172.31.40.0-255,66,243174,63,266121
6343,0.001986,172.31.40.0-255,66,243240,63,266121
6344,0.001989,172.31.40.0-255,66,243306,63,266121
6345,0.00202,172.31.40.0-255,66,243372,63,266121
6346,0.002033,172.31.40.0-255,66,243438,63,266121
6347,0.002038,74.125.68.0-255,5738,249176,63,266121
6348,0.002041,172.31.40.0-255,66,249242,63,266121
6349,0.002077,74.125.68.0-255,2902,252144,63,266121
6350,0.002081,172.31.40.0-255,66,252210,63,266121
6351,0.00211,172.31.40.0-255,66,252276,63,266121
6352,0.002113,74.125.68.0-255,1484,253760,63,266121
6353,0.002148,172.31.40.0-255,66,253826,63,266121
6354,0.002154,74.125.68.0-255,5738,259564,63,266121
6355,0.002156,172.31.40.0-255,66,259630,63,266121
6356,0.002188,74.125.68.0-255,6083,265713,63,266121
6357,0.002191,172.31.40.0-255,66,265779,63,266121
6358,0.002206,74.125.68.0-255,105,265884,63,266121
6359,0.009598,172.31.40.0-255,66,265950,63,266121
6360,0.009637,172.31.40.0-255,105,266055,63,266121
6361,0.012127,74.125.68.0-255,66,266121,63,266121
6362,0.0,172.217.194.0-255,143,143,63,181228
6363,1.8e-05,172.31.40.0-255,66,209,63,181228
6364,2.3e-05,172.217.194.0-255,1484,1693,63,181228
6365,2.8e-05,172.31.40.0-255,66,1759,63,181228
6366,3.4e-05,172.217.194.0-255,2902,4661,63,181228
6367,4.5e-05,172.31.40.0-255,66,4727,63,181228
6368,5.4e-05,172.217.194.0-255,7156,11883,63,181228
6369,5.7e-05,172.31.40.0-255,66,11949,63,181228
6370,6.1e-05,172.217.194.0-255,2023,13972,63,181228
6371,6.5e-05,172.31.40.0-255,66,14038,63,181228
6372,7.2e-05,172.217.194.0-255,7156,21194,63,181228
6373,7.5e-05,172.31.40.0-255,66,21260,63,181228
6374,0.000103,172.217.194.0-255,4320,25580,63,181228
6375,0.000106,172.31.40.0-255,66,25646,63,181228
6376,0.000116,172.217.194.0-255,5379,31025,63,181228
6377,0.000119,172.31.40.0-255,66,31091,63,181228
6378,0.000254,172.217.194.0-255,1484,32575,63,181228
6379,0.000258,172.31.40.0-255,66,32641,63,181228
6380,0.000264,172.217.194.0-255,2902,35543,63,181228
6381,0.000267,172.31.40.0-255,66,35609,63,181228
6382,0.000273,172.217.194.0-255,5738,41347,63,181228
6383,0.000281,172.31.40.0-255,66,41413,63,181228
6384,0.000307,172.217.194.0-255,4320,45733,63,181228
6385,0.00031,172.31.40.0-255,66,45799,63,181228
6386,0.000346,172.31.40.0-255,66,45865,63,181228
6387,0.000372,172.31.40.0-255,66,45931,63,181228
6388,0.000375,172.217.194.0-255,118,46049,63,181228
6389,0.000377,172.31.40.0-255,66,46115,63,181228
6390,0.000468,172.217.194.0-255,1484,47599,63,181228
6391,0.000472,172.31.40.0-255,66,47665,63,181228
6392,0.000477,172.217.194.0-255,2902,50567,63,181228
6393,0.000482,172.217.194.0-255,2902,53469,63,181228
6394,0.000498,172.217.194.0-255,2902,56371,63,181228
6395,0.000512,172.217.194.0-255,4320,60691,63,181228
6396,0.000572,172.217.194.0-255,1484,62175,63,181228
6397,0.000608,172.31.40.0-255,66,62241,63,181228
6398,0.000817,172.217.194.0-255,1484,63725,63,181228
6399,0.000823,172.217.194.0-255,2902,66627,63,181228
6400,0.000836,172.31.40.0-255,66,66693,63,181228
6401,0.000848,172.217.194.0-255,5738,72431,63,181228
6402,0.000856,172.217.194.0-255,7156,79587,63,181228
6403,0.000867,172.31.40.0-255,66,79653,63,181228
6404,0.000877,172.217.194.0-255,5738,85391,63,181228
6405,0.000888,172.217.194.0-255,5738,91129,63,181228
6406,0.000938,172.217.194.0-255,5020,96149,63,181228
6407,0.000945,172.217.194.0-255,5738,101887,63,181228
6408,0.000956,172.31.40.0-255,66,101953,63,181228
6409,0.000992,172.31.40.0-255,66,102019,63,181228
6410,0.001024,172.217.194.0-255,5020,107039,63,181228
6411,0.00103,172.31.40.0-255,66,107105,63,181228
6412,0.001067,172.217.194.0-255,1484,108589,63,181228
6413,0.001072,172.217.194.0-255,2902,111491,63,181228
6414,0.001088,172.217.194.0-255,5738,117229,63,181228
6415,0.001098,172.31.40.0-255,66,117295,63,181228
6416,0.001109,172.217.194.0-255,4320,121615,63,181228
6417,0.001119,172.31.40.0-255,66,121681,63,181228
6418,0.001171,172.31.40.0-255,66,121747,63,181228
6419,0.001251,172.217.194.0-255,1484,123231,63,181228
6420,0.001257,172.217.194.0-255,2902,126133,63,181228
6421,0.001263,172.31.40.0-255,66,126199,63,181228
6422,0.00129,172.217.194.0-255,5738,131937,63,181228
6423,0.001296,172.31.40.0-255,66,132003,63,181228
6424,0.001307,172.217.194.0-255,5738,137741,63,181228
6425,0.001317,172.31.40.0-255,66,137807,63,181228
6426,0.001347,172.217.194.0-255,7156,144963,63,181228
6427,0.001376,172.31.40.0-255,66,145029,63,181228
6428,0.001472,172.217.194.0-255,1484,146513,63,181228
6429,0.001478,172.217.194.0-255,2902,149415,63,181228
6430,0.001485,172.217.194.0-255,5738,155153,63,181228
6431,0.001497,172.217.194.0-255,1484,156637,63,181228
6432,0.001511,172.217.194.0-255,5738,162375,63,181228
6433,0.001516,172.31.40.0-255,66,162441,63,181228
6434,0.001561,172.217.194.0-255,5738,168179,63,181228
6435,0.001629,172.31.40.0-255,66,168245,63,181228
6436,0.001661,172.217.194.0-255,5738,173983,63,181228
6437,0.001675,172.31.40.0-255,66,174049,63,181228
6438,0.001803,172.217.194.0-255,5738,179787,63,181228
6439,0.001808,172.31.40.0-255,66,179853,63,181228
6440,0.001854,172.217.194.0-255,1033,180886,63,181228
6441,0.001856,172.217.194.0-255,105,180991,63,181228
6442,0.001875,172.31.40.0-255,66,181057,63,181228
6443,0.010164,172.31.40.0-255,105,181162,63,181228
6444,0.012683,172.217.194.0-255,66,181228,63,181228
6445,0.0,74.125.24.0-255,300,300,63,227148
6446,3.7e-05,172.31.40.0-255,66,366,63,227148
6447,4.4e-05,74.125.24.0-255,1484,1850,63,227148
6448,4.9e-05,172.31.40.0-255,66,1916,63,227148
6449,5.5e-05,74.125.24.0-255,4320,6236,63,227148
6450,6.6e-05,172.31.40.0-255,66,6302,63,227148
6451,7.2e-05,74.125.24.0-255,4320,10622,63,227148
6452,7.4e-05,172.31.40.0-255,66,10688,63,227148
6453,8.8e-05,74.125.24.0-255,3358,14046,63,227148
6454,9e-05,172.31.40.0-255,66,14112,63,227148
6455,0.000109,172.31.40.0-255,66,14178,63,227148
6456,0.000111,74.125.24.0-255,7156,21334,63,227148
6457,0.000114,172.31.40.0-255,66,21400,63,227148
6458,0.000159,172.31.40.0-255,66,21466,63,227148
6459,0.000165,74.125.24.0-255,6438,27904,63,227148
6460,0.000168,172.31.40.0-255,66,27970,63,227148
6461,0.000457,74.125.24.0-255,1484,29454,63,227148
6462,0.000462,172.31.40.0-255,66,29520,63,227148
6463,0.000467,74.125.24.0-255,2902,32422,63,227148
6464,0.00047,172.31.40.0-255,66,32488,63,227148
6465,0.000473,74.125.24.0-255,1484,33972,63,227148
6466,0.000475,172.31.40.0-255,66,34038,63,227148
6467,0.000507,74.125.24.0-255,4320,38358,63,227148
6468,0.000511,172.31.40.0-255,66,38424,63,227148
6469,0.000532,74.125.24.0-255,2902,41326,63,227148
6470,0.000536,172.31.40.0-255,66,41392,63,227148
6471,0.000557,74.125.24.0-255,3961,45353,63,227148
6472,0.000561,172.31.40.0-255,66,45419,63,227148
6473,0.000654,74.125.24.0-255,645,46064,63,227148
6474,0.000659,172.31.40.0-255,66,46130,63,227148
6475,0.000907,74.125.24.0-255,1484,47614,63,227148
6476,0.000913,74.125.24.0-255,1484,49098,63,227148
6477,0.000917,172.31.40.0-255,66,49164,63,227148
6478,0.000943,74.125.24.0-255,1484,50648,63,227148
6479,0.00095,74.125.24.0-255,5738,56386,63,227148
6480,0.000953,172.31.40.0-255,66,56452,63,227148
6481,0.000959,74.125.24.0-255,5738,62190,63,227148
6482,0.000961,172.31.40.0-255,66,62256,63,227148
6483,0.000988,74.125.24.0-255,7156,69412,63,227148
6484,0.000998,74.125.24.0-255,4320,73732,63,227148
6485,0.000999,172.31.40.0-255,66,73798,63,227148
6486,0.001003,172.31.40.0-255,66,73864,63,227148
6487,0.001031,74.125.24.0-255,6438,80302,63,227148
6488,0.001035,172.31.40.0-255,66,80368,63,227148
6489,0.001356,74.125.24.0-255,1484,81852,63,227148
6490,0.001367,74.125.24.0-255,2902,84754,63,227148
6491,0.001371,172.31.40.0-255,66,84820,63,227148
6492,0.00138,74.125.24.0-255,5738,90558,63,227148
6493,0.001382,172.31.40.0-255,66,90624,63,227148
6494,0.001387,74.125.24.0-255,2902,93526,63,227148
6495,0.001397,172.31.40.0-255,66,93592,63,227148
6496,0.001427,74.125.24.0-255,5738,99330,63,227148
6497,0.001431,172.31.40.0-255,66,99396,63,227148
6498,0.001436,74.125.24.0-255,2902,102298,63,227148
6499,0.001438,172.31.40.0-255,66,102364,63,227148
6500,0.001477,172.31.40.0-255,66,102430,63,227148
6501,0.001488,172.31.40.0-255,66,102496,63,227148
6502,0.001519,74.125.24.0-255,7156,109652,63,227148
6503,0.001522,172.31.40.0-255,66,109718,63,227148
6504,0.001532,172.31.40.0-255,66,109784,63,227148
6505,0.001585,172.31.40.0-255,66,109850,63,227148
6506,0.001612,74.125.24.0-255,766,110616,63,227148
6507,0.001721,74.125.24.0-255,1484,112100,63,227148
6508,0.001726,172.31.40.0-255,66,112166,63,227148
6509,0.001732,74.125.24.0-255,2902,115068,63,227148
6510,0.001734,172.31.40.0-255,66,115134,63,227148
6511,0.001764,74.125.24.0-255,5738,120872,63,227148
6512,0.001768,172.31.40.0-255,66,120938,63,227148
6513,0.001775,74.125.24.0-255,5738,126676,63,227148
6514,0.001777,172.31.40.0-255,66,126742,63,227148
6515,0.001815,74.125.24.0-255,7156,133898,63,227148
6516,0.001819,172.31.40.0-255,66,133964,63,227148
6517,0.00184,172.31.40.0-255,66,134030,63,227148
6518,0.001895,74.125.24.0-255,1484,135514,63,227148
6519,0.001901,74.125.24.0-255,2902,138416,63,227148
6520,0.001904,172.31.40.0-255,66,138482,63,227148
6521,0.001911,74.125.24.0-255,5738,144220,63,227148
6522,0.001915,172.31.40.0-255,66,144286,63,227148
6523,0.001969,172.31.40.0-255,66,144352,63,227148
6524,0.001975,74.125.24.0-255,5738,150090,63,227148
6525,0.001977,172.31.40.0-255,66,150156,63,227148
6526,0.002003,74.125.24.0-255,5020,155176,63,227148
6527,0.002007,172.31.40.0-255,66,155242,63,227148
6528,0.00209,74.125.24.0-255,1484,156726,63,227148
6529,0.002095,74.125.24.0-255,1484,158210,63,227148
6530,0.002099,172.31.40.0-255,66,158276,63,227148
6531,0.002131,74.125.24.0-255,1484,159760,63,227148
6532,0.002139,74.125.24.0-255,5738,165498,63,227148
6533,0.002142,172.31.40.0-255,66,165564,63,227148
6534,0.002168,172.31.40.0-255,66,165630,63,227148
6535,0.002179,172.31.40.0-255,66,165696,63,227148
6536,0.002204,74.125.24.0-255,766,166462,63,227148
6537,0.002207,74.125.24.0-255,1484,167946,63,227148
6538,0.002209,172.31.40.0-255,66,168012,63,227148
6539,0.002214,74.125.24.0-255,2902,170914,63,227148
6540,0.002216,172.31.40.0-255,66,170980,63,227148
6541,0.002237,74.125.24.0-255,1484,172464,63,227148
6542,0.002243,74.125.24.0-255,5738,178202,63,227148
6543,0.002246,172.31.40.0-255,66,178268,63,227148
6544,0.002273,74.125.24.0-255,4320,182588,63,227148
6545,0.002275,172.31.40.0-255,66,182654,63,227148
6546,0.002288,172.31.40.0-255,66,182720,63,227148
6547,0.002312,74.125.24.0-255,1484,184204,63,227148
6548,0.002317,74.125.24.0-255,3602,187806,63,227148
6549,0.002319,172.31.40.0-255,66,187872,63,227148
6550,0.004606,74.125.24.0-255,4320,192192,63,227148
6551,0.004611,172.31.40.0-255,66,192258,63,227148
6552,0.00463,74.125.24.0-255,1484,193742,63,227148
6553,0.006941,74.125.24.0-255,4320,198062,63,227148
6554,0.006966,172.31.40.0-255,66,198128,63,227148
6555,0.009303,74.125.24.0-255,5738,203866,63,227148
6556,0.009318,172.31.40.0-255,66,203932,63,227148
6557,0.011634,74.125.24.0-255,5738,209670,63,227148
6558,0.011649,172.31.40.0-255,66,209736,63,227148
6559,0.013974,74.125.24.0-255,5738,215474,63,227148
6560,0.013994,172.31.40.0-255,66,215540,63,227148
6561,0.016302,74.125.24.0-255,5738,221278,63,227148
6562,0.016319,172.31.40.0-255,66,221344,63,227148
6563,0.018606,74.125.24.0-255,5738,227082,63,227148
6564,0.018618,172.31.40.0-255,66,227148,63,227148
6565,0.0,74.125.200.0-255,153,153,63,163076
6566,2.1e-05,172.31.40.0-255,66,219,63,163076
6567,2.8e-05,74.125.200.0-255,1484,1703,63,163076
6568,3.2e-05,172.31.40.0-255,66,1769,63,163076
6569,3.8e-05,74.125.200.0-255,2902,4671,63,163076
6570,4.2e-05,172.31.40.0-255,66,4737,63,163076
6571,4.8e-05,74.125.200.0-255,5738,10475,63,163076
6572,5.1e-05,172.31.40.0-255,66,10541,63,163076
6573,9e-05,74.125.200.0-255,3421,13962,63,163076
6574,9.3e-05,172.31.40.0-255,66,14028,63,163076
6575,0.000198,74.125.200.0-255,1484,15512,63,163076
6576,0.000203,172.31.40.0-255,66,15578,63,163076
6577,0.000219,74.125.200.0-255,2902,18480,63,163076
6578,0.000221,172.31.40.0-255,66,18546,63,163076
6579,0.000236,74.125.200.0-255,4320,22866,63,163076
6580,0.000239,172.31.40.0-255,66,22932,63,163076
6581,0.000256,74.125.200.0-255,1484,24416,63,163076
6582,0.000258,172.31.40.0-255,66,24482,63,163076
6583,0.000319,74.125.200.0-255,6797,31279,63,163076
6584,0.000322,172.31.40.0-255,66,31345,63,163076
6585,0.000375,74.125.200.0-255,4320,35665,63,163076
6586,0.000378,172.31.40.0-255,66,35731,63,163076
6587,0.000394,74.125.200.0-255,2902,38633,63,163076
6588,0.000397,172.31.40.0-255,66,38699,63,163076
6589,0.000455,74.125.200.0-255,2902,41601,63,163076
6590,0.000459,172.31.40.0-255,66,41667,63,163076
6591,0.000476,74.125.200.0-255,6797,48464,63,163076
6592,0.00048,172.31.40.0-255,66,48530,63,163076
6593,0.001217,74.125.200.0-255,1484,50014,63,163076
6594,0.001224,172.31.40.0-255,66,50080,63,163076
6595,0.001233,74.125.200.0-255,2902,52982,63,163076
6596,0.001236,172.31.40.0-255,66,53048,63,163076
6597,0.001258,74.125.200.0-255,4320,57368,63,163076
6598,0.00126,172.31.40.0-255,66,57434,63,163076
6599,0.001276,74.125.200.0-255,1484,58918,63,163076
6600,0.001316,74.125.200.0-255,2902,61820,63,163076
6601,0.001319,172.31.40.0-255,66,61886,63,163076
6602,0.00134,74.125.200.0-255,4269,66155,63,163076
6603,0.001343,172.31.40.0-255,66,66221,63,163076
6604,0.001539,74.125.200.0-255,117,66338,63,163076
6605,0.001564,74.125.200.0-255,1484,67822,63,163076
6606,0.001568,172.31.40.0-255,66,67888,63,163076
6607,0.00159,74.125.200.0-255,2902,70790,63,163076
6608,0.001593,172.31.40.0-255,66,70856,63,163076
6609,0.00162,74.125.200.0-255,2902,73758,63,163076
6610,0.001622,172.31.40.0-255,66,73824,63,163076
6611,0.001626,74.125.200.0-255,1484,75308,63,163076
6612,0.001644,74.125.200.0-255,2902,78210,63,163076
6613,0.001646,172.31.40.0-255,66,78276,63,163076
6614,0.001681,74.125.200.0-255,5738,84014,63,163076
6615,0.001684,172.31.40.0-255,66,84080,63,163076
6616,0.001704,74.125.200.0-255,2902,86982,63,163076
6617,0.001706,172.31.40.0-255,66,87048,63,163076
6618,0.001774,74.125.200.0-255,2902,89950,63,163076
6619,0.001779,172.31.40.0-255,66,90016,63,163076
6620,0.001811,74.125.200.0-255,2902,92918,63,163076
6621,0.001814,172.31.40.0-255,66,92984,63,163076
6622,0.001845,172.31.40.0-255,66,93050,63,163076
6623,0.001923,74.125.200.0-255,4320,97370,63,163076
6624,0.001927,172.31.40.0-255,66,97436,63,163076
6625,0.001945,74.125.200.0-255,5738,103174,63,163076
6626,0.001948,172.31.40.0-255,66,103240,63,163076
6627,0.002033,74.125.200.0-255,1484,104724,63,163076
6628,0.002061,172.31.40.0-255,66,104790,63,163076
6629,0.002196,74.125.200.0-255,1484,106274,63,163076
6630,0.002228,172.31.40.0-255,66,106340,63,163076
6631,0.002338,74.125.200.0-255,5738,112078,63,163076
6632,0.002341,172.31.40.0-255,66,112144,63,163076
6633,0.002358,74.125.200.0-255,1484,113628,63,163076
6634,0.002418,74.125.200.0-255,6438,120066,63,163076
6635,0.00242,172.31.40.0-255,66,120132,63,163076
6636,0.002475,74.125.200.0-255,4320,124452,63,163076
6637,0.00249,74.125.200.0-255,2902,127354,63,163076
6638,0.002557,74.125.200.0-255,1484,128838,63,163076
6639,0.002569,74.125.200.0-255,2902,131740,63,163076
6640,0.002746,74.125.200.0-255,2184,133924,63,163076
6641,0.006484,172.31.40.0-255,66,133990,63,163076
6642,0.009077,74.125.200.0-255,5738,139728,63,163076
6643,0.009085,172.31.40.0-255,66,139794,63,163076
6644,0.011677,74.125.200.0-255,5738,145532,63,163076
6645,0.011686,172.31.40.0-255,66,145598,63,163076
6646,0.014286,74.125.200.0-255,5738,151336,63,163076
6647,0.014296,172.31.40.0-255,66,151402,63,163076
6648,0.016931,74.125.200.0-255,5738,157140,63,163076
6649,0.01694,172.31.40.0-255,66,157206,63,163076
6650,0.019557,74.125.200.0-255,4320,161526,63,163076
6651,0.019563,172.31.40.0-255,66,161592,63,163076
6652,0.019582,74.125.200.0-255,1484,163076,63,163076
6653,0.0,172.217.194.0-255,153,153,63,136585
6654,1.4e-05,172.31.40.0-255,66,219,63,136585
6655,2.1e-05,172.217.194.0-255,1484,1703,63,136585
6656,2.6e-05,172.31.40.0-255,66,1769,63,136585
6657,3.2e-05,172.217.194.0-255,2902,4671,63,136585
6658,3.6e-05,172.31.40.0-255,66,4737,63,136585
6659,4.2e-05,172.217.194.0-255,4320,9057,63,136585
6660,4.5e-05,172.31.40.0-255,66,9123,63,136585
6661,4.8e-05,172.217.194.0-255,1484,10607,63,136585
6662,5e-05,172.31.40.0-255,66,10673,63,136585
6663,8.8e-05,172.31.40.0-255,66,10739,63,136585
6664,9.9e-05,172.31.40.0-255,66,10805,63,136585
6665,0.000116,172.217.194.0-255,3961,14766,63,136585
6666,0.000118,172.31.40.0-255,66,14832,63,136585
6667,0.000157,172.217.194.0-255,2902,17734,63,136585
6668,0.00016,172.31.40.0-255,66,17800,63,136585
6669,0.000165,172.217.194.0-255,4320,22120,63,136585
6670,0.000168,172.31.40.0-255,66,22186,63,136585
6671,0.000174,172.217.194.0-255,4320,26506,63,136585
6672,0.000176,172.31.40.0-255,66,26572,63,136585
6673,0.000204,172.217.194.0-255,4320,30892,63,136585
6674,0.000206,172.31.40.0-255,66,30958,63,136585
6675,0.000209,172.217.194.0-255,1125,32083,63,136585
6676,0.000211,172.31.40.0-255,66,32149,63,136585
6677,0.000611,172.217.194.0-255,1484,33633,63,136585
6678,0.000616,172.31.40.0-255,66,33699,63,136585
6679,0.000623,172.217.194.0-255,2902,36601,63,136585
6680,0.000625,172.31.40.0-255,66,36667,63,136585
6681,0.000632,172.217.194.0-255,5738,42405,63,136585
6682,0.000634,172.31.40.0-255,66,42471,63,136585
6683,0.00066,172.217.194.0-255,5738,48209,63,136585
6684,0.000665,172.31.40.0-255,66,48275,63,136585
6685,0.000695,172.217.194.0-255,3961,52236,63,136585
6686,0.000699,172.217.194.0-255,1484,53720,63,136585
6687,0.000707,172.31.40.0-255,66,53786,63,136585
6688,0.000718,172.217.194.0-255,2902,56688,63,136585
6689,0.000726,172.217.194.0-255,7156,63844,63,136585
6690,0.000745,172.217.194.0-255,2543,66387,63,136585
6691,0.000748,172.217.194.0-255,645,67032,63,136585
6692,0.000753,172.31.40.0-255,66,67098,63,136585
6693,0.000766,172.217.194.0-255,1484,68582,63,136585
6694,0.000785,172.217.194.0-255,2902,71484,63,136585
6695,0.00079,172.31.40.0-255,66,71550,63,136585
6696,0.000809,172.217.194.0-255,1484,73034,63,136585
6697,0.000815,172.217.194.0-255,4320,77354,63,136585
6698,0.000822,172.217.194.0-255,5738,83092,63,136585
6699,0.000824,172.217.194.0-255,1125,84217,63,136585
6700,0.00083,172.31.40.0-255,66,84283,63,136585
6701,0.002831,172.217.194.0-255,5738,90021,63,136585
6702,0.002838,172.31.40.0-255,66,90087,63,136585
6703,0.004827,172.217.194.0-255,5738,95825,63,136585
6704,0.004834,172.31.40.0-255,66,95891,63,136585
6705,0.006819,172.217.194.0-255,2902,98793,63,136585
6706,0.006836,172.217.194.0-255,2902,101695,63,136585
6707,0.00737,172.31.40.0-255,66,101761,63,136585
6708,0.009364,172.217.194.0-255,5738,107499,63,136585
6709,0.009371,172.31.40.0-255,66,107565,63,136585
6710,0.011382,172.217.194.0-255,5738,113303,63,136585
6711,0.011491,172.31.40.0-255,66,113369,63,136585
6712,0.013491,172.217.194.0-255,5738,119107,63,136585
6713,0.0135,172.31.40.0-255,66,119173,63,136585
6714,0.015527,172.217.194.0-255,5738,124911,63,136585
6715,0.015535,172.31.40.0-255,66,124977,63,136585
6716,0.017544,172.217.194.0-255,5738,130715,63,136585
6717,0.017552,172.31.40.0-255,66,130781,63,136585
6718,0.019541,172.217.194.0-255,5738,136519,63,136585
6719,0.019549,172.31.40.0-255,66,136585,63,136585
6720,0.0,172.217.194.0-255,146,146,63,174287
6721,1.4e-05,172.31.40.0-255,66,212,63,174287
6722,2.1e-05,172.217.194.0-255,1484,1696,63,174287
6723,2.6e-05,172.31.40.0-255,66,1762,63,174287
6724,3.2e-05,172.217.194.0-255,2902,4664,63,174287
6725,3.4e-05,172.31.40.0-255,66,4730,63,174287
6726,4.2e-05,172.217.194.0-255,7156,11886,63,174287
6727,4.5e-05,172.31.40.0-255,66,11952,63,174287
6728,4.9e-05,172.217.194.0-255,2039,13991,63,174287
6729,5.3e-05,172.31.40.0-255,66,14057,63,174287
6730,0.000252,172.217.194.0-255,1484,15541,63,174287
6731,0.000257,172.31.40.0-255,66,15607,63,174287
6732,0.000263,172.217.194.0-255,2902,18509,63,174287
6733,0.000266,172.31.40.0-255,66,18575,63,174287
6734,0.000271,172.217.194.0-255,2902,21477,63,174287
6735,0.000273,172.31.40.0-255,66,21543,63,174287
6736,0.000299,172.217.194.0-255,2902,24445,63,174287
6737,0.000301,172.31.40.0-255,66,24511,63,174287
6738,0.000333,172.31.40.0-255,66,24577,63,174287
6739,0.000356,172.217.194.0-255,2543,27120,63,174287
6740,0.000359,172.31.40.0-255,66,27186,63,174287
6741,0.000374,172.31.40.0-255,66,27252,63,174287
6742,0.000399,172.217.194.0-255,4320,31572,63,174287
6743,0.000401,172.31.40.0-255,66,31638,63,174287
6744,0.000418,172.217.194.0-255,6765,38403,63,174287
6745,0.00042,172.31.40.0-255,66,38469,63,174287
6746,0.000423,172.217.194.0-255,382,38851,63,174287
6747,0.000425,172.31.40.0-255,66,38917,63,174287
6748,0.000594,172.217.194.0-255,1484,40401,63,174287
6749,0.000598,172.31.40.0-255,66,40467,63,174287
6750,0.000604,172.217.194.0-255,2902,43369,63,174287
6751,0.000607,172.31.40.0-255,66,43435,63,174287
6752,0.000611,172.217.194.0-255,2902,46337,63,174287
6753,0.000614,172.31.40.0-255,66,46403,63,174287
6754,0.00064,172.217.194.0-255,2902,49305,63,174287
6755,0.000643,172.31.40.0-255,66,49371,63,174287
6756,0.000656,172.31.40.0-255,66,49437,63,174287
6757,0.000663,172.217.194.0-255,5738,55175,63,174287
6758,0.000666,172.31.40.0-255,66,55241,63,174287
6759,0.000692,172.217.194.0-255,5020,60261,63,174287
6760,0.000696,172.31.40.0-255,66,60327,63,174287
6761,0.000927,172.217.194.0-255,1484,61811,63,174287
6762,0.000944,172.217.194.0-255,2902,64713,63,174287
6763,0.000947,172.31.40.0-255,66,64779,63,174287
6764,0.000971,172.217.194.0-255,5738,70517,63,174287
6765,0.000974,172.31.40.0-255,66,70583,63,174287
6766,0.00098,172.217.194.0-255,4320,74903,63,174287
6767,0.000982,172.31.40.0-255,66,74969,63,174287
6768,0.001017,172.31.40.0-255,66,75035,63,174287
6769,0.001029,172.31.40.0-255,66,75101,63,174287
6770,0.001044,172.217.194.0-255,766,75867,63,174287
6771,0.001239,172.217.194.0-255,1484,77351,63,174287
6772,0.001244,172.31.40.0-255,66,77417,63,174287
6773,0.001248,172.217.194.0-255,1484,78901,63,174287
6774,0.001265,172.217.194.0-255,1484,80385,63,174287
6775,0.001267,172.31.40.0-255,66,80451,63,174287
6776,0.001274,172.217.194.0-255,5738,86189,63,174287
6777,0.001276,172.31.40.0-255,66,86255,63,174287
6778,0.001319,172.31.40.0-255,66,86321,63,174287
6779,0.001333,172.31.40.0-255,66,86387,63,174287
6780,0.001389,172.217.194.0-255,2902,89289,63,174287
6781,0.001391,172.31.40.0-255,66,89355,63,174287
6782,0.001412,172.217.194.0-255,4320,93675,63,174287
6783,0.001435,172.217.194.0-255,766,94441,63,174287
6784,0.001439,172.31.40.0-255,66,94507,63,174287
6785,0.001443,172.31.40.0-255,66,94573,63,174287
6786,0.001451,172.31.40.0-255,66,94639,63,174287
6787,0.001681,172.217.194.0-255,1484,96123,63,174287
6788,0.001687,172.31.40.0-255,66,96189,63,174287
6789,0.001693,172.217.194.0-255,2902,99091,63,174287
6790,0.001695,172.31.40.0-255,66,99157,63,174287
6791,0.001702,172.217.194.0-255,5738,104895,63,174287
6792,0.001704,172.31.40.0-255,66,104961,63,174287
6793,0.001718,172.217.194.0-255,2902,107863,63,174287
6794,0.00172,172.31.40.0-255,66,107929,63,174287
6795,0.00175,172.31.40.0-255,66,107995,63,174287
6796,0.001753,172.217.194.0-255,1484,109479,63,174287
6797,0.001788,172.31.40.0-255,66,109545,63,174287
6798,0.001794,172.217.194.0-255,4320,113865,63,174287
6799,0.001796,172.31.40.0-255,66,113931,63,174287
6800,0.001813,172.217.194.0-255,5738,119669,63,174287
6801,0.001816,172.31.40.0-255,66,119735,63,174287
6802,0.001856,172.31.40.0-255,66,119801,63,174287
6803,0.001878,172.217.194.0-255,2902,122703,63,174287
6804,0.001894,172.217.194.0-255,5020,127723,63,174287
6805,0.001898,172.31.40.0-255,66,127789,63,174287
6806,0.001901,172.31.40.0-255,66,127855,63,174287
6807,0.003996,172.217.194.0-255,5738,133593,63,174287
6808,0.004004,172.31.40.0-255,66,133659,63,174287
6809,0.006136,172.217.194.0-255,5738,139397,63,174287
6810,0.006153,172.31.40.0-255,66,139463,63,174287
6811,0.008294,172.217.194.0-255,5738,145201,63,174287
6812,0.008311,172.31.40.0-255,66,145267,63,174287
6813,0.010413,172.217.194.0-255,5738,151005,63,174287
6814,0.010431,172.31.40.0-255,66,151071,63,174287
6815,0.012519,172.217.194.0-255,5738,156809,63,174287
6816,0.012526,172.31.40.0-255,66,156875,63,174287
6817,0.014592,172.217.194.0-255,5738,162613,63,174287
6818,0.014601,172.31.40.0-255,66,162679,63,174287
6819,0.016712,172.217.194.0-255,5738,168417,63,174287
6820,0.016728,172.31.40.0-255,66,168483,63,174287
6821,0.018779,172.217.194.0-255,5738,174221,63,174287
6822,0.018785,172.31.40.0-255,66,174287,63,174287
6823,0.0,74.125.24.0-255,153,153,63,123414
6824,1.3e-05,172.31.40.0-255,66,219,63,123414
6825,2e-05,74.125.24.0-255,1484,1703,63,123414
6826,2.4e-05,172.31.40.0-255,66,1769,63,123414
6827,2.9e-05,74.125.24.0-255,2902,4671,63,123414
6828,3.2e-05,172.31.40.0-255,66,4737,63,123414
6829,3.8e-05,74.125.24.0-255,5738,10475,63,123414
6830,4.1e-05,172.31.40.0-255,66,10541,63,123414
6831,5.9e-05,74.125.24.0-255,1484,12025,63,123414
6832,6.1e-05,172.31.40.0-255,66,12091,63,123414
6833,0.000103,172.31.40.0-255,66,12157,63,123414
6834,0.000109,74.125.24.0-255,6797,18954,63,123414
6835,0.000112,172.31.40.0-255,66,19020,63,123414
6836,0.000165,74.125.24.0-255,1484,20504,63,123414
6837,0.000168,172.31.40.0-255,66,20570,63,123414
6838,0.000172,74.125.24.0-255,2902,23472,63,123414
6839,0.000174,172.31.40.0-255,66,23538,63,123414
6840,0.000187,74.125.24.0-255,5738,29276,63,123414
6841,0.00019,172.31.40.0-255,66,29342,63,123414
6842,0.000218,172.31.40.0-255,66,29408,63,123414
6843,0.000239,74.125.24.0-255,4320,33728,63,123414
6844,0.000241,172.31.40.0-255,66,33794,63,123414
6845,0.000247,74.125.24.0-255,7156,40950,63,123414
6846,0.000249,172.31.40.0-255,66,41016,63,123414
6847,0.000272,74.125.24.0-255,1484,42500,63,123414
6848,0.000274,172.31.40.0-255,66,42566,63,123414
6849,0.000288,74.125.24.0-255,2184,44750,63,123414
6850,0.000292,172.31.40.0-255,66,44816,63,123414
6851,0.000304,74.125.24.0-255,363,45179,63,123414
6852,0.000307,172.31.40.0-255,66,45245,63,123414
6853,0.000822,74.125.24.0-255,129,45374,63,123414
6854,0.001075,74.125.24.0-255,1484,46858,63,123414
6855,0.001082,172.31.40.0-255,66,46924,63,123414
6856,0.001089,74.125.24.0-255,2902,49826,63,123414
6857,0.001091,172.31.40.0-255,66,49892,63,123414
6858,0.001103,74.125.24.0-255,1484,51376,63,123414
6859,0.001125,74.125.24.0-255,4320,55696,63,123414
6860,0.001128,172.31.40.0-255,66,55762,63,123414
6861,0.001131,74.125.24.0-255,1484,57246,63,123414
6862,0.001158,172.31.40.0-255,66,57312,63,123414
6863,0.001203,172.31.40.0-255,66,57378,63,123414
6864,0.001221,74.125.24.0-255,2184,59562,63,123414
6865,0.001223,172.31.40.0-255,66,59628,63,123414
6866,0.001919,74.125.24.0-255,1484,61112,63,123414
6867,0.001926,74.125.24.0-255,2902,64014,63,123414
6868,0.001931,172.31.40.0-255,66,64080,63,123414
6869,0.001937,74.125.24.0-255,2902,66982,63,123414
6870,0.001939,172.31.40.0-255,66,67048,63,123414
6871,0.001967,74.125.24.0-255,2902,69950,63,123414
6872,0.00197,172.31.40.0-255,66,70016,63,123414
6873,0.001981,172.31.40.0-255,66,70082,63,123414
6874,0.002,74.125.24.0-255,4320,74402,63,123414
6875,0.002003,172.31.40.0-255,66,74468,63,123414
6876,0.002034,172.31.40.0-255,66,74534,63,123414
6877,0.002037,74.125.24.0-255,1484,76018,63,123414
6878,0.00204,74.125.24.0-255,766,76784,63,123414
6879,0.002042,172.31.40.0-255,66,76850,63,123414
6880,0.004053,74.125.24.0-255,2902,79752,63,123414
6881,0.00406,172.31.40.0-255,66,79818,63,123414
6882,0.004085,74.125.24.0-255,2902,82720,63,123414
6883,0.004087,172.31.40.0-255,66,82786,63,123414
6884,0.006093,74.125.24.0-255,5738,88524,63,123414
6885,0.0061,172.31.40.0-255,66,88590,63,123414
6886,0.008115,74.125.24.0-255,5738,94328,63,123414
6887,0.008119,172.31.40.0-255,66,94394,63,123414
6888,0.010163,74.125.24.0-255,5738,100132,63,123414
6889,0.010171,172.31.40.0-255,66,100198,63,123414
6890,0.012198,74.125.24.0-255,5738,105936,63,123414
6891,0.012206,172.31.40.0-255,66,106002,63,123414
6892,0.014209,74.125.24.0-255,5738,111740,63,123414
6893,0.014215,172.31.40.0-255,66,111806,63,123414
6894,0.016245,74.125.24.0-255,5738,117544,63,123414
6895,0.016252,172.31.40.0-255,66,117610,63,123414
6896,0.01825,74.125.24.0-255,5738,123348,63,123414
6897,0.018258,172.31.40.0-255,66,123414,63,123414
6898,0.0,172.217.194.0-255,150,150,63,175267
6899,2.1e-05,172.31.40.0-255,66,216,63,175267
6900,2.8e-05,172.217.194.0-255,1484,1700,63,175267
6901,3.4e-05,172.31.40.0-255,66,1766,63,175267
6902,4.7e-05,172.217.194.0-255,2902,4668,63,175267
6903,5e-05,172.31.40.0-255,66,4734,63,175267
6904,6.7e-05,172.217.194.0-255,7156,11890,63,175267
6905,7.1e-05,172.31.40.0-255,66,11956,63,175267
6906,7.6e-05,172.217.194.0-255,2009,13965,63,175267
6907,7.8e-05,172.31.40.0-255,66,14031,63,175267
6908,0.000119,172.217.194.0-255,2902,16933,63,175267
6909,0.000122,172.31.40.0-255,66,16999,63,175267
6910,0.000127,172.217.194.0-255,4320,21319,63,175267
6911,0.00013,172.31.40.0-255,66,21385,63,175267
6912,0.000135,172.217.194.0-255,4320,25705,63,175267
6913,0.000137,172.31.40.0-255,66,25771,63,175267
6914,0.000167,172.217.194.0-255,4320,30091,63,175267
6915,0.00017,172.31.40.0-255,66,30157,63,175267
6916,0.000178,172.217.194.0-255,1125,31282,63,175267
6917,0.000179,172.31.40.0-255,66,31348,63,175267
6918,0.000488,172.217.194.0-255,1484,32832,63,175267
6919,0.000495,172.31.40.0-255,66,32898,63,175267
6920,0.0005,172.217.194.0-255,2902,35800,63,175267
6921,0.000502,172.31.40.0-255,66,35866,63,175267
6922,0.000509,172.217.194.0-255,5738,41604,63,175267
6923,0.000511,172.31.40.0-255,66,41670,63,175267
6924,0.000559,172.217.194.0-255,6797,48467,63,175267
6925,0.000563,172.31.40.0-255,66,48533,63,175267
6926,0.001345,172.217.194.0-255,1484,50017,63,175267
6927,0.001352,172.31.40.0-255,66,50083,63,175267
6928,0.001362,172.217.194.0-255,2902,52985,63,175267
6929,0.001364,172.31.40.0-255,66,53051,63,175267
6930,0.001376,172.217.194.0-255,5738,58789,63,175267
6931,0.001379,172.31.40.0-255,66,58855,63,175267
6932,0.001386,172.217.194.0-255,4320,63175,63,175267
6933,0.001388,172.31.40.0-255,66,63241,63,175267
6934,0.001415,172.217.194.0-255,2543,65784,63,175267
6935,0.001417,172.31.40.0-255,66,65850,63,175267
6936,0.001468,172.217.194.0-255,1484,67334,63,175267
6937,0.001474,172.217.194.0-255,2902,70236,63,175267
6938,0.001477,172.31.40.0-255,66,70302,63,175267
6939,0.001504,172.217.194.0-255,5738,76040,63,175267
6940,0.001506,172.31.40.0-255,66,76106,63,175267
6941,0.00153,172.217.194.0-255,2902,79008,63,175267
6942,0.001532,172.31.40.0-255,66,79074,63,175267
6943,0.001571,172.31.40.0-255,66,79140,63,175267
6944,0.001583,172.31.40.0-255,66,79206,63,175267
6945,0.001623,172.217.194.0-255,1705,80911,63,175267
6946,0.001625,172.31.40.0-255,66,80977,63,175267
6947,0.001736,172.217.194.0-255,1484,82461,63,175267
6948,0.001741,172.217.194.0-255,1484,83945,63,175267
6949,0.001745,172.31.40.0-255,66,84011,63,175267
6950,0.001772,172.217.194.0-255,1484,85495,63,175267
6951,0.001775,172.217.194.0-255,1484,86979,63,175267
6952,0.001778,172.31.40.0-255,66,87045,63,175267
6953,0.001784,172.217.194.0-255,5738,92783,63,175267
6954,0.001787,172.31.40.0-255,66,92849,63,175267
6955,0.001804,172.31.40.0-255,66,92915,63,175267
6956,0.001831,172.217.194.0-255,1484,94399,63,175267
6957,0.001843,172.31.40.0-255,66,94465,63,175267
6958,0.001872,172.217.194.0-255,5738,100203,63,175267
6959,0.001874,172.31.40.0-255,66,100269,63,175267
6960,0.001881,172.217.194.0-255,7156,107425,63,175267
6961,0.001883,172.31.40.0-255,66,107491,63,175267
6962,0.001886,172.217.194.0-255,1484,108975,63,175267
6963,0.001922,172.31.40.0-255,66,109041,63,175267
6964,0.001929,172.217.194.0-255,6438,115479,63,175267
6965,0.001932,172.31.40.0-255,66,115545,63,175267
6966,0.002225,172.217.194.0-255,1484,117029,63,175267
6967,0.002229,172.217.194.0-255,1484,118513,63,175267
6968,0.002231,172.31.40.0-255,66,118579,63,175267
6969,0.002254,172.217.194.0-255,1484,120063,63,175267
6970,0.002261,172.217.194.0-255,5738,125801,63,175267
6971,0.002263,172.31.40.0-255,66,125867,63,175267
6972,0.00227,172.217.194.0-255,7156,133023,63,175267
6973,0.002273,172.31.40.0-255,66,133089,63,175267
6974,0.002296,172.217.194.0-255,1484,134573,63,175267
6975,0.002311,172.31.40.0-255,66,134639,63,175267
6976,0.004578,172.217.194.0-255,5738,140377,63,175267
6977,0.004584,172.31.40.0-255,66,140443,63,175267
6978,0.006864,172.217.194.0-255,5738,146181,63,175267
6979,0.006871,172.31.40.0-255,66,146247,63,175267
6980,0.009129,172.217.194.0-255,5738,151985,63,175267
6981,0.009137,172.31.40.0-255,66,152051,63,175267
6982,0.011421,172.217.194.0-255,5738,157789,63,175267
6983,0.01143,172.31.40.0-255,66,157855,63,175267
6984,0.0137,172.217.194.0-255,5738,163593,63,175267
6985,0.013708,172.31.40.0-255,66,163659,63,175267
6986,0.016,172.217.194.0-255,5738,169397,63,175267
6987,0.016008,172.31.40.0-255,66,169463,63,175267
6988,0.018273,172.217.194.0-255,5738,175201,63,175267
6989,0.01828,172.31.40.0-255,66,175267,63,175267
6990,0.0,74.125.24.0-255,156,156,63,171748
6991,2.4e-05,172.31.40.0-255,66,222,63,171748
6992,3.1e-05,74.125.24.0-255,1484,1706,63,171748
6993,3.6e-05,172.31.40.0-255,66,1772,63,171748
6994,5e-05,74.125.24.0-255,2902,4674,63,171748
6995,5.3e-05,172.31.40.0-255,66,4740,63,171748
6996,6.1e-05,74.125.24.0-255,7156,11896,63,171748
6997,6.4e-05,172.31.40.0-255,66,11962,63,171748
6998,6.9e-05,74.125.24.0-255,2134,14096,63,171748
6999,7.1e-05,172.31.40.0-255,66,14162,63,171748
7000,0.00012,172.31.40.0-255,66,14228,63,171748
7001,0.000126,74.125.24.0-255,5379,19607,63,171748
7002,0.000129,172.31.40.0-255,66,19673,63,171748
7003,0.00021,74.125.24.0-255,1484,21157,63,171748
7004,0.000213,172.31.40.0-255,66,21223,63,171748
7005,0.000244,74.125.24.0-255,2902,24125,63,171748
7006,0.000247,172.31.40.0-255,66,24191,63,171748
7007,0.000253,74.125.24.0-255,5738,29929,63,171748
7008,0.000255,172.31.40.0-255,66,29995,63,171748
7009,0.000258,74.125.24.0-255,1484,31479,63,171748
7010,0.00026,172.31.40.0-255,66,31545,63,171748
7011,0.000301,172.31.40.0-255,66,31611,63,171748
7012,0.000314,172.31.40.0-255,66,31677,63,171748
7013,0.000318,74.125.24.0-255,2184,33861,63,171748
7014,0.000321,172.31.40.0-255,66,33927,63,171748
7015,0.000345,74.125.24.0-255,363,34290,63,171748
7016,0.000348,172.31.40.0-255,66,34356,63,171748
7017,0.00049,74.125.24.0-255,1484,35840,63,171748
7018,0.000494,172.31.40.0-255,66,35906,63,171748
7019,0.0005,74.125.24.0-255,2902,38808,63,171748
7020,0.000502,172.31.40.0-255,66,38874,63,171748
7021,0.000513,74.125.24.0-255,5738,44612,63,171748
7022,0.000515,172.31.40.0-255,66,44678,63,171748
7023,0.000545,172.31.40.0-255,66,44744,63,171748
7024,0.000576,74.125.24.0-255,4252,48996,63,171748
7025,0.000579,172.31.40.0-255,66,49062,63,171748
7026,0.000592,172.31.40.0-255,66,49128,63,171748
7027,0.000686,74.125.24.0-255,1484,50612,63,171748
7028,0.000693,74.125.24.0-255,2902,53514,63,171748
7029,0.000696,172.31.40.0-255,66,53580,63,171748
7030,0.000699,74.125.24.0-255,1484,55064,63,171748
7031,0.00073,74.125.24.0-255,4320,59384,63,171748
7032,0.000733,172.31.40.0-255,66,59450,63,171748
7033,0.00074,74.125.24.0-255,5738,65188,63,171748
7034,0.000742,172.31.40.0-255,66,65254,63,171748
7035,0.000753,74.125.24.0-255,1484,66738,63,171748
7036,0.000794,172.31.40.0-255,66,66804,63,171748
7037,0.000798,74.125.24.0-255,1636,68440,63,171748
7038,0.000801,172.31.40.0-255,66,68506,63,171748
7039,0.000951,74.125.24.0-255,1484,69990,63,171748
7040,0.000973,74.125.24.0-255,2902,72892,63,171748
7041,0.000977,172.31.40.0-255,66,72958,63,171748
7042,0.000982,74.125.24.0-255,2902,75860,63,171748
7043,0.000984,172.31.40.0-255,66,75926,63,171748
7044,0.000997,74.125.24.0-255,7156,83082,63,171748
7045,0.000999,172.31.40.0-255,66,83148,63,171748
7046,0.001002,74.125.24.0-255,1484,84632,63,171748
7047,0.001053,172.31.40.0-255,66,84698,63,171748
7048,0.001058,74.125.24.0-255,3602,88300,63,171748
7049,0.001061,172.31.40.0-255,66,88366,63,171748
7050,0.001926,74.125.24.0-255,1484,89850,63,171748
7051,0.001933,74.125.24.0-255,2902,92752,63,171748
7052,0.001937,172.31.40.0-255,66,92818,63,171748
7053,0.001942,74.125.24.0-255,2902,95720,63,171748
7054,0.001944,172.31.40.0-255,66,95786,63,171748
7055,0.001967,74.125.24.0-255,2902,98688,63,171748
7056,0.001969,172.31.40.0-255,66,98754,63,171748
7057,0.001984,172.31.40.0-255,66,98820,63,171748
7058,0.002007,74.125.24.0-255,4320,103140,63,171748
7059,0.002009,172.31.40.0-255,66,103206,63,171748
7060,0.002016,74.125.24.0-255,5738,108944,63,171748
7061,0.002018,172.31.40.0-255,66,109010,63,171748
7062,0.00205,74.125.24.0-255,5020,114030,63,171748
7063,0.002053,172.31.40.0-255,66,114096,63,171748
7064,0.002536,74.125.24.0-255,1484,115580,63,171748
7065,0.002543,74.125.24.0-255,1484,117064,63,171748
7066,0.002546,172.31.40.0-255,66,117130,63,171748
7067,0.002576,74.125.24.0-255,1484,118614,63,171748
7068,0.002583,74.125.24.0-255,5738,124352,63,171748
7069,0.002585,172.31.40.0-255,66,124418,63,171748
7070,0.002589,74.125.24.0-255,1484,125902,63,171748
7071,0.002624,172.31.40.0-255,66,125968,63,171748
7072,0.002631,74.125.24.0-255,4320,130288,63,171748
7073,0.002633,172.31.40.0-255,66,130354,63,171748
7074,0.002653,74.125.24.0-255,1484,131838,63,171748
7075,0.002661,74.125.24.0-255,5020,136858,63,171748
7076,0.002663,172.31.40.0-255,66,136924,63,171748
7077,0.005296,74.125.24.0-255,5738,142662,63,171748
7078,0.005303,172.31.40.0-255,66,142728,63,171748
7079,0.007954,74.125.24.0-255,5738,148466,63,171748
7080,0.007961,172.31.40.0-255,66,148532,63,171748
7081,0.010627,74.125.24.0-255,5738,154270,63,171748
7082,0.010636,172.31.40.0-255,66,154336,63,171748
7083,0.013316,74.125.24.0-255,5738,160074,63,171748
7084,0.013334,172.31.40.0-255,66,160140,63,171748
7085,0.015978,74.125.24.0-255,5738,165878,63,171748
7086,0.015997,172.31.40.0-255,66,165944,63,171748
7087,0.01868,74.125.24.0-255,5738,171682,63,171748
7088,0.01869,172.31.40.0-255,66,171748,63,171748
7089,0.0,172.217.194.0-255,146,146,63,180582
7090,2.2e-05,172.31.40.0-255,66,212,63,180582
7091,2.9e-05,172.217.194.0-255,1484,1696,63,180582
7092,3.4e-05,172.31.40.0-255,66,1762,63,180582
7093,4e-05,172.217.194.0-255,2902,4664,63,180582
7094,4.3e-05,172.31.40.0-255,66,4730,63,180582
7095,5.1e-05,172.217.194.0-255,7156,11886,63,180582
7096,5.4e-05,172.31.40.0-255,66,11952,63,180582
7097,8e-05,172.217.194.0-255,2047,13999,63,180582
7098,8.2e-05,172.31.40.0-255,66,14065,63,180582
7099,0.000123,172.217.194.0-255,1484,15549,63,180582
7100,0.000125,172.31.40.0-255,66,15615,63,180582
7101,0.000146,172.217.194.0-255,2902,18517,63,180582
7102,0.000149,172.31.40.0-255,66,18583,63,180582
7103,0.000172,172.217.194.0-255,5738,24321,63,180582
7104,0.000174,172.31.40.0-255,66,24387,63,180582
7105,0.000181,172.217.194.0-255,6797,31184,63,180582
7106,0.000184,172.31.40.0-255,66,31250,63,180582
7107,0.000226,172.217.194.0-255,1484,32734,63,180582
7108,0.000228,172.31.40.0-255,66,32800,63,180582
7109,0.000254,172.31.40.0-255,66,32866,63,180582
7110,0.000276,172.217.194.0-255,2543,35409,63,180582
7111,0.000278,172.31.40.0-255,66,35475,63,180582
7112,0.000283,172.217.194.0-255,2902,38377,63,180582
7113,0.000285,172.31.40.0-255,66,38443,63,180582
7114,0.00031,172.217.194.0-255,7156,45599,63,180582
7115,0.000312,172.31.40.0-255,66,45665,63,180582
7116,0.000338,172.217.194.0-255,6797,52462,63,180582
7117,0.00034,172.31.40.0-255,66,52528,63,180582
7118,0.000357,172.217.194.0-255,340,52868,63,180582
7119,0.00036,172.31.40.0-255,66,52934,63,180582
7120,0.000645,172.217.194.0-255,403,53337,63,180582
7121,0.000697,172.217.194.0-255,1484,54821,63,180582
7122,0.000709,172.31.40.0-255,66,54887,63,180582
7123,0.000723,172.217.194.0-255,4320,59207,63,180582
7124,0.000735,172.217.194.0-255,2902,62109,63,180582
7125,0.000741,172.31.40.0-255,66,62175,63,180582
7126,0.000765,172.217.194.0-255,7156,69331,63,180582
7127,0.000768,172.217.194.0-255,1125,70456,63,180582
7128,0.000778,172.31.40.0-255,66,70522,63,180582
7129,0.000862,172.217.194.0-255,1484,72006,63,180582
7130,0.000867,172.217.194.0-255,2902,74908,63,180582
7131,0.000886,172.31.40.0-255,66,74974,63,180582
7132,0.000893,172.217.194.0-255,5738,80712,63,180582
7133,0.000898,172.31.40.0-255,66,80778,63,180582
7134,0.000957,172.217.194.0-255,5738,86516,63,180582
7135,0.000962,172.31.40.0-255,66,86582,63,180582
7136,0.001026,172.217.194.0-255,5738,92320,63,180582
7137,0.001059,172.31.40.0-255,66,92386,63,180582
7138,0.001068,172.217.194.0-255,4320,96706,63,180582
7139,0.001073,172.31.40.0-255,66,96772,63,180582
7140,0.001101,172.217.194.0-255,3602,100374,63,180582
7141,0.001105,172.217.194.0-255,2366,102740,63,180582
7142,0.001125,172.31.40.0-255,66,102806,63,180582
7143,0.001246,172.217.194.0-255,1484,104290,63,180582
7144,0.00125,172.217.194.0-255,1484,105774,63,180582
7145,0.001261,172.217.194.0-255,1484,107258,63,180582
7146,0.001264,172.217.194.0-255,1484,108742,63,180582
7147,0.001279,172.217.194.0-255,4320,113062,63,180582
7148,0.001282,172.31.40.0-255,66,113128,63,180582
7149,0.001291,172.217.194.0-255,2902,116030,63,180582
7150,0.001296,172.31.40.0-255,66,116096,63,180582
7151,0.001312,172.217.194.0-255,1484,117580,63,180582
7152,0.001328,172.31.40.0-255,66,117646,63,180582
7153,0.001349,172.31.40.0-255,66,117712,63,180582
7154,0.001382,172.217.194.0-255,1484,119196,63,180582
7155,0.001386,172.217.194.0-255,1484,120680,63,180582
7156,0.001403,172.217.194.0-255,1484,122164,63,180582
7157,0.001408,172.217.194.0-255,4320,126484,63,180582
7158,0.001414,172.31.40.0-255,66,126550,63,180582
7159,0.001423,172.217.194.0-255,1484,128034,63,180582
7160,0.001426,172.217.194.0-255,2902,130936,63,180582
7161,0.001449,172.217.194.0-255,4320,135256,63,180582
7162,0.001465,172.31.40.0-255,66,135322,63,180582
7163,0.001473,172.217.194.0-255,2902,138224,63,180582
7164,0.001476,172.217.194.0-255,2184,140408,63,180582
7165,0.001487,172.31.40.0-255,66,140474,63,180582
7166,0.001969,172.217.194.0-255,1484,141958,63,180582
7167,0.001991,172.217.194.0-255,2902,144860,63,180582
7168,0.001994,172.31.40.0-255,66,144926,63,180582
7169,0.001999,172.217.194.0-255,2902,147828,63,180582
7170,0.002015,172.217.194.0-255,2902,150730,63,180582
7171,0.00202,172.217.194.0-255,4320,155050,63,180582
7172,0.002027,172.31.40.0-255,66,155116,63,180582
7173,0.002096,172.217.194.0-255,2184,157300,63,180582
7174,0.008629,172.31.40.0-255,66,157366,63,180582
7175,0.010939,172.217.194.0-255,5738,163104,63,180582
7176,0.012192,172.31.40.0-255,66,163170,63,180582
7177,0.014485,172.217.194.0-255,5738,168908,63,180582
7178,0.014492,172.31.40.0-255,66,168974,63,180582
7179,0.016806,172.217.194.0-255,5738,174712,63,180582
7180,0.016826,172.31.40.0-255,66,174778,63,180582
7181,0.019112,172.217.194.0-255,5738,180516,63,180582
7182,0.019121,172.31.40.0-255,66,180582,63,180582
7183,0.0,74.125.24.0-255,296,296,63,238129
7184,2.1e-05,172.31.40.0-255,66,362,63,238129
7185,2.8e-05,74.125.24.0-255,1484,1846,63,238129
7186,3.2e-05,172.31.40.0-255,66,1912,63,238129
7187,3.9e-05,74.125.24.0-255,4320,6232,63,238129
7188,4.3e-05,172.31.40.0-255,66,6298,63,238129
7189,6.4e-05,172.31.40.0-255,66,6364,63,238129
7190,7e-05,74.125.24.0-255,5738,12102,63,238129
7191,7.3e-05,172.31.40.0-255,66,12168,63,238129
7192,9.4e-05,74.125.24.0-255,4320,16488,63,238129
7193,9.8e-05,172.31.40.0-255,66,16554,63,238129
7194,0.000121,74.125.24.0-255,5379,21933,63,238129
7195,0.000125,172.31.40.0-255,66,21999,63,238129
7196,0.000132,74.125.24.0-255,7156,29155,63,238129
7197,0.00014,172.31.40.0-255,66,29221,63,238129
7198,0.000158,74.125.24.0-255,2902,32123,63,238129
7199,0.00016,172.31.40.0-255,66,32189,63,238129
7200,0.000166,74.125.24.0-255,4320,36509,63,238129
7201,0.000168,172.31.40.0-255,66,36575,63,238129
7202,0.000253,74.125.24.0-255,2543,39118,63,238129
7203,0.000258,172.31.40.0-255,66,39184,63,238129
7204,0.000708,74.125.24.0-255,1484,40668,63,238129
7205,0.000714,172.31.40.0-255,66,40734,63,238129
7206,0.000721,74.125.24.0-255,2902,43636,63,238129
7207,0.000723,172.31.40.0-255,66,43702,63,238129
7208,0.000733,74.125.24.0-255,5738,49440,63,238129
7209,0.000735,172.31.40.0-255,66,49506,63,238129
7210,0.000763,74.125.24.0-255,6797,56303,63,238129
7211,0.000765,172.31.40.0-255,66,56369,63,238129
7212,0.000794,74.125.24.0-255,1484,57853,63,238129
7213,0.000796,172.31.40.0-255,66,57919,63,238129
7214,0.000799,74.125.24.0-255,1484,59403,63,238129
7215,0.000821,74.125.24.0-255,1484,60887,63,238129
7216,0.000823,172.31.40.0-255,66,60953,63,238129
7217,0.000829,74.125.24.0-255,5738,66691,63,238129
7218,0.000832,172.31.40.0-255,66,66757,63,238129
7219,0.000861,172.31.40.0-255,66,66823,63,238129
7220,0.000895,74.125.24.0-255,5379,72202,63,238129
7221,0.000898,172.31.40.0-255,66,72268,63,238129
7222,0.000908,172.31.40.0-255,66,72334,63,238129
7223,0.000911,74.125.24.0-255,1707,74041,63,238129
7224,0.000913,172.31.40.0-255,66,74107,63,238129
7225,0.001149,74.125.24.0-255,1484,75591,63,238129
7226,0.001154,74.125.24.0-255,2902,78493,63,238129
7227,0.001157,172.31.40.0-255,66,78559,63,238129
7228,0.001187,74.125.24.0-255,5738,84297,63,238129
7229,0.00119,172.31.40.0-255,66,84363,63,238129
7230,0.0012,172.31.40.0-255,66,84429,63,238129
7231,0.001235,74.125.24.0-255,4320,88749,63,238129
7232,0.001241,172.31.40.0-255,66,88815,63,238129
7233,0.001263,172.31.40.0-255,66,88881,63,238129
7234,0.001389,74.125.24.0-255,1484,90365,63,238129
7235,0.001395,74.125.24.0-255,2902,93267,63,238129
7236,0.001398,172.31.40.0-255,66,93333,63,238129
7237,0.001403,74.125.24.0-255,2902,96235,63,238129
7238,0.001404,172.31.40.0-255,66,96301,63,238129
7239,0.001438,74.125.24.0-255,2902,99203,63,238129
7240,0.001441,172.31.40.0-255,66,99269,63,238129
7241,0.001449,74.125.24.0-255,7156,106425,63,238129
7242,0.001451,172.31.40.0-255,66,106491,63,238129
7243,0.001464,172.31.40.0-255,66,106557,63,238129
7244,0.001467,74.125.24.0-255,2184,108741,63,238129
7245,0.00147,172.31.40.0-255,66,108807,63,238129
7246,0.001524,74.125.24.0-255,1484,110291,63,238129
7247,0.001528,74.125.24.0-255,2902,113193,63,238129
7248,0.001531,172.31.40.0-255,66,113259,63,238129
7249,0.001536,74.125.24.0-255,5738,118997,63,238129
7250,0.001538,172.31.40.0-255,66,119063,63,238129
7251,0.001578,172.31.40.0-255,66,119129,63,238129
7252,0.001587,172.31.40.0-255,66,119195,63,238129
7253,0.001609,74.125.24.0-255,1484,120679,63,238129
7254,0.001616,74.125.24.0-255,5020,125699,63,238129
7255,0.001618,172.31.40.0-255,66,125765,63,238129
7256,0.001624,74.125.24.0-255,5738,131503,63,238129
7257,0.001626,172.31.40.0-255,66,131569,63,238129
7258,0.001669,172.31.40.0-255,66,131635,63,238129
7259,0.001675,74.125.24.0-255,5738,137373,63,238129
7260,0.001677,172.31.40.0-255,66,137439,63,238129
7261,0.001703,74.125.24.0-255,5020,142459,63,238129
7262,0.001706,172.31.40.0-255,66,142525,63,238129
7263,0.001716,172.31.40.0-255,66,142591,63,238129
7264,0.001741,74.125.24.0-255,1484,144075,63,238129
7265,0.001746,74.125.24.0-255,5738,149813,63,238129
7266,0.001749,172.31.40.0-255,66,149879,63,238129
7267,0.001789,74.125.24.0-255,5738,155617,63,238129
7268,0.001791,172.31.40.0-255,66,155683,63,238129
7269,0.001825,172.31.40.0-255,66,155749,63,238129
7270,0.001827,74.125.24.0-255,1484,157233,63,238129
7271,0.001831,74.125.24.0-255,2902,160135,63,238129
7272,0.001833,172.31.40.0-255,66,160201,63,238129
7273,0.001839,74.125.24.0-255,5738,165939,63,238129
7274,0.001841,172.31.40.0-255,66,166005,63,238129
7275,0.00189,172.31.40.0-255,66,166071,63,238129
7276,0.001901,172.31.40.0-255,66,166137,63,238129
7277,0.001983,74.125.24.0-255,1484,167621,63,238129
7278,0.002003,74.125.24.0-255,2902,170523,63,238129
7279,0.002006,172.31.40.0-255,66,170589,63,238129
7280,0.00201,74.125.24.0-255,1484,172073,63,238129
7281,0.002036,74.125.24.0-255,4320,176393,63,238129
7282,0.002038,172.31.40.0-255,66,176459,63,238129
7283,0.002048,172.31.40.0-255,66,176525,63,238129
7284,0.002086,74.125.24.0-255,4320,180845,63,238129
7285,0.002088,172.31.40.0-255,66,180911,63,238129
7286,0.002114,172.31.40.0-255,66,180977,63,238129
7287,0.002148,74.125.24.0-255,1484,182461,63,238129
7288,0.002163,74.125.24.0-255,2902,185363,63,238129
7289,0.002165,172.31.40.0-255,66,185429,63,238129
7290,0.002178,74.125.24.0-255,2902,188331,63,238129
7291,0.00218,172.31.40.0-255,66,188397,63,238129
7292,0.002202,74.125.24.0-255,2902,191299,63,238129
7293,0.002207,172.31.40.0-255,66,191365,63,238129
7294,0.002214,74.125.24.0-255,7156,198521,63,238129
7295,0.002215,172.31.40.0-255,66,198587,63,238129
7296,0.002277,172.31.40.0-255,66,198653,63,238129
7297,0.002281,74.125.24.0-255,2184,200837,63,238129
7298,0.002282,172.31.40.0-255,66,200903,63,238129
7299,0.00454,74.125.24.0-255,5738,206641,63,238129
7300,0.004551,172.31.40.0-255,66,206707,63,238129
7301,0.006806,74.125.24.0-255,5738,212445,63,238129
7302,0.006818,172.31.40.0-255,66,212511,63,238129
7303,0.009102,74.125.24.0-255,5738,218249,63,238129
7304,0.00912,172.31.40.0-255,66,218315,63,238129
7305,0.011394,74.125.24.0-255,5738,224053,63,238129
7306,0.011402,172.31.40.0-255,66,224119,63,238129
7307,0.013684,74.125.24.0-255,5738,229857,63,238129
7308,0.013694,172.31.40.0-255,66,229923,63,238129
7309,0.015967,74.125.24.0-255,5738,235661,63,238129
7310,0.015973,172.31.40.0-255,66,235727,63,238129
7311,0.018274,74.125.24.0-255,2336,238063,63,238129
7312,0.018282,172.31.40.0-255,66,238129,63,238129
7313,0.0,74.125.200.0-255,153,153,63,167965
7314,2.4e-05,172.31.40.0-255,66,219,63,167965
7315,3.1e-05,74.125.200.0-255,1484,1703,63,167965
7316,3.5e-05,172.31.40.0-255,66,1769,63,167965
7317,4.1e-05,74.125.200.0-255,2902,4671,63,167965
7318,5.3e-05,172.31.40.0-255,66,4737,63,167965
7319,5.5e-05,74.125.200.0-255,1484,6221,63,167965
7320,5.8e-05,172.31.40.0-255,66,6287,63,167965
7321,6.3e-05,74.125.200.0-255,2902,9189,63,167965
7322,6.7e-05,172.31.40.0-255,66,9255,63,167965
7323,7.4e-05,74.125.200.0-255,6365,15620,63,167965
7324,7.7e-05,172.31.40.0-255,66,15686,63,167965
7325,8.3e-05,74.125.200.0-255,5738,21424,63,167965
7326,8.6e-05,172.31.40.0-255,66,21490,63,167965
7327,9.4e-05,74.125.200.0-255,7156,28646,63,167965
7328,9.6e-05,172.31.40.0-255,66,28712,63,167965
7329,0.000132,74.125.200.0-255,2543,31255,63,167965
7330,0.00014,172.31.40.0-255,66,31321,63,167965
7331,0.000165,74.125.200.0-255,1484,32805,63,167965
7332,0.000168,172.31.40.0-255,66,32871,63,167965
7333,0.000179,74.125.200.0-255,1484,34355,63,167965
7334,0.000181,172.31.40.0-255,66,34421,63,167965
7335,0.000206,74.125.200.0-255,1484,35905,63,167965
7336,0.000208,172.31.40.0-255,66,35971,63,167965
7337,0.000215,74.125.200.0-255,5738,41709,63,167965
7338,0.000217,172.31.40.0-255,66,41775,63,167965
7339,0.000222,74.125.200.0-255,2902,44677,63,167965
7340,0.000224,172.31.40.0-255,66,44743,63,167965
7341,0.000229,74.125.200.0-255,3961,48704,63,167965
7342,0.000231,172.31.40.0-255,66,48770,63,167965
7343,0.000266,172.31.40.0-255,66,48836,63,167965
7344,0.000272,74.125.200.0-255,4320,53156,63,167965
7345,0.000274,172.31.40.0-255,66,53222,63,167965
7346,0.000301,74.125.200.0-255,1484,54706,63,167965
7347,0.000324,74.125.200.0-255,2898,57604,63,167965
7348,0.000327,172.31.40.0-255,66,57670,63,167965
7349,0.00061,74.125.200.0-255,333,58003,63,167965
7350,0.001019,74.125.200.0-255,1484,59487,63,167965
7351,0.001026,172.31.40.0-255,66,59553,63,167965
7352,0.001037,74.125.200.0-255,1484,61037,63,167965
7353,0.001052,74.125.200.0-255,1484,62521,63,167965
7354,0.001055,172.31.40.0-255,66,62587,63,167965
7355,0.001058,74.125.200.0-255,1484,64071,63,167965
7356,0.001087,74.125.200.0-255,4320,68391,63,167965
7357,0.00109,172.31.40.0-255,66,68457,63,167965
7358,0.001095,74.125.200.0-255,4320,72777,63,167965
7359,0.001098,172.31.40.0-255,66,72843,63,167965
7360,0.001116,74.125.200.0-255,2543,75386,63,167965
7361,0.001118,74.125.200.0-255,1484,76870,63,167965
7362,0.001124,172.31.40.0-255,66,76936,63,167965
7363,0.001139,74.125.200.0-255,2902,79838,63,167965
7364,0.001141,172.31.40.0-255,66,79904,63,167965
7365,0.00117,74.125.200.0-255,5738,85642,63,167965
7366,0.001173,172.31.40.0-255,66,85708,63,167965
7367,0.001176,74.125.200.0-255,1484,87192,63,167965
7368,0.001207,74.125.200.0-255,2902,90094,63,167965
7369,0.001209,172.31.40.0-255,66,90160,63,167965
7370,0.001237,74.125.200.0-255,2543,92703,63,167965
7371,0.001239,172.31.40.0-255,66,92769,63,167965
7372,0.001796,74.125.200.0-255,1484,94253,63,167965
7373,0.001806,74.125.200.0-255,2902,97155,63,167965
7374,0.00181,172.31.40.0-255,66,97221,63,167965
7375,0.001825,74.125.200.0-255,1484,98705,63,167965
7376,0.001841,74.125.200.0-255,1484,100189,63,167965
7377,0.001844,172.31.40.0-255,66,100255,63,167965
7378,0.001849,74.125.200.0-255,4320,104575,63,167965
7379,0.001851,172.31.40.0-255,66,104641,63,167965
7380,0.001857,74.125.200.0-255,4320,108961,63,167965
7381,0.001864,172.31.40.0-255,66,109027,63,167965
7382,0.001889,74.125.200.0-255,4320,113347,63,167965
7383,0.001892,172.31.40.0-255,66,113413,63,167965
7384,0.001898,74.125.200.0-255,4320,117733,63,167965
7385,0.0019,172.31.40.0-255,66,117799,63,167965
7386,0.001907,74.125.200.0-255,5738,123537,63,167965
7387,0.001909,172.31.40.0-255,66,123603,63,167965
7388,0.001954,74.125.200.0-255,3602,127205,63,167965
7389,0.001957,172.31.40.0-255,66,127271,63,167965
7390,0.004156,74.125.200.0-255,1484,128755,63,167965
7391,0.0042,74.125.200.0-255,4320,133075,63,167965
7392,0.004205,172.31.40.0-255,66,133141,63,167965
7393,0.006468,74.125.200.0-255,5738,138879,63,167965
7394,0.006474,172.31.40.0-255,66,138945,63,167965
7395,0.008748,74.125.200.0-255,5738,144683,63,167965
7396,0.008755,172.31.40.0-255,66,144749,63,167965
7397,0.01102,74.125.200.0-255,5738,150487,63,167965
7398,0.01103,172.31.40.0-255,66,150553,63,167965
7399,0.013292,74.125.200.0-255,5738,156291,63,167965
7400,0.013299,172.31.40.0-255,66,156357,63,167965
7401,0.015565,74.125.200.0-255,5738,162095,63,167965
7402,0.015575,172.31.40.0-255,66,162161,63,167965
7403,0.017828,74.125.200.0-255,5738,167899,63,167965
7404,0.017835,172.31.40.0-255,66,167965,63,167965
7405,0.0,172.217.194.0-255,153,153,63,182037
7406,1.5e-05,172.31.40.0-255,66,219,63,182037
7407,2.2e-05,172.217.194.0-255,1484,1703,63,182037
7408,2.7e-05,172.31.40.0-255,66,1769,63,182037
7409,3.2e-05,172.217.194.0-255,2902,4671,63,182037
7410,3.5e-05,172.31.40.0-255,66,4737,63,182037
7411,4.1e-05,172.217.194.0-255,4320,9057,63,182037
7412,4.4e-05,172.31.40.0-255,66,9123,63,182037
7413,6.7e-05,172.217.194.0-255,2902,12025,63,182037
7414,7e-05,172.31.40.0-255,66,12091,63,182037
7415,7.4e-05,172.217.194.0-255,1998,14089,63,182037
7416,7.7e-05,172.31.40.0-255,66,14155,63,182037
7417,0.000173,172.217.194.0-255,1484,15639,63,182037
7418,0.000176,172.31.40.0-255,66,15705,63,182037
7419,0.000183,172.217.194.0-255,2902,18607,63,182037
7420,0.000186,172.31.40.0-255,66,18673,63,182037
7421,0.000204,172.217.194.0-255,5738,24411,63,182037
7422,0.000207,172.31.40.0-255,66,24477,63,182037
7423,0.000246,172.217.194.0-255,4320,28797,63,182037
7424,0.000248,172.31.40.0-255,66,28863,63,182037
7425,0.000266,172.217.194.0-255,2543,31406,63,182037
7426,0.000268,172.31.40.0-255,66,31472,63,182037
7427,0.000336,172.217.194.0-255,1484,32956,63,182037
7428,0.000339,172.31.40.0-255,66,33022,63,182037
7429,0.000345,172.217.194.0-255,2902,35924,63,182037
7430,0.000347,172.31.40.0-255,66,35990,63,182037
7431,0.000366,172.217.194.0-255,5738,41728,63,182037
7432,0.000369,172.31.40.0-255,66,41794,63,182037
7433,0.000402,172.31.40.0-255,66,41860,63,182037
7434,0.000416,172.217.194.0-255,2902,44762,63,182037
7435,0.000418,172.31.40.0-255,66,44828,63,182037
7436,0.000447,172.31.40.0-255,66,44894,63,182037
7437,0.000504,172.217.194.0-255,363,45257,63,182037
7438,0.000784,172.217.194.0-255,1484,46741,63,182037
7439,0.000789,172.31.40.0-255,66,46807,63,182037
7440,0.000795,172.217.194.0-255,2902,49709,63,182037
7441,0.000797,172.31.40.0-255,66,49775,63,182037
7442,0.000818,172.217.194.0-255,4320,54095,63,182037
7443,0.000821,172.31.40.0-255,66,54161,63,182037
7444,0.000838,172.217.194.0-255,1484,55645,63,182037
7445,0.000846,172.217.194.0-255,7156,62801,63,182037
7446,0.000848,172.31.40.0-255,66,62867,63,182037
7447,0.000885,172.217.194.0-255,5738,68605,63,182037
7448,0.000888,172.31.40.0-255,66,68671,63,182037
7449,0.000919,172.31.40.0-255,66,68737,63,182037
7450,0.000923,172.217.194.0-255,2184,70921,63,182037
7451,0.000926,172.31.40.0-255,66,70987,63,182037
7452,0.001532,172.217.194.0-255,1484,72471,63,182037
7453,0.00154,172.217.194.0-255,1484,73955,63,182037
7454,0.001545,172.31.40.0-255,66,74021,63,182037
7455,0.00157,172.217.194.0-255,1484,75505,63,182037
7456,0.001578,172.217.194.0-255,5738,81243,63,182037
7457,0.00158,172.31.40.0-255,66,81309,63,182037
7458,0.001587,172.217.194.0-255,5738,87047,63,182037
7459,0.001589,172.31.40.0-255,66,87113,63,182037
7460,0.001612,172.217.194.0-255,7156,94269,63,182037
7461,0.001616,172.31.40.0-255,66,94335,63,182037
7462,0.001648,172.217.194.0-255,7156,101491,63,182037
7463,0.001649,172.31.40.0-255,66,101557,63,182037
7464,0.001663,172.217.194.0-255,2902,104459,63,182037
7465,0.001666,172.31.40.0-255,66,104525,63,182037
7466,0.001685,172.217.194.0-255,766,105291,63,182037
7467,0.001947,172.217.194.0-255,1484,106775,63,182037
7468,0.001954,172.31.40.0-255,66,106841,63,182037
7469,0.001961,172.217.194.0-255,2902,109743,63,182037
7470,0.001963,172.31.40.0-255,66,109809,63,182037
7471,0.001976,172.217.194.0-255,1484,111293,63,182037
7472,0.001996,172.217.194.0-255,4320,115613,63,182037
7473,0.001998,172.31.40.0-255,66,115679,63,182037
7474,0.00204,172.31.40.0-255,66,115745,63,182037
7475,0.002047,172.217.194.0-255,5738,121483,63,182037
7476,0.002049,172.31.40.0-255,66,121549,63,182037
7477,0.002068,172.217.194.0-255,5020,126569,63,182037
7478,0.002071,172.31.40.0-255,66,126635,63,182037
7479,0.002114,172.217.194.0-255,1484,128119,63,182037
7480,0.002119,172.217.194.0-255,2902,131021,63,182037
7481,0.002122,172.31.40.0-255,66,131087,63,182037
7482,0.002129,172.217.194.0-255,5738,136825,63,182037
7483,0.002132,172.31.40.0-255,66,136891,63,182037
7484,0.002137,172.217.194.0-255,4320,141211,63,182037
7485,0.002139,172.31.40.0-255,66,141277,63,182037
7486,0.002168,172.31.40.0-255,66,141343,63,182037
7487,0.00218,172.31.40.0-255,66,141409,63,182037
7488,0.004454,172.217.194.0-255,5738,147147,63,182037
7489,0.004459,172.31.40.0-255,66,147213,63,182037
7490,0.006774,172.217.194.0-255,5738,152951,63,182037
7491,0.006778,172.31.40.0-255,66,153017,63,182037
7492,0.00911,172.217.194.0-255,5738,158755,63,182037
7493,0.009118,172.31.40.0-255,66,158821,63,182037
7494,0.011431,172.217.194.0-255,5738,164559,63,182037
7495,0.011439,172.31.40.0-255,66,164625,63,182037
7496,0.013723,172.217.194.0-255,5738,170363,63,182037
7497,0.01373,172.31.40.0-255,66,170429,63,182037
7498,0.016016,172.217.194.0-255,5738,176167,63,182037
7499,0.016023,172.31.40.0-255,66,176233,63,182037
7500,0.018313,172.217.194.0-255,5738,181971,63,182037
7501,0.018323,172.31.40.0-255,66,182037,63,182037
7502,0.0,172.217.27.0-255,152,152,63,145469
7503,1.6e-05,172.31.40.0-255,66,218,63,145469
7504,2.3e-05,172.217.27.0-255,1484,1702,63,145469
7505,2.7e-05,172.31.40.0-255,66,1768,63,145469
7506,3.2e-05,172.217.27.0-255,2902,4670,63,145469
7507,3.4e-05,172.31.40.0-255,66,4736,63,145469
7508,4.1e-05,172.217.27.0-255,5738,10474,63,145469
7509,4.4e-05,172.31.40.0-255,66,10540,63,145469
7510,4.7e-05,172.217.27.0-255,1484,12024,63,145469
7511,4.9e-05,172.31.40.0-255,66,12090,63,145469
7512,7e-05,172.217.27.0-255,4838,16928,63,145469
7513,7.3e-05,172.31.40.0-255,66,16994,63,145469
7514,8.4e-05,172.31.40.0-255,66,17060,63,145469
7515,0.000101,172.217.27.0-255,3961,21021,63,145469
7516,0.000103,172.31.40.0-255,66,21087,63,145469
7517,0.000166,172.217.27.0-255,1484,22571,63,145469
7518,0.000169,172.31.40.0-255,66,22637,63,145469
7519,0.000173,172.217.27.0-255,2902,25539,63,145469
7520,0.000175,172.31.40.0-255,66,25605,63,145469
7521,0.000195,172.217.27.0-255,2902,28507,63,145469
7522,0.000197,172.31.40.0-255,66,28573,63,145469
7523,0.000218,172.217.27.0-255,1484,30057,63,145469
7524,0.00022,172.31.40.0-255,66,30123,63,145469
7525,0.000226,172.217.27.0-255,5738,35861,63,145469
7526,0.000228,172.31.40.0-255,66,35927,63,145469
7527,0.000256,172.31.40.0-255,66,35993,63,145469
7528,0.000273,172.217.27.0-255,2543,38536,63,145469
7529,0.000275,172.31.40.0-255,66,38602,63,145469
7530,0.000301,172.217.27.0-255,6797,45399,63,145469
7531,0.000303,172.31.40.0-255,66,45465,63,145469
7532,0.000407,172.217.27.0-255,392,45857,63,145469
7533,0.000735,172.217.27.0-255,115,45972,63,145469
7534,0.000869,172.217.27.0-255,1484,47456,63,145469
7535,0.000873,172.31.40.0-255,66,47522,63,145469
7536,0.000876,172.217.27.0-255,1484,49006,63,145469
7537,0.000893,172.217.27.0-255,2902,51908,63,145469
7538,0.000894,172.31.40.0-255,66,51974,63,145469
7539,0.000916,172.217.27.0-255,5738,57712,63,145469
7540,0.000918,172.31.40.0-255,66,57778,63,145469
7541,0.000946,172.31.40.0-255,66,57844,63,145469
7542,0.000981,172.217.27.0-255,5738,63582,63,145469
7543,0.000984,172.31.40.0-255,66,63648,63,145469
7544,0.000998,172.217.27.0-255,5379,69027,63,145469
7545,0.001,172.31.40.0-255,66,69093,63,145469
7546,0.001307,172.217.27.0-255,1484,70577,63,145469
7547,0.001313,172.217.27.0-255,1484,72061,63,145469
7548,0.001317,172.31.40.0-255,66,72127,63,145469
7549,0.001336,172.217.27.0-255,1484,73611,63,145469
7550,0.001341,172.217.27.0-255,4320,77931,63,145469
7551,0.001342,172.31.40.0-255,66,77997,63,145469
7552,0.001345,172.217.27.0-255,1484,79481,63,145469
7553,0.001361,172.217.27.0-255,4320,83801,63,145469
7554,0.001362,172.31.40.0-255,66,83867,63,145469
7555,0.001415,172.31.40.0-255,66,83933,63,145469
7556,0.001424,172.31.40.0-255,66,83999,63,145469
7557,0.001633,172.217.27.0-255,1484,85483,63,145469
7558,0.003036,172.217.27.0-255,4320,89803,63,145469
7559,0.003044,172.31.40.0-255,66,89869,63,145469
7560,0.004652,172.217.27.0-255,2902,92771,63,145469
7561,0.004655,172.31.40.0-255,66,92837,63,145469
7562,0.004674,172.217.27.0-255,2902,95739,63,145469
7563,0.004676,172.31.40.0-255,66,95805,63,145469
7564,0.006261,172.217.27.0-255,2902,98707,63,145469
7565,0.006266,172.31.40.0-255,66,98773,63,145469
7566,0.006286,172.217.27.0-255,2902,101675,63,145469
7567,0.006289,172.31.40.0-255,66,101741,63,145469
7568,0.007886,172.217.27.0-255,4320,106061,63,145469
7569,0.007891,172.31.40.0-255,66,106127,63,145469
7570,0.007908,172.217.27.0-255,1484,107611,63,145469
7571,0.009508,172.217.27.0-255,4320,111931,63,145469
7572,0.009514,172.31.40.0-255,66,111997,63,145469
7573,0.011138,172.217.27.0-255,5738,117735,63,145469
7574,0.011145,172.31.40.0-255,66,117801,63,145469
7575,0.012765,172.217.27.0-255,5738,123539,63,145469
7576,0.012773,172.31.40.0-255,66,123605,63,145469
7577,0.014396,172.217.27.0-255,5738,129343,63,145469
7578,0.014404,172.31.40.0-255,66,129409,63,145469
7579,0.016029,172.217.27.0-255,4320,133729,63,145469
7580,0.016034,172.31.40.0-255,66,133795,63,145469
7581,0.016055,172.217.27.0-255,1484,135279,63,145469
7582,0.017654,172.217.27.0-255,4320,139599,63,145469
7583,0.017661,172.31.40.0-255,66,139665,63,145469
7584,0.019283,172.217.27.0-255,5738,145403,63,145469
7585,0.019292,172.31.40.0-255,66,145469,63,145469
7586,0.0,74.125.24.0-255,153,153,63,229156
7587,2e-05,172.31.40.0-255,66,219,63,229156
7588,2.6e-05,74.125.24.0-255,1484,1703,63,229156
7589,3.1e-05,172.31.40.0-255,66,1769,63,229156
7590,3.7e-05,74.125.24.0-255,2902,4671,63,229156
7591,4.1e-05,172.31.40.0-255,66,4737,63,229156
7592,4.7e-05,74.125.24.0-255,5738,10475,63,229156
7593,5e-05,172.31.40.0-255,66,10541,63,229156
7594,0.000104,172.31.40.0-255,66,10607,63,229156
7595,0.00012,74.125.24.0-255,4903,15510,63,229156
7596,0.000123,172.31.40.0-255,66,15576,63,229156
7597,0.000128,74.125.24.0-255,2902,18478,63,229156
7598,0.00013,172.31.40.0-255,66,18544,63,229156
7599,0.000153,74.125.24.0-255,3961,22505,63,229156
7600,0.000156,172.31.40.0-255,66,22571,63,229156
7601,0.000263,74.125.24.0-255,1484,24055,63,229156
7602,0.000267,172.31.40.0-255,66,24121,63,229156
7603,0.000273,74.125.24.0-255,2902,27023,63,229156
7604,0.000276,172.31.40.0-255,66,27089,63,229156
7605,0.000299,74.125.24.0-255,5738,32827,63,229156
7606,0.000302,172.31.40.0-255,66,32893,63,229156
7607,0.000305,74.125.24.0-255,1484,34377,63,229156
7608,0.000307,172.31.40.0-255,66,34443,63,229156
7609,0.000346,172.31.40.0-255,66,34509,63,229156
7610,0.000374,74.125.24.0-255,4320,38829,63,229156
7611,0.000377,172.31.40.0-255,66,38895,63,229156
7612,0.000407,172.31.40.0-255,66,38961,63,229156
7613,0.00041,74.125.24.0-255,380,39341,63,229156
7614,0.000412,172.31.40.0-255,66,39407,63,229156
7615,0.00045,74.125.24.0-255,1484,40891,63,229156
7616,0.000472,74.125.24.0-255,2902,43793,63,229156
7617,0.000475,172.31.40.0-255,66,43859,63,229156
7618,0.000478,74.125.24.0-255,1484,45343,63,229156
7619,0.000496,74.125.24.0-255,4320,49663,63,229156
7620,0.000499,172.31.40.0-255,66,49729,63,229156
7621,0.000522,74.125.24.0-255,5738,55467,63,229156
7622,0.000525,172.31.40.0-255,66,55533,63,229156
7623,0.000527,74.125.24.0-255,575,56108,63,229156
7624,0.000622,74.125.24.0-255,1484,57592,63,229156
7625,0.000626,172.31.40.0-255,66,57658,63,229156
7626,0.000631,74.125.24.0-255,2902,60560,63,229156
7627,0.000633,172.31.40.0-255,66,60626,63,229156
7628,0.000639,74.125.24.0-255,5738,66364,63,229156
7629,0.000642,172.31.40.0-255,66,66430,63,229156
7630,0.000648,74.125.24.0-255,4320,70750,63,229156
7631,0.00065,172.31.40.0-255,66,70816,63,229156
7632,0.000693,74.125.24.0-255,2543,73359,63,229156
7633,0.000696,172.31.40.0-255,66,73425,63,229156
7634,0.000735,74.125.24.0-255,2902,76327,63,229156
7635,0.00074,172.31.40.0-255,66,76393,63,229156
7636,0.000755,74.125.24.0-255,1484,77877,63,229156
7637,0.000758,74.125.24.0-255,1484,79361,63,229156
7638,0.00076,172.31.40.0-255,66,79427,63,229156
7639,0.000778,74.125.24.0-255,4320,83747,63,229156
7640,0.000783,172.31.40.0-255,66,83813,63,229156
7641,0.000799,74.125.24.0-255,1484,85297,63,229156
7642,0.000816,74.125.24.0-255,5379,90676,63,229156
7643,0.000819,172.31.40.0-255,66,90742,63,229156
7644,0.001058,74.125.24.0-255,1484,92226,63,229156
7645,0.001074,74.125.24.0-255,2902,95128,63,229156
7646,0.001076,172.31.40.0-255,66,95194,63,229156
7647,0.001079,74.125.24.0-255,1484,96678,63,229156
7648,0.0011,74.125.24.0-255,4320,100998,63,229156
7649,0.001102,172.31.40.0-255,66,101064,63,229156
7650,0.001108,74.125.24.0-255,5738,106802,63,229156
7651,0.00111,172.31.40.0-255,66,106868,63,229156
7652,0.001142,74.125.24.0-255,5738,112606,63,229156
7653,0.001144,172.31.40.0-255,66,112672,63,229156
7654,0.001171,74.125.24.0-255,7156,119828,63,229156
7655,0.001173,172.31.40.0-255,66,119894,63,229156
7656,0.001178,74.125.24.0-255,2902,122796,63,229156
7657,0.001179,172.31.40.0-255,66,122862,63,229156
7658,0.001206,74.125.24.0-255,2184,125046,63,229156
7659,0.001209,172.31.40.0-255,66,125112,63,229156
7660,0.001378,74.125.24.0-255,1484,126596,63,229156
7661,0.001382,74.125.24.0-255,1484,128080,63,229156
7662,0.001385,172.31.40.0-255,66,128146,63,229156
7663,0.001406,74.125.24.0-255,1484,129630,63,229156
7664,0.001412,74.125.24.0-255,5738,135368,63,229156
7665,0.001415,172.31.40.0-255,66,135434,63,229156
7666,0.001417,74.125.24.0-255,1484,136918,63,229156
7667,0.001438,74.125.24.0-255,4320,141238,63,229156
7668,0.00144,172.31.40.0-255,66,141304,63,229156
7669,0.001461,74.125.24.0-255,4320,145624,63,229156
7670,0.001464,172.31.40.0-255,66,145690,63,229156
7671,0.001469,74.125.24.0-255,4320,150010,63,229156
7672,0.001471,172.31.40.0-255,66,150076,63,229156
7673,0.001492,172.31.40.0-255,66,150142,63,229156
7674,0.001673,74.125.24.0-255,1484,151626,63,229156
7675,0.001678,74.125.24.0-255,1484,153110,63,229156
7676,0.001681,172.31.40.0-255,66,153176,63,229156
7677,0.001702,74.125.24.0-255,1484,154660,63,229156
7678,0.001709,74.125.24.0-255,5738,160398,63,229156
7679,0.001712,172.31.40.0-255,66,160464,63,229156
7680,0.001719,74.125.24.0-255,5738,166202,63,229156
7681,0.001721,172.31.40.0-255,66,166268,63,229156
7682,0.001738,74.125.24.0-255,2902,169170,63,229156
7683,0.001741,172.31.40.0-255,66,169236,63,229156
7684,0.001769,74.125.24.0-255,2902,172138,63,229156
7685,0.001771,172.31.40.0-255,66,172204,63,229156
7686,0.001808,172.31.40.0-255,66,172270,63,229156
7687,0.001877,74.125.24.0-255,1484,173754,63,229156
7688,0.001882,74.125.24.0-255,2902,176656,63,229156
7689,0.001885,172.31.40.0-255,66,176722,63,229156
7690,0.001888,74.125.24.0-255,1484,178206,63,229156
7691,0.001911,74.125.24.0-255,4320,182526,63,229156
7692,0.001914,172.31.40.0-255,66,182592,63,229156
7693,0.001926,172.31.40.0-255,66,182658,63,229156
7694,0.002008,172.31.40.0-255,66,182724,63,229156
7695,0.004069,74.125.24.0-255,5738,188462,63,229156
7696,0.004076,172.31.40.0-255,66,188528,63,229156
7697,0.006146,74.125.24.0-255,5738,194266,63,229156
7698,0.00616,172.31.40.0-255,66,194332,63,229156
7699,0.008265,74.125.24.0-255,5738,200070,63,229156
7700,0.008271,172.31.40.0-255,66,200136,63,229156
7701,0.010309,74.125.24.0-255,5738,205874,63,229156
7702,0.010312,172.31.40.0-255,66,205940,63,229156
7703,0.012356,74.125.24.0-255,5738,211678,63,229156
7704,0.012362,172.31.40.0-255,66,211744,63,229156
7705,0.014405,74.125.24.0-255,5738,217482,63,229156
7706,0.014417,172.31.40.0-255,66,217548,63,229156
7707,0.016513,74.125.24.0-255,5738,223286,63,229156
7708,0.016523,172.31.40.0-255,66,223352,63,229156
7709,0.018592,74.125.24.0-255,5738,229090,63,229156
7710,0.018606,172.31.40.0-255,66,229156,63,229156
7711,0.0,74.125.24.0-255,153,153,63,181322
7712,2.5e-05,172.31.40.0-255,66,219,63,181322
7713,3.3e-05,74.125.24.0-255,1484,1703,63,181322
7714,3.8e-05,172.31.40.0-255,66,1769,63,181322
7715,4.3e-05,74.125.24.0-255,2902,4671,63,181322
7716,4.7e-05,172.31.40.0-255,66,4737,63,181322
7717,5.3e-05,74.125.24.0-255,5738,10475,63,181322
7718,5.6e-05,172.31.40.0-255,66,10541,63,181322
7719,8.3e-05,74.125.24.0-255,3520,14061,63,181322
7720,8.6e-05,172.31.40.0-255,66,14127,63,181322
7721,0.000272,74.125.24.0-255,1484,15611,63,181322
7722,0.000278,172.31.40.0-255,66,15677,63,181322
7723,0.000299,74.125.24.0-255,2902,18579,63,181322
7724,0.000302,172.31.40.0-255,66,18645,63,181322
7725,0.000306,74.125.24.0-255,2902,21547,63,181322
7726,0.000309,172.31.40.0-255,66,21613,63,181322
7727,0.000325,74.125.24.0-255,5738,27351,63,181322
7728,0.000328,172.31.40.0-255,66,27417,63,181322
7729,0.000347,74.125.24.0-255,1484,28901,63,181322
7730,0.000349,172.31.40.0-255,66,28967,63,181322
7731,0.000355,74.125.24.0-255,4320,33287,63,181322
7732,0.000357,172.31.40.0-255,66,33353,63,181322
7733,0.000393,172.31.40.0-255,66,33419,63,181322
7734,0.000436,172.31.40.0-255,66,33485,63,181322
7735,0.000454,74.125.24.0-255,2902,36387,63,181322
7736,0.000456,172.31.40.0-255,66,36453,63,181322
7737,0.000463,74.125.24.0-255,5020,41473,63,181322
7738,0.000465,172.31.40.0-255,66,41539,63,181322
7739,0.000725,74.125.24.0-255,393,41932,63,181322
7740,0.000734,172.31.40.0-255,66,41998,63,181322
7741,0.000881,74.125.24.0-255,117,42115,63,181322
7742,0.000913,74.125.24.0-255,1484,43599,63,181322
7743,0.000917,172.31.40.0-255,66,43665,63,181322
7744,0.000922,74.125.24.0-255,2902,46567,63,181322
7745,0.000924,172.31.40.0-255,66,46633,63,181322
7746,0.000951,74.125.24.0-255,7156,53789,63,181322
7747,0.000954,172.31.40.0-255,66,53855,63,181322
7748,0.000967,74.125.24.0-255,1484,55339,63,181322
7749,0.000997,172.31.40.0-255,66,55405,63,181322
7750,0.001018,74.125.24.0-255,4320,59725,63,181322
7751,0.001021,172.31.40.0-255,66,59791,63,181322
7752,0.001052,172.31.40.0-255,66,59857,63,181322
7753,0.001624,74.125.24.0-255,1484,61341,63,181322
7754,0.001633,74.125.24.0-255,2902,64243,63,181322
7755,0.001637,172.31.40.0-255,66,64309,63,181322
7756,0.001646,74.125.24.0-255,5738,70047,63,181322
7757,0.001648,172.31.40.0-255,66,70113,63,181322
7758,0.001679,172.31.40.0-255,66,70179,63,181322
7759,0.001703,74.125.24.0-255,1484,71663,63,181322
7760,0.00171,74.125.24.0-255,5738,77401,63,181322
7761,0.001713,172.31.40.0-255,66,77467,63,181322
7762,0.001716,74.125.24.0-255,1484,78951,63,181322
7763,0.001742,74.125.24.0-255,3602,82553,63,181322
7764,0.001745,172.31.40.0-255,66,82619,63,181322
7765,0.002022,74.125.24.0-255,1484,84103,63,181322
7766,0.00203,74.125.24.0-255,2902,87005,63,181322
7767,0.002034,172.31.40.0-255,66,87071,63,181322
7768,0.002041,74.125.24.0-255,4320,91391,63,181322
7769,0.002043,172.31.40.0-255,66,91457,63,181322
7770,0.002058,74.125.24.0-255,1484,92941,63,181322
7771,0.002073,74.125.24.0-255,1484,94425,63,181322
7772,0.002076,172.31.40.0-255,66,94491,63,181322
7773,0.002118,172.31.40.0-255,66,94557,63,181322
7774,0.002132,172.31.40.0-255,66,94623,63,181322
7775,0.002144,172.31.40.0-255,66,94689,63,181322
7776,0.002152,74.125.24.0-255,5738,100427,63,181322
7777,0.002155,172.31.40.0-255,66,100493,63,181322
7778,0.002174,74.125.24.0-255,5738,106231,63,181322
7779,0.002177,172.31.40.0-255,66,106297,63,181322
7780,0.002185,74.125.24.0-255,7156,113453,63,181322
7781,0.002188,172.31.40.0-255,66,113519,63,181322
7782,0.002206,74.125.24.0-255,5020,118539,63,181322
7783,0.002208,172.31.40.0-255,66,118605,63,181322
7784,0.00225,74.125.24.0-255,1484,120089,63,181322
7785,0.002255,74.125.24.0-255,2902,122991,63,181322
7786,0.002259,172.31.40.0-255,66,123057,63,181322
7787,0.002266,74.125.24.0-255,5738,128795,63,181322
7788,0.002268,172.31.40.0-255,66,128861,63,181322
7789,0.002292,74.125.24.0-255,5738,134599,63,181322
7790,0.002294,172.31.40.0-255,66,134665,63,181322
7791,0.002316,74.125.24.0-255,1484,136149,63,181322
7792,0.00232,74.125.24.0-255,1484,137633,63,181322
7793,0.002322,172.31.40.0-255,66,137699,63,181322
7794,0.002356,172.31.40.0-255,66,137765,63,181322
7795,0.00236,74.125.24.0-255,2184,139949,63,181322
7796,0.002362,172.31.40.0-255,66,140015,63,181322
7797,0.002441,172.31.40.0-255,66,140081,63,181322
7798,0.002476,74.125.24.0-255,2902,142983,63,181322
7799,0.002479,172.31.40.0-255,66,143049,63,181322
7800,0.002497,172.31.40.0-255,66,143115,63,181322
7801,0.002514,172.31.40.0-255,66,143181,63,181322
7802,0.002545,74.125.24.0-255,1484,144665,63,181322
7803,0.002562,172.31.40.0-255,66,144731,63,181322
7804,0.00257,74.125.24.0-255,7156,151887,63,181322
7805,0.002573,172.31.40.0-255,66,151953,63,181322
7806,0.002575,74.125.24.0-255,1484,153437,63,181322
7807,0.002647,74.125.24.0-255,2184,155621,63,181322
7808,0.002651,74.125.24.0-255,2902,158523,63,181322
7809,0.002655,74.125.24.0-255,4320,162843,63,181322
7810,0.002698,74.125.24.0-255,2902,165745,63,181322
7811,0.002714,74.125.24.0-255,5738,171483,63,181322
7812,0.002721,74.125.24.0-255,3602,175085,63,181322
7813,0.002751,74.125.24.0-255,1484,176569,63,181322
7814,0.002762,74.125.24.0-255,1484,178053,63,181322
7815,0.002766,74.125.24.0-255,2744,180797,63,181322
7816,0.002776,74.125.24.0-255,105,180902,63,181322
7817,0.010045,172.31.40.0-255,66,180968,63,181322
7818,0.012229,74.125.24.0-255,105,181073,63,181322
7819,0.012241,172.31.40.0-255,78,181151,63,181322
7820,0.012532,172.31.40.0-255,105,181256,63,181322
7821,0.014909,74.125.24.0-255,66,181322,63,181322
7822,0.0,74.125.68.0-255,153,153,63,283173
7823,1.8e-05,172.31.40.0-255,66,219,63,283173
7824,2.5e-05,74.125.68.0-255,1484,1703,63,283173
7825,2.9e-05,172.31.40.0-255,66,1769,63,283173
7826,3.6e-05,74.125.68.0-255,2902,4671,63,283173
7827,4e-05,172.31.40.0-255,66,4737,63,283173
7828,6.6e-05,74.125.68.0-255,7156,11893,63,283173
7829,6.9e-05,172.31.40.0-255,66,11959,63,283173
7830,7.3e-05,74.125.68.0-255,2139,14098,63,283173
7831,7.6e-05,172.31.40.0-255,66,14164,63,283173
7832,0.00017,74.125.68.0-255,1484,15648,63,283173
7833,0.000174,172.31.40.0-255,66,15714,63,283173
7834,0.000193,74.125.68.0-255,2902,18616,63,283173
7835,0.000196,172.31.40.0-255,66,18682,63,283173
7836,0.000213,74.125.68.0-255,5738,24420,63,283173
7837,0.000216,172.31.40.0-255,66,24486,63,283173
7838,0.000248,74.125.68.0-255,5738,30224,63,283173
7839,0.000251,172.31.40.0-255,66,30290,63,283173
7840,0.000272,74.125.68.0-255,6797,37087,63,283173
7841,0.000274,172.31.40.0-255,66,37153,63,283173
7842,0.000278,74.125.68.0-255,2902,40055,63,283173
7843,0.00028,172.31.40.0-255,66,40121,63,283173
7844,0.000329,74.125.68.0-255,4320,44441,63,283173
7845,0.000333,172.31.40.0-255,66,44507,63,283173
7846,0.000353,74.125.68.0-255,3961,48468,63,283173
7847,0.000355,172.31.40.0-255,66,48534,63,283173
7848,0.000376,74.125.68.0-255,1484,50018,63,283173
7849,0.000379,172.31.40.0-255,66,50084,63,283173
7850,0.000399,74.125.68.0-255,2902,52986,63,283173
7851,0.000403,172.31.40.0-255,66,53052,63,283173
7852,0.000409,74.125.68.0-255,5738,58790,63,283173
7853,0.000411,172.31.40.0-255,66,58856,63,283173
7854,0.000435,74.125.68.0-255,4320,63176,63,283173
7855,0.000437,172.31.40.0-255,66,63242,63,283173
7856,0.000451,74.125.68.0-255,2543,65785,63,283173
7857,0.000454,172.31.40.0-255,66,65851,63,283173
7858,0.000457,74.125.68.0-255,648,66499,63,283173
7859,0.000566,74.125.68.0-255,1484,67983,63,283173
7860,0.000571,172.31.40.0-255,66,68049,63,283173
7861,0.000585,74.125.68.0-255,1484,69533,63,283173
7862,0.00059,74.125.68.0-255,2902,72435,63,283173
7863,0.000592,172.31.40.0-255,66,72501,63,283173
7864,0.000617,74.125.68.0-255,5738,78239,63,283173
7865,0.000619,172.31.40.0-255,66,78305,63,283173
7866,0.000654,74.125.68.0-255,2902,81207,63,283173
7867,0.000658,172.31.40.0-255,66,81273,63,283173
7868,0.000682,74.125.68.0-255,2543,83816,63,283173
7869,0.000684,172.31.40.0-255,66,83882,63,283173
7870,0.000723,74.125.68.0-255,2902,86784,63,283173
7871,0.000726,172.31.40.0-255,66,86850,63,283173
7872,0.000729,74.125.68.0-255,1484,88334,63,283173
7873,0.000748,74.125.68.0-255,2902,91236,63,283173
7874,0.000751,172.31.40.0-255,66,91302,63,283173
7875,0.000769,74.125.68.0-255,5738,97040,63,283173
7876,0.000771,172.31.40.0-255,66,97106,63,283173
7877,0.000774,74.125.68.0-255,1484,98590,63,283173
7878,0.000795,74.125.68.0-255,1484,100074,63,283173
7879,0.000797,172.31.40.0-255,66,100140,63,283173
7880,0.000821,74.125.68.0-255,1125,101265,63,283173
7881,0.001045,74.125.68.0-255,1484,102749,63,283173
7882,0.00105,172.31.40.0-255,66,102815,63,283173
7883,0.001055,74.125.68.0-255,2902,105717,63,283173
7884,0.001058,172.31.40.0-255,66,105783,63,283173
7885,0.001076,74.125.68.0-255,5738,111521,63,283173
7886,0.001097,74.125.68.0-255,4320,115841,63,283173
7887,0.001103,74.125.68.0-255,5738,121579,63,283173
7888,0.001106,172.31.40.0-255,66,121645,63,283173
7889,0.001112,172.31.40.0-255,66,121711,63,283173
7890,0.001136,74.125.68.0-255,5738,127449,63,283173
7891,0.001146,172.31.40.0-255,66,127515,63,283173
7892,0.001156,74.125.68.0-255,5738,133253,63,283173
7893,0.00116,74.125.68.0-255,2184,135437,63,283173
7894,0.001166,172.31.40.0-255,66,135503,63,283173
7895,0.001523,74.125.68.0-255,1484,136987,63,283173
7896,0.001541,74.125.68.0-255,2902,139889,63,283173
7897,0.001546,172.31.40.0-255,66,139955,63,283173
7898,0.001558,74.125.68.0-255,2902,142857,63,283173
7899,0.00156,172.31.40.0-255,66,142923,63,283173
7900,0.001563,74.125.68.0-255,1484,144407,63,283173
7901,0.001586,74.125.68.0-255,2902,147309,63,283173
7902,0.001589,172.31.40.0-255,66,147375,63,283173
7903,0.001613,74.125.68.0-255,7156,154531,63,283173
7904,0.001616,172.31.40.0-255,66,154597,63,283173
7905,0.001636,74.125.68.0-255,1484,156081,63,283173
7906,0.001659,74.125.68.0-255,2902,158983,63,283173
7907,0.001673,74.125.68.0-255,5738,164721,63,283173
7908,0.001686,172.31.40.0-255,66,164787,63,283173
7909,0.001703,74.125.68.0-255,1484,166271,63,283173
7910,0.001725,74.125.68.0-255,3602,169873,63,283173
7911,0.001727,172.31.40.0-255,66,169939,63,283173
7912,0.001764,74.125.68.0-255,1484,171423,63,283173
7913,0.001781,74.125.68.0-255,2902,174325,63,283173
7914,0.001784,172.31.40.0-255,66,174391,63,283173
7915,0.001797,74.125.68.0-255,4320,178711,63,283173
7916,0.001799,172.31.40.0-255,66,178777,63,283173
7917,0.001814,74.125.68.0-255,1484,180261,63,283173
7918,0.001819,74.125.68.0-255,2902,183163,63,283173
7919,0.001823,172.31.40.0-255,66,183229,63,283173
7920,0.001841,74.125.68.0-255,1484,184713,63,283173
7921,0.001847,74.125.68.0-255,5738,190451,63,283173
7922,0.001858,74.125.68.0-255,1484,191935,63,283173
7923,0.001862,172.31.40.0-255,66,192001,63,283173
7924,0.001885,172.31.40.0-255,66,192067,63,283173
7925,0.001914,74.125.68.0-255,3602,195669,63,283173
7926,0.001919,172.31.40.0-255,66,195735,63,283173
7927,0.002107,74.125.68.0-255,1484,197219,63,283173
7928,0.002128,74.125.68.0-255,2902,200121,63,283173
7929,0.002132,172.31.40.0-255,66,200187,63,283173
7930,0.002139,74.125.68.0-255,5738,205925,63,283173
7931,0.002158,172.31.40.0-255,66,205991,63,283173
7932,0.002173,74.125.68.0-255,7156,213147,63,283173
7933,0.002186,74.125.68.0-255,2902,216049,63,283173
7934,0.002222,74.125.68.0-255,2902,218951,63,283173
7935,0.002243,74.125.68.0-255,2184,221135,63,283173
7936,0.002247,172.31.40.0-255,66,221201,63,283173
7937,0.002253,172.31.40.0-255,66,221267,63,283173
7938,0.002324,74.125.68.0-255,1484,222751,63,283173
7939,0.002328,74.125.68.0-255,1484,224235,63,283173
7940,0.002333,172.31.40.0-255,66,224301,63,283173
7941,0.002347,74.125.68.0-255,1484,225785,63,283173
7942,0.002375,74.125.68.0-255,5738,231523,63,283173
7943,0.002401,74.125.68.0-255,4320,235843,63,283173
7944,0.002408,74.125.68.0-255,5738,241581,63,283173
7945,0.002412,74.125.68.0-255,2902,244483,63,283173
7946,0.002417,172.31.40.0-255,66,244549,63,283173
7947,0.002441,74.125.68.0-255,2184,246733,63,283173
7948,0.002466,172.31.40.0-255,66,246799,63,283173
7949,0.002483,74.125.68.0-255,1484,248283,63,283173
7950,0.002539,172.31.40.0-255,66,248349,63,283173
7951,0.005044,74.125.68.0-255,5738,254087,63,283173
7952,0.005054,172.31.40.0-255,66,254153,63,283173
7953,0.007566,74.125.68.0-255,5738,259891,63,283173
7954,0.007581,172.31.40.0-255,66,259957,63,283173
7955,0.010099,74.125.68.0-255,5738,265695,63,283173
7956,0.010118,172.31.40.0-255,66,265761,63,283173
7957,0.012621,74.125.68.0-255,5738,271499,63,283173
7958,0.012628,172.31.40.0-255,66,271565,63,283173
7959,0.015119,74.125.68.0-255,5738,277303,63,283173
7960,0.015125,172.31.40.0-255,66,277369,63,283173
7961,0.017634,74.125.68.0-255,5738,283107,63,283173
7962,0.017648,172.31.40.0-255,66,283173,63,283173
7963,0.0,172.31.40.0-255,105,105,63,276
7964,0.001781,157.240.24.0-255,105,210,63,276
7965,0.001793,172.31.40.0-255,66,276,63,276
7966,0.0,74.125.24.0-255,146,146,63,171511
7967,2.1e-05,172.31.40.0-255,66,212,63,171511
7968,2.8e-05,74.125.24.0-255,1484,1696,63,171511
7969,3.3e-05,172.31.40.0-255,66,1762,63,171511
7970,3.8e-05,74.125.24.0-255,2902,4664,63,171511
7971,4.2e-05,172.31.40.0-255,66,4730,63,171511
7972,5.9e-05,74.125.24.0-255,7156,11886,63,171511
7973,6.2e-05,172.31.40.0-255,66,11952,63,171511
7974,6.7e-05,74.125.24.0-255,1978,13930,63,171511
7975,7e-05,172.31.40.0-255,66,13996,63,171511
7976,0.000639,74.125.24.0-255,1484,15480,63,171511
7977,0.000646,172.31.40.0-255,66,15546,63,171511
7978,0.000655,74.125.24.0-255,2902,18448,63,171511
7979,0.000658,172.31.40.0-255,66,18514,63,171511
7980,0.00067,74.125.24.0-255,5738,24252,63,171511
7981,0.000672,172.31.40.0-255,66,24318,63,171511
7982,0.000679,74.125.24.0-255,5738,30056,63,171511
7983,0.000681,172.31.40.0-255,66,30122,63,171511
7984,0.000708,74.125.24.0-255,1125,31247,63,171511
7985,0.000713,172.31.40.0-255,66,31313,63,171511
7986,0.000931,74.125.24.0-255,1484,32797,63,171511
7987,0.000937,172.31.40.0-255,66,32863,63,171511
7988,0.000943,74.125.24.0-255,2902,35765,63,171511
7989,0.000945,172.31.40.0-255,66,35831,63,171511
7990,0.000951,74.125.24.0-255,4320,40151,63,171511
7991,0.000953,172.31.40.0-255,66,40217,63,171511
7992,0.000974,74.125.24.0-255,1484,41701,63,171511
7993,0.000976,172.31.40.0-255,66,41767,63,171511
7994,0.000985,74.125.24.0-255,6797,48564,63,171511
7995,0.000988,172.31.40.0-255,66,48630,63,171511
7996,0.001013,74.125.24.0-255,1484,50114,63,171511
7997,0.001016,172.31.40.0-255,66,50180,63,171511
7998,0.001047,74.125.24.0-255,4320,54500,63,171511
7999,0.00105,172.31.40.0-255,66,54566,63,171511
8000,0.001057,74.125.24.0-255,7156,61722,63,171511
8001,0.00106,172.31.40.0-255,66,61788,63,171511
8002,0.001078,74.125.24.0-255,3961,65749,63,171511
8003,0.001081,172.31.40.0-255,66,65815,63,171511
8004,0.001207,74.125.24.0-255,648,66463,63,171511
8005,0.001351,74.125.24.0-255,1484,67947,63,171511
8006,0.001357,172.31.40.0-255,66,68013,63,171511
8007,0.001363,74.125.24.0-255,2902,70915,63,171511
8008,0.001366,172.31.40.0-255,66,70981,63,171511
8009,0.001402,74.125.24.0-255,5738,76719,63,171511
8010,0.001404,172.31.40.0-255,66,76785,63,171511
8011,0.001411,74.125.24.0-255,6797,83582,63,171511
8012,0.001414,172.31.40.0-255,66,83648,63,171511
8013,0.001416,74.125.24.0-255,1484,85132,63,171511
8014,0.001446,74.125.24.0-255,2902,88034,63,171511
8015,0.001449,172.31.40.0-255,66,88100,63,171511
8016,0.001456,74.125.24.0-255,5738,93838,63,171511
8017,0.001458,172.31.40.0-255,66,93904,63,171511
8018,0.001486,74.125.24.0-255,6797,100701,63,171511
8019,0.001488,172.31.40.0-255,66,100767,63,171511
8020,0.001937,74.125.24.0-255,1484,102251,63,171511
8021,0.001955,74.125.24.0-255,2902,105153,63,171511
8022,0.001957,172.31.40.0-255,66,105219,63,171511
8023,0.001964,74.125.24.0-255,5738,110957,63,171511
8024,0.001967,172.31.40.0-255,66,111023,63,171511
8025,0.001987,74.125.24.0-255,7156,118179,63,171511
8026,0.001991,172.31.40.0-255,66,118245,63,171511
8027,0.002016,74.125.24.0-255,4320,122565,63,171511
8028,0.002018,172.31.40.0-255,66,122631,63,171511
8029,0.002049,172.31.40.0-255,66,122697,63,171511
8030,0.002053,74.125.24.0-255,2184,124881,63,171511
8031,0.002055,172.31.40.0-255,66,124947,63,171511
8032,0.004081,74.125.24.0-255,5738,130685,63,171511
8033,0.004088,172.31.40.0-255,66,130751,63,171511
8034,0.006117,74.125.24.0-255,5738,136489,63,171511
8035,0.006124,172.31.40.0-255,66,136555,63,171511
8036,0.008141,74.125.24.0-255,5738,142293,63,171511
8037,0.00815,172.31.40.0-255,66,142359,63,171511
8038,0.010202,74.125.24.0-255,5738,148097,63,171511
8039,0.010211,172.31.40.0-255,66,148163,63,171511
8040,0.012216,74.125.24.0-255,2902,151065,63,171511
8041,0.012224,172.31.40.0-255,66,151131,63,171511
8042,0.012255,74.125.24.0-255,2902,154033,63,171511
8043,0.012258,172.31.40.0-255,66,154099,63,171511
8044,0.014251,74.125.24.0-255,5738,159837,63,171511
8045,0.014258,172.31.40.0-255,66,159903,63,171511
8046,0.016269,74.125.24.0-255,5738,165641,63,171511
8047,0.016277,172.31.40.0-255,66,165707,63,171511
8048,0.01835,74.125.24.0-255,5738,171445,63,171511
8049,0.018357,172.31.40.0-255,66,171511,63,171511
8050,0.0,74.125.24.0-255,153,153,63,166243
8051,2.4e-05,172.31.40.0-255,66,219,63,166243
8052,3.2e-05,74.125.24.0-255,1484,1703,63,166243
8053,3.7e-05,172.31.40.0-255,66,1769,63,166243
8054,5.1e-05,74.125.24.0-255,2902,4671,63,166243
8055,5.5e-05,172.31.40.0-255,66,4737,63,166243
8056,6.3e-05,74.125.24.0-255,7156,11893,63,166243
8057,6.6e-05,172.31.40.0-255,66,11959,63,166243
8058,7.1e-05,74.125.24.0-255,2091,14050,63,166243
8059,7.3e-05,172.31.40.0-255,66,14116,63,166243
8060,0.000101,74.125.24.0-255,7156,21272,63,166243
8061,0.000108,172.31.40.0-255,66,21338,63,166243
8062,0.000119,172.31.40.0-255,66,21404,63,166243
8063,0.000123,74.125.24.0-255,1125,22529,63,166243
8064,0.000125,172.31.40.0-255,66,22595,63,166243
8065,0.000388,74.125.24.0-255,1484,24079,63,166243
8066,0.000395,172.31.40.0-255,66,24145,63,166243
8067,0.000402,74.125.24.0-255,2902,27047,63,166243
8068,0.000405,172.31.40.0-255,66,27113,63,166243
8069,0.00043,74.125.24.0-255,4320,31433,63,166243
8070,0.000433,172.31.40.0-255,66,31499,63,166243
8071,0.000456,74.125.24.0-255,1484,32983,63,166243
8072,0.000459,172.31.40.0-255,66,33049,63,166243
8073,0.000474,172.31.40.0-255,66,33115,63,166243
8074,0.000485,172.31.40.0-255,66,33181,63,166243
8075,0.000492,74.125.24.0-255,6797,39978,63,166243
8076,0.000494,172.31.40.0-255,66,40044,63,166243
8077,0.000527,74.125.24.0-255,679,40723,63,166243
8078,0.00053,172.31.40.0-255,66,40789,63,166243
8079,0.000813,74.125.24.0-255,1484,42273,63,166243
8080,0.000819,74.125.24.0-255,2902,45175,63,166243
8081,0.000823,172.31.40.0-255,66,45241,63,166243
8082,0.000831,74.125.24.0-255,5738,50979,63,166243
8083,0.000833,172.31.40.0-255,66,51045,63,166243
8084,0.000848,74.125.24.0-255,1484,52529,63,166243
8085,0.000872,74.125.24.0-255,2902,55431,63,166243
8086,0.000875,172.31.40.0-255,66,55497,63,166243
8087,0.000883,74.125.24.0-255,7156,62653,63,166243
8088,0.000884,172.31.40.0-255,66,62719,63,166243
8089,0.000907,74.125.24.0-255,4320,67039,63,166243
8090,0.00091,172.31.40.0-255,66,67105,63,166243
8091,0.00092,172.31.40.0-255,66,67171,63,166243
8092,0.001308,74.125.24.0-255,1484,68655,63,166243
8093,0.001316,74.125.24.0-255,2902,71557,63,166243
8094,0.00132,172.31.40.0-255,66,71623,63,166243
8095,0.001326,74.125.24.0-255,4320,75943,63,166243
8096,0.001328,172.31.40.0-255,66,76009,63,166243
8097,0.001358,74.125.24.0-255,1484,77493,63,166243
8098,0.00137,172.31.40.0-255,66,77559,63,166243
8099,0.001397,74.125.24.0-255,2902,80461,63,166243
8100,0.0014,172.31.40.0-255,66,80527,63,166243
8101,0.001426,172.31.40.0-255,66,80593,63,166243
8102,0.002162,74.125.24.0-255,1484,82077,63,166243
8103,0.002173,74.125.24.0-255,2902,84979,63,166243
8104,0.002177,172.31.40.0-255,66,85045,63,166243
8105,0.002185,74.125.24.0-255,5738,90783,63,166243
8106,0.002187,172.31.40.0-255,66,90849,63,166243
8107,0.002194,74.125.24.0-255,4320,95169,63,166243
8108,0.002201,172.31.40.0-255,66,95235,63,166243
8109,0.002245,172.31.40.0-255,66,95301,63,166243
8110,0.002252,74.125.24.0-255,7156,102457,63,166243
8111,0.002254,172.31.40.0-255,66,102523,63,166243
8112,0.002259,74.125.24.0-255,3602,106125,63,166243
8113,0.002262,172.31.40.0-255,66,106191,63,166243
8114,0.002292,74.125.24.0-255,4320,110511,63,166243
8115,0.002294,172.31.40.0-255,66,110577,63,166243
8116,0.002299,74.125.24.0-255,2902,113479,63,166243
8117,0.002301,172.31.40.0-255,66,113545,63,166243
8118,0.002323,74.125.24.0-255,1484,115029,63,166243
8119,0.002339,172.31.40.0-255,66,115095,63,166243
8120,0.002369,74.125.24.0-255,4320,119415,63,166243
8121,0.002372,172.31.40.0-255,66,119481,63,166243
8122,0.002402,172.31.40.0-255,66,119547,63,166243
8123,0.002446,74.125.24.0-255,1484,121031,63,166243
8124,0.002451,74.125.24.0-255,2902,123933,63,166243
8125,0.002454,172.31.40.0-255,66,123999,63,166243
8126,0.002483,74.125.24.0-255,5738,129737,63,166243
8127,0.002486,172.31.40.0-255,66,129803,63,166243
8128,0.002506,172.31.40.0-255,66,129869,63,166243
8129,0.002536,74.125.24.0-255,1484,131353,63,166243
8130,0.002569,172.31.40.0-255,66,131419,63,166243
8131,0.005119,74.125.24.0-255,5738,137157,63,166243
8132,0.005127,172.31.40.0-255,66,137223,63,166243
8133,0.007678,74.125.24.0-255,5738,142961,63,166243
8134,0.007685,172.31.40.0-255,66,143027,63,166243
8135,0.010306,74.125.24.0-255,5738,148765,63,166243
8136,0.010313,172.31.40.0-255,66,148831,63,166243
8137,0.012892,74.125.24.0-255,5738,154569,63,166243
8138,0.012901,172.31.40.0-255,66,154635,63,166243
8139,0.015469,74.125.24.0-255,5738,160373,63,166243
8140,0.015486,172.31.40.0-255,66,160439,63,166243
8141,0.018079,74.125.24.0-255,5738,166177,63,166243
8142,0.018095,172.31.40.0-255,66,166243,63,166243
8143,0.0,172.217.194.0-255,153,153,63,190286
8144,2e-05,172.31.40.0-255,66,219,63,190286
8145,2.7e-05,172.217.194.0-255,1484,1703,63,190286
8146,3.2e-05,172.31.40.0-255,66,1769,63,190286
8147,3.8e-05,172.217.194.0-255,2902,4671,63,190286
8148,4.2e-05,172.31.40.0-255,66,4737,63,190286
8149,5e-05,172.217.194.0-255,7156,11893,63,190286
8150,5.3e-05,172.31.40.0-255,66,11959,63,190286
8151,7.1e-05,172.31.40.0-255,66,12025,63,190286
8152,7.4e-05,172.217.194.0-255,1484,13509,63,190286
8153,7.6e-05,172.31.40.0-255,66,13575,63,190286
8154,0.000102,172.217.194.0-255,5379,18954,63,190286
8155,0.000105,172.31.40.0-255,66,19020,63,190286
8156,0.000159,172.217.194.0-255,1484,20504,63,190286
8157,0.000163,172.31.40.0-255,66,20570,63,190286
8158,0.000168,172.217.194.0-255,2902,23472,63,190286
8159,0.00017,172.31.40.0-255,66,23538,63,190286
8160,0.000182,172.217.194.0-255,1484,25022,63,190286
8161,0.000184,172.31.40.0-255,66,25088,63,190286
8162,0.000212,172.217.194.0-255,2902,27990,63,190286
8163,0.000215,172.31.40.0-255,66,28056,63,190286
8164,0.000221,172.217.194.0-255,5738,33794,63,190286
8165,0.000223,172.31.40.0-255,66,33860,63,190286
8166,0.000229,172.217.194.0-255,5738,39598,63,190286
8167,0.000231,172.31.40.0-255,66,39664,63,190286
8168,0.000259,172.217.194.0-255,6797,46461,63,190286
8169,0.000262,172.31.40.0-255,66,46527,63,190286
8170,0.000269,172.217.194.0-255,7088,53615,63,190286
8171,0.000271,172.31.40.0-255,66,53681,63,190286
8172,0.000357,172.217.194.0-255,364,54045,63,190286
8173,0.00036,172.31.40.0-255,66,54111,63,190286
8174,0.000417,172.217.194.0-255,1484,55595,63,190286
8175,0.000424,172.217.194.0-255,4320,59915,63,190286
8176,0.000427,172.31.40.0-255,66,59981,63,190286
8177,0.000471,172.217.194.0-255,5738,65719,63,190286
8178,0.000474,172.31.40.0-255,66,65785,63,190286
8179,0.000491,172.217.194.0-255,7156,72941,63,190286
8180,0.000494,172.31.40.0-255,66,73007,63,190286
8181,0.000525,172.217.194.0-255,5379,78386,63,190286
8182,0.000527,172.31.40.0-255,66,78452,63,190286
8183,0.000538,172.31.40.0-255,66,78518,63,190286
8184,0.001417,172.217.194.0-255,1484,80002,63,190286
8185,0.001426,172.217.194.0-255,2902,82904,63,190286
8186,0.00143,172.31.40.0-255,66,82970,63,190286
8187,0.001438,172.217.194.0-255,5738,88708,63,190286
8188,0.00144,172.31.40.0-255,66,88774,63,190286
8189,0.001465,172.217.194.0-255,7156,95930,63,190286
8190,0.001467,172.31.40.0-255,66,95996,63,190286
8191,0.001489,172.217.194.0-255,5738,101734,63,190286
8192,0.001491,172.31.40.0-255,66,101800,63,190286
8193,0.001494,172.217.194.0-255,1484,103284,63,190286
8194,0.001522,172.31.40.0-255,66,103350,63,190286
8195,0.00168,172.217.194.0-255,1484,104834,63,190286
8196,0.001686,172.217.194.0-255,2902,107736,63,190286
8197,0.001691,172.31.40.0-255,66,107802,63,190286
8198,0.001698,172.217.194.0-255,5738,113540,63,190286
8199,0.0017,172.31.40.0-255,66,113606,63,190286
8200,0.001717,172.217.194.0-255,5738,119344,63,190286
8201,0.001719,172.31.40.0-255,66,119410,63,190286
8202,0.001758,172.31.40.0-255,66,119476,63,190286
8203,0.001763,172.217.194.0-255,4320,123796,63,190286
8204,0.001766,172.31.40.0-255,66,123862,63,190286
8205,0.001778,172.217.194.0-255,766,124628,63,190286
8206,0.00185,172.217.194.0-255,1484,126112,63,190286
8207,0.001853,172.31.40.0-255,66,126178,63,190286
8208,0.001875,172.217.194.0-255,2902,129080,63,190286
8209,0.001878,172.31.40.0-255,66,129146,63,190286
8210,0.001884,172.217.194.0-255,5738,134884,63,190286
8211,0.001886,172.31.40.0-255,66,134950,63,190286
8212,0.001909,172.31.40.0-255,66,135016,63,190286
8213,0.001928,172.217.194.0-255,2902,137918,63,190286
8214,0.00193,172.31.40.0-255,66,137984,63,190286
8215,0.001942,172.31.40.0-255,66,138050,63,190286
8216,0.003915,172.217.194.0-255,5738,143788,63,190286
8217,0.003921,172.31.40.0-255,66,143854,63,190286
8218,0.00588,172.217.194.0-255,5738,149592,63,190286
8219,0.005897,172.31.40.0-255,66,149658,63,190286
8220,0.007875,172.217.194.0-255,5738,155396,63,190286
8221,0.007882,172.31.40.0-255,66,155462,63,190286
8222,0.00988,172.217.194.0-255,5738,161200,63,190286
8223,0.009889,172.31.40.0-255,66,161266,63,190286
8224,0.011853,172.217.194.0-255,5738,167004,63,190286
8225,0.011864,172.31.40.0-255,66,167070,63,190286
8226,0.013847,172.217.194.0-255,5738,172808,63,190286
8227,0.013861,172.31.40.0-255,66,172874,63,190286
8228,0.015847,172.217.194.0-255,5738,178612,63,190286
8229,0.015861,172.31.40.0-255,66,178678,63,190286
8230,0.017842,172.217.194.0-255,5738,184416,63,190286
8231,0.017852,172.31.40.0-255,66,184482,63,190286
8232,0.019853,172.217.194.0-255,5738,190220,63,190286
8233,0.019868,172.31.40.0-255,66,190286,63,190286
8234,0.0,172.217.194.0-255,150,150,63,130698
8235,2.1e-05,172.31.40.0-255,66,216,63,130698
8236,2.9e-05,172.217.194.0-255,1484,1700,63,130698
8237,3.3e-05,172.31.40.0-255,66,1766,63,130698
8238,5.9e-05,172.217.194.0-255,2902,4668,63,130698
8239,6.2e-05,172.31.40.0-255,66,4734,63,130698
8240,7e-05,172.217.194.0-255,7156,11890,63,130698
8241,7.3e-05,172.31.40.0-255,66,11956,63,130698
8242,0.000117,172.217.194.0-255,4819,16775,63,130698
8243,0.00012,172.31.40.0-255,66,16841,63,130698
8244,0.000128,172.217.194.0-255,5738,22579,63,130698
8245,0.00013,172.31.40.0-255,66,22645,63,130698
8246,0.000176,172.31.40.0-255,66,22711,63,130698
8247,0.00019,172.31.40.0-255,66,22777,63,130698
8248,0.000192,172.217.194.0-255,766,23543,63,130698
8249,0.000195,172.31.40.0-255,66,23609,63,130698
8250,0.000251,172.217.194.0-255,1484,25093,63,130698
8251,0.000253,172.31.40.0-255,66,25159,63,130698
8252,0.000258,172.217.194.0-255,2902,28061,63,130698
8253,0.000261,172.31.40.0-255,66,28127,63,130698
8254,0.000296,172.217.194.0-255,5738,33865,63,130698
8255,0.000298,172.31.40.0-255,66,33931,63,130698
8256,0.00033,172.217.194.0-255,7087,41018,63,130698
8257,0.000333,172.31.40.0-255,66,41084,63,130698
8258,0.000383,172.217.194.0-255,1484,42568,63,130698
8259,0.000386,172.31.40.0-255,66,42634,63,130698
8260,0.000391,172.217.194.0-255,2902,45536,63,130698
8261,0.000393,172.31.40.0-255,66,45602,63,130698
8262,0.000424,172.217.194.0-255,5738,51340,63,130698
8263,0.000427,172.31.40.0-255,66,51406,63,130698
8264,0.000434,172.217.194.0-255,7156,58562,63,130698
8265,0.000436,172.31.40.0-255,66,58628,63,130698
8266,0.000472,172.31.40.0-255,66,58694,63,130698
8267,0.000497,172.217.194.0-255,5738,64432,63,130698
8268,0.0005,172.31.40.0-255,66,64498,63,130698
8269,0.000504,172.217.194.0-255,1903,66401,63,130698
8270,0.000507,172.31.40.0-255,66,66467,63,130698
8271,0.000836,172.217.194.0-255,1484,67951,63,130698
8272,0.000845,172.217.194.0-255,2902,70853,63,130698
8273,0.000851,172.31.40.0-255,66,70919,63,130698
8274,0.000858,172.217.194.0-255,5738,76657,63,130698
8275,0.00086,172.31.40.0-255,66,76723,63,130698
8276,0.000905,172.31.40.0-255,66,76789,63,130698
8277,0.000928,172.217.194.0-255,1484,78273,63,130698
8278,0.000947,172.217.194.0-255,7156,85429,63,130698
8279,0.00095,172.31.40.0-255,66,85495,63,130698
8280,0.000976,172.217.194.0-255,3602,89097,63,130698
8281,0.000978,172.31.40.0-255,66,89163,63,130698
8282,0.001127,172.217.194.0-255,1484,90647,63,130698
8283,0.001132,172.217.194.0-255,2902,93549,63,130698
8284,0.001135,172.31.40.0-255,66,93615,63,130698
8285,0.001155,172.217.194.0-255,5738,99353,63,130698
8286,0.001158,172.31.40.0-255,66,99419,63,130698
8287,0.001192,172.31.40.0-255,66,99485,63,130698
8288,0.001202,172.31.40.0-255,66,99551,63,130698
8289,0.001241,172.217.194.0-255,4320,103871,63,130698
8290,0.001244,172.31.40.0-255,66,103937,63,130698
8291,0.001285,172.31.40.0-255,66,104003,63,130698
8292,0.001297,172.31.40.0-255,66,104069,63,130698
8293,0.001311,172.31.40.0-255,66,104135,63,130698
8294,0.001314,172.217.194.0-255,1484,105619,63,130698
8295,0.001353,172.31.40.0-255,66,105685,63,130698
8296,0.001363,172.31.40.0-255,66,105751,63,130698
8297,0.001428,172.31.40.0-255,66,105817,63,130698
8298,0.001432,172.217.194.0-255,4320,110137,63,130698
8299,0.001434,172.31.40.0-255,66,110203,63,130698
8300,0.001438,172.217.194.0-255,2902,113105,63,130698
8301,0.00144,172.31.40.0-255,66,113171,63,130698
8302,0.001485,172.31.40.0-255,66,113237,63,130698
8303,0.00149,172.217.194.0-255,3602,116839,63,130698
8304,0.001492,172.31.40.0-255,66,116905,63,130698
8305,0.001497,172.217.194.0-255,4320,121225,63,130698
8306,0.001499,172.31.40.0-255,66,121291,63,130698
8307,0.001549,172.31.40.0-255,66,121357,63,130698
8308,0.00156,172.31.40.0-255,66,121423,63,130698
8309,0.001601,172.31.40.0-255,66,121489,63,130698
8310,0.001647,172.31.40.0-255,66,121555,63,130698
8311,0.001672,172.31.40.0-255,66,121621,63,130698
8312,0.001677,172.217.194.0-255,4320,125941,63,130698
8313,0.001679,172.31.40.0-255,66,126007,63,130698
8314,0.001721,172.31.40.0-255,66,126073,63,130698
8315,0.001739,172.31.40.0-255,66,126139,63,130698
8316,0.001768,172.217.194.0-255,3466,129605,63,130698
8317,0.00177,172.31.40.0-255,66,129671,63,130698
8318,0.001773,172.217.194.0-255,97,129768,63,130698
8319,0.001775,172.217.194.0-255,105,129873,63,130698
8320,0.001805,172.217.194.0-255,129,130002,63,130698
8321,0.004572,172.31.40.0-255,105,130107,63,130698
8322,0.004605,172.31.40.0-255,105,130212,63,130698
8323,0.006543,172.217.194.0-255,66,130278,63,130698
8324,0.00659,172.217.194.0-255,66,130344,63,130698
8325,0.011569,172.31.40.0-255,90,130434,63,130698
8326,0.011581,172.31.40.0-255,66,130500,63,130698
8327,0.01357,172.217.194.0-255,66,130566,63,130698
8328,0.013619,172.217.194.0-255,66,130632,63,130698
8329,0.013626,172.31.40.0-255,66,130698,63,130698
8330,0.0,74.125.24.0-255,146,146,63,98897
8331,3.2e-05,172.31.40.0-255,66,212,63,98897
8332,4e-05,74.125.24.0-255,1484,1696,63,98897
8333,4.5e-05,172.31.40.0-255,66,1762,63,98897
8334,5e-05,74.125.24.0-255,2902,4664,63,98897
8335,6e-05,172.31.40.0-255,66,4730,63,98897
8336,6.9e-05,74.125.24.0-255,7156,11886,63,98897
8337,7.2e-05,172.31.40.0-255,66,11952,63,98897
8338,7.6e-05,74.125.24.0-255,2037,13989,63,98897
8339,7.9e-05,172.31.40.0-255,66,14055,63,98897
8340,0.00021,74.125.24.0-255,1484,15539,63,98897
8341,0.000213,172.31.40.0-255,66,15605,63,98897
8342,0.00022,74.125.24.0-255,2902,18507,63,98897
8343,0.000222,172.31.40.0-255,66,18573,63,98897
8344,0.000256,74.125.24.0-255,5738,24311,63,98897
8345,0.000259,172.31.40.0-255,66,24377,63,98897
8346,0.000265,74.125.24.0-255,4320,28697,63,98897
8347,0.000267,172.31.40.0-255,66,28763,63,98897
8348,0.000306,74.125.24.0-255,2543,31306,63,98897
8349,0.000308,172.31.40.0-255,66,31372,63,98897
8350,0.000771,74.125.24.0-255,1484,32856,63,98897
8351,0.000777,172.31.40.0-255,66,32922,63,98897
8352,0.000784,74.125.24.0-255,2902,35824,63,98897
8353,0.000786,172.31.40.0-255,66,35890,63,98897
8354,0.000793,74.125.24.0-255,5738,41628,63,98897
8355,0.000801,172.31.40.0-255,66,41694,63,98897
8356,0.000806,74.125.24.0-255,2902,44596,63,98897
8357,0.000808,172.31.40.0-255,66,44662,63,98897
8358,0.000855,172.31.40.0-255,66,44728,63,98897
8359,0.000864,74.125.24.0-255,5738,50466,63,98897
8360,0.000866,172.31.40.0-255,66,50532,63,98897
8361,0.000905,74.125.24.0-255,3961,54493,63,98897
8362,0.000908,172.31.40.0-255,66,54559,63,98897
8363,0.001333,74.125.24.0-255,395,54954,63,98897
8364,0.00135,74.125.24.0-255,347,55301,63,98897
8365,0.003202,74.125.24.0-255,2902,58203,63,98897
8366,0.003211,172.31.40.0-255,66,58269,63,98897
8367,0.005475,74.125.24.0-255,5738,64007,63,98897
8368,0.005483,172.31.40.0-255,66,64073,63,98897
8369,0.007772,74.125.24.0-255,5738,69811,63,98897
8370,0.007778,172.31.40.0-255,66,69877,63,98897
8371,0.010069,74.125.24.0-255,5738,75615,63,98897
8372,0.010086,172.31.40.0-255,66,75681,63,98897
8373,0.012392,74.125.24.0-255,5738,81419,63,98897
8374,0.0124,172.31.40.0-255,66,81485,63,98897
8375,0.014671,74.125.24.0-255,5738,87223,63,98897
8376,0.01468,172.31.40.0-255,66,87289,63,98897
8377,0.016973,74.125.24.0-255,5738,93027,63,98897
8378,0.016981,172.31.40.0-255,66,93093,63,98897
8379,0.019269,74.125.24.0-255,5738,98831,63,98897
8380,0.019282,172.31.40.0-255,66,98897,63,98897
8381,0.0,172.217.194.0-255,431,431,63,98449
8382,1.8e-05,172.217.194.0-255,1484,1915,63,98449
8383,2.9e-05,172.31.40.0-255,66,1981,63,98449
8384,3.9e-05,172.217.194.0-255,4320,6301,63,98449
8385,4.2e-05,172.31.40.0-255,66,6367,63,98449
8386,0.00017,172.217.194.0-255,1484,7851,63,98449
8387,0.000229,172.217.194.0-255,6365,14216,63,98449
8388,0.000234,172.31.40.0-255,66,14282,63,98449
8389,0.000493,172.217.194.0-255,1484,15766,63,98449
8390,0.00054,172.217.194.0-255,2902,18668,63,98449
8391,0.000545,172.31.40.0-255,66,18734,63,98449
8392,0.000667,172.217.194.0-255,4320,23054,63,98449
8393,0.000671,172.31.40.0-255,66,23120,63,98449
8394,0.000695,172.217.194.0-255,1484,24604,63,98449
8395,0.000932,172.217.194.0-255,5738,30342,63,98449
8396,0.000938,172.31.40.0-255,66,30408,63,98449
8397,0.002143,172.217.194.0-255,2902,33310,63,98449
8398,0.00242,172.217.194.0-255,4320,37630,63,98449
8399,0.003364,172.217.194.0-255,4320,41950,63,98449
8400,0.003993,172.217.194.0-255,7156,49106,63,98449
8401,0.004081,172.31.40.0-255,66,49172,63,98449
8402,0.004495,172.31.40.0-255,66,49238,63,98449
8403,0.006301,172.31.40.0-255,66,49304,63,98449
8404,0.006385,172.217.194.0-255,4320,53624,63,98449
8405,0.006675,172.217.194.0-255,6128,59752,63,98449
8406,0.006822,172.217.194.0-255,3930,63682,63,98449
8407,0.007405,172.217.194.0-255,7156,70838,63,98449
8408,0.007673,172.217.194.0-255,1770,72608,63,98449
8409,0.008396,172.217.194.0-255,5738,78346,63,98449
8410,0.010022,172.31.40.0-255,66,78412,63,98449
8411,0.012188,172.31.40.0-255,66,78478,63,98449
8412,0.012218,172.217.194.0-255,5738,84216,63,98449
8413,0.012221,172.31.40.0-255,66,84282,63,98449
8414,0.012306,172.31.40.0-255,66,84348,63,98449
8415,0.012361,172.31.40.0-255,66,84414,63,98449
8416,0.01276,172.31.40.0-255,66,84480,63,98449
8417,0.012803,172.31.40.0-255,66,84546,63,98449
8418,0.013246,172.217.194.0-255,6180,90726,63,98449
8419,0.013251,172.31.40.0-255,66,90792,63,98449
8420,0.014332,172.31.40.0-255,66,90858,63,98449
8421,0.014371,172.31.40.0-255,66,90924,63,98449
8422,0.01448,172.217.194.0-255,7156,98080,63,98449
8423,0.014483,172.31.40.0-255,66,98146,63,98449
8424,0.014567,172.31.40.0-255,66,98212,63,98449
8425,0.014599,172.31.40.0-255,66,98278,63,98449
8426,0.017688,172.31.40.0-255,66,98344,63,98449
8427,0.019168,172.31.40.0-255,105,98449,63,98449
8428,0.0,74.125.130.0-255,296,296,63,128413
8429,2.3e-05,172.31.40.0-255,66,362,63,128413
8430,2.9e-05,74.125.130.0-255,1484,1846,63,128413
8431,3.3e-05,172.31.40.0-255,66,1912,63,128413
8432,5.8e-05,74.125.130.0-255,1484,3396,63,128413
8433,6e-05,172.31.40.0-255,66,3462,63,128413
8434,8.3e-05,74.125.130.0-255,2902,6364,63,128413
8435,8.6e-05,172.31.40.0-255,66,6430,63,128413
8436,9.2e-05,74.125.130.0-255,5738,12168,63,128413
8437,9.4e-05,172.31.40.0-255,66,12234,63,128413
8438,0.000114,74.125.130.0-255,1875,14109,63,128413
8439,0.000116,172.31.40.0-255,66,14175,63,128413
8440,0.000258,74.125.130.0-255,1484,15659,63,128413
8441,0.000262,172.31.40.0-255,66,15725,63,128413
8442,0.000277,74.125.130.0-255,2902,18627,63,128413
8443,0.000279,172.31.40.0-255,66,18693,63,128413
8444,0.000292,74.125.130.0-255,1484,20177,63,128413
8445,0.000294,172.31.40.0-255,66,20243,63,128413
8446,0.000308,74.125.130.0-255,4320,24563,63,128413
8447,0.00031,172.31.40.0-255,66,24629,63,128413
8448,0.000313,74.125.130.0-255,1484,26113,63,128413
8449,0.000316,172.31.40.0-255,66,26179,63,128413
8450,0.000343,74.125.130.0-255,5379,31558,63,128413
8451,0.000345,172.31.40.0-255,66,31624,63,128413
8452,0.000371,74.125.130.0-255,1484,33108,63,128413
8453,0.000373,172.31.40.0-255,66,33174,63,128413
8454,0.000385,74.125.130.0-255,1484,34658,63,128413
8455,0.000387,172.31.40.0-255,66,34724,63,128413
8456,0.0004,74.125.130.0-255,4320,39044,63,128413
8457,0.000402,172.31.40.0-255,66,39110,63,128413
8458,0.000427,74.125.130.0-255,4320,43430,63,128413
8459,0.00043,172.31.40.0-255,66,43496,63,128413
8460,0.000445,74.125.130.0-255,5379,48875,63,128413
8461,0.000463,172.31.40.0-255,66,48941,63,128413
8462,0.001187,74.125.130.0-255,1484,50425,63,128413
8463,0.001209,74.125.130.0-255,2902,53327,63,128413
8464,0.001214,172.31.40.0-255,66,53393,63,128413
8465,0.001219,74.125.130.0-255,1484,54877,63,128413
8466,0.001236,74.125.130.0-255,2902,57779,63,128413
8467,0.001238,172.31.40.0-255,66,57845,63,128413
8468,0.001258,74.125.130.0-255,5738,63583,63,128413
8469,0.00126,172.31.40.0-255,66,63649,63,128413
8470,0.001283,74.125.130.0-255,2543,66192,63,128413
8471,0.001285,172.31.40.0-255,66,66258,63,128413
8472,0.001306,74.125.130.0-255,2902,69160,63,128413
8473,0.001332,74.125.130.0-255,7156,76316,63,128413
8474,0.001376,74.125.130.0-255,4320,80636,63,128413
8475,0.001408,74.125.130.0-255,3122,83758,63,128413
8476,0.001425,74.125.130.0-255,4320,88078,63,128413
8477,0.001441,74.125.130.0-255,5738,93816,63,128413
8478,0.001489,74.125.130.0-255,2902,96718,63,128413
8479,0.001516,74.125.130.0-255,3961,100679,63,128413
8480,0.006714,172.31.40.0-255,66,100745,63,128413
8481,0.009068,74.125.130.0-255,4320,105065,63,128413
8482,0.009076,172.31.40.0-255,66,105131,63,128413
8483,0.009097,74.125.130.0-255,1484,106615,63,128413
8484,0.011415,74.125.130.0-255,4320,110935,63,128413
8485,0.011423,172.31.40.0-255,66,111001,63,128413
8486,0.013756,74.125.130.0-255,5738,116739,63,128413
8487,0.013764,172.31.40.0-255,66,116805,63,128413
8488,0.0161,74.125.130.0-255,5738,122543,63,128413
8489,0.016113,172.31.40.0-255,66,122609,63,128413
8490,0.018455,74.125.130.0-255,5738,128347,63,128413
8491,0.018468,172.31.40.0-255,66,128413,63,128413
8492,0.0,74.125.68.0-255,153,153,63,150283
8493,1.5e-05,172.31.40.0-255,66,219,63,150283
8494,2.1e-05,74.125.68.0-255,1484,1703,63,150283
8495,2.6e-05,172.31.40.0-255,66,1769,63,150283
8496,3.2e-05,74.125.68.0-255,2902,4671,63,150283
8497,3.6e-05,172.31.40.0-255,66,4737,63,150283
8498,3.9e-05,74.125.68.0-255,1484,6221,63,150283
8499,4.2e-05,172.31.40.0-255,66,6287,63,150283
8500,7.1e-05,74.125.68.0-255,5738,12025,63,150283
8501,7.4e-05,172.31.40.0-255,66,12091,63,150283
8502,7.8e-05,74.125.68.0-255,2094,14185,63,150283
8503,7.9e-05,172.31.40.0-255,66,14251,63,150283
8504,0.000146,74.125.68.0-255,1484,15735,63,150283
8505,0.00015,172.31.40.0-255,66,15801,63,150283
8506,0.000164,74.125.68.0-255,2902,18703,63,150283
8507,0.000167,172.31.40.0-255,66,18769,63,150283
8508,0.00017,74.125.68.0-255,1484,20253,63,150283
8509,0.000171,172.31.40.0-255,66,20319,63,150283
8510,0.000199,74.125.68.0-255,4320,24639,63,150283
8511,0.000202,172.31.40.0-255,66,24705,63,150283
8512,0.000219,74.125.68.0-255,5738,30443,63,150283
8513,0.000221,172.31.40.0-255,66,30509,63,150283
8514,0.000239,74.125.68.0-255,1125,31634,63,150283
8515,0.000241,172.31.40.0-255,66,31700,63,150283
8516,0.000296,74.125.68.0-255,1484,33184,63,150283
8517,0.000299,172.31.40.0-255,66,33250,63,150283
8518,0.000312,74.125.68.0-255,2902,36152,63,150283
8519,0.000316,172.31.40.0-255,66,36218,63,150283
8520,0.00032,74.125.68.0-255,2902,39120,63,150283
8521,0.000322,172.31.40.0-255,66,39186,63,150283
8522,0.000343,74.125.68.0-255,1484,40670,63,150283
8523,0.000346,172.31.40.0-255,66,40736,63,150283
8524,0.000372,172.31.40.0-255,66,40802,63,150283
8525,0.000377,74.125.68.0-255,4320,45122,63,150283
8526,0.000379,172.31.40.0-255,66,45188,63,150283
8527,0.000426,74.125.68.0-255,7156,52344,63,150283
8528,0.000429,172.31.40.0-255,66,52410,63,150283
8529,0.000447,74.125.68.0-255,3961,56371,63,150283
8530,0.000449,172.31.40.0-255,66,56437,63,150283
8531,0.000452,74.125.68.0-255,442,56879,63,150283
8532,0.000493,74.125.68.0-255,334,57213,63,150283
8533,0.000869,74.125.68.0-255,1484,58697,63,150283
8534,0.000874,172.31.40.0-255,66,58763,63,150283
8535,0.00088,74.125.68.0-255,2902,61665,63,150283
8536,0.000882,172.31.40.0-255,66,61731,63,150283
8537,0.000886,74.125.68.0-255,1484,63215,63,150283
8538,0.000917,74.125.68.0-255,4320,67535,63,150283
8539,0.00092,172.31.40.0-255,66,67601,63,150283
8540,0.000941,74.125.68.0-255,5738,73339,63,150283
8541,0.000945,172.31.40.0-255,66,73405,63,150283
8542,0.000954,74.125.68.0-255,2902,76307,63,150283
8543,0.000957,172.31.40.0-255,66,76373,63,150283
8544,0.00098,74.125.68.0-255,5738,82111,63,150283
8545,0.000983,172.31.40.0-255,66,82177,63,150283
8546,0.001001,74.125.68.0-255,4320,86497,63,150283
8547,0.001004,172.31.40.0-255,66,86563,63,150283
8548,0.001008,74.125.68.0-255,2902,89465,63,150283
8549,0.00101,172.31.40.0-255,66,89531,63,150283
8550,0.001043,74.125.68.0-255,2184,91715,63,150283
8551,0.001046,172.31.40.0-255,66,91781,63,150283
8552,0.002457,74.125.68.0-255,1484,93265,63,150283
8553,0.002468,74.125.68.0-255,2902,96167,63,150283
8554,0.002473,172.31.40.0-255,66,96233,63,150283
8555,0.002478,74.125.68.0-255,1484,97717,63,150283
8556,0.002499,74.125.68.0-255,4320,102037,63,150283
8557,0.002501,172.31.40.0-255,66,102103,63,150283
8558,0.002512,74.125.68.0-255,1484,103587,63,150283
8559,0.002525,74.125.68.0-255,2902,106489,63,150283
8560,0.002527,172.31.40.0-255,66,106555,63,150283
8561,0.002545,74.125.68.0-255,2902,109457,63,150283
8562,0.002548,172.31.40.0-255,66,109523,63,150283
8563,0.002565,74.125.68.0-255,2902,112425,63,150283
8564,0.002567,172.31.40.0-255,66,112491,63,150283
8565,0.002571,74.125.68.0-255,2902,115393,63,150283
8566,0.002574,172.31.40.0-255,66,115459,63,150283
8567,0.005113,74.125.68.0-255,5738,121197,63,150283
8568,0.00512,172.31.40.0-255,66,121263,63,150283
8569,0.007708,74.125.68.0-255,5738,127001,63,150283
8570,0.007713,172.31.40.0-255,66,127067,63,150283
8571,0.010284,74.125.68.0-255,5738,132805,63,150283
8572,0.010294,172.31.40.0-255,66,132871,63,150283
8573,0.012858,74.125.68.0-255,5738,138609,63,150283
8574,0.012869,172.31.40.0-255,66,138675,63,150283
8575,0.015438,74.125.68.0-255,5738,144413,63,150283
8576,0.01545,172.31.40.0-255,66,144479,63,150283
8577,0.018011,74.125.68.0-255,5738,150217,63,150283
8578,0.01802,172.31.40.0-255,66,150283,63,150283
8579,0.0,74.125.68.0-255,153,153,63,332146
8580,2.1e-05,172.31.40.0-255,66,219,63,332146
8581,2.7e-05,74.125.68.0-255,1484,1703,63,332146
8582,3.2e-05,172.31.40.0-255,66,1769,63,332146
8583,5.4e-05,74.125.68.0-255,1484,3253,63,332146
8584,5.6e-05,172.31.40.0-255,66,3319,63,332146
8585,7.8e-05,74.125.68.0-255,2902,6221,63,332146
8586,8e-05,172.31.40.0-255,66,6287,63,332146
8587,9.4e-05,74.125.68.0-255,5738,12025,63,332146
8588,9.7e-05,172.31.40.0-255,66,12091,63,332146
8589,0.00011,74.125.68.0-255,1484,13575,63,332146
8590,0.000112,172.31.40.0-255,66,13641,63,332146
8591,0.00013,74.125.68.0-255,611,14252,63,332146
8592,0.000132,172.31.40.0-255,66,14318,63,332146
8593,0.00027,74.125.68.0-255,1484,15802,63,332146
8594,0.000275,172.31.40.0-255,66,15868,63,332146
8595,0.00028,74.125.68.0-255,2902,18770,63,332146
8596,0.000282,172.31.40.0-255,66,18836,63,332146
8597,0.00032,74.125.68.0-255,5738,24574,63,332146
8598,0.000322,172.31.40.0-255,66,24640,63,332146
8599,0.000326,74.125.68.0-255,2902,27542,63,332146
8600,0.000328,172.31.40.0-255,66,27608,63,332146
8601,0.000333,74.125.68.0-255,3961,31569,63,332146
8602,0.000336,172.31.40.0-255,66,31635,63,332146
8603,0.000356,74.125.68.0-255,4320,35955,63,332146
8604,0.000359,172.31.40.0-255,66,36021,63,332146
8605,0.000379,74.125.68.0-255,4320,40341,63,332146
8606,0.000381,172.31.40.0-255,66,40407,63,332146
8607,0.000392,172.31.40.0-255,66,40473,63,332146
8608,0.000418,74.125.68.0-255,4320,44793,63,332146
8609,0.000421,172.31.40.0-255,66,44859,63,332146
8610,0.000442,74.125.68.0-255,7156,52015,63,332146
8611,0.000445,172.31.40.0-255,66,52081,63,332146
8612,0.000461,74.125.68.0-255,1484,53565,63,332146
8613,0.000478,74.125.68.0-255,2184,55749,63,332146
8614,0.00048,172.31.40.0-255,66,55815,63,332146
8615,0.000492,74.125.68.0-255,708,56523,63,332146
8616,0.00064,74.125.68.0-255,1484,58007,63,332146
8617,0.000644,172.31.40.0-255,66,58073,63,332146
8618,0.000649,74.125.68.0-255,2902,60975,63,332146
8619,0.000651,172.31.40.0-255,66,61041,63,332146
8620,0.000663,74.125.68.0-255,2902,63943,63,332146
8621,0.000667,172.31.40.0-255,66,64009,63,332146
8622,0.000684,74.125.68.0-255,4320,68329,63,332146
8623,0.000687,172.31.40.0-255,66,68395,63,332146
8624,0.000701,74.125.68.0-255,4320,72715,63,332146
8625,0.000704,172.31.40.0-255,66,72781,63,332146
8626,0.00073,74.125.68.0-255,4320,77101,63,332146
8627,0.000732,172.31.40.0-255,66,77167,63,332146
8628,0.000737,74.125.68.0-255,2902,80069,63,332146
8629,0.000739,172.31.40.0-255,66,80135,63,332146
8630,0.000743,74.125.68.0-255,4320,84455,63,332146
8631,0.000745,172.31.40.0-255,66,84521,63,332146
8632,0.000771,74.125.68.0-255,4320,88841,63,332146
8633,0.000773,172.31.40.0-255,66,88907,63,332146
8634,0.000783,74.125.68.0-255,2184,91091,63,332146
8635,0.000786,172.31.40.0-255,66,91157,63,332146
8636,0.001053,74.125.68.0-255,1484,92641,63,332146
8637,0.001068,74.125.68.0-255,1484,94125,63,332146
8638,0.001072,172.31.40.0-255,66,94191,63,332146
8639,0.001078,74.125.68.0-255,2902,97093,63,332146
8640,0.00108,172.31.40.0-255,66,97159,63,332146
8641,0.001103,74.125.68.0-255,5738,102897,63,332146
8642,0.001106,172.31.40.0-255,66,102963,63,332146
8643,0.001132,74.125.68.0-255,7156,110119,63,332146
8644,0.001135,172.31.40.0-255,66,110185,63,332146
8645,0.001145,172.31.40.0-255,66,110251,63,332146
8646,0.001166,74.125.68.0-255,1484,111735,63,332146
8647,0.001182,74.125.68.0-255,5020,116755,63,332146
8648,0.001185,172.31.40.0-255,66,116821,63,332146
8649,0.001249,74.125.68.0-255,1484,118305,63,332146
8650,0.001267,74.125.68.0-255,2902,121207,63,332146
8651,0.00127,172.31.40.0-255,66,121273,63,332146
8652,0.001294,74.125.68.0-255,4320,125593,63,332146
8653,0.001297,172.31.40.0-255,66,125659,63,332146
8654,0.001301,74.125.68.0-255,2902,128561,63,332146
8655,0.001303,172.31.40.0-255,66,128627,63,332146
8656,0.001322,74.125.68.0-255,5738,134365,63,332146
8657,0.001325,172.31.40.0-255,66,134431,63,332146
8658,0.001331,74.125.68.0-255,4320,138751,63,332146
8659,0.001333,172.31.40.0-255,66,138817,63,332146
8660,0.001351,74.125.68.0-255,2902,141719,63,332146
8661,0.001354,172.31.40.0-255,66,141785,63,332146
8662,0.001365,172.31.40.0-255,66,141851,63,332146
8663,0.001367,74.125.68.0-255,766,142617,63,332146
8664,0.001441,74.125.68.0-255,1484,144101,63,332146
8665,0.001444,172.31.40.0-255,66,144167,63,332146
8666,0.001449,74.125.68.0-255,2902,147069,63,332146
8667,0.001452,172.31.40.0-255,66,147135,63,332146
8668,0.001478,74.125.68.0-255,5738,152873,63,332146
8669,0.001481,172.31.40.0-255,66,152939,63,332146
8670,0.001486,74.125.68.0-255,2902,155841,63,332146
8671,0.001488,172.31.40.0-255,66,155907,63,332146
8672,0.001505,74.125.68.0-255,4320,160227,63,332146
8673,0.001508,172.31.40.0-255,66,160293,63,332146
8674,0.001551,172.31.40.0-255,66,160359,63,332146
8675,0.001571,74.125.68.0-255,2184,162543,63,332146
8676,0.001574,172.31.40.0-255,66,162609,63,332146
8677,0.001635,74.125.68.0-255,1484,164093,63,332146
8678,0.001654,74.125.68.0-255,2902,166995,63,332146
8679,0.001658,172.31.40.0-255,66,167061,63,332146
8680,0.001677,74.125.68.0-255,5738,172799,63,332146
8681,0.00168,172.31.40.0-255,66,172865,63,332146
8682,0.001684,74.125.68.0-255,2902,175767,63,332146
8683,0.001686,172.31.40.0-255,66,175833,63,332146
8684,0.001692,74.125.68.0-255,4320,180153,63,332146
8685,0.001694,172.31.40.0-255,66,180219,63,332146
8686,0.00173,172.31.40.0-255,66,180285,63,332146
8687,0.001737,74.125.68.0-255,5738,186023,63,332146
8688,0.001739,172.31.40.0-255,66,186089,63,332146
8689,0.001759,74.125.68.0-255,4320,190409,63,332146
8690,0.001761,172.31.40.0-255,66,190475,63,332146
8691,0.001785,74.125.68.0-255,2184,192659,63,332146
8692,0.001788,172.31.40.0-255,66,192725,63,332146
8693,0.001795,74.125.68.0-255,5738,198463,63,332146
8694,0.001797,172.31.40.0-255,66,198529,63,332146
8695,0.001809,74.125.68.0-255,7156,205685,63,332146
8696,0.001811,172.31.40.0-255,66,205751,63,332146
8697,0.001846,172.31.40.0-255,66,205817,63,332146
8698,0.001863,74.125.68.0-255,2902,208719,63,332146
8699,0.001865,172.31.40.0-255,66,208785,63,332146
8700,0.001879,74.125.68.0-255,3602,212387,63,332146
8701,0.001881,172.31.40.0-255,66,212453,63,332146
8702,0.001958,74.125.68.0-255,1484,213937,63,332146
8703,0.001972,74.125.68.0-255,1484,215421,63,332146
8704,0.001975,172.31.40.0-255,66,215487,63,332146
8705,0.002,74.125.68.0-255,1484,216971,63,332146
8706,0.002005,74.125.68.0-255,4320,221291,63,332146
8707,0.002008,172.31.40.0-255,66,221357,63,332146
8708,0.002013,74.125.68.0-255,2902,224259,63,332146
8709,0.002015,172.31.40.0-255,66,224325,63,332146
8710,0.002047,74.125.68.0-255,5738,230063,63,332146
8711,0.00205,172.31.40.0-255,66,230129,63,332146
8712,0.002056,74.125.68.0-255,4320,234449,63,332146
8713,0.002058,172.31.40.0-255,66,234515,63,332146
8714,0.002064,74.125.68.0-255,5738,240253,63,332146
8715,0.002066,172.31.40.0-255,66,240319,63,332146
8716,0.002098,74.125.68.0-255,6438,246757,63,332146
8717,0.002101,172.31.40.0-255,66,246823,63,332146
8718,0.002176,74.125.68.0-255,1484,248307,63,332146
8719,0.002213,74.125.68.0-255,2902,251209,63,332146
8720,0.002216,172.31.40.0-255,66,251275,63,332146
8721,0.002223,74.125.68.0-255,5738,257013,63,332146
8722,0.002226,172.31.40.0-255,66,257079,63,332146
8723,0.002262,172.31.40.0-255,66,257145,63,332146
8724,0.002268,74.125.68.0-255,4320,261465,63,332146
8725,0.00227,172.31.40.0-255,66,261531,63,332146
8726,0.002287,74.125.68.0-255,7156,268687,63,332146
8727,0.002289,172.31.40.0-255,66,268753,63,332146
8728,0.002293,74.125.68.0-255,2184,270937,63,332146
8729,0.002298,74.125.68.0-255,2902,273839,63,332146
8730,0.002315,74.125.68.0-255,5738,279577,63,332146
8731,0.002327,74.125.68.0-255,1484,281061,63,332146
8732,0.002331,74.125.68.0-255,2902,283963,63,332146
8733,0.002347,74.125.68.0-255,5738,289701,63,332146
8734,0.002351,74.125.68.0-255,2902,292603,63,332146
8735,0.002381,74.125.68.0-255,7156,299759,63,332146
8736,0.002384,74.125.68.0-255,1484,301243,63,332146
8737,0.0024,74.125.68.0-255,3602,304845,63,332146
8738,0.002436,74.125.68.0-255,2902,307747,63,332146
8739,0.002458,74.125.68.0-255,4320,312067,63,332146
8740,0.002478,74.125.68.0-255,2902,314969,63,332146
8741,0.002493,74.125.68.0-255,5738,320707,63,332146
8742,0.002498,74.125.68.0-255,4320,325027,63,332146
8743,0.002537,74.125.68.0-255,1484,326511,63,332146
8744,0.002554,74.125.68.0-255,4320,330831,63,332146
8745,0.002562,74.125.68.0-255,385,331216,63,332146
8746,0.013266,172.31.40.0-255,66,331282,63,332146
8747,0.014181,74.125.68.0-255,168,331450,63,332146
8748,0.015427,172.31.40.0-255,105,331555,63,332146
8749,0.015458,172.31.40.0-255,105,331660,63,332146
8750,0.015839,172.31.40.0-255,90,331750,63,332146
8751,0.015849,172.31.40.0-255,66,331816,63,332146
8752,0.017981,74.125.68.0-255,66,331882,63,332146
8753,0.017991,74.125.68.0-255,66,331948,63,332146
8754,0.018382,74.125.68.0-255,66,332014,63,332146
8755,0.018405,74.125.68.0-255,66,332080,63,332146
8756,0.018413,172.31.40.0-255,66,332146,63,332146
8757,0.0,74.125.24.0-255,153,153,63,288394
8758,2.1e-05,172.31.40.0-255,66,219,63,288394
8759,2.8e-05,74.125.24.0-255,1484,1703,63,288394
8760,3.3e-05,172.31.40.0-255,66,1769,63,288394
8761,3.8e-05,74.125.24.0-255,2902,4671,63,288394
8762,4.1e-05,172.31.40.0-255,66,4737,63,288394
8763,5.7e-05,74.125.24.0-255,1484,6221,63,288394
8764,6e-05,172.31.40.0-255,66,6287,63,288394
8765,9.3e-05,74.125.24.0-255,4320,10607,63,288394
8766,0.0001,172.31.40.0-255,66,10673,63,288394
8767,0.000106,74.125.24.0-255,3534,14207,63,288394
8768,0.000108,172.31.40.0-255,66,14273,63,288394
8769,0.000618,74.125.24.0-255,1484,15757,63,288394
8770,0.000624,172.31.40.0-255,66,15823,63,288394
8771,0.000631,74.125.24.0-255,2902,18725,63,288394
8772,0.000633,172.31.40.0-255,66,18791,63,288394
8773,0.000637,74.125.24.0-255,2902,21693,63,288394
8774,0.000644,172.31.40.0-255,66,21759,63,288394
8775,0.000685,74.125.24.0-255,7156,28915,63,288394
8776,0.000688,172.31.40.0-255,66,28981,63,288394
8777,0.000693,74.125.24.0-255,2902,31883,63,288394
8778,0.000695,172.31.40.0-255,66,31949,63,288394
8779,0.000719,74.125.24.0-255,2543,34492,63,288394
8780,0.000723,172.31.40.0-255,66,34558,63,288394
8781,0.000733,74.125.24.0-255,5738,40296,63,288394
8782,0.000736,172.31.40.0-255,66,40362,63,288394
8783,0.000747,172.31.40.0-255,66,40428,63,288394
8784,0.000779,74.125.24.0-255,2902,43330,63,288394
8785,0.000781,172.31.40.0-255,66,43396,63,288394
8786,0.000787,74.125.24.0-255,4320,47716,63,288394
8787,0.000789,172.31.40.0-255,66,47782,63,288394
8788,0.000808,74.125.24.0-255,5738,53520,63,288394
8789,0.000816,172.31.40.0-255,66,53586,63,288394
8790,0.000838,74.125.24.0-255,2184,55770,63,288394
8791,0.000841,172.31.40.0-255,66,55836,63,288394
8792,0.000844,74.125.24.0-255,394,56230,63,288394
8793,0.000898,74.125.24.0-255,348,56578,63,288394
8794,0.001036,74.125.24.0-255,1484,58062,63,288394
8795,0.001041,172.31.40.0-255,66,58128,63,288394
8796,0.001072,74.125.24.0-255,2902,61030,63,288394
8797,0.001076,172.31.40.0-255,66,61096,63,288394
8798,0.001082,74.125.24.0-255,5738,66834,63,288394
8799,0.001084,172.31.40.0-255,66,66900,63,288394
8800,0.00113,172.31.40.0-255,66,66966,63,288394
8801,0.001141,74.125.24.0-255,1484,68450,63,288394
8802,0.001144,74.125.24.0-255,1484,69934,63,288394
8803,0.00115,172.31.40.0-255,66,70000,63,288394
8804,0.00119,172.31.40.0-255,66,70066,63,288394
8805,0.002107,74.125.24.0-255,1484,71550,63,288394
8806,0.002117,74.125.24.0-255,2902,74452,63,288394
8807,0.002121,172.31.40.0-255,66,74518,63,288394
8808,0.00215,74.125.24.0-255,5738,80256,63,288394
8809,0.002153,172.31.40.0-255,66,80322,63,288394
8810,0.002156,74.125.24.0-255,1484,81806,63,288394
8811,0.002181,74.125.24.0-255,1484,83290,63,288394
8812,0.002183,172.31.40.0-255,66,83356,63,288394
8813,0.002195,172.31.40.0-255,66,83422,63,288394
8814,0.002208,74.125.24.0-255,1484,84906,63,288394
8815,0.002218,74.125.24.0-255,5738,90644,63,288394
8816,0.002221,172.31.40.0-255,66,90710,63,288394
8817,0.002253,74.125.24.0-255,4320,95030,63,288394
8818,0.002256,172.31.40.0-255,66,95096,63,288394
8819,0.002259,74.125.24.0-255,766,95862,63,288394
8820,0.002317,74.125.24.0-255,1484,97346,63,288394
8821,0.00232,172.31.40.0-255,66,97412,63,288394
8822,0.002323,74.125.24.0-255,1484,98896,63,288394
8823,0.002344,74.125.24.0-255,1484,100380,63,288394
8824,0.002346,172.31.40.0-255,66,100446,63,288394
8825,0.002354,74.125.24.0-255,5738,106184,63,288394
8826,0.002356,172.31.40.0-255,66,106250,63,288394
8827,0.002371,74.125.24.0-255,2902,109152,63,288394
8828,0.002373,172.31.40.0-255,66,109218,63,288394
8829,0.002399,74.125.24.0-255,2902,112120,63,288394
8830,0.002404,172.31.40.0-255,66,112186,63,288394
8831,0.002411,74.125.24.0-255,5738,117924,63,288394
8832,0.002413,172.31.40.0-255,66,117990,63,288394
8833,0.002436,74.125.24.0-255,7156,125146,63,288394
8834,0.002438,172.31.40.0-255,66,125212,63,288394
8835,0.002444,74.125.24.0-255,4320,129532,63,288394
8836,0.002446,172.31.40.0-255,66,129598,63,288394
8837,0.00245,74.125.24.0-255,766,130364,63,288394
8838,0.002628,74.125.24.0-255,1484,131848,63,288394
8839,0.002633,172.31.40.0-255,66,131914,63,288394
8840,0.002639,74.125.24.0-255,2902,134816,63,288394
8841,0.002642,172.31.40.0-255,66,134882,63,288394
8842,0.002675,74.125.24.0-255,5738,140620,63,288394
8843,0.002678,172.31.40.0-255,66,140686,63,288394
8844,0.002683,74.125.24.0-255,2902,143588,63,288394
8845,0.002685,172.31.40.0-255,66,143654,63,288394
8846,0.002693,74.125.24.0-255,7156,150810,63,288394
8847,0.002695,172.31.40.0-255,66,150876,63,288394
8848,0.002738,74.125.24.0-255,2902,153778,63,288394
8849,0.002741,172.31.40.0-255,66,153844,63,288394
8850,0.002759,172.31.40.0-255,66,153910,63,288394
8851,0.002783,74.125.24.0-255,1484,155394,63,288394
8852,0.002801,74.125.24.0-255,1484,156878,63,288394
8853,0.002803,172.31.40.0-255,66,156944,63,288394
8854,0.00283,74.125.24.0-255,1484,158428,63,288394
8855,0.002836,74.125.24.0-255,4320,162748,63,288394
8856,0.002839,172.31.40.0-255,66,162814,63,288394
8857,0.00285,172.31.40.0-255,66,162880,63,288394
8858,0.00288,74.125.24.0-255,4320,167200,63,288394
8859,0.002883,172.31.40.0-255,66,167266,63,288394
8860,0.002907,74.125.24.0-255,2902,170168,63,288394
8861,0.00291,172.31.40.0-255,66,170234,63,288394
8862,0.00292,172.31.40.0-255,66,170300,63,288394
8863,0.002927,74.125.24.0-255,766,171066,63,288394
8864,0.003679,74.125.24.0-255,1484,172550,63,288394
8865,0.003685,172.31.40.0-255,66,172616,63,288394
8866,0.003691,74.125.24.0-255,2902,175518,63,288394
8867,0.003694,172.31.40.0-255,66,175584,63,288394
8868,0.003706,74.125.24.0-255,5738,181322,63,288394
8869,0.003708,172.31.40.0-255,66,181388,63,288394
8870,0.003745,74.125.24.0-255,5738,187126,63,288394
8871,0.003748,172.31.40.0-255,66,187192,63,288394
8872,0.003781,74.125.24.0-255,7156,194348,63,288394
8873,0.003784,172.31.40.0-255,66,194414,63,288394
8874,0.003792,74.125.24.0-255,7156,201570,63,288394
8875,0.003794,172.31.40.0-255,66,201636,63,288394
8876,0.003827,74.125.24.0-255,3602,205238,63,288394
8877,0.003829,172.31.40.0-255,66,205304,63,288394
8878,0.003944,74.125.24.0-255,1484,206788,63,288394
8879,0.003968,74.125.24.0-255,2902,209690,63,288394
8880,0.003972,172.31.40.0-255,66,209756,63,288394
8881,0.003979,74.125.24.0-255,5738,215494,63,288394
8882,0.003981,172.31.40.0-255,66,215560,63,288394
8883,0.003991,74.125.24.0-255,4320,219880,63,288394
8884,0.003994,172.31.40.0-255,66,219946,63,288394
8885,0.003999,74.125.24.0-255,4320,224266,63,288394
8886,0.004001,172.31.40.0-255,66,224332,63,288394
8887,0.004039,74.125.24.0-255,7156,231488,63,288394
8888,0.004043,172.31.40.0-255,66,231554,63,288394
8889,0.004058,172.31.40.0-255,66,231620,63,288394
8890,0.004076,172.31.40.0-255,66,231686,63,288394
8891,0.0041,74.125.24.0-255,4320,236006,63,288394
8892,0.004106,172.31.40.0-255,66,236072,63,288394
8893,0.004119,172.31.40.0-255,66,236138,63,288394
8894,0.004199,74.125.24.0-255,1484,237622,63,288394
8895,0.004205,74.125.24.0-255,2902,240524,63,288394
8896,0.004208,172.31.40.0-255,66,240590,63,288394
8897,0.004246,74.125.24.0-255,5738,246328,63,288394
8898,0.00425,172.31.40.0-255,66,246394,63,288394
8899,0.004256,74.125.24.0-255,5738,252132,63,288394
8900,0.004259,172.31.40.0-255,66,252198,63,288394
8901,0.004308,74.125.24.0-255,5738,257936,63,288394
8902,0.004311,172.31.40.0-255,66,258002,63,288394
8903,0.004342,74.125.24.0-255,7156,265158,63,288394
8904,0.004346,172.31.40.0-255,66,265224,63,288394
8905,0.004352,74.125.24.0-255,5020,270244,63,288394
8906,0.004354,172.31.40.0-255,66,270310,63,288394
8907,0.004491,74.125.24.0-255,1484,271794,63,288394
8908,0.004497,74.125.24.0-255,2902,274696,63,288394
8909,0.004501,172.31.40.0-255,66,274762,63,288394
8910,0.004504,74.125.24.0-255,1484,276246,63,288394
8911,0.004536,172.31.40.0-255,66,276312,63,288394
8912,0.004542,74.125.24.0-255,4320,280632,63,288394
8913,0.004544,172.31.40.0-255,66,280698,63,288394
8914,0.004578,74.125.24.0-255,5738,286436,63,288394
8915,0.004581,172.31.40.0-255,66,286502,63,288394
8916,0.004584,74.125.24.0-255,1484,287986,63,288394
8917,0.004619,172.31.40.0-255,66,288052,63,288394
8918,0.004645,74.125.24.0-255,105,288157,63,288394
8919,0.012416,172.31.40.0-255,66,288223,63,288394
8920,0.012465,172.31.40.0-255,105,288328,63,288394
8921,0.014737,74.125.24.0-255,66,288394,63,288394
8922,0.0,172.217.194.0-255,153,153,63,155169
8923,2.4e-05,172.31.40.0-255,66,219,63,155169
8924,3.1e-05,172.217.194.0-255,1484,1703,63,155169
8925,3.6e-05,172.31.40.0-255,66,1769,63,155169
8926,4.2e-05,172.217.194.0-255,2902,4671,63,155169
8927,4.4e-05,172.31.40.0-255,66,4737,63,155169
8928,5e-05,172.217.194.0-255,4320,9057,63,155169
8929,5.3e-05,172.31.40.0-255,66,9123,63,155169
8930,7.8e-05,172.217.194.0-255,2902,12025,63,155169
8931,8.1e-05,172.31.40.0-255,66,12091,63,155169
8932,8.6e-05,172.217.194.0-255,1938,14029,63,155169
8933,8.8e-05,172.31.40.0-255,66,14095,63,155169
8934,9.4e-05,172.217.194.0-255,2902,16997,63,155169
8935,9.5e-05,172.31.40.0-255,66,17063,63,155169
8936,0.000103,172.217.194.0-255,7156,24219,63,155169
8937,0.000106,172.31.40.0-255,66,24285,63,155169
8938,0.000109,172.217.194.0-255,1484,25769,63,155169
8939,0.000112,172.31.40.0-255,66,25835,63,155169
8940,0.000159,172.31.40.0-255,66,25901,63,155169
8941,0.000166,172.217.194.0-255,5738,31639,63,155169
8942,0.000169,172.31.40.0-255,66,31705,63,155169
8943,0.000183,172.217.194.0-255,2184,33889,63,155169
8944,0.000186,172.31.40.0-255,66,33955,63,155169
8945,0.000197,172.31.40.0-255,66,34021,63,155169
8946,0.000221,172.217.194.0-255,5738,39759,63,155169
8947,0.000224,172.31.40.0-255,66,39825,63,155169
8948,0.000243,172.217.194.0-255,2833,42658,63,155169
8949,0.000246,172.31.40.0-255,66,42724,63,155169
8950,0.000249,172.217.194.0-255,365,43089,63,155169
8951,0.000251,172.31.40.0-255,66,43155,63,155169
8952,0.000524,172.217.194.0-255,1484,44639,63,155169
8953,0.00053,172.217.194.0-255,2902,47541,63,155169
8954,0.000534,172.31.40.0-255,66,47607,63,155169
8955,0.000552,172.217.194.0-255,5738,53345,63,155169
8956,0.000555,172.31.40.0-255,66,53411,63,155169
8957,0.000593,172.31.40.0-255,66,53477,63,155169
8958,0.000606,172.31.40.0-255,66,53543,63,155169
8959,0.000648,172.217.194.0-255,2184,55727,63,155169
8960,0.000651,172.31.40.0-255,66,55793,63,155169
8961,0.001229,172.217.194.0-255,1484,57277,63,155169
8962,0.001237,172.217.194.0-255,2902,60179,63,155169
8963,0.00124,172.31.40.0-255,66,60245,63,155169
8964,0.001248,172.217.194.0-255,5738,65983,63,155169
8965,0.001251,172.31.40.0-255,66,66049,63,155169
8966,0.001287,172.31.40.0-255,66,66115,63,155169
8967,0.0013,172.217.194.0-255,1484,67599,63,155169
8968,0.001334,172.217.194.0-255,4320,71919,63,155169
8969,0.001338,172.31.40.0-255,66,71985,63,155169
8970,0.001359,172.217.194.0-255,6438,78423,63,155169
8971,0.001362,172.31.40.0-255,66,78489,63,155169
8972,0.002017,172.217.194.0-255,1484,79973,63,155169
8973,0.002035,172.217.194.0-255,2902,82875,63,155169
8974,0.002039,172.31.40.0-255,66,82941,63,155169
8975,0.002046,172.217.194.0-255,4320,87261,63,155169
8976,0.002047,172.31.40.0-255,66,87327,63,155169
8977,0.002078,172.31.40.0-255,66,87393,63,155169
8978,0.002101,172.217.194.0-255,1484,88877,63,155169
8979,0.002148,172.31.40.0-255,66,88943,63,155169
8980,0.002162,172.31.40.0-255,66,89009,63,155169
8981,0.002167,172.217.194.0-255,4320,93329,63,155169
8982,0.002169,172.31.40.0-255,66,93395,63,155169
8983,0.002201,172.31.40.0-255,66,93461,63,155169
8984,0.002208,172.217.194.0-255,6438,99899,63,155169
8985,0.00221,172.31.40.0-255,66,99965,63,155169
8986,0.002243,172.217.194.0-255,7156,107121,63,155169
8987,0.002246,172.31.40.0-255,66,107187,63,155169
8988,0.002258,172.31.40.0-255,66,107253,63,155169
8989,0.002299,172.217.194.0-255,7156,114409,63,155169
8990,0.002302,172.31.40.0-255,66,114475,63,155169
8991,0.002333,172.31.40.0-255,66,114541,63,155169
8992,0.00468,172.217.194.0-255,5738,120279,63,155169
8993,0.004687,172.31.40.0-255,66,120345,63,155169
8994,0.007026,172.217.194.0-255,5738,126083,63,155169
8995,0.007033,172.31.40.0-255,66,126149,63,155169
8996,0.009383,172.217.194.0-255,5738,131887,63,155169
8997,0.009389,172.31.40.0-255,66,131953,63,155169
8998,0.011712,172.217.194.0-255,5738,137691,63,155169
8999,0.01172,172.31.40.0-255,66,137757,63,155169
9000,0.014104,172.217.194.0-255,5738,143495,63,155169
9001,0.014119,172.31.40.0-255,66,143561,63,155169
9002,0.016468,172.217.194.0-255,5738,149299,63,155169
9003,0.016482,172.31.40.0-255,66,149365,63,155169
9004,0.018835,172.217.194.0-255,5738,155103,63,155169
9005,0.018849,172.31.40.0-255,66,155169,63,155169
9006,0.0,74.125.130.0-255,300,300,63,190090
9007,2.5e-05,172.31.40.0-255,66,366,63,190090
9008,3.3e-05,74.125.130.0-255,1484,1850,63,190090
9009,3.7e-05,172.31.40.0-255,66,1916,63,190090
9010,4.5e-05,74.125.130.0-255,4320,6236,63,190090
9011,4.8e-05,172.31.40.0-255,66,6302,63,190090
9012,5.9e-05,172.31.40.0-255,66,6368,63,190090
9013,8.2e-05,74.125.130.0-255,4320,10688,63,190090
9014,8.5e-05,172.31.40.0-255,66,10754,63,190090
9015,0.000114,74.125.130.0-255,4320,15074,63,190090
9016,0.000117,172.31.40.0-255,66,15140,63,190090
9017,0.000129,172.31.40.0-255,66,15206,63,190090
9018,0.000133,74.125.130.0-255,1484,16690,63,190090
9019,0.000135,172.31.40.0-255,66,16756,63,190090
9020,0.000177,172.31.40.0-255,66,16822,63,190090
9021,0.000201,74.125.130.0-255,5738,22560,63,190090
9022,0.000204,172.31.40.0-255,66,22626,63,190090
9023,0.00021,74.125.130.0-255,7156,29782,63,190090
9024,0.000212,172.31.40.0-255,66,29848,63,190090
9025,0.000229,74.125.130.0-255,1484,31332,63,190090
9026,0.000231,172.31.40.0-255,66,31398,63,190090
9027,0.00025,74.125.130.0-255,3132,34530,63,190090
9028,0.000252,172.31.40.0-255,66,34596,63,190090
9029,0.000378,74.125.130.0-255,1484,36080,63,190090
9030,0.000381,172.31.40.0-255,66,36146,63,190090
9031,0.000386,74.125.130.0-255,1484,37630,63,190090
9032,0.000388,172.31.40.0-255,66,37696,63,190090
9033,0.000404,74.125.130.0-255,1484,39180,63,190090
9034,0.000406,172.31.40.0-255,66,39246,63,190090
9035,0.000414,74.125.130.0-255,5738,44984,63,190090
9036,0.000416,172.31.40.0-255,66,45050,63,190090
9037,0.000439,74.125.130.0-255,2902,47952,63,190090
9038,0.000441,172.31.40.0-255,66,48018,63,190090
9039,0.000462,74.125.130.0-255,3961,51979,63,190090
9040,0.000465,172.31.40.0-255,66,52045,63,190090
9041,0.000502,74.125.130.0-255,2902,54947,63,190090
9042,0.000504,172.31.40.0-255,66,55013,63,190090
9043,0.000524,74.125.130.0-255,4320,59333,63,190090
9044,0.000527,172.31.40.0-255,66,59399,63,190090
9045,0.000533,74.125.130.0-255,5738,65137,63,190090
9046,0.000535,172.31.40.0-255,66,65203,63,190090
9047,0.000541,74.125.130.0-255,3412,68615,63,190090
9048,0.000544,172.31.40.0-255,66,68681,63,190090
9049,0.000587,74.125.130.0-255,1484,70165,63,190090
9050,0.000591,74.125.130.0-255,1484,71649,63,190090
9051,0.000593,172.31.40.0-255,66,71715,63,190090
9052,0.000612,74.125.130.0-255,1484,73199,63,190090
9053,0.000618,74.125.130.0-255,4320,77519,63,190090
9054,0.00062,172.31.40.0-255,66,77585,63,190090
9055,0.000634,74.125.130.0-255,1484,79069,63,190090
9056,0.000639,74.125.130.0-255,2902,81971,63,190090
9057,0.000641,172.31.40.0-255,66,82037,63,190090
9058,0.000676,172.31.40.0-255,66,82103,63,190090
9059,0.000689,172.31.40.0-255,66,82169,63,190090
9060,0.000691,74.125.130.0-255,1125,83294,63,190090
9061,0.000903,74.125.130.0-255,1484,84778,63,190090
9062,0.000909,74.125.130.0-255,2902,87680,63,190090
9063,0.000913,74.125.130.0-255,4320,92000,63,190090
9064,0.000918,172.31.40.0-255,66,92066,63,190090
9065,0.000921,172.31.40.0-255,66,92132,63,190090
9066,0.000924,172.31.40.0-255,66,92198,63,190090
9067,0.000947,172.31.40.0-255,66,92264,63,190090
9068,0.000986,74.125.130.0-255,7156,99420,63,190090
9069,0.00099,172.31.40.0-255,66,99486,63,190090
9070,0.001016,172.31.40.0-255,66,99552,63,190090
9071,0.001295,74.125.130.0-255,1484,101036,63,190090
9072,0.001302,74.125.130.0-255,2902,103938,63,190090
9073,0.001305,172.31.40.0-255,66,104004,63,190090
9074,0.001313,74.125.130.0-255,5738,109742,63,190090
9075,0.001315,172.31.40.0-255,66,109808,63,190090
9076,0.001343,74.125.130.0-255,7156,116964,63,190090
9077,0.001346,172.31.40.0-255,66,117030,63,190090
9078,0.001365,74.125.130.0-255,2902,119932,63,190090
9079,0.001368,172.31.40.0-255,66,119998,63,190090
9080,0.001392,172.31.40.0-255,66,120064,63,190090
9081,0.001409,74.125.130.0-255,2184,122248,63,190090
9082,0.001411,172.31.40.0-255,66,122314,63,190090
9083,0.001469,74.125.130.0-255,1484,123798,63,190090
9084,0.001488,74.125.130.0-255,2902,126700,63,190090
9085,0.001491,172.31.40.0-255,66,126766,63,190090
9086,0.001498,74.125.130.0-255,5738,132504,63,190090
9087,0.0015,172.31.40.0-255,66,132570,63,190090
9088,0.001537,172.31.40.0-255,66,132636,63,190090
9089,0.001549,172.31.40.0-255,66,132702,63,190090
9090,0.001569,74.125.130.0-255,5020,137722,63,190090
9091,0.001572,172.31.40.0-255,66,137788,63,190090
9092,0.001958,74.125.130.0-255,1484,139272,63,190090
9093,0.003513,74.125.130.0-255,4320,143592,63,190090
9094,0.003526,172.31.40.0-255,66,143658,63,190090
9095,0.005467,74.125.130.0-255,5738,149396,63,190090
9096,0.005478,172.31.40.0-255,66,149462,63,190090
9097,0.007418,74.125.130.0-255,5738,155200,63,190090
9098,0.007428,172.31.40.0-255,66,155266,63,190090
9099,0.009426,74.125.130.0-255,5738,161004,63,190090
9100,0.009447,172.31.40.0-255,66,161070,63,190090
9101,0.011399,74.125.130.0-255,5738,166808,63,190090
9102,0.011419,172.31.40.0-255,66,166874,63,190090
9103,0.013434,74.125.130.0-255,5738,172612,63,190090
9104,0.013455,172.31.40.0-255,66,172678,63,190090
9105,0.015436,74.125.130.0-255,5738,178416,63,190090
9106,0.015453,172.31.40.0-255,66,178482,63,190090
9107,0.017409,74.125.130.0-255,5738,184220,63,190090
9108,0.017423,172.31.40.0-255,66,184286,63,190090
9109,0.019377,74.125.130.0-255,5738,190024,63,190090
9110,0.019395,172.31.40.0-255,66,190090,63,190090
9111,0.0,172.217.194.0-255,152,152,63,122358
9112,1.5e-05,172.31.40.0-255,66,218,63,122358
9113,2.2e-05,172.217.194.0-255,1484,1702,63,122358
9114,2.6e-05,172.31.40.0-255,66,1768,63,122358
9115,3.1e-05,172.217.194.0-255,2902,4670,63,122358
9116,3.4e-05,172.31.40.0-255,66,4736,63,122358
9117,0.000109,172.217.194.0-255,7156,11892,63,122358
9118,0.000112,172.31.40.0-255,66,11958,63,122358
9119,0.000318,172.217.194.0-255,2002,13960,63,122358
9120,0.000325,172.31.40.0-255,66,14026,63,122358
9121,0.000374,172.217.194.0-255,4320,18346,63,122358
9122,0.000378,172.31.40.0-255,66,18412,63,122358
9123,0.000417,172.31.40.0-255,66,18478,63,122358
9124,0.000819,172.217.194.0-255,1125,19603,63,122358
9125,0.000824,172.31.40.0-255,66,19669,63,122358
9126,0.00086,172.217.194.0-255,4320,23989,63,122358
9127,0.000863,172.31.40.0-255,66,24055,63,122358
9128,0.000902,172.31.40.0-255,66,24121,63,122358
9129,0.001506,172.217.194.0-255,5738,29859,63,122358
9130,0.001512,172.31.40.0-255,66,29925,63,122358
9131,0.001532,172.217.194.0-255,5379,35304,63,122358
9132,0.001535,172.31.40.0-255,66,35370,63,122358
9133,0.001813,172.217.194.0-255,646,36016,63,122358
9134,0.001816,172.31.40.0-255,66,36082,63,122358
9135,0.001846,172.217.194.0-255,1484,37566,63,122358
9136,0.001848,172.31.40.0-255,66,37632,63,122358
9137,0.001893,172.217.194.0-255,4320,41952,63,122358
9138,0.001896,172.31.40.0-255,66,42018,63,122358
9139,0.002026,172.217.194.0-255,4320,46338,63,122358
9140,0.002028,172.31.40.0-255,66,46404,63,122358
9141,0.00205,172.217.194.0-255,5738,52142,63,122358
9142,0.002301,172.217.194.0-255,1484,53626,63,122358
9143,0.002817,172.217.194.0-255,1484,55110,63,122358
9144,0.002865,172.217.194.0-255,2902,58012,63,122358
9145,0.002934,172.217.194.0-255,1484,59496,63,122358
9146,0.002949,172.217.194.0-255,4320,63816,63,122358
9147,0.003117,172.217.194.0-255,5738,69554,63,122358
9148,0.003139,172.217.194.0-255,7156,76710,63,122358
9149,0.003484,172.217.194.0-255,4320,81030,63,122358
9150,0.003503,172.217.194.0-255,6438,87468,63,122358
9151,0.004427,172.31.40.0-255,66,87534,63,122358
9152,0.007004,172.217.194.0-255,5738,93272,63,122358
9153,0.007009,172.31.40.0-255,66,93338,63,122358
9154,0.009579,172.217.194.0-255,5738,99076,63,122358
9155,0.009586,172.31.40.0-255,66,99142,63,122358
9156,0.012181,172.217.194.0-255,5738,104880,63,122358
9157,0.01219,172.31.40.0-255,66,104946,63,122358
9158,0.014774,172.217.194.0-255,5738,110684,63,122358
9159,0.014781,172.31.40.0-255,66,110750,63,122358
9160,0.01734,172.217.194.0-255,5738,116488,63,122358
9161,0.017348,172.31.40.0-255,66,116554,63,122358
9162,0.019922,172.217.194.0-255,5738,122292,63,122358
9163,0.019933,172.31.40.0-255,66,122358,63,122358
9164,0.0,172.31.40.0-255,105,105,63,276
9165,0.00177,157.240.24.0-255,105,210,63,276
9166,0.001785,172.31.40.0-255,66,276,63,276
9167,0.0,172.217.194.0-255,152,152,63,170015
9168,2.2e-05,172.31.40.0-255,66,218,63,170015
9169,2.9e-05,172.217.194.0-255,1484,1702,63,170015
9170,3.3e-05,172.31.40.0-255,66,1768,63,170015
9171,3.8e-05,172.217.194.0-255,2902,4670,63,170015
9172,4.1e-05,172.31.40.0-255,66,4736,63,170015
9173,5.6e-05,172.217.194.0-255,7156,11892,63,170015
9174,5.8e-05,172.31.40.0-255,66,11958,63,170015
9175,8.1e-05,172.217.194.0-255,2029,13987,63,170015
9176,8.8e-05,172.31.40.0-255,66,14053,63,170015
9177,0.000111,172.217.194.0-255,1484,15537,63,170015
9178,0.000114,172.31.40.0-255,66,15603,63,170015
9179,0.000119,172.217.194.0-255,2902,18505,63,170015
9180,0.000121,172.31.40.0-255,66,18571,63,170015
9181,0.000155,172.217.194.0-255,5738,24309,63,170015
9182,0.000158,172.31.40.0-255,66,24375,63,170015
9183,0.000183,172.217.194.0-255,4320,28695,63,170015
9184,0.000186,172.31.40.0-255,66,28761,63,170015
9185,0.000213,172.217.194.0-255,2543,31304,63,170015
9186,0.000215,172.31.40.0-255,66,31370,63,170015
9187,0.000295,172.217.194.0-255,1484,32854,63,170015
9188,0.000299,172.31.40.0-255,66,32920,63,170015
9189,0.000304,172.217.194.0-255,2902,35822,63,170015
9190,0.000307,172.31.40.0-255,66,35888,63,170015
9191,0.000331,172.217.194.0-255,5738,41626,63,170015
9192,0.000334,172.31.40.0-255,66,41692,63,170015
9193,0.000383,172.217.194.0-255,6797,48489,63,170015
9194,0.000386,172.31.40.0-255,66,48555,63,170015
9195,0.000418,172.217.194.0-255,7156,55711,63,170015
9196,0.000421,172.31.40.0-255,66,55777,63,170015
9197,0.000426,172.217.194.0-255,2902,58679,63,170015
9198,0.000428,172.31.40.0-255,66,58745,63,170015
9199,0.000451,172.217.194.0-255,2902,61647,63,170015
9200,0.000453,172.31.40.0-255,66,61713,63,170015
9201,0.000478,172.217.194.0-255,3961,65674,63,170015
9202,0.000481,172.31.40.0-255,66,65740,63,170015
9203,0.000505,172.217.194.0-255,645,66385,63,170015
9204,0.001107,172.31.40.0-255,66,66451,63,170015
9205,0.001571,172.217.194.0-255,1484,67935,63,170015
9206,0.00158,172.217.194.0-255,2902,70837,63,170015
9207,0.001584,172.31.40.0-255,66,70903,63,170015
9208,0.00159,172.217.194.0-255,2902,73805,63,170015
9209,0.001592,172.31.40.0-255,66,73871,63,170015
9210,0.00162,172.217.194.0-255,2902,76773,63,170015
9211,0.001622,172.31.40.0-255,66,76839,63,170015
9212,0.001629,172.217.194.0-255,7156,83995,63,170015
9213,0.001631,172.31.40.0-255,66,84061,63,170015
9214,0.001655,172.217.194.0-255,7156,91217,63,170015
9215,0.001658,172.31.40.0-255,66,91283,63,170015
9216,0.001691,172.217.194.0-255,7156,98439,63,170015
9217,0.001693,172.31.40.0-255,66,98505,63,170015
9218,0.001697,172.217.194.0-255,2184,100689,63,170015
9219,0.001698,172.31.40.0-255,66,100755,63,170015
9220,0.002276,172.217.194.0-255,1484,102239,63,170015
9221,0.002282,172.217.194.0-255,2902,105141,63,170015
9222,0.002285,172.31.40.0-255,66,105207,63,170015
9223,0.002311,172.217.194.0-255,5738,110945,63,170015
9224,0.002314,172.31.40.0-255,66,111011,63,170015
9225,0.002317,172.217.194.0-255,1484,112495,63,170015
9226,0.002352,172.31.40.0-255,66,112561,63,170015
9227,0.002357,172.217.194.0-255,2902,115463,63,170015
9228,0.002359,172.31.40.0-255,66,115529,63,170015
9229,0.002392,172.31.40.0-255,66,115595,63,170015
9230,0.00244,172.31.40.0-255,66,115661,63,170015
9231,0.002448,172.217.194.0-255,7156,122817,63,170015
9232,0.002449,172.31.40.0-255,66,122883,63,170015
9233,0.002479,172.217.194.0-255,7156,130039,63,170015
9234,0.002481,172.31.40.0-255,66,130105,63,170015
9235,0.002488,172.217.194.0-255,5020,135125,63,170015
9236,0.002491,172.31.40.0-255,66,135191,63,170015
9237,0.005052,172.217.194.0-255,5738,140929,63,170015
9238,0.005058,172.31.40.0-255,66,140995,63,170015
9239,0.007636,172.217.194.0-255,5738,146733,63,170015
9240,0.007641,172.31.40.0-255,66,146799,63,170015
9241,0.010238,172.217.194.0-255,5738,152537,63,170015
9242,0.010245,172.31.40.0-255,66,152603,63,170015
9243,0.012813,172.217.194.0-255,5738,158341,63,170015
9244,0.012822,172.31.40.0-255,66,158407,63,170015
9245,0.01541,172.217.194.0-255,5738,164145,63,170015
9246,0.015419,172.31.40.0-255,66,164211,63,170015
9247,0.018013,172.217.194.0-255,5738,169949,63,170015
9248,0.018026,172.31.40.0-255,66,170015,63,170015
9249,0.0,74.125.68.0-255,146,146,63,247184
9250,2.3e-05,172.31.40.0-255,66,212,63,247184
9251,3e-05,74.125.68.0-255,1484,1696,63,247184
9252,3.5e-05,172.31.40.0-255,66,1762,63,247184
9253,3.9e-05,74.125.68.0-255,1484,3246,63,247184
9254,4.2e-05,172.31.40.0-255,66,3312,63,247184
9255,6.1e-05,74.125.68.0-255,1484,4796,63,247184
9256,6.4e-05,172.31.40.0-255,66,4862,63,247184
9257,7.1e-05,74.125.68.0-255,4320,9182,63,247184
9258,7.4e-05,172.31.40.0-255,66,9248,63,247184
9259,8e-05,74.125.68.0-255,4984,14232,63,247184
9260,8.2e-05,172.31.40.0-255,66,14298,63,247184
9261,0.000116,74.125.68.0-255,5738,20036,63,247184
9262,0.000119,172.31.40.0-255,66,20102,63,247184
9263,0.000139,74.125.68.0-255,2902,23004,63,247184
9264,0.000141,172.31.40.0-255,66,23070,63,247184
9265,0.000154,74.125.68.0-255,1484,24554,63,247184
9266,0.000156,172.31.40.0-255,66,24620,63,247184
9267,0.000177,74.125.68.0-255,6797,31417,63,247184
9268,0.000179,172.31.40.0-255,66,31483,63,247184
9269,0.000216,74.125.68.0-255,1484,32967,63,247184
9270,0.000219,172.31.40.0-255,66,33033,63,247184
9271,0.000233,74.125.68.0-255,2902,35935,63,247184
9272,0.000236,172.31.40.0-255,66,36001,63,247184
9273,0.000266,74.125.68.0-255,5738,41739,63,247184
9274,0.000268,172.31.40.0-255,66,41805,63,247184
9275,0.000272,74.125.68.0-255,2902,44707,63,247184
9276,0.000275,172.31.40.0-255,66,44773,63,247184
9277,0.000308,172.31.40.0-255,66,44839,63,247184
9278,0.000327,74.125.68.0-255,1484,46323,63,247184
9279,0.000329,172.31.40.0-255,66,46389,63,247184
9280,0.000334,74.125.68.0-255,4320,50709,63,247184
9281,0.000336,172.31.40.0-255,66,50775,63,247184
9282,0.000367,74.125.68.0-255,2902,53677,63,247184
9283,0.00037,172.31.40.0-255,66,53743,63,247184
9284,0.00039,74.125.68.0-255,3602,57345,63,247184
9285,0.000393,172.31.40.0-255,66,57411,63,247184
9286,0.000633,74.125.68.0-255,646,58057,63,247184
9287,0.000856,74.125.68.0-255,1484,59541,63,247184
9288,0.000861,172.31.40.0-255,66,59607,63,247184
9289,0.00088,74.125.68.0-255,1484,61091,63,247184
9290,0.000884,74.125.68.0-255,2902,63993,63,247184
9291,0.000886,172.31.40.0-255,66,64059,63,247184
9292,0.00091,74.125.68.0-255,5738,69797,63,247184
9293,0.000913,172.31.40.0-255,66,69863,63,247184
9294,0.000918,74.125.68.0-255,4320,74183,63,247184
9295,0.00092,172.31.40.0-255,66,74249,63,247184
9296,0.000945,74.125.68.0-255,576,74825,63,247184
9297,0.001018,74.125.68.0-255,1484,76309,63,247184
9298,0.001021,172.31.40.0-255,66,76375,63,247184
9299,0.001025,74.125.68.0-255,1484,77859,63,247184
9300,0.001038,74.125.68.0-255,1484,79343,63,247184
9301,0.00104,172.31.40.0-255,66,79409,63,247184
9302,0.001071,74.125.68.0-255,5738,85147,63,247184
9303,0.001074,172.31.40.0-255,66,85213,63,247184
9304,0.001081,74.125.68.0-255,6797,92010,63,247184
9305,0.001084,172.31.40.0-255,66,92076,63,247184
9306,0.001529,74.125.68.0-255,1484,93560,63,247184
9307,0.001537,74.125.68.0-255,1484,95044,63,247184
9308,0.001542,172.31.40.0-255,66,95110,63,247184
9309,0.001562,74.125.68.0-255,1484,96594,63,247184
9310,0.001569,74.125.68.0-255,5738,102332,63,247184
9311,0.001571,172.31.40.0-255,66,102398,63,247184
9312,0.001594,74.125.68.0-255,7156,109554,63,247184
9313,0.001597,172.31.40.0-255,66,109620,63,247184
9314,0.001615,74.125.68.0-255,2902,112522,63,247184
9315,0.001618,172.31.40.0-255,66,112588,63,247184
9316,0.001625,74.125.68.0-255,5738,118326,63,247184
9317,0.001627,172.31.40.0-255,66,118392,63,247184
9318,0.00165,74.125.68.0-255,5738,124130,63,247184
9319,0.001653,172.31.40.0-255,66,124196,63,247184
9320,0.001657,74.125.68.0-255,2184,126380,63,247184
9321,0.001659,172.31.40.0-255,66,126446,63,247184
9322,0.001693,74.125.68.0-255,1484,127930,63,247184
9323,0.001714,74.125.68.0-255,2902,130832,63,247184
9324,0.001716,172.31.40.0-255,66,130898,63,247184
9325,0.001723,74.125.68.0-255,5738,136636,63,247184
9326,0.001725,172.31.40.0-255,66,136702,63,247184
9327,0.001728,74.125.68.0-255,1484,138186,63,247184
9328,0.001746,74.125.68.0-255,4320,142506,63,247184
9329,0.001748,172.31.40.0-255,66,142572,63,247184
9330,0.001772,74.125.68.0-255,5738,148310,63,247184
9331,0.001775,172.31.40.0-255,66,148376,63,247184
9332,0.001798,74.125.68.0-255,1484,149860,63,247184
9333,0.001812,172.31.40.0-255,66,149926,63,247184
9334,0.001857,74.125.68.0-255,1484,151410,63,247184
9335,0.001861,74.125.68.0-255,2902,154312,63,247184
9336,0.001863,172.31.40.0-255,66,154378,63,247184
9337,0.001869,74.125.68.0-255,4320,158698,63,247184
9338,0.001871,172.31.40.0-255,66,158764,63,247184
9339,0.001899,74.125.68.0-255,1484,160248,63,247184
9340,0.001907,74.125.68.0-255,5738,165986,63,247184
9341,0.00191,172.31.40.0-255,66,166052,63,247184
9342,0.001918,74.125.68.0-255,7156,173208,63,247184
9343,0.00192,172.31.40.0-255,66,173274,63,247184
9344,0.001951,74.125.68.0-255,7156,180430,63,247184
9345,0.001954,172.31.40.0-255,66,180496,63,247184
9346,0.001974,74.125.68.0-255,3602,184098,63,247184
9347,0.001976,172.31.40.0-255,66,184164,63,247184
9348,0.002178,74.125.68.0-255,1484,185648,63,247184
9349,0.002195,74.125.68.0-255,1484,187132,63,247184
9350,0.002199,172.31.40.0-255,66,187198,63,247184
9351,0.002215,74.125.68.0-255,1484,188682,63,247184
9352,0.002244,74.125.68.0-255,5738,194420,63,247184
9353,0.002247,172.31.40.0-255,66,194486,63,247184
9354,0.00225,74.125.68.0-255,1484,195970,63,247184
9355,0.002293,74.125.68.0-255,4320,200290,63,247184
9356,0.002297,172.31.40.0-255,66,200356,63,247184
9357,0.002359,74.125.68.0-255,5738,206094,63,247184
9358,0.002364,172.31.40.0-255,66,206160,63,247184
9359,0.004699,74.125.68.0-255,5738,211898,63,247184
9360,0.004707,172.31.40.0-255,66,211964,63,247184
9361,0.007022,74.125.68.0-255,2902,214866,63,247184
9362,0.007026,172.31.40.0-255,66,214932,63,247184
9363,0.007046,74.125.68.0-255,2902,217834,63,247184
9364,0.007048,172.31.40.0-255,66,217900,63,247184
9365,0.009337,74.125.68.0-255,2902,220802,63,247184
9366,0.009344,172.31.40.0-255,66,220868,63,247184
9367,0.009369,74.125.68.0-255,2902,223770,63,247184
9368,0.009372,172.31.40.0-255,66,223836,63,247184
9369,0.011643,74.125.68.0-255,2902,226738,63,247184
9370,0.011652,172.31.40.0-255,66,226804,63,247184
9371,0.011677,74.125.68.0-255,2902,229706,63,247184
9372,0.01168,172.31.40.0-255,66,229772,63,247184
9373,0.013977,74.125.68.0-255,5738,235510,63,247184
9374,0.013985,172.31.40.0-255,66,235576,63,247184
9375,0.016321,74.125.68.0-255,5738,241314,63,247184
9376,0.016342,172.31.40.0-255,66,241380,63,247184
9377,0.018675,74.125.68.0-255,5738,247118,63,247184
9378,0.018691,172.31.40.0-255,66,247184,63,247184
9379,0.0,74.125.68.0-255,152,152,63,173218
9380,2.3e-05,172.31.40.0-255,66,218,63,173218
9381,3.1e-05,74.125.68.0-255,1484,1702,63,173218
9382,3.6e-05,172.31.40.0-255,66,1768,63,173218
9383,4.2e-05,74.125.68.0-255,2902,4670,63,173218
9384,4.5e-05,172.31.40.0-255,66,4736,63,173218
9385,5.1e-05,74.125.68.0-255,4320,9056,63,173218
9386,5.4e-05,172.31.40.0-255,66,9122,63,173218
9387,5.8e-05,74.125.68.0-255,1484,10606,63,173218
9388,6.1e-05,172.31.40.0-255,66,10672,63,173218
9389,9e-05,74.125.68.0-255,3555,14227,63,173218
9390,9.3e-05,172.31.40.0-255,66,14293,63,173218
9391,0.000109,74.125.68.0-255,1484,15777,63,173218
9392,0.000111,172.31.40.0-255,66,15843,63,173218
9393,0.00013,74.125.68.0-255,2902,18745,63,173218
9394,0.000132,172.31.40.0-255,66,18811,63,173218
9395,0.000153,74.125.68.0-255,5738,24549,63,173218
9396,0.000156,172.31.40.0-255,66,24615,63,173218
9397,0.000182,74.125.68.0-255,6797,31412,63,173218
9398,0.000185,172.31.40.0-255,66,31478,63,173218
9399,0.000277,74.125.68.0-255,1484,32962,63,173218
9400,0.000281,172.31.40.0-255,66,33028,63,173218
9401,0.000286,74.125.68.0-255,2902,35930,63,173218
9402,0.000289,172.31.40.0-255,66,35996,63,173218
9403,0.000292,74.125.68.0-255,1484,37480,63,173218
9404,0.000294,172.31.40.0-255,66,37546,63,173218
9405,0.000316,74.125.68.0-255,1484,39030,63,173218
9406,0.000319,172.31.40.0-255,66,39096,63,173218
9407,0.000325,74.125.68.0-255,4320,43416,63,173218
9408,0.000327,172.31.40.0-255,66,43482,63,173218
9409,0.000367,172.31.40.0-255,66,43548,63,173218
9410,0.000388,74.125.68.0-255,4320,47868,63,173218
9411,0.000407,74.125.68.0-255,4320,52188,63,173218
9412,0.000411,74.125.68.0-255,4320,56508,63,173218
9413,0.000447,74.125.68.0-255,1473,57981,63,173218
9414,0.000518,172.31.40.0-255,66,58047,63,173218
9415,0.0007,74.125.68.0-255,329,58376,63,173218
9416,0.001099,172.31.40.0-255,66,58442,63,173218
9417,0.001104,74.125.68.0-255,1484,59926,63,173218
9418,0.001119,74.125.68.0-255,2902,62828,63,173218
9419,0.001131,74.125.68.0-255,4320,67148,63,173218
9420,0.001144,74.125.68.0-255,1484,68632,63,173218
9421,0.001159,74.125.68.0-255,5738,74370,63,173218
9422,0.001165,172.31.40.0-255,66,74436,63,173218
9423,0.001174,74.125.68.0-255,2902,77338,63,173218
9424,0.001181,74.125.68.0-255,7156,84494,63,173218
9425,0.001204,74.125.68.0-255,2902,87396,63,173218
9426,0.00121,74.125.68.0-255,5020,92416,63,173218
9427,0.001213,172.31.40.0-255,66,92482,63,173218
9428,0.001244,172.31.40.0-255,66,92548,63,173218
9429,0.00149,74.125.68.0-255,1484,94032,63,173218
9430,0.001509,74.125.68.0-255,2902,96934,63,173218
9431,0.001513,172.31.40.0-255,66,97000,63,173218
9432,0.001519,74.125.68.0-255,4320,101320,63,173218
9433,0.001536,74.125.68.0-255,5738,107058,63,173218
9434,0.001547,172.31.40.0-255,66,107124,63,173218
9435,0.001552,74.125.68.0-255,2902,110026,63,173218
9436,0.001556,172.31.40.0-255,66,110092,63,173218
9437,0.001567,74.125.68.0-255,5738,115830,63,173218
9438,0.001586,74.125.68.0-255,2902,118732,63,173218
9439,0.001593,172.31.40.0-255,66,118798,63,173218
9440,0.001635,74.125.68.0-255,7156,125954,63,173218
9441,0.001651,74.125.68.0-255,766,126720,63,173218
9442,0.001661,172.31.40.0-255,66,126786,63,173218
9443,0.003715,74.125.68.0-255,5738,132524,63,173218
9444,0.003724,172.31.40.0-255,66,132590,63,173218
9445,0.005781,74.125.68.0-255,5738,138328,63,173218
9446,0.005787,172.31.40.0-255,66,138394,63,173218
9447,0.007841,74.125.68.0-255,5738,144132,63,173218
9448,0.007846,172.31.40.0-255,66,144198,63,173218
9449,0.009904,74.125.68.0-255,5738,149936,63,173218
9450,0.009912,172.31.40.0-255,66,150002,63,173218
9451,0.011972,74.125.68.0-255,5738,155740,63,173218
9452,0.012023,172.31.40.0-255,66,155806,63,173218
9453,0.014088,74.125.68.0-255,5738,161544,63,173218
9454,0.014094,172.31.40.0-255,66,161610,63,173218
9455,0.016189,74.125.68.0-255,5738,167348,63,173218
9456,0.016238,172.31.40.0-255,66,167414,63,173218
9457,0.018303,74.125.68.0-255,5738,173152,63,173218
9458,0.018309,172.31.40.0-255,66,173218,63,173218
9459,0.0,74.125.24.0-255,153,153,63,211382
9460,2.8e-05,172.31.40.0-255,66,219,63,211382
9461,3.6e-05,74.125.24.0-255,1484,1703,63,211382
9462,4.1e-05,172.31.40.0-255,66,1769,63,211382
9463,4.6e-05,74.125.24.0-255,2902,4671,63,211382
9464,5.8e-05,172.31.40.0-255,66,4737,63,211382
9465,6.4e-05,74.125.24.0-255,4320,9057,63,211382
9466,6.7e-05,172.31.40.0-255,66,9123,63,211382
9467,7.5e-05,74.125.24.0-255,4827,13950,63,211382
9468,7.9e-05,172.31.40.0-255,66,14016,63,211382
9469,8.5e-05,74.125.24.0-255,5738,19754,63,211382
9470,8.9e-05,172.31.40.0-255,66,19820,63,211382
9471,0.000117,74.125.24.0-255,5738,25558,63,211382
9472,0.000125,172.31.40.0-255,66,25624,63,211382
9473,0.000132,74.125.24.0-255,5379,31003,63,211382
9474,0.000135,172.31.40.0-255,66,31069,63,211382
9475,0.000211,74.125.24.0-255,1484,32553,63,211382
9476,0.000214,172.31.40.0-255,66,32619,63,211382
9477,0.000219,74.125.24.0-255,2902,35521,63,211382
9478,0.000222,172.31.40.0-255,66,35587,63,211382
9479,0.000224,74.125.24.0-255,1484,37071,63,211382
9480,0.000226,172.31.40.0-255,66,37137,63,211382
9481,0.000271,74.125.24.0-255,4320,41457,63,211382
9482,0.000274,172.31.40.0-255,66,41523,63,211382
9483,0.000279,74.125.24.0-255,4320,45843,63,211382
9484,0.000281,172.31.40.0-255,66,45909,63,211382
9485,0.000296,172.31.40.0-255,66,45975,63,211382
9486,0.000304,74.125.24.0-255,7110,53085,63,211382
9487,0.000306,172.31.40.0-255,66,53151,63,211382
9488,0.000511,74.125.24.0-255,107,53258,63,211382
9489,0.000516,172.31.40.0-255,66,53324,63,211382
9490,0.000665,74.125.24.0-255,1484,54808,63,211382
9491,0.000671,74.125.24.0-255,1484,56292,63,211382
9492,0.000674,172.31.40.0-255,66,56358,63,211382
9493,0.000701,74.125.24.0-255,1484,57842,63,211382
9494,0.000708,74.125.24.0-255,5738,63580,63,211382
9495,0.000715,74.125.24.0-255,6797,70377,63,211382
9496,0.000721,172.31.40.0-255,66,70443,63,211382
9497,0.000724,172.31.40.0-255,66,70509,63,211382
9498,0.000778,74.125.24.0-255,1484,71993,63,211382
9499,0.000795,74.125.24.0-255,2902,74895,63,211382
9500,0.000798,172.31.40.0-255,66,74961,63,211382
9501,0.000801,74.125.24.0-255,1484,76445,63,211382
9502,0.000828,74.125.24.0-255,4320,80765,63,211382
9503,0.000831,172.31.40.0-255,66,80831,63,211382
9504,0.000835,74.125.24.0-255,2902,83733,63,211382
9505,0.000837,172.31.40.0-255,66,83799,63,211382
9506,0.00087,74.125.24.0-255,3961,87760,63,211382
9507,0.000874,172.31.40.0-255,66,87826,63,211382
9508,0.001639,74.125.24.0-255,1484,89310,63,211382
9509,0.00165,74.125.24.0-255,2902,92212,63,211382
9510,0.001655,172.31.40.0-255,66,92278,63,211382
9511,0.001661,74.125.24.0-255,2902,95180,63,211382
9512,0.001663,172.31.40.0-255,66,95246,63,211382
9513,0.001691,74.125.24.0-255,7156,102402,63,211382
9514,0.001698,172.31.40.0-255,66,102468,63,211382
9515,0.001753,172.31.40.0-255,66,102534,63,211382
9516,0.001788,74.125.24.0-255,1484,104018,63,211382
9517,0.001805,74.125.24.0-255,2184,106202,63,211382
9518,0.001808,172.31.40.0-255,66,106268,63,211382
9519,0.001949,74.125.24.0-255,1484,107752,63,211382
9520,0.001956,74.125.24.0-255,2902,110654,63,211382
9521,0.001959,172.31.40.0-255,66,110720,63,211382
9522,0.001986,74.125.24.0-255,5738,116458,63,211382
9523,0.001988,172.31.40.0-255,66,116524,63,211382
9524,0.002009,74.125.24.0-255,5738,122262,63,211382
9525,0.002014,172.31.40.0-255,66,122328,63,211382
9526,0.002043,74.125.24.0-255,7156,129484,63,211382
9527,0.002046,172.31.40.0-255,66,129550,63,211382
9528,0.002051,74.125.24.0-255,4320,133870,63,211382
9529,0.002054,172.31.40.0-255,66,133936,63,211382
9530,0.002091,74.125.24.0-255,6438,140374,63,211382
9531,0.002093,172.31.40.0-255,66,140440,63,211382
9532,0.002147,74.125.24.0-255,1484,141924,63,211382
9533,0.002164,74.125.24.0-255,2902,144826,63,211382
9534,0.002167,172.31.40.0-255,66,144892,63,211382
9535,0.002174,74.125.24.0-255,5738,150630,63,211382
9536,0.002176,172.31.40.0-255,66,150696,63,211382
9537,0.002223,172.31.40.0-255,66,150762,63,211382
9538,0.002254,74.125.24.0-255,4320,155082,63,211382
9539,0.002257,172.31.40.0-255,66,155148,63,211382
9540,0.002264,74.125.24.0-255,5738,160886,63,211382
9541,0.002266,172.31.40.0-255,66,160952,63,211382
9542,0.002309,172.31.40.0-255,66,161018,63,211382
9543,0.002314,74.125.24.0-255,2902,163920,63,211382
9544,0.002316,172.31.40.0-255,66,163986,63,211382
9545,0.002366,172.31.40.0-255,66,164052,63,211382
9546,0.002373,74.125.24.0-255,7156,171208,63,211382
9547,0.002375,172.31.40.0-255,66,171274,63,211382
9548,0.002378,74.125.24.0-255,766,172040,63,211382
9549,0.00319,172.31.40.0-255,66,172106,63,211382
9550,0.004691,74.125.24.0-255,4320,176426,63,211382
9551,0.004703,172.31.40.0-255,66,176492,63,211382
9552,0.005496,74.125.24.0-255,1484,177976,63,211382
9553,0.007019,74.125.24.0-255,4320,182296,63,211382
9554,0.007024,172.31.40.0-255,66,182362,63,211382
9555,0.009348,74.125.24.0-255,5738,188100,63,211382
9556,0.009354,172.31.40.0-255,66,188166,63,211382
9557,0.011679,74.125.24.0-255,5738,193904,63,211382
9558,0.011694,172.31.40.0-255,66,193970,63,211382
9559,0.014056,74.125.24.0-255,5738,199708,63,211382
9560,0.014078,172.31.40.0-255,66,199774,63,211382
9561,0.01643,74.125.24.0-255,5738,205512,63,211382
9562,0.016451,172.31.40.0-255,66,205578,63,211382
9563,0.01882,74.125.24.0-255,5738,211316,63,211382
9564,0.018839,172.31.40.0-255,66,211382,63,211382
9565,0.0,172.31.40.0-255,105,105,63,276
9566,0.001803,157.240.24.0-255,105,210,63,276
9567,0.001816,172.31.40.0-255,66,276,63,276
9568,0.0,172.217.26.0-255,147,147,63,172088
9569,2.5e-05,172.31.40.0-255,66,213,63,172088
9570,3.2e-05,172.217.26.0-255,1484,1697,63,172088
9571,3.7e-05,172.31.40.0-255,66,1763,63,172088
9572,4.2e-05,172.217.26.0-255,2902,4665,63,172088
9573,4.5e-05,172.31.40.0-255,66,4731,63,172088
9574,5.1e-05,172.217.26.0-255,4320,9051,63,172088
9575,5.4e-05,172.31.40.0-255,66,9117,63,172088
9576,5.9e-05,172.217.26.0-255,2902,12019,63,172088
9577,6.2e-05,172.31.40.0-255,66,12085,63,172088
9578,9.2e-05,172.217.26.0-255,2023,14108,63,172088
9579,9.6e-05,172.31.40.0-255,66,14174,63,172088
9580,0.000267,172.217.26.0-255,1484,15658,63,172088
9581,0.000272,172.31.40.0-255,66,15724,63,172088
9582,0.000278,172.217.26.0-255,2902,18626,63,172088
9583,0.000281,172.31.40.0-255,66,18692,63,172088
9584,0.000305,172.217.26.0-255,5738,24430,63,172088
9585,0.000307,172.31.40.0-255,66,24496,63,172088
9586,0.000329,172.217.26.0-255,6797,31293,63,172088
9587,0.000331,172.31.40.0-255,66,31359,63,172088
9588,0.000334,172.217.26.0-255,1484,32843,63,172088
9589,0.000336,172.31.40.0-255,66,32909,63,172088
9590,0.000377,172.217.26.0-255,5738,38647,63,172088
9591,0.00038,172.31.40.0-255,66,38713,63,172088
9592,0.000392,172.31.40.0-255,66,38779,63,172088
9593,0.000422,172.217.26.0-255,1484,40263,63,172088
9594,0.000425,172.31.40.0-255,66,40329,63,172088
9595,0.00043,172.217.26.0-255,2902,43231,63,172088
9596,0.000432,172.31.40.0-255,66,43297,63,172088
9597,0.000438,172.217.26.0-255,5738,49035,63,172088
9598,0.000441,172.31.40.0-255,66,49101,63,172088
9599,0.000474,172.217.26.0-255,6797,55898,63,172088
9600,0.000477,172.31.40.0-255,66,55964,63,172088
9601,0.000492,172.217.26.0-255,355,56319,63,172088
9602,0.001023,172.217.26.0-255,138,56457,63,172088
9603,0.001074,172.31.40.0-255,66,56523,63,172088
9604,0.001161,172.217.26.0-255,1484,58007,63,172088
9605,0.00117,172.217.26.0-255,2902,60909,63,172088
9606,0.001173,172.31.40.0-255,66,60975,63,172088
9607,0.001178,172.217.26.0-255,2902,63877,63,172088
9608,0.00118,172.31.40.0-255,66,63943,63,172088
9609,0.001186,172.217.26.0-255,4320,68263,63,172088
9610,0.001188,172.31.40.0-255,66,68329,63,172088
9611,0.001206,172.217.26.0-255,1484,69813,63,172088
9612,0.001219,172.217.26.0-255,1484,71297,63,172088
9613,0.001222,172.31.40.0-255,66,71363,63,172088
9614,0.001243,172.217.26.0-255,6797,78160,63,172088
9615,0.001245,172.31.40.0-255,66,78226,63,172088
9616,0.001259,172.31.40.0-255,66,78292,63,172088
9617,0.001444,172.217.26.0-255,1484,79776,63,172088
9618,0.001451,172.217.26.0-255,2902,82678,63,172088
9619,0.001454,172.31.40.0-255,66,82744,63,172088
9620,0.001458,172.217.26.0-255,1484,84228,63,172088
9621,0.001479,172.217.26.0-255,4320,88548,63,172088
9622,0.001482,172.31.40.0-255,66,88614,63,172088
9623,0.00149,172.217.26.0-255,7156,95770,63,172088
9624,0.001492,172.31.40.0-255,66,95836,63,172088
9625,0.001498,172.217.26.0-255,4320,100156,63,172088
9626,0.0015,172.31.40.0-255,66,100222,63,172088
9627,0.001522,172.217.26.0-255,4320,104542,63,172088
9628,0.001525,172.31.40.0-255,66,104608,63,172088
9629,0.001533,172.217.26.0-255,7156,111764,63,172088
9630,0.001535,172.31.40.0-255,66,111830,63,172088
9631,0.001553,172.217.26.0-255,3602,115432,63,172088
9632,0.001555,172.31.40.0-255,66,115498,63,172088
9633,0.00157,172.31.40.0-255,66,115564,63,172088
9634,0.001615,172.31.40.0-255,66,115630,63,172088
9635,0.002001,172.217.26.0-255,1484,117114,63,172088
9636,0.002017,172.217.26.0-255,1484,118598,63,172088
9637,0.002022,172.31.40.0-255,66,118664,63,172088
9638,0.003598,172.217.26.0-255,2902,121566,63,172088
9639,0.003607,172.31.40.0-255,66,121632,63,172088
9640,0.004001,172.217.26.0-255,2902,124534,63,172088
9641,0.004005,172.31.40.0-255,66,124600,63,172088
9642,0.005593,172.217.26.0-255,2902,127502,63,172088
9643,0.005598,172.31.40.0-255,66,127568,63,172088
9644,0.005984,172.217.26.0-255,2902,130470,63,172088
9645,0.005987,172.31.40.0-255,66,130536,63,172088
9646,0.007581,172.217.26.0-255,2902,133438,63,172088
9647,0.00759,172.31.40.0-255,66,133504,63,172088
9648,0.007964,172.217.26.0-255,2902,136406,63,172088
9649,0.007989,172.31.40.0-255,66,136472,63,172088
9650,0.009577,172.217.26.0-255,2902,139374,63,172088
9651,0.009587,172.31.40.0-255,66,139440,63,172088
9652,0.009973,172.217.26.0-255,2902,142342,63,172088
9653,0.00998,172.31.40.0-255,66,142408,63,172088
9654,0.011602,172.217.26.0-255,2902,145310,63,172088
9655,0.011617,172.31.40.0-255,66,145376,63,172088
9656,0.01196,172.217.26.0-255,2902,148278,63,172088
9657,0.011967,172.31.40.0-255,66,148344,63,172088
9658,0.013625,172.217.26.0-255,2902,151246,63,172088
9659,0.01364,172.31.40.0-255,66,151312,63,172088
9660,0.013956,172.217.26.0-255,2902,154214,63,172088
9661,0.013961,172.31.40.0-255,66,154280,63,172088
9662,0.015632,172.217.26.0-255,2902,157182,63,172088
9663,0.015643,172.31.40.0-255,66,157248,63,172088
9664,0.015941,172.217.26.0-255,2902,160150,63,172088
9665,0.015947,172.31.40.0-255,66,160216,63,172088
9666,0.01763,172.217.26.0-255,2902,163118,63,172088
9667,0.017639,172.31.40.0-255,66,163184,63,172088
9668,0.017919,172.217.26.0-255,2902,166086,63,172088
9669,0.017925,172.31.40.0-255,66,166152,63,172088
9670,0.019625,172.217.26.0-255,2902,169054,63,172088
9671,0.019634,172.31.40.0-255,66,169120,63,172088
9672,0.019909,172.217.26.0-255,2902,172022,63,172088
9673,0.019915,172.31.40.0-255,66,172088,63,172088
9674,0.0,172.217.194.0-255,150,150,63,193315
9675,1.8e-05,172.31.40.0-255,66,216,63,193315
9676,2.8e-05,172.217.194.0-255,1484,1700,63,193315
9677,3.3e-05,172.31.40.0-255,66,1766,63,193315
9678,3.9e-05,172.217.194.0-255,2902,4668,63,193315
9679,4.3e-05,172.31.40.0-255,66,4734,63,193315
9680,4.7e-05,172.217.194.0-255,2902,7636,63,193315
9681,5e-05,172.31.40.0-255,66,7702,63,193315
9682,5.5e-05,172.217.194.0-255,4320,12022,63,193315
9683,5.8e-05,172.31.40.0-255,66,12088,63,193315
9684,0.000102,172.31.40.0-255,66,12154,63,193315
9685,0.000114,172.31.40.0-255,66,12220,63,193315
9686,0.000134,172.217.194.0-255,1484,13704,63,193315
9687,0.000137,172.31.40.0-255,66,13770,63,193315
9688,0.000152,172.217.194.0-255,4320,18090,63,193315
9689,0.000155,172.31.40.0-255,66,18156,63,193315
9690,0.000181,172.217.194.0-255,4320,22476,63,193315
9691,0.000183,172.31.40.0-255,66,22542,63,193315
9692,0.000202,172.217.194.0-255,2902,25444,63,193315
9693,0.000211,172.31.40.0-255,66,25510,63,193315
9694,0.000215,172.217.194.0-255,2902,28412,63,193315
9695,0.000218,172.31.40.0-255,66,28478,63,193315
9696,0.00023,172.217.194.0-255,1125,29603,63,193315
9697,0.000232,172.31.40.0-255,66,29669,63,193315
9698,0.000591,172.217.194.0-255,1484,31153,63,193315
9699,0.000596,172.31.40.0-255,66,31219,63,193315
9700,0.000603,172.217.194.0-255,2902,34121,63,193315
9701,0.000605,172.31.40.0-255,66,34187,63,193315
9702,0.000611,172.217.194.0-255,5738,39925,63,193315
9703,0.000613,172.31.40.0-255,66,39991,63,193315
9704,0.000651,172.217.194.0-255,6797,46788,63,193315
9705,0.000654,172.31.40.0-255,66,46854,63,193315
9706,0.000732,172.217.194.0-255,645,47499,63,193315
9707,0.000877,172.217.194.0-255,1484,48983,63,193315
9708,0.000881,172.31.40.0-255,66,49049,63,193315
9709,0.000885,172.217.194.0-255,2902,51951,63,193315
9710,0.000887,172.31.40.0-255,66,52017,63,193315
9711,0.000892,172.217.194.0-255,2902,54919,63,193315
9712,0.000894,172.31.40.0-255,66,54985,63,193315
9713,0.000917,172.217.194.0-255,1484,56469,63,193315
9714,0.000923,172.217.194.0-255,5738,62207,63,193315
9715,0.000925,172.31.40.0-255,66,62273,63,193315
9716,0.000946,172.217.194.0-255,7156,69429,63,193315
9717,0.000949,172.31.40.0-255,66,69495,63,193315
9718,0.000966,172.217.194.0-255,4320,73815,63,193315
9719,0.000968,172.31.40.0-255,66,73881,63,193315
9720,0.000973,172.217.194.0-255,4320,78201,63,193315
9721,0.000975,172.31.40.0-255,66,78267,63,193315
9722,0.001005,172.217.194.0-255,3602,81869,63,193315
9723,0.001008,172.31.40.0-255,66,81935,63,193315
9724,0.001457,172.217.194.0-255,1484,83419,63,193315
9725,0.001465,172.217.194.0-255,2902,86321,63,193315
9726,0.001469,172.31.40.0-255,66,86387,63,193315
9727,0.001493,172.217.194.0-255,5738,92125,63,193315
9728,0.001496,172.31.40.0-255,66,92191,63,193315
9729,0.001539,172.31.40.0-255,66,92257,63,193315
9730,0.001545,172.217.194.0-255,5738,97995,63,193315
9731,0.001547,172.31.40.0-255,66,98061,63,193315
9732,0.001575,172.217.194.0-255,5020,103081,63,193315
9733,0.001578,172.31.40.0-255,66,103147,63,193315
9734,0.001675,172.217.194.0-255,1484,104631,63,193315
9735,0.00168,172.217.194.0-255,1484,106115,63,193315
9736,0.001683,172.31.40.0-255,66,106181,63,193315
9737,0.00172,172.217.194.0-255,1484,107665,63,193315
9738,0.001727,172.217.194.0-255,5738,113403,63,193315
9739,0.001729,172.31.40.0-255,66,113469,63,193315
9740,0.001743,172.31.40.0-255,66,113535,63,193315
9741,0.001802,172.217.194.0-255,4320,117855,63,193315
9742,0.001805,172.31.40.0-255,66,117921,63,193315
9743,0.001832,172.217.194.0-255,6438,124359,63,193315
9744,0.001835,172.31.40.0-255,66,124425,63,193315
9745,0.001876,172.217.194.0-255,1484,125909,63,193315
9746,0.001891,172.217.194.0-255,2902,128811,63,193315
9747,0.001894,172.31.40.0-255,66,128877,63,193315
9748,0.001915,172.217.194.0-255,5738,134615,63,193315
9749,0.001917,172.31.40.0-255,66,134681,63,193315
9750,0.001922,172.217.194.0-255,2902,137583,63,193315
9751,0.001924,172.31.40.0-255,66,137649,63,193315
9752,0.001944,172.217.194.0-255,1484,139133,63,193315
9753,0.002006,172.31.40.0-255,66,139199,63,193315
9754,0.002016,172.31.40.0-255,66,139265,63,193315
9755,0.002192,172.217.194.0-255,1484,140749,63,193315
9756,0.002209,172.217.194.0-255,2902,143651,63,193315
9757,0.002213,172.31.40.0-255,66,143717,63,193315
9758,0.00222,172.217.194.0-255,5738,149455,63,193315
9759,0.002222,172.31.40.0-255,66,149521,63,193315
9760,0.002251,172.31.40.0-255,66,149587,63,193315
9761,0.002269,172.217.194.0-255,1484,151071,63,193315
9762,0.002272,172.217.194.0-255,1484,152555,63,193315
9763,0.002274,172.31.40.0-255,66,152621,63,193315
9764,0.002299,172.31.40.0-255,66,152687,63,193315
9765,0.004642,172.217.194.0-255,5738,158425,63,193315
9766,0.004648,172.31.40.0-255,66,158491,63,193315
9767,0.006986,172.217.194.0-255,5738,164229,63,193315
9768,0.006993,172.31.40.0-255,66,164295,63,193315
9769,0.009342,172.217.194.0-255,5738,170033,63,193315
9770,0.009349,172.31.40.0-255,66,170099,63,193315
9771,0.011675,172.217.194.0-255,5738,175837,63,193315
9772,0.011684,172.31.40.0-255,66,175903,63,193315
9773,0.014041,172.217.194.0-255,5738,181641,63,193315
9774,0.014049,172.31.40.0-255,66,181707,63,193315
9775,0.016397,172.217.194.0-255,5738,187445,63,193315
9776,0.016409,172.31.40.0-255,66,187511,63,193315
9777,0.018739,172.217.194.0-255,5738,193249,63,193315
9778,0.018748,172.31.40.0-255,66,193315,63,193315
9779,0.0,172.31.40.0-255,105,105,63,276
9780,0.001816,157.240.13.0-255,105,210,63,276
9781,0.001831,172.31.40.0-255,66,276,63,276
9782,0.0,172.217.194.0-255,155,155,63,185416
9783,2.5e-05,172.31.40.0-255,66,221,63,185416
9784,3.2e-05,172.217.194.0-255,1484,1705,63,185416
9785,3.6e-05,172.31.40.0-255,66,1771,63,185416
9786,4.1e-05,172.217.194.0-255,2902,4673,63,185416
9787,4.6e-05,172.31.40.0-255,66,4739,63,185416
9788,6e-05,172.217.194.0-255,7156,11895,63,185416
9789,6.3e-05,172.31.40.0-255,66,11961,63,185416
9790,6.7e-05,172.217.194.0-255,1983,13944,63,185416
9791,6.9e-05,172.31.40.0-255,66,14010,63,185416
9792,9.9e-05,172.217.194.0-255,1484,15494,63,185416
9793,0.000102,172.31.40.0-255,66,15560,63,185416
9794,0.000106,172.217.194.0-255,2902,18462,63,185416
9795,0.000109,172.31.40.0-255,66,18528,63,185416
9796,0.000148,172.217.194.0-255,5738,24266,63,185416
9797,0.000154,172.31.40.0-255,66,24332,63,185416
9798,0.000162,172.217.194.0-255,6797,31129,63,185416
9799,0.000164,172.31.40.0-255,66,31195,63,185416
9800,0.000167,172.217.194.0-255,1484,32679,63,185416
9801,0.000169,172.31.40.0-255,66,32745,63,185416
9802,0.000196,172.217.194.0-255,5738,38483,63,185416
9803,0.000199,172.31.40.0-255,66,38549,63,185416
9804,0.000234,172.31.40.0-255,66,38615,63,185416
9805,0.000241,172.217.194.0-255,7156,45771,63,185416
9806,0.000243,172.31.40.0-255,66,45837,63,185416
9807,0.000271,172.217.194.0-255,2902,48739,63,185416
9808,0.000273,172.31.40.0-255,66,48805,63,185416
9809,0.00028,172.217.194.0-255,7108,55913,63,185416
9810,0.000282,172.31.40.0-255,66,55979,63,185416
9811,0.000285,172.217.194.0-255,396,56375,63,185416
9812,0.000287,172.31.40.0-255,66,56441,63,185416
9813,0.000683,172.217.194.0-255,1484,57925,63,185416
9814,0.000689,172.217.194.0-255,2902,60827,63,185416
9815,0.000692,172.31.40.0-255,66,60893,63,185416
9816,0.000696,172.217.194.0-255,1484,62377,63,185416
9817,0.000714,172.217.194.0-255,4320,66697,63,185416
9818,0.000717,172.31.40.0-255,66,66763,63,185416
9819,0.000724,172.217.194.0-255,5738,72501,63,185416
9820,0.000726,172.31.40.0-255,66,72567,63,185416
9821,0.00075,172.217.194.0-255,1484,74051,63,185416
9822,0.000771,172.217.194.0-255,1484,75535,63,185416
9823,0.000774,172.31.40.0-255,66,75601,63,185416
9824,0.000816,172.31.40.0-255,66,75667,63,185416
9825,0.000968,172.217.194.0-255,1484,77151,63,185416
9826,0.000973,172.217.194.0-255,1484,78635,63,185416
9827,0.000976,172.31.40.0-255,66,78701,63,185416
9828,0.001006,172.217.194.0-255,1484,80185,63,185416
9829,0.001012,172.217.194.0-255,5738,85923,63,185416
9830,0.001015,172.31.40.0-255,66,85989,63,185416
9831,0.001028,172.31.40.0-255,66,86055,63,185416
9832,0.001057,172.217.194.0-255,1484,87539,63,185416
9833,0.001085,172.31.40.0-255,66,87605,63,185416
9834,0.001137,172.217.194.0-255,1484,89089,63,185416
9835,0.001143,172.217.194.0-255,2902,91991,63,185416
9836,0.001145,172.31.40.0-255,66,92057,63,185416
9837,0.00115,172.217.194.0-255,2902,94959,63,185416
9838,0.001152,172.31.40.0-255,66,95025,63,185416
9839,0.001174,172.217.194.0-255,2902,97927,63,185416
9840,0.001177,172.31.40.0-255,66,97993,63,185416
9841,0.001219,172.31.40.0-255,66,98059,63,185416
9842,0.001283,172.31.40.0-255,66,98125,63,185416
9843,0.001382,172.217.194.0-255,1484,99609,63,185416
9844,0.001399,172.217.194.0-255,2902,102511,63,185416
9845,0.001402,172.217.194.0-255,1484,103995,63,185416
9846,0.001404,172.31.40.0-255,66,104061,63,185416
9847,0.001428,172.217.194.0-255,4320,108381,63,185416
9848,0.001431,172.31.40.0-255,66,108447,63,185416
9849,0.001446,172.217.194.0-255,2902,111349,63,185416
9850,0.001447,172.31.40.0-255,66,111415,63,185416
9851,0.001451,172.31.40.0-255,66,111481,63,185416
9852,0.001492,172.217.194.0-255,1484,112965,63,185416
9853,0.001529,172.31.40.0-255,66,113031,63,185416
9854,0.001544,172.31.40.0-255,66,113097,63,185416
9855,0.001546,172.217.194.0-255,2902,115999,63,185416
9856,0.00156,172.31.40.0-255,66,116065,63,185416
9857,0.001587,172.217.194.0-255,2184,118249,63,185416
9858,0.001591,172.217.194.0-255,2902,121151,63,185416
9859,0.001595,172.31.40.0-255,66,121217,63,185416
9860,0.00162,172.217.194.0-255,7156,128373,63,185416
9861,0.001633,172.31.40.0-255,66,128439,63,185416
9862,0.001663,172.31.40.0-255,66,128505,63,185416
9863,0.001682,172.217.194.0-255,5738,134243,63,185416
9864,0.00169,172.217.194.0-255,6438,140681,63,185416
9865,0.001702,172.31.40.0-255,66,140747,63,185416
9866,0.001713,172.217.194.0-255,1484,142231,63,185416
9867,0.001717,172.217.194.0-255,2902,145133,63,185416
9868,0.001731,172.31.40.0-255,66,145199,63,185416
9869,0.00175,172.217.194.0-255,5738,150937,63,185416
9870,0.001782,172.217.194.0-255,1484,152421,63,185416
9871,0.001806,172.217.194.0-255,5738,158159,63,185416
9872,0.001875,172.217.194.0-255,1484,159643,63,185416
9873,0.001888,172.217.194.0-255,2902,162545,63,185416
9874,0.001901,172.217.194.0-255,4320,166865,63,185416
9875,0.001914,172.217.194.0-255,1484,168349,63,185416
9876,0.001919,172.217.194.0-255,4320,172669,63,185416
9877,0.001976,172.217.194.0-255,766,173435,63,185416
9878,0.002011,172.217.194.0-255,2902,176337,63,185416
9879,0.002056,172.217.194.0-255,1484,177821,63,185416
9880,0.002073,172.217.194.0-255,7156,184977,63,185416
9881,0.002131,172.217.194.0-255,97,185074,63,185416
9882,0.002133,172.217.194.0-255,105,185179,63,185416
9883,0.005353,172.31.40.0-255,66,185245,63,185416
9884,0.007191,172.31.40.0-255,105,185350,63,185416
9885,0.009532,172.217.194.0-255,66,185416,63,185416
9886,0.0,172.217.194.0-255,152,152,63,175155
9887,1.5e-05,172.31.40.0-255,66,218,63,175155
9888,2.2e-05,172.217.194.0-255,1484,1702,63,175155
9889,2.7e-05,172.31.40.0-255,66,1768,63,175155
9890,3.3e-05,172.217.194.0-255,2902,4670,63,175155
9891,4.3e-05,172.31.40.0-255,66,4736,63,175155
9892,5e-05,172.217.194.0-255,7156,11892,63,175155
9893,5.3e-05,172.31.40.0-255,66,11958,63,175155
9894,0.000154,172.31.40.0-255,66,12024,63,175155
9895,0.000175,172.217.194.0-255,6392,18416,63,175155
9896,0.000178,172.31.40.0-255,66,18482,63,175155
9897,0.000309,172.217.194.0-255,2543,21025,63,175155
9898,0.000314,172.31.40.0-255,66,21091,63,175155
9899,0.000346,172.217.194.0-255,2902,23993,63,175155
9900,0.000348,172.31.40.0-255,66,24059,63,175155
9901,0.000373,172.217.194.0-255,4320,28379,63,175155
9902,0.000377,172.31.40.0-255,66,28445,63,175155
9903,0.000393,172.217.194.0-255,2902,31347,63,175155
9904,0.000395,172.31.40.0-255,66,31413,63,175155
9905,0.000455,172.217.194.0-255,1484,32897,63,175155
9906,0.000459,172.31.40.0-255,66,32963,63,175155
9907,0.000506,172.31.40.0-255,66,33029,63,175155
9908,0.000633,172.31.40.0-255,66,33095,63,175155
9909,0.000722,172.217.194.0-255,1484,34579,63,175155
9910,0.000726,172.31.40.0-255,78,34657,63,175155
9911,0.00073,172.217.194.0-255,380,35037,63,175155
9912,0.000732,172.31.40.0-255,66,35103,63,175155
9913,0.000738,172.217.194.0-255,4320,39423,63,175155
9914,0.000745,172.31.40.0-255,66,39489,63,175155
9915,0.000783,172.217.194.0-255,4320,43809,63,175155
9916,0.000786,172.31.40.0-255,66,43875,63,175155
9917,0.000812,172.217.194.0-255,5738,49613,63,175155
9918,0.000815,172.31.40.0-255,66,49679,63,175155
9919,0.000901,172.217.194.0-255,2543,52222,63,175155
9920,0.000905,172.31.40.0-255,66,52288,63,175155
9921,0.000934,172.31.40.0-255,66,52354,63,175155
9922,0.000949,172.217.194.0-255,5738,58092,63,175155
9923,0.000951,172.31.40.0-255,66,58158,63,175155
9924,0.001089,172.217.194.0-255,1125,59283,63,175155
9925,0.001487,172.31.40.0-255,66,59349,63,175155
9926,0.001638,172.217.194.0-255,1484,60833,63,175155
9927,0.001658,172.217.194.0-255,2902,63735,63,175155
9928,0.001662,172.31.40.0-255,66,63801,63,175155
9929,0.001668,172.217.194.0-255,2902,66703,63,175155
9930,0.00167,172.31.40.0-255,66,66769,63,175155
9931,0.001697,172.217.194.0-255,2902,69671,63,175155
9932,0.0017,172.31.40.0-255,66,69737,63,175155
9933,0.001728,172.217.194.0-255,7156,76893,63,175155
9934,0.00173,172.31.40.0-255,66,76959,63,175155
9935,0.001752,172.217.194.0-255,5738,82697,63,175155
9936,0.001754,172.31.40.0-255,66,82763,63,175155
9937,0.001886,172.217.194.0-255,7156,89919,63,175155
9938,0.00189,172.31.40.0-255,66,89985,63,175155
9939,0.001919,172.217.194.0-255,3602,93587,63,175155
9940,0.001922,172.31.40.0-255,66,93653,63,175155
9941,0.001994,172.217.194.0-255,1484,95137,63,175155
9942,0.002012,172.217.194.0-255,2902,98039,63,175155
9943,0.002015,172.31.40.0-255,66,98105,63,175155
9944,0.002062,172.217.194.0-255,5738,103843,63,175155
9945,0.002065,172.31.40.0-255,66,103909,63,175155
9946,0.002102,172.217.194.0-255,4320,108229,63,175155
9947,0.002104,172.31.40.0-255,66,108295,63,175155
9948,0.002137,172.31.40.0-255,66,108361,63,175155
9949,0.002256,172.217.194.0-255,5738,114099,63,175155
9950,0.00226,172.31.40.0-255,66,114165,63,175155
9951,0.002289,172.217.194.0-255,5020,119185,63,175155
9952,0.002292,172.31.40.0-255,66,119251,63,175155
9953,0.002364,172.217.194.0-255,2902,122153,63,175155
9954,0.002367,172.31.40.0-255,66,122219,63,175155
9955,0.002669,172.217.194.0-255,5738,127957,63,175155
9956,0.002685,172.217.194.0-255,2184,130141,63,175155
9957,0.002774,172.217.194.0-255,4320,134461,63,175155
9958,0.003359,172.31.40.0-255,66,134527,63,175155
9959,0.00559,172.217.194.0-255,5738,140265,63,175155
9960,0.005596,172.31.40.0-255,66,140331,63,175155
9961,0.007833,172.217.194.0-255,5738,146069,63,175155
9962,0.007838,172.31.40.0-255,66,146135,63,175155
9963,0.010081,172.217.194.0-255,5738,151873,63,175155
9964,0.01009,172.31.40.0-255,66,151939,63,175155
9965,0.012334,172.217.194.0-255,5738,157677,63,175155
9966,0.012344,172.31.40.0-255,66,157743,63,175155
9967,0.014598,172.217.194.0-255,5738,163481,63,175155
9968,0.014608,172.31.40.0-255,66,163547,63,175155
9969,0.01687,172.217.194.0-255,5738,169285,63,175155
9970,0.016889,172.31.40.0-255,66,169351,63,175155
9971,0.019145,172.217.194.0-255,5738,175089,63,175155
9972,0.019161,172.31.40.0-255,66,175155,63,175155
9973,0.0,172.217.194.0-255,153,153,63,175980
9974,2.2e-05,172.31.40.0-255,66,219,63,175980
9975,2.9e-05,172.217.194.0-255,1484,1703,63,175980
9976,3.4e-05,172.31.40.0-255,66,1769,63,175980
9977,3.9e-05,172.217.194.0-255,2902,4671,63,175980
9978,4.2e-05,172.31.40.0-255,66,4737,63,175980
9979,5.7e-05,172.217.194.0-255,7156,11893,63,175980
9980,6.1e-05,172.31.40.0-255,66,11959,63,175980
9981,6.6e-05,172.217.194.0-255,3573,15532,63,175980
9982,6.8e-05,172.31.40.0-255,66,15598,63,175980
9983,7.6e-05,172.217.194.0-255,5738,21336,63,175980
9984,7.8e-05,172.31.40.0-255,66,21402,63,175980
9985,0.000105,172.217.194.0-255,7156,28558,63,175980
9986,0.000107,172.31.40.0-255,66,28624,63,175980
9987,0.000111,172.217.194.0-255,2543,31167,63,175980
9988,0.000114,172.31.40.0-255,66,31233,63,175980
9989,0.00018,172.217.194.0-255,1484,32717,63,175980
9990,0.000184,172.31.40.0-255,66,32783,63,175980
9991,0.000189,172.217.194.0-255,2902,35685,63,175980
9992,0.000191,172.31.40.0-255,66,35751,63,175980
9993,0.000222,172.217.194.0-255,5738,41489,63,175980
9994,0.000225,172.31.40.0-255,66,41555,63,175980
9995,0.000257,172.31.40.0-255,66,41621,63,175980
9996,0.000268,172.31.40.0-255,66,41687,63,175980
9997,0.000296,172.217.194.0-255,1484,43171,63,175980
9998,0.000298,172.31.40.0-255,66,43237,63,175980
9999,0.000301,172.217.194.0-255,1090,44327,63,175980
10000,0.000303,172.31.40.0-255,66,44393,63,175980
10001,0.00046,172.217.194.0-255,1484,45877,63,175980
10002,0.000466,172.31.40.0-255,66,45943,63,175980
10003,0.000491,172.217.194.0-255,2902,48845,63,175980
10004,0.000495,172.31.40.0-255,66,48911,63,175980
10005,0.000501,172.217.194.0-255,5738,54649,63,175980
10006,0.000503,172.31.40.0-255,66,54715,63,175980
10007,0.000535,172.31.40.0-255,66,54781,63,175980
10008,0.000543,172.217.194.0-255,7156,61937,63,175980
10009,0.000545,172.31.40.0-255,66,62003,63,175980
10010,0.000575,172.217.194.0-255,2902,64905,63,175980
10011,0.000578,172.31.40.0-255,66,64971,63,175980
10012,0.000582,172.217.194.0-255,2902,67873,63,175980
10013,0.000585,172.31.40.0-255,66,67939,63,175980
10014,0.000612,172.217.194.0-255,2184,70123,63,175980
10015,0.000615,172.31.40.0-255,66,70189,63,175980
10016,0.000674,172.217.194.0-255,1484,71673,63,175980
10017,0.000688,172.217.194.0-255,2902,74575,63,175980
10018,0.000701,172.31.40.0-255,66,74641,63,175980
10019,0.000706,172.217.194.0-255,2902,77543,63,175980
10020,0.000709,172.31.40.0-255,66,77609,63,175980
10021,0.000738,172.217.194.0-255,2902,80511,63,175980
10022,0.000741,172.31.40.0-255,66,80577,63,175980
10023,0.000753,172.31.40.0-255,66,80643,63,175980
10024,0.000801,172.31.40.0-255,66,80709,63,175980
10025,0.000804,172.217.194.0-255,766,81475,63,175980
10026,0.000833,172.217.194.0-255,1484,82959,63,175980
10027,0.000835,172.31.40.0-255,66,83025,63,175980
10028,0.000864,172.217.194.0-255,4320,87345,63,175980
10029,0.000867,172.31.40.0-255,66,87411,63,175980
10030,0.000874,172.217.194.0-255,5738,93149,63,175980
10031,0.000876,172.31.40.0-255,66,93215,63,175980
10032,0.000948,172.31.40.0-255,66,93281,63,175980
10033,0.000959,172.31.40.0-255,66,93347,63,175980
10034,0.000962,172.217.194.0-255,766,94113,63,175980
10035,0.001034,172.217.194.0-255,1484,95597,63,175980
10036,0.001038,172.31.40.0-255,66,95663,63,175980
10037,0.001042,172.217.194.0-255,1484,97147,63,175980
10038,0.001061,172.217.194.0-255,1484,98631,63,175980
10039,0.001064,172.31.40.0-255,66,98697,63,175980
10040,0.001069,172.217.194.0-255,2902,101599,63,175980
10041,0.001072,172.31.40.0-255,66,101665,63,175980
10042,0.00111,172.217.194.0-255,7156,108821,63,175980
10043,0.001112,172.31.40.0-255,66,108887,63,175980
10044,0.001118,172.217.194.0-255,5738,114625,63,175980
10045,0.001121,172.31.40.0-255,66,114691,63,175980
10046,0.001195,172.31.40.0-255,66,114757,63,175980
10047,0.001217,172.217.194.0-255,5020,119777,63,175980
10048,0.00122,172.31.40.0-255,66,119843,63,175980
10049,0.001346,172.217.194.0-255,1484,121327,63,175980
10050,0.001352,172.217.194.0-255,2902,124229,63,175980
10051,0.001355,172.31.40.0-255,66,124295,63,175980
10052,0.001376,172.217.194.0-255,2902,127197,63,175980
10053,0.001378,172.31.40.0-255,66,127263,63,175980
10054,0.0014,172.217.194.0-255,4320,131583,63,175980
10055,0.001403,172.31.40.0-255,66,131649,63,175980
10056,0.001411,172.217.194.0-255,7156,138805,63,175980
10057,0.001413,172.31.40.0-255,66,138871,63,175980
10058,0.001446,172.217.194.0-255,1484,140355,63,175980
10059,0.001451,172.217.194.0-255,2902,143257,63,175980
10060,0.001455,172.31.40.0-255,66,143323,63,175980
10061,0.001493,172.31.40.0-255,66,143389,63,175980
10062,0.001534,172.217.194.0-255,1484,144873,63,175980
10063,0.001546,172.217.194.0-255,2902,147775,63,175980
10064,0.001549,172.31.40.0-255,66,147841,63,175980
10065,0.001552,172.217.194.0-255,1484,149325,63,175980
10066,0.001589,172.217.194.0-255,4320,153645,63,175980
10067,0.001592,172.31.40.0-255,66,153711,63,175980
10068,0.001604,172.217.194.0-255,7156,160867,63,175980
10069,0.001608,172.31.40.0-255,66,160933,63,175980
10070,0.001628,172.31.40.0-255,66,160999,63,175980
10071,0.001632,172.217.194.0-255,2184,163183,63,175980
10072,0.001635,172.31.40.0-255,66,163249,63,175980
10073,0.001676,172.217.194.0-255,5738,168987,63,175980
10074,0.00168,172.31.40.0-255,66,169053,63,175980
10075,0.001719,172.31.40.0-255,66,169119,63,175980
10076,0.001731,172.31.40.0-255,66,169185,63,175980
10077,0.001756,172.217.194.0-255,4320,173505,63,175980
10078,0.001759,172.31.40.0-255,66,173571,63,175980
10079,0.001818,172.31.40.0-255,66,173637,63,175980
10080,0.001863,172.31.40.0-255,66,173703,63,175980
10081,0.001923,172.31.40.0-255,66,173769,63,175980
10082,0.001946,172.31.40.0-255,66,173835,63,175980
10083,0.001968,172.31.40.0-255,66,173901,63,175980
10084,0.001971,172.217.194.0-255,1149,175050,63,175980
10085,0.001973,172.217.194.0-255,105,175155,63,175980
10086,0.001976,172.217.194.0-255,129,175284,63,175980
10087,0.004764,172.31.40.0-255,105,175389,63,175980
10088,0.0048,172.31.40.0-255,105,175494,63,175980
10089,0.005057,172.31.40.0-255,90,175584,63,175980
10090,0.005066,172.31.40.0-255,66,175650,63,175980
10091,0.007304,172.217.194.0-255,66,175716,63,175980
10092,0.007357,172.217.194.0-255,66,175782,63,175980
10093,0.007569,172.217.194.0-255,66,175848,63,175980
10094,0.007613,172.217.194.0-255,66,175914,63,175980
10095,0.00762,172.31.40.0-255,66,175980,63,175980
10096,0.0,172.217.27.0-255,152,152,63,179194
10097,1.6e-05,172.31.40.0-255,66,218,63,179194
10098,2.3e-05,172.217.27.0-255,1484,1702,63,179194
10099,2.8e-05,172.31.40.0-255,66,1768,63,179194
10100,4.1e-05,172.217.27.0-255,2902,4670,63,179194
10101,4.4e-05,172.31.40.0-255,66,4736,63,179194
10102,4.7e-05,172.217.27.0-255,1484,6220,63,179194
10103,5e-05,172.31.40.0-255,66,6286,63,179194
10104,8.4e-05,172.217.27.0-255,5738,12024,63,179194
10105,8.7e-05,172.31.40.0-255,66,12090,63,179194
10106,9.1e-05,172.217.27.0-255,2042,14132,63,179194
10107,9.3e-05,172.31.40.0-255,66,14198,63,179194
10108,0.000126,172.217.27.0-255,2902,17100,63,179194
10109,0.000129,172.31.40.0-255,66,17166,63,179194
10110,0.000136,172.217.27.0-255,7156,24322,63,179194
10111,0.000139,172.31.40.0-255,66,24388,63,179194
10112,0.00015,172.217.27.0-255,1484,25872,63,179194
10113,0.000152,172.31.40.0-255,66,25938,63,179194
10114,0.000181,172.217.27.0-255,5379,31317,63,179194
10115,0.000184,172.31.40.0-255,66,31383,63,179194
10116,0.000399,172.217.27.0-255,1484,32867,63,179194
10117,0.000403,172.217.27.0-255,1484,34351,63,179194
10118,0.000405,172.217.27.0-255,1484,35835,63,179194
10119,0.000409,172.31.40.0-255,66,35901,63,179194
10120,0.000417,172.31.40.0-255,66,35967,63,179194
10121,0.000421,172.31.40.0-255,66,36033,63,179194
10122,0.000429,172.217.27.0-255,1484,37517,63,179194
10123,0.000431,172.31.40.0-255,66,37583,63,179194
10124,0.000438,172.217.27.0-255,5738,43321,63,179194
10125,0.00044,172.31.40.0-255,66,43387,63,179194
10126,0.000468,172.217.27.0-255,5379,48766,63,179194
10127,0.000471,172.31.40.0-255,66,48832,63,179194
10128,0.000563,172.217.27.0-255,1484,50316,63,179194
10129,0.000568,172.217.27.0-255,2902,53218,63,179194
10130,0.000572,172.31.40.0-255,66,53284,63,179194
10131,0.000577,172.217.27.0-255,2902,56186,63,179194
10132,0.000579,172.31.40.0-255,66,56252,63,179194
10133,0.000588,172.217.27.0-255,4320,60572,63,179194
10134,0.00059,172.31.40.0-255,66,60638,63,179194
10135,0.000613,172.217.27.0-255,4320,64958,63,179194
10136,0.000616,172.31.40.0-255,66,65024,63,179194
10137,0.000626,172.217.27.0-255,1412,66436,63,179194
10138,0.001062,172.217.27.0-255,141,66577,63,179194
10139,0.001067,172.31.40.0-255,66,66643,63,179194
10140,0.001107,172.217.27.0-255,1484,68127,63,179194
10141,0.001112,172.217.27.0-255,2902,71029,63,179194
10142,0.001115,172.31.40.0-255,66,71095,63,179194
10143,0.001118,172.217.27.0-255,1484,72579,63,179194
10144,0.001144,172.217.27.0-255,4320,76899,63,179194
10145,0.001146,172.31.40.0-255,66,76965,63,179194
10146,0.001166,172.217.27.0-255,4320,81285,63,179194
10147,0.001168,172.31.40.0-255,66,81351,63,179194
10148,0.001179,172.31.40.0-255,66,81417,63,179194
10149,0.001217,172.31.40.0-255,66,81483,63,179194
10150,0.00122,172.217.27.0-255,766,82249,63,179194
10151,0.001269,172.217.27.0-255,1765,84014,63,179194
10152,0.001272,172.31.40.0-255,66,84080,63,179194
10153,0.001285,172.217.27.0-255,2902,86982,63,179194
10154,0.001293,172.31.40.0-255,66,87048,63,179194
10155,0.001316,172.217.27.0-255,7156,94204,63,179194
10156,0.001318,172.31.40.0-255,66,94270,63,179194
10157,0.001325,172.217.27.0-255,7156,101426,63,179194
10158,0.001328,172.31.40.0-255,66,101492,63,179194
10159,0.001331,172.217.27.0-255,1484,102976,63,179194
10160,0.001363,172.217.27.0-255,7156,110132,63,179194
10161,0.001366,172.31.40.0-255,66,110198,63,179194
10162,0.001394,172.217.27.0-255,6438,116636,63,179194
10163,0.001397,172.31.40.0-255,66,116702,63,179194
10164,0.003035,172.217.27.0-255,5738,122440,63,179194
10165,0.003041,172.31.40.0-255,66,122506,63,179194
10166,0.004686,172.217.27.0-255,5738,128244,63,179194
10167,0.004691,172.31.40.0-255,66,128310,63,179194
10168,0.006321,172.217.27.0-255,4320,132630,63,179194
10169,0.006324,172.31.40.0-255,66,132696,63,179194
10170,0.006341,172.217.27.0-255,1484,134180,63,179194
10171,0.007962,172.217.27.0-255,4320,138500,63,179194
10172,0.007969,172.31.40.0-255,66,138566,63,179194
10173,0.009611,172.217.27.0-255,5738,144304,63,179194
10174,0.009619,172.31.40.0-255,66,144370,63,179194
10175,0.011282,172.217.27.0-255,5738,150108,63,179194
10176,0.01129,172.31.40.0-255,66,150174,63,179194
10177,0.01293,172.217.27.0-255,5738,155912,63,179194
10178,0.012937,172.31.40.0-255,66,155978,63,179194
10179,0.014585,172.217.27.0-255,5738,161716,63,179194
10180,0.014594,172.31.40.0-255,66,161782,63,179194
10181,0.016239,172.217.27.0-255,5738,167520,63,179194
10182,0.016246,172.31.40.0-255,66,167586,63,179194
10183,0.017884,172.217.27.0-255,5738,173324,63,179194
10184,0.017891,172.31.40.0-255,66,173390,63,179194
10185,0.019525,172.217.27.0-255,5738,179128,63,179194
10186,0.019532,172.31.40.0-255,66,179194,63,179194
10187,0.0,74.125.24.0-255,156,156,63,191404
10188,2.2e-05,172.31.40.0-255,66,222,63,191404
10189,3e-05,74.125.24.0-255,1484,1706,63,191404
10190,3.4e-05,172.31.40.0-255,66,1772,63,191404
10191,4e-05,74.125.24.0-255,2902,4674,63,191404
10192,4.3e-05,172.31.40.0-255,66,4740,63,191404
10193,4.9e-05,74.125.24.0-255,5738,10478,63,191404
10194,5.2e-05,172.31.40.0-255,66,10544,63,191404
10195,8.1e-05,74.125.24.0-255,7156,17700,63,191404
10196,8.4e-05,172.31.40.0-255,66,17766,63,191404
10197,0.000109,74.125.24.0-255,6382,24148,63,191404
10198,0.000111,172.31.40.0-255,66,24214,63,191404
10199,0.000132,74.125.24.0-255,6797,31011,63,191404
10200,0.000135,172.31.40.0-255,66,31077,63,191404
10201,0.000237,74.125.24.0-255,1484,32561,63,191404
10202,0.000242,172.31.40.0-255,66,32627,63,191404
10203,0.000248,74.125.24.0-255,2902,35529,63,191404
10204,0.00025,172.31.40.0-255,66,35595,63,191404
10205,0.000272,74.125.24.0-255,5738,41333,63,191404
10206,0.000275,172.31.40.0-255,66,41399,63,191404
10207,0.000278,74.125.24.0-255,1484,42883,63,191404
10208,0.00028,172.31.40.0-255,66,42949,63,191404
10209,0.000299,74.125.24.0-255,2902,45851,63,191404
10210,0.000301,172.31.40.0-255,66,45917,63,191404
10211,0.000337,74.125.24.0-255,3961,49878,63,191404
10212,0.00034,172.31.40.0-255,66,49944,63,191404
10213,0.000345,74.125.24.0-255,4320,54264,63,191404
10214,0.000347,172.31.40.0-255,66,54330,63,191404
10215,0.00036,74.125.24.0-255,1484,55814,63,191404
10216,0.000362,172.31.40.0-255,66,55880,63,191404
10217,0.000391,172.31.40.0-255,66,55946,63,191404
10218,0.000393,74.125.24.0-255,1434,57380,63,191404
10219,0.000538,74.125.24.0-255,111,57491,63,191404
10220,0.000667,74.125.24.0-255,1484,58975,63,191404
10221,0.000673,172.31.40.0-255,66,59041,63,191404
10222,0.000679,74.125.24.0-255,2902,61943,63,191404
10223,0.000681,172.31.40.0-255,66,62009,63,191404
10224,0.000685,74.125.24.0-255,2902,64911,63,191404
10225,0.000687,172.31.40.0-255,66,64977,63,191404
10226,0.000716,74.125.24.0-255,1484,66461,63,191404
10227,0.000723,74.125.24.0-255,5738,72199,63,191404
10228,0.000725,172.31.40.0-255,66,72265,63,191404
10229,0.000742,74.125.24.0-255,1484,73749,63,191404
10230,0.000776,172.31.40.0-255,66,73815,63,191404
10231,0.000796,74.125.24.0-255,7041,80856,63,191404
10232,0.000798,172.31.40.0-255,66,80922,63,191404
10233,0.001102,74.125.24.0-255,1484,82406,63,191404
10234,0.001108,74.125.24.0-255,2902,85308,63,191404
10235,0.001111,172.31.40.0-255,66,85374,63,191404
10236,0.001132,74.125.24.0-255,5738,91112,63,191404
10237,0.001136,172.31.40.0-255,66,91178,63,191404
10238,0.001148,74.125.24.0-255,5738,96916,63,191404
10239,0.00115,172.31.40.0-255,66,96982,63,191404
10240,0.001172,74.125.24.0-255,7156,104138,63,191404
10241,0.001175,172.31.40.0-255,66,104204,63,191404
10242,0.001194,74.125.24.0-255,1484,105688,63,191404
10243,0.001215,172.31.40.0-255,66,105754,63,191404
10244,0.001481,74.125.24.0-255,1484,107238,63,191404
10245,0.001485,74.125.24.0-255,1484,108722,63,191404
10246,0.001488,172.31.40.0-255,66,108788,63,191404
10247,0.00151,74.125.24.0-255,1484,110272,63,191404
10248,0.001516,74.125.24.0-255,4320,114592,63,191404
10249,0.001518,172.31.40.0-255,66,114658,63,191404
10250,0.001528,172.31.40.0-255,66,114724,63,191404
10251,0.00155,74.125.24.0-255,1484,116208,63,191404
10252,0.00158,172.31.40.0-255,66,116274,63,191404
10253,0.002087,74.125.24.0-255,1484,117758,63,191404
10254,0.002093,74.125.24.0-255,2902,120660,63,191404
10255,0.002097,172.31.40.0-255,66,120726,63,191404
10256,0.002133,74.125.24.0-255,5738,126464,63,191404
10257,0.002165,172.31.40.0-255,66,126530,63,191404
10258,0.002185,74.125.24.0-255,5738,132268,63,191404
10259,0.002187,172.31.40.0-255,66,132334,63,191404
10260,0.002194,74.125.24.0-255,7156,139490,63,191404
10261,0.002196,172.31.40.0-255,66,139556,63,191404
10262,0.002199,74.125.24.0-255,1484,141040,63,191404
10263,0.002215,74.125.24.0-255,1484,142524,63,191404
10264,0.002218,172.31.40.0-255,66,142590,63,191404
10265,0.002223,74.125.24.0-255,4320,146910,63,191404
10266,0.002225,172.31.40.0-255,66,146976,63,191404
10267,0.002248,74.125.24.0-255,1484,148460,63,191404
10268,0.002259,74.125.24.0-255,2184,150644,63,191404
10269,0.002262,172.31.40.0-255,66,150710,63,191404
10270,0.004492,74.125.24.0-255,1484,152194,63,191404
10271,0.004527,74.125.24.0-255,4320,156514,63,191404
10272,0.004531,172.31.40.0-255,66,156580,63,191404
10273,0.006781,74.125.24.0-255,5738,162318,63,191404
10274,0.006784,172.31.40.0-255,66,162384,63,191404
10275,0.009062,74.125.24.0-255,5738,168122,63,191404
10276,0.009071,172.31.40.0-255,66,168188,63,191404
10277,0.011388,74.125.24.0-255,5738,173926,63,191404
10278,0.0114,172.31.40.0-255,66,173992,63,191404
10279,0.013685,74.125.24.0-255,5738,179730,63,191404
10280,0.013694,172.31.40.0-255,66,179796,63,191404
10281,0.015981,74.125.24.0-255,5738,185534,63,191404
10282,0.015989,172.31.40.0-255,66,185600,63,191404
10283,0.018268,74.125.24.0-255,5738,191338,63,191404
10284,0.018278,172.31.40.0-255,66,191404,63,191404
10285,0.0,172.217.194.0-255,153,153,63,178129
10286,2.3e-05,172.31.40.0-255,66,219,63,178129
10287,3.1e-05,172.217.194.0-255,1484,1703,63,178129
10288,3.6e-05,172.31.40.0-255,66,1769,63,178129
10289,5.1e-05,172.217.194.0-255,2902,4671,63,178129
10290,5.4e-05,172.31.40.0-255,66,4737,63,178129
10291,6.2e-05,172.217.194.0-255,7156,11893,63,178129
10292,6.5e-05,172.31.40.0-255,66,11959,63,178129
10293,7.7e-05,172.31.40.0-255,66,12025,63,178129
10294,0.00012,172.217.194.0-255,2000,14025,63,178129
10295,0.000123,172.31.40.0-255,66,14091,63,178129
10296,0.000136,172.31.40.0-255,66,14157,63,178129
10297,0.000162,172.217.194.0-255,1484,15641,63,178129
10298,0.000164,172.31.40.0-255,66,15707,63,178129
10299,0.000169,172.217.194.0-255,2902,18609,63,178129
10300,0.000171,172.31.40.0-255,66,18675,63,178129
10301,0.000178,172.217.194.0-255,5738,24413,63,178129
10302,0.000181,172.31.40.0-255,66,24479,63,178129
10303,0.000206,172.217.194.0-255,4320,28799,63,178129
10304,0.000209,172.31.40.0-255,66,28865,63,178129
10305,0.000244,172.31.40.0-255,66,28931,63,178129
10306,0.000285,172.31.40.0-255,66,28997,63,178129
10307,0.000288,172.217.194.0-255,364,29361,63,178129
10308,0.00029,172.31.40.0-255,66,29427,63,178129
10309,0.000366,172.217.194.0-255,1484,30911,63,178129
10310,0.000369,172.31.40.0-255,66,30977,63,178129
10311,0.000375,172.217.194.0-255,2902,33879,63,178129
10312,0.000377,172.31.40.0-255,66,33945,63,178129
10313,0.000405,172.217.194.0-255,5738,39683,63,178129
10314,0.000409,172.31.40.0-255,66,39749,63,178129
10315,0.000415,172.217.194.0-255,5738,45487,63,178129
10316,0.000417,172.31.40.0-255,66,45553,63,178129
10317,0.00044,172.217.194.0-255,5738,51291,63,178129
10318,0.000442,172.31.40.0-255,66,51357,63,178129
10319,0.000483,172.31.40.0-255,66,51423,63,178129
10320,0.000489,172.217.194.0-255,3961,55384,63,178129
10321,0.000492,172.31.40.0-255,66,55450,63,178129
10322,0.000883,172.217.194.0-255,1484,56934,63,178129
10323,0.00089,172.217.194.0-255,2902,59836,63,178129
10324,0.000895,172.31.40.0-255,66,59902,63,178129
10325,0.000901,172.217.194.0-255,4320,64222,63,178129
10326,0.000903,172.31.40.0-255,66,64288,63,178129
10327,0.000927,172.217.194.0-255,1484,65772,63,178129
10328,0.000938,172.217.194.0-255,5738,71510,63,178129
10329,0.000941,172.31.40.0-255,66,71576,63,178129
10330,0.000955,172.31.40.0-255,66,71642,63,178129
10331,0.000979,172.217.194.0-255,1484,73126,63,178129
10332,0.000986,172.217.194.0-255,5020,78146,63,178129
10333,0.001003,172.31.40.0-255,66,78212,63,178129
10334,0.001108,172.217.194.0-255,1484,79696,63,178129
10335,0.001114,172.217.194.0-255,2902,82598,63,178129
10336,0.001118,172.31.40.0-255,66,82664,63,178129
10337,0.001123,172.217.194.0-255,2902,85566,63,178129
10338,0.001126,172.31.40.0-255,66,85632,63,178129
10339,0.001148,172.217.194.0-255,2902,88534,63,178129
10340,0.001151,172.31.40.0-255,66,88600,63,178129
10341,0.001164,172.31.40.0-255,66,88666,63,178129
10342,0.001188,172.217.194.0-255,2902,91568,63,178129
10343,0.001191,172.31.40.0-255,66,91634,63,178129
10344,0.001199,172.217.194.0-255,7156,98790,63,178129
10345,0.001201,172.31.40.0-255,66,98856,63,178129
10346,0.00123,172.217.194.0-255,3602,102458,63,178129
10347,0.001233,172.31.40.0-255,66,102524,63,178129
10348,0.001727,172.217.194.0-255,1484,104008,63,178129
10349,0.001743,172.217.194.0-255,2902,106910,63,178129
10350,0.001746,172.31.40.0-255,66,106976,63,178129
10351,0.001753,172.217.194.0-255,5738,112714,63,178129
10352,0.001755,172.31.40.0-255,66,112780,63,178129
10353,0.001773,172.217.194.0-255,2902,115682,63,178129
10354,0.001775,172.31.40.0-255,66,115748,63,178129
10355,0.001835,172.31.40.0-255,66,115814,63,178129
10356,0.001849,172.31.40.0-255,66,115880,63,178129
10357,0.001852,172.217.194.0-255,1484,117364,63,178129
10358,0.001856,172.217.194.0-255,1484,118848,63,178129
10359,0.001858,172.31.40.0-255,66,118914,63,178129
10360,0.001893,172.217.194.0-255,1484,120398,63,178129
10361,0.001899,172.217.194.0-255,5738,126136,63,178129
10362,0.001902,172.31.40.0-255,66,126202,63,178129
10363,0.001915,172.31.40.0-255,66,126268,63,178129
10364,0.001918,172.217.194.0-255,1484,127752,63,178129
10365,0.001958,172.31.40.0-255,66,127818,63,178129
10366,0.002038,172.217.194.0-255,1484,129302,63,178129
10367,0.00206,172.217.194.0-255,2902,132204,63,178129
10368,0.002064,172.31.40.0-255,66,132270,63,178129
10369,0.00207,172.217.194.0-255,5738,138008,63,178129
10370,0.002072,172.31.40.0-255,66,138074,63,178129
10371,0.002118,172.31.40.0-255,66,138140,63,178129
10372,0.00213,172.31.40.0-255,66,138206,63,178129
10373,0.002189,172.217.194.0-255,1484,139690,63,178129
10374,0.002194,172.217.194.0-255,2902,142592,63,178129
10375,0.002197,172.31.40.0-255,66,142658,63,178129
10376,0.002204,172.217.194.0-255,5738,148396,63,178129
10377,0.002206,172.31.40.0-255,66,148462,63,178129
10378,0.002217,172.31.40.0-255,66,148528,63,178129
10379,0.002239,172.217.194.0-255,2902,151430,63,178129
10380,0.002241,172.31.40.0-255,66,151496,63,178129
10381,0.002249,172.217.194.0-255,5738,157234,63,178129
10382,0.002251,172.31.40.0-255,66,157300,63,178129
10383,0.002298,172.217.194.0-255,6438,163738,63,178129
10384,0.002302,172.31.40.0-255,66,163804,63,178129
10385,0.002318,172.31.40.0-255,66,163870,63,178129
10386,0.002336,172.31.40.0-255,66,163936,63,178129
10387,0.002338,172.217.194.0-255,766,164702,63,178129
10388,0.002369,172.31.40.0-255,66,164768,63,178129
10389,0.002401,172.217.194.0-255,7156,171924,63,178129
10390,0.002404,172.31.40.0-255,66,171990,63,178129
10391,0.002426,172.31.40.0-255,66,172056,63,178129
10392,0.002428,172.217.194.0-255,766,172822,63,178129
10393,0.002463,172.31.40.0-255,66,172888,63,178129
10394,0.002504,172.31.40.0-255,66,172954,63,178129
10395,0.002527,172.217.194.0-255,4483,177437,63,178129
10396,0.002544,172.217.194.0-255,105,177542,63,178129
10397,0.01134,172.31.40.0-255,66,177608,63,178129
10398,0.012788,172.31.40.0-255,101,177709,63,178129
10399,0.013108,172.217.194.0-255,105,177814,63,178129
10400,0.01312,172.31.40.0-255,78,177892,63,178129
10401,0.013891,172.31.40.0-255,105,177997,63,178129
10402,0.015355,172.217.194.0-255,66,178063,63,178129
10403,0.016493,172.217.194.0-255,66,178129,63,178129
10404,0.0,74.125.130.0-255,149,149,63,117064
10405,1.7e-05,172.31.40.0-255,66,215,63,117064
10406,2.4e-05,74.125.130.0-255,1484,1699,63,117064
10407,3e-05,172.31.40.0-255,66,1765,63,117064
10408,3.7e-05,74.125.130.0-255,2902,4667,63,117064
10409,4.1e-05,172.31.40.0-255,66,4733,63,117064
10410,8.1e-05,74.125.130.0-255,4320,9053,63,117064
10411,8.4e-05,172.31.40.0-255,66,9119,63,117064
10412,0.000182,74.125.130.0-255,4989,14108,63,117064
10413,0.000186,172.31.40.0-255,66,14174,63,117064
10414,0.000295,74.125.130.0-255,1484,15658,63,117064
10415,0.0003,172.31.40.0-255,66,15724,63,117064
10416,0.000315,74.125.130.0-255,4320,20044,63,117064
10417,0.000317,172.31.40.0-255,66,20110,63,117064
10418,0.000441,74.125.130.0-255,7156,27266,63,117064
10419,0.000447,172.31.40.0-255,66,27332,63,117064
10420,0.000469,74.125.130.0-255,3961,31293,63,117064
10421,0.000472,172.31.40.0-255,66,31359,63,117064
10422,0.000912,74.125.130.0-255,1484,32843,63,117064
10423,0.000919,172.31.40.0-255,66,32909,63,117064
10424,0.000928,74.125.130.0-255,2902,35811,63,117064
10425,0.000931,172.31.40.0-255,66,35877,63,117064
10426,0.000985,74.125.130.0-255,5738,41615,63,117064
10427,0.000988,172.31.40.0-255,66,41681,63,117064
10428,0.00112,74.125.130.0-255,4320,46001,63,117064
10429,0.001125,172.31.40.0-255,66,46067,63,117064
10430,0.001143,74.125.130.0-255,1484,47551,63,117064
10431,0.001145,172.31.40.0-255,66,47617,63,117064
10432,0.00126,74.125.130.0-255,4320,51937,63,117064
10433,0.001266,172.31.40.0-255,66,52003,63,117064
10434,0.001294,172.31.40.0-255,66,52069,63,117064
10435,0.00157,74.125.130.0-255,5991,58060,63,117064
10436,0.001697,74.125.130.0-255,1484,59544,63,117064
10437,0.001742,74.125.130.0-255,2902,62446,63,117064
10438,0.001805,74.125.130.0-255,2902,65348,63,117064
10439,0.001817,74.125.130.0-255,2902,68250,63,117064
10440,0.00194,172.31.40.0-255,66,68316,63,117064
10441,0.001973,172.31.40.0-255,66,68382,63,117064
10442,0.002278,74.125.130.0-255,2184,70566,63,117064
10443,0.002285,172.31.40.0-255,66,70632,63,117064
10444,0.004328,74.125.130.0-255,5738,76370,63,117064
10445,0.004333,172.31.40.0-255,66,76436,63,117064
10446,0.006373,74.125.130.0-255,5738,82174,63,117064
10447,0.006379,172.31.40.0-255,66,82240,63,117064
10448,0.008441,74.125.130.0-255,5738,87978,63,117064
10449,0.008451,172.31.40.0-255,66,88044,63,117064
10450,0.010503,74.125.130.0-255,5738,93782,63,117064
10451,0.010516,172.31.40.0-255,66,93848,63,117064
10452,0.01259,74.125.130.0-255,5738,99586,63,117064
10453,0.012606,172.31.40.0-255,66,99652,63,117064
10454,0.014657,74.125.130.0-255,5738,105390,63,117064
10455,0.014669,172.31.40.0-255,66,105456,63,117064
10456,0.016731,74.125.130.0-255,5738,111194,63,117064
10457,0.016741,172.31.40.0-255,66,111260,63,117064
10458,0.018786,74.125.130.0-255,5738,116998,63,117064
10459,0.018793,172.31.40.0-255,66,117064,63,117064
10460,0.0,172.217.194.0-255,153,153,63,198209
10461,1.8e-05,172.31.40.0-255,66,219,63,198209
10462,2.4e-05,172.217.194.0-255,1484,1703,63,198209
10463,2.8e-05,172.31.40.0-255,66,1769,63,198209
10464,3.4e-05,172.217.194.0-255,2902,4671,63,198209
10465,3.7e-05,172.31.40.0-255,66,4737,63,198209
10466,4.3e-05,172.217.194.0-255,5738,10475,63,198209
10467,4.6e-05,172.31.40.0-255,66,10541,63,198209
10468,7.8e-05,172.217.194.0-255,3449,13990,63,198209
10469,8.1e-05,172.31.40.0-255,66,14056,63,198209
10470,0.000179,172.217.194.0-255,1484,15540,63,198209
10471,0.000183,172.31.40.0-255,66,15606,63,198209
10472,0.000187,172.217.194.0-255,2902,18508,63,198209
10473,0.000189,172.31.40.0-255,66,18574,63,198209
10474,0.000207,172.217.194.0-255,5738,24312,63,198209
10475,0.000209,172.31.40.0-255,66,24378,63,198209
10476,0.000229,172.217.194.0-255,4320,28698,63,198209
10477,0.000231,172.31.40.0-255,66,28764,63,198209
10478,0.000267,172.217.194.0-255,5379,34143,63,198209
10479,0.00027,172.31.40.0-255,66,34209,63,198209
10480,0.000296,172.31.40.0-255,66,34275,63,198209
10481,0.000298,172.217.194.0-255,1484,35759,63,198209
10482,0.0003,172.31.40.0-255,66,35825,63,198209
10483,0.000341,172.31.40.0-255,66,35891,63,198209
10484,0.000348,172.217.194.0-255,6438,42329,63,198209
10485,0.00035,172.31.40.0-255,66,42395,63,198209
10486,0.000364,172.217.194.0-255,678,43073,63,198209
10487,0.000366,172.31.40.0-255,66,43139,63,198209
10488,0.000587,172.217.194.0-255,1484,44623,63,198209
10489,0.000591,172.31.40.0-255,66,44689,63,198209
10490,0.000596,172.217.194.0-255,2902,47591,63,198209
10491,0.000598,172.31.40.0-255,66,47657,63,198209
10492,0.000612,172.217.194.0-255,4320,51977,63,198209
10493,0.000614,172.31.40.0-255,66,52043,63,198209
10494,0.000626,172.217.194.0-255,1484,53527,63,198209
10495,0.000631,172.217.194.0-255,2902,56429,63,198209
10496,0.000633,172.31.40.0-255,66,56495,63,198209
10497,0.000651,172.31.40.0-255,66,56561,63,198209
10498,0.000701,172.31.40.0-255,66,56627,63,198209
10499,0.000721,172.217.194.0-255,2184,58811,63,198209
10500,0.000725,172.31.40.0-255,66,58877,63,198209
10501,0.001054,172.217.194.0-255,1484,60361,63,198209
10502,0.001072,172.217.194.0-255,2902,63263,63,198209
10503,0.001075,172.31.40.0-255,66,63329,63,198209
10504,0.001082,172.217.194.0-255,4320,67649,63,198209
10505,0.001084,172.31.40.0-255,66,67715,63,198209
10506,0.001099,172.217.194.0-255,1484,69199,63,198209
10507,0.001105,172.217.194.0-255,5738,74937,63,198209
10508,0.001107,172.31.40.0-255,66,75003,63,198209
10509,0.001115,172.217.194.0-255,7156,82159,63,198209
10510,0.001117,172.31.40.0-255,66,82225,63,198209
10511,0.001141,172.217.194.0-255,1484,83709,63,198209
10512,0.001164,172.31.40.0-255,66,83775,63,198209
10513,0.001239,172.217.194.0-255,1484,85259,63,198209
10514,0.001243,172.217.194.0-255,2902,88161,63,198209
10515,0.001246,172.31.40.0-255,66,88227,63,198209
10516,0.001271,172.217.194.0-255,5738,93965,63,198209
10517,0.001274,172.31.40.0-255,66,94031,63,198209
10518,0.001282,172.217.194.0-255,7156,101187,63,198209
10519,0.001284,172.31.40.0-255,66,101253,63,198209
10520,0.001302,172.217.194.0-255,5738,106991,63,198209
10521,0.001321,172.31.40.0-255,66,107057,63,198209
10522,0.001335,172.31.40.0-255,66,107123,63,198209
10523,0.00167,172.217.194.0-255,1484,108607,63,198209
10524,0.001676,172.217.194.0-255,2902,111509,63,198209
10525,0.001682,172.31.40.0-255,66,111575,63,198209
10526,0.001691,172.217.194.0-255,1484,113059,63,198209
10527,0.001704,172.217.194.0-255,2902,115961,63,198209
10528,0.001706,172.31.40.0-255,66,116027,63,198209
10529,0.001713,172.217.194.0-255,5738,121765,63,198209
10530,0.001715,172.31.40.0-255,66,121831,63,198209
10531,0.001758,172.31.40.0-255,66,121897,63,198209
10532,0.001765,172.217.194.0-255,6438,128335,63,198209
10533,0.001768,172.31.40.0-255,66,128401,63,198209
10534,0.001884,172.217.194.0-255,1484,129885,63,198209
10535,0.001901,172.217.194.0-255,2902,132787,63,198209
10536,0.001905,172.31.40.0-255,66,132853,63,198209
10537,0.001912,172.217.194.0-255,5738,138591,63,198209
10538,0.001914,172.31.40.0-255,66,138657,63,198209
10539,0.00194,172.217.194.0-255,5738,144395,63,198209
10540,0.001942,172.31.40.0-255,66,144461,63,198209
10541,0.001969,172.217.194.0-255,7156,151617,63,198209
10542,0.001971,172.31.40.0-255,66,151683,63,198209
10543,0.001979,172.217.194.0-255,7156,158839,63,198209
10544,0.001981,172.31.40.0-255,66,158905,63,198209
10545,0.002019,172.217.194.0-255,3602,162507,63,198209
10546,0.002023,172.31.40.0-255,66,162573,63,198209
10547,0.002126,172.217.194.0-255,1484,164057,63,198209
10548,0.002131,172.217.194.0-255,2902,166959,63,198209
10549,0.002134,172.31.40.0-255,66,167025,63,198209
10550,0.002138,172.217.194.0-255,1484,168509,63,198209
10551,0.002159,172.217.194.0-255,4320,172829,63,198209
10552,0.002162,172.31.40.0-255,66,172895,63,198209
10553,0.002166,172.217.194.0-255,2902,175797,63,198209
10554,0.002168,172.31.40.0-255,66,175863,63,198209
10555,0.002193,172.217.194.0-255,4320,180183,63,198209
10556,0.002197,172.31.40.0-255,66,180249,63,198209
10557,0.002212,172.31.40.0-255,66,180315,63,198209
10558,0.002215,172.217.194.0-255,2184,182499,63,198209
10559,0.002217,172.31.40.0-255,66,182565,63,198209
10560,0.002259,172.217.194.0-255,1484,184049,63,198209
10561,0.002264,172.217.194.0-255,2902,186951,63,198209
10562,0.002267,172.31.40.0-255,66,187017,63,198209
10563,0.002272,172.217.194.0-255,2902,189919,63,198209
10564,0.002274,172.31.40.0-255,66,189985,63,198209
10565,0.002292,172.217.194.0-255,2902,192887,63,198209
10566,0.002294,172.31.40.0-255,66,192953,63,198209
10567,0.002299,172.217.194.0-255,4320,197273,63,198209
10568,0.002302,172.31.40.0-255,66,197339,63,198209
10569,0.002328,172.31.40.0-255,66,197405,63,198209
10570,0.002339,172.31.40.0-255,66,197471,63,198209
10571,0.002408,172.31.40.0-255,66,197537,63,198209
10572,0.002427,172.31.40.0-255,66,197603,63,198209
10573,0.00244,172.31.40.0-255,66,197669,63,198209
10574,0.002509,172.31.40.0-255,66,197735,63,198209
10575,0.002548,172.31.40.0-255,66,197801,63,198209
10576,0.002569,172.31.40.0-255,66,197867,63,198209
10577,0.005069,172.217.194.0-255,105,197972,63,198209
10578,0.013038,172.31.40.0-255,66,198038,63,198209
10579,0.013088,172.31.40.0-255,105,198143,63,198209
10580,0.015575,172.217.194.0-255,66,198209,63,198209
10581,0.0,74.125.200.0-255,147,147,63,201874
10582,2.9e-05,172.31.40.0-255,66,213,63,201874
10583,3.8e-05,74.125.200.0-255,1484,1697,63,201874
10584,4.3e-05,172.31.40.0-255,66,1763,63,201874
10585,4.9e-05,74.125.200.0-255,2902,4665,63,201874
10586,6e-05,172.31.40.0-255,66,4731,63,201874
10587,6.8e-05,74.125.200.0-255,5738,10469,63,201874
10588,7.1e-05,172.31.40.0-255,66,10535,63,201874
10589,7.6e-05,74.125.200.0-255,3348,13883,63,201874
10590,7.9e-05,172.31.40.0-255,66,13949,63,201874
10591,0.000349,74.125.200.0-255,1484,15433,63,201874
10592,0.000355,172.31.40.0-255,66,15499,63,201874
10593,0.000361,74.125.200.0-255,2902,18401,63,201874
10594,0.000364,172.31.40.0-255,66,18467,63,201874
10595,0.000367,74.125.200.0-255,1484,19951,63,201874
10596,0.000374,172.31.40.0-255,66,20017,63,201874
10597,0.000407,74.125.200.0-255,2902,22919,63,201874
10598,0.00041,172.31.40.0-255,66,22985,63,201874
10599,0.000416,74.125.200.0-255,5738,28723,63,201874
10600,0.000419,172.31.40.0-255,66,28789,63,201874
10601,0.000455,74.125.200.0-255,3961,32750,63,201874
10602,0.000458,172.31.40.0-255,66,32816,63,201874
10603,0.000463,74.125.200.0-255,4320,37136,63,201874
10604,0.000465,172.31.40.0-255,66,37202,63,201874
10605,0.000468,74.125.200.0-255,1484,38686,63,201874
10606,0.00047,172.31.40.0-255,66,38752,63,201874
10607,0.000498,74.125.200.0-255,5738,44490,63,201874
10608,0.000501,172.31.40.0-255,66,44556,63,201874
10609,0.000527,74.125.200.0-255,2902,47458,63,201874
10610,0.000534,172.31.40.0-255,66,47524,63,201874
10611,0.00054,74.125.200.0-255,5738,53262,63,201874
10612,0.000543,172.31.40.0-255,66,53328,63,201874
10613,0.000551,74.125.200.0-255,7156,60484,63,201874
10614,0.000553,172.31.40.0-255,66,60550,63,201874
10615,0.000582,74.125.200.0-255,5020,65570,63,201874
10616,0.000589,172.31.40.0-255,66,65636,63,201874
10617,0.000592,74.125.200.0-255,412,66048,63,201874
10618,0.000691,74.125.200.0-255,332,66380,63,201874
10619,0.000984,74.125.200.0-255,1484,67864,63,201874
10620,0.000995,172.31.40.0-255,66,67930,63,201874
10621,0.001002,74.125.200.0-255,2902,70832,63,201874
10622,0.001005,172.31.40.0-255,66,70898,63,201874
10623,0.001034,74.125.200.0-255,5738,76636,63,201874
10624,0.001037,172.31.40.0-255,66,76702,63,201874
10625,0.001043,74.125.200.0-255,4320,81022,63,201874
10626,0.001045,172.31.40.0-255,66,81088,63,201874
10627,0.001088,74.125.200.0-255,4320,85408,63,201874
10628,0.001091,172.31.40.0-255,66,85474,63,201874
10629,0.001105,172.31.40.0-255,66,85540,63,201874
10630,0.001111,74.125.200.0-255,5020,90560,63,201874
10631,0.001114,172.31.40.0-255,66,90626,63,201874
10632,0.001806,74.125.200.0-255,1484,92110,63,201874
10633,0.001816,74.125.200.0-255,2902,95012,63,201874
10634,0.001821,172.31.40.0-255,66,95078,63,201874
10635,0.001854,74.125.200.0-255,5738,100816,63,201874
10636,0.001857,172.31.40.0-255,66,100882,63,201874
10637,0.001862,74.125.200.0-255,2902,103784,63,201874
10638,0.001864,172.31.40.0-255,66,103850,63,201874
10639,0.001874,74.125.200.0-255,4320,108170,63,201874
10640,0.001877,172.31.40.0-255,66,108236,63,201874
10641,0.00188,74.125.200.0-255,1484,109720,63,201874
10642,0.001921,74.125.200.0-255,7156,116876,63,201874
10643,0.001926,172.31.40.0-255,66,116942,63,201874
10644,0.001931,74.125.200.0-255,2902,119844,63,201874
10645,0.001933,172.31.40.0-255,66,119910,63,201874
10646,0.001961,74.125.200.0-255,5020,124930,63,201874
10647,0.001964,172.31.40.0-255,66,124996,63,201874
10648,0.002072,74.125.200.0-255,1484,126480,63,201874
10649,0.002087,74.125.200.0-255,2902,129382,63,201874
10650,0.00209,172.31.40.0-255,66,129448,63,201874
10651,0.002111,74.125.200.0-255,4320,133768,63,201874
10652,0.002114,172.31.40.0-255,66,133834,63,201874
10653,0.002144,74.125.200.0-255,1484,135318,63,201874
10654,0.002152,74.125.200.0-255,7156,142474,63,201874
10655,0.002155,172.31.40.0-255,66,142540,63,201874
10656,0.002163,74.125.200.0-255,5738,148278,63,201874
10657,0.002164,172.31.40.0-255,66,148344,63,201874
10658,0.002199,172.31.40.0-255,66,148410,63,201874
10659,0.002221,74.125.200.0-255,2184,150594,63,201874
10660,0.002224,172.31.40.0-255,66,150660,63,201874
10661,0.002486,74.125.200.0-255,1484,152144,63,201874
10662,0.002495,74.125.200.0-255,2902,155046,63,201874
10663,0.002499,172.31.40.0-255,66,155112,63,201874
10664,0.002504,74.125.200.0-255,1484,156596,63,201874
10665,0.00253,74.125.200.0-255,1484,158080,63,201874
10666,0.002532,172.31.40.0-255,66,158146,63,201874
10667,0.002575,74.125.200.0-255,4320,162466,63,201874
10668,0.002578,172.31.40.0-255,66,162532,63,201874
10669,0.002584,74.125.200.0-255,4320,166852,63,201874
10670,0.002586,172.31.40.0-255,66,166918,63,201874
10671,0.002589,74.125.200.0-255,1484,168402,63,201874
10672,0.005137,74.125.200.0-255,4320,172722,63,201874
10673,0.005142,172.31.40.0-255,66,172788,63,201874
10674,0.007681,74.125.200.0-255,1484,174272,63,201874
10675,0.007697,74.125.200.0-255,4320,178592,63,201874
10676,0.007702,172.31.40.0-255,66,178658,63,201874
10677,0.010244,74.125.200.0-255,5738,184396,63,201874
10678,0.010252,172.31.40.0-255,66,184462,63,201874
10679,0.012805,74.125.200.0-255,5738,190200,63,201874
10680,0.012813,172.31.40.0-255,66,190266,63,201874
10681,0.015368,74.125.200.0-255,5738,196004,63,201874
10682,0.015378,172.31.40.0-255,66,196070,63,201874
10683,0.017938,74.125.200.0-255,5738,201808,63,201874
10684,0.017948,172.31.40.0-255,66,201874,63,201874
10685,0.0,74.125.24.0-255,155,155,63,190869
10686,1.4e-05,172.31.40.0-255,66,221,63,190869
10687,2e-05,74.125.24.0-255,1484,1705,63,190869
10688,2.4e-05,172.31.40.0-255,66,1771,63,190869
10689,2.9e-05,74.125.24.0-255,2902,4673,63,190869
10690,3.2e-05,172.31.40.0-255,66,4739,63,190869
10691,4e-05,74.125.24.0-255,7156,11895,63,190869
10692,4.3e-05,172.31.40.0-255,66,11961,63,190869
10693,6.3e-05,74.125.24.0-255,2100,14061,63,190869
10694,6.6e-05,172.31.40.0-255,66,14127,63,190869
10695,8.8e-05,74.125.24.0-255,2902,17029,63,190869
10696,9e-05,172.31.40.0-255,66,17095,63,190869
10697,9.5e-05,74.125.24.0-255,2902,19997,63,190869
10698,9.7e-05,172.31.40.0-255,66,20063,63,190869
10699,0.000117,74.125.24.0-255,4320,24383,63,190869
10700,0.000119,172.31.40.0-255,66,24449,63,190869
10701,0.000142,74.125.24.0-255,4320,28769,63,190869
10702,0.000145,172.31.40.0-255,66,28835,63,190869
10703,0.000169,74.125.24.0-255,1484,30319,63,190869
10704,0.000171,172.31.40.0-255,66,30385,63,190869
10705,0.000174,74.125.24.0-255,1125,31510,63,190869
10706,0.000175,172.31.40.0-255,66,31576,63,190869
10707,0.00019,74.125.24.0-255,1484,33060,63,190869
10708,0.000193,172.31.40.0-255,66,33126,63,190869
10709,0.000199,74.125.24.0-255,4320,37446,63,190869
10710,0.000201,172.31.40.0-255,66,37512,63,190869
10711,0.000204,74.125.24.0-255,1484,38996,63,190869
10712,0.000206,172.31.40.0-255,66,39062,63,190869
10713,0.000235,74.125.24.0-255,5738,44800,63,190869
10714,0.000238,172.31.40.0-255,66,44866,63,190869
10715,0.000252,172.31.40.0-255,66,44932,63,190869
10716,0.000257,74.125.24.0-255,2902,47834,63,190869
10717,0.000258,172.31.40.0-255,66,47900,63,190869
10718,0.000275,74.125.24.0-255,3961,51861,63,190869
10719,0.000278,172.31.40.0-255,66,51927,63,190869
10720,0.000524,74.125.24.0-255,413,52340,63,190869
10721,0.000547,74.125.24.0-255,331,52671,63,190869
10722,0.000737,74.125.24.0-255,1484,54155,63,190869
10723,0.000742,172.31.40.0-255,66,54221,63,190869
10724,0.000749,74.125.24.0-255,2902,57123,63,190869
10725,0.000751,172.31.40.0-255,66,57189,63,190869
10726,0.000779,74.125.24.0-255,5738,62927,63,190869
10727,0.000781,172.31.40.0-255,66,62993,63,190869
10728,0.000784,74.125.24.0-255,1484,64477,63,190869
10729,0.000793,172.31.40.0-255,66,64543,63,190869
10730,0.000826,172.31.40.0-255,66,64609,63,190869
10731,0.000843,74.125.24.0-255,5020,69629,63,190869
10732,0.000846,172.31.40.0-255,66,69695,63,190869
10733,0.000982,74.125.24.0-255,1484,71179,63,190869
10734,0.000989,74.125.24.0-255,2902,74081,63,190869
10735,0.000992,172.31.40.0-255,66,74147,63,190869
10736,0.000997,74.125.24.0-255,4320,78467,63,190869
10737,0.000999,172.31.40.0-255,66,78533,63,190869
10738,0.00101,74.125.24.0-255,1484,80017,63,190869
10739,0.001016,74.125.24.0-255,5738,85755,63,190869
10740,0.001018,172.31.40.0-255,66,85821,63,190869
10741,0.001051,74.125.24.0-255,7156,92977,63,190869
10742,0.001054,172.31.40.0-255,66,93043,63,190869
10743,0.001061,74.125.24.0-255,7156,100199,63,190869
10744,0.001063,172.31.40.0-255,66,100265,63,190869
10745,0.001078,74.125.24.0-255,3602,103867,63,190869
10746,0.001082,172.31.40.0-255,66,103933,63,190869
10747,0.001994,74.125.24.0-255,1484,105417,63,190869
10748,0.002004,74.125.24.0-255,2902,108319,63,190869
10749,0.002009,172.31.40.0-255,66,108385,63,190869
10750,0.002017,74.125.24.0-255,5738,114123,63,190869
10751,0.002019,172.31.40.0-255,66,114189,63,190869
10752,0.002022,74.125.24.0-255,1484,115673,63,190869
10753,0.002063,172.31.40.0-255,66,115739,63,190869
10754,0.00207,74.125.24.0-255,7156,122895,63,190869
10755,0.002072,172.31.40.0-255,66,122961,63,190869
10756,0.002099,74.125.24.0-255,3602,126563,63,190869
10757,0.002102,172.31.40.0-255,66,126629,63,190869
10758,0.002176,74.125.24.0-255,1484,128113,63,190869
10759,0.002182,74.125.24.0-255,2902,131015,63,190869
10760,0.002185,172.31.40.0-255,66,131081,63,190869
10761,0.002191,74.125.24.0-255,5738,136819,63,190869
10762,0.002193,172.31.40.0-255,66,136885,63,190869
10763,0.002221,172.31.40.0-255,66,136951,63,190869
10764,0.002244,74.125.24.0-255,2902,139853,63,190869
10765,0.002246,172.31.40.0-255,66,139919,63,190869
10766,0.002252,74.125.24.0-255,5738,145657,63,190869
10767,0.002255,172.31.40.0-255,66,145723,63,190869
10768,0.002284,172.31.40.0-255,66,145789,63,190869
10769,0.002319,74.125.24.0-255,4320,150109,63,190869
10770,0.002322,172.31.40.0-255,66,150175,63,190869
10771,0.002352,172.31.40.0-255,66,150241,63,190869
10772,0.004632,74.125.24.0-255,5738,155979,63,190869
10773,0.00464,172.31.40.0-255,66,156045,63,190869
10774,0.006912,74.125.24.0-255,5738,161783,63,190869
10775,0.006918,172.31.40.0-255,66,161849,63,190869
10776,0.009223,74.125.24.0-255,5738,167587,63,190869
10777,0.00923,172.31.40.0-255,66,167653,63,190869
10778,0.011496,74.125.24.0-255,5738,173391,63,190869
10779,0.011505,172.31.40.0-255,66,173457,63,190869
10780,0.01378,74.125.24.0-255,5738,179195,63,190869
10781,0.013793,172.31.40.0-255,66,179261,63,190869
10782,0.016061,74.125.24.0-255,5738,184999,63,190869
10783,0.016074,172.31.40.0-255,66,185065,63,190869
10784,0.018363,74.125.24.0-255,5738,190803,63,190869
10785,0.018377,172.31.40.0-255,66,190869,63,190869
10786,0.0,74.125.24.0-255,299,299,63,183001
10787,2.5e-05,172.31.40.0-255,66,365,63,183001
10788,3.2e-05,74.125.24.0-255,1484,1849,63,183001
10789,3.6e-05,172.31.40.0-255,66,1915,63,183001
10790,4.3e-05,74.125.24.0-255,4320,6235,63,183001
10791,4.7e-05,172.31.40.0-255,66,6301,63,183001
10792,6e-05,172.31.40.0-255,66,6367,63,183001
10793,9.2e-05,172.31.40.0-255,66,6433,63,183001
10794,9.8e-05,74.125.24.0-255,5379,11812,63,183001
10795,0.000101,172.31.40.0-255,66,11878,63,183001
10796,0.000242,74.125.24.0-255,1484,13362,63,183001
10797,0.000247,172.31.40.0-255,66,13428,63,183001
10798,0.000252,74.125.24.0-255,2902,16330,63,183001
10799,0.000254,172.31.40.0-255,66,16396,63,183001
10800,0.000284,74.125.24.0-255,5738,22134,63,183001
10801,0.000287,172.31.40.0-255,66,22200,63,183001
10802,0.00031,74.125.24.0-255,6797,28997,63,183001
10803,0.000313,172.31.40.0-255,66,29063,63,183001
10804,0.000359,74.125.24.0-255,1484,30547,63,183001
10805,0.000362,172.31.40.0-255,66,30613,63,183001
10806,0.000367,74.125.24.0-255,2902,33515,63,183001
10807,0.000369,172.31.40.0-255,66,33581,63,183001
10808,0.000384,74.125.24.0-255,2902,36483,63,183001
10809,0.000386,172.31.40.0-255,66,36549,63,183001
10810,0.000399,74.125.24.0-255,2902,39451,63,183001
10811,0.000402,172.31.40.0-255,66,39517,63,183001
10812,0.000409,74.125.24.0-255,5738,45255,63,183001
10813,0.000411,172.31.40.0-255,66,45321,63,183001
10814,0.000446,74.125.24.0-255,1422,46743,63,183001
10815,0.000449,172.31.40.0-255,66,46809,63,183001
10816,0.000496,74.125.24.0-255,1484,48293,63,183001
10817,0.000516,74.125.24.0-255,2902,51195,63,183001
10818,0.000519,172.31.40.0-255,66,51261,63,183001
10819,0.000526,74.125.24.0-255,5738,56999,63,183001
10820,0.000528,172.31.40.0-255,66,57065,63,183001
10821,0.000559,74.125.24.0-255,5738,62803,63,183001
10822,0.000562,172.31.40.0-255,66,62869,63,183001
10823,0.000606,74.125.24.0-255,3961,66830,63,183001
10824,0.000609,172.31.40.0-255,66,66896,63,183001
10825,0.000621,172.31.40.0-255,66,66962,63,183001
10826,0.000626,74.125.24.0-255,3695,70657,63,183001
10827,0.000629,172.31.40.0-255,66,70723,63,183001
10828,0.000853,74.125.24.0-255,1484,72207,63,183001
10829,0.000859,74.125.24.0-255,2902,75109,63,183001
10830,0.000869,172.31.40.0-255,66,75175,63,183001
10831,0.000878,74.125.24.0-255,5738,80913,63,183001
10832,0.00088,172.31.40.0-255,66,80979,63,183001
10833,0.000937,172.31.40.0-255,66,81045,63,183001
10834,0.000947,74.125.24.0-255,1484,82529,63,183001
10835,0.00096,172.31.40.0-255,66,82595,63,183001
10836,0.001641,74.125.24.0-255,1484,84079,63,183001
10837,0.001649,74.125.24.0-255,2902,86981,63,183001
10838,0.001652,172.31.40.0-255,66,87047,63,183001
10839,0.001676,74.125.24.0-255,5738,92785,63,183001
10840,0.001679,172.31.40.0-255,66,92851,63,183001
10841,0.001682,74.125.24.0-255,1484,94335,63,183001
10842,0.001722,172.31.40.0-255,66,94401,63,183001
10843,0.00173,74.125.24.0-255,7156,101557,63,183001
10844,0.001731,172.31.40.0-255,66,101623,63,183001
10845,0.001749,74.125.24.0-255,2184,103807,63,183001
10846,0.001752,172.31.40.0-255,66,103873,63,183001
10847,0.001897,74.125.24.0-255,1484,105357,63,183001
10848,0.001903,74.125.24.0-255,2902,108259,63,183001
10849,0.001906,172.31.40.0-255,66,108325,63,183001
10850,0.001931,74.125.24.0-255,4320,112645,63,183001
10851,0.001934,172.31.40.0-255,66,112711,63,183001
10852,0.001952,74.125.24.0-255,1484,114195,63,183001
10853,0.001956,74.125.24.0-255,1484,115679,63,183001
10854,0.001958,172.31.40.0-255,66,115745,63,183001
10855,0.001991,172.31.40.0-255,66,115811,63,183001
10856,0.002002,172.31.40.0-255,66,115877,63,183001
10857,0.002004,74.125.24.0-255,766,116643,63,183001
10858,0.002258,74.125.24.0-255,1484,118127,63,183001
10859,0.002262,172.31.40.0-255,66,118193,63,183001
10860,0.002268,74.125.24.0-255,2902,121095,63,183001
10861,0.00227,172.31.40.0-255,66,121161,63,183001
10862,0.002276,74.125.24.0-255,4320,125481,63,183001
10863,0.002278,172.31.40.0-255,66,125547,63,183001
10864,0.002302,74.125.24.0-255,1484,127031,63,183001
10865,0.00231,74.125.24.0-255,7156,134187,63,183001
10866,0.002312,172.31.40.0-255,66,134253,63,183001
10867,0.002334,74.125.24.0-255,5738,139991,63,183001
10868,0.002336,172.31.40.0-255,66,140057,63,183001
10869,0.002367,172.31.40.0-255,66,140123,63,183001
10870,0.002372,74.125.24.0-255,2184,142307,63,183001
10871,0.002373,172.31.40.0-255,66,142373,63,183001
10872,0.004701,74.125.24.0-255,5738,148111,63,183001
10873,0.004713,172.31.40.0-255,66,148177,63,183001
10874,0.007018,74.125.24.0-255,5738,153915,63,183001
10875,0.007026,172.31.40.0-255,66,153981,63,183001
10876,0.009361,74.125.24.0-255,5738,159719,63,183001
10877,0.009368,172.31.40.0-255,66,159785,63,183001
10878,0.011684,74.125.24.0-255,5738,165523,63,183001
10879,0.011692,172.31.40.0-255,66,165589,63,183001
10880,0.014026,74.125.24.0-255,5738,171327,63,183001
10881,0.014041,172.31.40.0-255,66,171393,63,183001
10882,0.016358,74.125.24.0-255,5738,177131,63,183001
10883,0.016373,172.31.40.0-255,66,177197,63,183001
10884,0.018715,74.125.24.0-255,5738,182935,63,183001
10885,0.018726,172.31.40.0-255,66,183001,63,183001
10886,0.0,172.217.194.0-255,152,152,63,135726
10887,1.4e-05,172.31.40.0-255,66,218,63,135726
10888,2.1e-05,172.217.194.0-255,1484,1702,63,135726
10889,2.5e-05,172.31.40.0-255,66,1768,63,135726
10890,3.1e-05,172.217.194.0-255,2902,4670,63,135726
10891,4.5e-05,172.31.40.0-255,66,4736,63,135726
10892,5e-05,172.217.194.0-255,2902,7638,63,135726
10893,5.2e-05,172.31.40.0-255,66,7704,63,135726
10894,8.5e-05,172.217.194.0-255,2902,10606,63,135726
10895,8.8e-05,172.31.40.0-255,66,10672,63,135726
10896,0.000115,172.217.194.0-255,3485,14157,63,135726
10897,0.000118,172.31.40.0-255,66,14223,63,135726
10898,0.000181,172.217.194.0-255,1484,15707,63,135726
10899,0.000184,172.31.40.0-255,66,15773,63,135726
10900,0.000197,172.217.194.0-255,2902,18675,63,135726
10901,0.0002,172.31.40.0-255,66,18741,63,135726
10902,0.000202,172.217.194.0-255,1484,20225,63,135726
10903,0.000209,172.31.40.0-255,66,20291,63,135726
10904,0.000232,172.217.194.0-255,4320,24611,63,135726
10905,0.000235,172.31.40.0-255,66,24677,63,135726
10906,0.000247,172.31.40.0-255,66,24743,63,135726
10907,0.000298,172.31.40.0-255,66,24809,63,135726
10908,0.000316,172.31.40.0-255,66,24875,63,135726
10909,0.000339,172.217.194.0-255,766,25641,63,135726
10910,0.000346,172.31.40.0-255,66,25707,63,135726
10911,0.000349,172.217.194.0-255,395,26102,63,135726
10912,0.000351,172.31.40.0-255,66,26168,63,135726
10913,0.000453,172.217.194.0-255,380,26548,63,135726
10914,0.000456,172.31.40.0-255,66,26614,63,135726
10915,0.000616,172.217.194.0-255,1484,28098,63,135726
10916,0.000622,172.217.194.0-255,2902,31000,63,135726
10917,0.000627,172.31.40.0-255,66,31066,63,135726
10918,0.000631,172.217.194.0-255,1484,32550,63,135726
10919,0.00066,172.217.194.0-255,4320,36870,63,135726
10920,0.000663,172.31.40.0-255,66,36936,63,135726
10921,0.00067,172.217.194.0-255,7156,44092,63,135726
10922,0.000673,172.31.40.0-255,66,44158,63,135726
10923,0.000725,172.31.40.0-255,66,44224,63,135726
10924,0.000729,172.217.194.0-255,2184,46408,63,135726
10925,0.000731,172.31.40.0-255,66,46474,63,135726
10926,0.000972,172.217.194.0-255,1484,47958,63,135726
10927,0.000977,172.217.194.0-255,2902,50860,63,135726
10928,0.000981,172.31.40.0-255,66,50926,63,135726
10929,0.001021,172.217.194.0-255,2902,53828,63,135726
10930,0.001023,172.31.40.0-255,66,53894,63,135726
10931,0.001055,172.217.194.0-255,2902,56796,63,135726
10932,0.001058,172.31.40.0-255,66,56862,63,135726
10933,0.001064,172.217.194.0-255,5738,62600,63,135726
10934,0.001067,172.31.40.0-255,66,62666,63,135726
10935,0.001087,172.31.40.0-255,66,62732,63,135726
10936,0.001093,172.217.194.0-255,5020,67752,63,135726
10937,0.001095,172.31.40.0-255,66,67818,63,135726
10938,0.001473,172.217.194.0-255,1484,69302,63,135726
10939,0.001479,172.217.194.0-255,2902,72204,63,135726
10940,0.001483,172.31.40.0-255,66,72270,63,135726
10941,0.001487,172.217.194.0-255,1484,73754,63,135726
10942,0.001503,172.217.194.0-255,4320,78074,63,135726
10943,0.001513,172.217.194.0-255,5738,83812,63,135726
10944,0.001522,172.31.40.0-255,66,83878,63,135726
10945,0.001525,172.31.40.0-255,66,83944,63,135726
10946,0.001577,172.31.40.0-255,66,84010,63,135726
10947,0.00158,172.217.194.0-255,766,84776,63,135726
10948,0.00219,172.31.40.0-255,66,84842,63,135726
10949,0.003515,172.217.194.0-255,4320,89162,63,135726
10950,0.003522,172.31.40.0-255,66,89228,63,135726
10951,0.004106,172.217.194.0-255,1484,90712,63,135726
10952,0.005474,172.217.194.0-255,4320,95032,63,135726
10953,0.005481,172.31.40.0-255,66,95098,63,135726
10954,0.007426,172.217.194.0-255,5738,100836,63,135726
10955,0.007431,172.31.40.0-255,66,100902,63,135726
10956,0.009358,172.217.194.0-255,5738,106640,63,135726
10957,0.009365,172.31.40.0-255,66,106706,63,135726
10958,0.011301,172.217.194.0-255,5738,112444,63,135726
10959,0.011309,172.31.40.0-255,66,112510,63,135726
10960,0.013296,172.217.194.0-255,5738,118248,63,135726
10961,0.013304,172.31.40.0-255,66,118314,63,135726
10962,0.015261,172.217.194.0-255,5738,124052,63,135726
10963,0.015269,172.31.40.0-255,66,124118,63,135726
10964,0.017197,172.217.194.0-255,5738,129856,63,135726
10965,0.017205,172.31.40.0-255,66,129922,63,135726
10966,0.019161,172.217.194.0-255,5738,135660,63,135726
10967,0.019168,172.31.40.0-255,66,135726,63,135726
10968,0.0,172.217.24.0-255,153,153,63,153419
10969,1.4e-05,172.31.40.0-255,66,219,63,153419
10970,2.1e-05,172.217.24.0-255,1484,1703,63,153419
10971,2.4e-05,172.31.40.0-255,66,1769,63,153419
10972,3e-05,172.217.24.0-255,2902,4671,63,153419
10973,3.4e-05,172.31.40.0-255,66,4737,63,153419
10974,3.7e-05,172.217.24.0-255,1484,6221,63,153419
10975,3.9e-05,172.31.40.0-255,66,6287,63,153419
10976,7.1e-05,172.217.24.0-255,5738,12025,63,153419
10977,7.5e-05,172.31.40.0-255,66,12091,63,153419
10978,7.9e-05,172.217.24.0-255,2126,14217,63,153419
10979,8.1e-05,172.31.40.0-255,66,14283,63,153419
10980,8.6e-05,172.217.24.0-255,2902,17185,63,153419
10981,8.8e-05,172.31.40.0-255,66,17251,63,153419
10982,9.5e-05,172.217.24.0-255,7156,24407,63,153419
10983,9.8e-05,172.31.40.0-255,66,24473,63,153419
10984,0.000155,172.217.24.0-255,6797,31270,63,153419
10985,0.000158,172.31.40.0-255,66,31336,63,153419
10986,0.000179,172.217.24.0-255,1484,32820,63,153419
10987,0.000181,172.31.40.0-255,66,32886,63,153419
10988,0.000184,172.217.24.0-255,1484,34370,63,153419
10989,0.000186,172.31.40.0-255,66,34436,63,153419
10990,0.00021,172.217.24.0-255,1484,35920,63,153419
10991,0.000213,172.31.40.0-255,66,35986,63,153419
10992,0.000219,172.217.24.0-255,5738,41724,63,153419
10993,0.000222,172.31.40.0-255,66,41790,63,153419
10994,0.000226,172.217.24.0-255,2902,44692,63,153419
10995,0.000229,172.31.40.0-255,66,44758,63,153419
10996,0.000242,172.217.24.0-255,3961,48719,63,153419
10997,0.000244,172.31.40.0-255,66,48785,63,153419
10998,0.00034,172.217.24.0-255,1484,50269,63,153419
10999,0.000344,172.31.40.0-255,66,50335,63,153419
11000,0.00035,172.217.24.0-255,2902,53237,63,153419
11001,0.000352,172.31.40.0-255,66,53303,63,153419
11002,0.000366,172.217.24.0-255,4320,57623,63,153419
11003,0.000369,172.31.40.0-255,66,57689,63,153419
11004,0.000372,172.217.24.0-255,1484,59173,63,153419
11005,0.000389,172.217.24.0-255,4320,63493,63,153419
11006,0.000392,172.31.40.0-255,66,63559,63,153419
11007,0.000414,172.217.24.0-255,2543,66102,63,153419
11008,0.000416,172.31.40.0-255,66,66168,63,153419
11009,0.000448,172.217.24.0-255,396,66564,63,153419
11010,0.000972,172.217.24.0-255,117,66681,63,153419
11011,0.00101,172.31.40.0-255,66,66747,63,153419
11012,0.001125,172.217.24.0-255,1484,68231,63,153419
11013,0.001133,172.217.24.0-255,2902,71133,63,153419
11014,0.001137,172.31.40.0-255,66,71199,63,153419
11015,0.001142,172.217.24.0-255,2902,74101,63,153419
11016,0.001144,172.31.40.0-255,66,74167,63,153419
11017,0.001163,172.217.24.0-255,2902,77069,63,153419
11018,0.001165,172.31.40.0-255,66,77135,63,153419
11019,0.001176,172.217.24.0-255,1484,78619,63,153419
11020,0.001196,172.217.24.0-255,5379,83998,63,153419
11021,0.001199,172.31.40.0-255,66,84064,63,153419
11022,0.001226,172.217.24.0-255,5738,89802,63,153419
11023,0.001228,172.31.40.0-255,66,89868,63,153419
11024,0.00125,172.217.24.0-255,1484,91352,63,153419
11025,0.001255,172.217.24.0-255,4320,95672,63,153419
11026,0.001258,172.31.40.0-255,66,95738,63,153419
11027,0.001263,172.217.24.0-255,5379,101117,63,153419
11028,0.001266,172.31.40.0-255,66,101183,63,153419
11029,0.0032,172.217.24.0-255,5738,106921,63,153419
11030,0.003205,172.31.40.0-255,66,106987,63,153419
11031,0.005138,172.217.24.0-255,5738,112725,63,153419
11032,0.005143,172.31.40.0-255,66,112791,63,153419
11033,0.007089,172.217.24.0-255,5738,118529,63,153419
11034,0.007094,172.31.40.0-255,66,118595,63,153419
11035,0.009078,172.217.24.0-255,5738,124333,63,153419
11036,0.009085,172.31.40.0-255,66,124399,63,153419
11037,0.011039,172.217.24.0-255,5738,130137,63,153419
11038,0.011046,172.31.40.0-255,66,130203,63,153419
11039,0.013001,172.217.24.0-255,5738,135941,63,153419
11040,0.013008,172.31.40.0-255,66,136007,63,153419
11041,0.014955,172.217.24.0-255,5738,141745,63,153419
11042,0.014963,172.31.40.0-255,66,141811,63,153419
11043,0.016911,172.217.24.0-255,5738,147549,63,153419
11044,0.016921,172.31.40.0-255,66,147615,63,153419
11045,0.018868,172.217.24.0-255,5738,153353,63,153419
11046,0.018875,172.31.40.0-255,66,153419,63,153419
11047,0.0,172.217.160.0-255,146,146,63,206341
11048,2.3e-05,172.31.40.0-255,66,212,63,206341
11049,3e-05,172.217.160.0-255,1484,1696,63,206341
11050,3.5e-05,172.31.40.0-255,66,1762,63,206341
11051,4.1e-05,172.217.160.0-255,2902,4664,63,206341
11052,4.5e-05,172.31.40.0-255,66,4730,63,206341
11053,5.3e-05,172.217.160.0-255,7156,11886,63,206341
11054,5.6e-05,172.31.40.0-255,66,11952,63,206341
11055,6e-05,172.217.160.0-255,1985,13937,63,206341
11056,6.4e-05,172.31.40.0-255,66,14003,63,206341
11057,6.9e-05,172.217.160.0-255,2902,16905,63,206341
11058,7.2e-05,172.31.40.0-255,66,16971,63,206341
11059,7.7e-05,172.217.160.0-255,4320,21291,63,206341
11060,7.9e-05,172.31.40.0-255,66,21357,63,206341
11061,0.000116,172.31.40.0-255,66,21423,63,206341
11062,0.00012,172.217.160.0-255,1125,22548,63,206341
11063,0.000122,172.31.40.0-255,66,22614,63,206341
11064,0.000179,172.217.160.0-255,1484,24098,63,206341
11065,0.000181,172.31.40.0-255,66,24164,63,206341
11066,0.000186,172.217.160.0-255,2902,27066,63,206341
11067,0.000188,172.31.40.0-255,66,27132,63,206341
11068,0.000192,172.217.160.0-255,1484,28616,63,206341
11069,0.000194,172.31.40.0-255,66,28682,63,206341
11070,0.000213,172.217.160.0-255,4320,33002,63,206341
11071,0.000216,172.31.40.0-255,66,33068,63,206341
11072,0.000236,172.217.160.0-255,5738,38806,63,206341
11073,0.000239,172.31.40.0-255,66,38872,63,206341
11074,0.000264,172.217.160.0-255,1125,39997,63,206341
11075,0.000266,172.31.40.0-255,66,40063,63,206341
11076,0.000273,172.217.160.0-255,5738,45801,63,206341
11077,0.000276,172.31.40.0-255,66,45867,63,206341
11078,0.000299,172.217.160.0-255,1484,47351,63,206341
11079,0.000301,172.31.40.0-255,66,47417,63,206341
11080,0.000306,172.217.160.0-255,4320,51737,63,206341
11081,0.000308,172.31.40.0-255,66,51803,63,206341
11082,0.000338,172.217.160.0-255,5379,57182,63,206341
11083,0.000341,172.31.40.0-255,66,57248,63,206341
11084,0.000371,172.217.160.0-255,373,57621,63,206341
11085,0.000374,172.31.40.0-255,66,57687,63,206341
11086,0.000871,172.217.160.0-255,369,58056,63,206341
11087,0.000971,172.217.160.0-255,1484,59540,63,206341
11088,0.000976,172.31.40.0-255,66,59606,63,206341
11089,0.000982,172.217.160.0-255,2902,62508,63,206341
11090,0.000987,172.217.160.0-255,4320,66828,63,206341
11091,0.000999,172.217.160.0-255,1484,68312,63,206341
11092,0.001003,172.31.40.0-255,66,68378,63,206341
11093,0.001029,172.217.160.0-255,4320,72698,63,206341
11094,0.001046,172.31.40.0-255,66,72764,63,206341
11095,0.001078,172.217.160.0-255,1125,73889,63,206341
11096,0.001086,172.31.40.0-255,66,73955,63,206341
11097,0.00128,172.217.160.0-255,1484,75439,63,206341
11098,0.001285,172.217.160.0-255,2902,78341,63,206341
11099,0.001308,172.217.160.0-255,1484,79825,63,206341
11100,0.001313,172.31.40.0-255,66,79891,63,206341
11101,0.001316,172.31.40.0-255,66,79957,63,206341
11102,0.001332,172.217.160.0-255,4320,84277,63,206341
11103,0.001349,172.217.160.0-255,7156,91433,63,206341
11104,0.001367,172.217.160.0-255,3602,95035,63,206341
11105,0.001383,172.217.160.0-255,5738,100773,63,206341
11106,0.001386,172.31.40.0-255,66,100839,63,206341
11107,0.001392,172.31.40.0-255,66,100905,63,206341
11108,0.001411,172.217.160.0-255,5738,106643,63,206341
11109,0.001414,172.217.160.0-255,1484,108127,63,206341
11110,0.001421,172.31.40.0-255,66,108193,63,206341
11111,0.00144,172.217.160.0-255,7156,115349,63,206341
11112,0.001458,172.217.160.0-255,5738,121087,63,206341
11113,0.00149,172.31.40.0-255,66,121153,63,206341
11114,0.001727,172.217.160.0-255,1484,122637,63,206341
11115,0.001733,172.217.160.0-255,2902,125539,63,206341
11116,0.001735,172.217.160.0-255,1484,127023,63,206341
11117,0.001741,172.31.40.0-255,66,127089,63,206341
11118,0.001753,172.217.160.0-255,4320,131409,63,206341
11119,0.001758,172.217.160.0-255,4320,135729,63,206341
11120,0.001773,172.31.40.0-255,66,135795,63,206341
11121,0.001813,172.217.160.0-255,5738,141533,63,206341
11122,0.001822,172.31.40.0-255,66,141599,63,206341
11123,0.001833,172.217.160.0-255,2184,143783,63,206341
11124,0.001847,172.217.160.0-255,4320,148103,63,206341
11125,0.00185,172.217.160.0-255,1484,149587,63,206341
11126,0.001867,172.31.40.0-255,66,149653,63,206341
11127,0.001872,172.217.160.0-255,4320,153973,63,206341
11128,0.001876,172.217.160.0-255,2902,156875,63,206341
11129,0.001889,172.217.160.0-255,2902,159777,63,206341
11130,0.001893,172.31.40.0-255,66,159843,63,206341
11131,0.001906,172.217.160.0-255,5738,165581,63,206341
11132,0.001921,172.31.40.0-255,66,165647,63,206341
11133,0.001961,172.31.40.0-255,66,165713,63,206341
11134,0.003892,172.217.160.0-255,5738,171451,63,206341
11135,0.003898,172.31.40.0-255,66,171517,63,206341
11136,0.005838,172.217.160.0-255,5738,177255,63,206341
11137,0.005842,172.31.40.0-255,66,177321,63,206341
11138,0.007777,172.217.160.0-255,5738,183059,63,206341
11139,0.008152,172.31.40.0-255,66,183125,63,206341
11140,0.01008,172.217.160.0-255,5738,188863,63,206341
11141,0.010086,172.31.40.0-255,66,188929,63,206341
11142,0.012019,172.217.160.0-255,5738,194667,63,206341
11143,0.015249,172.31.40.0-255,66,194733,63,206341
11144,0.017185,172.217.160.0-255,5738,200471,63,206341
11145,0.017195,172.31.40.0-255,66,200537,63,206341
11146,0.019119,172.217.160.0-255,5738,206275,63,206341
11147,0.019126,172.31.40.0-255,66,206341,63,206341
11148,0.0,74.125.130.0-255,153,153,63,247754
11149,2e-05,172.31.40.0-255,66,219,63,247754
11150,2.7e-05,74.125.130.0-255,1484,1703,63,247754
11151,3.1e-05,172.31.40.0-255,66,1769,63,247754
11152,3.5e-05,74.125.130.0-255,2902,4671,63,247754
11153,3.8e-05,172.31.40.0-255,66,4737,63,247754
11154,4.2e-05,74.125.130.0-255,4320,9057,63,247754
11155,4.5e-05,172.31.40.0-255,66,9123,63,247754
11156,8e-05,74.125.130.0-255,2902,12025,63,247754
11157,8.2e-05,172.31.40.0-255,66,12091,63,247754
11158,0.000102,74.125.130.0-255,3486,15577,63,247754
11159,0.000105,172.31.40.0-255,66,15643,63,247754
11160,0.000111,74.125.130.0-255,7156,22799,63,247754
11161,0.000112,172.31.40.0-255,66,22865,63,247754
11162,0.000146,172.31.40.0-255,66,22931,63,247754
11163,0.000298,74.125.130.0-255,1484,24415,63,247754
11164,0.000302,172.31.40.0-255,66,24481,63,247754
11165,0.000306,74.125.130.0-255,1484,25965,63,247754
11166,0.000308,172.31.40.0-255,66,26031,63,247754
11167,0.000322,74.125.130.0-255,1484,27515,63,247754
11168,0.000324,172.31.40.0-255,66,27581,63,247754
11169,0.00033,74.125.130.0-255,2902,30483,63,247754
11170,0.000332,172.31.40.0-255,66,30549,63,247754
11171,0.000351,74.125.130.0-255,1484,32033,63,247754
11172,0.000353,172.31.40.0-255,66,32099,63,247754
11173,0.000359,74.125.130.0-255,5738,37837,63,247754
11174,0.000361,172.31.40.0-255,66,37903,63,247754
11175,0.000377,74.125.130.0-255,1484,39387,63,247754
11176,0.000379,172.31.40.0-255,66,39453,63,247754
11177,0.000402,74.125.130.0-255,6797,46250,63,247754
11178,0.000404,172.31.40.0-255,66,46316,63,247754
11179,0.000407,74.125.130.0-255,1484,47800,63,247754
11180,0.000431,74.125.130.0-255,7156,54956,63,247754
11181,0.000433,172.31.40.0-255,66,55022,63,247754
11182,0.000437,74.125.130.0-255,2796,57818,63,247754
11183,0.000439,172.31.40.0-255,66,57884,63,247754
11184,0.000452,74.125.130.0-255,120,58004,63,247754
11185,0.000529,74.125.130.0-255,1484,59488,63,247754
11186,0.000533,172.31.40.0-255,66,59554,63,247754
11187,0.000537,74.125.130.0-255,1484,61038,63,247754
11188,0.000551,74.125.130.0-255,1484,62522,63,247754
11189,0.000554,172.31.40.0-255,66,62588,63,247754
11190,0.000557,74.125.130.0-255,1484,64072,63,247754
11191,0.000577,74.125.130.0-255,4320,68392,63,247754
11192,0.000579,172.31.40.0-255,66,68458,63,247754
11193,0.000583,74.125.130.0-255,1484,69942,63,247754
11194,0.000599,74.125.130.0-255,5112,75054,63,247754
11195,0.000601,172.31.40.0-255,66,75120,63,247754
11196,0.000758,74.125.130.0-255,1484,76604,63,247754
11197,0.000765,74.125.130.0-255,2902,79506,63,247754
11198,0.000767,172.31.40.0-255,66,79572,63,247754
11199,0.000788,74.125.130.0-255,4320,83892,63,247754
11200,0.00079,172.31.40.0-255,66,83958,63,247754
11201,0.000818,74.125.130.0-255,1484,85442,63,247754
11202,0.000825,74.125.130.0-255,7156,92598,63,247754
11203,0.000827,172.31.40.0-255,66,92664,63,247754
11204,0.000845,74.125.130.0-255,5738,98402,63,247754
11205,0.000847,172.31.40.0-255,66,98468,63,247754
11206,0.000861,74.125.130.0-255,4320,102788,63,247754
11207,0.000864,172.31.40.0-255,66,102854,63,247754
11208,0.0009,74.125.130.0-255,6438,109292,63,247754
11209,0.000904,172.31.40.0-255,66,109358,63,247754
11210,0.001123,74.125.130.0-255,1484,110842,63,247754
11211,0.001129,74.125.130.0-255,2902,113744,63,247754
11212,0.001132,172.31.40.0-255,66,113810,63,247754
11213,0.001178,74.125.130.0-255,4320,118130,63,247754
11214,0.001181,172.31.40.0-255,66,118196,63,247754
11215,0.001188,74.125.130.0-255,7156,125352,63,247754
11216,0.00119,172.31.40.0-255,66,125418,63,247754
11217,0.001219,74.125.130.0-255,1484,126902,63,247754
11218,0.001226,74.125.130.0-255,7156,134058,63,247754
11219,0.001228,172.31.40.0-255,66,134124,63,247754
11220,0.001235,74.125.130.0-255,5738,139862,63,247754
11221,0.001236,172.31.40.0-255,66,139928,63,247754
11222,0.001253,74.125.130.0-255,2902,142830,63,247754
11223,0.001256,172.31.40.0-255,66,142896,63,247754
11224,0.001259,74.125.130.0-255,766,143662,63,247754
11225,0.001824,74.125.130.0-255,1484,145146,63,247754
11226,0.001832,172.31.40.0-255,66,145212,63,247754
11227,0.001848,74.125.130.0-255,2902,148114,63,247754
11228,0.00185,172.31.40.0-255,66,148180,63,247754
11229,0.001876,74.125.130.0-255,5738,153918,63,247754
11230,0.001878,172.31.40.0-255,66,153984,63,247754
11231,0.001882,74.125.130.0-255,1484,155468,63,247754
11232,0.001902,74.125.130.0-255,2902,158370,63,247754
11233,0.001904,172.31.40.0-255,66,158436,63,247754
11234,0.001907,74.125.130.0-255,1484,159920,63,247754
11235,0.001928,74.125.130.0-255,4320,164240,63,247754
11236,0.00193,172.31.40.0-255,66,164306,63,247754
11237,0.001935,74.125.130.0-255,2902,167208,63,247754
11238,0.001937,172.31.40.0-255,66,167274,63,247754
11239,0.001953,74.125.130.0-255,4320,171594,63,247754
11240,0.001956,172.31.40.0-255,66,171660,63,247754
11241,0.001991,74.125.130.0-255,2902,174562,63,247754
11242,0.001993,172.31.40.0-255,66,174628,63,247754
11243,0.002016,74.125.130.0-255,3602,178230,63,247754
11244,0.002018,172.31.40.0-255,66,178296,63,247754
11245,0.002192,74.125.130.0-255,1484,179780,63,247754
11246,0.002197,74.125.130.0-255,1484,181264,63,247754
11247,0.0022,172.31.40.0-255,66,181330,63,247754
11248,0.002218,74.125.130.0-255,1484,182814,63,247754
11249,0.002225,74.125.130.0-255,5738,188552,63,247754
11250,0.002228,172.31.40.0-255,66,188618,63,247754
11251,0.002249,74.125.130.0-255,5738,194356,63,247754
11252,0.002252,172.31.40.0-255,66,194422,63,247754
11253,0.002255,74.125.130.0-255,1484,195906,63,247754
11254,0.00228,74.125.130.0-255,5738,201644,63,247754
11255,0.002282,172.31.40.0-255,66,201710,63,247754
11256,0.002288,74.125.130.0-255,4320,206030,63,247754
11257,0.00229,172.31.40.0-255,66,206096,63,247754
11258,0.002302,74.125.130.0-255,1484,207580,63,247754
11259,0.002343,74.125.130.0-255,2902,210482,63,247754
11260,0.002346,172.31.40.0-255,66,210548,63,247754
11261,0.002365,74.125.130.0-255,2184,212732,63,247754
11262,0.002367,172.31.40.0-255,66,212798,63,247754
11263,0.004857,74.125.130.0-255,2902,215700,63,247754
11264,0.004863,172.31.40.0-255,66,215766,63,247754
11265,0.004886,74.125.130.0-255,2902,218668,63,247754
11266,0.004888,172.31.40.0-255,66,218734,63,247754
11267,0.007386,74.125.130.0-255,5738,224472,63,247754
11268,0.007391,172.31.40.0-255,66,224538,63,247754
11269,0.009914,74.125.130.0-255,5738,230276,63,247754
11270,0.00992,172.31.40.0-255,66,230342,63,247754
11271,0.012433,74.125.130.0-255,5738,236080,63,247754
11272,0.01244,172.31.40.0-255,66,236146,63,247754
11273,0.014993,74.125.130.0-255,5738,241884,63,247754
11274,0.015004,172.31.40.0-255,66,241950,63,247754
11275,0.017535,74.125.130.0-255,5738,247688,63,247754
11276,0.017545,172.31.40.0-255,66,247754,63,247754
11277,0.0,74.125.130.0-255,154,154,63,290465
11278,2e-05,172.31.40.0-255,66,220,63,290465
11279,2.7e-05,74.125.130.0-255,1484,1704,63,290465
11280,3.1e-05,172.31.40.0-255,66,1770,63,290465
11281,3.5e-05,74.125.130.0-255,2902,4672,63,290465
11282,3.8e-05,172.31.40.0-255,66,4738,63,290465
11283,4.7e-05,74.125.130.0-255,1484,6222,63,290465
11284,4.9e-05,172.31.40.0-255,66,6288,63,290465
11285,5.4e-05,74.125.130.0-255,2902,9190,63,290465
11286,5.6e-05,172.31.40.0-255,66,9256,63,290465
11287,8.9e-05,74.125.130.0-255,4320,13576,63,290465
11288,9.2e-05,172.31.40.0-255,66,13642,63,290465
11289,0.000111,74.125.130.0-255,2031,15673,63,290465
11290,0.000113,172.31.40.0-255,66,15739,63,290465
11291,0.00012,74.125.130.0-255,7156,22895,63,290465
11292,0.000122,172.31.40.0-255,66,22961,63,290465
11293,0.000161,172.31.40.0-255,66,23027,63,290465
11294,0.000296,74.125.130.0-255,1484,24511,63,290465
11295,0.0003,172.31.40.0-255,66,24577,63,290465
11296,0.000324,74.125.130.0-255,2902,27479,63,290465
11297,0.000326,172.31.40.0-255,66,27545,63,290465
11298,0.000332,74.125.130.0-255,5738,33283,63,290465
11299,0.000334,172.31.40.0-255,66,33349,63,290465
11300,0.000359,74.125.130.0-255,6797,40146,63,290465
11301,0.000361,172.31.40.0-255,66,40212,63,290465
11302,0.000382,74.125.130.0-255,7156,47368,63,290465
11303,0.000384,172.31.40.0-255,66,47434,63,290465
11304,0.000421,172.31.40.0-255,66,47500,63,290465
11305,0.000443,74.125.130.0-255,1416,48916,63,290465
11306,0.000445,172.31.40.0-255,66,48982,63,290465
11307,0.000467,74.125.130.0-255,365,49347,63,290465
11308,0.000587,74.125.130.0-255,1484,50831,63,290465
11309,0.00059,172.31.40.0-255,66,50897,63,290465
11310,0.000607,74.125.130.0-255,2902,53799,63,290465
11311,0.000609,172.31.40.0-255,66,53865,63,290465
11312,0.000637,74.125.130.0-255,5738,59603,63,290465
11313,0.00064,172.31.40.0-255,66,59669,63,290465
11314,0.000644,74.125.130.0-255,2902,62571,63,290465
11315,0.000646,172.31.40.0-255,66,62637,63,290465
11316,0.000664,74.125.130.0-255,2902,65539,63,290465
11317,0.000666,172.31.40.0-255,66,65605,63,290465
11318,0.000683,74.125.130.0-255,1484,67089,63,290465
11319,0.000707,74.125.130.0-255,7156,74245,63,290465
11320,0.00071,172.31.40.0-255,66,74311,63,290465
11321,0.000735,74.125.130.0-255,4320,78631,63,290465
11322,0.000737,172.31.40.0-255,66,78697,63,290465
11323,0.000756,74.125.130.0-255,4320,83017,63,290465
11324,0.000759,172.31.40.0-255,66,83083,63,290465
11325,0.000761,74.125.130.0-255,766,83849,63,290465
11326,0.000944,74.125.130.0-255,1484,85333,63,290465
11327,0.000948,172.31.40.0-255,66,85399,63,290465
11328,0.000954,74.125.130.0-255,2902,88301,63,290465
11329,0.000956,172.31.40.0-255,66,88367,63,290465
11330,0.000976,74.125.130.0-255,2902,91269,63,290465
11331,0.000981,172.31.40.0-255,66,91335,63,290465
11332,0.001003,74.125.130.0-255,2902,94237,63,290465
11333,0.001005,172.31.40.0-255,66,94303,63,290465
11334,0.00101,74.125.130.0-255,4320,98623,63,290465
11335,0.001012,172.31.40.0-255,66,98689,63,290465
11336,0.001039,74.125.130.0-255,2902,101591,63,290465
11337,0.001041,172.31.40.0-255,66,101657,63,290465
11338,0.001064,74.125.130.0-255,2902,104559,63,290465
11339,0.001066,172.31.40.0-255,66,104625,63,290465
11340,0.001074,74.125.130.0-255,7156,111781,63,290465
11341,0.001075,172.31.40.0-255,66,111847,63,290465
11342,0.001139,74.125.130.0-255,6438,118285,63,290465
11343,0.001142,172.31.40.0-255,66,118351,63,290465
11344,0.001277,74.125.130.0-255,1484,119835,63,290465
11345,0.001284,74.125.130.0-255,2902,122737,63,290465
11346,0.001286,172.31.40.0-255,66,122803,63,290465
11347,0.00129,74.125.130.0-255,1484,124287,63,290465
11348,0.001311,74.125.130.0-255,2902,127189,63,290465
11349,0.001313,172.31.40.0-255,66,127255,63,290465
11350,0.001318,74.125.130.0-255,4320,131575,63,290465
11351,0.00132,172.31.40.0-255,66,131641,63,290465
11352,0.001349,74.125.130.0-255,1484,133125,63,290465
11353,0.001355,74.125.130.0-255,4320,137445,63,290465
11354,0.001357,172.31.40.0-255,66,137511,63,290465
11355,0.001375,74.125.130.0-255,5738,143249,63,290465
11356,0.001378,172.31.40.0-255,66,143315,63,290465
11357,0.001425,172.31.40.0-255,66,143381,63,290465
11358,0.001666,74.125.130.0-255,1484,144865,63,290465
11359,0.001673,74.125.130.0-255,2902,147767,63,290465
11360,0.001676,172.31.40.0-255,66,147833,63,290465
11361,0.001703,74.125.130.0-255,5738,153571,63,290465
11362,0.001706,172.31.40.0-255,66,153637,63,290465
11363,0.001709,74.125.130.0-255,2902,156539,63,290465
11364,0.001711,172.31.40.0-255,66,156605,63,290465
11365,0.001715,74.125.130.0-255,2902,159507,63,290465
11366,0.001717,172.31.40.0-255,66,159573,63,290465
11367,0.001738,74.125.130.0-255,1484,161057,63,290465
11368,0.001752,172.31.40.0-255,66,161123,63,290465
11369,0.001758,74.125.130.0-255,5738,166861,63,290465
11370,0.00176,172.31.40.0-255,66,166927,63,290465
11371,0.001792,74.125.130.0-255,6438,173365,63,290465
11372,0.001795,172.31.40.0-255,66,173431,63,290465
11373,0.001821,74.125.130.0-255,7156,180587,63,290465
11374,0.001823,172.31.40.0-255,66,180653,63,290465
11375,0.00183,74.125.130.0-255,7156,187809,63,290465
11376,0.001832,172.31.40.0-255,66,187875,63,290465
11377,0.001854,74.125.130.0-255,1484,189359,63,290465
11378,0.001859,74.125.130.0-255,4320,193679,63,290465
11379,0.00186,172.31.40.0-255,66,193745,63,290465
11380,0.001871,74.125.130.0-255,2902,196647,63,290465
11381,0.001877,172.31.40.0-255,66,196713,63,290465
11382,0.001905,74.125.130.0-255,1484,198197,63,290465
11383,0.001923,74.125.130.0-255,5020,203217,63,290465
11384,0.001926,172.31.40.0-255,66,203283,63,290465
11385,0.001932,74.125.130.0-255,7156,210439,63,290465
11386,0.001934,172.31.40.0-255,66,210505,63,290465
11387,0.001974,172.31.40.0-255,66,210571,63,290465
11388,0.00201,172.31.40.0-255,66,210637,63,290465
11389,0.002014,74.125.130.0-255,2184,212821,63,290465
11390,0.002016,172.31.40.0-255,66,212887,63,290465
11391,0.002019,74.125.130.0-255,2902,215789,63,290465
11392,0.002021,172.31.40.0-255,66,215855,63,290465
11393,0.002052,74.125.130.0-255,7156,223011,63,290465
11394,0.002055,172.31.40.0-255,66,223077,63,290465
11395,0.002059,74.125.130.0-255,4320,227397,63,290465
11396,0.002061,172.31.40.0-255,66,227463,63,290465
11397,0.002093,74.125.130.0-255,5738,233201,63,290465
11398,0.002096,172.31.40.0-255,66,233267,63,290465
11399,0.002107,172.31.40.0-255,66,233333,63,290465
11400,0.002133,74.125.130.0-255,2902,236235,63,290465
11401,0.002135,172.31.40.0-255,66,236301,63,290465
11402,0.00214,74.125.130.0-255,2184,238485,63,290465
11403,0.002142,172.31.40.0-255,66,238551,63,290465
11404,0.002218,172.31.40.0-255,66,238617,63,290465
11405,0.002252,74.125.130.0-255,5738,244355,63,290465
11406,0.002255,172.31.40.0-255,66,244421,63,290465
11407,0.002276,172.31.40.0-255,66,244487,63,290465
11408,0.002283,74.125.130.0-255,6438,250925,63,290465
11409,0.002286,172.31.40.0-255,66,250991,63,290465
11410,0.002289,74.125.130.0-255,1484,252475,63,290465
11411,0.004528,74.125.130.0-255,1484,253959,63,290465
11412,0.004532,172.31.40.0-255,66,254025,63,290465
11413,0.004549,74.125.130.0-255,2902,256927,63,290465
11414,0.004552,172.31.40.0-255,66,256993,63,290465
11415,0.006795,74.125.130.0-255,4320,261313,63,290465
11416,0.00681,172.31.40.0-255,66,261379,63,290465
11417,0.006838,74.125.130.0-255,1484,262863,63,290465
11418,0.009078,74.125.130.0-255,4320,267183,63,290465
11419,0.009091,172.31.40.0-255,66,267249,63,290465
11420,0.011357,74.125.130.0-255,5738,272987,63,290465
11421,0.011362,172.31.40.0-255,66,273053,63,290465
11422,0.013929,74.125.130.0-255,5738,278791,63,290465
11423,0.013948,172.31.40.0-255,66,278857,63,290465
11424,0.016214,74.125.130.0-255,5738,284595,63,290465
11425,0.016221,172.31.40.0-255,66,284661,63,290465
11426,0.018479,74.125.130.0-255,5738,290399,63,290465
11427,0.018485,172.31.40.0-255,66,290465,63,290465
11428,0.0,74.125.130.0-255,150,150,63,188935
11429,2.3e-05,172.31.40.0-255,66,216,63,188935
11430,3e-05,74.125.130.0-255,1484,1700,63,188935
11431,3.5e-05,172.31.40.0-255,66,1766,63,188935
11432,4e-05,74.125.130.0-255,2902,4668,63,188935
11433,5.4e-05,172.31.40.0-255,66,4734,63,188935
11434,5.8e-05,74.125.130.0-255,1484,6218,63,188935
11435,6e-05,172.31.40.0-255,66,6284,63,188935
11436,6.6e-05,74.125.130.0-255,2902,9186,63,188935
11437,7e-05,172.31.40.0-255,66,9252,63,188935
11438,9.9e-05,74.125.130.0-255,6256,15508,63,188935
11439,0.000102,172.31.40.0-255,66,15574,63,188935
11440,0.000107,74.125.130.0-255,4320,19894,63,188935
11441,0.00011,172.31.40.0-255,66,19960,63,188935
11442,0.000138,74.125.130.0-255,5738,25698,63,188935
11443,0.000141,172.31.40.0-255,66,25764,63,188935
11444,0.000147,74.125.130.0-255,5379,31143,63,188935
11445,0.00015,172.31.40.0-255,66,31209,63,188935
11446,0.000601,74.125.130.0-255,1484,32693,63,188935
11447,0.000607,172.31.40.0-255,66,32759,63,188935
11448,0.000641,74.125.130.0-255,2902,35661,63,188935
11449,0.000645,172.31.40.0-255,66,35727,63,188935
11450,0.000649,74.125.130.0-255,2902,38629,63,188935
11451,0.000651,172.31.40.0-255,66,38695,63,188935
11452,0.000656,74.125.130.0-255,4320,43015,63,188935
11453,0.000663,172.31.40.0-255,66,43081,63,188935
11454,0.00067,74.125.130.0-255,5738,48819,63,188935
11455,0.000671,172.31.40.0-255,66,48885,63,188935
11456,0.000702,74.125.130.0-255,2902,51787,63,188935
11457,0.000705,172.31.40.0-255,66,51853,63,188935
11458,0.000734,172.31.40.0-255,66,51919,63,188935
11459,0.000741,74.125.130.0-255,1484,53403,63,188935
11460,0.000751,74.125.130.0-255,2184,55587,63,188935
11461,0.000754,172.31.40.0-255,66,55653,63,188935
11462,0.001174,74.125.130.0-255,378,56031,63,188935
11463,0.001211,74.125.130.0-255,1484,57515,63,188935
11464,0.001215,172.31.40.0-255,66,57581,63,188935
11465,0.001224,74.125.130.0-255,4320,61901,63,188935
11466,0.001226,172.31.40.0-255,66,61967,63,188935
11467,0.001235,74.125.130.0-255,1484,63451,63,188935
11468,0.001264,172.31.40.0-255,66,63517,63,188935
11469,0.001272,74.125.130.0-255,7156,70673,63,188935
11470,0.001274,172.31.40.0-255,66,70739,63,188935
11471,0.001291,172.31.40.0-255,66,70805,63,188935
11472,0.001339,74.125.130.0-255,2184,72989,63,188935
11473,0.001341,172.31.40.0-255,66,73055,63,188935
11474,0.001569,74.125.130.0-255,1484,74539,63,188935
11475,0.001577,74.125.130.0-255,2902,77441,63,188935
11476,0.00158,172.31.40.0-255,66,77507,63,188935
11477,0.001587,74.125.130.0-255,4320,81827,63,188935
11478,0.001589,172.31.40.0-255,66,81893,63,188935
11479,0.001607,74.125.130.0-255,1484,83377,63,188935
11480,0.00162,74.125.130.0-255,7156,90533,63,188935
11481,0.001623,172.31.40.0-255,66,90599,63,188935
11482,0.001643,74.125.130.0-255,5738,96337,63,188935
11483,0.001645,172.31.40.0-255,66,96403,63,188935
11484,0.001669,74.125.130.0-255,1484,97887,63,188935
11485,0.001694,172.31.40.0-255,66,97953,63,188935
11486,0.002256,74.125.130.0-255,1484,99437,63,188935
11487,0.002263,74.125.130.0-255,2902,102339,63,188935
11488,0.002268,172.31.40.0-255,66,102405,63,188935
11489,0.002301,74.125.130.0-255,4320,106725,63,188935
11490,0.002303,172.31.40.0-255,66,106791,63,188935
11491,0.002312,172.31.40.0-255,66,106857,63,188935
11492,0.002348,172.31.40.0-255,66,106923,63,188935
11493,0.002373,74.125.130.0-255,766,107689,63,188935
11494,0.002385,172.31.40.0-255,66,107755,63,188935
11495,0.002406,74.125.130.0-255,5738,113493,63,188935
11496,0.002408,172.31.40.0-255,66,113559,63,188935
11497,0.002423,172.31.40.0-255,66,113625,63,188935
11498,0.002425,74.125.130.0-255,766,114391,63,188935
11499,0.002428,74.125.130.0-255,1484,115875,63,188935
11500,0.00243,172.31.40.0-255,66,115941,63,188935
11501,0.002432,74.125.130.0-255,1484,117425,63,188935
11502,0.002466,74.125.130.0-255,2902,120327,63,188935
11503,0.002468,172.31.40.0-255,66,120393,63,188935
11504,0.002477,172.31.40.0-255,66,120459,63,188935
11505,0.002487,74.125.130.0-255,5738,126197,63,188935
11506,0.002489,172.31.40.0-255,66,126263,63,188935
11507,0.002494,74.125.130.0-255,4320,130583,63,188935
11508,0.002496,172.31.40.0-255,66,130649,63,188935
11509,0.002525,74.125.130.0-255,2902,133551,63,188935
11510,0.002526,172.31.40.0-255,66,133617,63,188935
11511,0.002532,74.125.130.0-255,4320,137937,63,188935
11512,0.002533,172.31.40.0-255,66,138003,63,188935
11513,0.002568,74.125.130.0-255,6438,144441,63,188935
11514,0.00257,172.31.40.0-255,66,144507,63,188935
11515,0.002591,172.31.40.0-255,66,144573,63,188935
11516,0.002604,172.31.40.0-255,66,144639,63,188935
11517,0.002633,74.125.130.0-255,2184,146823,63,188935
11518,0.002634,172.31.40.0-255,66,146889,63,188935
11519,0.002641,74.125.130.0-255,7156,154045,63,188935
11520,0.002643,172.31.40.0-255,66,154111,63,188935
11521,0.005243,74.125.130.0-255,5738,159849,63,188935
11522,0.005248,172.31.40.0-255,66,159915,63,188935
11523,0.007822,74.125.130.0-255,5738,165653,63,188935
11524,0.007829,172.31.40.0-255,66,165719,63,188935
11525,0.010396,74.125.130.0-255,5738,171457,63,188935
11526,0.010403,172.31.40.0-255,66,171523,63,188935
11527,0.012979,74.125.130.0-255,5738,177261,63,188935
11528,0.012988,172.31.40.0-255,66,177327,63,188935
11529,0.015563,74.125.130.0-255,5738,183065,63,188935
11530,0.015571,172.31.40.0-255,66,183131,63,188935
11531,0.018153,74.125.130.0-255,5738,188869,63,188935
11532,0.018161,172.31.40.0-255,66,188935,63,188935
11533,0.0,172.217.194.0-255,153,153,63,207409
11534,9e-06,172.31.40.0-255,66,219,63,207409
11535,3.6e-05,172.217.194.0-255,1484,1703,63,207409
11536,4.1e-05,172.31.40.0-255,66,1769,63,207409
11537,4.6e-05,172.217.194.0-255,2902,4671,63,207409
11538,4.9e-05,172.31.40.0-255,66,4737,63,207409
11539,8.7e-05,172.217.194.0-255,7156,11893,63,207409
11540,9e-05,172.31.40.0-255,66,11959,63,207409
11541,9.5e-05,172.217.194.0-255,3450,15409,63,207409
11542,9.6e-05,172.31.40.0-255,66,15475,63,207409
11543,9.9e-05,172.217.194.0-255,1484,16959,63,207409
11544,0.000101,172.31.40.0-255,66,17025,63,207409
11545,0.000131,172.31.40.0-255,66,17091,63,207409
11546,0.000154,172.217.194.0-255,1484,18575,63,207409
11547,0.000156,172.31.40.0-255,66,18641,63,207409
11548,0.00016,172.217.194.0-255,2543,21184,63,207409
11549,0.000162,172.31.40.0-255,66,21250,63,207409
11550,0.000215,172.217.194.0-255,1484,22734,63,207409
11551,0.000218,172.31.40.0-255,66,22800,63,207409
11552,0.000222,172.217.194.0-255,2902,25702,63,207409
11553,0.000224,172.31.40.0-255,66,25768,63,207409
11554,0.000228,172.217.194.0-255,2902,28670,63,207409
11555,0.00023,172.31.40.0-255,66,28736,63,207409
11556,0.000256,172.217.194.0-255,2902,31638,63,207409
11557,0.000258,172.31.40.0-255,66,31704,63,207409
11558,0.000268,172.31.40.0-255,66,31770,63,207409
11559,0.000291,172.217.194.0-255,5379,37149,63,207409
11560,0.000293,172.31.40.0-255,66,37215,63,207409
11561,0.000303,172.31.40.0-255,66,37281,63,207409
11562,0.000305,172.217.194.0-255,367,37648,63,207409
11563,0.000403,172.217.194.0-255,1484,39132,63,207409
11564,0.000406,172.31.40.0-255,66,39198,63,207409
11565,0.000421,172.217.194.0-255,2902,42100,63,207409
11566,0.000426,172.31.40.0-255,66,42166,63,207409
11567,0.000429,172.217.194.0-255,1484,43650,63,207409
11568,0.00045,172.217.194.0-255,1484,45134,63,207409
11569,0.000452,172.31.40.0-255,66,45200,63,207409
11570,0.00046,172.217.194.0-255,7156,52356,63,207409
11571,0.000462,172.31.40.0-255,66,52422,63,207409
11572,0.000516,172.31.40.0-255,66,52488,63,207409
11573,0.000533,172.217.194.0-255,2902,55390,63,207409
11574,0.000539,172.31.40.0-255,66,55456,63,207409
11575,0.00055,172.217.194.0-255,766,56222,63,207409
11576,0.000872,172.217.194.0-255,1484,57706,63,207409
11577,0.000876,172.31.40.0-255,66,57772,63,207409
11578,0.000881,172.217.194.0-255,2902,60674,63,207409
11579,0.000883,172.31.40.0-255,66,60740,63,207409
11580,0.000902,172.217.194.0-255,2902,63642,63,207409
11581,0.000908,172.31.40.0-255,66,63708,63,207409
11582,0.000933,172.217.194.0-255,1484,65192,63,207409
11583,0.000955,172.217.194.0-255,5738,70930,63,207409
11584,0.000957,172.31.40.0-255,66,70996,63,207409
11585,0.000966,172.31.40.0-255,66,71062,63,207409
11586,0.000987,172.217.194.0-255,5738,76800,63,207409
11587,0.000989,172.31.40.0-255,66,76866,63,207409
11588,0.00102,172.217.194.0-255,2007,78873,63,207409
11589,0.001022,172.31.40.0-255,66,78939,63,207409
11590,0.001048,172.217.194.0-255,2902,81841,63,207409
11591,0.001051,172.31.40.0-255,66,81907,63,207409
11592,0.001055,172.217.194.0-255,2902,84809,63,207409
11593,0.001057,172.31.40.0-255,66,84875,63,207409
11594,0.001087,172.217.194.0-255,7156,92031,63,207409
11595,0.00109,172.31.40.0-255,66,92097,63,207409
11596,0.001127,172.31.40.0-255,66,92163,63,207409
11597,0.00115,172.217.194.0-255,4320,96483,63,207409
11598,0.001153,172.31.40.0-255,66,96549,63,207409
11599,0.00117,172.217.194.0-255,2902,99451,63,207409
11600,0.001177,172.31.40.0-255,66,99517,63,207409
11601,0.001206,172.217.194.0-255,3602,103119,63,207409
11602,0.00121,172.31.40.0-255,66,103185,63,207409
11603,0.001253,172.217.194.0-255,1484,104669,63,207409
11604,0.001257,172.217.194.0-255,1484,106153,63,207409
11605,0.00126,172.31.40.0-255,66,106219,63,207409
11606,0.00128,172.217.194.0-255,1484,107703,63,207409
11607,0.001291,172.217.194.0-255,5738,113441,63,207409
11608,0.001294,172.31.40.0-255,66,113507,63,207409
11609,0.001297,172.217.194.0-255,1484,114991,63,207409
11610,0.001345,172.31.40.0-255,66,115057,63,207409
11611,0.001356,172.31.40.0-255,66,115123,63,207409
11612,0.001386,172.217.194.0-255,2184,117307,63,207409
11613,0.001389,172.31.40.0-255,66,117373,63,207409
11614,0.001468,172.217.194.0-255,1484,118857,63,207409
11615,0.001473,172.217.194.0-255,2902,121759,63,207409
11616,0.001476,172.31.40.0-255,66,121825,63,207409
11617,0.001481,172.217.194.0-255,2902,124727,63,207409
11618,0.001483,172.31.40.0-255,66,124793,63,207409
11619,0.001507,172.217.194.0-255,2902,127695,63,207409
11620,0.001509,172.31.40.0-255,66,127761,63,207409
11621,0.001516,172.217.194.0-255,7156,134917,63,207409
11622,0.001519,172.31.40.0-255,66,134983,63,207409
11623,0.001542,172.217.194.0-255,5738,140721,63,207409
11624,0.001546,172.31.40.0-255,66,140787,63,207409
11625,0.001556,172.31.40.0-255,66,140853,63,207409
11626,0.001612,172.31.40.0-255,66,140919,63,207409
11627,0.001625,172.31.40.0-255,66,140985,63,207409
11628,0.001706,172.31.40.0-255,66,141051,63,207409
11629,0.001734,172.217.194.0-255,4320,145371,63,207409
11630,0.001737,172.31.40.0-255,66,145437,63,207409
11631,0.001744,172.217.194.0-255,6438,151875,63,207409
11632,0.001748,172.31.40.0-255,66,151941,63,207409
11633,0.002176,172.217.194.0-255,1484,153425,63,207409
11634,0.002192,172.217.194.0-255,2902,156327,63,207409
11635,0.002196,172.31.40.0-255,66,156393,63,207409
11636,0.0022,172.217.194.0-255,1484,157877,63,207409
11637,0.002227,172.217.194.0-255,4320,162197,63,207409
11638,0.00223,172.31.40.0-255,66,162263,63,207409
11639,0.002242,172.31.40.0-255,66,162329,63,207409
11640,0.002277,172.217.194.0-255,4320,166649,63,207409
11641,0.00228,172.31.40.0-255,66,166715,63,207409
11642,0.002292,172.31.40.0-255,66,166781,63,207409
11643,0.004573,172.217.194.0-255,5738,172519,63,207409
11644,0.004579,172.31.40.0-255,66,172585,63,207409
11645,0.006856,172.217.194.0-255,5738,178323,63,207409
11646,0.00687,172.31.40.0-255,66,178389,63,207409
11647,0.009185,172.217.194.0-255,5738,184127,63,207409
11648,0.009199,172.31.40.0-255,66,184193,63,207409
11649,0.011501,172.217.194.0-255,5738,189931,63,207409
11650,0.01151,172.31.40.0-255,66,189997,63,207409
11651,0.013791,172.217.194.0-255,5738,195735,63,207409
11652,0.013812,172.31.40.0-255,66,195801,63,207409
11653,0.016065,172.217.194.0-255,5738,201539,63,207409
11654,0.016073,172.31.40.0-255,66,201605,63,207409
11655,0.018363,172.217.194.0-255,5738,207343,63,207409
11656,0.01838,172.31.40.0-255,66,207409,63,207409
11657,0.0,74.125.24.0-255,297,297,63,208006
11658,2.3e-05,172.31.40.0-255,66,363,63,208006
11659,3e-05,74.125.24.0-255,1484,1847,63,208006
11660,3.4e-05,172.31.40.0-255,66,1913,63,208006
11661,4e-05,74.125.24.0-255,2902,4815,63,208006
11662,5.2e-05,172.31.40.0-255,66,4881,63,208006
11663,5.8e-05,74.125.24.0-255,5738,10619,63,208006
11664,6.1e-05,172.31.40.0-255,66,10685,63,208006
11665,6.6e-05,74.125.24.0-255,3384,14069,63,208006
11666,6.9e-05,172.31.40.0-255,66,14135,63,208006
11667,0.00012,74.125.24.0-255,1484,15619,63,208006
11668,0.000124,172.31.40.0-255,66,15685,63,208006
11669,0.000128,74.125.24.0-255,1484,17169,63,208006
11670,0.000129,172.31.40.0-255,66,17235,63,208006
11671,0.000162,74.125.24.0-255,1484,18719,63,208006
11672,0.000166,172.31.40.0-255,66,18785,63,208006
11673,0.000172,74.125.24.0-255,5738,24523,63,208006
11674,0.000175,172.31.40.0-255,66,24589,63,208006
11675,0.000184,74.125.24.0-255,4320,28909,63,208006
11676,0.000187,172.31.40.0-255,66,28975,63,208006
11677,0.000229,172.31.40.0-255,66,29041,63,208006
11678,0.000234,74.125.24.0-255,4320,33361,63,208006
11679,0.000236,172.31.40.0-255,66,33427,63,208006
11680,0.00024,74.125.24.0-255,2902,36329,63,208006
11681,0.000242,172.31.40.0-255,66,36395,63,208006
11682,0.000293,172.31.40.0-255,66,36461,63,208006
11683,0.000296,74.125.24.0-255,2184,38645,63,208006
11684,0.000298,172.31.40.0-255,66,38711,63,208006
11685,0.000301,74.125.24.0-255,362,39073,63,208006
11686,0.000303,172.31.40.0-255,66,39139,63,208006
11687,0.000331,74.125.24.0-255,131,39270,63,208006
11688,0.000487,74.125.24.0-255,1484,40754,63,208006
11689,0.000492,172.31.40.0-255,66,40820,63,208006
11690,0.000498,74.125.24.0-255,2902,43722,63,208006
11691,0.0005,172.31.40.0-255,66,43788,63,208006
11692,0.000509,74.125.24.0-255,2902,46690,63,208006
11693,0.000511,172.31.40.0-255,66,46756,63,208006
11694,0.000542,74.125.24.0-255,2902,49658,63,208006
11695,0.000545,172.31.40.0-255,66,49724,63,208006
11696,0.000563,172.31.40.0-255,66,49790,63,208006
11697,0.000596,74.125.24.0-255,2902,52692,63,208006
11698,0.000598,172.31.40.0-255,66,52758,63,208006
11699,0.000633,172.31.40.0-255,66,52824,63,208006
11700,0.000746,74.125.24.0-255,1484,54308,63,208006
11701,0.000752,74.125.24.0-255,2902,57210,63,208006
11702,0.000756,172.31.40.0-255,66,57276,63,208006
11703,0.000764,74.125.24.0-255,5738,63014,63,208006
11704,0.000766,172.31.40.0-255,66,63080,63,208006
11705,0.000774,74.125.24.0-255,1484,64564,63,208006
11706,0.000832,172.31.40.0-255,66,64630,63,208006
11707,0.000839,74.125.24.0-255,5738,70368,63,208006
11708,0.000841,172.31.40.0-255,66,70434,63,208006
11709,0.000869,74.125.24.0-255,5020,75454,63,208006
11710,0.000871,172.31.40.0-255,66,75520,63,208006
11711,0.000958,74.125.24.0-255,1484,77004,63,208006
11712,0.000972,74.125.24.0-255,2902,79906,63,208006
11713,0.000975,172.31.40.0-255,66,79972,63,208006
11714,0.000979,74.125.24.0-255,1484,81456,63,208006
11715,0.001009,74.125.24.0-255,4320,85776,63,208006
11716,0.001012,172.31.40.0-255,66,85842,63,208006
11717,0.001024,172.31.40.0-255,66,85908,63,208006
11718,0.001045,74.125.24.0-255,4320,90228,63,208006
11719,0.001052,172.31.40.0-255,66,90294,63,208006
11720,0.001095,172.31.40.0-255,66,90360,63,208006
11721,0.00117,74.125.24.0-255,1484,91844,63,208006
11722,0.001187,74.125.24.0-255,2902,94746,63,208006
11723,0.00119,172.31.40.0-255,66,94812,63,208006
11724,0.00122,74.125.24.0-255,5738,100550,63,208006
11725,0.001224,172.31.40.0-255,66,100616,63,208006
11726,0.001231,74.125.24.0-255,7156,107772,63,208006
11727,0.001233,172.31.40.0-255,66,107838,63,208006
11728,0.001266,172.31.40.0-255,66,107904,63,208006
11729,0.001295,74.125.24.0-255,4320,112224,63,208006
11730,0.001298,172.31.40.0-255,66,112290,63,208006
11731,0.001302,74.125.24.0-255,2184,114474,63,208006
11732,0.001304,172.31.40.0-255,66,114540,63,208006
11733,0.001353,74.125.24.0-255,1484,116024,63,208006
11734,0.001371,74.125.24.0-255,2902,118926,63,208006
11735,0.001374,172.31.40.0-255,66,118992,63,208006
11736,0.001377,74.125.24.0-255,1484,120476,63,208006
11737,0.001408,74.125.24.0-255,1484,121960,63,208006
11738,0.001412,172.31.40.0-255,66,122026,63,208006
11739,0.001417,74.125.24.0-255,4320,126346,63,208006
11740,0.00142,172.31.40.0-255,66,126412,63,208006
11741,0.001434,172.31.40.0-255,66,126478,63,208006
11742,0.001445,172.31.40.0-255,66,126544,63,208006
11743,0.001473,74.125.24.0-255,1484,128028,63,208006
11744,0.001496,74.125.24.0-255,3602,131630,63,208006
11745,0.001499,172.31.40.0-255,66,131696,63,208006
11746,0.001544,74.125.24.0-255,1484,133180,63,208006
11747,0.001548,74.125.24.0-255,2902,136082,63,208006
11748,0.001551,172.31.40.0-255,66,136148,63,208006
11749,0.001576,74.125.24.0-255,5738,141886,63,208006
11750,0.001579,172.31.40.0-255,66,141952,63,208006
11751,0.001583,74.125.24.0-255,2902,144854,63,208006
11752,0.001585,172.31.40.0-255,66,144920,63,208006
11753,0.001635,172.31.40.0-255,66,144986,63,208006
11754,0.001649,172.31.40.0-255,66,145052,63,208006
11755,0.001708,74.125.24.0-255,1484,146536,63,208006
11756,0.001728,74.125.24.0-255,2902,149438,63,208006
11757,0.001732,172.31.40.0-255,66,149504,63,208006
11758,0.001737,74.125.24.0-255,4320,153824,63,208006
11759,0.001739,172.31.40.0-255,66,153890,63,208006
11760,0.001782,74.125.24.0-255,4320,158210,63,208006
11761,0.001784,172.31.40.0-255,66,158276,63,208006
11762,0.001823,74.125.24.0-255,4320,162596,63,208006
11763,0.001826,172.31.40.0-255,66,162662,63,208006
11764,0.001847,172.31.40.0-255,66,162728,63,208006
11765,0.001864,172.31.40.0-255,66,162794,63,208006
11766,0.001871,74.125.24.0-255,7156,169950,63,208006
11767,0.001873,172.31.40.0-255,66,170016,63,208006
11768,0.001903,74.125.24.0-255,2902,172918,63,208006
11769,0.001906,172.31.40.0-255,66,172984,63,208006
11770,0.001929,172.31.40.0-255,66,173050,63,208006
11771,0.001964,172.31.40.0-255,66,173116,63,208006
11772,0.001983,172.31.40.0-255,66,173182,63,208006
11773,0.004592,74.125.24.0-255,5738,178920,63,208006
11774,0.004604,172.31.40.0-255,66,178986,63,208006
11775,0.007246,74.125.24.0-255,5738,184724,63,208006
11776,0.007266,172.31.40.0-255,66,184790,63,208006
11777,0.009886,74.125.24.0-255,5738,190528,63,208006
11778,0.009902,172.31.40.0-255,66,190594,63,208006
11779,0.012525,74.125.24.0-255,5738,196332,63,208006
11780,0.012536,172.31.40.0-255,66,196398,63,208006
11781,0.015164,74.125.24.0-255,5738,202136,63,208006
11782,0.015183,172.31.40.0-255,66,202202,63,208006
11783,0.017821,74.125.24.0-255,5738,207940,63,208006
11784,0.017837,172.31.40.0-255,66,208006,63,208006
11785,0.0,172.217.194.0-255,226,226,63,52826
11786,2.1e-05,172.31.40.0-255,66,292,63,52826
11787,2.9e-05,172.217.194.0-255,1484,1776,63,52826
11788,3.3e-05,172.31.40.0-255,66,1842,63,52826
11789,5.8e-05,172.217.194.0-255,1484,3326,63,52826
11790,6.1e-05,172.31.40.0-255,66,3392,63,52826
11791,9.1e-05,172.217.194.0-255,2902,6294,63,52826
11792,9.3e-05,172.31.40.0-255,66,6360,63,52826
11793,0.000312,172.31.40.0-255,66,6426,63,52826
11794,0.000829,172.31.40.0-255,66,6492,63,52826
11795,0.00243,172.217.194.0-255,2566,9058,63,52826
11796,0.002437,172.31.40.0-255,66,9124,63,52826
11797,0.003185,172.217.194.0-255,2902,12026,63,52826
11798,0.00319,172.31.40.0-255,66,12092,63,52826
11799,0.004804,172.217.194.0-255,2902,14994,63,52826
11800,0.004812,172.31.40.0-255,66,15060,63,52826
11801,0.005549,172.217.194.0-255,2902,17962,63,52826
11802,0.005557,172.31.40.0-255,66,18028,63,52826
11803,0.007186,172.217.194.0-255,2902,20930,63,52826
11804,0.007193,172.31.40.0-255,66,20996,63,52826
11805,0.007906,172.217.194.0-255,402,21398,63,52826
11806,0.007912,172.31.40.0-255,66,21464,63,52826
11807,0.007931,172.217.194.0-255,1484,22948,63,52826
11808,0.007934,172.31.40.0-255,66,23014,63,52826
11809,0.009596,172.217.194.0-255,2902,25916,63,52826
11810,0.009606,172.31.40.0-255,66,25982,63,52826
11811,0.010305,172.217.194.0-255,2902,28884,63,52826
11812,0.010309,172.31.40.0-255,66,28950,63,52826
11813,0.011993,172.217.194.0-255,2902,31852,63,52826
11814,0.012006,172.31.40.0-255,66,31918,63,52826
11815,0.012678,172.217.194.0-255,2902,34820,63,52826
11816,0.012685,172.31.40.0-255,66,34886,63,52826
11817,0.014368,172.217.194.0-255,1484,36370,63,52826
11818,0.014375,172.31.40.0-255,66,36436,63,52826
11819,0.015053,172.217.194.0-255,4320,40756,63,52826
11820,0.01506,172.31.40.0-255,66,40822,63,52826
11821,0.016734,172.217.194.0-255,1484,42306,63,52826
11822,0.016742,172.31.40.0-255,66,42372,63,52826
11823,0.017449,172.217.194.0-255,4320,46692,63,52826
11824,0.017457,172.31.40.0-255,66,46758,63,52826
11825,0.019102,172.217.194.0-255,1484,48242,63,52826
11826,0.019109,172.31.40.0-255,66,48308,63,52826
11827,0.019817,172.217.194.0-255,2902,51210,63,52826
11828,0.019823,172.31.40.0-255,66,51276,63,52826
11829,0.019884,172.217.194.0-255,1484,52760,63,52826
11830,0.019888,172.31.40.0-255,66,52826,63,52826
11831,0.0,172.217.194.0-255,153,153,63,158587
11832,2e-05,172.31.40.0-255,66,219,63,158587
11833,2.8e-05,172.217.194.0-255,1484,1703,63,158587
11834,3.3e-05,172.31.40.0-255,66,1769,63,158587
11835,3.6e-05,172.217.194.0-255,1484,3253,63,158587
11836,3.8e-05,172.31.40.0-255,66,3319,63,158587
11837,5.2e-05,172.217.194.0-255,4320,7639,63,158587
11838,5.5e-05,172.31.40.0-255,66,7705,63,158587
11839,0.000119,172.31.40.0-255,66,7771,63,158587
11840,0.000126,172.217.194.0-255,5738,13509,63,158587
11841,0.000128,172.31.40.0-255,66,13575,63,158587
11842,0.00015,172.217.194.0-255,6797,20372,63,158587
11843,0.000156,172.31.40.0-255,66,20438,63,158587
11844,0.000203,172.217.194.0-255,4320,24758,63,158587
11845,0.000206,172.31.40.0-255,66,24824,63,158587
11846,0.000212,172.217.194.0-255,5738,30562,63,158587
11847,0.000215,172.31.40.0-255,66,30628,63,158587
11848,0.000251,172.31.40.0-255,66,30694,63,158587
11849,0.000262,172.31.40.0-255,66,30760,63,158587
11850,0.000295,172.217.194.0-255,3164,33924,63,158587
11851,0.000297,172.31.40.0-255,66,33990,63,158587
11852,0.000446,172.217.194.0-255,1484,35474,63,158587
11853,0.000452,172.31.40.0-255,66,35540,63,158587
11854,0.000458,172.217.194.0-255,2902,38442,63,158587
11855,0.00046,172.31.40.0-255,66,38508,63,158587
11856,0.000492,172.217.194.0-255,5738,44246,63,158587
11857,0.000495,172.31.40.0-255,66,44312,63,158587
11858,0.000503,172.217.194.0-255,7156,51468,63,158587
11859,0.000506,172.31.40.0-255,66,51534,63,158587
11860,0.000533,172.217.194.0-255,5738,57272,63,158587
11861,0.000536,172.31.40.0-255,66,57338,63,158587
11862,0.000546,172.31.40.0-255,66,57404,63,158587
11863,0.00055,172.217.194.0-255,2184,59588,63,158587
11864,0.000553,172.31.40.0-255,66,59654,63,158587
11865,0.000842,172.217.194.0-255,1484,61138,63,158587
11866,0.000864,172.217.194.0-255,2902,64040,63,158587
11867,0.000868,172.31.40.0-255,66,64106,63,158587
11868,0.000875,172.217.194.0-255,5738,69844,63,158587
11869,0.000877,172.31.40.0-255,66,69910,63,158587
11870,0.00088,172.217.194.0-255,1484,71394,63,158587
11871,0.000913,172.31.40.0-255,66,71460,63,158587
11872,0.000916,172.217.194.0-255,1484,72944,63,158587
11873,0.000952,172.31.40.0-255,66,73010,63,158587
11874,0.000955,172.217.194.0-255,766,73776,63,158587
11875,0.001025,172.217.194.0-255,1484,75260,63,158587
11876,0.001029,172.31.40.0-255,66,75326,63,158587
11877,0.001034,172.217.194.0-255,2902,78228,63,158587
11878,0.001036,172.31.40.0-255,66,78294,63,158587
11879,0.00104,172.217.194.0-255,1484,79778,63,158587
11880,0.001067,172.217.194.0-255,4320,84098,63,158587
11881,0.00107,172.31.40.0-255,66,84164,63,158587
11882,0.001086,172.31.40.0-255,66,84230,63,158587
11883,0.001134,172.31.40.0-255,66,84296,63,158587
11884,0.001153,172.217.194.0-255,3602,87898,63,158587
11885,0.001155,172.31.40.0-255,66,87964,63,158587
11886,0.001196,172.31.40.0-255,66,88030,63,158587
11887,0.001207,172.31.40.0-255,66,88096,63,158587
11888,0.001245,172.31.40.0-255,66,88162,63,158587
11889,0.001405,172.217.194.0-255,1484,89646,63,158587
11890,0.001411,172.217.194.0-255,2902,92548,63,158587
11891,0.001414,172.31.40.0-255,66,92614,63,158587
11892,0.001418,172.217.194.0-255,1484,94098,63,158587
11893,0.001445,172.217.194.0-255,4320,98418,63,158587
11894,0.001448,172.31.40.0-255,66,98484,63,158587
11895,0.001459,172.31.40.0-255,66,98550,63,158587
11896,0.001496,172.217.194.0-255,2902,101452,63,158587
11897,0.0015,172.31.40.0-255,66,101518,63,158587
11898,0.001512,172.31.40.0-255,66,101584,63,158587
11899,0.001516,172.217.194.0-255,2902,104486,63,158587
11900,0.001518,172.31.40.0-255,66,104552,63,158587
11901,0.001552,172.217.194.0-255,1484,106036,63,158587
11902,0.001559,172.217.194.0-255,5738,111774,63,158587
11903,0.001562,172.31.40.0-255,66,111840,63,158587
11904,0.00158,172.31.40.0-255,66,111906,63,158587
11905,0.001594,172.31.40.0-255,66,111972,63,158587
11906,0.00163,172.217.194.0-255,5738,117710,63,158587
11907,0.001634,172.31.40.0-255,66,117776,63,158587
11908,0.001642,172.217.194.0-255,7156,124932,63,158587
11909,0.001644,172.31.40.0-255,66,124998,63,158587
11910,0.001689,172.31.40.0-255,66,125064,63,158587
11911,0.001697,172.217.194.0-255,6438,131502,63,158587
11912,0.001699,172.31.40.0-255,66,131568,63,158587
11913,0.001744,172.217.194.0-255,1484,133052,63,158587
11914,0.001749,172.217.194.0-255,2902,135954,63,158587
11915,0.001752,172.31.40.0-255,66,136020,63,158587
11916,0.001758,172.217.194.0-255,5738,141758,63,158587
11917,0.00176,172.31.40.0-255,66,141824,63,158587
11918,0.001811,172.31.40.0-255,66,141890,63,158587
11919,0.001847,172.31.40.0-255,66,141956,63,158587
11920,0.001892,172.31.40.0-255,66,142022,63,158587
11921,0.001903,172.31.40.0-255,66,142088,63,158587
11922,0.001933,172.217.194.0-255,5738,147826,63,158587
11923,0.001936,172.31.40.0-255,66,147892,63,158587
11924,0.001971,172.31.40.0-255,66,147958,63,158587
11925,0.001987,172.31.40.0-255,66,148024,63,158587
11926,0.002026,172.217.194.0-255,4320,152344,63,158587
11927,0.002028,172.31.40.0-255,66,152410,63,158587
11928,0.002064,172.31.40.0-255,66,152476,63,158587
11929,0.002071,172.217.194.0-255,5703,158179,63,158587
11930,0.002073,172.31.40.0-255,66,158245,63,158587
11931,0.002076,172.217.194.0-255,105,158350,63,158587
11932,0.004672,172.31.40.0-255,66,158416,63,158587
11933,0.004708,172.31.40.0-255,105,158521,63,158587
11934,0.006957,172.217.194.0-255,66,158587,63,158587
11935,0.0,172.217.194.0-255,150,150,63,147861
11936,2.5e-05,172.31.40.0-255,66,216,63,147861
11937,3.2e-05,172.217.194.0-255,1484,1700,63,147861
11938,3.7e-05,172.31.40.0-255,66,1766,63,147861
11939,4.2e-05,172.217.194.0-255,2902,4668,63,147861
11940,4.5e-05,172.31.40.0-255,66,4734,63,147861
11941,6e-05,172.217.194.0-255,7156,11890,63,147861
11942,6.4e-05,172.31.40.0-255,66,11956,63,147861
11943,6.8e-05,172.217.194.0-255,2143,14099,63,147861
11944,7.1e-05,172.31.40.0-255,66,14165,63,147861
11945,0.000255,172.217.194.0-255,1484,15649,63,147861
11946,0.000261,172.31.40.0-255,66,15715,63,147861
11947,0.000267,172.217.194.0-255,2902,18617,63,147861
11948,0.00027,172.31.40.0-255,66,18683,63,147861
11949,0.000281,172.217.194.0-255,5738,24421,63,147861
11950,0.000284,172.31.40.0-255,66,24487,63,147861
11951,0.000289,172.217.194.0-255,4320,28807,63,147861
11952,0.000291,172.31.40.0-255,66,28873,63,147861
11953,0.000337,172.217.194.0-255,4320,33193,63,147861
11954,0.00034,172.31.40.0-255,66,33259,63,147861
11955,0.000385,172.31.40.0-255,66,33325,63,147861
11956,0.000392,172.217.194.0-255,6797,40122,63,147861
11957,0.000394,172.31.40.0-255,66,40188,63,147861
11958,0.00041,172.217.194.0-255,4320,44508,63,147861
11959,0.000413,172.31.40.0-255,66,44574,63,147861
11960,0.000423,172.217.194.0-255,5738,50312,63,147861
11961,0.000426,172.31.40.0-255,66,50378,63,147861
11962,0.000456,172.217.194.0-255,2902,53280,63,147861
11963,0.000459,172.31.40.0-255,66,53346,63,147861
11964,0.000473,172.217.194.0-255,4291,57637,63,147861
11965,0.00048,172.31.40.0-255,66,57703,63,147861
11966,0.000713,172.217.194.0-255,378,58081,63,147861
11967,0.000966,172.217.194.0-255,1484,59565,63,147861
11968,0.000973,172.31.40.0-255,66,59631,63,147861
11969,0.001006,172.217.194.0-255,2902,62533,63,147861
11970,0.001009,172.31.40.0-255,66,62599,63,147861
11971,0.001016,172.217.194.0-255,5738,68337,63,147861
11972,0.001018,172.31.40.0-255,66,68403,63,147861
11973,0.001035,172.31.40.0-255,66,68469,63,147861
11974,0.001074,172.217.194.0-255,2902,71371,63,147861
11975,0.001077,172.31.40.0-255,66,71437,63,147861
11976,0.001115,172.31.40.0-255,66,71503,63,147861
11977,0.001841,172.217.194.0-255,1484,72987,63,147861
11978,0.001852,172.217.194.0-255,2902,75889,63,147861
11979,0.001857,172.31.40.0-255,66,75955,63,147861
11980,0.001866,172.217.194.0-255,5738,81693,63,147861
11981,0.001868,172.31.40.0-255,66,81759,63,147861
11982,0.001881,172.217.194.0-255,7156,88915,63,147861
11983,0.001884,172.31.40.0-255,66,88981,63,147861
11984,0.001933,172.31.40.0-255,66,89047,63,147861
11985,0.001938,172.217.194.0-255,2184,91231,63,147861
11986,0.00194,172.31.40.0-255,66,91297,63,147861
11987,0.002097,172.217.194.0-255,1484,92781,63,147861
11988,0.002104,172.217.194.0-255,2902,95683,63,147861
11989,0.002107,172.31.40.0-255,66,95749,63,147861
11990,0.002149,172.217.194.0-255,5738,101487,63,147861
11991,0.002152,172.31.40.0-255,66,101553,63,147861
11992,0.002166,172.31.40.0-255,66,101619,63,147861
11993,0.002202,172.31.40.0-255,66,101685,63,147861
11994,0.002204,172.217.194.0-255,766,102451,63,147861
11995,0.002519,172.217.194.0-255,1484,103935,63,147861
11996,0.002526,172.31.40.0-255,66,104001,63,147861
11997,0.002532,172.217.194.0-255,2902,106903,63,147861
11998,0.002536,172.31.40.0-255,66,106969,63,147861
11999,0.004963,172.217.194.0-255,2902,109871,63,147861
12000,0.004968,172.31.40.0-255,66,109937,63,147861
12001,0.005015,172.217.194.0-255,2902,112839,63,147861
12002,0.005018,172.31.40.0-255,66,112905,63,147861
12003,0.007433,172.217.194.0-255,2902,115807,63,147861
12004,0.00744,172.31.40.0-255,66,115873,63,147861
12005,0.007477,172.217.194.0-255,2902,118775,63,147861
12006,0.00748,172.31.40.0-255,66,118841,63,147861
12007,0.009945,172.217.194.0-255,5738,124579,63,147861
12008,0.009956,172.31.40.0-255,66,124645,63,147861
12009,0.012404,172.217.194.0-255,5738,130383,63,147861
12010,0.012415,172.31.40.0-255,66,130449,63,147861
12011,0.014911,172.217.194.0-255,5738,136187,63,147861
12012,0.014922,172.31.40.0-255,66,136253,63,147861
12013,0.017412,172.217.194.0-255,5738,141991,63,147861
12014,0.017421,172.31.40.0-255,66,142057,63,147861
12015,0.019891,172.217.194.0-255,5738,147795,63,147861
12016,0.0199,172.31.40.0-255,66,147861,63,147861
12017,0.0,74.125.24.0-255,150,150,63,208577
12018,2.2e-05,172.31.40.0-255,66,216,63,208577
12019,2.9e-05,74.125.24.0-255,1484,1700,63,208577
12020,3.3e-05,172.31.40.0-255,66,1766,63,208577
12021,3.9e-05,74.125.24.0-255,2902,4668,63,208577
12022,5e-05,172.31.40.0-255,66,4734,63,208577
12023,5.7e-05,74.125.24.0-255,7156,11890,63,208577
12024,6.1e-05,172.31.40.0-255,66,11956,63,208577
12025,6.5e-05,74.125.24.0-255,2110,14066,63,208577
12026,6.8e-05,172.31.40.0-255,66,14132,63,208577
12027,0.000227,74.125.24.0-255,1484,15616,63,208577
12028,0.000232,172.31.40.0-255,66,15682,63,208577
12029,0.000238,74.125.24.0-255,2902,18584,63,208577
12030,0.000241,172.31.40.0-255,66,18650,63,208577
12031,0.000265,74.125.24.0-255,5738,24388,63,208577
12032,0.000267,172.31.40.0-255,66,24454,63,208577
12033,0.000278,74.125.24.0-255,4320,28774,63,208577
12034,0.00028,172.31.40.0-255,66,28840,63,208577
12035,0.000301,74.125.24.0-255,1484,30324,63,208577
12036,0.000304,172.31.40.0-255,66,30390,63,208577
12037,0.000316,74.125.24.0-255,6797,37187,63,208577
12038,0.000319,172.31.40.0-255,66,37253,63,208577
12039,0.000323,74.125.24.0-255,2902,40155,63,208577
12040,0.000325,172.31.40.0-255,66,40221,63,208577
12041,0.000366,172.31.40.0-255,66,40287,63,208577
12042,0.000385,172.31.40.0-255,66,40353,63,208577
12043,0.000431,74.125.24.0-255,2184,42537,63,208577
12044,0.000433,172.31.40.0-255,66,42603,63,208577
12045,0.000444,74.125.24.0-255,646,43249,63,208577
12046,0.000451,172.31.40.0-255,66,43315,63,208577
12047,0.000586,74.125.24.0-255,1484,44799,63,208577
12048,0.000595,74.125.24.0-255,2902,47701,63,208577
12049,0.000598,74.125.24.0-255,1484,49185,63,208577
12050,0.000611,74.125.24.0-255,4320,53505,63,208577
12051,0.000615,74.125.24.0-255,2902,56407,63,208577
12052,0.000619,172.31.40.0-255,66,56473,63,208577
12053,0.00063,172.31.40.0-255,66,56539,63,208577
12054,0.000703,172.31.40.0-255,66,56605,63,208577
12055,0.000711,74.125.24.0-255,1484,58089,63,208577
12056,0.000732,74.125.24.0-255,4320,62409,63,208577
12057,0.000739,74.125.24.0-255,7156,69565,63,208577
12058,0.000758,172.31.40.0-255,66,69631,63,208577
12059,0.000795,74.125.24.0-255,1484,71115,63,208577
12060,0.00081,172.31.40.0-255,66,71181,63,208577
12061,0.000848,172.31.40.0-255,66,71247,63,208577
12062,0.000871,74.125.24.0-255,2184,73431,63,208577
12063,0.000882,172.31.40.0-255,66,73497,63,208577
12064,0.001042,74.125.24.0-255,1484,74981,63,208577
12065,0.001048,74.125.24.0-255,2902,77883,63,208577
12066,0.00106,74.125.24.0-255,2902,80785,63,208577
12067,0.001073,74.125.24.0-255,2902,83687,63,208577
12068,0.001079,74.125.24.0-255,5738,89425,63,208577
12069,0.001082,172.31.40.0-255,66,89491,63,208577
12070,0.001087,172.31.40.0-255,66,89557,63,208577
12071,0.001094,74.125.24.0-255,1484,91041,63,208577
12072,0.001136,74.125.24.0-255,1484,92525,63,208577
12073,0.001143,172.31.40.0-255,66,92591,63,208577
12074,0.00116,74.125.24.0-255,3602,96193,63,208577
12075,0.001178,172.31.40.0-255,66,96259,63,208577
12076,0.001288,74.125.24.0-255,1484,97743,63,208577
12077,0.001294,74.125.24.0-255,2902,100645,63,208577
12078,0.001316,74.125.24.0-255,5738,106383,63,208577
12079,0.001319,172.31.40.0-255,66,106449,63,208577
12080,0.001324,172.31.40.0-255,66,106515,63,208577
12081,0.001376,74.125.24.0-255,5738,112253,63,208577
12082,0.001378,74.125.24.0-255,1484,113737,63,208577
12083,0.001395,74.125.24.0-255,3602,117339,63,208577
12084,0.0014,172.31.40.0-255,66,117405,63,208577
12085,0.001514,74.125.24.0-255,1484,118889,63,208577
12086,0.001534,74.125.24.0-255,2902,121791,63,208577
12087,0.001544,172.31.40.0-255,66,121857,63,208577
12088,0.001555,74.125.24.0-255,5738,127595,63,208577
12089,0.001569,172.31.40.0-255,66,127661,63,208577
12090,0.001575,74.125.24.0-255,4320,131981,63,208577
12091,0.001658,172.31.40.0-255,66,132047,63,208577
12092,0.00167,74.125.24.0-255,2184,134231,63,208577
12093,0.001675,172.31.40.0-255,66,134297,63,208577
12094,0.001701,74.125.24.0-255,2902,137199,63,208577
12095,0.001707,74.125.24.0-255,1484,138683,63,208577
12096,0.001711,74.125.24.0-255,2902,141585,63,208577
12097,0.001728,74.125.24.0-255,1484,143069,63,208577
12098,0.001743,74.125.24.0-255,4320,147389,63,208577
12099,0.001756,172.31.40.0-255,66,147455,63,208577
12100,0.001787,74.125.24.0-255,1484,148939,63,208577
12101,0.001797,74.125.24.0-255,1484,150423,63,208577
12102,0.001805,172.31.40.0-255,66,150489,63,208577
12103,0.001824,74.125.24.0-255,5738,156227,63,208577
12104,0.001841,74.125.24.0-255,2902,159129,63,208577
12105,0.00185,172.31.40.0-255,66,159195,63,208577
12106,0.001882,74.125.24.0-255,7156,166351,63,208577
12107,0.001896,74.125.24.0-255,2184,168535,63,208577
12108,0.001905,172.31.40.0-255,66,168601,63,208577
12109,0.00193,74.125.24.0-255,1484,170085,63,208577
12110,0.001955,74.125.24.0-255,2902,172987,63,208577
12111,0.00197,172.31.40.0-255,66,173053,63,208577
12112,0.001981,74.125.24.0-255,5738,178791,63,208577
12113,0.002009,74.125.24.0-255,5020,183811,63,208577
12114,0.002021,172.31.40.0-255,66,183877,63,208577
12115,0.004054,74.125.24.0-255,5738,189615,63,208577
12116,0.00406,172.31.40.0-255,66,189681,63,208577
12117,0.006114,74.125.24.0-255,5738,195419,63,208577
12118,0.013228,74.125.24.0-255,1484,196903,63,208577
12119,0.014692,172.31.40.0-255,66,196969,63,208577
12120,0.01673,74.125.24.0-255,5738,202707,63,208577
12121,0.016744,172.31.40.0-255,66,202773,63,208577
12122,0.018765,74.125.24.0-255,5738,208511,63,208577
12123,0.018773,172.31.40.0-255,66,208577,63,208577
12124,0.0,74.125.24.0-255,153,153,63,176820
12125,2.5e-05,172.31.40.0-255,66,219,63,176820
12126,3.2e-05,74.125.24.0-255,1484,1703,63,176820
12127,3.6e-05,172.31.40.0-255,66,1769,63,176820
12128,4.4e-05,74.125.24.0-255,2902,4671,63,176820
12129,5.5e-05,172.31.40.0-255,66,4737,63,176820
12130,6.3e-05,74.125.24.0-255,7156,11893,63,176820
12131,6.7e-05,172.31.40.0-255,66,11959,63,176820
12132,8.2e-05,172.31.40.0-255,66,12025,63,176820
12133,0.000119,74.125.24.0-255,3484,15509,63,176820
12134,0.000122,172.31.40.0-255,66,15575,63,176820
12135,0.000133,172.31.40.0-255,66,15641,63,176820
12136,0.000149,172.31.40.0-255,66,15707,63,176820
12137,0.000184,74.125.24.0-255,2543,18250,63,176820
12138,0.000187,172.31.40.0-255,66,18316,63,176820
12139,0.00031,74.125.24.0-255,1484,19800,63,176820
12140,0.000314,172.31.40.0-255,66,19866,63,176820
12141,0.000319,74.125.24.0-255,2902,22768,63,176820
12142,0.000322,172.31.40.0-255,66,22834,63,176820
12143,0.000333,74.125.24.0-255,5738,28572,63,176820
12144,0.000337,172.31.40.0-255,66,28638,63,176820
12145,0.0004,74.125.24.0-255,7093,35731,63,176820
12146,0.000403,172.31.40.0-255,66,35797,63,176820
12147,0.000623,74.125.24.0-255,132,35929,63,176820
12148,0.00063,172.31.40.0-255,66,35995,63,176820
12149,0.000741,74.125.24.0-255,1484,37479,63,176820
12150,0.000745,172.31.40.0-255,66,37545,63,176820
12151,0.000751,74.125.24.0-255,2902,40447,63,176820
12152,0.000754,172.31.40.0-255,66,40513,63,176820
12153,0.000786,74.125.24.0-255,5738,46251,63,176820
12154,0.000789,172.31.40.0-255,66,46317,63,176820
12155,0.000795,74.125.24.0-255,5738,52055,63,176820
12156,0.000798,172.31.40.0-255,66,52121,63,176820
12157,0.000807,74.125.24.0-255,2902,55023,63,176820
12158,0.000809,172.31.40.0-255,66,55089,63,176820
12159,0.000855,172.31.40.0-255,66,55155,63,176820
12160,0.00086,74.125.24.0-255,3961,59116,63,176820
12161,0.000862,172.31.40.0-255,66,59182,63,176820
12162,0.001365,74.125.24.0-255,1484,60666,63,176820
12163,0.001383,74.125.24.0-255,2902,63568,63,176820
12164,0.001387,172.31.40.0-255,66,63634,63,176820
12165,0.00141,74.125.24.0-255,5738,69372,63,176820
12166,0.001413,172.31.40.0-255,66,69438,63,176820
12167,0.001421,74.125.24.0-255,7156,76594,63,176820
12168,0.001423,172.31.40.0-255,66,76660,63,176820
12169,0.001453,74.125.24.0-255,5738,82398,63,176820
12170,0.001458,74.125.24.0-255,4320,86718,63,176820
12171,0.001463,172.31.40.0-255,66,86784,63,176820
12172,0.00147,172.31.40.0-255,66,86850,63,176820
12173,0.001494,74.125.24.0-255,6438,93288,63,176820
12174,0.001496,172.31.40.0-255,66,93354,63,176820
12175,0.001788,74.125.24.0-255,1484,94838,63,176820
12176,0.001793,74.125.24.0-255,1484,96322,63,176820
12177,0.001796,172.31.40.0-255,66,96388,63,176820
12178,0.001825,74.125.24.0-255,1484,97872,63,176820
12179,0.001832,74.125.24.0-255,5738,103610,63,176820
12180,0.001835,172.31.40.0-255,66,103676,63,176820
12181,0.001849,172.31.40.0-255,66,103742,63,176820
12182,0.001864,172.31.40.0-255,66,103808,63,176820
12183,0.001912,74.125.24.0-255,4320,108128,63,176820
12184,0.001917,172.31.40.0-255,66,108194,63,176820
12185,0.001958,172.31.40.0-255,66,108260,63,176820
12186,0.001973,172.31.40.0-255,66,108326,63,176820
12187,0.001976,74.125.24.0-255,1484,109810,63,176820
12188,0.001981,74.125.24.0-255,2902,112712,63,176820
12189,0.001984,172.31.40.0-255,66,112778,63,176820
12190,0.001988,74.125.24.0-255,2902,115680,63,176820
12191,0.001991,172.31.40.0-255,66,115746,63,176820
12192,0.002013,74.125.24.0-255,2902,118648,63,176820
12193,0.002015,172.31.40.0-255,66,118714,63,176820
12194,0.002021,74.125.24.0-255,5738,124452,63,176820
12195,0.002024,172.31.40.0-255,66,124518,63,176820
12196,0.002049,74.125.24.0-255,5738,130256,63,176820
12197,0.002069,172.31.40.0-255,66,130322,63,176820
12198,0.002072,172.31.40.0-255,66,130388,63,176820
12199,0.004152,74.125.24.0-255,5738,136126,63,176820
12200,0.004168,172.31.40.0-255,66,136192,63,176820
12201,0.006193,74.125.24.0-255,5738,141930,63,176820
12202,0.006198,172.31.40.0-255,66,141996,63,176820
12203,0.008225,74.125.24.0-255,5738,147734,63,176820
12204,0.008235,172.31.40.0-255,66,147800,63,176820
12205,0.01027,74.125.24.0-255,5738,153538,63,176820
12206,0.010285,172.31.40.0-255,66,153604,63,176820
12207,0.01235,74.125.24.0-255,5738,159342,63,176820
12208,0.012368,172.31.40.0-255,66,159408,63,176820
12209,0.014414,74.125.24.0-255,5738,165146,63,176820
12210,0.014436,172.31.40.0-255,66,165212,63,176820
12211,0.016491,74.125.24.0-255,5738,170950,63,176820
12212,0.016508,172.31.40.0-255,66,171016,63,176820
12213,0.018562,74.125.24.0-255,5738,176754,63,176820
12214,0.018578,172.31.40.0-255,66,176820,63,176820
12215,0.0,172.217.194.0-255,151,151,63,183516
12216,1.5e-05,172.31.40.0-255,66,217,63,183516
12217,2.2e-05,172.217.194.0-255,1484,1701,63,183516
12218,2.7e-05,172.31.40.0-255,66,1767,63,183516
12219,3.3e-05,172.217.194.0-255,2902,4669,63,183516
12220,3.6e-05,172.31.40.0-255,66,4735,63,183516
12221,4.3e-05,172.217.194.0-255,5738,10473,63,183516
12222,4.7e-05,172.31.40.0-255,66,10539,63,183516
12223,6.7e-05,172.217.194.0-255,1484,12023,63,183516
12224,7e-05,172.31.40.0-255,66,12089,63,183516
12225,9.2e-05,172.31.40.0-255,66,12155,63,183516
12226,0.000111,172.217.194.0-255,3441,15596,63,183516
12227,0.000114,172.31.40.0-255,66,15662,63,183516
12228,0.000124,172.31.40.0-255,66,15728,63,183516
12229,0.000148,172.217.194.0-255,2902,18630,63,183516
12230,0.00015,172.31.40.0-255,66,18696,63,183516
12231,0.000179,172.31.40.0-255,66,18762,63,183516
12232,0.000186,172.217.194.0-255,7156,25918,63,183516
12233,0.000188,172.31.40.0-255,66,25984,63,183516
12234,0.000208,172.31.40.0-255,66,26050,63,183516
12235,0.00021,172.217.194.0-255,1125,27175,63,183516
12236,0.000212,172.31.40.0-255,66,27241,63,183516
12237,0.000254,172.217.194.0-255,365,27606,63,183516
12238,0.000256,172.31.40.0-255,66,27672,63,183516
12239,0.000281,172.217.194.0-255,1484,29156,63,183516
12240,0.000283,172.31.40.0-255,66,29222,63,183516
12241,0.000295,172.217.194.0-255,4320,33542,63,183516
12242,0.000298,172.31.40.0-255,66,33608,63,183516
12243,0.000326,172.31.40.0-255,66,33674,63,183516
12244,0.000363,172.217.194.0-255,7156,40830,63,183516
12245,0.000366,172.31.40.0-255,66,40896,63,183516
12246,0.000388,172.31.40.0-255,66,40962,63,183516
12247,0.000449,172.31.40.0-255,66,41028,63,183516
12248,0.000466,172.217.194.0-255,2902,43930,63,183516
12249,0.000468,172.31.40.0-255,66,43996,63,183516
12250,0.000472,172.217.194.0-255,2543,46539,63,183516
12251,0.000474,172.31.40.0-255,66,46605,63,183516
12252,0.000545,172.217.194.0-255,1484,48089,63,183516
12253,0.00055,172.217.194.0-255,2902,50991,63,183516
12254,0.000553,172.31.40.0-255,66,51057,63,183516
12255,0.000556,172.217.194.0-255,1484,52541,63,183516
12256,0.000574,172.217.194.0-255,4320,56861,63,183516
12257,0.000577,172.31.40.0-255,66,56927,63,183516
12258,0.000581,172.217.194.0-255,2902,59829,63,183516
12259,0.000582,172.31.40.0-255,66,59895,63,183516
12260,0.000605,172.31.40.0-255,66,59961,63,183516
12261,0.000621,172.217.194.0-255,1484,61445,63,183516
12262,0.000633,172.31.40.0-255,66,61511,63,183516
12263,0.000735,172.217.194.0-255,1484,62995,63,183516
12264,0.000742,172.217.194.0-255,2902,65897,63,183516
12265,0.000745,172.31.40.0-255,66,65963,63,183516
12266,0.000751,172.217.194.0-255,4320,70283,63,183516
12267,0.000753,172.31.40.0-255,66,70349,63,183516
12268,0.000765,172.217.194.0-255,1484,71833,63,183516
12269,0.000767,172.217.194.0-255,1484,73317,63,183516
12270,0.000769,172.31.40.0-255,66,73383,63,183516
12271,0.000771,172.217.194.0-255,1484,74867,63,183516
12272,0.0008,172.217.194.0-255,7156,82023,63,183516
12273,0.000803,172.31.40.0-255,66,82089,63,183516
12274,0.000817,172.217.194.0-255,5738,87827,63,183516
12275,0.00082,172.31.40.0-255,66,87893,63,183516
12276,0.000848,172.217.194.0-255,7156,95049,63,183516
12277,0.000851,172.31.40.0-255,66,95115,63,183516
12278,0.000853,172.217.194.0-255,766,95881,63,183516
12279,0.00087,172.217.194.0-255,1484,97365,63,183516
12280,0.000872,172.217.194.0-255,1484,98849,63,183516
12281,0.000875,172.31.40.0-255,66,98915,63,183516
12282,0.000883,172.217.194.0-255,2902,101817,63,183516
12283,0.000886,172.31.40.0-255,66,101883,63,183516
12284,0.000927,172.31.40.0-255,66,101949,63,183516
12285,0.000934,172.217.194.0-255,7156,109105,63,183516
12286,0.000936,172.31.40.0-255,66,109171,63,183516
12287,0.000971,172.217.194.0-255,5738,114909,63,183516
12288,0.000974,172.31.40.0-255,66,114975,63,183516
12289,0.000994,172.217.194.0-255,5020,119995,63,183516
12290,0.000996,172.31.40.0-255,66,120061,63,183516
12291,0.001016,172.217.194.0-255,5738,125799,63,183516
12292,0.001018,172.31.40.0-255,66,125865,63,183516
12293,0.001035,172.217.194.0-255,5738,131603,63,183516
12294,0.001037,172.31.40.0-255,66,131669,63,183516
12295,0.001049,172.31.40.0-255,66,131735,63,183516
12296,0.001079,172.31.40.0-255,66,131801,63,183516
12297,0.00111,172.31.40.0-255,66,131867,63,183516
12298,0.001113,172.217.194.0-255,1484,133351,63,183516
12299,0.001137,172.31.40.0-255,66,133417,63,183516
12300,0.001165,172.217.194.0-255,2902,136319,63,183516
12301,0.001168,172.31.40.0-255,66,136385,63,183516
12302,0.001171,172.31.40.0-255,66,136451,63,183516
12303,0.001182,172.217.194.0-255,2184,138635,63,183516
12304,0.001184,172.31.40.0-255,66,138701,63,183516
12305,0.001213,172.217.194.0-255,5738,144439,63,183516
12306,0.001216,172.31.40.0-255,66,144505,63,183516
12307,0.001253,172.217.194.0-255,2902,147407,63,183516
12308,0.001255,172.31.40.0-255,66,147473,63,183516
12309,0.001285,172.217.194.0-255,5738,153211,63,183516
12310,0.001305,172.31.40.0-255,66,153277,63,183516
12311,0.001325,172.31.40.0-255,66,153343,63,183516
12312,0.001338,172.217.194.0-255,1484,154827,63,183516
12313,0.001351,172.217.194.0-255,2902,157729,63,183516
12314,0.001354,172.217.194.0-255,1484,159213,63,183516
12315,0.001366,172.217.194.0-255,4320,163533,63,183516
12316,0.001373,172.31.40.0-255,66,163599,63,183516
12317,0.001388,172.217.194.0-255,4320,167919,63,183516
12318,0.001405,172.217.194.0-255,7156,175075,63,183516
12319,0.001413,172.31.40.0-255,66,175141,63,183516
12320,0.001491,172.217.194.0-255,2902,178043,63,183516
12321,0.001495,172.31.40.0-255,66,178109,63,183516
12322,0.001499,172.31.40.0-255,66,178175,63,183516
12323,0.001542,172.217.194.0-255,4999,183174,63,183516
12324,0.001557,172.217.194.0-255,105,183279,63,183516
12325,0.001567,172.31.40.0-255,66,183345,63,183516
12326,0.010139,172.31.40.0-255,105,183450,63,183516
12327,0.012405,172.217.194.0-255,66,183516,63,183516
12328,0.0,74.125.68.0-255,147,147,63,77336
12329,2.3e-05,172.31.40.0-255,66,213,63,77336
12330,3.1e-05,74.125.68.0-255,1484,1697,63,77336
12331,3.5e-05,172.31.40.0-255,66,1763,63,77336
12332,4.8e-05,74.125.68.0-255,2902,4665,63,77336
12333,5.2e-05,172.31.40.0-255,66,4731,63,77336
12334,0.000144,74.125.68.0-255,7156,11887,63,77336
12335,0.000149,172.31.40.0-255,66,11953,63,77336
12336,0.000388,74.125.68.0-255,2102,14055,63,77336
12337,0.000394,172.31.40.0-255,66,14121,63,77336
12338,0.000464,74.125.68.0-255,5738,19859,63,77336
12339,0.000468,172.31.40.0-255,66,19925,63,77336
12340,0.00049,74.125.68.0-255,5738,25663,63,77336
12341,0.000493,172.31.40.0-255,66,25729,63,77336
12342,0.000848,74.125.68.0-255,2902,28631,63,77336
12343,0.000853,172.31.40.0-255,66,28697,63,77336
12344,0.00095,74.125.68.0-255,2902,31599,63,77336
12345,0.000954,172.31.40.0-255,66,31665,63,77336
12346,0.000994,172.31.40.0-255,66,31731,63,77336
12347,0.001646,172.31.40.0-255,66,31797,63,77336
12348,0.001676,74.125.68.0-255,1745,33542,63,77336
12349,0.001678,172.31.40.0-255,66,33608,63,77336
12350,0.002225,74.125.68.0-255,4320,37928,63,77336
12351,0.002228,172.31.40.0-255,66,37994,63,77336
12352,0.002265,172.31.40.0-255,66,38060,63,77336
12353,0.002869,74.125.68.0-255,4320,42380,63,77336
12354,0.002872,172.31.40.0-255,66,42446,63,77336
12355,0.00291,172.31.40.0-255,66,42512,63,77336
12356,0.005416,74.125.68.0-255,5738,48250,63,77336
12357,0.005515,172.31.40.0-255,66,48316,63,77336
12358,0.008019,74.125.68.0-255,5738,54054,63,77336
12359,0.008028,172.31.40.0-255,66,54120,63,77336
12360,0.010564,74.125.68.0-255,5738,59858,63,77336
12361,0.011255,172.31.40.0-255,66,59924,63,77336
12362,0.013772,74.125.68.0-255,5738,65662,63,77336
12363,0.013786,172.31.40.0-255,66,65728,63,77336
12364,0.016308,74.125.68.0-255,5738,71466,63,77336
12365,0.016319,172.31.40.0-255,66,71532,63,77336
12366,0.018829,74.125.68.0-255,5738,77270,63,77336
12367,0.01884,172.31.40.0-255,66,77336,63,77336
12368,0.0,74.125.24.0-255,155,155,63,197642
12369,2.1e-05,172.31.40.0-255,66,221,63,197642
12370,2.8e-05,74.125.24.0-255,1484,1705,63,197642
12371,3.2e-05,172.31.40.0-255,66,1771,63,197642
12372,3.7e-05,74.125.24.0-255,2902,4673,63,197642
12373,4e-05,172.31.40.0-255,66,4739,63,197642
12374,4.3e-05,74.125.24.0-255,1484,6223,63,197642
12375,4.6e-05,172.31.40.0-255,66,6289,63,197642
12376,5.3e-05,74.125.24.0-255,5738,12027,63,197642
12377,5.5e-05,172.31.40.0-255,66,12093,63,197642
12378,0.000112,172.31.40.0-255,66,12159,63,197642
12379,0.000138,74.125.24.0-255,7156,19315,63,197642
12380,0.000141,172.31.40.0-255,66,19381,63,197642
12381,0.000156,74.125.24.0-255,1484,20865,63,197642
12382,0.000158,172.31.40.0-255,66,20931,63,197642
12383,0.000162,74.125.24.0-255,2543,23474,63,197642
12384,0.000164,172.31.40.0-255,66,23540,63,197642
12385,0.000224,74.125.24.0-255,1484,25024,63,197642
12386,0.000227,172.31.40.0-255,66,25090,63,197642
12387,0.000249,74.125.24.0-255,2902,27992,63,197642
12388,0.000252,172.31.40.0-255,66,28058,63,197642
12389,0.000255,74.125.24.0-255,1484,29542,63,197642
12390,0.000257,172.31.40.0-255,66,29608,63,197642
12391,0.000275,74.125.24.0-255,4320,33928,63,197642
12392,0.000278,172.31.40.0-255,66,33994,63,197642
12393,0.000281,74.125.24.0-255,1484,35478,63,197642
12394,0.000283,172.31.40.0-255,66,35544,63,197642
12395,0.000313,74.125.24.0-255,5379,40923,63,197642
12396,0.000315,172.31.40.0-255,66,40989,63,197642
12397,0.000592,74.125.24.0-255,1484,42473,63,197642
12398,0.000597,172.31.40.0-255,66,42539,63,197642
12399,0.000603,74.125.24.0-255,2902,45441,63,197642
12400,0.000606,172.31.40.0-255,66,45507,63,197642
12401,0.000632,74.125.24.0-255,5738,51245,63,197642
12402,0.000634,172.31.40.0-255,66,51311,63,197642
12403,0.00064,74.125.24.0-255,4320,55631,63,197642
12404,0.000642,172.31.40.0-255,66,55697,63,197642
12405,0.000661,74.125.24.0-255,2543,58240,63,197642
12406,0.000664,172.31.40.0-255,66,58306,63,197642
12407,0.000666,74.125.24.0-255,412,58718,63,197642
12408,0.00081,74.125.24.0-255,330,59048,63,197642
12409,0.000848,74.125.24.0-255,1484,60532,63,197642
12410,0.000851,172.31.40.0-255,66,60598,63,197642
12411,0.00087,74.125.24.0-255,2902,63500,63,197642
12412,0.000873,172.31.40.0-255,66,63566,63,197642
12413,0.000884,74.125.24.0-255,1484,65050,63,197642
12414,0.00089,74.125.24.0-255,5738,70788,63,197642
12415,0.000892,172.31.40.0-255,66,70854,63,197642
12416,0.000906,74.125.24.0-255,2902,73756,63,197642
12417,0.000908,172.31.40.0-255,66,73822,63,197642
12418,0.000946,74.125.24.0-255,2543,76365,63,197642
12419,0.000949,172.31.40.0-255,66,76431,63,197642
12420,0.001178,74.125.24.0-255,1484,77915,63,197642
12421,0.001195,74.125.24.0-255,2902,80817,63,197642
12422,0.001198,172.31.40.0-255,66,80883,63,197642
12423,0.001202,74.125.24.0-255,1484,82367,63,197642
12424,0.001223,74.125.24.0-255,4320,86687,63,197642
12425,0.001225,172.31.40.0-255,66,86753,63,197642
12426,0.001243,74.125.24.0-255,4320,91073,63,197642
12427,0.001246,172.31.40.0-255,66,91139,63,197642
12428,0.001265,74.125.24.0-255,2543,93682,63,197642
12429,0.001268,172.31.40.0-255,66,93748,63,197642
12430,0.001292,74.125.24.0-255,7156,100904,63,197642
12431,0.001295,172.31.40.0-255,66,100970,63,197642
12432,0.001311,74.125.24.0-255,1484,102454,63,197642
12433,0.001336,172.31.40.0-255,66,102520,63,197642
12434,0.001349,172.31.40.0-255,66,102586,63,197642
12435,0.001353,74.125.24.0-255,1484,104070,63,197642
12436,0.001373,74.125.24.0-255,3602,107672,63,197642
12437,0.001376,172.31.40.0-255,66,107738,63,197642
12438,0.001413,74.125.24.0-255,1484,109222,63,197642
12439,0.001417,74.125.24.0-255,1484,110706,63,197642
12440,0.001419,172.31.40.0-255,66,110772,63,197642
12441,0.001434,74.125.24.0-255,1484,112256,63,197642
12442,0.001442,74.125.24.0-255,5738,117994,63,197642
12443,0.001445,172.31.40.0-255,66,118060,63,197642
12444,0.001449,74.125.24.0-255,2902,120962,63,197642
12445,0.001451,172.31.40.0-255,66,121028,63,197642
12446,0.001467,74.125.24.0-255,2902,123930,63,197642
12447,0.00147,172.31.40.0-255,66,123996,63,197642
12448,0.001477,74.125.24.0-255,5738,129734,63,197642
12449,0.001479,172.31.40.0-255,66,129800,63,197642
12450,0.001508,74.125.24.0-255,7156,136956,63,197642
12451,0.001512,172.31.40.0-255,66,137022,63,197642
12452,0.001518,74.125.24.0-255,5020,142042,63,197642
12453,0.00152,172.31.40.0-255,66,142108,63,197642
12454,0.001914,74.125.24.0-255,1484,143592,63,197642
12455,0.001942,74.125.24.0-255,2902,146494,63,197642
12456,0.001946,172.31.40.0-255,66,146560,63,197642
12457,0.001952,74.125.24.0-255,4320,150880,63,197642
12458,0.001954,172.31.40.0-255,66,150946,63,197642
12459,0.001991,172.31.40.0-255,66,151012,63,197642
12460,0.00205,172.31.40.0-255,66,151078,63,197642
12461,0.002077,172.31.40.0-255,66,151144,63,197642
12462,0.004091,74.125.24.0-255,5738,156882,63,197642
12463,0.004097,172.31.40.0-255,66,156948,63,197642
12464,0.006156,74.125.24.0-255,1484,158432,63,197642
12465,0.006171,74.125.24.0-255,4320,162752,63,197642
12466,0.006174,172.31.40.0-255,66,162818,63,197642
12467,0.008243,74.125.24.0-255,5738,168556,63,197642
12468,0.00825,172.31.40.0-255,66,168622,63,197642
12469,0.0103,74.125.24.0-255,5738,174360,63,197642
12470,0.010308,172.31.40.0-255,66,174426,63,197642
12471,0.012375,74.125.24.0-255,5738,180164,63,197642
12472,0.012385,172.31.40.0-255,66,180230,63,197642
12473,0.014427,74.125.24.0-255,5738,185968,63,197642
12474,0.014436,172.31.40.0-255,66,186034,63,197642
12475,0.016489,74.125.24.0-255,5738,191772,63,197642
12476,0.016499,172.31.40.0-255,66,191838,63,197642
12477,0.018538,74.125.24.0-255,5738,197576,63,197642
12478,0.018545,172.31.40.0-255,66,197642,63,197642
12479,0.0,172.217.160.0-255,294,294,63,211806
12480,2.4e-05,172.31.40.0-255,66,360,63,211806
12481,3.1e-05,172.217.160.0-255,1484,1844,63,211806
12482,3.6e-05,172.31.40.0-255,66,1910,63,211806
12483,4.3e-05,172.217.160.0-255,4320,6230,63,211806
12484,4.7e-05,172.31.40.0-255,66,6296,63,211806
12485,5.8e-05,172.31.40.0-255,66,6362,63,211806
12486,7.1e-05,172.31.40.0-255,66,6428,63,211806
12487,0.000102,172.217.160.0-255,4320,10748,63,211806
12488,0.000105,172.31.40.0-255,66,10814,63,211806
12489,0.00011,172.217.160.0-255,2543,13357,63,211806
12490,0.000112,172.31.40.0-255,66,13423,63,211806
12491,0.000163,172.217.160.0-255,1484,14907,63,211806
12492,0.000166,172.31.40.0-255,66,14973,63,211806
12493,0.000171,172.217.160.0-255,2902,17875,63,211806
12494,0.000173,172.31.40.0-255,66,17941,63,211806
12495,0.000178,172.217.160.0-255,4320,22261,63,211806
12496,0.00018,172.31.40.0-255,66,22327,63,211806
12497,0.000205,172.217.160.0-255,1484,23811,63,211806
12498,0.000208,172.31.40.0-255,66,23877,63,211806
12499,0.000219,172.31.40.0-255,66,23943,63,211806
12500,0.000257,172.217.160.0-255,4320,28263,63,211806
12501,0.00026,172.31.40.0-255,66,28329,63,211806
12502,0.000306,172.31.40.0-255,66,28395,63,211806
12503,0.000547,172.217.160.0-255,103,28498,63,211806
12504,0.000553,172.31.40.0-255,66,28564,63,211806
12505,0.000689,172.217.160.0-255,1484,30048,63,211806
12506,0.000693,172.31.40.0-255,66,30114,63,211806
12507,0.000715,172.217.160.0-255,2902,33016,63,211806
12508,0.000722,172.217.160.0-255,5738,38754,63,211806
12509,0.000769,172.31.40.0-255,66,38820,63,211806
12510,0.000778,172.217.160.0-255,2902,41722,63,211806
12511,0.000789,172.217.160.0-255,766,42488,63,211806
12512,0.000796,172.31.40.0-255,66,42554,63,211806
12513,0.000817,172.217.160.0-255,1484,44038,63,211806
12514,0.000823,172.217.160.0-255,4320,48358,63,211806
12515,0.000836,172.31.40.0-255,66,48424,63,211806
12516,0.000883,172.31.40.0-255,66,48490,63,211806
12517,0.000899,172.217.160.0-255,7156,55646,63,211806
12518,0.000919,172.217.160.0-255,2184,57830,63,211806
12519,0.000931,172.31.40.0-255,66,57896,63,211806
12520,0.000941,172.31.40.0-255,66,57962,63,211806
12521,0.000979,172.31.40.0-255,66,58028,63,211806
12522,0.000993,172.217.160.0-255,5738,63766,63,211806
12523,0.001009,172.31.40.0-255,66,63832,63,211806
12524,0.001021,172.217.160.0-255,5738,69570,63,211806
12525,0.001025,172.217.160.0-255,3602,73172,63,211806
12526,0.001038,172.31.40.0-255,66,73238,63,211806
12527,0.001153,172.217.160.0-255,1484,74722,63,211806
12528,0.001159,172.217.160.0-255,2902,77624,63,211806
12529,0.001164,172.31.40.0-255,66,77690,63,211806
12530,0.001175,172.217.160.0-255,5738,83428,63,211806
12531,0.00118,172.31.40.0-255,66,83494,63,211806
12532,0.001191,172.217.160.0-255,2902,86396,63,211806
12533,0.001226,172.217.160.0-255,7156,93552,63,211806
12534,0.00123,172.31.40.0-255,66,93618,63,211806
12535,0.001276,172.217.160.0-255,3602,97220,63,211806
12536,0.001283,172.217.160.0-255,4320,101540,63,211806
12537,0.00129,172.31.40.0-255,66,101606,63,211806
12538,0.001355,172.217.160.0-255,5738,107344,63,211806
12539,0.001359,172.31.40.0-255,66,107410,63,211806
12540,0.001371,172.217.160.0-255,2184,109594,63,211806
12541,0.001398,172.217.160.0-255,5738,115332,63,211806
12542,0.00143,172.217.160.0-255,6438,121770,63,211806
12543,0.001476,172.31.40.0-255,66,121836,63,211806
12544,0.001479,172.217.160.0-255,1484,123320,63,211806
12545,0.001483,172.217.160.0-255,2902,126222,63,211806
12546,0.001486,172.217.160.0-255,1484,127706,63,211806
12547,0.001498,172.217.160.0-255,4320,132026,63,211806
12548,0.001501,172.31.40.0-255,66,132092,63,211806
12549,0.00151,172.217.160.0-255,1484,133576,63,211806
12550,0.001523,172.217.160.0-255,4320,137896,63,211806
12551,0.00154,172.217.160.0-255,2902,140798,63,211806
12552,0.001546,172.217.160.0-255,4320,145118,63,211806
12553,0.001551,172.31.40.0-255,66,145184,63,211806
12554,0.001559,172.217.160.0-255,2902,148086,63,211806
12555,0.00157,172.31.40.0-255,66,148152,63,211806
12556,0.001575,172.217.160.0-255,2902,151054,63,211806
12557,0.00158,172.217.160.0-255,5020,156074,63,211806
12558,0.001604,172.31.40.0-255,66,156140,63,211806
12559,0.001637,172.217.160.0-255,1484,157624,63,211806
12560,0.001643,172.217.160.0-255,2902,160526,63,211806
12561,0.001647,172.217.160.0-255,2902,163428,63,211806
12562,0.001652,172.31.40.0-255,66,163494,63,211806
12563,0.001672,172.217.160.0-255,2902,166396,63,211806
12564,0.001675,172.217.160.0-255,1484,167880,63,211806
12565,0.001687,172.217.160.0-255,2902,170782,63,211806
12566,0.001695,172.31.40.0-255,66,170848,63,211806
12567,0.001707,172.217.160.0-255,2902,173750,63,211806
12568,0.001724,172.31.40.0-255,66,173816,63,211806
12569,0.003359,172.217.160.0-255,2902,176718,63,211806
12570,0.003365,172.31.40.0-255,66,176784,63,211806
12571,0.003396,172.217.160.0-255,2902,179686,63,211806
12572,0.003407,172.31.40.0-255,66,179752,63,211806
12573,0.005062,172.217.160.0-255,2902,182654,63,211806
12574,0.005068,172.31.40.0-255,66,182720,63,211806
12575,0.005096,172.217.160.0-255,2902,185622,63,211806
12576,0.006716,172.217.160.0-255,2902,188524,63,211806
12577,0.009876,172.31.40.0-255,66,188590,63,211806
12578,0.011554,172.217.160.0-255,5738,194328,63,211806
12579,0.011562,172.31.40.0-255,66,194394,63,211806
12580,0.013233,172.217.160.0-255,2902,197296,63,211806
12581,0.013254,172.217.160.0-255,2902,200198,63,211806
12582,0.015684,172.31.40.0-255,66,200264,63,211806
12583,0.017368,172.217.160.0-255,5738,206002,63,211806
12584,0.017379,172.31.40.0-255,66,206068,63,211806
12585,0.019056,172.217.160.0-255,5738,211806,63,211806
12586,0.0,172.31.40.0-255,250,250,63,316
12587,0.006884,172.217.194.0-255,66,316,63,316
12588,0.0,74.125.24.0-255,153,153,63,137966
12589,1.5e-05,172.31.40.0-255,66,219,63,137966
12590,2.1e-05,74.125.24.0-255,1484,1703,63,137966
12591,2.5e-05,172.31.40.0-255,66,1769,63,137966
12592,3.1e-05,74.125.24.0-255,2902,4671,63,137966
12593,3.5e-05,172.31.40.0-255,66,4737,63,137966
12594,4.2e-05,74.125.24.0-255,7156,11893,63,137966
12595,4.5e-05,172.31.40.0-255,66,11959,63,137966
12596,8.5e-05,74.125.24.0-255,1484,13443,63,137966
12597,8.8e-05,172.31.40.0-255,66,13509,63,137966
12598,0.000113,172.31.40.0-255,66,13575,63,137966
12599,0.000207,74.125.24.0-255,7156,20731,63,137966
12600,0.000212,172.31.40.0-255,66,20797,63,137966
12601,0.000234,74.125.24.0-255,6797,27594,63,137966
12602,0.000237,172.31.40.0-255,66,27660,63,137966
12603,0.000319,74.125.24.0-255,4320,31980,63,137966
12604,0.000323,172.31.40.0-255,66,32046,63,137966
12605,0.00036,172.31.40.0-255,66,32112,63,137966
12606,0.00048,74.125.24.0-255,5020,37132,63,137966
12607,0.000485,172.31.40.0-255,66,37198,63,137966
12608,0.000502,74.125.24.0-255,646,37844,63,137966
12609,0.000505,172.31.40.0-255,66,37910,63,137966
12610,0.00081,74.125.24.0-255,1484,39394,63,137966
12611,0.000814,172.31.40.0-255,66,39460,63,137966
12612,0.000819,74.125.24.0-255,2902,42362,63,137966
12613,0.000821,172.31.40.0-255,66,42428,63,137966
12614,0.000826,74.125.24.0-255,2902,45330,63,137966
12615,0.000828,172.31.40.0-255,66,45396,63,137966
12616,0.000853,74.125.24.0-255,2902,48298,63,137966
12617,0.000856,172.31.40.0-255,66,48364,63,137966
12618,0.000859,74.125.24.0-255,1484,49848,63,137966
12619,0.000883,172.31.40.0-255,66,49914,63,137966
12620,0.000971,74.125.24.0-255,1484,51398,63,137966
12621,0.000978,74.125.24.0-255,4320,55718,63,137966
12622,0.000981,172.31.40.0-255,66,55784,63,137966
12623,0.001003,74.125.24.0-255,5020,60804,63,137966
12624,0.001006,172.31.40.0-255,66,60870,63,137966
12625,0.001058,74.125.24.0-255,1484,62354,63,137966
12626,0.00109,172.31.40.0-255,66,62420,63,137966
12627,0.001173,172.31.40.0-255,66,62486,63,137966
12628,0.001192,74.125.24.0-255,1484,63970,63,137966
12629,0.00125,74.125.24.0-255,4320,68290,63,137966
12630,0.001254,172.31.40.0-255,66,68356,63,137966
12631,0.001278,74.125.24.0-255,6438,74794,63,137966
12632,0.001281,172.31.40.0-255,66,74860,63,137966
12633,0.001567,74.125.24.0-255,1484,76344,63,137966
12634,0.001573,74.125.24.0-255,2902,79246,63,137966
12635,0.001576,172.31.40.0-255,66,79312,63,137966
12636,0.001599,74.125.24.0-255,4320,83632,63,137966
12637,0.001601,172.31.40.0-255,66,83698,63,137966
12638,0.00164,74.125.24.0-255,5738,89436,63,137966
12639,0.001643,172.31.40.0-255,66,89502,63,137966
12640,0.001663,74.125.24.0-255,2902,92404,63,137966
12641,0.001666,172.31.40.0-255,66,92470,63,137966
12642,0.001685,172.31.40.0-255,66,92536,63,137966
12643,0.001762,74.125.24.0-255,4320,96856,63,137966
12644,0.001766,172.31.40.0-255,66,96922,63,137966
12645,0.001804,74.125.24.0-255,3602,100524,63,137966
12646,0.001806,172.31.40.0-255,66,100590,63,137966
12647,0.001824,74.125.24.0-255,1484,102074,63,137966
12648,0.001851,74.125.24.0-255,2902,104976,63,137966
12649,0.001854,172.31.40.0-255,66,105042,63,137966
12650,0.001863,74.125.24.0-255,7156,112198,63,137966
12651,0.001865,172.31.40.0-255,66,112264,63,137966
12652,0.00189,74.125.24.0-255,2902,115166,63,137966
12653,0.001892,172.31.40.0-255,66,115232,63,137966
12654,0.00193,74.125.24.0-255,1484,116716,63,137966
12655,0.00196,172.31.40.0-255,66,116782,63,137966
12656,0.001993,172.31.40.0-255,66,116848,63,137966
12657,0.002102,74.125.24.0-255,7156,124004,63,137966
12658,0.002106,172.31.40.0-255,66,124070,63,137966
12659,0.002128,74.125.24.0-255,5738,129808,63,137966
12660,0.002131,172.31.40.0-255,66,129874,63,137966
12661,0.002224,172.31.40.0-255,66,129940,63,137966
12662,0.002268,172.31.40.0-255,66,130006,63,137966
12663,0.002478,74.125.24.0-255,7156,137162,63,137966
12664,0.002482,172.31.40.0-255,66,137228,63,137966
12665,0.002526,172.31.40.0-255,66,137294,63,137966
12666,0.00274,172.31.40.0-255,66,137360,63,137966
12667,0.002841,172.31.40.0-255,66,137426,63,137966
12668,0.002865,172.31.40.0-255,66,137492,63,137966
12669,0.003275,172.31.40.0-255,66,137558,63,137966
12670,0.003337,172.31.40.0-255,66,137624,63,137966
12671,0.005634,74.125.24.0-255,105,137729,63,137966
12672,0.014018,172.31.40.0-255,66,137795,63,137966
12673,0.014068,172.31.40.0-255,105,137900,63,137966
12674,0.016393,74.125.24.0-255,66,137966,63,137966
12675,0.0,74.125.24.0-255,153,153,63,211558
12676,2.6e-05,172.31.40.0-255,66,219,63,211558
12677,3.6e-05,74.125.24.0-255,1484,1703,63,211558
12678,4.1e-05,172.31.40.0-255,66,1769,63,211558
12679,4.8e-05,74.125.24.0-255,2902,4671,63,211558
12680,5.1e-05,172.31.40.0-255,66,4737,63,211558
12681,6e-05,74.125.24.0-255,7156,11893,63,211558
12682,6.4e-05,172.31.40.0-255,66,11959,63,211558
12683,6.8e-05,74.125.24.0-255,1901,13860,63,211558
12684,7.1e-05,172.31.40.0-255,66,13926,63,211558
12685,0.000264,74.125.24.0-255,1484,15410,63,211558
12686,0.00027,172.31.40.0-255,66,15476,63,211558
12687,0.000277,74.125.24.0-255,2902,18378,63,211558
12688,0.00028,172.31.40.0-255,66,18444,63,211558
12689,0.000285,74.125.24.0-255,2902,21346,63,211558
12690,0.000288,172.31.40.0-255,66,21412,63,211558
12691,0.000308,74.125.24.0-255,2902,24314,63,211558
12692,0.000311,172.31.40.0-255,66,24380,63,211558
12693,0.000318,74.125.24.0-255,5738,30118,63,211558
12694,0.000321,172.31.40.0-255,66,30184,63,211558
12695,0.000369,74.125.24.0-255,1125,31309,63,211558
12696,0.000372,172.31.40.0-255,66,31375,63,211558
12697,0.000462,74.125.24.0-255,1484,32859,63,211558
12698,0.000467,172.31.40.0-255,66,32925,63,211558
12699,0.000472,74.125.24.0-255,2902,35827,63,211558
12700,0.000475,172.31.40.0-255,66,35893,63,211558
12701,0.000478,74.125.24.0-255,1484,37377,63,211558
12702,0.00048,172.31.40.0-255,66,37443,63,211558
12703,0.000501,74.125.24.0-255,4320,41763,63,211558
12704,0.000504,172.31.40.0-255,66,41829,63,211558
12705,0.000516,172.31.40.0-255,66,41895,63,211558
12706,0.000636,74.125.24.0-255,374,42269,63,211558
12707,0.00087,172.31.40.0-255,66,42335,63,211558
12708,0.001371,74.125.24.0-255,1484,43819,63,211558
12709,0.001378,74.125.24.0-255,2902,46721,63,211558
12710,0.001383,74.125.24.0-255,2902,49623,63,211558
12711,0.001397,74.125.24.0-255,2902,52525,63,211558
12712,0.0014,74.125.24.0-255,2902,55427,63,211558
12713,0.00141,172.31.40.0-255,66,55493,63,211558
12714,0.001431,74.125.24.0-255,4320,59813,63,211558
12715,0.001436,172.31.40.0-255,66,59879,63,211558
12716,0.001453,74.125.24.0-255,4320,64199,63,211558
12717,0.001458,74.125.24.0-255,2184,66383,63,211558
12718,0.001475,172.31.40.0-255,66,66449,63,211558
12719,0.002941,74.125.24.0-255,1484,67933,63,211558
12720,0.002956,74.125.24.0-255,2902,70835,63,211558
12721,0.002963,172.31.40.0-255,66,70901,63,211558
12722,0.002971,74.125.24.0-255,4320,75221,63,211558
12723,0.00299,74.125.24.0-255,1484,76705,63,211558
12724,0.002994,74.125.24.0-255,2902,79607,63,211558
12725,0.00302,74.125.24.0-255,5738,85345,63,211558
12726,0.00305,74.125.24.0-255,5020,90365,63,211558
12727,0.003395,74.125.24.0-255,1484,91849,63,211558
12728,0.003408,74.125.24.0-255,2902,94751,63,211558
12729,0.003431,74.125.24.0-255,4320,99071,63,211558
12730,0.003441,74.125.24.0-255,1484,100555,63,211558
12731,0.003457,74.125.24.0-255,4320,104875,63,211558
12732,0.003471,74.125.24.0-255,4320,109195,63,211558
12733,0.003487,74.125.24.0-255,1484,110679,63,211558
12734,0.003506,74.125.24.0-255,4320,114999,63,211558
12735,0.003545,74.125.24.0-255,766,115765,63,211558
12736,0.004436,74.125.24.0-255,1484,117249,63,211558
12737,0.004442,74.125.24.0-255,1484,118733,63,211558
12738,0.004454,74.125.24.0-255,1484,120217,63,211558
12739,0.004468,74.125.24.0-255,4320,124537,63,211558
12740,0.004492,74.125.24.0-255,1484,126021,63,211558
12741,0.004501,74.125.24.0-255,7156,133177,63,211558
12742,0.004527,74.125.24.0-255,5738,138915,63,211558
12743,0.004532,74.125.24.0-255,2184,141099,63,211558
12744,0.004876,74.125.24.0-255,1484,142583,63,211558
12745,0.004896,74.125.24.0-255,2902,145485,63,211558
12746,0.004903,74.125.24.0-255,5738,151223,63,211558
12747,0.005011,74.125.24.0-255,7156,158379,63,211558
12748,0.005063,74.125.24.0-255,3602,161981,63,211558
12749,0.005117,74.125.24.0-255,1484,163465,63,211558
12750,0.005135,74.125.24.0-255,5738,169203,63,211558
12751,0.005177,74.125.24.0-255,7156,176359,63,211558
12752,0.005199,74.125.24.0-255,4320,180679,63,211558
12753,0.005206,74.125.24.0-255,5738,186417,63,211558
12754,0.005273,74.125.24.0-255,3602,190019,63,211558
12755,0.00528,74.125.24.0-255,6438,196457,63,211558
12756,0.005426,74.125.24.0-255,1484,197941,63,211558
12757,0.005431,74.125.24.0-255,1484,199425,63,211558
12758,0.00545,74.125.24.0-255,1484,200909,63,211558
12759,0.005457,74.125.24.0-255,5738,206647,63,211558
12760,0.005462,74.125.24.0-255,2902,209549,63,211558
12761,0.005526,74.125.24.0-255,1484,211033,63,211558
12762,0.005556,74.125.24.0-255,105,211138,63,211558
12763,0.01173,172.31.40.0-255,66,211204,63,211558
12764,0.013873,74.125.24.0-255,105,211309,63,211558
12765,0.013887,172.31.40.0-255,78,211387,63,211558
12766,0.014246,172.31.40.0-255,105,211492,63,211558
12767,0.016541,74.125.24.0-255,66,211558,63,211558
12768,0.0,172.217.194.0-255,153,153,63,277362
12769,2.1e-05,172.31.40.0-255,66,219,63,277362
12770,2.8e-05,172.217.194.0-255,1484,1703,63,277362
12771,3.2e-05,172.31.40.0-255,66,1769,63,277362
12772,3.7e-05,172.217.194.0-255,2902,4671,63,277362
12773,4.9e-05,172.31.40.0-255,66,4737,63,277362
12774,5.6e-05,172.217.194.0-255,7156,11893,63,277362
12775,5.9e-05,172.31.40.0-255,66,11959,63,277362
12776,6.3e-05,172.217.194.0-255,1928,13887,63,277362
12777,6.6e-05,172.31.40.0-255,66,13953,63,277362
12778,0.000118,172.217.194.0-255,1484,15437,63,277362
12779,0.00012,172.31.40.0-255,66,15503,63,277362
12780,0.000124,172.217.194.0-255,2902,18405,63,277362
12781,0.000126,172.31.40.0-255,66,18471,63,277362
12782,0.00013,172.217.194.0-255,2902,21373,63,277362
12783,0.000132,172.31.40.0-255,66,21439,63,277362
12784,0.000165,172.217.194.0-255,2902,24341,63,277362
12785,0.000167,172.31.40.0-255,66,24407,63,277362
12786,0.000173,172.217.194.0-255,5738,30145,63,277362
12787,0.000175,172.31.40.0-255,66,30211,63,277362
12788,0.000178,172.217.194.0-255,1125,31336,63,277362
12789,0.00018,172.31.40.0-255,66,31402,63,277362
12790,0.000207,172.217.194.0-255,1484,32886,63,277362
12791,0.000209,172.31.40.0-255,66,32952,63,277362
12792,0.000214,172.217.194.0-255,4320,37272,63,277362
12793,0.000216,172.31.40.0-255,66,37338,63,277362
12794,0.000244,172.217.194.0-255,5738,43076,63,277362
12795,0.000247,172.31.40.0-255,66,43142,63,277362
12796,0.000271,172.217.194.0-255,4320,47462,63,277362
12797,0.000273,172.31.40.0-255,66,47528,63,277362
12798,0.000275,172.217.194.0-255,1125,48653,63,277362
12799,0.000277,172.31.40.0-255,66,48719,63,277362
12800,0.000963,172.217.194.0-255,1484,50203,63,277362
12801,0.000975,172.217.194.0-255,2902,53105,63,277362
12802,0.000979,172.31.40.0-255,66,53171,63,277362
12803,0.000987,172.217.194.0-255,4320,57491,63,277362
12804,0.000989,172.31.40.0-255,66,57557,63,277362
12805,0.001016,172.217.194.0-255,1484,59041,63,277362
12806,0.001028,172.217.194.0-255,6797,65838,63,277362
12807,0.001031,172.31.40.0-255,66,65904,63,277362
12808,0.001078,172.217.194.0-255,1484,67388,63,277362
12809,0.001084,172.217.194.0-255,2902,70290,63,277362
12810,0.001087,172.31.40.0-255,66,70356,63,277362
12811,0.00109,172.217.194.0-255,1484,71840,63,277362
12812,0.001117,172.217.194.0-255,4320,76160,63,277362
12813,0.001119,172.31.40.0-255,66,76226,63,277362
12814,0.001128,172.217.194.0-255,6797,83023,63,277362
12815,0.00113,172.31.40.0-255,66,83089,63,277362
12816,0.001168,172.217.194.0-255,2902,85991,63,277362
12817,0.001171,172.31.40.0-255,66,86057,63,277362
12818,0.001207,172.31.40.0-255,66,86123,63,277362
12819,0.001212,172.217.194.0-255,2902,89025,63,277362
12820,0.001214,172.31.40.0-255,66,89091,63,277362
12821,0.001237,172.217.194.0-255,1125,90216,63,277362
12822,0.001288,172.217.194.0-255,1484,91700,63,277362
12823,0.001291,172.31.40.0-255,66,91766,63,277362
12824,0.001298,172.217.194.0-255,2902,94668,63,277362
12825,0.001301,172.31.40.0-255,66,94734,63,277362
12826,0.001305,172.217.194.0-255,2902,97636,63,277362
12827,0.001313,172.31.40.0-255,66,97702,63,277362
12828,0.001338,172.217.194.0-255,2902,100604,63,277362
12829,0.00134,172.31.40.0-255,66,100670,63,277362
12830,0.001347,172.217.194.0-255,5738,106408,63,277362
12831,0.00135,172.31.40.0-255,66,106474,63,277362
12832,0.001353,172.217.194.0-255,561,107035,63,277362
12833,0.001423,172.217.194.0-255,1484,108519,63,277362
12834,0.001427,172.31.40.0-255,66,108585,63,277362
12835,0.001432,172.217.194.0-255,2902,111487,63,277362
12836,0.001435,172.31.40.0-255,66,111553,63,277362
12837,0.001462,172.217.194.0-255,5738,117291,63,277362
12838,0.001465,172.31.40.0-255,66,117357,63,277362
12839,0.001471,172.217.194.0-255,5738,123095,63,277362
12840,0.001473,172.31.40.0-255,66,123161,63,277362
12841,0.001496,172.217.194.0-255,2902,126063,63,277362
12842,0.001499,172.31.40.0-255,66,126129,63,277362
12843,0.00154,172.31.40.0-255,66,126195,63,277362
12844,0.001875,172.217.194.0-255,1484,127679,63,277362
12845,0.001883,172.217.194.0-255,2902,130581,63,277362
12846,0.001888,172.31.40.0-255,66,130647,63,277362
12847,0.001895,172.217.194.0-255,4320,134967,63,277362
12848,0.001897,172.31.40.0-255,66,135033,63,277362
12849,0.001915,172.217.194.0-255,1484,136517,63,277362
12850,0.001921,172.217.194.0-255,4320,140837,63,277362
12851,0.001923,172.31.40.0-255,66,140903,63,277362
12852,0.001951,172.31.40.0-255,66,140969,63,277362
12853,0.001962,172.31.40.0-255,66,141035,63,277362
12854,0.00202,172.217.194.0-255,1484,142519,63,277362
12855,0.002024,172.217.194.0-255,2902,145421,63,277362
12856,0.002026,172.31.40.0-255,66,145487,63,277362
12857,0.002033,172.217.194.0-255,5738,151225,63,277362
12858,0.002036,172.31.40.0-255,66,151291,63,277362
12859,0.002077,172.31.40.0-255,66,151357,63,277362
12860,0.00208,172.217.194.0-255,1484,152841,63,277362
12861,0.002113,172.31.40.0-255,66,152907,63,277362
12862,0.002262,172.217.194.0-255,1484,154391,63,277362
12863,0.002278,172.217.194.0-255,2902,157293,63,277362
12864,0.00228,172.31.40.0-255,66,157359,63,277362
12865,0.002284,172.217.194.0-255,1484,158843,63,277362
12866,0.002309,172.217.194.0-255,4320,163163,63,277362
12867,0.002312,172.31.40.0-255,66,163229,63,277362
12868,0.002317,172.217.194.0-255,4320,167549,63,277362
12869,0.00232,172.31.40.0-255,66,167615,63,277362
12870,0.002322,172.217.194.0-255,1484,169099,63,277362
12871,0.00235,172.31.40.0-255,66,169165,63,277362
12872,0.002353,172.217.194.0-255,1484,170649,63,277362
12873,0.002358,172.217.194.0-255,2902,173551,63,277362
12874,0.002362,172.217.194.0-255,2902,176453,63,277362
12875,0.002402,172.217.194.0-255,2184,178637,63,277362
12876,0.00245,172.217.194.0-255,1484,180121,63,277362
12877,0.002463,172.217.194.0-255,2902,183023,63,277362
12878,0.002475,172.217.194.0-255,1484,184507,63,277362
12879,0.002489,172.217.194.0-255,2902,187409,63,277362
12880,0.002492,172.217.194.0-255,1484,188893,63,277362
12881,0.002505,172.217.194.0-255,2902,191795,63,277362
12882,0.002519,172.217.194.0-255,4320,196115,63,277362
12883,0.002523,172.217.194.0-255,2902,199017,63,277362
12884,0.002527,172.217.194.0-255,1484,200501,63,277362
12885,0.002549,172.217.194.0-255,7156,207657,63,277362
12886,0.002566,172.217.194.0-255,1484,209141,63,277362
12887,0.002571,172.217.194.0-255,2902,212043,63,277362
12888,0.002573,172.217.194.0-255,766,212809,63,277362
12889,0.002749,172.217.194.0-255,1484,214293,63,277362
12890,0.002762,172.217.194.0-255,2902,217195,63,277362
12891,0.002784,172.217.194.0-255,5738,222933,63,277362
12892,0.002802,172.217.194.0-255,4320,227253,63,277362
12893,0.002814,172.217.194.0-255,2902,230155,63,277362
12894,0.00283,172.217.194.0-255,2902,233057,63,277362
12895,0.002864,172.217.194.0-255,2184,235241,63,277362
12896,0.002918,172.217.194.0-255,1484,236725,63,277362
12897,0.002931,172.217.194.0-255,2902,239627,63,277362
12898,0.00295,172.217.194.0-255,4320,243947,63,277362
12899,0.002966,172.217.194.0-255,1484,245431,63,277362
12900,0.002982,172.217.194.0-255,5738,251169,63,277362
12901,0.002998,172.217.194.0-255,1484,252653,63,277362
12902,0.003012,172.217.194.0-255,7156,259809,63,277362
12903,0.003044,172.217.194.0-255,2902,262711,63,277362
12904,0.003155,172.217.194.0-255,5738,268449,63,277362
12905,0.003179,172.217.194.0-255,1484,269933,63,277362
12906,0.0032,172.217.194.0-255,6904,276837,63,277362
12907,0.003203,172.217.194.0-255,105,276942,63,277362
12908,0.011928,172.31.40.0-255,66,277008,63,277362
12909,0.012388,172.217.194.0-255,105,277113,63,277362
12910,0.0124,172.31.40.0-255,78,277191,63,277362
12911,0.015171,172.31.40.0-255,105,277296,63,277362
12912,0.017454,172.217.194.0-255,66,277362,63,277362
12913,0.0,74.125.24.0-255,151,151,63,153498
12914,2e-05,172.31.40.0-255,66,217,63,153498
12915,2.7e-05,74.125.24.0-255,1484,1701,63,153498
12916,3.1e-05,172.31.40.0-255,66,1767,63,153498
12917,5.9e-05,74.125.24.0-255,2902,4669,63,153498
12918,6.2e-05,172.31.40.0-255,66,4735,63,153498
12919,6.8e-05,74.125.24.0-255,4320,9055,63,153498
12920,7.1e-05,172.31.40.0-255,66,9121,63,153498
12921,0.000106,74.125.24.0-255,4776,13897,63,153498
12922,0.000109,172.31.40.0-255,66,13963,63,153498
12923,0.000149,74.125.24.0-255,5738,19701,63,153498
12924,0.000154,172.31.40.0-255,66,19767,63,153498
12925,0.000176,74.125.24.0-255,7156,26923,63,153498
12926,0.000179,172.31.40.0-255,66,26989,63,153498
12927,0.000199,74.125.24.0-255,3961,30950,63,153498
12928,0.000202,172.31.40.0-255,66,31016,63,153498
12929,0.000265,74.125.24.0-255,1484,32500,63,153498
12930,0.000268,172.31.40.0-255,66,32566,63,153498
12931,0.000273,74.125.24.0-255,2902,35468,63,153498
12932,0.000275,172.31.40.0-255,66,35534,63,153498
12933,0.00028,74.125.24.0-255,4320,39854,63,153498
12934,0.000282,172.31.40.0-255,66,39920,63,153498
12935,0.000312,74.125.24.0-255,1484,41404,63,153498
12936,0.000314,172.31.40.0-255,66,41470,63,153498
12937,0.000319,74.125.24.0-255,5738,47208,63,153498
12938,0.000321,172.31.40.0-255,66,47274,63,153498
12939,0.000338,74.125.24.0-255,1125,48399,63,153498
12940,0.00034,172.31.40.0-255,66,48465,63,153498
12941,0.0005,74.125.24.0-255,1484,49949,63,153498
12942,0.000504,172.31.40.0-255,66,50015,63,153498
12943,0.000509,74.125.24.0-255,2902,52917,63,153498
12944,0.000512,172.31.40.0-255,66,52983,63,153498
12945,0.000536,74.125.24.0-255,5738,58721,63,153498
12946,0.000539,172.31.40.0-255,66,58787,63,153498
12947,0.000558,74.125.24.0-255,6797,65584,63,153498
12948,0.00057,172.31.40.0-255,66,65650,63,153498
12949,0.000586,74.125.24.0-255,648,66298,63,153498
12950,0.000941,74.125.24.0-255,1484,67782,63,153498
12951,0.000946,74.125.24.0-255,2902,70684,63,153498
12952,0.000951,172.31.40.0-255,66,70750,63,153498
12953,0.000954,172.31.40.0-255,66,70816,63,153498
12954,0.000966,74.125.24.0-255,5738,76554,63,153498
12955,0.000969,172.31.40.0-255,66,76620,63,153498
12956,0.001009,172.31.40.0-255,66,76686,63,153498
12957,0.001014,74.125.24.0-255,4320,81006,63,153498
12958,0.001017,172.31.40.0-255,66,81072,63,153498
12959,0.001036,74.125.24.0-255,6438,87510,63,153498
12960,0.001039,172.31.40.0-255,66,87576,63,153498
12961,0.001319,74.125.24.0-255,1484,89060,63,153498
12962,0.001326,74.125.24.0-255,2902,91962,63,153498
12963,0.001329,172.31.40.0-255,66,92028,63,153498
12964,0.001354,74.125.24.0-255,1484,93512,63,153498
12965,0.001368,74.125.24.0-255,4320,97832,63,153498
12966,0.00137,172.31.40.0-255,66,97898,63,153498
12967,0.001383,172.31.40.0-255,66,97964,63,153498
12968,0.001426,172.31.40.0-255,66,98030,63,153498
12969,0.002072,74.125.24.0-255,1484,99514,63,153498
12970,0.002083,74.125.24.0-255,2902,102416,63,153498
12971,0.002087,172.31.40.0-255,66,102482,63,153498
12972,0.002095,74.125.24.0-255,5738,108220,63,153498
12973,0.002098,172.31.40.0-255,66,108286,63,153498
12974,0.002102,74.125.24.0-255,2902,111188,63,153498
12975,0.002104,172.31.40.0-255,66,111254,63,153498
12976,0.002128,172.31.40.0-255,66,111320,63,153498
12977,0.002145,74.125.24.0-255,1484,112804,63,153498
12978,0.002165,172.31.40.0-255,66,112870,63,153498
12979,0.004445,74.125.24.0-255,5738,118608,63,153498
12980,0.004452,172.31.40.0-255,66,118674,63,153498
12981,0.006722,74.125.24.0-255,5738,124412,63,153498
12982,0.006727,172.31.40.0-255,66,124478,63,153498
12983,0.009038,74.125.24.0-255,5738,130216,63,153498
12984,0.009045,172.31.40.0-255,66,130282,63,153498
12985,0.011337,74.125.24.0-255,5738,136020,63,153498
12986,0.011344,172.31.40.0-255,66,136086,63,153498
12987,0.013643,74.125.24.0-255,5738,141824,63,153498
12988,0.013654,172.31.40.0-255,66,141890,63,153498
12989,0.015911,74.125.24.0-255,5738,147628,63,153498
12990,0.015915,172.31.40.0-255,66,147694,63,153498
12991,0.018207,74.125.24.0-255,5738,153432,63,153498
12992,0.018214,172.31.40.0-255,66,153498,63,153498
12993,0.0,74.125.24.0-255,298,298,63,120069
12994,1.5e-05,172.31.40.0-255,66,364,63,120069
12995,2.2e-05,74.125.24.0-255,1484,1848,63,120069
12996,2.7e-05,172.31.40.0-255,66,1914,63,120069
12997,5.9e-05,74.125.24.0-255,4320,6234,63,120069
12998,6.2e-05,172.31.40.0-255,66,6300,63,120069
12999,6.7e-05,74.125.24.0-255,2902,9202,63,120069
13000,7e-05,172.31.40.0-255,66,9268,63,120069
13001,9.5e-05,74.125.24.0-255,2902,12170,63,120069
13002,0.000102,172.31.40.0-255,66,12236,63,120069
13003,0.000125,74.125.24.0-255,1784,14020,63,120069
13004,0.000128,172.31.40.0-255,66,14086,63,120069
13005,0.000168,74.125.24.0-255,1484,15570,63,120069
13006,0.00017,172.31.40.0-255,66,15636,63,120069
13007,0.000189,74.125.24.0-255,2902,18538,63,120069
13008,0.000192,172.31.40.0-255,66,18604,63,120069
13009,0.000196,74.125.24.0-255,2902,21506,63,120069
13010,0.000199,172.31.40.0-255,66,21572,63,120069
13011,0.000221,74.125.24.0-255,2902,24474,63,120069
13012,0.000223,172.31.40.0-255,66,24540,63,120069
13013,0.00023,74.125.24.0-255,5738,30278,63,120069
13014,0.000233,172.31.40.0-255,66,30344,63,120069
13015,0.000273,74.125.24.0-255,5379,35723,63,120069
13016,0.000276,172.31.40.0-255,66,35789,63,120069
13017,0.000288,172.31.40.0-255,66,35855,63,120069
13018,0.000309,172.31.40.0-255,66,35921,63,120069
13019,0.000331,74.125.24.0-255,766,36687,63,120069
13020,0.000333,172.31.40.0-255,66,36753,63,120069
13021,0.00034,74.125.24.0-255,443,37196,63,120069
13022,0.000342,172.31.40.0-255,66,37262,63,120069
13023,0.000405,74.125.24.0-255,1484,38746,63,120069
13024,0.000409,74.125.24.0-255,1484,40230,63,120069
13025,0.000412,172.31.40.0-255,66,40296,63,120069
13026,0.000466,74.125.24.0-255,1484,41780,63,120069
13027,0.000474,74.125.24.0-255,5738,47518,63,120069
13028,0.000477,172.31.40.0-255,66,47584,63,120069
13029,0.000491,172.31.40.0-255,66,47650,63,120069
13030,0.000509,172.31.40.0-255,66,47716,63,120069
13031,0.000704,74.125.24.0-255,1484,49200,63,120069
13032,0.000712,74.125.24.0-255,2902,52102,63,120069
13033,0.000716,172.31.40.0-255,66,52168,63,120069
13034,0.000721,74.125.24.0-255,2902,55070,63,120069
13035,0.000724,172.31.40.0-255,66,55136,63,120069
13036,0.000759,74.125.24.0-255,2902,58038,63,120069
13037,0.000762,172.31.40.0-255,66,58104,63,120069
13038,0.000769,74.125.24.0-255,7156,65260,63,120069
13039,0.000771,172.31.40.0-255,66,65326,63,120069
13040,0.00081,172.31.40.0-255,66,65392,63,120069
13041,0.000813,74.125.24.0-255,2184,67576,63,120069
13042,0.000816,172.31.40.0-255,66,67642,63,120069
13043,0.001363,74.125.24.0-255,1484,69126,63,120069
13044,0.00138,74.125.24.0-255,2902,72028,63,120069
13045,0.001384,172.31.40.0-255,66,72094,63,120069
13046,0.001427,74.125.24.0-255,4320,76414,63,120069
13047,0.001429,172.31.40.0-255,66,76480,63,120069
13048,0.001458,74.125.24.0-255,1484,77964,63,120069
13049,0.001472,172.31.40.0-255,66,78030,63,120069
13050,0.001491,172.31.40.0-255,66,78096,63,120069
13051,0.001693,74.125.24.0-255,1484,79580,63,120069
13052,0.001714,74.125.24.0-255,2902,82482,63,120069
13053,0.001718,172.31.40.0-255,66,82548,63,120069
13054,0.001725,74.125.24.0-255,5738,88286,63,120069
13055,0.001727,172.31.40.0-255,66,88352,63,120069
13056,0.001731,74.125.24.0-255,2902,91254,63,120069
13057,0.001738,172.31.40.0-255,66,91320,63,120069
13058,0.001791,172.31.40.0-255,66,91386,63,120069
13059,0.001794,172.31.40.0-255,66,91452,63,120069
13060,0.001856,172.31.40.0-255,66,91518,63,120069
13061,0.001867,172.31.40.0-255,66,91584,63,120069
13062,0.001878,74.125.24.0-255,5738,97322,63,120069
13063,0.00188,172.31.40.0-255,66,97388,63,120069
13064,0.001888,74.125.24.0-255,7156,104544,63,120069
13065,0.00189,172.31.40.0-255,66,104610,63,120069
13066,0.001946,172.31.40.0-255,66,104676,63,120069
13067,0.001953,74.125.24.0-255,6438,111114,63,120069
13068,0.001956,172.31.40.0-255,66,111180,63,120069
13069,0.001983,172.31.40.0-255,66,111246,63,120069
13070,0.002013,74.125.24.0-255,1484,112730,63,120069
13071,0.002031,172.31.40.0-255,66,112796,63,120069
13072,0.002092,172.31.40.0-255,66,112862,63,120069
13073,0.002154,172.31.40.0-255,66,112928,63,120069
13074,0.002189,74.125.24.0-255,6438,119366,63,120069
13075,0.002193,172.31.40.0-255,66,119432,63,120069
13076,0.002218,172.31.40.0-255,66,119498,63,120069
13077,0.002236,172.31.40.0-255,66,119564,63,120069
13078,0.002249,172.31.40.0-255,66,119630,63,120069
13079,0.002252,74.125.24.0-255,97,119727,63,120069
13080,0.002255,74.125.24.0-255,105,119832,63,120069
13081,0.010374,172.31.40.0-255,66,119898,63,120069
13082,0.010418,172.31.40.0-255,105,120003,63,120069
13083,0.012936,74.125.24.0-255,66,120069,63,120069
13084,0.0,172.217.194.0-255,150,150,63,191679
13085,2.4e-05,172.31.40.0-255,66,216,63,191679
13086,3.1e-05,172.217.194.0-255,1484,1700,63,191679
13087,3.5e-05,172.31.40.0-255,66,1766,63,191679
13088,6.3e-05,172.217.194.0-255,2902,4668,63,191679
13089,6.7e-05,172.31.40.0-255,66,4734,63,191679
13090,7.5e-05,172.217.194.0-255,7156,11890,63,191679
13091,7.9e-05,172.31.40.0-255,66,11956,63,191679
13092,9.6e-05,172.31.40.0-255,66,12022,63,191679
13093,0.000163,172.31.40.0-255,66,12088,63,191679
13094,0.000176,172.31.40.0-255,66,12154,63,191679
13095,0.000442,172.217.194.0-255,1484,13638,63,191679
13096,0.000448,172.31.40.0-255,66,13704,63,191679
13097,0.000454,172.217.194.0-255,2902,16606,63,191679
13098,0.000456,172.31.40.0-255,66,16672,63,191679
13099,0.000482,172.217.194.0-255,5738,22410,63,191679
13100,0.000485,172.31.40.0-255,66,22476,63,191679
13101,0.00049,172.217.194.0-255,2902,25378,63,191679
13102,0.000492,172.31.40.0-255,66,25444,63,191679
13103,0.000526,172.217.194.0-255,3961,29405,63,191679
13104,0.000529,172.31.40.0-255,66,29471,63,191679
13105,0.000532,172.217.194.0-255,647,30118,63,191679
13106,0.000533,172.31.40.0-255,66,30184,63,191679
13107,0.000557,172.217.194.0-255,1484,31668,63,191679
13108,0.000559,172.31.40.0-255,66,31734,63,191679
13109,0.000564,172.217.194.0-255,2902,34636,63,191679
13110,0.000566,172.31.40.0-255,66,34702,63,191679
13111,0.000602,172.217.194.0-255,1484,36186,63,191679
13112,0.000605,172.31.40.0-255,66,36252,63,191679
13113,0.000613,172.217.194.0-255,7156,43408,63,191679
13114,0.000616,172.31.40.0-255,66,43474,63,191679
13115,0.000628,172.217.194.0-255,7156,50630,63,191679
13116,0.000632,172.31.40.0-255,66,50696,63,191679
13117,0.000673,172.31.40.0-255,66,50762,63,191679
13118,0.00068,172.217.194.0-255,5020,55782,63,191679
13119,0.000682,172.31.40.0-255,66,55848,63,191679
13120,0.000841,172.217.194.0-255,1484,57332,63,191679
13121,0.000846,172.217.194.0-255,2902,60234,63,191679
13122,0.000853,172.31.40.0-255,66,60300,63,191679
13123,0.00088,172.217.194.0-255,5738,66038,63,191679
13124,0.000883,172.31.40.0-255,66,66104,63,191679
13125,0.000891,172.217.194.0-255,6247,72351,63,191679
13126,0.000893,172.31.40.0-255,66,72417,63,191679
13127,0.000933,172.217.194.0-255,1484,73901,63,191679
13128,0.000939,172.217.194.0-255,2902,76803,63,191679
13129,0.000942,172.31.40.0-255,66,76869,63,191679
13130,0.000948,172.217.194.0-255,5738,82607,63,191679
13131,0.00095,172.31.40.0-255,66,82673,63,191679
13132,0.000983,172.217.194.0-255,7156,89829,63,191679
13133,0.000985,172.31.40.0-255,66,89895,63,191679
13134,0.001015,172.217.194.0-255,5738,95633,63,191679
13135,0.001017,172.31.40.0-255,66,95699,63,191679
13136,0.001029,172.31.40.0-255,66,95765,63,191679
13137,0.001032,172.217.194.0-255,2184,97949,63,191679
13138,0.001034,172.31.40.0-255,66,98015,63,191679
13139,0.001426,172.217.194.0-255,1484,99499,63,191679
13140,0.001431,172.217.194.0-255,1484,100983,63,191679
13141,0.001434,172.31.40.0-255,66,101049,63,191679
13142,0.001463,172.217.194.0-255,1484,102533,63,191679
13143,0.001469,172.217.194.0-255,5738,108271,63,191679
13144,0.001472,172.31.40.0-255,66,108337,63,191679
13145,0.001484,172.31.40.0-255,66,108403,63,191679
13146,0.001504,172.217.194.0-255,1484,109887,63,191679
13147,0.001509,172.217.194.0-255,2902,112789,63,191679
13148,0.001511,172.31.40.0-255,66,112855,63,191679
13149,0.001547,172.31.40.0-255,66,112921,63,191679
13150,0.001842,172.217.194.0-255,1484,114405,63,191679
13151,0.001849,172.217.194.0-255,2902,117307,63,191679
13152,0.001852,172.31.40.0-255,66,117373,63,191679
13153,0.001875,172.217.194.0-255,5738,123111,63,191679
13154,0.001877,172.31.40.0-255,66,123177,63,191679
13155,0.001885,172.217.194.0-255,7156,130333,63,191679
13156,0.001887,172.31.40.0-255,66,130399,63,191679
13157,0.001931,172.31.40.0-255,66,130465,63,191679
13158,0.001935,172.217.194.0-255,2184,132649,63,191679
13159,0.001937,172.31.40.0-255,66,132715,63,191679
13160,0.001999,172.217.194.0-255,1484,134199,63,191679
13161,0.002018,172.217.194.0-255,2902,137101,63,191679
13162,0.00202,172.31.40.0-255,66,137167,63,191679
13163,0.002027,172.217.194.0-255,5738,142905,63,191679
13164,0.002029,172.31.40.0-255,66,142971,63,191679
13165,0.00207,172.31.40.0-255,66,143037,63,191679
13166,0.002075,172.217.194.0-255,2902,145939,63,191679
13167,0.002077,172.31.40.0-255,66,146005,63,191679
13168,0.002114,172.31.40.0-255,66,146071,63,191679
13169,0.004201,172.217.194.0-255,5738,151809,63,191679
13170,0.004208,172.31.40.0-255,66,151875,63,191679
13171,0.006291,172.217.194.0-255,2902,154777,63,191679
13172,0.006298,172.31.40.0-255,66,154843,63,191679
13173,0.006328,172.217.194.0-255,2902,157745,63,191679
13174,0.006332,172.31.40.0-255,66,157811,63,191679
13175,0.008389,172.217.194.0-255,2902,160713,63,191679
13176,0.008407,172.31.40.0-255,66,160779,63,191679
13177,0.008439,172.217.194.0-255,2902,163681,63,191679
13178,0.008443,172.31.40.0-255,66,163747,63,191679
13179,0.010477,172.217.194.0-255,2902,166649,63,191679
13180,0.010491,172.31.40.0-255,66,166715,63,191679
13181,0.010526,172.217.194.0-255,2902,169617,63,191679
13182,0.010529,172.31.40.0-255,66,169683,63,191679
13183,0.012582,172.217.194.0-255,2902,172585,63,191679
13184,0.012596,172.31.40.0-255,66,172651,63,191679
13185,0.012629,172.217.194.0-255,2902,175553,63,191679
13186,0.012632,172.31.40.0-255,66,175619,63,191679
13187,0.014694,172.217.194.0-255,4320,179939,63,191679
13188,0.014701,172.31.40.0-255,66,180005,63,191679
13189,0.014731,172.217.194.0-255,1484,181489,63,191679
13190,0.016809,172.217.194.0-255,4320,185809,63,191679
13191,0.01682,172.31.40.0-255,66,185875,63,191679
13192,0.018903,172.217.194.0-255,5738,191613,63,191679
13193,0.018912,172.31.40.0-255,66,191679,63,191679
13194,0.0,74.125.24.0-255,153,153,63,176220
13195,2.1e-05,172.31.40.0-255,66,219,63,176220
13196,2.8e-05,74.125.24.0-255,1484,1703,63,176220
13197,3.2e-05,172.31.40.0-255,66,1769,63,176220
13198,3.8e-05,74.125.24.0-255,2902,4671,63,176220
13199,4.9e-05,172.31.40.0-255,66,4737,63,176220
13200,5.7e-05,74.125.24.0-255,7156,11893,63,176220
13201,5.9e-05,172.31.40.0-255,66,11959,63,176220
13202,6.2e-05,74.125.24.0-255,1484,13443,63,176220
13203,6.4e-05,172.31.40.0-255,66,13509,63,176220
13204,9.6e-05,74.125.24.0-255,614,14123,63,176220
13205,9.8e-05,172.31.40.0-255,66,14189,63,176220
13206,0.000123,74.125.24.0-255,1484,15673,63,176220
13207,0.000125,172.31.40.0-255,66,15739,63,176220
13208,0.000138,74.125.24.0-255,4320,20059,63,176220
13209,0.00014,172.31.40.0-255,66,20125,63,176220
13210,0.000149,74.125.24.0-255,5738,25863,63,176220
13211,0.000151,172.31.40.0-255,66,25929,63,176220
13212,0.000203,74.125.24.0-255,5379,31308,63,176220
13213,0.000205,172.31.40.0-255,66,31374,63,176220
13214,0.000651,74.125.24.0-255,1484,32858,63,176220
13215,0.000656,172.31.40.0-255,66,32924,63,176220
13216,0.000664,74.125.24.0-255,2902,35826,63,176220
13217,0.000666,172.31.40.0-255,66,35892,63,176220
13218,0.000689,74.125.24.0-255,4320,40212,63,176220
13219,0.000691,172.31.40.0-255,66,40278,63,176220
13220,0.000703,74.125.24.0-255,1484,41762,63,176220
13221,0.000708,172.31.40.0-255,66,41828,63,176220
13222,0.000743,172.31.40.0-255,66,41894,63,176220
13223,0.000748,74.125.24.0-255,4320,46214,63,176220
13224,0.00075,172.31.40.0-255,66,46280,63,176220
13225,0.000776,74.125.24.0-255,4320,50600,63,176220
13226,0.000778,172.31.40.0-255,66,50666,63,176220
13227,0.000781,74.125.24.0-255,1431,52097,63,176220
13228,0.000837,74.125.24.0-255,113,52210,63,176220
13229,0.000927,74.125.24.0-255,1484,53694,63,176220
13230,0.000931,172.31.40.0-255,66,53760,63,176220
13231,0.000953,74.125.24.0-255,2902,56662,63,176220
13232,0.000956,172.31.40.0-255,66,56728,63,176220
13233,0.000963,74.125.24.0-255,5738,62466,63,176220
13234,0.000965,172.31.40.0-255,66,62532,63,176220
13235,0.000969,74.125.24.0-255,1484,64016,63,176220
13236,0.001002,74.125.24.0-255,5738,69754,63,176220
13237,0.001005,172.31.40.0-255,66,69820,63,176220
13238,0.001057,74.125.24.0-255,7156,76976,63,176220
13239,0.001062,172.31.40.0-255,66,77042,63,176220
13240,0.001101,172.31.40.0-255,66,77108,63,176220
13241,0.001924,74.125.24.0-255,1484,78592,63,176220
13242,0.001933,74.125.24.0-255,2902,81494,63,176220
13243,0.001937,172.31.40.0-255,66,81560,63,176220
13244,0.001945,74.125.24.0-255,5738,87298,63,176220
13245,0.001948,172.31.40.0-255,66,87364,63,176220
13246,0.00196,74.125.24.0-255,5738,93102,63,176220
13247,0.001963,172.31.40.0-255,66,93168,63,176220
13248,0.001966,74.125.24.0-255,1484,94652,63,176220
13249,0.002004,172.31.40.0-255,66,94718,63,176220
13250,0.002009,74.125.24.0-255,5020,99738,63,176220
13251,0.002012,172.31.40.0-255,66,99804,63,176220
13252,0.002042,74.125.24.0-255,5738,105542,63,176220
13253,0.002045,172.31.40.0-255,66,105608,63,176220
13254,0.002069,74.125.24.0-255,7156,112764,63,176220
13255,0.002072,172.31.40.0-255,66,112830,63,176220
13256,0.002083,172.31.40.0-255,66,112896,63,176220
13257,0.002123,74.125.24.0-255,5738,118634,63,176220
13258,0.00213,172.31.40.0-255,66,118700,63,176220
13259,0.002138,74.125.24.0-255,6438,125138,63,176220
13260,0.002141,172.31.40.0-255,66,125204,63,176220
13261,0.002144,74.125.24.0-255,1484,126688,63,176220
13262,0.002177,74.125.24.0-255,2902,129590,63,176220
13263,0.00218,172.31.40.0-255,66,129656,63,176220
13264,0.002187,74.125.24.0-255,5738,135394,63,176220
13265,0.002189,172.31.40.0-255,66,135460,63,176220
13266,0.002229,172.31.40.0-255,66,135526,63,176220
13267,0.002242,172.31.40.0-255,66,135592,63,176220
13268,0.004559,74.125.24.0-255,5738,141330,63,176220
13269,0.004562,172.31.40.0-255,66,141396,63,176220
13270,0.006862,74.125.24.0-255,5738,147134,63,176220
13271,0.006869,172.31.40.0-255,66,147200,63,176220
13272,0.009183,74.125.24.0-255,5738,152938,63,176220
13273,0.009192,172.31.40.0-255,66,153004,63,176220
13274,0.011534,74.125.24.0-255,5738,158742,63,176220
13275,0.011543,172.31.40.0-255,66,158808,63,176220
13276,0.01388,74.125.24.0-255,5738,164546,63,176220
13277,0.013889,172.31.40.0-255,66,164612,63,176220
13278,0.016222,74.125.24.0-255,5738,170350,63,176220
13279,0.01623,172.31.40.0-255,66,170416,63,176220
13280,0.018531,74.125.24.0-255,5738,176154,63,176220
13281,0.018539,172.31.40.0-255,66,176220,63,176220
13282,0.0,74.125.130.0-255,153,153,63,185548
13283,1.7e-05,172.31.40.0-255,66,219,63,185548
13284,2.3e-05,74.125.130.0-255,1484,1703,63,185548
13285,2.7e-05,172.31.40.0-255,66,1769,63,185548
13286,3.3e-05,74.125.130.0-255,2902,4671,63,185548
13287,3.6e-05,172.31.40.0-255,66,4737,63,185548
13288,6.7e-05,74.125.130.0-255,4320,9057,63,185548
13289,7.1e-05,172.31.40.0-255,66,9123,63,185548
13290,0.0001,74.125.130.0-255,2902,12025,63,185548
13291,0.000103,172.31.40.0-255,66,12091,63,185548
13292,0.000107,74.125.130.0-255,2063,14154,63,185548
13293,0.000109,172.31.40.0-255,66,14220,63,185548
13294,0.000132,74.125.130.0-255,1484,15704,63,185548
13295,0.000134,172.31.40.0-255,66,15770,63,185548
13296,0.000137,74.125.130.0-255,1484,17254,63,185548
13297,0.000139,172.31.40.0-255,66,17320,63,185548
13298,0.000167,74.125.130.0-255,1484,18804,63,185548
13299,0.00017,172.31.40.0-255,66,18870,63,185548
13300,0.000175,74.125.130.0-255,5738,24608,63,185548
13301,0.000177,172.31.40.0-255,66,24674,63,185548
13302,0.000184,74.125.130.0-255,6797,31471,63,185548
13303,0.000186,172.31.40.0-255,66,31537,63,185548
13304,0.000381,74.125.130.0-255,1484,33021,63,185548
13305,0.000386,172.31.40.0-255,66,33087,63,185548
13306,0.000411,74.125.130.0-255,2902,35989,63,185548
13307,0.000413,172.31.40.0-255,66,36055,63,185548
13308,0.000419,74.125.130.0-255,5738,41793,63,185548
13309,0.000422,172.31.40.0-255,66,41859,63,185548
13310,0.000425,74.125.130.0-255,2902,44761,63,185548
13311,0.000427,172.31.40.0-255,66,44827,63,185548
13312,0.000431,74.125.130.0-255,2902,47729,63,185548
13313,0.000433,172.31.40.0-255,66,47795,63,185548
13314,0.00046,74.125.130.0-255,1125,48920,63,185548
13315,0.000474,74.125.130.0-255,2902,51822,63,185548
13316,0.000476,172.31.40.0-255,66,51888,63,185548
13317,0.000518,74.125.130.0-255,5738,57626,63,185548
13318,0.000522,172.31.40.0-255,66,57692,63,185548
13319,0.000529,74.125.130.0-255,7156,64848,63,185548
13320,0.000531,172.31.40.0-255,66,64914,63,185548
13321,0.000553,74.125.130.0-255,1125,66039,63,185548
13322,0.000788,74.125.130.0-255,367,66406,63,185548
13323,0.001139,172.31.40.0-255,66,66472,63,185548
13324,0.001172,74.125.130.0-255,1484,67956,63,185548
13325,0.001175,74.125.130.0-255,1484,69440,63,185548
13326,0.001178,172.31.40.0-255,66,69506,63,185548
13327,0.001203,74.125.130.0-255,2902,72408,63,185548
13328,0.001205,172.31.40.0-255,66,72474,63,185548
13329,0.001212,74.125.130.0-255,5738,78212,63,185548
13330,0.001214,172.31.40.0-255,66,78278,63,185548
13331,0.001256,172.31.40.0-255,66,78344,63,185548
13332,0.001266,172.31.40.0-255,66,78410,63,185548
13333,0.001444,74.125.130.0-255,1484,79894,63,185548
13334,0.001459,74.125.130.0-255,2902,82796,63,185548
13335,0.001462,172.31.40.0-255,66,82862,63,185548
13336,0.001481,74.125.130.0-255,5738,88600,63,185548
13337,0.001489,172.31.40.0-255,66,88666,63,185548
13338,0.001495,74.125.130.0-255,4320,92986,63,185548
13339,0.001497,172.31.40.0-255,66,93052,63,185548
13340,0.001501,74.125.130.0-255,1484,94536,63,185548
13341,0.001535,74.125.130.0-255,4320,98856,63,185548
13342,0.001538,172.31.40.0-255,66,98922,63,185548
13343,0.001544,74.125.130.0-255,4320,103242,63,185548
13344,0.001546,172.31.40.0-255,66,103308,63,185548
13345,0.00158,74.125.130.0-255,7156,110464,63,185548
13346,0.001583,172.31.40.0-255,66,110530,63,185548
13347,0.001587,74.125.130.0-255,2184,112714,63,185548
13348,0.001588,172.31.40.0-255,66,112780,63,185548
13349,0.001601,74.125.130.0-255,2902,115682,63,185548
13350,0.001609,172.31.40.0-255,66,115748,63,185548
13351,0.001637,74.125.130.0-255,2902,118650,63,185548
13352,0.00164,172.31.40.0-255,66,118716,63,185548
13353,0.001647,74.125.130.0-255,7156,125872,63,185548
13354,0.00165,172.31.40.0-255,66,125938,63,185548
13355,0.001653,74.125.130.0-255,1484,127422,63,185548
13356,0.001697,172.31.40.0-255,66,127488,63,185548
13357,0.001731,172.31.40.0-255,66,127554,63,185548
13358,0.001832,74.125.130.0-255,1484,129038,63,185548
13359,0.001848,74.125.130.0-255,2902,131940,63,185548
13360,0.001852,172.31.40.0-255,66,132006,63,185548
13361,0.001857,74.125.130.0-255,2902,134908,63,185548
13362,0.001862,74.125.130.0-255,4320,139228,63,185548
13363,0.001884,74.125.130.0-255,1484,140712,63,185548
13364,0.001897,74.125.130.0-255,1484,142196,63,185548
13365,0.001906,172.31.40.0-255,66,142262,63,185548
13366,0.001913,74.125.130.0-255,5738,148000,63,185548
13367,0.001919,172.31.40.0-255,66,148066,63,185548
13368,0.002024,172.31.40.0-255,66,148132,63,185548
13369,0.00215,74.125.130.0-255,1484,149616,63,185548
13370,0.002156,74.125.130.0-255,2902,152518,63,185548
13371,0.00216,172.31.40.0-255,66,152584,63,185548
13372,0.002164,74.125.130.0-255,1484,154068,63,185548
13373,0.002197,74.125.130.0-255,4320,158388,63,185548
13374,0.002211,74.125.130.0-255,1484,159872,63,185548
13375,0.00222,172.31.40.0-255,66,159938,63,185548
13376,0.002264,74.125.130.0-255,1484,161422,63,185548
13377,0.00227,172.31.40.0-255,66,161488,63,185548
13378,0.002347,74.125.130.0-255,3602,165090,63,185548
13379,0.002393,74.125.130.0-255,7156,172246,63,185548
13380,0.00244,74.125.130.0-255,7156,179402,63,185548
13381,0.002537,74.125.130.0-255,5738,185140,63,185548
13382,0.012323,172.31.40.0-255,66,185206,63,185548
13383,0.013019,74.125.130.0-255,105,185311,63,185548
13384,0.014725,172.31.40.0-255,66,185377,63,185548
13385,0.014771,172.31.40.0-255,105,185482,63,185548
13386,0.017343,74.125.130.0-255,66,185548,63,185548
13387,0.0,172.253.118.0-255,150,150,63,157336
13388,1.8e-05,172.31.40.0-255,66,216,63,157336
13389,2.5e-05,172.253.118.0-255,1484,1700,63,157336
13390,3e-05,172.31.40.0-255,66,1766,63,157336
13391,3.6e-05,172.253.118.0-255,2902,4668,63,157336
13392,3.8e-05,172.31.40.0-255,66,4734,63,157336
13393,4.5e-05,172.253.118.0-255,5738,10472,63,157336
13394,4.7e-05,172.31.40.0-255,66,10538,63,157336
13395,0.000101,172.253.118.0-255,3456,13994,63,157336
13396,0.000104,172.31.40.0-255,66,14060,63,157336
13397,0.000161,172.253.118.0-255,1484,15544,63,157336
13398,0.000164,172.31.40.0-255,66,15610,63,157336
13399,0.000169,172.253.118.0-255,2902,18512,63,157336
13400,0.000171,172.31.40.0-255,66,18578,63,157336
13401,0.000177,172.253.118.0-255,5738,24316,63,157336
13402,0.000179,172.31.40.0-255,66,24382,63,157336
13403,0.000185,172.253.118.0-255,4320,28702,63,157336
13404,0.000187,172.31.40.0-255,66,28768,63,157336
13405,0.000202,172.253.118.0-255,2543,31311,63,157336
13406,0.000204,172.31.40.0-255,66,31377,63,157336
13407,0.000647,172.253.118.0-255,1484,32861,63,157336
13408,0.000653,172.31.40.0-255,66,32927,63,157336
13409,0.000659,172.253.118.0-255,2902,35829,63,157336
13410,0.000661,172.31.40.0-255,66,35895,63,157336
13411,0.000668,172.253.118.0-255,5738,41633,63,157336
13412,0.00067,172.31.40.0-255,66,41699,63,157336
13413,0.000696,172.253.118.0-255,6797,48496,63,157336
13414,0.000698,172.31.40.0-255,66,48562,63,157336
13415,0.000716,172.253.118.0-255,4320,52882,63,157336
13416,0.000718,172.31.40.0-255,66,52948,63,157336
13417,0.000741,172.31.40.0-255,66,53014,63,157336
13418,0.000745,172.253.118.0-255,2543,55557,63,157336
13419,0.000748,172.31.40.0-255,66,55623,63,157336
13420,0.000768,172.253.118.0-255,414,56037,63,157336
13421,0.00089,172.253.118.0-255,1484,57521,63,157336
13422,0.000894,172.31.40.0-255,66,57587,63,157336
13423,0.000907,172.253.118.0-255,2902,60489,63,157336
13424,0.00091,172.31.40.0-255,66,60555,63,157336
13425,0.000924,172.253.118.0-255,2902,63457,63,157336
13426,0.000926,172.31.40.0-255,66,63523,63,157336
13427,0.000939,172.253.118.0-255,2902,66425,63,157336
13428,0.000941,172.31.40.0-255,66,66491,63,157336
13429,0.000947,172.253.118.0-255,4320,70811,63,157336
13430,0.000949,172.31.40.0-255,66,70877,63,157336
13431,0.000971,172.253.118.0-255,2543,73420,63,157336
13432,0.000974,172.31.40.0-255,66,73486,63,157336
13433,0.000994,172.253.118.0-255,4320,77806,63,157336
13434,0.000997,172.31.40.0-255,66,77872,63,157336
13435,0.001027,172.31.40.0-255,66,77938,63,157336
13436,0.001047,172.253.118.0-255,2784,80722,63,157336
13437,0.00105,172.31.40.0-255,66,80788,63,157336
13438,0.001444,172.253.118.0-255,1484,82272,63,157336
13439,0.001463,172.253.118.0-255,2902,85174,63,157336
13440,0.001467,172.31.40.0-255,66,85240,63,157336
13441,0.001474,172.253.118.0-255,5738,90978,63,157336
13442,0.001476,172.31.40.0-255,66,91044,63,157336
13443,0.001514,172.31.40.0-255,66,91110,63,157336
13444,0.001521,172.253.118.0-255,7156,98266,63,157336
13445,0.001523,172.31.40.0-255,66,98332,63,157336
13446,0.001558,172.253.118.0-255,3602,101934,63,157336
13447,0.001561,172.31.40.0-255,66,102000,63,157336
13448,0.00222,172.253.118.0-255,1484,103484,63,157336
13449,0.002231,172.253.118.0-255,2902,106386,63,157336
13450,0.002235,172.31.40.0-255,66,106452,63,157336
13451,0.00228,172.253.118.0-255,5738,112190,63,157336
13452,0.002282,172.31.40.0-255,66,112256,63,157336
13453,0.002288,172.253.118.0-255,4320,116576,63,157336
13454,0.00229,172.31.40.0-255,66,116642,63,157336
13455,0.0023,172.31.40.0-255,66,116708,63,157336
13456,0.004562,172.253.118.0-255,5738,122446,63,157336
13457,0.004567,172.31.40.0-255,66,122512,63,157336
13458,0.006814,172.253.118.0-255,5738,128250,63,157336
13459,0.006817,172.31.40.0-255,66,128316,63,157336
13460,0.009066,172.253.118.0-255,5738,134054,63,157336
13461,0.009072,172.31.40.0-255,66,134120,63,157336
13462,0.011328,172.253.118.0-255,5738,139858,63,157336
13463,0.011336,172.31.40.0-255,66,139924,63,157336
13464,0.013613,172.253.118.0-255,5738,145662,63,157336
13465,0.013645,172.31.40.0-255,66,145728,63,157336
13466,0.01591,172.253.118.0-255,5738,151466,63,157336
13467,0.015929,172.31.40.0-255,66,151532,63,157336
13468,0.018219,172.253.118.0-255,5738,157270,63,157336
13469,0.01823,172.31.40.0-255,66,157336,63,157336
13470,0.0,74.125.24.0-255,296,296,63,172402
13471,2.3e-05,172.31.40.0-255,66,362,63,172402
13472,3e-05,74.125.24.0-255,1484,1846,63,172402
13473,3.5e-05,172.31.40.0-255,66,1912,63,172402
13474,4.2e-05,74.125.24.0-255,4320,6232,63,172402
13475,5.2e-05,172.31.40.0-255,66,6298,63,172402
13476,6.4e-05,172.31.40.0-255,66,6364,63,172402
13477,0.00011,172.31.40.0-255,66,6430,63,172402
13478,0.000115,74.125.24.0-255,2543,8973,63,172402
13479,0.000117,172.31.40.0-255,66,9039,63,172402
13480,0.000176,74.125.24.0-255,1484,10523,63,172402
13481,0.000179,172.31.40.0-255,66,10589,63,172402
13482,0.000184,74.125.24.0-255,2902,13491,63,172402
13483,0.000186,172.31.40.0-255,66,13557,63,172402
13484,0.000191,74.125.24.0-255,2902,16459,63,172402
13485,0.000197,172.31.40.0-255,66,16525,63,172402
13486,0.000225,74.125.24.0-255,2902,19427,63,172402
13487,0.000228,172.31.40.0-255,66,19493,63,172402
13488,0.000233,74.125.24.0-255,2902,22395,63,172402
13489,0.000235,172.31.40.0-255,66,22461,63,172402
13490,0.000279,172.31.40.0-255,66,22527,63,172402
13491,0.000291,172.31.40.0-255,66,22593,63,172402
13492,0.000382,74.125.24.0-255,647,23240,63,172402
13493,0.000386,172.31.40.0-255,66,23306,63,172402
13494,0.000543,74.125.24.0-255,1484,24790,63,172402
13495,0.000549,172.31.40.0-255,66,24856,63,172402
13496,0.000575,74.125.24.0-255,2902,27758,63,172402
13497,0.000579,172.31.40.0-255,66,27824,63,172402
13498,0.000586,74.125.24.0-255,5738,33562,63,172402
13499,0.000589,172.31.40.0-255,66,33628,63,172402
13500,0.000614,74.125.24.0-255,5738,39366,63,172402
13501,0.000617,172.31.40.0-255,66,39432,63,172402
13502,0.000658,74.125.24.0-255,7156,46588,63,172402
13503,0.000661,172.31.40.0-255,66,46654,63,172402
13504,0.000672,172.31.40.0-255,66,46720,63,172402
13505,0.000676,74.125.24.0-255,2184,48904,63,172402
13506,0.000679,172.31.40.0-255,66,48970,63,172402
13507,0.001298,74.125.24.0-255,1484,50454,63,172402
13508,0.001318,74.125.24.0-255,2902,53356,63,172402
13509,0.001324,172.31.40.0-255,66,53422,63,172402
13510,0.001334,74.125.24.0-255,2902,56324,63,172402
13511,0.001336,172.31.40.0-255,66,56390,63,172402
13512,0.001342,74.125.24.0-255,2902,59292,63,172402
13513,0.001347,172.31.40.0-255,66,59358,63,172402
13514,0.001377,74.125.24.0-255,4320,63678,63,172402
13515,0.001379,172.31.40.0-255,66,63744,63,172402
13516,0.001393,172.31.40.0-255,66,63810,63,172402
13517,0.001418,74.125.24.0-255,1484,65294,63,172402
13518,0.001426,74.125.24.0-255,5738,71032,63,172402
13519,0.001428,172.31.40.0-255,66,71098,63,172402
13520,0.001461,74.125.24.0-255,766,71864,63,172402
13521,0.001502,74.125.24.0-255,1484,73348,63,172402
13522,0.001506,172.31.40.0-255,66,73414,63,172402
13523,0.00151,74.125.24.0-255,1484,74898,63,172402
13524,0.001533,74.125.24.0-255,2902,77800,63,172402
13525,0.001536,172.31.40.0-255,66,77866,63,172402
13526,0.001542,74.125.24.0-255,5738,83604,63,172402
13527,0.001544,172.31.40.0-255,66,83670,63,172402
13528,0.001552,74.125.24.0-255,7156,90826,63,172402
13529,0.001554,172.31.40.0-255,66,90892,63,172402
13530,0.001606,172.31.40.0-255,66,90958,63,172402
13531,0.001609,74.125.24.0-255,766,91724,63,172402
13532,0.001634,74.125.24.0-255,4320,96044,63,172402
13533,0.001636,172.31.40.0-255,66,96110,63,172402
13534,0.001642,74.125.24.0-255,4320,100430,63,172402
13535,0.001644,172.31.40.0-255,66,100496,63,172402
13536,0.001671,74.125.24.0-255,1484,101980,63,172402
13537,0.001686,172.31.40.0-255,66,102046,63,172402
13538,0.001697,172.31.40.0-255,66,102112,63,172402
13539,0.00172,74.125.24.0-255,3602,105714,63,172402
13540,0.001723,172.31.40.0-255,66,105780,63,172402
13541,0.001758,74.125.24.0-255,1484,107264,63,172402
13542,0.001763,74.125.24.0-255,2902,110166,63,172402
13543,0.001766,172.31.40.0-255,66,110232,63,172402
13544,0.001786,74.125.24.0-255,5738,115970,63,172402
13545,0.001789,172.31.40.0-255,66,116036,63,172402
13546,0.001825,74.125.24.0-255,2902,118938,63,172402
13547,0.001828,172.31.40.0-255,66,119004,63,172402
13548,0.001853,74.125.24.0-255,4320,123324,63,172402
13549,0.001869,74.125.24.0-255,2184,125508,63,172402
13550,0.001873,172.31.40.0-255,66,125574,63,172402
13551,0.001876,172.31.40.0-255,66,125640,63,172402
13552,0.001878,172.31.40.0-255,66,125706,63,172402
13553,0.002128,74.125.24.0-255,1484,127190,63,172402
13554,0.002147,74.125.24.0-255,2902,130092,63,172402
13555,0.002153,74.125.24.0-255,5738,135830,63,172402
13556,0.002158,172.31.40.0-255,66,135896,63,172402
13557,0.002165,172.31.40.0-255,66,135962,63,172402
13558,0.002169,74.125.24.0-255,1484,137446,63,172402
13559,0.002212,172.31.40.0-255,66,137512,63,172402
13560,0.002224,172.31.40.0-255,66,137578,63,172402
13561,0.004837,74.125.24.0-255,5738,143316,63,172402
13562,0.00485,172.31.40.0-255,66,143382,63,172402
13563,0.007432,74.125.24.0-255,5738,149120,63,172402
13564,0.007445,172.31.40.0-255,66,149186,63,172402
13565,0.010019,74.125.24.0-255,5738,154924,63,172402
13566,0.010038,172.31.40.0-255,66,154990,63,172402
13567,0.012629,74.125.24.0-255,5738,160728,63,172402
13568,0.012649,172.31.40.0-255,66,160794,63,172402
13569,0.015206,74.125.24.0-255,5738,166532,63,172402
13570,0.015218,172.31.40.0-255,66,166598,63,172402
13571,0.01779,74.125.24.0-255,5738,172336,63,172402
13572,0.0178,172.31.40.0-255,66,172402,63,172402
13573,0.0,172.217.194.0-255,151,151,63,211104
13574,2.4e-05,172.31.40.0-255,66,217,63,211104
13575,3.1e-05,172.217.194.0-255,1484,1701,63,211104
13576,3.6e-05,172.31.40.0-255,66,1767,63,211104
13577,4.1e-05,172.217.194.0-255,2902,4669,63,211104
13578,4.5e-05,172.31.40.0-255,66,4735,63,211104
13579,5.2e-05,172.217.194.0-255,7156,11891,63,211104
13580,5.5e-05,172.31.40.0-255,66,11957,63,211104
13581,5.8e-05,172.217.194.0-255,1484,13441,63,211104
13582,6e-05,172.31.40.0-255,66,13507,63,211104
13583,6.4e-05,172.217.194.0-255,1484,14991,63,211104
13584,6.7e-05,172.31.40.0-255,66,15057,63,211104
13585,0.000109,172.31.40.0-255,66,15123,63,211104
13586,0.000117,172.217.194.0-255,6797,21920,63,211104
13587,0.00012,172.31.40.0-255,66,21986,63,211104
13588,0.000162,172.217.194.0-255,1484,23470,63,211104
13589,0.000165,172.31.40.0-255,66,23536,63,211104
13590,0.000169,172.217.194.0-255,1484,25020,63,211104
13591,0.000171,172.31.40.0-255,66,25086,63,211104
13592,0.000186,172.217.194.0-255,1484,26570,63,211104
13593,0.000188,172.31.40.0-255,66,26636,63,211104
13594,0.000195,172.217.194.0-255,5738,32374,63,211104
13595,0.000199,172.31.40.0-255,66,32440,63,211104
13596,0.000226,172.217.194.0-255,6797,39237,63,211104
13597,0.000229,172.31.40.0-255,66,39303,63,211104
13598,0.000629,172.217.194.0-255,1484,40787,63,211104
13599,0.000633,172.31.40.0-255,66,40853,63,211104
13600,0.000649,172.217.194.0-255,2902,43755,63,211104
13601,0.000652,172.31.40.0-255,66,43821,63,211104
13602,0.000657,172.217.194.0-255,4320,48141,63,211104
13603,0.00066,172.31.40.0-255,66,48207,63,211104
13604,0.000678,172.217.194.0-255,1484,49691,63,211104
13605,0.000711,172.217.194.0-255,6797,56488,63,211104
13606,0.000715,172.31.40.0-255,66,56554,63,211104
13607,0.000756,172.217.194.0-255,1484,58038,63,211104
13608,0.000763,172.217.194.0-255,2902,60940,63,211104
13609,0.000765,172.31.40.0-255,66,61006,63,211104
13610,0.000773,172.217.194.0-255,5738,66744,63,211104
13611,0.000776,172.31.40.0-255,66,66810,63,211104
13612,0.000813,172.31.40.0-255,66,66876,63,211104
13613,0.000826,172.31.40.0-255,66,66942,63,211104
13614,0.000828,172.217.194.0-255,288,67230,63,211104
13615,0.000994,172.217.194.0-255,1484,68714,63,211104
13616,0.000998,172.31.40.0-255,66,68780,63,211104
13617,0.001004,172.217.194.0-255,2902,71682,63,211104
13618,0.001007,172.31.40.0-255,66,71748,63,211104
13619,0.001013,172.217.194.0-255,5738,77486,63,211104
13620,0.001016,172.31.40.0-255,66,77552,63,211104
13621,0.001075,172.217.194.0-255,4320,81872,63,211104
13622,0.001078,172.31.40.0-255,66,81938,63,211104
13623,0.001098,172.217.194.0-255,1979,83917,63,211104
13624,0.001101,172.31.40.0-255,66,83983,63,211104
13625,0.001138,172.217.194.0-255,1484,85467,63,211104
13626,0.001173,172.217.194.0-255,2902,88369,63,211104
13627,0.001176,172.31.40.0-255,66,88435,63,211104
13628,0.001199,172.217.194.0-255,4320,92755,63,211104
13629,0.001201,172.31.40.0-255,66,92821,63,211104
13630,0.001215,172.217.194.0-255,1484,94305,63,211104
13631,0.001232,172.217.194.0-255,2902,97207,63,211104
13632,0.001235,172.31.40.0-255,66,97273,63,211104
13633,0.001259,172.217.194.0-255,2951,100224,63,211104
13634,0.001262,172.31.40.0-255,66,100290,63,211104
13635,0.001429,172.217.194.0-255,1484,101774,63,211104
13636,0.001435,172.217.194.0-255,2902,104676,63,211104
13637,0.001439,172.31.40.0-255,66,104742,63,211104
13638,0.001445,172.217.194.0-255,5738,110480,63,211104
13639,0.001448,172.31.40.0-255,66,110546,63,211104
13640,0.001451,172.217.194.0-255,1484,112030,63,211104
13641,0.00147,172.217.194.0-255,7156,119186,63,211104
13642,0.001472,172.31.40.0-255,66,119252,63,211104
13643,0.001501,172.217.194.0-255,4320,123572,63,211104
13644,0.001504,172.31.40.0-255,66,123638,63,211104
13645,0.001517,172.31.40.0-255,66,123704,63,211104
13646,0.001752,172.217.194.0-255,1484,125188,63,211104
13647,0.001758,172.217.194.0-255,2902,128090,63,211104
13648,0.001761,172.31.40.0-255,66,128156,63,211104
13649,0.001767,172.217.194.0-255,2902,131058,63,211104
13650,0.001768,172.31.40.0-255,66,131124,63,211104
13651,0.001783,172.217.194.0-255,2902,134026,63,211104
13652,0.001785,172.31.40.0-255,66,134092,63,211104
13653,0.001798,172.31.40.0-255,66,134158,63,211104
13654,0.001832,172.217.194.0-255,1484,135642,63,211104
13655,0.001882,172.31.40.0-255,66,135708,63,211104
13656,0.00202,172.217.194.0-255,1484,137192,63,211104
13657,0.002027,172.217.194.0-255,2902,140094,63,211104
13658,0.002031,172.31.40.0-255,66,140160,63,211104
13659,0.002037,172.217.194.0-255,5738,145898,63,211104
13660,0.00204,172.31.40.0-255,66,145964,63,211104
13661,0.00207,172.217.194.0-255,7156,153120,63,211104
13662,0.002101,172.31.40.0-255,66,153186,63,211104
13663,0.002106,172.31.40.0-255,66,153252,63,211104
13664,0.002128,172.217.194.0-255,5738,158990,63,211104
13665,0.002133,172.31.40.0-255,66,159056,63,211104
13666,0.002155,172.217.194.0-255,2184,161240,63,211104
13667,0.002166,172.31.40.0-255,66,161306,63,211104
13668,0.002411,172.217.194.0-255,1484,162790,63,211104
13669,0.002416,172.217.194.0-255,1484,164274,63,211104
13670,0.002419,172.31.40.0-255,66,164340,63,211104
13671,0.002437,172.217.194.0-255,1484,165824,63,211104
13672,0.002442,172.217.194.0-255,2902,168726,63,211104
13673,0.002448,172.31.40.0-255,66,168792,63,211104
13674,0.002493,172.31.40.0-255,66,168858,63,211104
13675,0.002552,172.217.194.0-255,6438,175296,63,211104
13676,0.002562,172.31.40.0-255,66,175362,63,211104
13677,0.003021,172.217.194.0-255,1484,176846,63,211104
13678,0.003027,172.217.194.0-255,2902,179748,63,211104
13679,0.00303,172.31.40.0-255,66,179814,63,211104
13680,0.003035,172.217.194.0-255,4320,184134,63,211104
13681,0.003037,172.31.40.0-255,66,184200,63,211104
13682,0.003068,172.217.194.0-255,1484,185684,63,211104
13683,0.003095,172.31.40.0-255,66,185750,63,211104
13684,0.0031,172.217.194.0-255,4320,190070,63,211104
13685,0.003102,172.31.40.0-255,66,190136,63,211104
13686,0.003104,172.217.194.0-255,1484,191620,63,211104
13687,0.00317,172.31.40.0-255,66,191686,63,211104
13688,0.003187,172.217.194.0-255,3602,195288,63,211104
13689,0.003189,172.31.40.0-255,66,195354,63,211104
13690,0.003199,172.31.40.0-255,66,195420,63,211104
13691,0.003224,172.217.194.0-255,7156,202576,63,211104
13692,0.003246,172.31.40.0-255,66,202642,63,211104
13693,0.003262,172.217.194.0-255,5738,208380,63,211104
13694,0.003271,172.31.40.0-255,66,208446,63,211104
13695,0.003304,172.31.40.0-255,66,208512,63,211104
13696,0.003314,172.217.194.0-255,2184,210696,63,211104
13697,0.003369,172.31.40.0-255,66,210762,63,211104
13698,0.003376,172.217.194.0-255,105,210867,63,211104
13699,0.00497,172.31.40.0-255,66,210933,63,211104
13700,0.005007,172.31.40.0-255,105,211038,63,211104
13701,0.007257,172.217.194.0-255,66,211104,63,211104
13702,0.0,74.125.68.0-255,153,153,63,151324
13703,2.2e-05,172.31.40.0-255,66,219,63,151324
13704,2.9e-05,74.125.68.0-255,1484,1703,63,151324
13705,3.4e-05,172.31.40.0-255,66,1769,63,151324
13706,3.9e-05,74.125.68.0-255,2902,4671,63,151324
13707,4.2e-05,172.31.40.0-255,66,4737,63,151324
13708,4.8e-05,74.125.68.0-255,4320,9057,63,151324
13709,5.1e-05,172.31.40.0-255,66,9123,63,151324
13710,7.3e-05,74.125.68.0-255,1484,10607,63,151324
13711,7.5e-05,172.31.40.0-255,66,10673,63,151324
13712,8e-05,74.125.68.0-255,2902,13575,63,151324
13713,8.2e-05,172.31.40.0-255,66,13641,63,151324
13714,8.7e-05,74.125.68.0-255,3492,17133,63,151324
13715,9e-05,172.31.40.0-255,66,17199,63,151324
13716,9.4e-05,74.125.68.0-255,2902,20101,63,151324
13717,9.6e-05,172.31.40.0-255,66,20167,63,151324
13718,0.00012,74.125.68.0-255,5738,25905,63,151324
13719,0.000122,172.31.40.0-255,66,25971,63,151324
13720,0.000158,74.125.68.0-255,5379,31350,63,151324
13721,0.000162,172.31.40.0-255,66,31416,63,151324
13722,0.000307,74.125.68.0-255,1484,32900,63,151324
13723,0.000311,172.31.40.0-255,66,32966,63,151324
13724,0.000317,74.125.68.0-255,2902,35868,63,151324
13725,0.000319,172.31.40.0-255,66,35934,63,151324
13726,0.000355,74.125.68.0-255,5738,41672,63,151324
13727,0.000359,172.31.40.0-255,66,41738,63,151324
13728,0.000366,74.125.68.0-255,6797,48535,63,151324
13729,0.000368,172.31.40.0-255,66,48601,63,151324
13730,0.000382,74.125.68.0-255,2902,51503,63,151324
13731,0.000385,172.31.40.0-255,66,51569,63,151324
13732,0.000399,74.125.68.0-255,4320,55889,63,151324
13733,0.000402,172.31.40.0-255,66,55955,63,151324
13734,0.000405,74.125.68.0-255,1484,57439,63,151324
13735,0.000436,172.31.40.0-255,66,57505,63,151324
13736,0.000629,74.125.68.0-255,112,57617,63,151324
13737,0.000644,74.125.68.0-255,333,57950,63,151324
13738,0.000995,74.125.68.0-255,1484,59434,63,151324
13739,0.001,172.31.40.0-255,66,59500,63,151324
13740,0.001005,74.125.68.0-255,2902,62402,63,151324
13741,0.001007,172.31.40.0-255,66,62468,63,151324
13742,0.001029,74.125.68.0-255,4320,66788,63,151324
13743,0.001032,172.31.40.0-255,66,66854,63,151324
13744,0.001046,74.125.68.0-255,1484,68338,63,151324
13745,0.001078,172.31.40.0-255,66,68404,63,151324
13746,0.001113,74.125.68.0-255,5738,74142,63,151324
13747,0.001116,172.31.40.0-255,66,74208,63,151324
13748,0.001136,74.125.68.0-255,5020,79228,63,151324
13749,0.001138,172.31.40.0-255,66,79294,63,151324
13750,0.001576,74.125.68.0-255,1484,80778,63,151324
13751,0.001584,74.125.68.0-255,2902,83680,63,151324
13752,0.001588,172.31.40.0-255,66,83746,63,151324
13753,0.001611,74.125.68.0-255,5738,89484,63,151324
13754,0.001614,172.31.40.0-255,66,89550,63,151324
13755,0.001645,172.31.40.0-255,66,89616,63,151324
13756,0.001649,74.125.68.0-255,2902,92518,63,151324
13757,0.001651,172.31.40.0-255,66,92584,63,151324
13758,0.001677,74.125.68.0-255,7156,99740,63,151324
13759,0.00168,172.31.40.0-255,66,99806,63,151324
13760,0.001686,74.125.68.0-255,5020,104826,63,151324
13761,0.001689,172.31.40.0-255,66,104892,63,151324
13762,0.003767,74.125.68.0-255,5738,110630,63,151324
13763,0.003778,172.31.40.0-255,66,110696,63,151324
13764,0.005845,74.125.68.0-255,5738,116434,63,151324
13765,0.005851,172.31.40.0-255,66,116500,63,151324
13766,0.007922,74.125.68.0-255,5738,122238,63,151324
13767,0.00793,172.31.40.0-255,66,122304,63,151324
13768,0.009995,74.125.68.0-255,5738,128042,63,151324
13769,0.010001,172.31.40.0-255,66,128108,63,151324
13770,0.01209,74.125.68.0-255,5738,133846,63,151324
13771,0.012098,172.31.40.0-255,66,133912,63,151324
13772,0.014162,74.125.68.0-255,5738,139650,63,151324
13773,0.01417,172.31.40.0-255,66,139716,63,151324
13774,0.016244,74.125.68.0-255,5738,145454,63,151324
13775,0.016255,172.31.40.0-255,66,145520,63,151324
13776,0.018375,74.125.68.0-255,5738,151258,63,151324
13777,0.018385,172.31.40.0-255,66,151324,63,151324
13778,0.0,74.125.24.0-255,150,150,63,132476
13779,1.5e-05,172.31.40.0-255,66,216,63,132476
13780,2.1e-05,74.125.24.0-255,1484,1700,63,132476
13781,2.5e-05,172.31.40.0-255,66,1766,63,132476
13782,3.1e-05,74.125.24.0-255,2902,4668,63,132476
13783,3.3e-05,172.31.40.0-255,66,4734,63,132476
13784,6.4e-05,74.125.24.0-255,5738,10472,63,132476
13785,6.7e-05,172.31.40.0-255,66,10538,63,132476
13786,8.4e-05,74.125.24.0-255,1484,12022,63,132476
13787,8.6e-05,172.31.40.0-255,66,12088,63,132476
13788,9.9e-05,74.125.24.0-255,2101,14189,63,132476
13789,0.000101,172.31.40.0-255,66,14255,63,132476
13790,0.000137,74.125.24.0-255,1484,15739,63,132476
13791,0.00014,74.125.24.0-255,1484,17223,63,132476
13792,0.000144,172.31.40.0-255,66,17289,63,132476
13793,0.000147,172.31.40.0-255,66,17355,63,132476
13794,0.000155,74.125.24.0-255,1484,18839,63,132476
13795,0.000157,172.31.40.0-255,66,18905,63,132476
13796,0.000164,74.125.24.0-255,5738,24643,63,132476
13797,0.000167,172.31.40.0-255,66,24709,63,132476
13798,0.000204,74.125.24.0-255,6797,31506,63,132476
13799,0.000206,172.31.40.0-255,66,31572,63,132476
13800,0.000214,74.125.24.0-255,7156,38728,63,132476
13801,0.000216,172.31.40.0-255,66,38794,63,132476
13802,0.000237,74.125.24.0-255,2902,41696,63,132476
13803,0.00024,172.31.40.0-255,66,41762,63,132476
13804,0.000263,74.125.24.0-255,6797,48559,63,132476
13805,0.000266,172.31.40.0-255,66,48625,63,132476
13806,0.000308,172.31.40.0-255,66,48691,63,132476
13807,0.000343,74.125.24.0-255,5738,54429,63,132476
13808,0.000345,172.31.40.0-255,66,54495,63,132476
13809,0.000361,74.125.24.0-255,2889,57384,63,132476
13810,0.000363,172.31.40.0-255,66,57450,63,132476
13811,0.00089,74.125.24.0-255,332,57782,63,132476
13812,0.001035,172.31.40.0-255,66,57848,63,132476
13813,0.001275,74.125.24.0-255,1484,59332,63,132476
13814,0.001284,74.125.24.0-255,2902,62234,63,132476
13815,0.001288,172.31.40.0-255,66,62300,63,132476
13816,0.001294,74.125.24.0-255,2902,65202,63,132476
13817,0.001296,172.31.40.0-255,66,65268,63,132476
13818,0.001311,74.125.24.0-255,2902,68170,63,132476
13819,0.001313,172.31.40.0-255,66,68236,63,132476
13820,0.001325,172.31.40.0-255,66,68302,63,132476
13821,0.001348,74.125.24.0-255,1484,69786,63,132476
13822,0.001378,172.31.40.0-255,66,69852,63,132476
13823,0.00193,74.125.24.0-255,1484,71336,63,132476
13824,0.001939,74.125.24.0-255,2902,74238,63,132476
13825,0.001943,172.31.40.0-255,66,74304,63,132476
13826,0.00195,74.125.24.0-255,5738,80042,63,132476
13827,0.001952,172.31.40.0-255,66,80108,63,132476
13828,0.001957,74.125.24.0-255,2902,83010,63,132476
13829,0.001959,172.31.40.0-255,66,83076,63,132476
13830,0.001987,74.125.24.0-255,7156,90232,63,132476
13831,0.001989,172.31.40.0-255,66,90298,63,132476
13832,0.002006,74.125.24.0-255,1484,91782,63,132476
13833,0.002031,172.31.40.0-255,66,91848,63,132476
13834,0.004286,74.125.24.0-255,5738,97586,63,132476
13835,0.004288,172.31.40.0-255,66,97652,63,132476
13836,0.006563,74.125.24.0-255,5738,103390,63,132476
13837,0.006568,172.31.40.0-255,66,103456,63,132476
13838,0.008862,74.125.24.0-255,5738,109194,63,132476
13839,0.00887,172.31.40.0-255,66,109260,63,132476
13840,0.011149,74.125.24.0-255,5738,114998,63,132476
13841,0.011158,172.31.40.0-255,66,115064,63,132476
13842,0.013452,74.125.24.0-255,5738,120802,63,132476
13843,0.013464,172.31.40.0-255,66,120868,63,132476
13844,0.015744,74.125.24.0-255,5738,126606,63,132476
13845,0.015753,172.31.40.0-255,66,126672,63,132476
13846,0.018046,74.125.24.0-255,5738,132410,63,132476
13847,0.018054,172.31.40.0-255,66,132476,63,132476
13848,0.0,74.125.68.0-255,152,152,63,219910
13849,2.6e-05,172.31.40.0-255,66,218,63,219910
13850,3.4e-05,74.125.68.0-255,1484,1702,63,219910
13851,3.9e-05,172.31.40.0-255,66,1768,63,219910
13852,4.4e-05,74.125.68.0-255,2902,4670,63,219910
13853,4.8e-05,172.31.40.0-255,66,4736,63,219910
13854,5.4e-05,74.125.68.0-255,4320,9056,63,219910
13855,5.7e-05,172.31.40.0-255,66,9122,63,219910
13856,6.3e-05,74.125.68.0-255,4952,14074,63,219910
13857,6.6e-05,172.31.40.0-255,66,14140,63,219910
13858,0.000163,74.125.68.0-255,1484,15624,63,219910
13859,0.000166,172.31.40.0-255,66,15690,63,219910
13860,0.000187,74.125.68.0-255,2902,18592,63,219910
13861,0.000189,172.31.40.0-255,66,18658,63,219910
13862,0.000194,74.125.68.0-255,4320,22978,63,219910
13863,0.000197,172.31.40.0-255,66,23044,63,219910
13864,0.000235,74.125.68.0-255,7156,30200,63,219910
13865,0.000239,172.31.40.0-255,66,30266,63,219910
13866,0.000257,74.125.68.0-255,2543,32809,63,219910
13867,0.000259,172.31.40.0-255,66,32875,63,219910
13868,0.00027,172.31.40.0-255,66,32941,63,219910
13869,0.000273,74.125.68.0-255,1484,34425,63,219910
13870,0.000275,172.31.40.0-255,66,34491,63,219910
13871,0.000308,172.31.40.0-255,66,34557,63,219910
13872,0.00032,172.31.40.0-255,66,34623,63,219910
13873,0.000337,74.125.68.0-255,1484,36107,63,219910
13874,0.00034,172.31.40.0-255,66,36173,63,219910
13875,0.000343,74.125.68.0-255,766,36939,63,219910
13876,0.000345,172.31.40.0-255,66,37005,63,219910
13877,0.000364,74.125.68.0-255,677,37682,63,219910
13878,0.000724,74.125.68.0-255,1484,39166,63,219910
13879,0.00073,74.125.68.0-255,2902,42068,63,219910
13880,0.000742,172.31.40.0-255,66,42134,63,219910
13881,0.000746,172.31.40.0-255,66,42200,63,219910
13882,0.000751,74.125.68.0-255,4320,46520,63,219910
13883,0.000754,172.31.40.0-255,66,46586,63,219910
13884,0.000768,74.125.68.0-255,2902,49488,63,219910
13885,0.000771,172.31.40.0-255,66,49554,63,219910
13886,0.000793,74.125.68.0-255,5738,55292,63,219910
13887,0.000797,172.31.40.0-255,66,55358,63,219910
13888,0.000804,74.125.68.0-255,5738,61096,63,219910
13889,0.000806,172.31.40.0-255,66,61162,63,219910
13890,0.000812,74.125.68.0-255,7156,68318,63,219910
13891,0.000814,172.31.40.0-255,66,68384,63,219910
13892,0.000861,74.125.68.0-255,3602,71986,63,219910
13893,0.000863,172.31.40.0-255,66,72052,63,219910
13894,0.000924,74.125.68.0-255,1484,73536,63,219910
13895,0.000928,74.125.68.0-255,1484,75020,63,219910
13896,0.000931,172.31.40.0-255,66,75086,63,219910
13897,0.00095,74.125.68.0-255,1484,76570,63,219910
13898,0.000956,74.125.68.0-255,4320,80890,63,219910
13899,0.000958,172.31.40.0-255,66,80956,63,219910
13900,0.00099,172.31.40.0-255,66,81022,63,219910
13901,0.000998,74.125.68.0-255,7156,88178,63,219910
13902,0.001001,172.31.40.0-255,66,88244,63,219910
13903,0.001035,172.31.40.0-255,66,88310,63,219910
13904,0.001038,74.125.68.0-255,766,89076,63,219910
13905,0.001104,74.125.68.0-255,1484,90560,63,219910
13906,0.001108,172.31.40.0-255,66,90626,63,219910
13907,0.001113,74.125.68.0-255,2902,93528,63,219910
13908,0.001115,172.31.40.0-255,66,93594,63,219910
13909,0.001141,74.125.68.0-255,5738,99332,63,219910
13910,0.001144,172.31.40.0-255,66,99398,63,219910
13911,0.001148,74.125.68.0-255,2902,102300,63,219910
13912,0.001149,172.31.40.0-255,66,102366,63,219910
13913,0.001174,74.125.68.0-255,5738,108104,63,219910
13914,0.001177,172.31.40.0-255,66,108170,63,219910
13915,0.001196,74.125.68.0-255,4320,112490,63,219910
13916,0.001199,172.31.40.0-255,66,112556,63,219910
13917,0.00121,172.31.40.0-255,66,112622,63,219910
13918,0.001241,74.125.68.0-255,766,113388,63,219910
13919,0.001349,74.125.68.0-255,1484,114872,63,219910
13920,0.001353,172.31.40.0-255,66,114938,63,219910
13921,0.001357,74.125.68.0-255,1484,116422,63,219910
13922,0.001373,74.125.68.0-255,1484,117906,63,219910
13923,0.001375,172.31.40.0-255,66,117972,63,219910
13924,0.001382,74.125.68.0-255,5738,123710,63,219910
13925,0.001384,172.31.40.0-255,66,123776,63,219910
13926,0.001411,74.125.68.0-255,7156,130932,63,219910
13927,0.001413,172.31.40.0-255,66,130998,63,219910
13928,0.001418,74.125.68.0-255,2902,133900,63,219910
13929,0.00142,172.31.40.0-255,66,133966,63,219910
13930,0.001435,74.125.68.0-255,5738,139704,63,219910
13931,0.001437,172.31.40.0-255,66,139770,63,219910
13932,0.001476,172.31.40.0-255,66,139836,63,219910
13933,0.001645,74.125.68.0-255,1484,141320,63,219910
13934,0.001648,74.125.68.0-255,1484,142804,63,219910
13935,0.001652,172.31.40.0-255,66,142870,63,219910
13936,0.001666,74.125.68.0-255,1484,144354,63,219910
13937,0.001673,74.125.68.0-255,5738,150092,63,219910
13938,0.001676,172.31.40.0-255,66,150158,63,219910
13939,0.001704,74.125.68.0-255,5738,155896,63,219910
13940,0.001706,172.31.40.0-255,66,155962,63,219910
13941,0.001729,74.125.68.0-255,7156,163118,63,219910
13942,0.001731,172.31.40.0-255,66,163184,63,219910
13943,0.001764,172.31.40.0-255,66,163250,63,219910
13944,0.00177,74.125.68.0-255,4320,167570,63,219910
13945,0.001772,172.31.40.0-255,66,167636,63,219910
13946,0.001815,74.125.68.0-255,5738,173374,63,219910
13947,0.00182,172.31.40.0-255,66,173440,63,219910
13948,0.001858,172.31.40.0-255,66,173506,63,219910
13949,0.001865,74.125.68.0-255,6438,179944,63,219910
13950,0.001867,172.31.40.0-255,66,180010,63,219910
13951,0.00187,74.125.68.0-255,1484,181494,63,219910
13952,0.001904,172.31.40.0-255,66,181560,63,219910
13953,0.001917,172.31.40.0-255,66,181626,63,219910
13954,0.001956,74.125.68.0-255,2902,184528,63,219910
13955,0.001958,172.31.40.0-255,66,184594,63,219910
13956,0.001984,74.125.68.0-255,5738,190332,63,219910
13957,0.001987,172.31.40.0-255,66,190398,63,219910
13958,0.001998,172.31.40.0-255,66,190464,63,219910
13959,0.002003,74.125.68.0-255,2902,193366,63,219910
13960,0.002005,172.31.40.0-255,66,193432,63,219910
13961,0.002059,74.125.68.0-255,7156,200588,63,219910
13962,0.002063,172.31.40.0-255,66,200654,63,219910
13963,0.002071,172.31.40.0-255,66,200720,63,219910
13964,0.002096,172.31.40.0-255,66,200786,63,219910
13965,0.002122,74.125.68.0-255,2184,202970,63,219910
13966,0.002125,172.31.40.0-255,66,203036,63,219910
13967,0.002141,172.31.40.0-255,66,203102,63,219910
13968,0.002148,74.125.68.0-255,5738,208840,63,219910
13969,0.00215,172.31.40.0-255,66,208906,63,219910
13970,0.002207,172.31.40.0-255,66,208972,63,219910
13971,0.002219,172.31.40.0-255,66,209038,63,219910
13972,0.004418,74.125.68.0-255,5738,214776,63,219910
13973,0.004432,172.31.40.0-255,66,214842,63,219910
13974,0.006622,74.125.68.0-255,4831,219673,63,219910
13975,0.006637,172.31.40.0-255,66,219739,63,219910
13976,0.015299,172.31.40.0-255,105,219844,63,219910
13977,0.017469,74.125.68.0-255,66,219910,63,219910
13978,0.0,74.125.24.0-255,297,297,63,102153
13979,2.4e-05,172.31.40.0-255,66,363,63,102153
13980,3e-05,74.125.24.0-255,1484,1847,63,102153
13981,3.5e-05,172.31.40.0-255,66,1913,63,102153
13982,4.2e-05,74.125.24.0-255,4320,6233,63,102153
13983,4.6e-05,172.31.40.0-255,66,6299,63,102153
13984,5.3e-05,74.125.24.0-255,5738,12037,63,102153
13985,6.4e-05,172.31.40.0-255,66,12103,63,102153
13986,8.4e-05,74.125.24.0-255,1740,13843,63,102153
13987,8.7e-05,172.31.40.0-255,66,13909,63,102153
13988,9.6e-05,74.125.24.0-255,2902,16811,63,102153
13989,9.9e-05,172.31.40.0-255,66,16877,63,102153
13990,0.000127,74.125.24.0-255,4320,21197,63,102153
13991,0.000131,172.31.40.0-255,66,21263,63,102153
13992,0.000142,172.31.40.0-255,66,21329,63,102153
13993,0.000144,74.125.24.0-255,1125,22454,63,102153
13994,0.000147,172.31.40.0-255,66,22520,63,102153
13995,0.000389,74.125.24.0-255,1484,24004,63,102153
13996,0.000394,172.31.40.0-255,66,24070,63,102153
13997,0.0004,74.125.24.0-255,2902,26972,63,102153
13998,0.000402,172.31.40.0-255,66,27038,63,102153
13999,0.000408,74.125.24.0-255,5738,32776,63,102153
14000,0.00041,172.31.40.0-255,66,32842,63,102153
14001,0.000432,74.125.24.0-255,1484,34326,63,102153
14002,0.000435,172.31.40.0-255,66,34392,63,102153
14003,0.000469,172.31.40.0-255,66,34458,63,102153
14004,0.00048,172.31.40.0-255,66,34524,63,102153
14005,0.001052,74.125.24.0-255,415,34939,63,102153
14006,0.001057,172.31.40.0-255,66,35005,63,102153
14007,0.001096,74.125.24.0-255,328,35333,63,102153
14008,0.001137,172.31.40.0-255,66,35399,63,102153
14009,0.001522,74.125.24.0-255,1484,36883,63,102153
14010,0.001532,74.125.24.0-255,2902,39785,63,102153
14011,0.001537,172.31.40.0-255,66,39851,63,102153
14012,0.001574,74.125.24.0-255,5738,45589,63,102153
14013,0.001576,172.31.40.0-255,66,45655,63,102153
14014,0.001583,74.125.24.0-255,5738,51393,63,102153
14015,0.001586,172.31.40.0-255,66,51459,63,102153
14016,0.001621,74.125.24.0-255,7156,58615,63,102153
14017,0.001624,172.31.40.0-255,66,58681,63,102153
14018,0.001633,172.31.40.0-255,66,58747,63,102153
14019,0.001666,74.125.24.0-255,2184,60931,63,102153
14020,0.001669,172.31.40.0-255,66,60997,63,102153
14021,0.003945,74.125.24.0-255,2902,63899,63,102153
14022,0.003953,172.31.40.0-255,66,63965,63,102153
14023,0.003982,74.125.24.0-255,2902,66867,63,102153
14024,0.003984,172.31.40.0-255,66,66933,63,102153
14025,0.006287,74.125.24.0-255,2902,69835,63,102153
14026,0.006293,172.31.40.0-255,66,69901,63,102153
14027,0.006329,74.125.24.0-255,2902,72803,63,102153
14028,0.006332,172.31.40.0-255,66,72869,63,102153
14029,0.008617,74.125.24.0-255,2902,75771,63,102153
14030,0.008626,172.31.40.0-255,66,75837,63,102153
14031,0.008657,74.125.24.0-255,2902,78739,63,102153
14032,0.00866,172.31.40.0-255,66,78805,63,102153
14033,0.010909,74.125.24.0-255,2902,81707,63,102153
14034,0.010918,172.31.40.0-255,66,81773,63,102153
14035,0.010948,74.125.24.0-255,2902,84675,63,102153
14036,0.010951,172.31.40.0-255,66,84741,63,102153
14037,0.013251,74.125.24.0-255,5738,90479,63,102153
14038,0.013261,172.31.40.0-255,66,90545,63,102153
14039,0.015577,74.125.24.0-255,5738,96283,63,102153
14040,0.015592,172.31.40.0-255,66,96349,63,102153
14041,0.017912,74.125.24.0-255,5738,102087,63,102153
14042,0.017921,172.31.40.0-255,66,102153,63,102153
14043,0.0,172.217.194.0-255,153,153,63,168007
14044,2.1e-05,172.31.40.0-255,66,219,63,168007
14045,2.8e-05,172.217.194.0-255,1484,1703,63,168007
14046,3.2e-05,172.31.40.0-255,66,1769,63,168007
14047,3.7e-05,172.217.194.0-255,2902,4671,63,168007
14048,4e-05,172.31.40.0-255,66,4737,63,168007
14049,4.8e-05,172.217.194.0-255,7156,11893,63,168007
14050,5.1e-05,172.31.40.0-255,66,11959,63,168007
14051,0.000126,172.217.194.0-255,4974,16933,63,168007
14052,0.000129,172.31.40.0-255,66,16999,63,168007
14053,0.00019,172.217.194.0-255,5738,22737,63,168007
14054,0.000193,172.31.40.0-255,66,22803,63,168007
14055,0.000255,172.217.194.0-255,5738,28541,63,168007
14056,0.000259,172.31.40.0-255,66,28607,63,168007
14057,0.000284,172.217.194.0-255,7156,35763,63,168007
14058,0.000288,172.31.40.0-255,66,35829,63,168007
14059,0.000404,172.217.194.0-255,4320,40149,63,168007
14060,0.000409,172.31.40.0-255,66,40215,63,168007
14061,0.000443,172.31.40.0-255,66,40281,63,168007
14062,0.000568,172.217.194.0-255,4320,44601,63,168007
14063,0.000572,172.31.40.0-255,66,44667,63,168007
14064,0.000606,172.31.40.0-255,66,44733,63,168007
14065,0.000761,172.217.194.0-255,7156,51889,63,168007
14066,0.000765,172.31.40.0-255,66,51955,63,168007
14067,0.000794,172.31.40.0-255,66,52021,63,168007
14068,0.000967,172.31.40.0-255,66,52087,63,168007
14069,0.00099,172.217.194.0-255,5020,57107,63,168007
14070,0.000994,172.31.40.0-255,66,57173,63,168007
14071,0.001149,172.217.194.0-255,1484,58657,63,168007
14072,0.001166,172.217.194.0-255,2902,61559,63,168007
14073,0.001169,172.31.40.0-255,66,61625,63,168007
14074,0.001194,172.217.194.0-255,1484,63109,63,168007
14075,0.00121,172.217.194.0-255,4320,67429,63,168007
14076,0.001223,172.31.40.0-255,66,67495,63,168007
14077,0.001281,172.217.194.0-255,7156,74651,63,168007
14078,0.001284,172.31.40.0-255,66,74717,63,168007
14079,0.001306,172.217.194.0-255,5738,80455,63,168007
14080,0.001342,172.31.40.0-255,66,80521,63,168007
14081,0.001452,172.31.40.0-255,66,80587,63,168007
14082,0.001565,172.31.40.0-255,66,80653,63,168007
14083,0.001607,172.31.40.0-255,66,80719,63,168007
14084,0.001916,172.217.194.0-255,2902,83621,63,168007
14085,0.00192,172.31.40.0-255,66,83687,63,168007
14086,0.001932,172.217.194.0-255,766,84453,63,168007
14087,0.001942,172.217.194.0-255,1484,85937,63,168007
14088,0.001949,172.31.40.0-255,66,86003,63,168007
14089,0.001959,172.217.194.0-255,2902,88905,63,168007
14090,0.001978,172.31.40.0-255,66,88971,63,168007
14091,0.002021,172.217.194.0-255,5738,94709,63,168007
14092,0.002024,172.31.40.0-255,66,94775,63,168007
14093,0.002066,172.217.194.0-255,5738,100513,63,168007
14094,0.002083,172.217.194.0-255,5738,106251,63,168007
14095,0.002088,172.31.40.0-255,66,106317,63,168007
14096,0.002196,172.217.194.0-255,5738,112055,63,168007
14097,0.00221,172.31.40.0-255,66,112121,63,168007
14098,0.00223,172.217.194.0-255,6438,118559,63,168007
14099,0.002238,172.31.40.0-255,66,118625,63,168007
14100,0.002358,172.31.40.0-255,66,118691,63,168007
14101,0.002381,172.31.40.0-255,66,118757,63,168007
14102,0.002554,172.217.194.0-255,4320,123077,63,168007
14103,0.002558,172.31.40.0-255,66,123143,63,168007
14104,0.002602,172.31.40.0-255,66,123209,63,168007
14105,0.002658,172.217.194.0-255,5020,128229,63,168007
14106,0.003072,172.217.194.0-255,6438,134667,63,168007
14107,0.003141,172.217.194.0-255,2902,137569,63,168007
14108,0.003757,172.217.194.0-255,7156,144725,63,168007
14109,0.00905,172.31.40.0-255,66,144791,63,168007
14110,0.011655,172.217.194.0-255,5738,150529,63,168007
14111,0.011664,172.31.40.0-255,66,150595,63,168007
14112,0.014276,172.217.194.0-255,5738,156333,63,168007
14113,0.014282,172.31.40.0-255,66,156399,63,168007
14114,0.016926,172.217.194.0-255,5738,162137,63,168007
14115,0.016942,172.31.40.0-255,66,162203,63,168007
14116,0.019629,172.217.194.0-255,5738,167941,63,168007
14117,0.019642,172.31.40.0-255,66,168007,63,168007
14118,0.0,74.125.68.0-255,153,153,63,214988
14119,2.3e-05,172.31.40.0-255,66,219,63,214988
14120,3.1e-05,74.125.68.0-255,1484,1703,63,214988
14121,3.6e-05,172.31.40.0-255,66,1769,63,214988
14122,4.1e-05,74.125.68.0-255,2902,4671,63,214988
14123,5.3e-05,172.31.40.0-255,66,4737,63,214988
14124,5.8e-05,74.125.68.0-255,2902,7639,63,214988
14125,6.1e-05,172.31.40.0-255,66,7705,63,214988
14126,6.6e-05,74.125.68.0-255,4320,12025,63,214988
14127,6.9e-05,172.31.40.0-255,66,12091,63,214988
14128,9.8e-05,74.125.68.0-255,1903,13994,63,214988
14129,0.000105,172.31.40.0-255,66,14060,63,214988
14130,0.000172,74.125.68.0-255,1484,15544,63,214988
14131,0.000176,172.31.40.0-255,66,15610,63,214988
14132,0.000179,74.125.68.0-255,1484,17094,63,214988
14133,0.000181,172.31.40.0-255,66,17160,63,214988
14134,0.000213,74.125.68.0-255,2902,20062,63,214988
14135,0.000216,172.31.40.0-255,66,20128,63,214988
14136,0.000222,74.125.68.0-255,4320,24448,63,214988
14137,0.000224,172.31.40.0-255,66,24514,63,214988
14138,0.000248,74.125.68.0-255,1484,25998,63,214988
14139,0.00025,172.31.40.0-255,66,26064,63,214988
14140,0.000257,74.125.68.0-255,5379,31443,63,214988
14141,0.00026,172.31.40.0-255,66,31509,63,214988
14142,0.000285,74.125.68.0-255,1484,32993,63,214988
14143,0.000287,172.31.40.0-255,66,33059,63,214988
14144,0.000309,74.125.68.0-255,4320,37379,63,214988
14145,0.000311,172.31.40.0-255,66,37445,63,214988
14146,0.000314,74.125.68.0-255,1484,38929,63,214988
14147,0.000316,172.31.40.0-255,66,38995,63,214988
14148,0.00032,74.125.68.0-255,2902,41897,63,214988
14149,0.000322,172.31.40.0-255,66,41963,63,214988
14150,0.00036,74.125.68.0-255,5738,47701,63,214988
14151,0.000363,172.31.40.0-255,66,47767,63,214988
14152,0.000366,74.125.68.0-255,1125,48892,63,214988
14153,0.000648,74.125.68.0-255,1484,50376,63,214988
14154,0.000654,172.31.40.0-255,66,50442,63,214988
14155,0.00066,74.125.68.0-255,2902,53344,63,214988
14156,0.000663,172.31.40.0-255,66,53410,63,214988
14157,0.000666,74.125.68.0-255,1484,54894,63,214988
14158,0.000675,74.125.68.0-255,2902,57796,63,214988
14159,0.000677,172.31.40.0-255,66,57862,63,214988
14160,0.000682,74.125.68.0-255,4320,62182,63,214988
14161,0.000685,172.31.40.0-255,66,62248,63,214988
14162,0.000716,74.125.68.0-255,1484,63732,63,214988
14163,0.00072,74.125.68.0-255,2853,66585,63,214988
14164,0.000722,172.31.40.0-255,66,66651,63,214988
14165,0.000997,74.125.68.0-255,109,66760,63,214988
14166,0.001045,74.125.68.0-255,1484,68244,63,214988
14167,0.001051,172.31.40.0-255,66,68310,63,214988
14168,0.001055,74.125.68.0-255,1484,69794,63,214988
14169,0.00108,74.125.68.0-255,2902,72696,63,214988
14170,0.001083,172.31.40.0-255,66,72762,63,214988
14171,0.001089,74.125.68.0-255,5738,78500,63,214988
14172,0.001091,172.31.40.0-255,66,78566,63,214988
14173,0.001128,172.31.40.0-255,66,78632,63,214988
14174,0.001182,172.31.40.0-255,66,78698,63,214988
14175,0.001193,74.125.68.0-255,2902,81600,63,214988
14176,0.0012,172.31.40.0-255,66,81666,63,214988
14177,0.001225,74.125.68.0-255,766,82432,63,214988
14178,0.001229,74.125.68.0-255,334,82766,63,214988
14179,0.001304,74.125.68.0-255,1484,84250,63,214988
14180,0.001307,172.31.40.0-255,66,84316,63,214988
14181,0.001335,74.125.68.0-255,2902,87218,63,214988
14182,0.001338,172.31.40.0-255,66,87284,63,214988
14183,0.001345,74.125.68.0-255,5738,93022,63,214988
14184,0.001348,172.31.40.0-255,66,93088,63,214988
14185,0.001381,172.31.40.0-255,66,93154,63,214988
14186,0.001424,74.125.68.0-255,7156,100310,63,214988
14187,0.001428,172.31.40.0-255,66,100376,63,214988
14188,0.001453,74.125.68.0-255,4320,104696,63,214988
14189,0.001456,172.31.40.0-255,66,104762,63,214988
14190,0.001486,74.125.68.0-255,2184,106946,63,214988
14191,0.001489,172.31.40.0-255,66,107012,63,214988
14192,0.001517,74.125.68.0-255,2902,109914,63,214988
14193,0.00152,172.31.40.0-255,66,109980,63,214988
14194,0.001525,74.125.68.0-255,4320,114300,63,214988
14195,0.001528,172.31.40.0-255,66,114366,63,214988
14196,0.001543,74.125.68.0-255,2902,117268,63,214988
14197,0.001546,172.31.40.0-255,66,117334,63,214988
14198,0.001559,74.125.68.0-255,2902,120236,63,214988
14199,0.001561,172.31.40.0-255,66,120302,63,214988
14200,0.001602,172.31.40.0-255,66,120368,63,214988
14201,0.001678,172.31.40.0-255,66,120434,63,214988
14202,0.00172,74.125.68.0-255,4320,124754,63,214988
14203,0.001723,172.31.40.0-255,66,124820,63,214988
14204,0.001752,74.125.68.0-255,5738,130558,63,214988
14205,0.001755,172.31.40.0-255,66,130624,63,214988
14206,0.001792,172.31.40.0-255,66,130690,63,214988
14207,0.001817,74.125.68.0-255,2902,133592,63,214988
14208,0.00182,172.31.40.0-255,66,133658,63,214988
14209,0.001835,74.125.68.0-255,2902,136560,63,214988
14210,0.001841,172.31.40.0-255,66,136626,63,214988
14211,0.001877,172.31.40.0-255,66,136692,63,214988
14212,0.001933,74.125.68.0-255,2902,139594,63,214988
14213,0.001936,172.31.40.0-255,66,139660,63,214988
14214,0.001966,74.125.68.0-255,5738,145398,63,214988
14215,0.001969,172.31.40.0-255,66,145464,63,214988
14216,0.002004,74.125.68.0-255,2902,148366,63,214988
14217,0.002009,172.31.40.0-255,66,148432,63,214988
14218,0.002048,172.31.40.0-255,66,148498,63,214988
14219,0.002077,74.125.68.0-255,1484,149982,63,214988
14220,0.002105,172.31.40.0-255,66,150048,63,214988
14221,0.002137,172.31.40.0-255,66,150114,63,214988
14222,0.002171,74.125.68.0-255,6438,156552,63,214988
14223,0.002175,172.31.40.0-255,66,156618,63,214988
14224,0.002261,74.125.68.0-255,4320,160938,63,214988
14225,0.002266,172.31.40.0-255,66,161004,63,214988
14226,0.002301,172.31.40.0-255,66,161070,63,214988
14227,0.002353,74.125.68.0-255,7156,168226,63,214988
14228,0.002358,172.31.40.0-255,66,168292,63,214988
14229,0.002384,74.125.68.0-255,2902,171194,63,214988
14230,0.002387,172.31.40.0-255,66,171260,63,214988
14231,0.002402,74.125.68.0-255,2902,174162,63,214988
14232,0.002408,172.31.40.0-255,66,174228,63,214988
14233,0.002466,172.31.40.0-255,66,174294,63,214988
14234,0.004753,74.125.68.0-255,1484,175778,63,214988
14235,0.004778,74.125.68.0-255,4320,180098,63,214988
14236,0.004783,172.31.40.0-255,66,180164,63,214988
14237,0.007088,74.125.68.0-255,5738,185902,63,214988
14238,0.007103,172.31.40.0-255,66,185968,63,214988
14239,0.009413,74.125.68.0-255,5738,191706,63,214988
14240,0.00943,172.31.40.0-255,66,191772,63,214988
14241,0.011722,74.125.68.0-255,5738,197510,63,214988
14242,0.011727,172.31.40.0-255,66,197576,63,214988
14243,0.014036,74.125.68.0-255,5738,203314,63,214988
14244,0.014046,172.31.40.0-255,66,203380,63,214988
14245,0.016359,74.125.68.0-255,5738,209118,63,214988
14246,0.016366,172.31.40.0-255,66,209184,63,214988
14247,0.018718,74.125.68.0-255,5738,214922,63,214988
14248,0.018734,172.31.40.0-255,66,214988,63,214988
14249,0.0,74.125.24.0-255,152,152,63,162457
14250,2.4e-05,172.31.40.0-255,66,218,63,162457
14251,3.2e-05,74.125.24.0-255,1484,1702,63,162457
14252,3.7e-05,172.31.40.0-255,66,1768,63,162457
14253,4.9e-05,74.125.24.0-255,2902,4670,63,162457
14254,5.3e-05,172.31.40.0-255,66,4736,63,162457
14255,5.8e-05,74.125.24.0-255,2902,7638,63,162457
14256,6e-05,172.31.40.0-255,66,7704,63,162457
14257,7.3e-05,172.31.40.0-255,66,7770,63,162457
14258,0.000113,172.31.40.0-255,66,7836,63,162457
14259,0.000183,74.125.24.0-255,1484,9320,63,162457
14260,0.000187,172.31.40.0-255,66,9386,63,162457
14261,0.000191,74.125.24.0-255,2902,12288,63,162457
14262,0.000194,172.31.40.0-255,66,12354,63,162457
14263,0.000224,74.125.24.0-255,5738,18092,63,162457
14264,0.000227,172.31.40.0-255,66,18158,63,162457
14265,0.000241,172.31.40.0-255,66,18224,63,162457
14266,0.000253,74.125.24.0-255,7156,25380,63,162457
14267,0.000255,172.31.40.0-255,66,25446,63,162457
14268,0.000287,74.125.24.0-255,3900,29346,63,162457
14269,0.000289,172.31.40.0-255,66,29412,63,162457
14270,0.000317,74.125.24.0-255,124,29536,63,162457
14271,0.000319,172.31.40.0-255,66,29602,63,162457
14272,0.000694,74.125.24.0-255,1484,31086,63,162457
14273,0.0007,172.31.40.0-255,66,31152,63,162457
14274,0.000706,74.125.24.0-255,2902,34054,63,162457
14275,0.000709,172.31.40.0-255,66,34120,63,162457
14276,0.000716,74.125.24.0-255,5738,39858,63,162457
14277,0.000723,172.31.40.0-255,66,39924,63,162457
14278,0.000763,172.31.40.0-255,66,39990,63,162457
14279,0.00083,172.31.40.0-255,66,40056,63,162457
14280,0.00088,74.125.24.0-255,1484,41540,63,162457
14281,0.000886,74.125.24.0-255,1484,43024,63,162457
14282,0.000889,172.31.40.0-255,66,43090,63,162457
14283,0.000921,74.125.24.0-255,1484,44574,63,162457
14284,0.000927,74.125.24.0-255,5738,50312,63,162457
14285,0.000931,172.31.40.0-255,66,50378,63,162457
14286,0.000944,172.31.40.0-255,66,50444,63,162457
14287,0.000972,74.125.24.0-255,1484,51928,63,162457
14288,0.000986,172.31.40.0-255,66,51994,63,162457
14289,0.001091,74.125.24.0-255,1484,53478,63,162457
14290,0.001105,74.125.24.0-255,2902,56380,63,162457
14291,0.001109,172.31.40.0-255,66,56446,63,162457
14292,0.001116,74.125.24.0-255,5738,62184,63,162457
14293,0.001118,172.31.40.0-255,66,62250,63,162457
14294,0.001149,172.31.40.0-255,66,62316,63,162457
14295,0.00118,74.125.24.0-255,4320,66636,63,162457
14296,0.001183,172.31.40.0-255,66,66702,63,162457
14297,0.001191,74.125.24.0-255,7156,73858,63,162457
14298,0.001193,172.31.40.0-255,66,73924,63,162457
14299,0.001203,74.125.24.0-255,3602,77526,63,162457
14300,0.001206,172.31.40.0-255,66,77592,63,162457
14301,0.001763,74.125.24.0-255,1484,79076,63,162457
14302,0.00177,74.125.24.0-255,2902,81978,63,162457
14303,0.001773,172.31.40.0-255,66,82044,63,162457
14304,0.001807,74.125.24.0-255,5738,87782,63,162457
14305,0.00181,172.31.40.0-255,66,87848,63,162457
14306,0.001847,172.31.40.0-255,66,87914,63,162457
14307,0.001852,74.125.24.0-255,2902,90816,63,162457
14308,0.001854,172.31.40.0-255,66,90882,63,162457
14309,0.001897,172.31.40.0-255,66,90948,63,162457
14310,0.001911,172.31.40.0-255,66,91014,63,162457
14311,0.001959,172.31.40.0-255,66,91080,63,162457
14312,0.001964,74.125.24.0-255,2902,93982,63,162457
14313,0.001966,172.31.40.0-255,66,94048,63,162457
14314,0.002008,74.125.24.0-255,4320,98368,63,162457
14315,0.002011,172.31.40.0-255,66,98434,63,162457
14316,0.002022,172.31.40.0-255,66,98500,63,162457
14317,0.002043,172.31.40.0-255,66,98566,63,162457
14318,0.002083,172.31.40.0-255,66,98632,63,162457
14319,0.002087,74.125.24.0-255,2184,100816,63,162457
14320,0.00209,172.31.40.0-255,66,100882,63,162457
14321,0.002094,74.125.24.0-255,2902,103784,63,162457
14322,0.002096,172.31.40.0-255,66,103850,63,162457
14323,0.002108,74.125.24.0-255,7156,111006,63,162457
14324,0.002125,172.31.40.0-255,66,111072,63,162457
14325,0.00214,172.31.40.0-255,66,111138,63,162457
14326,0.002147,74.125.24.0-255,6438,117576,63,162457
14327,0.00215,172.31.40.0-255,66,117642,63,162457
14328,0.002242,172.31.40.0-255,66,117708,63,162457
14329,0.002255,172.31.40.0-255,66,117774,63,162457
14330,0.002273,74.125.24.0-255,7156,124930,63,162457
14331,0.002275,172.31.40.0-255,66,124996,63,162457
14332,0.002286,172.31.40.0-255,66,125062,63,162457
14333,0.002327,74.125.24.0-255,1484,126546,63,162457
14334,0.002331,74.125.24.0-255,766,127312,63,162457
14335,0.002338,74.125.24.0-255,5738,133050,63,162457
14336,0.002349,74.125.24.0-255,1484,134534,63,162457
14337,0.007301,172.31.40.0-255,66,134600,63,162457
14338,0.009603,74.125.24.0-255,5738,140338,63,162457
14339,0.009614,172.31.40.0-255,66,140404,63,162457
14340,0.011935,74.125.24.0-255,5738,146142,63,162457
14341,0.011941,172.31.40.0-255,66,146208,63,162457
14342,0.014245,74.125.24.0-255,5738,151946,63,162457
14343,0.014255,172.31.40.0-255,66,152012,63,162457
14344,0.016544,74.125.24.0-255,5738,157750,63,162457
14345,0.016554,172.31.40.0-255,66,157816,63,162457
14346,0.018866,74.125.24.0-255,4575,162391,63,162457
14347,0.018881,172.31.40.0-255,66,162457,63,162457
14348,0.0,74.125.24.0-255,154,154,63,89787
14349,2.4e-05,172.31.40.0-255,66,220,63,89787
14350,3.1e-05,74.125.24.0-255,1484,1704,63,89787
14351,3.6e-05,172.31.40.0-255,66,1770,63,89787
14352,4.2e-05,74.125.24.0-255,2902,4672,63,89787
14353,5.3e-05,172.31.40.0-255,66,4738,63,89787
14354,6e-05,74.125.24.0-255,5738,10476,63,89787
14355,6.3e-05,172.31.40.0-255,66,10542,63,89787
14356,0.000108,172.31.40.0-255,66,10608,63,89787
14357,0.000113,74.125.24.0-255,2902,13510,63,89787
14358,0.000115,172.31.40.0-255,66,13576,63,89787
14359,0.000135,74.125.24.0-255,4320,17896,63,89787
14360,0.000138,172.31.40.0-255,66,17962,63,89787
14361,0.00016,74.125.24.0-255,2543,20505,63,89787
14362,0.000166,172.31.40.0-255,66,20571,63,89787
14363,0.000229,74.125.24.0-255,1484,22055,63,89787
14364,0.000233,172.31.40.0-255,66,22121,63,89787
14365,0.000261,74.125.24.0-255,2902,25023,63,89787
14366,0.000264,172.31.40.0-255,66,25089,63,89787
14367,0.00027,74.125.24.0-255,5738,30827,63,89787
14368,0.000272,172.31.40.0-255,66,30893,63,89787
14369,0.000325,172.31.40.0-255,66,30959,63,89787
14370,0.000336,172.31.40.0-255,66,31025,63,89787
14371,0.000346,74.125.24.0-255,4320,35345,63,89787
14372,0.000348,172.31.40.0-255,66,35411,63,89787
14373,0.000371,74.125.24.0-255,2810,38221,63,89787
14374,0.000378,172.31.40.0-255,66,38287,63,89787
14375,0.000381,74.125.24.0-255,135,38422,63,89787
14376,0.000383,172.31.40.0-255,66,38488,63,89787
14377,0.001146,74.125.24.0-255,349,38837,63,89787
14378,0.001672,74.125.24.0-255,1484,40321,63,89787
14379,0.00168,172.31.40.0-255,66,40387,63,89787
14380,0.001687,74.125.24.0-255,2902,43289,63,89787
14381,0.001694,74.125.24.0-255,4320,47609,63,89787
14382,0.00171,74.125.24.0-255,1484,49093,63,89787
14383,0.001715,74.125.24.0-255,4320,53413,63,89787
14384,0.001718,74.125.24.0-255,1484,54897,63,89787
14385,0.004827,172.31.40.0-255,66,54963,63,89787
14386,0.006864,74.125.24.0-255,5738,60701,63,89787
14387,0.00687,172.31.40.0-255,66,60767,63,89787
14388,0.008906,74.125.24.0-255,5738,66505,63,89787
14389,0.008913,172.31.40.0-255,66,66571,63,89787
14390,0.010964,74.125.24.0-255,5738,72309,63,89787
14391,0.010971,172.31.40.0-255,66,72375,63,89787
14392,0.013009,74.125.24.0-255,5738,78113,63,89787
14393,0.015768,172.31.40.0-255,66,78179,63,89787
14394,0.017821,74.125.24.0-255,5738,83917,63,89787
14395,0.017831,172.31.40.0-255,66,83983,63,89787
14396,0.019893,74.125.24.0-255,5738,89721,63,89787
14397,0.0199,172.31.40.0-255,66,89787,63,89787
14398,0.0,74.125.200.0-255,150,150,63,257955
14399,2.2e-05,172.31.40.0-255,66,216,63,257955
14400,3e-05,74.125.200.0-255,1484,1700,63,257955
14401,3.4e-05,172.31.40.0-255,66,1766,63,257955
14402,4e-05,74.125.200.0-255,2902,4668,63,257955
14403,5.3e-05,172.31.40.0-255,66,4734,63,257955
14404,5.7e-05,74.125.200.0-255,1484,6218,63,257955
14405,6e-05,172.31.40.0-255,66,6284,63,257955
14406,6.5e-05,74.125.200.0-255,2902,9186,63,257955
14407,6.9e-05,172.31.40.0-255,66,9252,63,257955
14408,7.5e-05,74.125.200.0-255,6300,15552,63,257955
14409,7.8e-05,172.31.40.0-255,66,15618,63,257955
14410,8.5e-05,74.125.200.0-255,7156,22774,63,257955
14411,8.8e-05,172.31.40.0-255,66,22840,63,257955
14412,9.8e-05,172.31.40.0-255,66,22906,63,257955
14413,0.000151,74.125.200.0-255,1484,24390,63,257955
14414,0.000153,172.31.40.0-255,66,24456,63,257955
14415,0.000181,74.125.200.0-255,2902,27358,63,257955
14416,0.000183,172.31.40.0-255,66,27424,63,257955
14417,0.000188,74.125.200.0-255,4320,31744,63,257955
14418,0.000191,172.31.40.0-255,66,31810,63,257955
14419,0.000221,74.125.200.0-255,5738,37548,63,257955
14420,0.000224,172.31.40.0-255,66,37614,63,257955
14421,0.000259,172.31.40.0-255,66,37680,63,257955
14422,0.000292,172.31.40.0-255,66,37746,63,257955
14423,0.000295,74.125.200.0-255,132,37878,63,257955
14424,0.000297,172.31.40.0-255,66,37944,63,257955
14425,0.000335,74.125.200.0-255,343,38287,63,257955
14426,0.000337,172.31.40.0-255,66,38353,63,257955
14427,0.000472,74.125.200.0-255,1484,39837,63,257955
14428,0.000479,74.125.200.0-255,2902,42739,63,257955
14429,0.000483,172.31.40.0-255,66,42805,63,257955
14430,0.000487,74.125.200.0-255,1484,44289,63,257955
14431,0.000512,74.125.200.0-255,1484,45773,63,257955
14432,0.000515,172.31.40.0-255,66,45839,63,257955
14433,0.000521,74.125.200.0-255,4320,50159,63,257955
14434,0.000523,172.31.40.0-255,66,50225,63,257955
14435,0.000528,74.125.200.0-255,2902,53127,63,257955
14436,0.00053,172.31.40.0-255,66,53193,63,257955
14437,0.000575,74.125.200.0-255,5738,58931,63,257955
14438,0.000578,172.31.40.0-255,66,58997,63,257955
14439,0.000589,172.31.40.0-255,66,59063,63,257955
14440,0.000626,74.125.200.0-255,1484,60547,63,257955
14441,0.00065,74.125.200.0-255,3602,64149,63,257955
14442,0.000653,172.31.40.0-255,66,64215,63,257955
14443,0.000689,74.125.200.0-255,1484,65699,63,257955
14444,0.000691,74.125.200.0-255,1484,67183,63,257955
14445,0.000694,172.31.40.0-255,66,67249,63,257955
14446,0.00071,74.125.200.0-255,1484,68733,63,257955
14447,0.000714,74.125.200.0-255,1484,70217,63,257955
14448,0.000716,172.31.40.0-255,66,70283,63,257955
14449,0.000742,74.125.200.0-255,4320,74603,63,257955
14450,0.000745,172.31.40.0-255,66,74669,63,257955
14451,0.000749,74.125.200.0-255,2902,77571,63,257955
14452,0.000751,172.31.40.0-255,66,77637,63,257955
14453,0.000788,172.31.40.0-255,66,77703,63,257955
14454,0.000818,172.31.40.0-255,66,77769,63,257955
14455,0.001035,74.125.200.0-255,1484,79253,63,257955
14456,0.001039,74.125.200.0-255,1484,80737,63,257955
14457,0.001042,172.31.40.0-255,66,80803,63,257955
14458,0.001065,74.125.200.0-255,1484,82287,63,257955
14459,0.001071,74.125.200.0-255,4320,86607,63,257955
14460,0.001073,172.31.40.0-255,66,86673,63,257955
14461,0.001101,74.125.200.0-255,7156,93829,63,257955
14462,0.001104,172.31.40.0-255,66,93895,63,257955
14463,0.001117,74.125.200.0-255,1484,95379,63,257955
14464,0.001135,172.31.40.0-255,66,95445,63,257955
14465,0.001172,172.31.40.0-255,66,95511,63,257955
14466,0.001547,74.125.200.0-255,1484,96995,63,257955
14467,0.001568,74.125.200.0-255,2902,99897,63,257955
14468,0.001572,172.31.40.0-255,66,99963,63,257955
14469,0.001579,74.125.200.0-255,5738,105701,63,257955
14470,0.001581,172.31.40.0-255,66,105767,63,257955
14471,0.00162,172.31.40.0-255,66,105833,63,257955
14472,0.001626,74.125.200.0-255,4320,110153,63,257955
14473,0.001628,172.31.40.0-255,66,110219,63,257955
14474,0.001671,74.125.200.0-255,4320,114539,63,257955
14475,0.001674,172.31.40.0-255,66,114605,63,257955
14476,0.001699,74.125.200.0-255,2184,116789,63,257955
14477,0.001702,172.31.40.0-255,66,116855,63,257955
14478,0.001774,74.125.200.0-255,1484,118339,63,257955
14479,0.001792,74.125.200.0-255,2902,121241,63,257955
14480,0.001795,172.31.40.0-255,66,121307,63,257955
14481,0.001802,74.125.200.0-255,5738,127045,63,257955
14482,0.001804,172.31.40.0-255,66,127111,63,257955
14483,0.001812,74.125.200.0-255,2902,130013,63,257955
14484,0.001815,172.31.40.0-255,66,130079,63,257955
14485,0.00184,74.125.200.0-255,4320,134399,63,257955
14486,0.001843,172.31.40.0-255,66,134465,63,257955
14487,0.001873,74.125.200.0-255,5738,140203,63,257955
14488,0.001876,172.31.40.0-255,66,140269,63,257955
14489,0.001892,172.31.40.0-255,66,140335,63,257955
14490,0.002002,74.125.200.0-255,1484,141819,63,257955
14491,0.002006,74.125.200.0-255,1484,143303,63,257955
14492,0.002009,172.31.40.0-255,66,143369,63,257955
14493,0.002041,74.125.200.0-255,2902,146271,63,257955
14494,0.002043,172.31.40.0-255,66,146337,63,257955
14495,0.00205,74.125.200.0-255,5738,152075,63,257955
14496,0.002051,172.31.40.0-255,66,152141,63,257955
14497,0.002073,74.125.200.0-255,2902,155043,63,257955
14498,0.002075,172.31.40.0-255,66,155109,63,257955
14499,0.002099,74.125.200.0-255,7156,162265,63,257955
14500,0.002101,172.31.40.0-255,66,162331,63,257955
14501,0.002106,74.125.200.0-255,2902,165233,63,257955
14502,0.002107,172.31.40.0-255,66,165299,63,257955
14503,0.002147,172.31.40.0-255,66,165365,63,257955
14504,0.00215,74.125.200.0-255,766,166131,63,257955
14505,0.002153,74.125.200.0-255,1484,167615,63,257955
14506,0.002155,172.31.40.0-255,66,167681,63,257955
14507,0.002184,74.125.200.0-255,4320,172001,63,257955
14508,0.002187,172.31.40.0-255,66,172067,63,257955
14509,0.002192,74.125.200.0-255,5738,177805,63,257955
14510,0.002194,172.31.40.0-255,66,177871,63,257955
14511,0.002248,172.31.40.0-255,66,177937,63,257955
14512,0.002258,172.31.40.0-255,66,178003,63,257955
14513,0.002287,74.125.200.0-255,3602,181605,63,257955
14514,0.002289,172.31.40.0-255,66,181671,63,257955
14515,0.002294,74.125.200.0-255,4320,185991,63,257955
14516,0.002296,172.31.40.0-255,66,186057,63,257955
14517,0.0023,74.125.200.0-255,4320,190377,63,257955
14518,0.002302,172.31.40.0-255,66,190443,63,257955
14519,0.002339,74.125.200.0-255,5738,196181,63,257955
14520,0.002342,172.31.40.0-255,66,196247,63,257955
14521,0.002347,74.125.200.0-255,5738,201985,63,257955
14522,0.002349,172.31.40.0-255,66,202051,63,257955
14523,0.00236,74.125.200.0-255,7156,209207,63,257955
14524,0.002362,172.31.40.0-255,66,209273,63,257955
14525,0.002365,74.125.200.0-255,2902,212175,63,257955
14526,0.002367,172.31.40.0-255,66,212241,63,257955
14527,0.002403,74.125.200.0-255,5020,217261,63,257955
14528,0.002406,172.31.40.0-255,66,217327,63,257955
14529,0.004749,74.125.200.0-255,5738,223065,63,257955
14530,0.004756,172.31.40.0-255,66,223131,63,257955
14531,0.007093,74.125.200.0-255,5738,228869,63,257955
14532,0.007099,172.31.40.0-255,66,228935,63,257955
14533,0.009454,74.125.200.0-255,5738,234673,63,257955
14534,0.009466,172.31.40.0-255,66,234739,63,257955
14535,0.011814,74.125.200.0-255,5738,240477,63,257955
14536,0.01183,172.31.40.0-255,66,240543,63,257955
14537,0.014178,74.125.200.0-255,5738,246281,63,257955
14538,0.014186,172.31.40.0-255,66,246347,63,257955
14539,0.016568,74.125.200.0-255,5738,252085,63,257955
14540,0.016585,172.31.40.0-255,66,252151,63,257955
14541,0.018983,74.125.200.0-255,5738,257889,63,257955
14542,0.019,172.31.40.0-255,66,257955,63,257955
14543,0.0,172.217.194.0-255,152,152,63,258159
14544,2.3e-05,172.31.40.0-255,66,218,63,258159
14545,3e-05,172.217.194.0-255,1484,1702,63,258159
14546,3.5e-05,172.31.40.0-255,66,1768,63,258159
14547,4.1e-05,172.217.194.0-255,2902,4670,63,258159
14548,5.1e-05,172.31.40.0-255,66,4736,63,258159
14549,5.9e-05,172.217.194.0-255,7156,11892,63,258159
14550,6.3e-05,172.31.40.0-255,66,11958,63,258159
14551,0.000106,172.31.40.0-255,66,12024,63,258159
14552,0.000132,172.217.194.0-255,4320,16344,63,258159
14553,0.000134,172.31.40.0-255,66,16410,63,258159
14554,0.000155,172.217.194.0-255,3961,20371,63,258159
14555,0.000158,172.31.40.0-255,66,20437,63,258159
14556,0.000193,172.217.194.0-255,1484,21921,63,258159
14557,0.000196,172.31.40.0-255,66,21987,63,258159
14558,0.000201,172.217.194.0-255,2902,24889,63,258159
14559,0.000203,172.31.40.0-255,66,24955,63,258159
14560,0.00024,172.217.194.0-255,5738,30693,63,258159
14561,0.000243,172.31.40.0-255,66,30759,63,258159
14562,0.000248,172.217.194.0-255,4320,35079,63,258159
14563,0.00025,172.31.40.0-255,66,35145,63,258159
14564,0.00028,172.217.194.0-255,1484,36629,63,258159
14565,0.000283,172.31.40.0-255,66,36695,63,258159
14566,0.000321,172.31.40.0-255,66,36761,63,258159
14567,0.000328,172.217.194.0-255,7055,43816,63,258159
14568,0.000331,172.31.40.0-255,66,43882,63,258159
14569,0.000339,172.217.194.0-255,397,44279,63,258159
14570,0.000342,172.31.40.0-255,66,44345,63,258159
14571,0.000527,172.217.194.0-255,1484,45829,63,258159
14572,0.000531,172.31.40.0-255,66,45895,63,258159
14573,0.000538,172.217.194.0-255,2902,48797,63,258159
14574,0.000541,172.31.40.0-255,66,48863,63,258159
14575,0.000548,172.217.194.0-255,5738,54601,63,258159
14576,0.000555,172.31.40.0-255,66,54667,63,258159
14577,0.0006,172.31.40.0-255,66,54733,63,258159
14578,0.000607,172.217.194.0-255,5738,60471,63,258159
14579,0.000609,172.31.40.0-255,66,60537,63,258159
14580,0.000637,172.217.194.0-255,5020,65557,63,258159
14581,0.00064,172.31.40.0-255,66,65623,63,258159
14582,0.000855,172.217.194.0-255,1484,67107,63,258159
14583,0.000882,172.217.194.0-255,2902,70009,63,258159
14584,0.000886,172.31.40.0-255,66,70075,63,258159
14585,0.000889,172.217.194.0-255,1484,71559,63,258159
14586,0.000911,172.217.194.0-255,1484,73043,63,258159
14587,0.000913,172.31.40.0-255,66,73109,63,258159
14588,0.000921,172.217.194.0-255,7156,80265,63,258159
14589,0.000923,172.31.40.0-255,66,80331,63,258159
14590,0.00097,172.31.40.0-255,66,80397,63,258159
14591,0.001008,172.31.40.0-255,66,80463,63,258159
14592,0.001013,172.217.194.0-255,4320,84783,63,258159
14593,0.001015,172.31.40.0-255,66,84849,63,258159
14594,0.001069,172.31.40.0-255,66,84915,63,258159
14595,0.001101,172.217.194.0-255,6438,91353,63,258159
14596,0.001104,172.31.40.0-255,66,91419,63,258159
14597,0.001134,172.217.194.0-255,2902,94321,63,258159
14598,0.001137,172.31.40.0-255,66,94387,63,258159
14599,0.001143,172.217.194.0-255,4320,98707,63,258159
14600,0.001145,172.31.40.0-255,66,98773,63,258159
14601,0.001149,172.217.194.0-255,2902,101675,63,258159
14602,0.001151,172.31.40.0-255,66,101741,63,258159
14603,0.001184,172.217.194.0-255,5738,107479,63,258159
14604,0.001187,172.217.194.0-255,1125,108604,63,258159
14605,0.001193,172.217.194.0-255,5738,114342,63,258159
14606,0.001201,172.31.40.0-255,66,114408,63,258159
14607,0.001205,172.31.40.0-255,66,114474,63,258159
14608,0.001211,172.217.194.0-255,5738,120212,63,258159
14609,0.001214,172.31.40.0-255,66,120278,63,258159
14610,0.001222,172.217.194.0-255,2902,123180,63,258159
14611,0.001225,172.31.40.0-255,66,123246,63,258159
14612,0.001246,172.217.194.0-255,2543,125789,63,258159
14613,0.001248,172.31.40.0-255,66,125855,63,258159
14614,0.001326,172.217.194.0-255,1484,127339,63,258159
14615,0.00133,172.217.194.0-255,1484,128823,63,258159
14616,0.001334,172.31.40.0-255,66,128889,63,258159
14617,0.001355,172.217.194.0-255,1484,130373,63,258159
14618,0.001362,172.217.194.0-255,5738,136111,63,258159
14619,0.001365,172.31.40.0-255,66,136177,63,258159
14620,0.001371,172.217.194.0-255,5738,141915,63,258159
14621,0.001373,172.31.40.0-255,66,141981,63,258159
14622,0.001376,172.217.194.0-255,1484,143465,63,258159
14623,0.00142,172.31.40.0-255,66,143531,63,258159
14624,0.001426,172.217.194.0-255,5020,148551,63,258159
14625,0.001428,172.31.40.0-255,66,148617,63,258159
14626,0.001535,172.217.194.0-255,1484,150101,63,258159
14627,0.001541,172.217.194.0-255,2902,153003,63,258159
14628,0.001543,172.31.40.0-255,66,153069,63,258159
14629,0.001576,172.217.194.0-255,5738,158807,63,258159
14630,0.00158,172.31.40.0-255,66,158873,63,258159
14631,0.001605,172.31.40.0-255,66,158939,63,258159
14632,0.001665,172.31.40.0-255,66,159005,63,258159
14633,0.001668,172.217.194.0-255,1484,160489,63,258159
14634,0.001671,172.217.194.0-255,1484,161973,63,258159
14635,0.001673,172.31.40.0-255,66,162039,63,258159
14636,0.001695,172.217.194.0-255,1484,163523,63,258159
14637,0.001709,172.217.194.0-255,4320,167843,63,258159
14638,0.001716,172.31.40.0-255,66,167909,63,258159
14639,0.001732,172.217.194.0-255,1484,169393,63,258159
14640,0.001742,172.217.194.0-255,4320,173713,63,258159
14641,0.001744,172.31.40.0-255,66,173779,63,258159
14642,0.001758,172.31.40.0-255,66,173845,63,258159
14643,0.001761,172.217.194.0-255,1484,175329,63,258159
14644,0.001796,172.217.194.0-255,6438,181767,63,258159
14645,0.001799,172.31.40.0-255,66,181833,63,258159
14646,0.001846,172.217.194.0-255,1484,183317,63,258159
14647,0.001852,172.217.194.0-255,2902,186219,63,258159
14648,0.001855,172.31.40.0-255,66,186285,63,258159
14649,0.001889,172.217.194.0-255,5738,192023,63,258159
14650,0.001893,172.31.40.0-255,66,192089,63,258159
14651,0.001899,172.217.194.0-255,4320,196409,63,258159
14652,0.001901,172.31.40.0-255,66,196475,63,258159
14653,0.00193,172.31.40.0-255,66,196541,63,258159
14654,0.001973,172.217.194.0-255,5738,202279,63,258159
14655,0.001976,172.31.40.0-255,66,202345,63,258159
14656,0.002006,172.217.194.0-255,5020,207365,63,258159
14657,0.00201,172.31.40.0-255,66,207431,63,258159
14658,0.002039,172.217.194.0-255,1484,208915,63,258159
14659,0.002054,172.217.194.0-255,2902,211817,63,258159
14660,0.002057,172.31.40.0-255,66,211883,63,258159
14661,0.00206,172.217.194.0-255,1484,213367,63,258159
14662,0.002077,172.217.194.0-255,1484,214851,63,258159
14663,0.00208,172.217.194.0-255,1484,216335,63,258159
14664,0.002099,172.217.194.0-255,5738,222073,63,258159
14665,0.002105,172.31.40.0-255,66,222139,63,258159
14666,0.002121,172.217.194.0-255,4320,226459,63,258159
14667,0.00215,172.31.40.0-255,66,226525,63,258159
14668,0.002155,172.31.40.0-255,66,226591,63,258159
14669,0.002186,172.217.194.0-255,5020,231611,63,258159
14670,0.002203,172.31.40.0-255,66,231677,63,258159
14671,0.002215,172.217.194.0-255,1484,233161,63,258159
14672,0.002224,172.217.194.0-255,2902,236063,63,258159
14673,0.002245,172.217.194.0-255,5738,241801,63,258159
14674,0.00225,172.31.40.0-255,66,241867,63,258159
14675,0.002255,172.31.40.0-255,66,241933,63,258159
14676,0.002265,172.217.194.0-255,2902,244835,63,258159
14677,0.002281,172.31.40.0-255,66,244901,63,258159
14678,0.002316,172.217.194.0-255,7156,252057,63,258159
14679,0.002322,172.217.194.0-255,4320,256377,63,258159
14680,0.002338,172.217.194.0-255,1440,257817,63,258159
14681,0.002341,172.217.194.0-255,105,257922,63,258159
14682,0.002359,172.31.40.0-255,66,257988,63,258159
14683,0.004739,172.31.40.0-255,105,258093,63,258159
14684,0.007313,172.217.194.0-255,66,258159,63,258159
14685,0.0,74.125.68.0-255,153,153,63,176496
14686,1.4e-05,172.31.40.0-255,66,219,63,176496
14687,2e-05,74.125.68.0-255,1484,1703,63,176496
14688,2.4e-05,172.31.40.0-255,66,1769,63,176496
14689,4.8e-05,74.125.68.0-255,1484,3253,63,176496
14690,5e-05,172.31.40.0-255,66,3319,63,176496
14691,6.5e-05,74.125.68.0-255,2902,6221,63,176496
14692,6.8e-05,172.31.40.0-255,66,6287,63,176496
14693,8.4e-05,74.125.68.0-255,2902,9189,63,176496
14694,8.7e-05,172.31.40.0-255,66,9255,63,176496
14695,0.00011,74.125.68.0-255,2902,12157,63,176496
14696,0.000112,172.31.40.0-255,66,12223,63,176496
14697,0.000116,74.125.68.0-255,2004,14227,63,176496
14698,0.000118,172.31.40.0-255,66,14293,63,176496
14699,0.00012,74.125.68.0-255,1484,15777,63,176496
14700,0.000122,172.31.40.0-255,66,15843,63,176496
14701,0.000135,74.125.68.0-255,1484,17327,63,176496
14702,0.000137,172.31.40.0-255,66,17393,63,176496
14703,0.000149,74.125.68.0-255,2902,20295,63,176496
14704,0.000152,172.31.40.0-255,66,20361,63,176496
14705,0.000169,74.125.68.0-255,4320,24681,63,176496
14706,0.000172,172.31.40.0-255,66,24747,63,176496
14707,0.000201,74.125.68.0-255,1484,26231,63,176496
14708,0.000203,172.31.40.0-255,66,26297,63,176496
14709,0.000216,74.125.68.0-255,2902,29199,63,176496
14710,0.000218,172.31.40.0-255,66,29265,63,176496
14711,0.000239,74.125.68.0-255,2543,31808,63,176496
14712,0.000241,172.31.40.0-255,66,31874,63,176496
14713,0.000396,74.125.68.0-255,1484,33358,63,176496
14714,0.0004,172.31.40.0-255,66,33424,63,176496
14715,0.000404,74.125.68.0-255,1484,34908,63,176496
14716,0.000407,172.31.40.0-255,66,34974,63,176496
14717,0.000424,74.125.68.0-255,2902,37876,63,176496
14718,0.000432,172.31.40.0-255,66,37942,63,176496
14719,0.000443,74.125.68.0-255,4320,42262,63,176496
14720,0.000448,172.31.40.0-255,66,42328,63,176496
14721,0.000455,74.125.68.0-255,1484,43812,63,176496
14722,0.000476,74.125.68.0-255,4320,48132,63,176496
14723,0.000491,74.125.68.0-255,2543,50675,63,176496
14724,0.000494,74.125.68.0-255,1484,52159,63,176496
14725,0.0005,172.31.40.0-255,66,52225,63,176496
14726,0.000528,74.125.68.0-255,7156,59381,63,176496
14727,0.000543,172.31.40.0-255,66,59447,63,176496
14728,0.000554,74.125.68.0-255,2902,62349,63,176496
14729,0.000567,74.125.68.0-255,4266,66615,63,176496
14730,0.000586,172.31.40.0-255,66,66681,63,176496
14731,0.000622,74.125.68.0-255,114,66795,63,176496
14732,0.000635,74.125.68.0-255,333,67128,63,176496
14733,0.001066,172.31.40.0-255,66,67194,63,176496
14734,0.001177,74.125.68.0-255,1484,68678,63,176496
14735,0.001194,74.125.68.0-255,2902,71580,63,176496
14736,0.001209,74.125.68.0-255,1484,73064,63,176496
14737,0.00122,74.125.68.0-255,2902,75966,63,176496
14738,0.001224,74.125.68.0-255,2902,78868,63,176496
14739,0.001242,74.125.68.0-255,2902,81770,63,176496
14740,0.001263,74.125.68.0-255,4320,86090,63,176496
14741,0.001285,74.125.68.0-255,7156,93246,63,176496
14742,0.001311,74.125.68.0-255,4320,97566,63,176496
14743,0.001331,74.125.68.0-255,3602,101168,63,176496
14744,0.002107,74.125.68.0-255,1484,102652,63,176496
14745,0.002116,74.125.68.0-255,2902,105554,63,176496
14746,0.002118,74.125.68.0-255,1484,107038,63,176496
14747,0.002135,74.125.68.0-255,2902,109940,63,176496
14748,0.002147,74.125.68.0-255,1484,111424,63,176496
14749,0.002165,74.125.68.0-255,4320,115744,63,176496
14750,0.002171,74.125.68.0-255,4320,120064,63,176496
14751,0.002187,74.125.68.0-255,4320,124384,63,176496
14752,0.002225,74.125.68.0-255,5738,130122,63,176496
14753,0.002244,74.125.68.0-255,4320,134442,63,176496
14754,0.002247,74.125.68.0-255,766,135208,63,176496
14755,0.00233,172.31.40.0-255,66,135274,63,176496
14756,0.004828,74.125.68.0-255,5738,141012,63,176496
14757,0.004834,172.31.40.0-255,66,141078,63,176496
14758,0.007337,74.125.68.0-255,5738,146816,63,176496
14759,0.007342,172.31.40.0-255,66,146882,63,176496
14760,0.009852,74.125.68.0-255,5738,152620,63,176496
14761,0.00986,172.31.40.0-255,66,152686,63,176496
14762,0.012373,74.125.68.0-255,2902,155588,63,176496
14763,0.012382,172.31.40.0-255,66,155654,63,176496
14764,0.012402,74.125.68.0-255,2902,158556,63,176496
14765,0.012441,172.31.40.0-255,66,158622,63,176496
14766,0.014871,74.125.68.0-255,2902,161524,63,176496
14767,0.014879,172.31.40.0-255,66,161590,63,176496
14768,0.014931,74.125.68.0-255,2902,164492,63,176496
14769,0.014962,172.31.40.0-255,66,164558,63,176496
14770,0.01739,74.125.68.0-255,2902,167460,63,176496
14771,0.017399,172.31.40.0-255,66,167526,63,176496
14772,0.017437,74.125.68.0-255,1484,169010,63,176496
14773,0.01745,74.125.68.0-255,1484,170494,63,176496
14774,0.017461,172.31.40.0-255,66,170560,63,176496
14775,0.019893,74.125.68.0-255,2902,173462,63,176496
14776,0.019903,172.31.40.0-255,66,173528,63,176496
14777,0.019945,74.125.68.0-255,2902,176430,63,176496
14778,0.019969,172.31.40.0-255,66,176496,63,176496
14779,0.0,74.125.68.0-255,153,153,63,237074
14780,2.3e-05,172.31.40.0-255,66,219,63,237074
14781,3.1e-05,74.125.68.0-255,1484,1703,63,237074
14782,3.6e-05,172.31.40.0-255,66,1769,63,237074
14783,4.3e-05,74.125.68.0-255,2902,4671,63,237074
14784,4.8e-05,172.31.40.0-255,66,4737,63,237074
14785,5.1e-05,74.125.68.0-255,1484,6221,63,237074
14786,5.5e-05,172.31.40.0-255,66,6287,63,237074
14787,6e-05,74.125.68.0-255,2902,9189,63,237074
14788,6.3e-05,172.31.40.0-255,66,9255,63,237074
14789,9.6e-05,74.125.68.0-255,4857,14112,63,237074
14790,9.9e-05,172.31.40.0-255,66,14178,63,237074
14791,0.000122,74.125.68.0-255,5738,19916,63,237074
14792,0.000125,172.31.40.0-255,66,19982,63,237074
14793,0.000154,74.125.68.0-255,5738,25720,63,237074
14794,0.000157,172.31.40.0-255,66,25786,63,237074
14795,0.00018,74.125.68.0-255,5379,31165,63,237074
14796,0.000183,172.31.40.0-255,66,31231,63,237074
14797,0.000267,74.125.68.0-255,1484,32715,63,237074
14798,0.000271,172.31.40.0-255,66,32781,63,237074
14799,0.000276,74.125.68.0-255,2902,35683,63,237074
14800,0.000278,172.31.40.0-255,66,35749,63,237074
14801,0.000304,74.125.68.0-255,5738,41487,63,237074
14802,0.000307,172.31.40.0-255,66,41553,63,237074
14803,0.000314,74.125.68.0-255,6797,48350,63,237074
14804,0.000316,172.31.40.0-255,66,48416,63,237074
14805,0.000361,74.125.68.0-255,5738,54154,63,237074
14806,0.000365,172.31.40.0-255,66,54220,63,237074
14807,0.000377,74.125.68.0-255,2902,57122,63,237074
14808,0.000379,172.31.40.0-255,66,57188,63,237074
14809,0.000407,172.31.40.0-255,66,57254,63,237074
14810,0.000422,74.125.68.0-255,381,57635,63,237074
14811,0.000478,74.125.68.0-255,1484,59119,63,237074
14812,0.000481,172.31.40.0-255,66,59185,63,237074
14813,0.000509,74.125.68.0-255,4320,63505,63,237074
14814,0.000512,172.31.40.0-255,66,63571,63,237074
14815,0.000535,74.125.68.0-255,5738,69309,63,237074
14816,0.000538,172.31.40.0-255,66,69375,63,237074
14817,0.000562,172.31.40.0-255,66,69441,63,237074
14818,0.000591,172.31.40.0-255,66,69507,63,237074
14819,0.00062,74.125.68.0-255,3053,72560,63,237074
14820,0.000623,172.31.40.0-255,66,72626,63,237074
14821,0.000937,74.125.68.0-255,1484,74110,63,237074
14822,0.000943,74.125.68.0-255,2902,77012,63,237074
14823,0.000946,172.31.40.0-255,66,77078,63,237074
14824,0.000968,74.125.68.0-255,5738,82816,63,237074
14825,0.000971,172.31.40.0-255,66,82882,63,237074
14826,0.001015,74.125.68.0-255,7156,90038,63,237074
14827,0.001018,172.31.40.0-255,66,90104,63,237074
14828,0.001039,74.125.68.0-255,4320,94424,63,237074
14829,0.001042,172.31.40.0-255,66,94490,63,237074
14830,0.001045,74.125.68.0-255,1484,95974,63,237074
14831,0.001061,74.125.68.0-255,4320,100294,63,237074
14832,0.001063,172.31.40.0-255,66,100360,63,237074
14833,0.001066,74.125.68.0-255,1484,101844,63,237074
14834,0.001089,74.125.68.0-255,4320,106164,63,237074
14835,0.001091,172.31.40.0-255,66,106230,63,237074
14836,0.001102,74.125.68.0-255,766,106996,63,237074
14837,0.001188,74.125.68.0-255,1484,108480,63,237074
14838,0.001191,172.31.40.0-255,66,108546,63,237074
14839,0.001195,74.125.68.0-255,2902,111448,63,237074
14840,0.001197,172.31.40.0-255,66,111514,63,237074
14841,0.001238,74.125.68.0-255,1484,112998,63,237074
14842,0.001241,74.125.68.0-255,1484,114482,63,237074
14843,0.001243,172.31.40.0-255,66,114548,63,237074
14844,0.001261,74.125.68.0-255,1484,116032,63,237074
14845,0.001267,74.125.68.0-255,5738,121770,63,237074
14846,0.001269,172.31.40.0-255,66,121836,63,237074
14847,0.001286,74.125.68.0-255,4320,126156,63,237074
14848,0.001288,172.31.40.0-255,66,126222,63,237074
14849,0.00131,74.125.68.0-255,1484,127706,63,237074
14850,0.001316,74.125.68.0-255,7156,134862,63,237074
14851,0.001318,172.31.40.0-255,66,134928,63,237074
14852,0.001344,74.125.68.0-255,2902,137830,63,237074
14853,0.001346,172.31.40.0-255,66,137896,63,237074
14854,0.001351,74.125.68.0-255,3602,141498,63,237074
14855,0.001353,172.31.40.0-255,66,141564,63,237074
14856,0.00196,74.125.68.0-255,1484,143048,63,237074
14857,0.001967,74.125.68.0-255,2902,145950,63,237074
14858,0.001971,172.31.40.0-255,66,146016,63,237074
14859,0.001975,74.125.68.0-255,1484,147500,63,237074
14860,0.001979,74.125.68.0-255,2902,150402,63,237074
14861,0.001981,172.31.40.0-255,66,150468,63,237074
14862,0.002016,74.125.68.0-255,5738,156206,63,237074
14863,0.002019,172.31.40.0-255,66,156272,63,237074
14864,0.002038,74.125.68.0-255,7156,163428,63,237074
14865,0.00204,172.31.40.0-255,66,163494,63,237074
14866,0.002057,74.125.68.0-255,2902,166396,63,237074
14867,0.002059,172.31.40.0-255,66,166462,63,237074
14868,0.002086,74.125.68.0-255,4320,170782,63,237074
14869,0.002088,172.31.40.0-255,66,170848,63,237074
14870,0.002105,74.125.68.0-255,5020,175868,63,237074
14871,0.002107,172.31.40.0-255,66,175934,63,237074
14872,0.002177,74.125.68.0-255,1484,177418,63,237074
14873,0.002199,74.125.68.0-255,2902,180320,63,237074
14874,0.002202,172.31.40.0-255,66,180386,63,237074
14875,0.002206,74.125.68.0-255,1484,181870,63,237074
14876,0.002224,74.125.68.0-255,4320,186190,63,237074
14877,0.002227,172.31.40.0-255,66,186256,63,237074
14878,0.002233,74.125.68.0-255,4320,190576,63,237074
14879,0.002235,172.31.40.0-255,66,190642,63,237074
14880,0.004432,74.125.68.0-255,5738,196380,63,237074
14881,0.004438,172.31.40.0-255,66,196446,63,237074
14882,0.00664,74.125.68.0-255,5738,202184,63,237074
14883,0.006643,172.31.40.0-255,66,202250,63,237074
14884,0.008849,74.125.68.0-255,5738,207988,63,237074
14885,0.008855,172.31.40.0-255,66,208054,63,237074
14886,0.011073,74.125.68.0-255,5738,213792,63,237074
14887,0.011098,172.31.40.0-255,66,213858,63,237074
14888,0.013306,74.125.68.0-255,5738,219596,63,237074
14889,0.013314,172.31.40.0-255,66,219662,63,237074
14890,0.015535,74.125.68.0-255,5738,225400,63,237074
14891,0.015544,172.31.40.0-255,66,225466,63,237074
14892,0.017747,74.125.68.0-255,5738,231204,63,237074
14893,0.017753,172.31.40.0-255,66,231270,63,237074
14894,0.01997,74.125.68.0-255,5738,237008,63,237074
14895,0.019977,172.31.40.0-255,66,237074,63,237074
14896,0.0,74.125.68.0-255,152,152,63,217453
14897,2e-05,172.31.40.0-255,66,218,63,217453
14898,2.7e-05,74.125.68.0-255,1484,1702,63,217453
14899,3.1e-05,172.31.40.0-255,66,1768,63,217453
14900,3.7e-05,74.125.68.0-255,2902,4670,63,217453
14901,4e-05,172.31.40.0-255,66,4736,63,217453
14902,5.6e-05,74.125.68.0-255,7156,11892,63,217453
14903,6.1e-05,172.31.40.0-255,66,11958,63,217453
14904,6.4e-05,74.125.68.0-255,1484,13442,63,217453
14905,6.6e-05,172.31.40.0-255,66,13508,63,217453
14906,0.000101,74.125.68.0-255,6258,19766,63,217453
14907,0.000104,172.31.40.0-255,66,19832,63,217453
14908,0.000111,74.125.68.0-255,7156,26988,63,217453
14909,0.000113,172.31.40.0-255,66,27054,63,217453
14910,0.00014,74.125.68.0-255,3961,31015,63,217453
14911,0.000143,172.31.40.0-255,66,31081,63,217453
14912,0.000169,74.125.68.0-255,4320,35401,63,217453
14913,0.000172,172.31.40.0-255,66,35467,63,217453
14914,0.000202,74.125.68.0-255,7156,42623,63,217453
14915,0.000205,172.31.40.0-255,66,42689,63,217453
14916,0.000243,74.125.68.0-255,5379,48068,63,217453
14917,0.000247,172.31.40.0-255,66,48134,63,217453
14918,0.000648,74.125.68.0-255,1484,49618,63,217453
14919,0.000653,172.31.40.0-255,66,49684,63,217453
14920,0.000659,74.125.68.0-255,2902,52586,63,217453
14921,0.000661,172.31.40.0-255,66,52652,63,217453
14922,0.00069,74.125.68.0-255,5738,58390,63,217453
14923,0.000692,172.31.40.0-255,66,58456,63,217453
14924,0.000698,74.125.68.0-255,4320,62776,63,217453
14925,0.0007,172.31.40.0-255,66,62842,63,217453
14926,0.000723,74.125.68.0-255,3123,65965,63,217453
14927,0.000727,172.31.40.0-255,66,66031,63,217453
14928,0.001041,74.125.68.0-255,1484,67515,63,217453
14929,0.001047,74.125.68.0-255,1484,68999,63,217453
14930,0.00105,172.31.40.0-255,66,69065,63,217453
14931,0.001067,74.125.68.0-255,1484,70549,63,217453
14932,0.001072,74.125.68.0-255,2902,73451,63,217453
14933,0.001074,172.31.40.0-255,66,73517,63,217453
14934,0.001094,74.125.68.0-255,2902,76419,63,217453
14935,0.001096,172.31.40.0-255,66,76485,63,217453
14936,0.001103,74.125.68.0-255,4320,80805,63,217453
14937,0.001105,172.31.40.0-255,66,80871,63,217453
14938,0.001134,74.125.68.0-255,7156,88027,63,217453
14939,0.001136,172.31.40.0-255,66,88093,63,217453
14940,0.00115,172.31.40.0-255,66,88159,63,217453
14941,0.001531,74.125.68.0-255,1484,89643,63,217453
14942,0.001539,74.125.68.0-255,2902,92545,63,217453
14943,0.001544,172.31.40.0-255,66,92611,63,217453
14944,0.001576,74.125.68.0-255,5738,98349,63,217453
14945,0.001579,172.31.40.0-255,66,98415,63,217453
14946,0.001582,74.125.68.0-255,1484,99899,63,217453
14947,0.001588,74.125.68.0-255,4320,104219,63,217453
14948,0.00159,172.31.40.0-255,66,104285,63,217453
14949,0.00162,74.125.68.0-255,4320,108605,63,217453
14950,0.001623,172.31.40.0-255,66,108671,63,217453
14951,0.001635,172.31.40.0-255,66,108737,63,217453
14952,0.001662,74.125.68.0-255,3602,112339,63,217453
14953,0.001665,172.31.40.0-255,66,112405,63,217453
14954,0.001695,74.125.68.0-255,4320,116725,63,217453
14955,0.001697,172.31.40.0-255,66,116791,63,217453
14956,0.001726,74.125.68.0-255,5738,122529,63,217453
14957,0.001729,172.31.40.0-255,66,122595,63,217453
14958,0.001736,74.125.68.0-255,7156,129751,63,217453
14959,0.001738,172.31.40.0-255,66,129817,63,217453
14960,0.001762,74.125.68.0-255,1484,131301,63,217453
14961,0.001778,74.125.68.0-255,5738,137039,63,217453
14962,0.001782,172.31.40.0-255,66,137105,63,217453
14963,0.001812,74.125.68.0-255,7156,144261,63,217453
14964,0.001816,172.31.40.0-255,66,144327,63,217453
14965,0.00182,74.125.68.0-255,2184,146511,63,217453
14966,0.001822,172.31.40.0-255,66,146577,63,217453
14967,0.001873,74.125.68.0-255,1484,148061,63,217453
14968,0.001892,74.125.68.0-255,2902,150963,63,217453
14969,0.001897,172.31.40.0-255,66,151029,63,217453
14970,0.001917,74.125.68.0-255,2902,153931,63,217453
14971,0.001921,172.31.40.0-255,66,153997,63,217453
14972,0.001926,74.125.68.0-255,4320,158317,63,217453
14973,0.001929,172.31.40.0-255,66,158383,63,217453
14974,0.001992,172.31.40.0-255,66,158449,63,217453
14975,0.001999,74.125.68.0-255,7156,165605,63,217453
14976,0.002001,172.31.40.0-255,66,165671,63,217453
14977,0.002019,74.125.68.0-255,2902,168573,63,217453
14978,0.002022,172.31.40.0-255,66,168639,63,217453
14979,0.00204,74.125.68.0-255,3602,172241,63,217453
14980,0.002043,172.31.40.0-255,66,172307,63,217453
14981,0.004083,74.125.68.0-255,1484,173791,63,217453
14982,0.004119,74.125.68.0-255,4320,178111,63,217453
14983,0.004124,172.31.40.0-255,66,178177,63,217453
14984,0.006182,74.125.68.0-255,4320,182497,63,217453
14985,0.006186,172.31.40.0-255,66,182563,63,217453
14986,0.006211,74.125.68.0-255,1484,184047,63,217453
14987,0.008267,74.125.68.0-255,4320,188367,63,217453
14988,0.008273,172.31.40.0-255,66,188433,63,217453
14989,0.010343,74.125.68.0-255,5738,194171,63,217453
14990,0.010351,172.31.40.0-255,66,194237,63,217453
14991,0.01243,74.125.68.0-255,5738,199975,63,217453
14992,0.012438,172.31.40.0-255,66,200041,63,217453
14993,0.014505,74.125.68.0-255,5738,205779,63,217453
14994,0.014513,172.31.40.0-255,66,205845,63,217453
14995,0.016593,74.125.68.0-255,5738,211583,63,217453
14996,0.016601,172.31.40.0-255,66,211649,63,217453
14997,0.018674,74.125.68.0-255,5738,217387,63,217453
14998,0.018681,172.31.40.0-255,66,217453,63,217453
14999,0.0,172.31.40.0-255,105,105,63,459
15000,0.000153,172.31.40.0-255,90,195,63,459
15001,0.000164,172.31.40.0-255,66,261,63,459
15002,0.002503,172.217.194.0-255,66,327,63,459
15003,0.00252,172.217.194.0-255,66,393,63,459
15004,0.002533,172.31.40.0-255,66,459,63,459
15005,0.0,74.125.200.0-255,294,294,63,272638
15006,2.3e-05,172.31.40.0-255,66,360,63,272638
15007,2.9e-05,74.125.200.0-255,1484,1844,63,272638
15008,3.4e-05,172.31.40.0-255,66,1910,63,272638
15009,4.2e-05,74.125.200.0-255,4320,6230,63,272638
15010,4.4e-05,172.31.40.0-255,66,6296,63,272638
15011,5.1e-05,74.125.200.0-255,5738,12034,63,272638
15012,5.3e-05,172.31.40.0-255,66,12100,63,272638
15013,9.2e-05,74.125.200.0-255,5738,17838,63,272638
15014,9.4e-05,172.31.40.0-255,66,17904,63,272638
15015,0.000119,74.125.200.0-255,1899,19803,63,272638
15016,0.000121,172.31.40.0-255,66,19869,63,272638
15017,0.000132,172.31.40.0-255,66,19935,63,272638
15018,0.000136,74.125.200.0-255,2543,22478,63,272638
15019,0.000139,172.31.40.0-255,66,22544,63,272638
15020,0.000231,74.125.200.0-255,1484,24028,63,272638
15021,0.000235,172.31.40.0-255,66,24094,63,272638
15022,0.000241,74.125.200.0-255,2902,26996,63,272638
15023,0.000243,172.31.40.0-255,66,27062,63,272638
15024,0.000258,74.125.200.0-255,5738,32800,63,272638
15025,0.000261,172.31.40.0-255,66,32866,63,272638
15026,0.000341,74.125.200.0-255,6797,39663,63,272638
15027,0.000344,172.31.40.0-255,66,39729,63,272638
15028,0.000693,74.125.200.0-255,1484,41213,63,272638
15029,0.000698,172.31.40.0-255,66,41279,63,272638
15030,0.000704,74.125.200.0-255,2902,44181,63,272638
15031,0.000706,172.31.40.0-255,66,44247,63,272638
15032,0.000739,74.125.200.0-255,5738,49985,63,272638
15033,0.000742,172.31.40.0-255,66,50051,63,272638
15034,0.000749,74.125.200.0-255,4320,54371,63,272638
15035,0.000751,172.31.40.0-255,66,54437,63,272638
15036,0.000797,74.125.200.0-255,3123,57560,63,272638
15037,0.0008,172.31.40.0-255,66,57626,63,272638
15038,0.000887,74.125.200.0-255,1484,59110,63,272638
15039,0.000905,74.125.200.0-255,1484,60594,63,272638
15040,0.000908,172.31.40.0-255,66,60660,63,272638
15041,0.000913,74.125.200.0-255,2902,63562,63,272638
15042,0.000915,172.31.40.0-255,66,63628,63,272638
15043,0.000939,74.125.200.0-255,5738,69366,63,272638
15044,0.000942,172.31.40.0-255,66,69432,63,272638
15045,0.000945,74.125.200.0-255,1484,70916,63,272638
15046,0.000962,74.125.200.0-255,2902,73818,63,272638
15047,0.000965,172.31.40.0-255,66,73884,63,272638
15048,0.000999,74.125.200.0-255,1484,75368,63,272638
15049,0.001019,74.125.200.0-255,3961,79329,63,272638
15050,0.001022,172.31.40.0-255,66,79395,63,272638
15051,0.001029,74.125.200.0-255,5738,85133,63,272638
15052,0.001031,172.31.40.0-255,66,85199,63,272638
15053,0.001066,74.125.200.0-255,5738,90937,63,272638
15054,0.001069,172.31.40.0-255,66,91003,63,272638
15055,0.001098,74.125.200.0-255,1125,92128,63,272638
15056,0.001167,74.125.200.0-255,1484,93612,63,272638
15057,0.001171,172.31.40.0-255,66,93678,63,272638
15058,0.001185,74.125.200.0-255,2902,96580,63,272638
15059,0.001187,172.31.40.0-255,66,96646,63,272638
15060,0.00121,74.125.200.0-255,1484,98130,63,272638
15061,0.001222,74.125.200.0-255,2902,101032,63,272638
15062,0.001224,172.31.40.0-255,66,101098,63,272638
15063,0.001243,74.125.200.0-255,5738,106836,63,272638
15064,0.001246,172.31.40.0-255,66,106902,63,272638
15065,0.00125,74.125.200.0-255,1484,108386,63,272638
15066,0.001282,74.125.200.0-255,562,108948,63,272638
15067,0.001285,172.31.40.0-255,66,109014,63,272638
15068,0.001446,74.125.200.0-255,1484,110498,63,272638
15069,0.001451,74.125.200.0-255,1484,111982,63,272638
15070,0.001453,172.31.40.0-255,66,112048,63,272638
15071,0.00148,74.125.200.0-255,2902,114950,63,272638
15072,0.001482,172.31.40.0-255,66,115016,63,272638
15073,0.001505,74.125.200.0-255,5738,120754,63,272638
15074,0.001508,172.31.40.0-255,66,120820,63,272638
15075,0.001511,74.125.200.0-255,1484,122304,63,272638
15076,0.001529,74.125.200.0-255,2902,125206,63,272638
15077,0.001532,172.31.40.0-255,66,125272,63,272638
15078,0.001548,74.125.200.0-255,1484,126756,63,272638
15079,0.001563,74.125.200.0-255,4320,131076,63,272638
15080,0.001565,172.31.40.0-255,66,131142,63,272638
15081,0.001569,74.125.200.0-255,1484,132626,63,272638
15082,0.001605,74.125.200.0-255,2902,135528,63,272638
15083,0.001607,172.31.40.0-255,66,135594,63,272638
15084,0.00163,74.125.200.0-255,5738,141332,63,272638
15085,0.001633,172.31.40.0-255,66,141398,63,272638
15086,0.001636,74.125.200.0-255,1484,142882,63,272638
15087,0.001667,74.125.200.0-255,766,143648,63,272638
15088,0.00167,172.31.40.0-255,66,143714,63,272638
15089,0.001798,74.125.200.0-255,1484,145198,63,272638
15090,0.001819,74.125.200.0-255,2902,148100,63,272638
15091,0.001823,172.31.40.0-255,66,148166,63,272638
15092,0.001846,74.125.200.0-255,4320,152486,63,272638
15093,0.001848,172.31.40.0-255,66,152552,63,272638
15094,0.001906,74.125.200.0-255,4320,156872,63,272638
15095,0.001909,172.31.40.0-255,66,156938,63,272638
15096,0.001928,74.125.200.0-255,2902,159840,63,272638
15097,0.00193,172.31.40.0-255,66,159906,63,272638
15098,0.001937,74.125.200.0-255,7156,167062,63,272638
15099,0.00194,172.31.40.0-255,66,167128,63,272638
15100,0.001972,74.125.200.0-255,1484,168612,63,272638
15101,0.001997,74.125.200.0-255,7156,175768,63,272638
15102,0.002001,172.31.40.0-255,66,175834,63,272638
15103,0.002027,74.125.200.0-255,2184,178018,63,272638
15104,0.00203,172.31.40.0-255,66,178084,63,272638
15105,0.00213,74.125.200.0-255,1484,179568,63,272638
15106,0.002143,74.125.200.0-255,2902,182470,63,272638
15107,0.002147,172.31.40.0-255,66,182536,63,272638
15108,0.00215,74.125.200.0-255,1484,184020,63,272638
15109,0.00217,74.125.200.0-255,4320,188340,63,272638
15110,0.002174,172.31.40.0-255,66,188406,63,272638
15111,0.002179,74.125.200.0-255,2902,191308,63,272638
15112,0.002181,172.31.40.0-255,66,191374,63,272638
15113,0.002205,74.125.200.0-255,5738,197112,63,272638
15114,0.002207,172.31.40.0-255,66,197178,63,272638
15115,0.002219,172.31.40.0-255,66,197244,63,272638
15116,0.002224,74.125.200.0-255,2902,200146,63,272638
15117,0.002226,172.31.40.0-255,66,200212,63,272638
15118,0.002249,74.125.200.0-255,2184,202396,63,272638
15119,0.002251,172.31.40.0-255,66,202462,63,272638
15120,0.002352,74.125.200.0-255,1484,203946,63,272638
15121,0.002364,74.125.200.0-255,2902,206848,63,272638
15122,0.002367,172.31.40.0-255,66,206914,63,272638
15123,0.002371,74.125.200.0-255,1484,208398,63,272638
15124,0.002384,74.125.200.0-255,2902,211300,63,272638
15125,0.002387,172.31.40.0-255,66,211366,63,272638
15126,0.002392,74.125.200.0-255,4320,215686,63,272638
15127,0.002394,172.31.40.0-255,66,215752,63,272638
15128,0.002413,74.125.200.0-255,1484,217236,63,272638
15129,0.002421,74.125.200.0-255,5738,222974,63,272638
15130,0.002423,172.31.40.0-255,66,223040,63,272638
15131,0.002447,74.125.200.0-255,5738,228778,63,272638
15132,0.002449,172.31.40.0-255,66,228844,63,272638
15133,0.002461,74.125.200.0-255,5738,234582,63,272638
15134,0.002463,172.31.40.0-255,66,234648,63,272638
15135,0.00249,74.125.200.0-255,4320,238968,63,272638
15136,0.002493,172.31.40.0-255,66,239034,63,272638
15137,0.002536,172.31.40.0-255,66,239100,63,272638
15138,0.002543,74.125.200.0-255,5738,244838,63,272638
15139,0.002545,172.31.40.0-255,66,244904,63,272638
15140,0.002569,172.31.40.0-255,66,244970,63,272638
15141,0.00512,74.125.200.0-255,5738,250708,63,272638
15142,0.005129,172.31.40.0-255,66,250774,63,272638
15143,0.007686,74.125.200.0-255,4320,255094,63,272638
15144,0.007689,172.31.40.0-255,66,255160,63,272638
15145,0.007707,74.125.200.0-255,1484,256644,63,272638
15146,0.010264,74.125.200.0-255,4320,260964,63,272638
15147,0.012579,172.31.40.0-255,66,261030,63,272638
15148,0.015156,74.125.200.0-255,5738,266768,63,272638
15149,0.015172,172.31.40.0-255,66,266834,63,272638
15150,0.017749,74.125.200.0-255,5738,272572,63,272638
15151,0.017767,172.31.40.0-255,66,272638,63,272638
15152,0.0,74.125.24.0-255,152,152,63,180476
15153,2.4e-05,172.31.40.0-255,66,218,63,180476
15154,3.2e-05,74.125.24.0-255,1484,1702,63,180476
15155,3.7e-05,172.31.40.0-255,66,1768,63,180476
15156,4.3e-05,74.125.24.0-255,2902,4670,63,180476
15157,4.6e-05,172.31.40.0-255,66,4736,63,180476
15158,7.7e-05,74.125.24.0-255,5738,10474,63,180476
15159,8e-05,172.31.40.0-255,66,10540,63,180476
15160,9.8e-05,74.125.24.0-255,2902,13442,63,180476
15161,0.000101,172.31.40.0-255,66,13508,63,180476
15162,0.000118,74.125.24.0-255,742,14250,63,180476
15163,0.00012,172.31.40.0-255,66,14316,63,180476
15164,0.000261,74.125.24.0-255,1484,15800,63,180476
15165,0.000266,172.31.40.0-255,66,15866,63,180476
15166,0.000271,74.125.24.0-255,2902,18768,63,180476
15167,0.000274,172.31.40.0-255,66,18834,63,180476
15168,0.000298,74.125.24.0-255,5738,24572,63,180476
15169,0.000301,172.31.40.0-255,66,24638,63,180476
15170,0.000342,74.125.24.0-255,4320,28958,63,180476
15171,0.000344,172.31.40.0-255,66,29024,63,180476
15172,0.000376,74.125.24.0-255,2543,31567,63,180476
15173,0.000378,172.31.40.0-255,66,31633,63,180476
15174,0.000393,172.31.40.0-255,66,31699,63,180476
15175,0.000407,172.31.40.0-255,66,31765,63,180476
15176,0.000413,74.125.24.0-255,5020,36785,63,180476
15177,0.000415,172.31.40.0-255,66,36851,63,180476
15178,0.001335,74.125.24.0-255,645,37496,63,180476
15179,0.001342,172.31.40.0-255,66,37562,63,180476
15180,0.001366,74.125.24.0-255,1484,39046,63,180476
15181,0.00137,172.31.40.0-255,66,39112,63,180476
15182,0.001392,74.125.24.0-255,2902,42014,63,180476
15183,0.001394,172.31.40.0-255,66,42080,63,180476
15184,0.001402,74.125.24.0-255,5738,47818,63,180476
15185,0.001403,172.31.40.0-255,66,47884,63,180476
15186,0.001406,74.125.24.0-255,1484,49368,63,180476
15187,0.001427,74.125.24.0-255,2902,52270,63,180476
15188,0.00143,172.31.40.0-255,66,52336,63,180476
15189,0.001479,74.125.24.0-255,7156,59492,63,180476
15190,0.001481,172.31.40.0-255,66,59558,63,180476
15191,0.001505,74.125.24.0-255,4320,63878,63,180476
15192,0.001508,172.31.40.0-255,66,63944,63,180476
15193,0.001511,74.125.24.0-255,1484,65428,63,180476
15194,0.001534,74.125.24.0-255,6438,71866,63,180476
15195,0.001536,172.31.40.0-255,66,71932,63,180476
15196,0.001779,74.125.24.0-255,1484,73416,63,180476
15197,0.001787,74.125.24.0-255,2902,76318,63,180476
15198,0.001791,172.31.40.0-255,66,76384,63,180476
15199,0.001812,74.125.24.0-255,5738,82122,63,180476
15200,0.001814,172.31.40.0-255,66,82188,63,180476
15201,0.001819,74.125.24.0-255,2902,85090,63,180476
15202,0.001821,172.31.40.0-255,66,85156,63,180476
15203,0.001845,74.125.24.0-255,2902,88058,63,180476
15204,0.001848,172.31.40.0-255,66,88124,63,180476
15205,0.001873,74.125.24.0-255,7156,95280,63,180476
15206,0.001875,172.31.40.0-255,66,95346,63,180476
15207,0.001878,74.125.24.0-255,1484,96830,63,180476
15208,0.001899,74.125.24.0-255,5738,102568,63,180476
15209,0.001901,172.31.40.0-255,66,102634,63,180476
15210,0.001913,74.125.24.0-255,3602,106236,63,180476
15211,0.001916,172.31.40.0-255,66,106302,63,180476
15212,0.001944,74.125.24.0-255,4320,110622,63,180476
15213,0.001948,172.31.40.0-255,66,110688,63,180476
15214,0.001959,172.31.40.0-255,66,110754,63,180476
15215,0.001994,172.31.40.0-255,66,110820,63,180476
15216,0.002012,74.125.24.0-255,1484,112304,63,180476
15217,0.002059,172.31.40.0-255,66,112370,63,180476
15218,0.002254,74.125.24.0-255,1484,113854,63,180476
15219,0.00226,74.125.24.0-255,2902,116756,63,180476
15220,0.002264,172.31.40.0-255,66,116822,63,180476
15221,0.002268,74.125.24.0-255,1484,118306,63,180476
15222,0.002288,74.125.24.0-255,2902,121208,63,180476
15223,0.002291,172.31.40.0-255,66,121274,63,180476
15224,0.002296,74.125.24.0-255,4320,125594,63,180476
15225,0.002299,172.31.40.0-255,66,125660,63,180476
15226,0.002312,74.125.24.0-255,1484,127144,63,180476
15227,0.002327,74.125.24.0-255,2902,130046,63,180476
15228,0.002329,172.31.40.0-255,66,130112,63,180476
15229,0.002343,74.125.24.0-255,1484,131596,63,180476
15230,0.002368,74.125.24.0-255,2902,134498,63,180476
15231,0.002371,172.31.40.0-255,66,134564,63,180476
15232,0.002389,74.125.24.0-255,1484,136048,63,180476
15233,0.002414,74.125.24.0-255,2902,138950,63,180476
15234,0.002417,172.31.40.0-255,66,139016,63,180476
15235,0.00242,74.125.24.0-255,1484,140500,63,180476
15236,0.002443,74.125.24.0-255,6438,146938,63,180476
15237,0.002445,172.31.40.0-255,66,147004,63,180476
15238,0.004975,74.125.24.0-255,5738,152742,63,180476
15239,0.004981,172.31.40.0-255,66,152808,63,180476
15240,0.007537,74.125.24.0-255,4320,157128,63,180476
15241,0.007541,172.31.40.0-255,66,157194,63,180476
15242,0.007557,74.125.24.0-255,1484,158678,63,180476
15243,0.010141,74.125.24.0-255,4320,162998,63,180476
15244,0.010156,172.31.40.0-255,66,163064,63,180476
15245,0.012733,74.125.24.0-255,5738,168802,63,180476
15246,0.012744,172.31.40.0-255,66,168868,63,180476
15247,0.015349,74.125.24.0-255,5738,174606,63,180476
15248,0.015357,172.31.40.0-255,66,174672,63,180476
15249,0.017915,74.125.24.0-255,5738,180410,63,180476
15250,0.017923,172.31.40.0-255,66,180476,63,180476
15251,0.0,74.125.24.0-255,293,293,63,207476
15252,2.5e-05,172.31.40.0-255,66,359,63,207476
15253,3.2e-05,74.125.24.0-255,1484,1843,63,207476
15254,3.7e-05,172.31.40.0-255,66,1909,63,207476
15255,4.4e-05,74.125.24.0-255,4320,6229,63,207476
15256,5.7e-05,172.31.40.0-255,66,6295,63,207476
15257,6.4e-05,74.125.24.0-255,5738,12033,63,207476
15258,6.7e-05,172.31.40.0-255,66,12099,63,207476
15259,7.1e-05,74.125.24.0-255,1802,13901,63,207476
15260,7.5e-05,172.31.40.0-255,66,13967,63,207476
15261,7.9e-05,74.125.24.0-255,1484,15451,63,207476
15262,8.1e-05,172.31.40.0-255,66,15517,63,207476
15263,8.5e-05,74.125.24.0-255,2902,18419,63,207476
15264,8.8e-05,172.31.40.0-255,66,18485,63,207476
15265,9.4e-05,74.125.24.0-255,5738,24223,63,207476
15266,9.8e-05,172.31.40.0-255,66,24289,63,207476
15267,0.000105,74.125.24.0-255,6797,31086,63,207476
15268,0.000109,172.31.40.0-255,66,31152,63,207476
15269,0.000158,74.125.24.0-255,5738,36890,63,207476
15270,0.000162,172.31.40.0-255,66,36956,63,207476
15271,0.00017,74.125.24.0-255,7156,44112,63,207476
15272,0.000173,172.31.40.0-255,66,44178,63,207476
15273,0.000178,74.125.24.0-255,3961,48139,63,207476
15274,0.00018,172.31.40.0-255,66,48205,63,207476
15275,0.000208,74.125.24.0-255,4320,52525,63,207476
15276,0.000211,172.31.40.0-255,66,52591,63,207476
15277,0.000244,172.31.40.0-255,66,52657,63,207476
15278,0.000247,74.125.24.0-255,1484,54141,63,207476
15279,0.000249,172.31.40.0-255,66,54207,63,207476
15280,0.00028,74.125.24.0-255,1707,55914,63,207476
15281,0.000283,172.31.40.0-255,66,55980,63,207476
15282,0.000401,74.125.24.0-255,1484,57464,63,207476
15283,0.000411,74.125.24.0-255,2902,60366,63,207476
15284,0.000414,172.31.40.0-255,66,60432,63,207476
15285,0.000419,74.125.24.0-255,2902,63334,63,207476
15286,0.000421,172.31.40.0-255,66,63400,63,207476
15287,0.000456,74.125.24.0-255,7156,70556,63,207476
15288,0.000459,172.31.40.0-255,66,70622,63,207476
15289,0.000486,74.125.24.0-255,2543,73165,63,207476
15290,0.000489,172.31.40.0-255,66,73231,63,207476
15291,0.000514,74.125.24.0-255,2902,76133,63,207476
15292,0.000516,172.31.40.0-255,66,76199,63,207476
15293,0.000523,74.125.24.0-255,4320,80519,63,207476
15294,0.000525,172.31.40.0-255,66,80585,63,207476
15295,0.00059,172.31.40.0-255,66,80651,63,207476
15296,0.000593,74.125.24.0-255,1125,81776,63,207476
15297,0.000862,74.125.24.0-255,1484,83260,63,207476
15298,0.000867,172.31.40.0-255,66,83326,63,207476
15299,0.000874,74.125.24.0-255,2902,86228,63,207476
15300,0.000876,172.31.40.0-255,66,86294,63,207476
15301,0.00088,74.125.24.0-255,2902,89196,63,207476
15302,0.000887,172.31.40.0-255,66,89262,63,207476
15303,0.000926,74.125.24.0-255,2902,92164,63,207476
15304,0.000929,172.31.40.0-255,66,92230,63,207476
15305,0.000944,172.31.40.0-255,66,92296,63,207476
15306,0.000956,172.31.40.0-255,66,92362,63,207476
15307,0.001038,74.125.24.0-255,1484,93846,63,207476
15308,0.001044,74.125.24.0-255,2902,96748,63,207476
15309,0.001047,172.31.40.0-255,66,96814,63,207476
15310,0.001054,74.125.24.0-255,4320,101134,63,207476
15311,0.001056,172.31.40.0-255,66,101200,63,207476
15312,0.001074,74.125.24.0-255,1484,102684,63,207476
15313,0.001089,172.31.40.0-255,66,102750,63,207476
15314,0.0011,172.31.40.0-255,66,102816,63,207476
15315,0.001133,74.125.24.0-255,2184,105000,63,207476
15316,0.001137,172.31.40.0-255,66,105066,63,207476
15317,0.001453,74.125.24.0-255,1484,106550,63,207476
15318,0.001481,74.125.24.0-255,2902,109452,63,207476
15319,0.001485,172.31.40.0-255,66,109518,63,207476
15320,0.001492,74.125.24.0-255,5738,115256,63,207476
15321,0.001495,172.31.40.0-255,66,115322,63,207476
15322,0.001506,74.125.24.0-255,4320,119642,63,207476
15323,0.001508,172.31.40.0-255,66,119708,63,207476
15324,0.001514,74.125.24.0-255,5738,125446,63,207476
15325,0.001516,172.31.40.0-255,66,125512,63,207476
15326,0.00153,172.31.40.0-255,66,125578,63,207476
15327,0.001562,74.125.24.0-255,2184,127762,63,207476
15328,0.001564,172.31.40.0-255,66,127828,63,207476
15329,0.001662,74.125.24.0-255,1484,129312,63,207476
15330,0.001668,74.125.24.0-255,2902,132214,63,207476
15331,0.001671,172.31.40.0-255,66,132280,63,207476
15332,0.001691,74.125.24.0-255,5738,138018,63,207476
15333,0.001693,172.31.40.0-255,66,138084,63,207476
15334,0.001701,74.125.24.0-255,1484,139568,63,207476
15335,0.001744,172.31.40.0-255,66,139634,63,207476
15336,0.001762,172.31.40.0-255,66,139700,63,207476
15337,0.00179,74.125.24.0-255,1484,141184,63,207476
15338,0.001795,74.125.24.0-255,2902,144086,63,207476
15339,0.001798,172.31.40.0-255,66,144152,63,207476
15340,0.001802,74.125.24.0-255,2902,147054,63,207476
15341,0.001805,172.31.40.0-255,66,147120,63,207476
15342,0.001838,74.125.24.0-255,2902,150022,63,207476
15343,0.00184,172.31.40.0-255,66,150088,63,207476
15344,0.00186,172.31.40.0-255,66,150154,63,207476
15345,0.001867,74.125.24.0-255,7156,157310,63,207476
15346,0.001872,172.31.40.0-255,66,157376,63,207476
15347,0.001899,74.125.24.0-255,3602,160978,63,207476
15348,0.001902,172.31.40.0-255,66,161044,63,207476
15349,0.004002,74.125.24.0-255,5738,166782,63,207476
15350,0.004009,172.31.40.0-255,66,166848,63,207476
15351,0.006025,74.125.24.0-255,5738,172586,63,207476
15352,0.006042,172.31.40.0-255,66,172652,63,207476
15353,0.008076,74.125.24.0-255,5738,178390,63,207476
15354,0.008091,172.31.40.0-255,66,178456,63,207476
15355,0.010123,74.125.24.0-255,5738,184194,63,207476
15356,0.010156,172.31.40.0-255,66,184260,63,207476
15357,0.012188,74.125.24.0-255,5738,189998,63,207476
15358,0.012197,172.31.40.0-255,66,190064,63,207476
15359,0.014201,74.125.24.0-255,5738,195802,63,207476
15360,0.014209,172.31.40.0-255,66,195868,63,207476
15361,0.016242,74.125.24.0-255,5738,201606,63,207476
15362,0.016249,172.31.40.0-255,66,201672,63,207476
15363,0.018257,74.125.24.0-255,5738,207410,63,207476
15364,0.018266,172.31.40.0-255,66,207476,63,207476
15365,0.0,74.125.130.0-255,155,155,63,205316
15366,2.1e-05,172.31.40.0-255,66,221,63,205316
15367,2.9e-05,74.125.130.0-255,1484,1705,63,205316
15368,3.4e-05,172.31.40.0-255,66,1771,63,205316
15369,4e-05,74.125.130.0-255,2902,4673,63,205316
15370,4.3e-05,172.31.40.0-255,66,4739,63,205316
15371,4.6e-05,74.125.130.0-255,1484,6223,63,205316
15372,4.9e-05,172.31.40.0-255,66,6289,63,205316
15373,5.5e-05,74.125.130.0-255,2902,9191,63,205316
15374,5.7e-05,172.31.40.0-255,66,9257,63,205316
15375,9e-05,74.125.130.0-255,6322,15579,63,205316
15376,9.3e-05,172.31.40.0-255,66,15645,63,205316
15377,9.7e-05,74.125.130.0-255,2902,18547,63,205316
15378,9.9e-05,172.31.40.0-255,66,18613,63,205316
15379,0.000105,74.125.130.0-255,4320,22933,63,205316
15380,0.000108,172.31.40.0-255,66,22999,63,205316
15381,0.00014,74.125.130.0-255,2902,25901,63,205316
15382,0.000143,172.31.40.0-255,66,25967,63,205316
15383,0.000167,74.125.130.0-255,5379,31346,63,205316
15384,0.00017,172.31.40.0-255,66,31412,63,205316
15385,0.000275,74.125.130.0-255,1484,32896,63,205316
15386,0.00028,172.31.40.0-255,66,32962,63,205316
15387,0.000285,74.125.130.0-255,2902,35864,63,205316
15388,0.000287,172.31.40.0-255,66,35930,63,205316
15389,0.000301,74.125.130.0-255,2902,38832,63,205316
15390,0.000303,172.31.40.0-255,66,38898,63,205316
15391,0.000324,74.125.130.0-255,1484,40382,63,205316
15392,0.000326,172.31.40.0-255,66,40448,63,205316
15393,0.00035,74.125.130.0-255,7156,47604,63,205316
15394,0.000352,172.31.40.0-255,66,47670,63,205316
15395,0.000368,74.125.130.0-255,2543,50213,63,205316
15396,0.000371,172.31.40.0-255,66,50279,63,205316
15397,0.000383,172.31.40.0-255,66,50345,63,205316
15398,0.000386,74.125.130.0-255,1484,51829,63,205316
15399,0.000409,74.125.130.0-255,3961,55790,63,205316
15400,0.000412,172.31.40.0-255,66,55856,63,205316
15401,0.000429,74.125.130.0-255,359,56215,63,205316
15402,0.000472,74.125.130.0-255,383,56598,63,205316
15403,0.0008,74.125.130.0-255,1484,58082,63,205316
15404,0.000805,172.31.40.0-255,66,58148,63,205316
15405,0.00081,74.125.130.0-255,2902,61050,63,205316
15406,0.000813,172.31.40.0-255,66,61116,63,205316
15407,0.000832,74.125.130.0-255,5738,66854,63,205316
15408,0.000834,172.31.40.0-255,66,66920,63,205316
15409,0.000838,74.125.130.0-255,1484,68404,63,205316
15410,0.000862,74.125.130.0-255,5738,74142,63,205316
15411,0.000864,172.31.40.0-255,66,74208,63,205316
15412,0.00087,74.125.130.0-255,4320,78528,63,205316
15413,0.000872,172.31.40.0-255,66,78594,63,205316
15414,0.000889,74.125.130.0-255,4320,82914,63,205316
15415,0.000892,172.31.40.0-255,66,82980,63,205316
15416,0.000924,74.125.130.0-255,2902,85882,63,205316
15417,0.000926,172.31.40.0-255,66,85948,63,205316
15418,0.000944,74.125.130.0-255,5020,90968,63,205316
15419,0.000947,172.31.40.0-255,66,91034,63,205316
15420,0.001088,74.125.130.0-255,1484,92518,63,205316
15421,0.001107,74.125.130.0-255,2902,95420,63,205316
15422,0.00111,172.31.40.0-255,66,95486,63,205316
15423,0.001126,74.125.130.0-255,4320,99806,63,205316
15424,0.001129,172.31.40.0-255,66,99872,63,205316
15425,0.001149,74.125.130.0-255,1484,101356,63,205316
15426,0.001155,74.125.130.0-255,5738,107094,63,205316
15427,0.001157,172.31.40.0-255,66,107160,63,205316
15428,0.001182,74.125.130.0-255,5738,112898,63,205316
15429,0.001185,172.31.40.0-255,66,112964,63,205316
15430,0.001196,172.31.40.0-255,66,113030,63,205316
15431,0.001211,74.125.130.0-255,3602,116632,63,205316
15432,0.001213,172.31.40.0-255,66,116698,63,205316
15433,0.00174,74.125.130.0-255,1484,118182,63,205316
15434,0.001745,74.125.130.0-255,1484,119666,63,205316
15435,0.001748,172.31.40.0-255,66,119732,63,205316
15436,0.001764,74.125.130.0-255,1484,121216,63,205316
15437,0.001769,74.125.130.0-255,4320,125536,63,205316
15438,0.001771,172.31.40.0-255,66,125602,63,205316
15439,0.001785,74.125.130.0-255,1484,127086,63,205316
15440,0.001801,74.125.130.0-255,7156,134242,63,205316
15441,0.001804,172.31.40.0-255,66,134308,63,205316
15442,0.00181,74.125.130.0-255,5738,140046,63,205316
15443,0.001812,172.31.40.0-255,66,140112,63,205316
15444,0.001815,74.125.130.0-255,1484,141596,63,205316
15445,0.00184,74.125.130.0-255,5738,147334,63,205316
15446,0.001844,172.31.40.0-255,66,147400,63,205316
15447,0.001862,74.125.130.0-255,3602,151002,63,205316
15448,0.001864,172.31.40.0-255,66,151068,63,205316
15449,0.002015,74.125.130.0-255,1484,152552,63,205316
15450,0.002021,74.125.130.0-255,2902,155454,63,205316
15451,0.002024,172.31.40.0-255,66,155520,63,205316
15452,0.002045,74.125.130.0-255,2902,158422,63,205316
15453,0.002048,172.31.40.0-255,66,158488,63,205316
15454,0.004034,74.125.130.0-255,5738,164226,63,205316
15455,0.00404,172.31.40.0-255,66,164292,63,205316
15456,0.00604,74.125.130.0-255,5738,170030,63,205316
15457,0.006044,172.31.40.0-255,66,170096,63,205316
15458,0.008039,74.125.130.0-255,2902,172998,63,205316
15459,0.008047,172.31.40.0-255,66,173064,63,205316
15460,0.00807,74.125.130.0-255,2902,175966,63,205316
15461,0.008073,172.31.40.0-255,66,176032,63,205316
15462,0.010048,74.125.130.0-255,2902,178934,63,205316
15463,0.010056,172.31.40.0-255,66,179000,63,205316
15464,0.010079,74.125.130.0-255,2902,181902,63,205316
15465,0.010082,172.31.40.0-255,66,181968,63,205316
15466,0.012066,74.125.130.0-255,2902,184870,63,205316
15467,0.012074,172.31.40.0-255,66,184936,63,205316
15468,0.012091,74.125.130.0-255,2902,187838,63,205316
15469,0.012094,172.31.40.0-255,66,187904,63,205316
15470,0.01408,74.125.130.0-255,5738,193642,63,205316
15471,0.014088,172.31.40.0-255,66,193708,63,205316
15472,0.016105,74.125.130.0-255,5738,199446,63,205316
15473,0.016116,172.31.40.0-255,66,199512,63,205316
15474,0.018121,74.125.130.0-255,5738,205250,63,205316
15475,0.018128,172.31.40.0-255,66,205316,63,205316
15476,0.0,172.217.26.0-255,153,153,63,122364
15477,2.2e-05,172.31.40.0-255,66,219,63,122364
15478,2.9e-05,172.217.26.0-255,1484,1703,63,122364
15479,3.3e-05,172.31.40.0-255,66,1769,63,122364
15480,3.9e-05,172.217.26.0-255,2902,4671,63,122364
15481,4.8e-05,172.31.40.0-255,66,4737,63,122364
15482,5.5e-05,172.217.26.0-255,7156,11893,63,122364
15483,5.8e-05,172.31.40.0-255,66,11959,63,122364
15484,8.8e-05,172.217.26.0-255,2902,14861,63,122364
15485,9.1e-05,172.31.40.0-255,66,14927,63,122364
15486,0.000128,172.31.40.0-255,66,14993,63,122364
15487,0.000135,172.217.26.0-255,6797,21790,63,122364
15488,0.000136,172.31.40.0-255,66,21856,63,122364
15489,0.000174,172.217.26.0-255,1484,23340,63,122364
15490,0.000176,172.31.40.0-255,66,23406,63,122364
15491,0.00018,172.217.26.0-255,2902,26308,63,122364
15492,0.000182,172.31.40.0-255,66,26374,63,122364
15493,0.000187,172.217.26.0-255,4320,30694,63,122364
15494,0.000189,172.31.40.0-255,66,30760,63,122364
15495,0.000213,172.217.26.0-255,1484,32244,63,122364
15496,0.000215,172.31.40.0-255,66,32310,63,122364
15497,0.000226,172.31.40.0-255,66,32376,63,122364
15498,0.000237,172.31.40.0-255,66,32442,63,122364
15499,0.000253,172.217.26.0-255,1484,33926,63,122364
15500,0.000255,172.31.40.0-255,66,33992,63,122364
15501,0.000281,172.217.26.0-255,2543,36535,63,122364
15502,0.000284,172.31.40.0-255,66,36601,63,122364
15503,0.000305,172.217.26.0-255,397,36998,63,122364
15504,0.000307,172.31.40.0-255,66,37064,63,122364
15505,0.001331,172.217.26.0-255,112,37176,63,122364
15506,0.001433,172.217.26.0-255,1484,38660,63,122364
15507,0.001438,172.31.40.0-255,66,38726,63,122364
15508,0.001444,172.217.26.0-255,2902,41628,63,122364
15509,0.001446,172.31.40.0-255,66,41694,63,122364
15510,0.001452,172.217.26.0-255,4320,46014,63,122364
15511,0.001458,172.31.40.0-255,66,46080,63,122364
15512,0.001488,172.217.26.0-255,1484,47564,63,122364
15513,0.001496,172.217.26.0-255,6797,54361,63,122364
15514,0.001498,172.31.40.0-255,66,54427,63,122364
15515,0.001525,172.217.26.0-255,7156,61583,63,122364
15516,0.001528,172.31.40.0-255,66,61649,63,122364
15517,0.001533,172.217.26.0-255,4320,65969,63,122364
15518,0.001535,172.31.40.0-255,66,66035,63,122364
15519,0.001582,172.217.26.0-255,4320,70355,63,122364
15520,0.001585,172.31.40.0-255,66,70421,63,122364
15521,0.001596,172.217.26.0-255,1125,71546,63,122364
15522,0.003548,172.217.26.0-255,4320,75866,63,122364
15523,0.003552,172.31.40.0-255,66,75932,63,122364
15524,0.005523,172.217.26.0-255,5738,81670,63,122364
15525,0.005528,172.31.40.0-255,66,81736,63,122364
15526,0.007494,172.217.26.0-255,5738,87474,63,122364
15527,0.0075,172.31.40.0-255,66,87540,63,122364
15528,0.009472,172.217.26.0-255,5738,93278,63,122364
15529,0.009479,172.31.40.0-255,66,93344,63,122364
15530,0.011455,172.217.26.0-255,5738,99082,63,122364
15531,0.011463,172.31.40.0-255,66,99148,63,122364
15532,0.013439,172.217.26.0-255,5738,104886,63,122364
15533,0.01345,172.31.40.0-255,66,104952,63,122364
15534,0.015423,172.217.26.0-255,5738,110690,63,122364
15535,0.01543,172.31.40.0-255,66,110756,63,122364
15536,0.017394,172.217.26.0-255,5738,116494,63,122364
15537,0.017402,172.31.40.0-255,66,116560,63,122364
15538,0.019376,172.217.26.0-255,5738,122298,63,122364
15539,0.019385,172.31.40.0-255,66,122364,63,122364
15540,0.0,74.125.130.0-255,152,152,63,138792
15541,2.1e-05,172.31.40.0-255,66,218,63,138792
15542,2.8e-05,74.125.130.0-255,1484,1702,63,138792
15543,3.2e-05,172.31.40.0-255,66,1768,63,138792
15544,3.8e-05,74.125.130.0-255,2902,4670,63,138792
15545,4.1e-05,172.31.40.0-255,66,4736,63,138792
15546,4.7e-05,74.125.130.0-255,2902,7638,63,138792
15547,5e-05,172.31.40.0-255,66,7704,63,138792
15548,6.9e-05,74.125.130.0-255,2902,10606,63,138792
15549,7.2e-05,172.31.40.0-255,66,10672,63,138792
15550,9.4e-05,74.125.130.0-255,3393,14065,63,138792
15551,9.7e-05,172.31.40.0-255,66,14131,63,138792
15552,0.000117,74.125.130.0-255,4320,18451,63,138792
15553,0.00012,172.31.40.0-255,66,18517,63,138792
15554,0.000153,74.125.130.0-255,1484,20001,63,138792
15555,0.000155,172.31.40.0-255,66,20067,63,138792
15556,0.000179,74.125.130.0-255,4320,24387,63,138792
15557,0.000182,172.31.40.0-255,66,24453,63,138792
15558,0.000189,74.125.130.0-255,6797,31250,63,138792
15559,0.000191,172.31.40.0-255,66,31316,63,138792
15560,0.000222,74.125.130.0-255,4320,35636,63,138792
15561,0.000225,172.31.40.0-255,66,35702,63,138792
15562,0.000243,74.125.130.0-255,1484,37186,63,138792
15563,0.000245,172.31.40.0-255,66,37252,63,138792
15564,0.000253,74.125.130.0-255,7156,44408,63,138792
15565,0.000256,172.31.40.0-255,66,44474,63,138792
15566,0.000275,74.125.130.0-255,3961,48435,63,138792
15567,0.000278,172.31.40.0-255,66,48501,63,138792
15568,0.000955,74.125.130.0-255,1484,49985,63,138792
15569,0.000962,172.31.40.0-255,66,50051,63,138792
15570,0.000967,74.125.130.0-255,2902,52953,63,138792
15571,0.00097,172.31.40.0-255,66,53019,63,138792
15572,0.000976,74.125.130.0-255,4320,57339,63,138792
15573,0.000994,74.125.130.0-255,1484,58823,63,138792
15574,0.001002,74.125.130.0-255,6797,65620,63,138792
15575,0.001175,74.125.130.0-255,1484,67104,63,138792
15576,0.001181,74.125.130.0-255,2902,70006,63,138792
15577,0.001195,74.125.130.0-255,4320,74326,63,138792
15578,0.001211,74.125.130.0-255,1484,75810,63,138792
15579,0.00123,74.125.130.0-255,1484,77294,63,138792
15580,0.00125,74.125.130.0-255,5959,83253,63,138792
15581,0.001655,74.125.130.0-255,1484,84737,63,138792
15582,0.001663,74.125.130.0-255,2902,87639,63,138792
15583,0.001668,74.125.130.0-255,4320,91959,63,138792
15584,0.001684,74.125.130.0-255,4320,96279,63,138792
15585,0.001698,74.125.130.0-255,1484,97763,63,138792
15586,0.001731,74.125.130.0-255,2902,100665,63,138792
15587,0.001746,74.125.130.0-255,4457,105122,63,138792
15588,0.00493,172.31.40.0-255,66,105188,63,138792
15589,0.006947,74.125.130.0-255,4320,109508,63,138792
15590,0.006954,172.31.40.0-255,66,109574,63,138792
15591,0.006974,74.125.130.0-255,1484,111058,63,138792
15592,0.008968,74.125.130.0-255,4320,115378,63,138792
15593,0.008976,172.31.40.0-255,66,115444,63,138792
15594,0.011002,74.125.130.0-255,5738,121182,63,138792
15595,0.011976,172.31.40.0-255,66,121248,63,138792
15596,0.013999,74.125.130.0-255,5738,126986,63,138792
15597,0.01401,172.31.40.0-255,66,127052,63,138792
15598,0.016047,74.125.130.0-255,5738,132790,63,138792
15599,0.016062,172.31.40.0-255,66,132856,63,138792
15600,0.018086,74.125.130.0-255,2902,135758,63,138792
15601,0.018097,172.31.40.0-255,66,135824,63,138792
15602,0.018121,74.125.130.0-255,2902,138726,63,138792
15603,0.018155,172.31.40.0-255,66,138792,63,138792
15604,0.0,172.31.40.0-255,105,105,63,276
15605,0.00177,157.240.24.0-255,105,210,63,276
15606,0.001781,172.31.40.0-255,66,276,63,276
15607,0.0,216.58.221.0-255,292,292,63,146487
15608,2.1e-05,172.31.40.0-255,66,358,63,146487
15609,2.7e-05,216.58.221.0-255,1484,1842,63,146487
15610,3.1e-05,172.31.40.0-255,66,1908,63,146487
15611,3.7e-05,216.58.221.0-255,4320,6228,63,146487
15612,4.9e-05,172.31.40.0-255,66,6294,63,146487
15613,5.4e-05,216.58.221.0-255,4320,10614,63,146487
15614,5.7e-05,172.31.40.0-255,66,10680,63,146487
15615,7.9e-05,216.58.221.0-255,3340,14020,63,146487
15616,8.2e-05,172.31.40.0-255,66,14086,63,146487
15617,0.000103,216.58.221.0-255,1484,15570,63,146487
15618,0.000106,172.31.40.0-255,66,15636,63,146487
15619,0.000111,216.58.221.0-255,2902,18538,63,146487
15620,0.000113,172.31.40.0-255,66,18604,63,146487
15621,0.000143,216.58.221.0-255,5738,24342,63,146487
15622,0.000146,172.31.40.0-255,66,24408,63,146487
15623,0.000175,216.58.221.0-255,6797,31205,63,146487
15624,0.000179,172.31.40.0-255,66,31271,63,146487
15625,0.000273,216.58.221.0-255,1484,32755,63,146487
15626,0.000277,172.31.40.0-255,66,32821,63,146487
15627,0.000282,216.58.221.0-255,2902,35723,63,146487
15628,0.000284,172.31.40.0-255,66,35789,63,146487
15629,0.00029,216.58.221.0-255,5738,41527,63,146487
15630,0.000298,172.31.40.0-255,66,41593,63,146487
15631,0.000323,216.58.221.0-255,4320,45913,63,146487
15632,0.000326,172.31.40.0-255,66,45979,63,146487
15633,0.000351,216.58.221.0-255,2543,48522,63,146487
15634,0.000354,172.31.40.0-255,66,48588,63,146487
15635,0.000681,216.58.221.0-255,1484,50072,63,146487
15636,0.000686,172.31.40.0-255,66,50138,63,146487
15637,0.000692,216.58.221.0-255,2902,53040,63,146487
15638,0.000693,172.31.40.0-255,66,53106,63,146487
15639,0.000698,216.58.221.0-255,2902,56008,63,146487
15640,0.000705,172.31.40.0-255,66,56074,63,146487
15641,0.000739,216.58.221.0-255,2902,58976,63,146487
15642,0.000743,172.31.40.0-255,66,59042,63,146487
15643,0.00075,216.58.221.0-255,6797,65839,63,146487
15644,0.000752,172.31.40.0-255,66,65905,63,146487
15645,0.00076,216.58.221.0-255,389,66294,63,146487
15646,0.00103,172.31.40.0-255,66,66360,63,146487
15647,0.001544,216.58.221.0-255,1484,67844,63,146487
15648,0.001594,216.58.221.0-255,2902,70746,63,146487
15649,0.0016,172.31.40.0-255,66,70812,63,146487
15650,0.001608,216.58.221.0-255,4320,75132,63,146487
15651,0.00161,172.31.40.0-255,66,75198,63,146487
15652,0.001639,216.58.221.0-255,1484,76682,63,146487
15653,0.001666,216.58.221.0-255,6797,83479,63,146487
15654,0.001669,172.31.40.0-255,66,83545,63,146487
15655,0.001672,216.58.221.0-255,354,83899,63,146487
15656,0.001714,216.58.221.0-255,1484,85383,63,146487
15657,0.001717,172.31.40.0-255,66,85449,63,146487
15658,0.001722,216.58.221.0-255,2902,88351,63,146487
15659,0.001725,172.31.40.0-255,66,88417,63,146487
15660,0.001735,216.58.221.0-255,2902,91319,63,146487
15661,0.001737,172.31.40.0-255,66,91385,63,146487
15662,0.001765,216.58.221.0-255,1484,92869,63,146487
15663,0.001782,172.31.40.0-255,66,92935,63,146487
15664,0.001796,172.31.40.0-255,66,93001,63,146487
15665,0.001848,216.58.221.0-255,1876,94877,63,146487
15666,0.001854,172.31.40.0-255,66,94943,63,146487
15667,0.003736,216.58.221.0-255,2902,97845,63,146487
15668,0.003741,172.31.40.0-255,66,97911,63,146487
15669,0.003787,216.58.221.0-255,2902,100813,63,146487
15670,0.003791,172.31.40.0-255,66,100879,63,146487
15671,0.005669,216.58.221.0-255,2902,103781,63,146487
15672,0.005674,172.31.40.0-255,66,103847,63,146487
15673,0.005728,216.58.221.0-255,2902,106749,63,146487
15674,0.005731,172.31.40.0-255,66,106815,63,146487
15675,0.007609,216.58.221.0-255,2902,109717,63,146487
15676,0.007617,172.31.40.0-255,66,109783,63,146487
15677,0.007666,216.58.221.0-255,2902,112685,63,146487
15678,0.00767,172.31.40.0-255,66,112751,63,146487
15679,0.009573,216.58.221.0-255,2902,115653,63,146487
15680,0.009582,172.31.40.0-255,66,115719,63,146487
15681,0.009618,216.58.221.0-255,2902,118621,63,146487
15682,0.009622,172.31.40.0-255,66,118687,63,146487
15683,0.01153,216.58.221.0-255,2902,121589,63,146487
15684,0.011537,172.31.40.0-255,66,121655,63,146487
15685,0.011573,216.58.221.0-255,2902,124557,63,146487
15686,0.011578,172.31.40.0-255,66,124623,63,146487
15687,0.013512,216.58.221.0-255,4320,128943,63,146487
15688,0.013519,172.31.40.0-255,66,129009,63,146487
15689,0.013544,216.58.221.0-255,1484,130493,63,146487
15690,0.015474,216.58.221.0-255,4320,134813,63,146487
15691,0.015481,172.31.40.0-255,66,134879,63,146487
15692,0.017434,216.58.221.0-255,5738,140617,63,146487
15693,0.01744,172.31.40.0-255,66,140683,63,146487
15694,0.019413,216.58.221.0-255,5738,146421,63,146487
15695,0.019424,172.31.40.0-255,66,146487,63,146487
15696,0.0,74.125.24.0-255,153,153,63,212430
15697,2.3e-05,172.31.40.0-255,66,219,63,212430
15698,3.1e-05,74.125.24.0-255,1484,1703,63,212430
15699,3.6e-05,172.31.40.0-255,66,1769,63,212430
15700,4.2e-05,74.125.24.0-255,2902,4671,63,212430
15701,5.4e-05,172.31.40.0-255,66,4737,63,212430
15702,6.2e-05,74.125.24.0-255,7156,11893,63,212430
15703,6.5e-05,172.31.40.0-255,66,11959,63,212430
15704,6.9e-05,74.125.24.0-255,2101,14060,63,212430
15705,7.2e-05,172.31.40.0-255,66,14126,63,212430
15706,0.000115,74.125.24.0-255,1484,15610,63,212430
15707,0.000118,172.31.40.0-255,66,15676,63,212430
15708,0.000123,74.125.24.0-255,2902,18578,63,212430
15709,0.000126,172.31.40.0-255,66,18644,63,212430
15710,0.000157,74.125.24.0-255,5738,24382,63,212430
15711,0.00016,172.31.40.0-255,66,24448,63,212430
15712,0.000166,74.125.24.0-255,4320,28768,63,212430
15713,0.000168,172.31.40.0-255,66,28834,63,212430
15714,0.000234,172.31.40.0-255,66,28900,63,212430
15715,0.00026,74.125.24.0-255,2543,31443,63,212430
15716,0.000262,172.31.40.0-255,66,31509,63,212430
15717,0.000269,74.125.24.0-255,6797,38306,63,212430
15718,0.000271,172.31.40.0-255,66,38372,63,212430
15719,0.000697,74.125.24.0-255,1484,39856,63,212430
15720,0.000703,172.31.40.0-255,66,39922,63,212430
15721,0.000709,74.125.24.0-255,2902,42824,63,212430
15722,0.000711,172.31.40.0-255,66,42890,63,212430
15723,0.00075,74.125.24.0-255,5738,48628,63,212430
15724,0.000761,172.31.40.0-255,66,48694,63,212430
15725,0.000767,74.125.24.0-255,4320,53014,63,212430
15726,0.000769,172.31.40.0-255,66,53080,63,212430
15727,0.0008,74.125.24.0-255,2543,55623,63,212430
15728,0.000803,172.31.40.0-255,66,55689,63,212430
15729,0.000859,74.125.24.0-255,647,56336,63,212430
15730,0.001158,172.31.40.0-255,66,56402,63,212430
15731,0.001395,74.125.24.0-255,1484,57886,63,212430
15732,0.001405,74.125.24.0-255,2902,60788,63,212430
15733,0.001409,172.31.40.0-255,66,60854,63,212430
15734,0.001413,74.125.24.0-255,1484,62338,63,212430
15735,0.001437,74.125.24.0-255,4320,66658,63,212430
15736,0.00144,172.31.40.0-255,66,66724,63,212430
15737,0.001468,172.31.40.0-255,66,66790,63,212430
15738,0.001474,74.125.24.0-255,5738,72528,63,212430
15739,0.001476,172.31.40.0-255,66,72594,63,212430
15740,0.001525,74.125.24.0-255,5020,77614,63,212430
15741,0.001528,172.31.40.0-255,66,77680,63,212430
15742,0.002241,74.125.24.0-255,1484,79164,63,212430
15743,0.002249,74.125.24.0-255,2902,82066,63,212430
15744,0.002254,172.31.40.0-255,66,82132,63,212430
15745,0.002262,74.125.24.0-255,5738,87870,63,212430
15746,0.002264,172.31.40.0-255,66,87936,63,212430
15747,0.002267,74.125.24.0-255,1484,89420,63,212430
15748,0.002308,172.31.40.0-255,66,89486,63,212430
15749,0.002321,172.31.40.0-255,66,89552,63,212430
15750,0.002325,74.125.24.0-255,2184,91736,63,212430
15751,0.002327,172.31.40.0-255,66,91802,63,212430
15752,0.002537,74.125.24.0-255,1484,93286,63,212430
15753,0.00256,74.125.24.0-255,2902,96188,63,212430
15754,0.002563,172.31.40.0-255,66,96254,63,212430
15755,0.002592,74.125.24.0-255,5738,101992,63,212430
15756,0.002596,172.31.40.0-255,66,102058,63,212430
15757,0.0026,74.125.24.0-255,2902,104960,63,212430
15758,0.002602,172.31.40.0-255,66,105026,63,212430
15759,0.002605,74.125.24.0-255,1484,106510,63,212430
15760,0.002643,172.31.40.0-255,66,106576,63,212430
15761,0.002656,172.31.40.0-255,66,106642,63,212430
15762,0.003217,74.125.24.0-255,1484,108126,63,212430
15763,0.003235,74.125.24.0-255,2902,111028,63,212430
15764,0.003238,172.31.40.0-255,66,111094,63,212430
15765,0.003244,74.125.24.0-255,4320,115414,63,212430
15766,0.003247,172.31.40.0-255,66,115480,63,212430
15767,0.003276,74.125.24.0-255,1484,116964,63,212430
15768,0.003289,172.31.40.0-255,66,117030,63,212430
15769,0.003315,74.125.24.0-255,2902,119932,63,212430
15770,0.003318,172.31.40.0-255,66,119998,63,212430
15771,0.00333,172.31.40.0-255,66,120064,63,212430
15772,0.003379,74.125.24.0-255,1484,121548,63,212430
15773,0.003397,74.125.24.0-255,2902,124450,63,212430
15774,0.0034,172.31.40.0-255,66,124516,63,212430
15775,0.003406,74.125.24.0-255,4320,128836,63,212430
15776,0.003408,172.31.40.0-255,66,128902,63,212430
15777,0.003431,74.125.24.0-255,1484,130386,63,212430
15778,0.003443,74.125.24.0-255,7156,137542,63,212430
15779,0.003446,172.31.40.0-255,66,137608,63,212430
15780,0.003489,172.31.40.0-255,66,137674,63,212430
15781,0.00351,74.125.24.0-255,2902,140576,63,212430
15782,0.003513,172.31.40.0-255,66,140642,63,212430
15783,0.003526,172.31.40.0-255,66,140708,63,212430
15784,0.003529,74.125.24.0-255,1484,142192,63,212430
15785,0.003532,74.125.24.0-255,1484,143676,63,212430
15786,0.003534,172.31.40.0-255,66,143742,63,212430
15787,0.003537,74.125.24.0-255,1484,145226,63,212430
15788,0.003559,172.31.40.0-255,66,145292,63,212430
15789,0.00359,74.125.24.0-255,3602,148894,63,212430
15790,0.003593,172.31.40.0-255,66,148960,63,212430
15791,0.003622,172.31.40.0-255,66,149026,63,212430
15792,0.003661,172.31.40.0-255,66,149092,63,212430
15793,0.003668,74.125.24.0-255,6438,155530,63,212430
15794,0.00367,172.31.40.0-255,66,155596,63,212430
15795,0.003702,74.125.24.0-255,7156,162752,63,212430
15796,0.003704,172.31.40.0-255,66,162818,63,212430
15797,0.003716,74.125.24.0-255,1484,164302,63,212430
15798,0.003738,74.125.24.0-255,7156,171458,63,212430
15799,0.003742,172.31.40.0-255,66,171524,63,212430
15800,0.003746,74.125.24.0-255,2902,174426,63,212430
15801,0.003748,172.31.40.0-255,66,174492,63,212430
15802,0.003792,172.31.40.0-255,66,174558,63,212430
15803,0.003835,172.31.40.0-255,66,174624,63,212430
15804,0.003854,172.31.40.0-255,66,174690,63,212430
15805,0.003861,74.125.24.0-255,7156,181846,63,212430
15806,0.003863,172.31.40.0-255,66,181912,63,212430
15807,0.003899,74.125.24.0-255,3602,185514,63,212430
15808,0.003902,172.31.40.0-255,66,185580,63,212430
15809,0.004123,74.125.24.0-255,1484,187064,63,212430
15810,0.004147,74.125.24.0-255,2902,189966,63,212430
15811,0.004151,172.31.40.0-255,66,190032,63,212430
15812,0.004154,74.125.24.0-255,1484,191516,63,212430
15813,0.004158,74.125.24.0-255,1484,193000,63,212430
15814,0.004159,172.31.40.0-255,66,193066,63,212430
15815,0.004185,74.125.24.0-255,4320,197386,63,212430
15816,0.004188,172.31.40.0-255,66,197452,63,212430
15817,0.004194,74.125.24.0-255,4320,201772,63,212430
15818,0.004197,172.31.40.0-255,66,201838,63,212430
15819,0.004233,172.31.40.0-255,66,201904,63,212430
15820,0.004239,74.125.24.0-255,5738,207642,63,212430
15821,0.004241,172.31.40.0-255,66,207708,63,212430
15822,0.004255,74.125.24.0-255,1484,209192,63,212430
15823,0.004275,74.125.24.0-255,2184,211376,63,212430
15824,0.004278,172.31.40.0-255,66,211442,63,212430
15825,0.004749,74.125.24.0-255,366,211808,63,212430
15826,0.004781,74.125.24.0-255,97,211905,63,212430
15827,0.004848,74.125.24.0-255,105,212010,63,212430
15828,0.012268,172.31.40.0-255,66,212076,63,212430
15829,0.012319,172.31.40.0-255,105,212181,63,212430
15830,0.013262,74.125.24.0-255,105,212286,63,212430
15831,0.013274,172.31.40.0-255,78,212364,63,212430
15832,0.014355,74.125.24.0-255,66,212430,63,212430
15833,0.0,172.217.194.0-255,148,148,63,170601
15834,2.4e-05,172.31.40.0-255,66,214,63,170601
15835,3.1e-05,172.217.194.0-255,1484,1698,63,170601
15836,3.6e-05,172.31.40.0-255,66,1764,63,170601
15837,4.2e-05,172.217.194.0-255,2902,4666,63,170601
15838,4.6e-05,172.31.40.0-255,66,4732,63,170601
15839,5.4e-05,172.217.194.0-255,7156,11888,63,170601
15840,5.8e-05,172.31.40.0-255,66,11954,63,170601
15841,6e-05,172.217.194.0-255,1484,13438,63,170601
15842,6.3e-05,172.31.40.0-255,66,13504,63,170601
15843,9.1e-05,172.217.194.0-255,2018,15522,63,170601
15844,9.4e-05,172.31.40.0-255,66,15588,63,170601
15845,0.0001,172.217.194.0-255,2902,18490,63,170601
15846,0.000102,172.31.40.0-255,66,18556,63,170601
15847,0.000108,172.217.194.0-255,4320,22876,63,170601
15848,0.00011,172.31.40.0-255,66,22942,63,170601
15849,0.000135,172.217.194.0-255,2902,25844,63,170601
15850,0.000137,172.31.40.0-255,66,25910,63,170601
15851,0.000144,172.217.194.0-255,5379,31289,63,170601
15852,0.000146,172.31.40.0-255,66,31355,63,170601
15853,0.000198,172.217.194.0-255,5738,37093,63,170601
15854,0.000201,172.31.40.0-255,66,37159,63,170601
15855,0.000209,172.217.194.0-255,7156,44315,63,170601
15856,0.000212,172.31.40.0-255,66,44381,63,170601
15857,0.000243,172.217.194.0-255,3961,48342,63,170601
15858,0.000245,172.31.40.0-255,66,48408,63,170601
15859,0.000784,172.217.194.0-255,1484,49892,63,170601
15860,0.00079,172.217.194.0-255,2902,52794,63,170601
15861,0.000795,172.217.194.0-255,4320,57114,63,170601
15862,0.000808,172.31.40.0-255,66,57180,63,170601
15863,0.000812,172.31.40.0-255,66,57246,63,170601
15864,0.000814,172.31.40.0-255,66,57312,63,170601
15865,0.000818,172.217.194.0-255,1484,58796,63,170601
15866,0.000825,172.217.194.0-255,4320,63116,63,170601
15867,0.000828,172.31.40.0-255,66,63182,63,170601
15868,0.000863,172.217.194.0-255,2543,65725,63,170601
15869,0.000866,172.31.40.0-255,66,65791,63,170601
15870,0.000967,172.217.194.0-255,1484,67275,63,170601
15871,0.000971,172.217.194.0-255,1484,68759,63,170601
15872,0.000974,172.31.40.0-255,66,68825,63,170601
15873,0.000991,172.217.194.0-255,1484,70309,63,170601
15874,0.000997,172.217.194.0-255,5738,76047,63,170601
15875,0.001,172.31.40.0-255,66,76113,63,170601
15876,0.001013,172.217.194.0-255,4320,80433,63,170601
15877,0.001016,172.31.40.0-255,66,80499,63,170601
15878,0.001036,172.217.194.0-255,2543,83042,63,170601
15879,0.001043,172.217.194.0-255,7156,90198,63,170601
15880,0.001047,172.31.40.0-255,66,90264,63,170601
15881,0.001054,172.31.40.0-255,66,90330,63,170601
15882,0.001059,172.217.194.0-255,2902,93232,63,170601
15883,0.001061,172.31.40.0-255,66,93298,63,170601
15884,0.001087,172.217.194.0-255,6797,100095,63,170601
15885,0.00109,172.31.40.0-255,66,100161,63,170601
15886,0.002186,172.217.194.0-255,1484,101645,63,170601
15887,0.0022,172.217.194.0-255,2902,104547,63,170601
15888,0.002205,172.31.40.0-255,66,104613,63,170601
15889,0.002213,172.217.194.0-255,5738,110351,63,170601
15890,0.002215,172.31.40.0-255,66,110417,63,170601
15891,0.00223,172.31.40.0-255,66,110483,63,170601
15892,0.002235,172.217.194.0-255,2902,113385,63,170601
15893,0.002237,172.31.40.0-255,66,113451,63,170601
15894,0.002273,172.31.40.0-255,66,113517,63,170601
15895,0.002319,172.217.194.0-255,1484,115001,63,170601
15896,0.002333,172.217.194.0-255,2902,117903,63,170601
15897,0.002336,172.31.40.0-255,66,117969,63,170601
15898,0.002341,172.217.194.0-255,2902,120871,63,170601
15899,0.002343,172.31.40.0-255,66,120937,63,170601
15900,0.002358,172.217.194.0-255,2902,123839,63,170601
15901,0.002361,172.31.40.0-255,66,123905,63,170601
15902,0.002375,172.31.40.0-255,66,123971,63,170601
15903,0.002412,172.31.40.0-255,66,124037,63,170601
15904,0.002431,172.217.194.0-255,4320,128357,63,170601
15905,0.002434,172.31.40.0-255,66,128423,63,170601
15906,0.002453,172.217.194.0-255,7156,135579,63,170601
15907,0.002456,172.31.40.0-255,66,135645,63,170601
15908,0.002467,172.31.40.0-255,66,135711,63,170601
15909,0.002506,172.31.40.0-255,66,135777,63,170601
15910,0.005077,172.217.194.0-255,5738,141515,63,170601
15911,0.005084,172.31.40.0-255,66,141581,63,170601
15912,0.007654,172.217.194.0-255,5738,147319,63,170601
15913,0.007661,172.31.40.0-255,66,147385,63,170601
15914,0.010275,172.217.194.0-255,5738,153123,63,170601
15915,0.010282,172.31.40.0-255,66,153189,63,170601
15916,0.012841,172.217.194.0-255,5738,158927,63,170601
15917,0.01285,172.31.40.0-255,66,158993,63,170601
15918,0.015433,172.217.194.0-255,5738,164731,63,170601
15919,0.01545,172.31.40.0-255,66,164797,63,170601
15920,0.018015,172.217.194.0-255,5738,170535,63,170601
15921,0.018023,172.31.40.0-255,66,170601,63,170601
15922,0.0,74.125.200.0-255,153,153,63,249937
15923,2e-05,172.31.40.0-255,66,219,63,249937
15924,2.6e-05,74.125.200.0-255,1484,1703,63,249937
15925,3e-05,172.31.40.0-255,66,1769,63,249937
15926,3.6e-05,74.125.200.0-255,2902,4671,63,249937
15927,4e-05,172.31.40.0-255,66,4737,63,249937
15928,4.7e-05,74.125.200.0-255,4320,9057,63,249937
15929,4.9e-05,172.31.40.0-255,66,9123,63,249937
15930,8e-05,74.125.200.0-255,2902,12025,63,249937
15931,8.3e-05,172.31.40.0-255,66,12091,63,249937
15932,9e-05,74.125.200.0-255,4857,16948,63,249937
15933,9.3e-05,172.31.40.0-255,66,17014,63,249937
15934,0.0001,74.125.200.0-255,5738,22752,63,249937
15935,0.000102,172.31.40.0-255,66,22818,63,249937
15936,0.000138,172.31.40.0-255,66,22884,63,249937
15937,0.000162,74.125.200.0-255,1484,24368,63,249937
15938,0.000164,172.31.40.0-255,66,24434,63,249937
15939,0.000177,74.125.200.0-255,2902,27336,63,249937
15940,0.000179,172.31.40.0-255,66,27402,63,249937
15941,0.000202,74.125.200.0-255,5738,33140,63,249937
15942,0.000204,172.31.40.0-255,66,33206,63,249937
15943,0.000207,74.125.200.0-255,1484,34690,63,249937
15944,0.00021,172.31.40.0-255,66,34756,63,249937
15945,0.000227,74.125.200.0-255,2902,37658,63,249937
15946,0.00023,172.31.40.0-255,66,37724,63,249937
15947,0.000285,74.125.200.0-255,2543,40267,63,249937
15948,0.000288,172.31.40.0-255,66,40333,63,249937
15949,0.000308,74.125.200.0-255,1484,41817,63,249937
15950,0.000311,172.31.40.0-255,66,41883,63,249937
15951,0.000332,74.125.200.0-255,1484,43367,63,249937
15952,0.000334,172.31.40.0-255,66,43433,63,249937
15953,0.00034,74.125.200.0-255,4320,47753,63,249937
15954,0.000342,172.31.40.0-255,66,47819,63,249937
15955,0.000346,74.125.200.0-255,2902,50721,63,249937
15956,0.000348,172.31.40.0-255,66,50787,63,249937
15957,0.000362,74.125.200.0-255,5738,56525,63,249937
15958,0.000364,172.31.40.0-255,66,56591,63,249937
15959,0.000368,74.125.200.0-255,1706,58297,63,249937
15960,0.00037,172.31.40.0-255,66,58363,63,249937
15961,0.000433,74.125.200.0-255,1484,59847,63,249937
15962,0.000451,74.125.200.0-255,2902,62749,63,249937
15963,0.000454,172.31.40.0-255,66,62815,63,249937
15964,0.000477,74.125.200.0-255,5738,68553,63,249937
15965,0.000479,172.31.40.0-255,66,68619,63,249937
15966,0.000508,74.125.200.0-255,6247,74866,63,249937
15967,0.000511,172.31.40.0-255,66,74932,63,249937
15968,0.000561,74.125.200.0-255,1484,76416,63,249937
15969,0.000566,74.125.200.0-255,2902,79318,63,249937
15970,0.000568,172.31.40.0-255,66,79384,63,249937
15971,0.000592,74.125.200.0-255,5738,85122,63,249937
15972,0.000594,172.31.40.0-255,66,85188,63,249937
15973,0.000614,74.125.200.0-255,4320,89508,63,249937
15974,0.000617,172.31.40.0-255,66,89574,63,249937
15975,0.000637,74.125.200.0-255,2543,92117,63,249937
15976,0.00064,172.31.40.0-255,66,92183,63,249937
15977,0.000743,74.125.200.0-255,1484,93667,63,249937
15978,0.000763,74.125.200.0-255,2902,96569,63,249937
15979,0.000766,172.31.40.0-255,66,96635,63,249937
15980,0.00077,74.125.200.0-255,1484,98119,63,249937
15981,0.000824,74.125.200.0-255,2902,101021,63,249937
15982,0.000826,172.31.40.0-255,66,101087,63,249937
15983,0.000833,74.125.200.0-255,5738,106825,63,249937
15984,0.000835,172.31.40.0-255,66,106891,63,249937
15985,0.000837,74.125.200.0-255,1484,108375,63,249937
15986,0.000865,74.125.200.0-255,1125,109500,63,249937
15987,0.000867,172.31.40.0-255,66,109566,63,249937
15988,0.000898,74.125.200.0-255,1484,111050,63,249937
15989,0.000921,74.125.200.0-255,4320,115370,63,249937
15990,0.000924,172.31.40.0-255,66,115436,63,249937
15991,0.00094,74.125.200.0-255,1484,116920,63,249937
15992,0.000964,74.125.200.0-255,4320,121240,63,249937
15993,0.000968,172.31.40.0-255,66,121306,63,249937
15994,0.000985,74.125.200.0-255,4320,125626,63,249937
15995,0.000987,172.31.40.0-255,66,125692,63,249937
15996,0.001008,74.125.200.0-255,1125,126817,63,249937
15997,0.001035,74.125.200.0-255,1484,128301,63,249937
15998,0.001037,172.31.40.0-255,66,128367,63,249937
15999,0.001043,74.125.200.0-255,2902,131269,63,249937
16000,0.001045,172.31.40.0-255,66,131335,63,249937
16001,0.001058,74.125.200.0-255,2902,134237,63,249937
16002,0.00106,172.31.40.0-255,66,134303,63,249937
16003,0.001084,74.125.200.0-255,2902,137205,63,249937
16004,0.001086,172.31.40.0-255,66,137271,63,249937
16005,0.001092,74.125.200.0-255,4320,141591,63,249937
16006,0.001094,172.31.40.0-255,66,141657,63,249937
16007,0.0011,74.125.200.0-255,5379,147036,63,249937
16008,0.001102,172.31.40.0-255,66,147102,63,249937
16009,0.001141,172.31.40.0-255,66,147168,63,249937
16010,0.001145,74.125.200.0-255,2543,149711,63,249937
16011,0.001147,172.31.40.0-255,66,149777,63,249937
16012,0.001636,74.125.200.0-255,1484,151261,63,249937
16013,0.001641,74.125.200.0-255,1484,152745,63,249937
16014,0.001645,172.31.40.0-255,66,152811,63,249937
16015,0.001661,74.125.200.0-255,1484,154295,63,249937
16016,0.001667,74.125.200.0-255,5738,160033,63,249937
16017,0.001669,172.31.40.0-255,66,160099,63,249937
16018,0.00169,74.125.200.0-255,4320,164419,63,249937
16019,0.001692,172.31.40.0-255,66,164485,63,249937
16020,0.001712,74.125.200.0-255,4320,168805,63,249937
16021,0.001715,172.31.40.0-255,66,168871,63,249937
16022,0.001726,172.31.40.0-255,66,168937,63,249937
16023,0.001742,74.125.200.0-255,4320,173257,63,249937
16024,0.001745,172.31.40.0-255,66,173323,63,249937
16025,0.001769,74.125.200.0-255,766,174089,63,249937
16026,0.001884,74.125.200.0-255,1484,175573,63,249937
16027,0.001888,172.31.40.0-255,66,175639,63,249937
16028,0.001902,74.125.200.0-255,2902,178541,63,249937
16029,0.001905,172.31.40.0-255,66,178607,63,249937
16030,0.001912,74.125.200.0-255,5738,184345,63,249937
16031,0.001914,172.31.40.0-255,66,184411,63,249937
16032,0.001937,74.125.200.0-255,2902,187313,63,249937
16033,0.00194,172.31.40.0-255,66,187379,63,249937
16034,0.001969,172.31.40.0-255,66,187445,63,249937
16035,0.001976,74.125.200.0-255,5738,193183,63,249937
16036,0.001978,172.31.40.0-255,66,193249,63,249937
16037,0.001991,74.125.200.0-255,4320,197569,63,249937
16038,0.001994,172.31.40.0-255,66,197635,63,249937
16039,0.003918,74.125.200.0-255,1484,199119,63,249937
16040,0.003942,74.125.200.0-255,4320,203439,63,249937
16041,0.003947,172.31.40.0-255,66,203505,63,249937
16042,0.005892,74.125.200.0-255,5738,209243,63,249937
16043,0.005895,172.31.40.0-255,66,209309,63,249937
16044,0.007849,74.125.200.0-255,5738,215047,63,249937
16045,0.007853,172.31.40.0-255,66,215113,63,249937
16046,0.009831,74.125.200.0-255,5738,220851,63,249937
16047,0.009847,172.31.40.0-255,66,220917,63,249937
16048,0.011816,74.125.200.0-255,5738,226655,63,249937
16049,0.011828,172.31.40.0-255,66,226721,63,249937
16050,0.013803,74.125.200.0-255,5738,232459,63,249937
16051,0.013818,172.31.40.0-255,66,232525,63,249937
16052,0.015785,74.125.200.0-255,5738,238263,63,249937
16053,0.0158,172.31.40.0-255,66,238329,63,249937
16054,0.017748,74.125.200.0-255,5738,244067,63,249937
16055,0.017756,172.31.40.0-255,66,244133,63,249937
16056,0.019717,74.125.200.0-255,5738,249871,63,249937
16057,0.019726,172.31.40.0-255,66,249937,63,249937
16058,0.0,74.125.68.0-255,298,298,63,199465
16059,2.3e-05,172.31.40.0-255,66,364,63,199465
16060,3e-05,74.125.68.0-255,1484,1848,63,199465
16061,3.5e-05,172.31.40.0-255,66,1914,63,199465
16062,4.1e-05,74.125.68.0-255,4320,6234,63,199465
16063,4.4e-05,172.31.40.0-255,66,6300,63,199465
16064,4.9e-05,74.125.68.0-255,2902,9202,63,199465
16065,5.2e-05,172.31.40.0-255,66,9268,63,199465
16066,5.7e-05,74.125.68.0-255,4320,13588,63,199465
16067,6e-05,172.31.40.0-255,66,13654,63,199465
16068,9.7e-05,74.125.68.0-255,4320,17974,63,199465
16069,0.0001,172.31.40.0-255,66,18040,63,199465
16070,0.000125,74.125.68.0-255,4550,22590,63,199465
16071,0.000127,172.31.40.0-255,66,22656,63,199465
16072,0.000168,74.125.68.0-255,2902,25558,63,199465
16073,0.00017,172.31.40.0-255,66,25624,63,199465
16074,0.000194,74.125.68.0-255,5379,31003,63,199465
16075,0.000197,172.31.40.0-255,66,31069,63,199465
16076,0.000215,74.125.68.0-255,1484,32553,63,199465
16077,0.000217,172.31.40.0-255,66,32619,63,199465
16078,0.000239,74.125.68.0-255,1484,34103,63,199465
16079,0.000241,172.31.40.0-255,66,34169,63,199465
16080,0.000255,74.125.68.0-255,2902,37071,63,199465
16081,0.000257,172.31.40.0-255,66,37137,63,199465
16082,0.000286,74.125.68.0-255,5738,42875,63,199465
16083,0.000289,172.31.40.0-255,66,42941,63,199465
16084,0.000295,74.125.68.0-255,4320,47261,63,199465
16085,0.000297,172.31.40.0-255,66,47327,63,199465
16086,0.000313,74.125.68.0-255,2902,50229,63,199465
16087,0.000315,172.31.40.0-255,66,50295,63,199465
16088,0.000358,172.31.40.0-255,66,50361,63,199465
16089,0.000362,74.125.68.0-255,4320,54681,63,199465
16090,0.000365,172.31.40.0-255,66,54747,63,199465
16091,0.000396,74.125.68.0-255,2515,57262,63,199465
16092,0.000398,172.31.40.0-255,66,57328,63,199465
16093,0.000481,74.125.68.0-255,110,57438,63,199465
16094,0.000698,74.125.68.0-255,1484,58922,63,199465
16095,0.000704,172.31.40.0-255,66,58988,63,199465
16096,0.000717,74.125.68.0-255,1484,60472,63,199465
16097,0.000735,74.125.68.0-255,1484,61956,63,199465
16098,0.000738,172.31.40.0-255,66,62022,63,199465
16099,0.000757,74.125.68.0-255,4320,66342,63,199465
16100,0.00076,172.31.40.0-255,66,66408,63,199465
16101,0.000784,74.125.68.0-255,5738,72146,63,199465
16102,0.000788,172.31.40.0-255,66,72212,63,199465
16103,0.000809,74.125.68.0-255,7156,79368,63,199465
16104,0.000811,172.31.40.0-255,66,79434,63,199465
16105,0.000843,172.31.40.0-255,66,79500,63,199465
16106,0.000864,74.125.68.0-255,2902,82402,63,199465
16107,0.000867,172.31.40.0-255,66,82468,63,199465
16108,0.000891,74.125.68.0-255,1033,83501,63,199465
16109,0.001055,74.125.68.0-255,1484,84985,63,199465
16110,0.001059,172.31.40.0-255,66,85051,63,199465
16111,0.001064,74.125.68.0-255,2902,87953,63,199465
16112,0.001067,172.31.40.0-255,66,88019,63,199465
16113,0.00107,74.125.68.0-255,1484,89503,63,199465
16114,0.001094,74.125.68.0-255,4320,93823,63,199465
16115,0.001096,172.31.40.0-255,66,93889,63,199465
16116,0.001099,74.125.68.0-255,1484,95373,63,199465
16117,0.001127,172.31.40.0-255,66,95439,63,199465
16118,0.00115,74.125.68.0-255,5738,101177,63,199465
16119,0.001153,172.31.40.0-255,66,101243,63,199465
16120,0.001177,74.125.68.0-255,5738,106981,63,199465
16121,0.00118,172.31.40.0-255,66,107047,63,199465
16122,0.001185,74.125.68.0-255,2184,109231,63,199465
16123,0.001187,172.31.40.0-255,66,109297,63,199465
16124,0.001818,74.125.68.0-255,1484,110781,63,199465
16125,0.001855,74.125.68.0-255,2902,113683,63,199465
16126,0.001859,172.31.40.0-255,66,113749,63,199465
16127,0.001863,74.125.68.0-255,1484,115233,63,199465
16128,0.001905,74.125.68.0-255,2902,118135,63,199465
16129,0.001907,172.31.40.0-255,66,118201,63,199465
16130,0.001913,74.125.68.0-255,5738,123939,63,199465
16131,0.001915,172.31.40.0-255,66,124005,63,199465
16132,0.001921,74.125.68.0-255,4320,128325,63,199465
16133,0.001922,172.31.40.0-255,66,128391,63,199465
16134,0.001925,74.125.68.0-255,1484,129875,63,199465
16135,0.001948,74.125.68.0-255,4320,134195,63,199465
16136,0.00195,172.31.40.0-255,66,134261,63,199465
16137,0.001953,74.125.68.0-255,1484,135745,63,199465
16138,0.00197,74.125.68.0-255,1484,137229,63,199465
16139,0.001973,172.31.40.0-255,66,137295,63,199465
16140,0.001993,74.125.68.0-255,2902,140197,63,199465
16141,0.001995,172.31.40.0-255,66,140263,63,199465
16142,0.002014,74.125.68.0-255,1484,141747,63,199465
16143,0.002018,74.125.68.0-255,1484,143231,63,199465
16144,0.00202,172.31.40.0-255,66,143297,63,199465
16145,0.002051,74.125.68.0-255,766,144063,63,199465
16146,0.002159,74.125.68.0-255,1484,145547,63,199465
16147,0.002163,172.31.40.0-255,66,145613,63,199465
16148,0.002198,74.125.68.0-255,2902,148515,63,199465
16149,0.002201,172.31.40.0-255,66,148581,63,199465
16150,0.002219,74.125.68.0-255,1484,150065,63,199465
16151,0.002237,74.125.68.0-255,2902,152967,63,199465
16152,0.00224,172.31.40.0-255,66,153033,63,199465
16153,0.00226,74.125.68.0-255,5738,158771,63,199465
16154,0.002262,172.31.40.0-255,66,158837,63,199465
16155,0.004515,74.125.68.0-255,5738,164575,63,199465
16156,0.004523,172.31.40.0-255,66,164641,63,199465
16157,0.006768,74.125.68.0-255,5738,170379,63,199465
16158,0.006773,172.31.40.0-255,66,170445,63,199465
16159,0.00902,74.125.68.0-255,5738,176183,63,199465
16160,0.009028,172.31.40.0-255,66,176249,63,199465
16161,0.011276,74.125.68.0-255,5738,181987,63,199465
16162,0.011285,172.31.40.0-255,66,182053,63,199465
16163,0.013546,74.125.68.0-255,5738,187791,63,199465
16164,0.01356,172.31.40.0-255,66,187857,63,199465
16165,0.015822,74.125.68.0-255,5738,193595,63,199465
16166,0.015836,172.31.40.0-255,66,193661,63,199465
16167,0.018085,74.125.68.0-255,5738,199399,63,199465
16168,0.018095,172.31.40.0-255,66,199465,63,199465
16169,0.0,74.125.24.0-255,298,298,63,107584
16170,2e-05,172.31.40.0-255,66,364,63,107584
16171,2.6e-05,74.125.24.0-255,1484,1848,63,107584
16172,3e-05,172.31.40.0-255,66,1914,63,107584
16173,3.6e-05,74.125.24.0-255,4320,6234,63,107584
16174,4.5e-05,172.31.40.0-255,66,6300,63,107584
16175,5.5e-05,172.31.40.0-255,66,6366,63,107584
16176,9.6e-05,172.31.40.0-255,66,6432,63,107584
16177,0.000109,74.125.24.0-255,4320,10752,63,107584
16178,0.000114,172.31.40.0-255,66,10818,63,107584
16179,0.000119,74.125.24.0-255,2543,13361,63,107584
16180,0.000121,172.31.40.0-255,66,13427,63,107584
16181,0.000817,74.125.24.0-255,1484,14911,63,107584
16182,0.000824,172.31.40.0-255,66,14977,63,107584
16183,0.000833,74.125.24.0-255,2902,17879,63,107584
16184,0.000835,172.31.40.0-255,66,17945,63,107584
16185,0.000848,74.125.24.0-255,5738,23683,63,107584
16186,0.00085,172.31.40.0-255,66,23749,63,107584
16187,0.000857,74.125.24.0-255,5738,29487,63,107584
16188,0.00086,172.31.40.0-255,66,29553,63,107584
16189,0.000906,172.31.40.0-255,66,29619,63,107584
16190,0.000913,74.125.24.0-255,5020,34639,63,107584
16191,0.000915,172.31.40.0-255,66,34705,63,107584
16192,0.000943,74.125.24.0-255,445,35150,63,107584
16193,0.000946,172.31.40.0-255,66,35216,63,107584
16194,0.001033,74.125.24.0-255,1484,36700,63,107584
16195,0.001038,172.31.40.0-255,66,36766,63,107584
16196,0.001043,74.125.24.0-255,2902,39668,63,107584
16197,0.001045,172.31.40.0-255,66,39734,63,107584
16198,0.001048,74.125.24.0-255,1484,41218,63,107584
16199,0.00107,74.125.24.0-255,5738,46956,63,107584
16200,0.001073,172.31.40.0-255,66,47022,63,107584
16201,0.001185,172.31.40.0-255,66,47088,63,107584
16202,0.001197,172.31.40.0-255,66,47154,63,107584
16203,0.001209,74.125.24.0-255,5738,52892,63,107584
16204,0.001212,172.31.40.0-255,66,52958,63,107584
16205,0.001245,74.125.24.0-255,4320,57278,63,107584
16206,0.001247,172.31.40.0-255,66,57344,63,107584
16207,0.001259,172.31.40.0-255,66,57410,63,107584
16208,0.001274,172.31.40.0-255,66,57476,63,107584
16209,0.001301,74.125.24.0-255,1484,58960,63,107584
16210,0.001304,74.125.24.0-255,766,59726,63,107584
16211,0.001305,172.31.40.0-255,66,59792,63,107584
16212,0.001519,74.125.24.0-255,1484,61276,63,107584
16213,0.001525,74.125.24.0-255,2902,64178,63,107584
16214,0.001529,172.31.40.0-255,66,64244,63,107584
16215,0.001534,74.125.24.0-255,4320,68564,63,107584
16216,0.001537,172.31.40.0-255,66,68630,63,107584
16217,0.001566,74.125.24.0-255,1484,70114,63,107584
16218,0.001577,172.31.40.0-255,66,70180,63,107584
16219,0.001608,74.125.24.0-255,4320,74500,63,107584
16220,0.00161,172.31.40.0-255,66,74566,63,107584
16221,0.001646,172.31.40.0-255,66,74632,63,107584
16222,0.001699,74.125.24.0-255,1484,76116,63,107584
16223,0.001704,74.125.24.0-255,2902,79018,63,107584
16224,0.001707,172.31.40.0-255,66,79084,63,107584
16225,0.001732,74.125.24.0-255,5738,84822,63,107584
16226,0.001735,172.31.40.0-255,66,84888,63,107584
16227,0.001795,172.31.40.0-255,66,84954,63,107584
16228,0.001809,172.31.40.0-255,66,85020,63,107584
16229,0.001821,74.125.24.0-255,1484,86504,63,107584
16230,0.001831,74.125.24.0-255,2902,89406,63,107584
16231,0.001833,172.31.40.0-255,66,89472,63,107584
16232,0.001836,74.125.24.0-255,1484,90956,63,107584
16233,0.001854,74.125.24.0-255,4320,95276,63,107584
16234,0.001856,172.31.40.0-255,66,95342,63,107584
16235,0.001866,172.31.40.0-255,66,95408,63,107584
16236,0.001912,172.31.40.0-255,66,95474,63,107584
16237,0.001942,74.125.24.0-255,3602,99076,63,107584
16238,0.001944,172.31.40.0-255,66,99142,63,107584
16239,0.001954,172.31.40.0-255,66,99208,63,107584
16240,0.00199,172.31.40.0-255,66,99274,63,107584
16241,0.002026,172.31.40.0-255,66,99340,63,107584
16242,0.002038,172.31.40.0-255,66,99406,63,107584
16243,0.002078,172.31.40.0-255,66,99472,63,107584
16244,0.002084,74.125.24.0-255,5020,104492,63,107584
16245,0.002086,172.31.40.0-255,66,104558,63,107584
16246,0.002099,172.31.40.0-255,66,104624,63,107584
16247,0.002149,172.31.40.0-255,66,104690,63,107584
16248,0.002152,74.125.24.0-255,766,105456,63,107584
16249,0.00218,172.31.40.0-255,66,105522,63,107584
16250,0.002221,172.31.40.0-255,66,105588,63,107584
16251,0.002266,172.31.40.0-255,66,105654,63,107584
16252,0.002287,172.31.40.0-255,66,105720,63,107584
16253,0.00229,74.125.24.0-255,727,106447,63,107584
16254,0.002293,74.125.24.0-255,105,106552,63,107584
16255,0.002295,74.125.24.0-255,129,106681,63,107584
16256,0.012799,74.125.24.0-255,129,106810,63,107584
16257,0.012816,172.31.40.0-255,78,106888,63,107584
16258,0.014252,172.31.40.0-255,105,106993,63,107584
16259,0.014287,172.31.40.0-255,105,107098,63,107584
16260,0.014558,172.31.40.0-255,90,107188,63,107584
16261,0.014567,172.31.40.0-255,66,107254,63,107584
16262,0.016507,74.125.24.0-255,66,107320,63,107584
16263,0.016533,74.125.24.0-255,66,107386,63,107584
16264,0.016814,74.125.24.0-255,66,107452,63,107584
16265,0.016849,74.125.24.0-255,66,107518,63,107584
16266,0.016857,172.31.40.0-255,66,107584,63,107584
16267,0.0,172.217.194.0-255,150,150,63,181315
16268,2.5e-05,172.31.40.0-255,66,216,63,181315
16269,3.1e-05,172.217.194.0-255,1484,1700,63,181315
16270,3.6e-05,172.31.40.0-255,66,1766,63,181315
16271,4.2e-05,172.217.194.0-255,2902,4668,63,181315
16272,5.3e-05,172.31.40.0-255,66,4734,63,181315
16273,6.1e-05,172.217.194.0-255,7156,11890,63,181315
16274,6.4e-05,172.31.40.0-255,66,11956,63,181315
16275,7.7e-05,172.31.40.0-255,66,12022,63,181315
16276,0.000114,172.31.40.0-255,66,12088,63,181315
16277,0.000118,172.217.194.0-255,2543,14631,63,181315
16278,0.000121,172.31.40.0-255,66,14697,63,181315
16279,0.000142,172.217.194.0-255,1484,16181,63,181315
16280,0.000145,172.31.40.0-255,66,16247,63,181315
16281,0.00015,172.217.194.0-255,2902,19149,63,181315
16282,0.000152,172.31.40.0-255,66,19215,63,181315
16283,0.000155,172.217.194.0-255,1484,20699,63,181315
16284,0.000158,172.31.40.0-255,66,20765,63,181315
16285,0.000189,172.217.194.0-255,4320,25085,63,181315
16286,0.000192,172.31.40.0-255,66,25151,63,181315
16287,0.000203,172.31.40.0-255,66,25217,63,181315
16288,0.000247,172.31.40.0-255,66,25283,63,181315
16289,0.000277,172.217.194.0-255,7097,32380,63,181315
16290,0.00028,172.31.40.0-255,66,32446,63,181315
16291,0.000304,172.217.194.0-255,385,32831,63,181315
16292,0.000306,172.31.40.0-255,66,32897,63,181315
16293,0.000447,172.217.194.0-255,1484,34381,63,181315
16294,0.00045,172.31.40.0-255,66,34447,63,181315
16295,0.000455,172.217.194.0-255,2902,37349,63,181315
16296,0.000457,172.31.40.0-255,66,37415,63,181315
16297,0.00046,172.217.194.0-255,1484,38899,63,181315
16298,0.000489,172.217.194.0-255,4320,43219,63,181315
16299,0.000493,172.31.40.0-255,66,43285,63,181315
16300,0.000497,172.217.194.0-255,2902,46187,63,181315
16301,0.000499,172.31.40.0-255,66,46253,63,181315
16302,0.000534,172.31.40.0-255,66,46319,63,181315
16303,0.000567,172.31.40.0-255,66,46385,63,181315
16304,0.000592,172.217.194.0-255,2184,48569,63,181315
16305,0.000594,172.31.40.0-255,66,48635,63,181315
16306,0.000618,172.217.194.0-255,1484,50119,63,181315
16307,0.000623,172.217.194.0-255,2902,53021,63,181315
16308,0.000625,172.31.40.0-255,66,53087,63,181315
16309,0.000631,172.217.194.0-255,4320,57407,63,181315
16310,0.000633,172.31.40.0-255,66,57473,63,181315
16311,0.000663,172.217.194.0-255,1484,58957,63,181315
16312,0.000677,172.31.40.0-255,66,59023,63,181315
16313,0.000706,172.217.194.0-255,5738,64761,63,181315
16314,0.000709,172.31.40.0-255,66,64827,63,181315
16315,0.00073,172.217.194.0-255,5020,69847,63,181315
16316,0.000733,172.31.40.0-255,66,69913,63,181315
16317,0.000746,172.31.40.0-255,66,69979,63,181315
16318,0.000795,172.31.40.0-255,66,70045,63,181315
16319,0.000826,172.217.194.0-255,4320,74365,63,181315
16320,0.00083,172.31.40.0-255,66,74431,63,181315
16321,0.000841,172.31.40.0-255,66,74497,63,181315
16322,0.000932,172.217.194.0-255,1484,75981,63,181315
16323,0.000947,172.217.194.0-255,2902,78883,63,181315
16324,0.000949,172.31.40.0-255,66,78949,63,181315
16325,0.000954,172.217.194.0-255,2902,81851,63,181315
16326,0.000957,172.31.40.0-255,66,81917,63,181315
16327,0.000988,172.217.194.0-255,2902,84819,63,181315
16328,0.000991,172.31.40.0-255,66,84885,63,181315
16329,0.001004,172.31.40.0-255,66,84951,63,181315
16330,0.001011,172.217.194.0-255,5738,90689,63,181315
16331,0.001013,172.31.40.0-255,66,90755,63,181315
16332,0.001042,172.217.194.0-255,5020,95775,63,181315
16333,0.001044,172.31.40.0-255,66,95841,63,181315
16334,0.001049,172.217.194.0-255,4320,100161,63,181315
16335,0.001052,172.31.40.0-255,66,100227,63,181315
16336,0.001086,172.31.40.0-255,66,100293,63,181315
16337,0.001119,172.31.40.0-255,66,100359,63,181315
16338,0.001124,172.217.194.0-255,3602,103961,63,181315
16339,0.001126,172.31.40.0-255,66,104027,63,181315
16340,0.001269,172.217.194.0-255,1484,105511,63,181315
16341,0.001292,172.217.194.0-255,2902,108413,63,181315
16342,0.001295,172.31.40.0-255,66,108479,63,181315
16343,0.001302,172.217.194.0-255,5738,114217,63,181315
16344,0.001305,172.31.40.0-255,66,114283,63,181315
16345,0.001336,172.217.194.0-255,7156,121439,63,181315
16346,0.001339,172.31.40.0-255,66,121505,63,181315
16347,0.001347,172.217.194.0-255,2902,124407,63,181315
16348,0.001349,172.31.40.0-255,66,124473,63,181315
16349,0.001394,172.31.40.0-255,66,124539,63,181315
16350,0.001398,172.217.194.0-255,2184,126723,63,181315
16351,0.0014,172.31.40.0-255,66,126789,63,181315
16352,0.001614,172.217.194.0-255,1484,128273,63,181315
16353,0.001622,172.217.194.0-255,2902,131175,63,181315
16354,0.001626,172.31.40.0-255,66,131241,63,181315
16355,0.001655,172.217.194.0-255,5738,136979,63,181315
16356,0.001658,172.31.40.0-255,66,137045,63,181315
16357,0.001665,172.217.194.0-255,5738,142783,63,181315
16358,0.001667,172.31.40.0-255,66,142849,63,181315
16359,0.001707,172.217.194.0-255,7156,150005,63,181315
16360,0.001711,172.31.40.0-255,66,150071,63,181315
16361,0.001717,172.217.194.0-255,4320,154391,63,181315
16362,0.001726,172.217.194.0-255,6438,160829,63,181315
16363,0.00173,172.31.40.0-255,66,160895,63,181315
16364,0.001736,172.31.40.0-255,66,160961,63,181315
16365,0.001772,172.217.194.0-255,1484,162445,63,181315
16366,0.001789,172.217.194.0-255,2902,165347,63,181315
16367,0.001793,172.31.40.0-255,66,165413,63,181315
16368,0.001798,172.217.194.0-255,4320,169733,63,181315
16369,0.001801,172.31.40.0-255,66,169799,63,181315
16370,0.001825,172.217.194.0-255,1484,171283,63,181315
16371,0.001838,172.31.40.0-255,66,171349,63,181315
16372,0.001868,172.217.194.0-255,1484,172833,63,181315
16373,0.001885,172.31.40.0-255,66,172899,63,181315
16374,0.001898,172.31.40.0-255,66,172965,63,181315
16375,0.001972,172.31.40.0-255,66,173031,63,181315
16376,0.00201,172.31.40.0-255,66,173097,63,181315
16377,0.002037,172.217.194.0-255,7156,180253,63,181315
16378,0.00204,172.31.40.0-255,66,180319,63,181315
16379,0.002083,172.31.40.0-255,66,180385,63,181315
16380,0.002086,172.217.194.0-255,105,180490,63,181315
16381,0.002088,172.217.194.0-255,129,180619,63,181315
16382,0.005012,172.31.40.0-255,105,180724,63,181315
16383,0.005052,172.31.40.0-255,105,180829,63,181315
16384,0.007343,172.217.194.0-255,66,180895,63,181315
16385,0.007354,172.217.194.0-255,66,180961,63,181315
16386,0.012609,172.31.40.0-255,90,181051,63,181315
16387,0.012622,172.31.40.0-255,66,181117,63,181315
16388,0.014947,172.217.194.0-255,66,181183,63,181315
16389,0.01496,172.217.194.0-255,66,181249,63,181315
16390,0.014968,172.31.40.0-255,66,181315,63,181315
16391,0.0,172.217.194.0-255,153,153,63,116584
16392,1.5e-05,172.31.40.0-255,66,219,63,116584
16393,2.2e-05,172.217.194.0-255,1484,1703,63,116584
16394,2.7e-05,172.31.40.0-255,66,1769,63,116584
16395,3.4e-05,172.217.194.0-255,2902,4671,63,116584
16396,4.6e-05,172.31.40.0-255,66,4737,63,116584
16397,5.4e-05,172.217.194.0-255,7156,11893,63,116584
16398,5.8e-05,172.31.40.0-255,66,11959,63,116584
16399,6.3e-05,172.217.194.0-255,2039,13998,63,116584
16400,6.6e-05,172.31.40.0-255,66,14064,63,116584
16401,0.000144,172.217.194.0-255,1484,15548,63,116584
16402,0.000146,172.31.40.0-255,66,15614,63,116584
16403,0.000165,172.217.194.0-255,2902,18516,63,116584
16404,0.000168,172.217.194.0-255,1484,20000,63,116584
16405,0.000173,172.31.40.0-255,66,20066,63,116584
16406,0.000176,172.31.40.0-255,66,20132,63,116584
16407,0.000206,172.217.194.0-255,4320,24452,63,116584
16408,0.000208,172.31.40.0-255,66,24518,63,116584
16409,0.000224,172.31.40.0-255,66,24584,63,116584
16410,0.000264,172.217.194.0-255,5379,29963,63,116584
16411,0.000267,172.31.40.0-255,66,30029,63,116584
16412,0.00027,172.217.194.0-255,1484,31513,63,116584
16413,0.000272,172.31.40.0-255,66,31579,63,116584
16414,0.000294,172.31.40.0-255,66,31645,63,116584
16415,0.000305,172.31.40.0-255,66,31711,63,116584
16416,0.000308,172.217.194.0-255,392,32103,63,116584
16417,0.00031,172.31.40.0-255,66,32169,63,116584
16418,0.000667,172.217.194.0-255,381,32550,63,116584
16419,0.000673,172.31.40.0-255,66,32616,63,116584
16420,0.00096,172.217.194.0-255,1484,34100,63,116584
16421,0.000982,172.217.194.0-255,2902,37002,63,116584
16422,0.000986,172.31.40.0-255,66,37068,63,116584
16423,0.000993,172.217.194.0-255,5738,42806,63,116584
16424,0.000996,172.31.40.0-255,66,42872,63,116584
16425,0.001038,172.31.40.0-255,66,42938,63,116584
16426,0.001049,172.31.40.0-255,66,43004,63,116584
16427,0.002014,172.217.194.0-255,1484,44488,63,116584
16428,0.002025,172.217.194.0-255,2902,47390,63,116584
16429,0.002029,172.31.40.0-255,66,47456,63,116584
16430,0.002037,172.217.194.0-255,5738,53194,63,116584
16431,0.00204,172.31.40.0-255,66,53260,63,116584
16432,0.002052,172.217.194.0-255,7156,60416,63,116584
16433,0.002055,172.31.40.0-255,66,60482,63,116584
16434,0.002061,172.217.194.0-255,4320,64802,63,116584
16435,0.002063,172.31.40.0-255,66,64868,63,116584
16436,0.002111,172.31.40.0-255,66,64934,63,116584
16437,0.002115,172.217.194.0-255,2184,67118,63,116584
16438,0.002117,172.31.40.0-255,66,67184,63,116584
16439,0.002122,172.217.194.0-255,2902,70086,63,116584
16440,0.002128,172.31.40.0-255,66,70152,63,116584
16441,0.004217,172.217.194.0-255,5738,75890,63,116584
16442,0.004223,172.31.40.0-255,66,75956,63,116584
16443,0.006345,172.217.194.0-255,5738,81694,63,116584
16444,0.00635,172.31.40.0-255,66,81760,63,116584
16445,0.008425,172.217.194.0-255,5738,87498,63,116584
16446,0.008431,172.31.40.0-255,66,87564,63,116584
16447,0.010534,172.217.194.0-255,5738,93302,63,116584
16448,0.010542,172.31.40.0-255,66,93368,63,116584
16449,0.012646,172.217.194.0-255,5738,99106,63,116584
16450,0.012654,172.31.40.0-255,66,99172,63,116584
16451,0.014747,172.217.194.0-255,5738,104910,63,116584
16452,0.014753,172.31.40.0-255,66,104976,63,116584
16453,0.016866,172.217.194.0-255,5738,110714,63,116584
16454,0.016874,172.31.40.0-255,66,110780,63,116584
16455,0.018988,172.217.194.0-255,5738,116518,63,116584
16456,0.018996,172.31.40.0-255,66,116584,63,116584
16457,0.0,172.217.194.0-255,155,155,63,234422
16458,2.2e-05,172.31.40.0-255,66,221,63,234422
16459,2.9e-05,172.217.194.0-255,1484,1705,63,234422
16460,3.3e-05,172.31.40.0-255,66,1771,63,234422
16461,4.8e-05,172.217.194.0-255,2902,4673,63,234422
16462,5.1e-05,172.31.40.0-255,66,4739,63,234422
16463,5.7e-05,172.217.194.0-255,5738,10477,63,234422
16464,6e-05,172.31.40.0-255,66,10543,63,234422
16465,8.3e-05,172.217.194.0-255,3555,14098,63,234422
16466,9e-05,172.31.40.0-255,66,14164,63,234422
16467,0.000123,172.217.194.0-255,1484,15648,63,234422
16468,0.000126,172.31.40.0-255,66,15714,63,234422
16469,0.00013,172.217.194.0-255,2902,18616,63,234422
16470,0.000132,172.31.40.0-255,66,18682,63,234422
16471,0.000151,172.217.194.0-255,4320,23002,63,234422
16472,0.000154,172.31.40.0-255,66,23068,63,234422
16473,0.000181,172.217.194.0-255,1484,24552,63,234422
16474,0.000183,172.31.40.0-255,66,24618,63,234422
16475,0.000196,172.217.194.0-255,6797,31415,63,234422
16476,0.000198,172.31.40.0-255,66,31481,63,234422
16477,0.000247,172.217.194.0-255,7156,38637,63,234422
16478,0.00025,172.31.40.0-255,66,38703,63,234422
16479,0.000285,172.217.194.0-255,7156,45859,63,234422
16480,0.000288,172.31.40.0-255,66,45925,63,234422
16481,0.000304,172.217.194.0-255,1484,47409,63,234422
16482,0.000306,172.31.40.0-255,66,47475,63,234422
16483,0.000309,172.217.194.0-255,1125,48600,63,234422
16484,0.000312,172.31.40.0-255,66,48666,63,234422
16485,0.000342,172.217.194.0-255,1484,50150,63,234422
16486,0.000344,172.31.40.0-255,66,50216,63,234422
16487,0.000349,172.217.194.0-255,2902,53118,63,234422
16488,0.00035,172.31.40.0-255,66,53184,63,234422
16489,0.000356,172.217.194.0-255,4320,57504,63,234422
16490,0.000382,172.31.40.0-255,66,57570,63,234422
16491,0.000385,172.217.194.0-255,1484,59054,63,234422
16492,0.000392,172.217.194.0-255,6797,65851,63,234422
16493,0.000408,172.31.40.0-255,66,65917,63,234422
16494,0.000424,172.217.194.0-255,363,66280,63,234422
16495,0.000444,172.217.194.0-255,379,66659,63,234422
16496,0.00051,172.217.194.0-255,1484,68143,63,234422
16497,0.000526,172.217.194.0-255,4320,72463,63,234422
16498,0.000533,172.217.194.0-255,5738,78201,63,234422
16499,0.000584,172.217.194.0-255,5379,83580,63,234422
16500,0.000587,172.217.194.0-255,1484,85064,63,234422
16501,0.000609,172.217.194.0-255,4320,89384,63,234422
16502,0.000642,172.217.194.0-255,2902,92286,63,234422
16503,0.000707,172.31.40.0-255,66,92352,63,234422
16504,0.001264,172.217.194.0-255,1484,93836,63,234422
16505,0.001283,172.217.194.0-255,2902,96738,63,234422
16506,0.001287,172.31.40.0-255,66,96804,63,234422
16507,0.001292,172.217.194.0-255,2902,99706,63,234422
16508,0.001311,172.217.194.0-255,1484,101190,63,234422
16509,0.001349,172.31.40.0-255,66,101256,63,234422
16510,0.001358,172.217.194.0-255,7156,108412,63,234422
16511,0.001363,172.31.40.0-255,66,108478,63,234422
16512,0.001433,172.217.194.0-255,1484,109962,63,234422
16513,0.001437,172.31.40.0-255,66,110028,63,234422
16514,0.001483,172.31.40.0-255,66,110094,63,234422
16515,0.001519,172.217.194.0-255,1484,111578,63,234422
16516,0.001537,172.217.194.0-255,2902,114480,63,234422
16517,0.001541,172.217.194.0-255,1484,115964,63,234422
16518,0.001557,172.217.194.0-255,4320,120284,63,234422
16519,0.001561,172.217.194.0-255,2902,123186,63,234422
16520,0.001564,172.31.40.0-255,66,123252,63,234422
16521,0.001571,172.31.40.0-255,66,123318,63,234422
16522,0.00164,172.31.40.0-255,66,123384,63,234422
16523,0.001648,172.217.194.0-255,7156,130540,63,234422
16524,0.001673,172.31.40.0-255,66,130606,63,234422
16525,0.001701,172.31.40.0-255,66,130672,63,234422
16526,0.001714,172.217.194.0-255,7156,137828,63,234422
16527,0.001728,172.31.40.0-255,66,137894,63,234422
16528,0.001793,172.217.194.0-255,2184,140078,63,234422
16529,0.00181,172.31.40.0-255,66,140144,63,234422
16530,0.001834,172.217.194.0-255,1484,141628,63,234422
16531,0.001838,172.217.194.0-255,1484,143112,63,234422
16532,0.001849,172.217.194.0-255,1484,144596,63,234422
16533,0.001853,172.31.40.0-255,66,144662,63,234422
16534,0.001885,172.217.194.0-255,5738,150400,63,234422
16535,0.00189,172.217.194.0-255,4320,154720,63,234422
16536,0.001897,172.31.40.0-255,66,154786,63,234422
16537,0.001927,172.217.194.0-255,1484,156270,63,234422
16538,0.001953,172.217.194.0-255,7156,163426,63,234422
16539,0.001965,172.31.40.0-255,66,163492,63,234422
16540,0.001974,172.217.194.0-255,2184,165676,63,234422
16541,0.001978,172.217.194.0-255,2902,168578,63,234422
16542,0.002001,172.217.194.0-255,7156,175734,63,234422
16543,0.002008,172.217.194.0-255,7156,182890,63,234422
16544,0.002011,172.31.40.0-255,66,182956,63,234422
16545,0.002045,172.217.194.0-255,1484,184440,63,234422
16546,0.002055,172.31.40.0-255,66,184506,63,234422
16547,0.002111,172.217.194.0-255,1484,185990,63,234422
16548,0.002117,172.31.40.0-255,66,186056,63,234422
16549,0.002129,172.217.194.0-255,7156,193212,63,234422
16550,0.002134,172.31.40.0-255,66,193278,63,234422
16551,0.002196,172.217.194.0-255,4320,197598,63,234422
16552,0.002214,172.31.40.0-255,66,197664,63,234422
16553,0.00224,172.217.194.0-255,3602,201266,63,234422
16554,0.00226,172.31.40.0-255,66,201332,63,234422
16555,0.002291,172.217.194.0-255,1484,202816,63,234422
16556,0.002295,172.217.194.0-255,1484,204300,63,234422
16557,0.002307,172.217.194.0-255,1484,205784,63,234422
16558,0.002314,172.217.194.0-255,5738,211522,63,234422
16559,0.00232,172.217.194.0-255,5738,217260,63,234422
16560,0.002326,172.31.40.0-255,66,217326,63,234422
16561,0.002356,172.217.194.0-255,7156,224482,63,234422
16562,0.002371,172.31.40.0-255,66,224548,63,234422
16563,0.002382,172.217.194.0-255,5738,230286,63,234422
16564,0.002391,172.217.194.0-255,3794,234080,63,234422
16565,0.002399,172.31.40.0-255,66,234146,63,234422
16566,0.002429,172.217.194.0-255,105,234251,63,234422
16567,0.017713,172.31.40.0-255,66,234317,63,234422
16568,0.017764,172.31.40.0-255,105,234422,63,234422
16569,0.0,74.125.24.0-255,153,153,63,164505
16570,1.6e-05,172.31.40.0-255,66,219,63,164505
16571,2.1e-05,74.125.24.0-255,1484,1703,63,164505
16572,2.6e-05,172.31.40.0-255,66,1769,63,164505
16573,3e-05,74.125.24.0-255,2902,4671,63,164505
16574,3.4e-05,172.31.40.0-255,66,4737,63,164505
16575,4.1e-05,74.125.24.0-255,5738,10475,63,164505
16576,4.4e-05,172.31.40.0-255,66,10541,63,164505
16577,7.1e-05,74.125.24.0-255,1484,12025,63,164505
16578,7.3e-05,172.31.40.0-255,66,12091,63,164505
16579,7.9e-05,74.125.24.0-255,4873,16964,63,164505
16580,8.2e-05,172.31.40.0-255,66,17030,63,164505
16581,8.6e-05,74.125.24.0-255,4320,21350,63,164505
16582,8.8e-05,172.31.40.0-255,66,21416,63,164505
16583,0.000114,172.31.40.0-255,66,21482,63,164505
16584,0.000158,74.125.24.0-255,1484,22966,63,164505
16585,0.00016,172.31.40.0-255,66,23032,63,164505
16586,0.000191,172.31.40.0-255,66,23098,63,164505
16587,0.000204,74.125.24.0-255,4320,27418,63,164505
16588,0.000206,172.31.40.0-255,66,27484,63,164505
16589,0.00022,74.125.24.0-255,2543,30027,63,164505
16590,0.000222,172.31.40.0-255,66,30093,63,164505
16591,0.000258,74.125.24.0-255,4320,34413,63,164505
16592,0.000261,172.31.40.0-255,66,34479,63,164505
16593,0.000265,74.125.24.0-255,2902,37381,63,164505
16594,0.000267,172.31.40.0-255,66,37447,63,164505
16595,0.000281,74.125.24.0-255,2902,40349,63,164505
16596,0.000283,172.31.40.0-255,66,40415,63,164505
16597,0.000325,74.125.24.0-255,7131,47546,63,164505
16598,0.000327,172.31.40.0-255,66,47612,63,164505
16599,0.000414,74.125.24.0-255,343,47955,63,164505
16600,0.000616,74.125.24.0-255,1484,49439,63,164505
16601,0.000621,172.31.40.0-255,66,49505,63,164505
16602,0.000626,74.125.24.0-255,2902,52407,63,164505
16603,0.000628,172.31.40.0-255,66,52473,63,164505
16604,0.000635,74.125.24.0-255,5738,58211,63,164505
16605,0.000637,172.31.40.0-255,66,58277,63,164505
16606,0.000663,74.125.24.0-255,5738,64015,63,164505
16607,0.000667,172.31.40.0-255,66,64081,63,164505
16608,0.000675,74.125.24.0-255,1125,65206,63,164505
16609,0.000942,74.125.24.0-255,1484,66690,63,164505
16610,0.000946,172.31.40.0-255,66,66756,63,164505
16611,0.000952,74.125.24.0-255,2902,69658,63,164505
16612,0.000954,172.31.40.0-255,66,69724,63,164505
16613,0.00096,74.125.24.0-255,5738,75462,63,164505
16614,0.000963,172.31.40.0-255,66,75528,63,164505
16615,0.000968,74.125.24.0-255,4320,79848,63,164505
16616,0.000971,172.31.40.0-255,66,79914,63,164505
16617,0.001023,74.125.24.0-255,2543,82457,63,164505
16618,0.001026,172.31.40.0-255,66,82523,63,164505
16619,0.001596,74.125.24.0-255,1484,84007,63,164505
16620,0.001617,74.125.24.0-255,2902,86909,63,164505
16621,0.001621,172.31.40.0-255,66,86975,63,164505
16622,0.001628,74.125.24.0-255,5738,92713,63,164505
16623,0.00163,172.31.40.0-255,66,92779,63,164505
16624,0.001634,74.125.24.0-255,2902,95681,63,164505
16625,0.001635,172.31.40.0-255,66,95747,63,164505
16626,0.00166,172.31.40.0-255,66,95813,63,164505
16627,0.001709,172.31.40.0-255,66,95879,63,164505
16628,0.001932,74.125.24.0-255,1484,97363,63,164505
16629,0.001939,74.125.24.0-255,2902,100265,63,164505
16630,0.001943,172.31.40.0-255,66,100331,63,164505
16631,0.001947,74.125.24.0-255,1484,101815,63,164505
16632,0.001967,74.125.24.0-255,4320,106135,63,164505
16633,0.001969,172.31.40.0-255,66,106201,63,164505
16634,0.002008,172.31.40.0-255,66,106267,63,164505
16635,0.002024,74.125.24.0-255,1484,107751,63,164505
16636,0.002064,172.31.40.0-255,66,107817,63,164505
16637,0.00222,74.125.24.0-255,1484,109301,63,164505
16638,0.002235,74.125.24.0-255,2902,112203,63,164505
16639,0.002238,172.31.40.0-255,66,112269,63,164505
16640,0.002255,74.125.24.0-255,5738,118007,63,164505
16641,0.002257,172.31.40.0-255,66,118073,63,164505
16642,0.00228,74.125.24.0-255,5738,123811,63,164505
16643,0.002283,172.31.40.0-255,66,123877,63,164505
16644,0.004534,74.125.24.0-255,5738,129615,63,164505
16645,0.004537,172.31.40.0-255,66,129681,63,164505
16646,0.006799,74.125.24.0-255,5738,135419,63,164505
16647,0.006806,172.31.40.0-255,66,135485,63,164505
16648,0.009081,74.125.24.0-255,5738,141223,63,164505
16649,0.009087,172.31.40.0-255,66,141289,63,164505
16650,0.011337,74.125.24.0-255,5738,147027,63,164505
16651,0.011346,172.31.40.0-255,66,147093,63,164505
16652,0.013632,74.125.24.0-255,5738,152831,63,164505
16653,0.013639,172.31.40.0-255,66,152897,63,164505
16654,0.015874,74.125.24.0-255,5738,158635,63,164505
16655,0.015882,172.31.40.0-255,66,158701,63,164505
16656,0.018131,74.125.24.0-255,5738,164439,63,164505
16657,0.01814,172.31.40.0-255,66,164505,63,164505
16658,0.0,74.125.200.0-255,150,150,63,208273
16659,2.3e-05,172.31.40.0-255,66,216,63,208273
16660,3e-05,74.125.200.0-255,1484,1700,63,208273
16661,3.4e-05,172.31.40.0-255,66,1766,63,208273
16662,4e-05,74.125.200.0-255,2902,4668,63,208273
16663,5.2e-05,172.31.40.0-255,66,4734,63,208273
16664,5.7e-05,74.125.200.0-255,2902,7636,63,208273
16665,6e-05,172.31.40.0-255,66,7702,63,208273
16666,0.000111,74.125.200.0-255,4320,12022,63,208273
16667,0.000118,172.31.40.0-255,66,12088,63,208273
16668,0.000123,74.125.200.0-255,3532,15620,63,208273
16669,0.000126,172.31.40.0-255,66,15686,63,208273
16670,0.000131,74.125.200.0-255,4320,20006,63,208273
16671,0.000133,172.31.40.0-255,66,20072,63,208273
16672,0.000161,74.125.200.0-255,5738,25810,63,208273
16673,0.000164,172.31.40.0-255,66,25876,63,208273
16674,0.000192,74.125.200.0-255,2902,28778,63,208273
16675,0.000195,172.31.40.0-255,66,28844,63,208273
16676,0.000219,74.125.200.0-255,2543,31387,63,208273
16677,0.000222,172.31.40.0-255,66,31453,63,208273
16678,0.000352,74.125.200.0-255,1484,32937,63,208273
16679,0.000357,172.31.40.0-255,66,33003,63,208273
16680,0.000361,74.125.200.0-255,1484,34487,63,208273
16681,0.000363,172.31.40.0-255,66,34553,63,208273
16682,0.000393,74.125.200.0-255,2902,37455,63,208273
16683,0.000397,172.31.40.0-255,66,37521,63,208273
16684,0.000423,74.125.200.0-255,5738,43259,63,208273
16685,0.000426,172.31.40.0-255,66,43325,63,208273
16686,0.00046,74.125.200.0-255,7156,50481,63,208273
16687,0.000463,172.31.40.0-255,66,50547,63,208273
16688,0.000469,74.125.200.0-255,5738,56285,63,208273
16689,0.000471,172.31.40.0-255,66,56351,63,208273
16690,0.000498,74.125.200.0-255,7156,63507,63,208273
16691,0.000501,172.31.40.0-255,66,63573,63,208273
16692,0.000527,74.125.200.0-255,2184,65757,63,208273
16693,0.00053,172.31.40.0-255,66,65823,63,208273
16694,0.000546,74.125.200.0-255,357,66180,63,208273
16695,0.000771,74.125.200.0-255,135,66315,63,208273
16696,0.001055,74.125.200.0-255,1484,67799,63,208273
16697,0.001061,172.31.40.0-255,66,67865,63,208273
16698,0.001067,74.125.200.0-255,2902,70767,63,208273
16699,0.00107,172.31.40.0-255,66,70833,63,208273
16700,0.001075,74.125.200.0-255,4320,75153,63,208273
16701,0.001082,172.31.40.0-255,66,75219,63,208273
16702,0.001088,74.125.200.0-255,5738,80957,63,208273
16703,0.001091,172.31.40.0-255,66,81023,63,208273
16704,0.001104,74.125.200.0-255,1484,82507,63,208273
16705,0.001145,172.31.40.0-255,66,82573,63,208273
16706,0.00115,74.125.200.0-255,4320,86893,63,208273
16707,0.001152,172.31.40.0-255,66,86959,63,208273
16708,0.001177,74.125.200.0-255,3602,90561,63,208273
16709,0.00118,172.31.40.0-255,66,90627,63,208273
16710,0.001484,74.125.200.0-255,1484,92111,63,208273
16711,0.001504,74.125.200.0-255,2902,95013,63,208273
16712,0.001508,172.31.40.0-255,66,95079,63,208273
16713,0.001514,74.125.200.0-255,4320,99399,63,208273
16714,0.001517,172.31.40.0-255,66,99465,63,208273
16715,0.001535,74.125.200.0-255,1484,100949,63,208273
16716,0.001544,74.125.200.0-255,2902,103851,63,208273
16717,0.001547,172.31.40.0-255,66,103917,63,208273
16718,0.001552,74.125.200.0-255,4320,108237,63,208273
16719,0.001554,172.31.40.0-255,66,108303,63,208273
16720,0.001558,74.125.200.0-255,2902,111205,63,208273
16721,0.00156,172.31.40.0-255,66,111271,63,208273
16722,0.001605,74.125.200.0-255,5738,117009,63,208273
16723,0.001609,172.31.40.0-255,66,117075,63,208273
16724,0.001619,172.31.40.0-255,66,117141,63,208273
16725,0.00184,74.125.200.0-255,1484,118625,63,208273
16726,0.001859,74.125.200.0-255,2902,121527,63,208273
16727,0.001863,172.31.40.0-255,66,121593,63,208273
16728,0.001869,74.125.200.0-255,4320,125913,63,208273
16729,0.001871,172.31.40.0-255,66,125979,63,208273
16730,0.001895,74.125.200.0-255,1484,127463,63,208273
16731,0.001899,74.125.200.0-255,2902,130365,63,208273
16732,0.001902,172.31.40.0-255,66,130431,63,208273
16733,0.001907,74.125.200.0-255,4320,134751,63,208273
16734,0.001909,172.31.40.0-255,66,134817,63,208273
16735,0.001947,172.31.40.0-255,66,134883,63,208273
16736,0.001951,74.125.200.0-255,2902,137785,63,208273
16737,0.001953,172.31.40.0-255,66,137851,63,208273
16738,0.002002,172.31.40.0-255,66,137917,63,208273
16739,0.002029,74.125.200.0-255,2184,140101,63,208273
16740,0.002033,172.31.40.0-255,66,140167,63,208273
16741,0.002052,172.31.40.0-255,66,140233,63,208273
16742,0.002058,74.125.200.0-255,4320,144553,63,208273
16743,0.00206,172.31.40.0-255,66,144619,63,208273
16744,0.002121,74.125.200.0-255,6438,151057,63,208273
16745,0.002124,172.31.40.0-255,66,151123,63,208273
16746,0.002146,74.125.200.0-255,1484,152607,63,208273
16747,0.002158,74.125.200.0-255,1484,154091,63,208273
16748,0.00216,172.31.40.0-255,66,154157,63,208273
16749,0.002183,74.125.200.0-255,1484,155641,63,208273
16750,0.002187,74.125.200.0-255,2902,158543,63,208273
16751,0.00219,172.31.40.0-255,66,158609,63,208273
16752,0.002193,74.125.200.0-255,1484,160093,63,208273
16753,0.002216,74.125.200.0-255,2902,162995,63,208273
16754,0.002218,172.31.40.0-255,66,163061,63,208273
16755,0.002251,172.31.40.0-255,66,163127,63,208273
16756,0.002255,74.125.200.0-255,2902,166029,63,208273
16757,0.002257,172.31.40.0-255,66,166095,63,208273
16758,0.002293,74.125.200.0-255,1484,167579,63,208273
16759,0.002313,172.31.40.0-255,66,167645,63,208273
16760,0.00461,74.125.200.0-255,5738,173383,63,208273
16761,0.004617,172.31.40.0-255,66,173449,63,208273
16762,0.00692,74.125.200.0-255,5738,179187,63,208273
16763,0.006927,172.31.40.0-255,66,179253,63,208273
16764,0.009237,74.125.200.0-255,5738,184991,63,208273
16765,0.009242,172.31.40.0-255,66,185057,63,208273
16766,0.011568,74.125.200.0-255,5738,190795,63,208273
16767,0.011586,172.31.40.0-255,66,190861,63,208273
16768,0.013895,74.125.200.0-255,5738,196599,63,208273
16769,0.013911,172.31.40.0-255,66,196665,63,208273
16770,0.016236,74.125.200.0-255,5738,202403,63,208273
16771,0.016249,172.31.40.0-255,66,202469,63,208273
16772,0.018562,74.125.200.0-255,5738,208207,63,208273
16773,0.018573,172.31.40.0-255,66,208273,63,208273
16774,0.0,172.217.194.0-255,153,153,63,166110
16775,2.2e-05,172.31.40.0-255,66,219,63,166110
16776,3e-05,172.217.194.0-255,1484,1703,63,166110
16777,3.5e-05,172.31.40.0-255,66,1769,63,166110
16778,4.1e-05,172.217.194.0-255,2902,4671,63,166110
16779,4.4e-05,172.31.40.0-255,66,4737,63,166110
16780,5.1e-05,172.217.194.0-255,7156,11893,63,166110
16781,5.4e-05,172.31.40.0-255,66,11959,63,166110
16782,5.8e-05,172.217.194.0-255,1484,13443,63,166110
16783,6e-05,172.31.40.0-255,66,13509,63,166110
16784,0.000102,172.31.40.0-255,66,13575,63,166110
16785,0.000125,172.217.194.0-255,4817,18392,63,166110
16786,0.000128,172.31.40.0-255,66,18458,63,166110
16787,0.000133,172.217.194.0-255,2543,21001,63,166110
16788,0.000135,172.31.40.0-255,66,21067,63,166110
16789,0.000138,172.217.194.0-255,1484,22551,63,166110
16790,0.00014,172.31.40.0-255,66,22617,63,166110
16791,0.000145,172.217.194.0-255,2902,25519,63,166110
16792,0.000147,172.31.40.0-255,66,25585,63,166110
16793,0.000153,172.217.194.0-255,4320,29905,63,166110
16794,0.000155,172.31.40.0-255,66,29971,63,166110
16795,0.000187,172.217.194.0-255,1484,31455,63,166110
16796,0.00019,172.31.40.0-255,66,31521,63,166110
16797,0.000205,172.31.40.0-255,66,31587,63,166110
16798,0.000221,172.217.194.0-255,1484,33071,63,166110
16799,0.000224,172.31.40.0-255,66,33137,63,166110
16800,0.000252,172.31.40.0-255,66,33203,63,166110
16801,0.00028,172.217.194.0-255,1484,34687,63,166110
16802,0.000282,172.31.40.0-255,66,34753,63,166110
16803,0.000288,172.217.194.0-255,2902,37655,63,166110
16804,0.00029,172.31.40.0-255,66,37721,63,166110
16805,0.000304,172.217.194.0-255,4320,42041,63,166110
16806,0.000307,172.31.40.0-255,66,42107,63,166110
16807,0.000332,172.217.194.0-255,1484,43591,63,166110
16808,0.000349,172.31.40.0-255,66,43657,63,166110
16809,0.000379,172.217.194.0-255,2902,46559,63,166110
16810,0.000381,172.31.40.0-255,66,46625,63,166110
16811,0.000399,172.217.194.0-255,6797,53422,63,166110
16812,0.000402,172.31.40.0-255,66,53488,63,166110
16813,0.000426,172.217.194.0-255,2902,56390,63,166110
16814,0.000428,172.31.40.0-255,66,56456,63,166110
16815,0.000435,172.217.194.0-255,4320,60776,63,166110
16816,0.000437,172.31.40.0-255,66,60842,63,166110
16817,0.000442,172.217.194.0-255,2902,63744,63,166110
16818,0.000446,172.31.40.0-255,66,63810,63,166110
16819,0.000468,172.217.194.0-255,5738,69548,63,166110
16820,0.000471,172.31.40.0-255,66,69614,63,166110
16821,0.000494,172.31.40.0-255,66,69680,63,166110
16822,0.000514,172.31.40.0-255,66,69746,63,166110
16823,0.000535,172.217.194.0-255,5738,75484,63,166110
16824,0.000538,172.31.40.0-255,66,75550,63,166110
16825,0.000558,172.217.194.0-255,7156,82706,63,166110
16826,0.000561,172.31.40.0-255,66,82772,63,166110
16827,0.000576,172.31.40.0-255,66,82838,63,166110
16828,0.00058,172.217.194.0-255,2902,85740,63,166110
16829,0.000582,172.31.40.0-255,66,85806,63,166110
16830,0.0006,172.217.194.0-255,3602,89408,63,166110
16831,0.000603,172.31.40.0-255,66,89474,63,166110
16832,0.000652,172.217.194.0-255,1484,90958,63,166110
16833,0.000666,172.217.194.0-255,2902,93860,63,166110
16834,0.000668,172.31.40.0-255,66,93926,63,166110
16835,0.000673,172.217.194.0-255,2902,96828,63,166110
16836,0.000675,172.31.40.0-255,66,96894,63,166110
16837,0.000691,172.217.194.0-255,2902,99796,63,166110
16838,0.000697,172.217.194.0-255,5738,105534,63,166110
16839,0.0007,172.217.194.0-255,1484,107018,63,166110
16840,0.00074,172.217.194.0-255,5020,112038,63,166110
16841,0.000788,172.217.194.0-255,4320,116358,63,166110
16842,0.000815,172.217.194.0-255,1484,117842,63,166110
16843,0.000854,172.217.194.0-255,5020,122862,63,166110
16844,0.00091,172.31.40.0-255,66,122928,63,166110
16845,0.000923,172.217.194.0-255,1484,124412,63,166110
16846,0.00093,172.217.194.0-255,2902,127314,63,166110
16847,0.000945,172.217.194.0-255,5738,133052,63,166110
16848,0.000993,172.31.40.0-255,66,133118,63,166110
16849,0.001011,172.31.40.0-255,66,133184,63,166110
16850,0.001016,172.217.194.0-255,2184,135368,63,166110
16851,0.001042,172.31.40.0-255,66,135434,63,166110
16852,0.001141,172.217.194.0-255,1484,136918,63,166110
16853,0.001145,172.217.194.0-255,1484,138402,63,166110
16854,0.001158,172.217.194.0-255,1484,139886,63,166110
16855,0.001165,172.217.194.0-255,5738,145624,63,166110
16856,0.001181,172.217.194.0-255,4320,149944,63,166110
16857,0.001198,172.31.40.0-255,66,150010,63,166110
16858,0.001204,172.217.194.0-255,4320,154330,63,166110
16859,0.001216,172.31.40.0-255,66,154396,63,166110
16860,0.001222,172.217.194.0-255,4320,158716,63,166110
16861,0.00124,172.31.40.0-255,66,158782,63,166110
16862,0.001266,172.31.40.0-255,66,158848,63,166110
16863,0.001297,172.31.40.0-255,66,158914,63,166110
16864,0.00134,172.217.194.0-255,4320,163234,63,166110
16865,0.001356,172.31.40.0-255,66,163300,63,166110
16866,0.001377,172.31.40.0-255,66,163366,63,166110
16867,0.001472,172.31.40.0-255,66,163432,63,166110
16868,0.001483,172.217.194.0-255,2336,165768,63,166110
16869,0.001485,172.217.194.0-255,105,165873,63,166110
16870,0.001511,172.31.40.0-255,66,165939,63,166110
16871,0.008812,172.31.40.0-255,105,166044,63,166110
16872,0.010812,172.217.194.0-255,66,166110,63,166110
16873,0.0,74.125.68.0-255,153,153,63,212269
16874,2.5e-05,172.31.40.0-255,66,219,63,212269
16875,3.2e-05,74.125.68.0-255,1484,1703,63,212269
16876,3.7e-05,172.31.40.0-255,66,1769,63,212269
16877,4.4e-05,74.125.68.0-255,2902,4671,63,212269
16878,4.8e-05,172.31.40.0-255,66,4737,63,212269
16879,5.1e-05,74.125.68.0-255,1484,6221,63,212269
16880,5.4e-05,172.31.40.0-255,66,6287,63,212269
16881,5.9e-05,74.125.68.0-255,2902,9189,63,212269
16882,6.3e-05,172.31.40.0-255,66,9255,63,212269
16883,8.6e-05,74.125.68.0-255,4983,14238,63,212269
16884,8.9e-05,172.31.40.0-255,66,14304,63,212269
16885,0.000126,74.125.68.0-255,1484,15788,63,212269
16886,0.000128,172.31.40.0-255,66,15854,63,212269
16887,0.000163,74.125.68.0-255,1484,17338,63,212269
16888,0.000165,172.31.40.0-255,66,17404,63,212269
16889,0.000186,74.125.68.0-255,1484,18888,63,212269
16890,0.000188,172.31.40.0-255,66,18954,63,212269
16891,0.000196,74.125.68.0-255,5738,24692,63,212269
16892,0.000198,172.31.40.0-255,66,24758,63,212269
16893,0.000206,74.125.68.0-255,6797,31555,63,212269
16894,0.000208,172.31.40.0-255,66,31621,63,212269
16895,0.000223,74.125.68.0-255,1484,33105,63,212269
16896,0.000226,172.31.40.0-255,66,33171,63,212269
16897,0.000245,74.125.68.0-255,5738,38909,63,212269
16898,0.000248,172.31.40.0-255,66,38975,63,212269
16899,0.000264,74.125.68.0-255,4320,43295,63,212269
16900,0.000266,172.31.40.0-255,66,43361,63,212269
16901,0.00029,74.125.68.0-255,4320,47681,63,212269
16902,0.000292,172.31.40.0-255,66,47747,63,212269
16903,0.000295,74.125.68.0-255,1125,48872,63,212269
16904,0.000297,172.31.40.0-255,66,48938,63,212269
16905,0.000466,74.125.68.0-255,1484,50422,63,212269
16906,0.000487,74.125.68.0-255,2902,53324,63,212269
16907,0.000491,172.31.40.0-255,66,53390,63,212269
16908,0.000494,74.125.68.0-255,1484,54874,63,212269
16909,0.000519,74.125.68.0-255,5738,60612,63,212269
16910,0.000522,172.31.40.0-255,66,60678,63,212269
16911,0.00054,74.125.68.0-255,5959,66637,63,212269
16912,0.000542,172.31.40.0-255,66,66703,63,212269
16913,0.000687,74.125.68.0-255,1484,68187,63,212269
16914,0.000694,74.125.68.0-255,2902,71089,63,212269
16915,0.000698,172.31.40.0-255,66,71155,63,212269
16916,0.000727,74.125.68.0-255,5738,76893,63,212269
16917,0.00073,172.31.40.0-255,66,76959,63,212269
16918,0.000735,74.125.68.0-255,2902,79861,63,212269
16919,0.000737,172.31.40.0-255,66,79927,63,212269
16920,0.000752,74.125.68.0-255,3412,83339,63,212269
16921,0.000755,172.31.40.0-255,66,83405,63,212269
16922,0.000789,74.125.68.0-255,1484,84889,63,212269
16923,0.000794,74.125.68.0-255,2902,87791,63,212269
16924,0.000797,172.31.40.0-255,66,87857,63,212269
16925,0.000823,74.125.68.0-255,5738,93595,63,212269
16926,0.000826,172.31.40.0-255,66,93661,63,212269
16927,0.000829,74.125.68.0-255,1484,95145,63,212269
16928,0.000851,74.125.68.0-255,5379,100524,63,212269
16929,0.000854,172.31.40.0-255,66,100590,63,212269
16930,0.00172,74.125.68.0-255,1484,102074,63,212269
16931,0.001732,74.125.68.0-255,2902,104976,63,212269
16932,0.001737,172.31.40.0-255,66,105042,63,212269
16933,0.001742,74.125.68.0-255,1484,106526,63,212269
16934,0.001766,74.125.68.0-255,4320,110846,63,212269
16935,0.001769,172.31.40.0-255,66,110912,63,212269
16936,0.001773,74.125.68.0-255,2902,113814,63,212269
16937,0.001775,172.31.40.0-255,66,113880,63,212269
16938,0.001794,74.125.68.0-255,3947,117827,63,212269
16939,0.001796,172.31.40.0-255,66,117893,63,212269
16940,0.001804,74.125.68.0-255,7156,125049,63,212269
16941,0.001806,172.31.40.0-255,66,125115,63,212269
16942,0.001832,74.125.68.0-255,7156,132271,63,212269
16943,0.001835,172.31.40.0-255,66,132337,63,212269
16944,0.001883,74.125.68.0-255,1533,133870,63,212269
16945,0.001886,172.31.40.0-255,66,133936,63,212269
16946,0.001892,74.125.68.0-255,2902,136838,63,212269
16947,0.001894,172.31.40.0-255,66,136904,63,212269
16948,0.001914,74.125.68.0-255,5738,142642,63,212269
16949,0.001917,172.31.40.0-255,66,142708,63,212269
16950,0.00192,74.125.68.0-255,1484,144192,63,212269
16951,0.001942,74.125.68.0-255,2902,147094,63,212269
16952,0.001945,172.31.40.0-255,66,147160,63,212269
16953,0.00198,74.125.68.0-255,3961,151121,63,212269
16954,0.001984,172.31.40.0-255,66,151187,63,212269
16955,0.002304,74.125.68.0-255,1484,152671,63,212269
16956,0.002336,74.125.68.0-255,1484,154155,63,212269
16957,0.00234,172.31.40.0-255,66,154221,63,212269
16958,0.002358,74.125.68.0-255,1484,155705,63,212269
16959,0.00237,74.125.68.0-255,1484,157189,63,212269
16960,0.002372,172.31.40.0-255,66,157255,63,212269
16961,0.002391,74.125.68.0-255,2902,160157,63,212269
16962,0.002393,172.31.40.0-255,66,160223,63,212269
16963,0.002399,74.125.68.0-255,4320,164543,63,212269
16964,0.002401,172.31.40.0-255,66,164609,63,212269
16965,0.00243,74.125.68.0-255,3961,168570,63,212269
16966,0.002433,172.31.40.0-255,66,168636,63,212269
16967,0.002444,172.31.40.0-255,66,168702,63,212269
16968,0.00245,74.125.68.0-255,4320,173022,63,212269
16969,0.002453,172.31.40.0-255,66,173088,63,212269
16970,0.002496,74.125.68.0-255,3961,177049,63,212269
16971,0.002499,172.31.40.0-255,66,177115,63,212269
16972,0.004931,74.125.68.0-255,1484,178599,63,212269
16973,0.004989,74.125.68.0-255,1484,180083,63,212269
16974,0.004994,172.31.40.0-255,66,180149,63,212269
16975,0.005012,74.125.68.0-255,2902,183051,63,212269
16976,0.005014,172.31.40.0-255,66,183117,63,212269
16977,0.007487,74.125.68.0-255,2902,186019,63,212269
16978,0.007494,172.31.40.0-255,66,186085,63,212269
16979,0.007509,74.125.68.0-255,2902,188987,63,212269
16980,0.007512,172.31.40.0-255,66,189053,63,212269
16981,0.010068,74.125.68.0-255,5738,194791,63,212269
16982,0.010082,172.31.40.0-255,66,194857,63,212269
16983,0.012595,74.125.68.0-255,5738,200595,63,212269
16984,0.012613,172.31.40.0-255,66,200661,63,212269
16985,0.015124,74.125.68.0-255,5738,206399,63,212269
16986,0.015137,172.31.40.0-255,66,206465,63,212269
16987,0.017662,74.125.68.0-255,5738,212203,63,212269
16988,0.01768,172.31.40.0-255,66,212269,63,212269
16989,0.0,216.58.221.0-255,296,296,63,113385
16990,2e-05,172.31.40.0-255,66,362,63,113385
16991,2.6e-05,216.58.221.0-255,1484,1846,63,113385
16992,3e-05,172.31.40.0-255,66,1912,63,113385
16993,3.8e-05,216.58.221.0-255,4320,6232,63,113385
16994,4.1e-05,172.31.40.0-255,66,6298,63,113385
16995,8.2e-05,172.31.40.0-255,66,6364,63,113385
16996,0.000137,216.58.221.0-255,7156,13520,63,113385
16997,0.00014,172.31.40.0-255,66,13586,63,113385
16998,0.000155,216.58.221.0-255,1484,15070,63,113385
16999,0.000157,172.31.40.0-255,66,15136,63,113385
17000,0.000232,216.58.221.0-255,5738,20874,63,113385
17001,0.000236,172.31.40.0-255,66,20940,63,113385
17002,0.000254,216.58.221.0-255,2543,23483,63,113385
17003,0.000257,172.31.40.0-255,66,23549,63,113385
17004,0.000353,216.58.221.0-255,2902,26451,63,113385
17005,0.000356,172.31.40.0-255,66,26517,63,113385
17006,0.000369,172.31.40.0-255,66,26583,63,113385
17007,0.000382,216.58.221.0-255,4320,30903,63,113385
17008,0.000384,172.31.40.0-255,66,30969,63,113385
17009,0.000489,216.58.221.0-255,4320,35289,63,113385
17010,0.000494,172.31.40.0-255,66,35355,63,113385
17011,0.000522,172.31.40.0-255,66,35421,63,113385
17012,0.000648,216.58.221.0-255,2851,38272,63,113385
17013,0.000653,172.31.40.0-255,66,38338,63,113385
17014,0.001052,216.58.221.0-255,115,38453,63,113385
17015,0.001057,172.31.40.0-255,66,38519,63,113385
17016,0.001219,216.58.221.0-255,1484,40003,63,113385
17017,0.001224,172.31.40.0-255,66,40069,63,113385
17018,0.001232,216.58.221.0-255,2902,42971,63,113385
17019,0.001234,172.31.40.0-255,66,43037,63,113385
17020,0.001246,216.58.221.0-255,1484,44521,63,113385
17021,0.001267,216.58.221.0-255,4320,48841,63,113385
17022,0.001269,172.31.40.0-255,66,48907,63,113385
17023,0.001309,216.58.221.0-255,1484,50391,63,113385
17024,0.00133,216.58.221.0-255,2902,53293,63,113385
17025,0.001333,172.31.40.0-255,66,53359,63,113385
17026,0.001366,216.58.221.0-255,7156,60515,63,113385
17027,0.001386,216.58.221.0-255,5379,65894,63,113385
17028,0.001499,216.58.221.0-255,6797,72691,63,113385
17029,0.004957,172.31.40.0-255,66,72757,63,113385
17030,0.006864,216.58.221.0-255,5738,78495,63,113385
17031,0.006872,172.31.40.0-255,66,78561,63,113385
17032,0.008771,216.58.221.0-255,5738,84299,63,113385
17033,0.008779,172.31.40.0-255,66,84365,63,113385
17034,0.010685,216.58.221.0-255,5738,90103,63,113385
17035,0.010693,172.31.40.0-255,66,90169,63,113385
17036,0.012588,216.58.221.0-255,5738,95907,63,113385
17037,0.012595,172.31.40.0-255,66,95973,63,113385
17038,0.014496,216.58.221.0-255,5738,101711,63,113385
17039,0.014505,172.31.40.0-255,66,101777,63,113385
17040,0.016404,216.58.221.0-255,5738,107515,63,113385
17041,0.016411,172.31.40.0-255,66,107581,63,113385
17042,0.01833,216.58.221.0-255,5738,113319,63,113385
17043,0.018339,172.31.40.0-255,66,113385,63,113385
17044,0.0,172.217.194.0-255,66,66,63,66
17045,0.0,74.125.24.0-255,146,146,63,180589
17046,2.4e-05,172.31.40.0-255,66,212,63,180589
17047,3.2e-05,74.125.24.0-255,1484,1696,63,180589
17048,3.6e-05,172.31.40.0-255,66,1762,63,180589
17049,4.2e-05,74.125.24.0-255,2902,4664,63,180589
17050,5.6e-05,172.31.40.0-255,66,4730,63,180589
17051,5.9e-05,74.125.24.0-255,1484,6214,63,180589
17052,6.2e-05,172.31.40.0-255,66,6280,63,180589
17053,8.1e-05,74.125.24.0-255,5738,12018,63,180589
17054,8.9e-05,172.31.40.0-255,66,12084,63,180589
17055,0.000111,74.125.24.0-255,1968,14052,63,180589
17056,0.000113,172.31.40.0-255,66,14118,63,180589
17057,0.000156,74.125.24.0-255,1484,15602,63,180589
17058,0.000159,172.31.40.0-255,66,15668,63,180589
17059,0.000163,74.125.24.0-255,2902,18570,63,180589
17060,0.000166,172.31.40.0-255,66,18636,63,180589
17061,0.000192,74.125.24.0-255,5738,24374,63,180589
17062,0.000195,172.31.40.0-255,66,24440,63,180589
17063,0.000201,74.125.24.0-255,4320,28760,63,180589
17064,0.000203,172.31.40.0-255,66,28826,63,180589
17065,0.000232,74.125.24.0-255,2543,31369,63,180589
17066,0.000235,172.31.40.0-255,66,31435,63,180589
17067,0.000339,74.125.24.0-255,1484,32919,63,180589
17068,0.000343,172.31.40.0-255,66,32985,63,180589
17069,0.000348,74.125.24.0-255,2902,35887,63,180589
17070,0.000351,172.31.40.0-255,66,35953,63,180589
17071,0.000381,74.125.24.0-255,5738,41691,63,180589
17072,0.000384,172.31.40.0-255,66,41757,63,180589
17073,0.000411,74.125.24.0-255,5738,47495,63,180589
17074,0.000414,172.31.40.0-255,66,47561,63,180589
17075,0.000448,74.125.24.0-255,2543,50104,63,180589
17076,0.000451,172.31.40.0-255,66,50170,63,180589
17077,0.000462,172.31.40.0-255,66,50236,63,180589
17078,0.000474,74.125.24.0-255,7072,57308,63,180589
17079,0.000477,172.31.40.0-255,66,57374,63,180589
17080,0.000524,74.125.24.0-255,381,57755,63,180589
17081,0.000557,74.125.24.0-255,1484,59239,63,180589
17082,0.00056,172.31.40.0-255,66,59305,63,180589
17083,0.000583,74.125.24.0-255,4320,63625,63,180589
17084,0.000586,172.31.40.0-255,66,63691,63,180589
17085,0.000598,74.125.24.0-255,7156,70847,63,180589
17086,0.000601,172.31.40.0-255,66,70913,63,180589
17087,0.000625,74.125.24.0-255,2902,73815,63,180589
17088,0.000628,172.31.40.0-255,66,73881,63,180589
17089,0.000635,74.125.24.0-255,1125,75006,63,180589
17090,0.00067,172.31.40.0-255,66,75072,63,180589
17091,0.000682,74.125.24.0-255,4320,79392,63,180589
17092,0.000689,172.31.40.0-255,66,79458,63,180589
17093,0.000717,74.125.24.0-255,3961,83419,63,180589
17094,0.000719,172.31.40.0-255,66,83485,63,180589
17095,0.000822,74.125.24.0-255,1484,84969,63,180589
17096,0.000844,74.125.24.0-255,2902,87871,63,180589
17097,0.000849,172.31.40.0-255,66,87937,63,180589
17098,0.000854,74.125.24.0-255,4320,92257,63,180589
17099,0.000857,172.31.40.0-255,66,92323,63,180589
17100,0.000892,74.125.24.0-255,1484,93807,63,180589
17101,0.000904,172.31.40.0-255,66,93873,63,180589
17102,0.000962,172.31.40.0-255,66,93939,63,180589
17103,0.000989,74.125.24.0-255,5888,99827,63,180589
17104,0.000992,74.125.24.0-255,1484,101311,63,180589
17105,0.000995,74.125.24.0-255,1484,102795,63,180589
17106,0.000999,172.31.40.0-255,66,102861,63,180589
17107,0.001008,172.31.40.0-255,66,102927,63,180589
17108,0.001011,74.125.24.0-255,1484,104411,63,180589
17109,0.001017,74.125.24.0-255,5738,110149,63,180589
17110,0.001024,172.31.40.0-255,66,110215,63,180589
17111,0.001028,74.125.24.0-255,1484,111699,63,180589
17112,0.001038,172.31.40.0-255,66,111765,63,180589
17113,0.001088,74.125.24.0-255,5738,117503,63,180589
17114,0.001092,172.31.40.0-255,66,117569,63,180589
17115,0.001117,172.31.40.0-255,66,117635,63,180589
17116,0.0018,74.125.24.0-255,1484,119119,63,180589
17117,0.001806,74.125.24.0-255,2902,122021,63,180589
17118,0.001811,74.125.24.0-255,5738,127759,63,180589
17119,0.001817,172.31.40.0-255,66,127825,63,180589
17120,0.001821,172.31.40.0-255,66,127891,63,180589
17121,0.001857,74.125.24.0-255,4320,132211,63,180589
17122,0.001861,172.31.40.0-255,66,132277,63,180589
17123,0.001885,74.125.24.0-255,2902,135179,63,180589
17124,0.001888,172.31.40.0-255,66,135245,63,180589
17125,0.001899,172.31.40.0-255,66,135311,63,180589
17126,0.001956,172.31.40.0-255,66,135377,63,180589
17127,0.004049,74.125.24.0-255,5738,141115,63,180589
17128,0.004057,172.31.40.0-255,66,141181,63,180589
17129,0.006107,74.125.24.0-255,4320,145501,63,180589
17130,0.00611,172.31.40.0-255,66,145567,63,180589
17131,0.006124,74.125.24.0-255,1484,147051,63,180589
17132,0.008139,74.125.24.0-255,4320,151371,63,180589
17133,0.008144,172.31.40.0-255,66,151437,63,180589
17134,0.010225,74.125.24.0-255,5738,157175,63,180589
17135,0.010233,172.31.40.0-255,66,157241,63,180589
17136,0.012287,74.125.24.0-255,5738,162979,63,180589
17137,0.012295,172.31.40.0-255,66,163045,63,180589
17138,0.014339,74.125.24.0-255,5738,168783,63,180589
17139,0.014349,172.31.40.0-255,66,168849,63,180589
17140,0.016431,74.125.24.0-255,5738,174587,63,180589
17141,0.016439,172.31.40.0-255,66,174653,63,180589
17142,0.018479,74.125.24.0-255,2902,177555,63,180589
17143,0.018486,172.31.40.0-255,66,177621,63,180589
17144,0.018518,74.125.24.0-255,2902,180523,63,180589
17145,0.018521,172.31.40.0-255,66,180589,63,180589
17146,0.0,172.217.194.0-255,153,153,63,169230
17147,3.4e-05,172.31.40.0-255,66,219,63,169230
17148,4.1e-05,172.217.194.0-255,1484,1703,63,169230
17149,4.5e-05,172.31.40.0-255,66,1769,63,169230
17150,5e-05,172.217.194.0-255,2902,4671,63,169230
17151,5.3e-05,172.31.40.0-255,66,4737,63,169230
17152,5.9e-05,172.217.194.0-255,5738,10475,63,169230
17153,6.3e-05,172.31.40.0-255,66,10541,63,169230
17154,6.8e-05,172.217.194.0-255,4320,14861,63,169230
17155,7.1e-05,172.31.40.0-255,66,14927,63,169230
17156,0.000115,172.31.40.0-255,66,14993,63,169230
17157,0.000121,172.217.194.0-255,6797,21790,63,169230
17158,0.000123,172.31.40.0-255,66,21856,63,169230
17159,0.000301,172.217.194.0-255,1484,23340,63,169230
17160,0.000305,172.31.40.0-255,66,23406,63,169230
17161,0.000311,172.217.194.0-255,2902,26308,63,169230
17162,0.000314,172.31.40.0-255,66,26374,63,169230
17163,0.000317,172.217.194.0-255,1484,27858,63,169230
17164,0.000319,172.31.40.0-255,66,27924,63,169230
17165,0.000345,172.217.194.0-255,4320,32244,63,169230
17166,0.000348,172.31.40.0-255,66,32310,63,169230
17167,0.000355,172.217.194.0-255,6797,39107,63,169230
17168,0.000357,172.31.40.0-255,66,39173,63,169230
17169,0.00036,172.217.194.0-255,1484,40657,63,169230
17170,0.000362,172.31.40.0-255,66,40723,63,169230
17171,0.00038,172.217.194.0-255,5738,46461,63,169230
17172,0.000384,172.31.40.0-255,66,46527,63,169230
17173,0.00041,172.31.40.0-255,66,46593,63,169230
17174,0.000514,172.217.194.0-255,98,46691,63,169230
17175,0.000517,172.31.40.0-255,66,46757,63,169230
17176,0.00054,172.217.194.0-255,366,47123,63,169230
17177,0.000693,172.217.194.0-255,1484,48607,63,169230
17178,0.000696,172.31.40.0-255,66,48673,63,169230
17179,0.000701,172.217.194.0-255,2902,51575,63,169230
17180,0.000703,172.31.40.0-255,66,51641,63,169230
17181,0.00072,172.217.194.0-255,5738,57379,63,169230
17182,0.000722,172.31.40.0-255,66,57445,63,169230
17183,0.000755,172.217.194.0-255,6249,63694,63,169230
17184,0.000757,172.31.40.0-255,66,63760,63,169230
17185,0.000878,172.217.194.0-255,1484,65244,63,169230
17186,0.000891,172.217.194.0-255,2902,68146,63,169230
17187,0.000894,172.31.40.0-255,66,68212,63,169230
17188,0.000897,172.217.194.0-255,1484,69696,63,169230
17189,0.000917,172.217.194.0-255,4320,74016,63,169230
17190,0.00092,172.31.40.0-255,66,74082,63,169230
17191,0.000923,172.217.194.0-255,1484,75566,63,169230
17192,0.000965,172.31.40.0-255,66,75632,63,169230
17193,0.000976,172.31.40.0-255,66,75698,63,169230
17194,0.00161,172.217.194.0-255,1484,77182,63,169230
17195,0.00162,172.217.194.0-255,2902,80084,63,169230
17196,0.001624,172.31.40.0-255,66,80150,63,169230
17197,0.00163,172.217.194.0-255,5738,85888,63,169230
17198,0.001632,172.31.40.0-255,66,85954,63,169230
17199,0.001638,172.217.194.0-255,4320,90274,63,169230
17200,0.00164,172.31.40.0-255,66,90340,63,169230
17201,0.001676,172.31.40.0-255,66,90406,63,169230
17202,0.001687,172.31.40.0-255,66,90472,63,169230
17203,0.001753,172.217.194.0-255,1484,91956,63,169230
17204,0.001759,172.217.194.0-255,2902,94858,63,169230
17205,0.001761,172.31.40.0-255,66,94924,63,169230
17206,0.00182,172.217.194.0-255,5738,100662,63,169230
17207,0.001823,172.31.40.0-255,66,100728,63,169230
17208,0.001834,172.31.40.0-255,66,100794,63,169230
17209,0.001843,172.31.40.0-255,66,100860,63,169230
17210,0.001894,172.31.40.0-255,66,100926,63,169230
17211,0.001921,172.217.194.0-255,2902,103828,63,169230
17212,0.001924,172.31.40.0-255,66,103894,63,169230
17213,0.001927,172.31.40.0-255,66,103960,63,169230
17214,0.001947,172.31.40.0-255,66,104026,63,169230
17215,0.001952,172.217.194.0-255,4320,108346,63,169230
17216,0.001953,172.31.40.0-255,66,108412,63,169230
17217,0.001989,172.31.40.0-255,66,108478,63,169230
17218,0.002,172.31.40.0-255,66,108544,63,169230
17219,0.002016,172.217.194.0-255,2902,111446,63,169230
17220,0.002018,172.31.40.0-255,66,111512,63,169230
17221,0.00202,172.217.194.0-255,766,112278,63,169230
17222,0.002035,172.217.194.0-255,1484,113762,63,169230
17223,0.002037,172.31.40.0-255,66,113828,63,169230
17224,0.002055,172.217.194.0-255,4320,118148,63,169230
17225,0.002057,172.31.40.0-255,66,118214,63,169230
17226,0.002079,172.217.194.0-255,4320,122534,63,169230
17227,0.002081,172.31.40.0-255,66,122600,63,169230
17228,0.004098,172.217.194.0-255,1484,124084,63,169230
17229,0.004125,172.217.194.0-255,1484,125568,63,169230
17230,0.004129,172.31.40.0-255,66,125634,63,169230
17231,0.004141,172.217.194.0-255,2902,128536,63,169230
17232,0.004143,172.31.40.0-255,66,128602,63,169230
17233,0.006168,172.217.194.0-255,5738,134340,63,169230
17234,0.006175,172.31.40.0-255,66,134406,63,169230
17235,0.008248,172.217.194.0-255,5738,140144,63,169230
17236,0.008256,172.31.40.0-255,66,140210,63,169230
17237,0.010339,172.217.194.0-255,5738,145948,63,169230
17238,0.010348,172.31.40.0-255,66,146014,63,169230
17239,0.012436,172.217.194.0-255,5738,151752,63,169230
17240,0.012448,172.31.40.0-255,66,151818,63,169230
17241,0.014502,172.217.194.0-255,5738,157556,63,169230
17242,0.014511,172.31.40.0-255,66,157622,63,169230
17243,0.016569,172.217.194.0-255,5738,163360,63,169230
17244,0.016578,172.31.40.0-255,66,163426,63,169230
17245,0.018657,172.217.194.0-255,5738,169164,63,169230
17246,0.018665,172.31.40.0-255,66,169230,63,169230
17247,0.0,172.217.194.0-255,152,152,63,163298
17248,3.4e-05,172.31.40.0-255,66,218,63,163298
17249,4.1e-05,172.217.194.0-255,1484,1702,63,163298
17250,4.5e-05,172.31.40.0-255,66,1768,63,163298
17251,5e-05,172.217.194.0-255,2902,4670,63,163298
17252,6.1e-05,172.31.40.0-255,66,4736,63,163298
17253,6.8e-05,172.217.194.0-255,7156,11892,63,163298
17254,7.1e-05,172.31.40.0-255,66,11958,63,163298
17255,7.5e-05,172.217.194.0-255,2067,14025,63,163298
17256,7.7e-05,172.31.40.0-255,66,14091,63,163298
17257,0.000129,172.31.40.0-255,66,14157,63,163298
17258,0.000135,172.217.194.0-255,5379,19536,63,163298
17259,0.000137,172.31.40.0-255,66,19602,63,163298
17260,0.00017,172.217.194.0-255,1484,21086,63,163298
17261,0.000173,172.31.40.0-255,66,21152,63,163298
17262,0.00018,172.217.194.0-255,2902,24054,63,163298
17263,0.000182,172.31.40.0-255,66,24120,63,163298
17264,0.000189,172.217.194.0-255,5738,29858,63,163298
17265,0.000192,172.31.40.0-255,66,29924,63,163298
17266,0.000239,172.31.40.0-255,66,29990,63,163298
17267,0.000251,172.31.40.0-255,66,30056,63,163298
17268,0.000322,172.217.194.0-255,121,30177,63,163298
17269,0.000325,172.31.40.0-255,66,30243,63,163298
17270,0.00042,172.217.194.0-255,1484,31727,63,163298
17271,0.000423,172.31.40.0-255,66,31793,63,163298
17272,0.000429,172.217.194.0-255,2902,34695,63,163298
17273,0.000431,172.31.40.0-255,66,34761,63,163298
17274,0.000456,172.217.194.0-255,5738,40499,63,163298
17275,0.000459,172.31.40.0-255,66,40565,63,163298
17276,0.0005,172.31.40.0-255,66,40631,63,163298
17277,0.000525,172.217.194.0-255,4320,44951,63,163298
17278,0.000532,172.31.40.0-255,66,45017,63,163298
17279,0.000558,172.217.194.0-255,5695,50712,63,163298
17280,0.000571,172.31.40.0-255,66,50778,63,163298
17281,0.00065,172.217.194.0-255,1484,52262,63,163298
17282,0.000657,172.217.194.0-255,2902,55164,63,163298
17283,0.000665,172.31.40.0-255,66,55230,63,163298
17284,0.000675,172.217.194.0-255,5738,60968,63,163298
17285,0.000678,172.217.194.0-255,1484,62452,63,163298
17286,0.000683,172.31.40.0-255,66,62518,63,163298
17287,0.000723,172.217.194.0-255,2902,65420,63,163298
17288,0.000724,172.31.40.0-255,66,65486,63,163298
17289,0.000738,172.31.40.0-255,66,65552,63,163298
17290,0.000753,172.217.194.0-255,6438,71990,63,163298
17291,0.000767,172.31.40.0-255,66,72056,63,163298
17292,0.000805,172.31.40.0-255,66,72122,63,163298
17293,0.000819,172.31.40.0-255,66,72188,63,163298
17294,0.00086,172.31.40.0-255,66,72254,63,163298
17295,0.000873,172.217.194.0-255,3602,75856,63,163298
17296,0.000888,172.31.40.0-255,66,75922,63,163298
17297,0.000926,172.217.194.0-255,1484,77406,63,163298
17298,0.000931,172.217.194.0-255,2902,80308,63,163298
17299,0.000938,172.31.40.0-255,66,80374,63,163298
17300,0.000959,172.217.194.0-255,5738,86112,63,163298
17301,0.000962,172.217.194.0-255,1484,87596,63,163298
17302,0.000963,172.31.40.0-255,66,87662,63,163298
17303,0.000992,172.217.194.0-255,4320,91982,63,163298
17304,0.000997,172.31.40.0-255,66,92048,63,163298
17305,0.001013,172.217.194.0-255,4320,96368,63,163298
17306,0.001024,172.31.40.0-255,66,96434,63,163298
17307,0.001029,172.217.194.0-255,2184,98618,63,163298
17308,0.001032,172.31.40.0-255,66,98684,63,163298
17309,0.001064,172.217.194.0-255,2902,101586,63,163298
17310,0.001069,172.217.194.0-255,2902,104488,63,163298
17311,0.00107,172.31.40.0-255,66,104554,63,163298
17312,0.001075,172.31.40.0-255,66,104620,63,163298
17313,0.001106,172.217.194.0-255,4320,108940,63,163298
17314,0.001112,172.31.40.0-255,66,109006,63,163298
17315,0.001126,172.31.40.0-255,66,109072,63,163298
17316,0.001162,172.31.40.0-255,66,109138,63,163298
17317,0.00134,172.217.194.0-255,1484,110622,63,163298
17318,0.001346,172.217.194.0-255,2902,113524,63,163298
17319,0.001349,172.31.40.0-255,66,113590,63,163298
17320,0.001353,172.217.194.0-255,1484,115074,63,163298
17321,0.001382,172.217.194.0-255,4320,119394,63,163298
17322,0.001389,172.31.40.0-255,66,119460,63,163298
17323,0.001404,172.31.40.0-255,66,119526,63,163298
17324,0.001418,172.217.194.0-255,766,120292,63,163298
17325,0.001427,172.31.40.0-255,66,120358,63,163298
17326,0.001511,172.217.194.0-255,1484,121842,63,163298
17327,0.00153,172.217.194.0-255,2902,124744,63,163298
17328,0.001534,172.31.40.0-255,66,124810,63,163298
17329,0.00154,172.217.194.0-255,4320,129130,63,163298
17330,0.001557,172.31.40.0-255,66,129196,63,163298
17331,0.001563,172.217.194.0-255,1484,130680,63,163298
17332,0.001566,172.217.194.0-255,1484,132164,63,163298
17333,0.001572,172.31.40.0-255,66,132230,63,163298
17334,0.001589,172.217.194.0-255,2902,135132,63,163298
17335,0.001595,172.31.40.0-255,66,135198,63,163298
17336,0.001631,172.31.40.0-255,66,135264,63,163298
17337,0.001644,172.31.40.0-255,66,135330,63,163298
17338,0.001707,172.217.194.0-255,1484,136814,63,163298
17339,0.001713,172.217.194.0-255,2902,139716,63,163298
17340,0.001718,172.31.40.0-255,66,139782,63,163298
17341,0.00173,172.217.194.0-255,5738,145520,63,163298
17342,0.001734,172.31.40.0-255,66,145586,63,163298
17343,0.001748,172.217.194.0-255,1484,147070,63,163298
17344,0.001792,172.31.40.0-255,66,147136,63,163298
17345,0.001806,172.31.40.0-255,66,147202,63,163298
17346,0.001831,172.217.194.0-255,5020,152222,63,163298
17347,0.001835,172.31.40.0-255,66,152288,63,163298
17348,0.001842,172.217.194.0-255,5738,158026,63,163298
17349,0.001847,172.217.194.0-255,4320,162346,63,163298
17350,0.001852,172.31.40.0-255,66,162412,63,163298
17351,0.001898,172.31.40.0-255,66,162478,63,163298
17352,0.001915,172.31.40.0-255,66,162544,63,163298
17353,0.001919,172.31.40.0-255,66,162610,63,163298
17354,0.001973,172.217.194.0-255,97,162707,63,163298
17355,0.001975,172.217.194.0-255,105,162812,63,163298
17356,0.001976,172.31.40.0-255,66,162878,63,163298
17357,0.009571,172.31.40.0-255,66,162944,63,163298
17358,0.009604,172.31.40.0-255,105,163049,63,163298
17359,0.011697,172.217.194.0-255,105,163154,63,163298
17360,0.011712,172.31.40.0-255,78,163232,63,163298
17361,0.011813,172.217.194.0-255,66,163298,63,163298
17362,0.0,74.125.130.0-255,295,295,63,168730
17363,2e-05,172.31.40.0-255,66,361,63,168730
17364,2.7e-05,74.125.130.0-255,1484,1845,63,168730
17365,3.1e-05,172.31.40.0-255,66,1911,63,168730
17366,3.8e-05,74.125.130.0-255,4320,6231,63,168730
17367,4.2e-05,172.31.40.0-255,66,6297,63,168730
17368,7.5e-05,74.125.130.0-255,5738,12035,63,168730
17369,7.8e-05,172.31.40.0-255,66,12101,63,168730
17370,0.000101,74.125.130.0-255,1812,13913,63,168730
17371,0.000103,172.31.40.0-255,66,13979,63,168730
17372,0.000254,74.125.130.0-255,1484,15463,63,168730
17373,0.000259,172.31.40.0-255,66,15529,63,168730
17374,0.000264,74.125.130.0-255,2902,18431,63,168730
17375,0.000267,172.31.40.0-255,66,18497,63,168730
17376,0.000297,74.125.130.0-255,5738,24235,63,168730
17377,0.000299,172.31.40.0-255,66,24301,63,168730
17378,0.000304,74.125.130.0-255,2902,27203,63,168730
17379,0.000306,172.31.40.0-255,66,27269,63,168730
17380,0.000311,74.125.130.0-255,3961,31230,63,168730
17381,0.000313,172.31.40.0-255,66,31296,63,168730
17382,0.000355,172.31.40.0-255,66,31362,63,168730
17383,0.000357,74.125.130.0-255,1484,32846,63,168730
17384,0.00036,172.31.40.0-255,66,32912,63,168730
17385,0.000384,172.31.40.0-255,66,32978,63,168730
17386,0.00043,172.31.40.0-255,66,33044,63,168730
17387,0.000433,74.125.130.0-255,1076,34120,63,168730
17388,0.000435,172.31.40.0-255,66,34186,63,168730
17389,0.000469,74.125.130.0-255,367,34553,63,168730
17390,0.000472,172.31.40.0-255,66,34619,63,168730
17391,0.000598,74.125.130.0-255,1484,36103,63,168730
17392,0.000606,74.125.130.0-255,2902,39005,63,168730
17393,0.000609,172.31.40.0-255,66,39071,63,168730
17394,0.000629,74.125.130.0-255,4320,43391,63,168730
17395,0.000633,172.31.40.0-255,66,43457,63,168730
17396,0.000641,74.125.130.0-255,1484,44941,63,168730
17397,0.000646,74.125.130.0-255,2902,47843,63,168730
17398,0.000654,172.31.40.0-255,66,47909,63,168730
17399,0.00066,74.125.130.0-255,4320,52229,63,168730
17400,0.000662,172.31.40.0-255,66,52295,63,168730
17401,0.000679,74.125.130.0-255,5738,58033,63,168730
17402,0.000682,172.31.40.0-255,66,58099,63,168730
17403,0.000714,74.125.130.0-255,2902,61001,63,168730
17404,0.000717,172.31.40.0-255,66,61067,63,168730
17405,0.000723,74.125.130.0-255,7156,68223,63,168730
17406,0.000726,172.31.40.0-255,66,68289,63,168730
17407,0.000729,74.125.130.0-255,766,69055,63,168730
17408,0.00133,74.125.130.0-255,1484,70539,63,168730
17409,0.001335,172.31.40.0-255,66,70605,63,168730
17410,0.00134,74.125.130.0-255,1484,72089,63,168730
17411,0.001358,74.125.130.0-255,1484,73573,63,168730
17412,0.00136,172.31.40.0-255,66,73639,63,168730
17413,0.001366,74.125.130.0-255,4320,77959,63,168730
17414,0.001368,172.31.40.0-255,66,78025,63,168730
17415,0.001392,172.31.40.0-255,66,78091,63,168730
17416,0.001396,74.125.130.0-255,1484,79575,63,168730
17417,0.001424,74.125.130.0-255,4320,83895,63,168730
17418,0.001427,172.31.40.0-255,66,83961,63,168730
17419,0.001434,74.125.130.0-255,7156,91117,63,168730
17420,0.001436,172.31.40.0-255,66,91183,63,168730
17421,0.001458,74.125.130.0-255,3602,94785,63,168730
17422,0.001461,172.31.40.0-255,66,94851,63,168730
17423,0.001911,74.125.130.0-255,1484,96335,63,168730
17424,0.001921,74.125.130.0-255,2902,99237,63,168730
17425,0.001925,172.31.40.0-255,66,99303,63,168730
17426,0.001944,74.125.130.0-255,1484,100787,63,168730
17427,0.001959,74.125.130.0-255,4320,105107,63,168730
17428,0.001961,172.31.40.0-255,66,105173,63,168730
17429,0.001964,74.125.130.0-255,1484,106657,63,168730
17430,0.001979,74.125.130.0-255,2902,109559,63,168730
17431,0.001981,172.31.40.0-255,66,109625,63,168730
17432,0.002012,74.125.130.0-255,5738,115363,63,168730
17433,0.002015,172.31.40.0-255,66,115429,63,168730
17434,0.00202,74.125.130.0-255,2902,118331,63,168730
17435,0.002022,172.31.40.0-255,66,118397,63,168730
17436,0.002028,74.125.130.0-255,4320,122717,63,168730
17437,0.00203,172.31.40.0-255,66,122783,63,168730
17438,0.002066,74.125.130.0-255,6438,129221,63,168730
17439,0.002069,172.31.40.0-255,66,129287,63,168730
17440,0.004326,74.125.130.0-255,5738,135025,63,168730
17441,0.004334,172.31.40.0-255,66,135091,63,168730
17442,0.006581,74.125.130.0-255,4320,139411,63,168730
17443,0.006585,172.31.40.0-255,66,139477,63,168730
17444,0.006603,74.125.130.0-255,1484,140961,63,168730
17445,0.008097,172.31.40.0-255,101,141062,63,168730
17446,0.008827,74.125.130.0-255,4320,145382,63,168730
17447,0.008834,172.31.40.0-255,66,145448,63,168730
17448,0.010341,74.125.130.0-255,1484,146932,63,168730
17449,0.011095,74.125.130.0-255,4320,151252,63,168730
17450,0.011101,172.31.40.0-255,66,151318,63,168730
17451,0.013358,74.125.130.0-255,5738,157056,63,168730
17452,0.013371,172.31.40.0-255,66,157122,63,168730
17453,0.015632,74.125.130.0-255,5738,162860,63,168730
17454,0.015643,172.31.40.0-255,66,162926,63,168730
17455,0.01792,74.125.130.0-255,5738,168664,63,168730
17456,0.01793,172.31.40.0-255,66,168730,63,168730
17457,0.0,172.217.194.0-255,147,147,63,65479
17458,2.3e-05,172.31.40.0-255,66,213,63,65479
17459,3.1e-05,172.217.194.0-255,1484,1697,63,65479
17460,3.5e-05,172.31.40.0-255,66,1763,63,65479
17461,5e-05,172.217.194.0-255,2902,4665,63,65479
17462,5.4e-05,172.31.40.0-255,66,4731,63,65479
17463,5.9e-05,172.217.194.0-255,2902,7633,63,65479
17464,6.2e-05,172.31.40.0-255,66,7699,63,65479
17465,9.8e-05,172.217.194.0-255,4320,12019,63,65479
17466,0.000101,172.31.40.0-255,66,12085,63,65479
17467,0.000106,172.217.194.0-255,1982,14067,63,65479
17468,0.000108,172.31.40.0-255,66,14133,63,65479
17469,0.000134,172.217.194.0-255,5738,19871,63,65479
17470,0.000136,172.31.40.0-255,66,19937,63,65479
17471,0.000172,172.217.194.0-255,7156,27093,63,65479
17472,0.000175,172.31.40.0-255,66,27159,63,65479
17473,0.000179,172.217.194.0-255,2902,30061,63,65479
17474,0.000182,172.31.40.0-255,66,30127,63,65479
17475,0.000221,172.31.40.0-255,66,30193,63,65479
17476,0.000257,172.31.40.0-255,66,30259,63,65479
17477,0.003851,172.217.194.0-255,1484,31743,63,65479
17478,0.003862,172.31.40.0-255,66,31809,63,65479
17479,0.003873,172.217.194.0-255,2902,34711,63,65479
17480,0.003882,172.31.40.0-255,66,34777,63,65479
17481,0.003886,172.217.194.0-255,1484,36261,63,65479
17482,0.003888,172.31.40.0-255,66,36327,63,65479
17483,0.006456,172.217.194.0-255,2902,39229,63,65479
17484,0.006464,172.31.40.0-255,66,39295,63,65479
17485,0.006494,172.217.194.0-255,2902,42197,63,65479
17486,0.006497,172.31.40.0-255,66,42263,63,65479
17487,0.009061,172.217.194.0-255,5738,48001,63,65479
17488,0.01159,172.31.40.0-255,66,48067,63,65479
17489,0.014166,172.217.194.0-255,5738,53805,63,65479
17490,0.01418,172.31.40.0-255,66,53871,63,65479
17491,0.016774,172.217.194.0-255,5738,59609,63,65479
17492,0.016788,172.31.40.0-255,66,59675,63,65479
17493,0.019363,172.217.194.0-255,5738,65413,63,65479
17494,0.019374,172.31.40.0-255,66,65479,63,65479
17495,0.0,74.125.68.0-255,153,153,63,214578
17496,2.1e-05,172.31.40.0-255,66,219,63,214578
17497,2.8e-05,74.125.68.0-255,1484,1703,63,214578
17498,3.3e-05,172.31.40.0-255,66,1769,63,214578
17499,3.6e-05,74.125.68.0-255,1484,3253,63,214578
17500,4e-05,172.31.40.0-255,66,3319,63,214578
17501,4.6e-05,74.125.68.0-255,2902,6221,63,214578
17502,4.9e-05,172.31.40.0-255,66,6287,63,214578
17503,5.5e-05,74.125.68.0-255,5738,12025,63,214578
17504,5.8e-05,172.31.40.0-255,66,12091,63,214578
17505,8.1e-05,74.125.68.0-255,5738,17829,63,214578
17506,8.4e-05,172.31.40.0-255,66,17895,63,214578
17507,0.000105,74.125.68.0-255,621,18516,63,214578
17508,0.000107,172.31.40.0-255,66,18582,63,214578
17509,0.000115,74.125.68.0-255,7156,25738,63,214578
17510,0.000118,172.31.40.0-255,66,25804,63,214578
17511,0.000162,74.125.68.0-255,5379,31183,63,214578
17512,0.000165,172.31.40.0-255,66,31249,63,214578
17513,0.0008,74.125.68.0-255,1484,32733,63,214578
17514,0.000807,172.31.40.0-255,66,32799,63,214578
17515,0.000815,74.125.68.0-255,2902,35701,63,214578
17516,0.000818,172.31.40.0-255,66,35767,63,214578
17517,0.000842,74.125.68.0-255,4320,40087,63,214578
17518,0.000845,172.31.40.0-255,66,40153,63,214578
17519,0.000861,74.125.68.0-255,1484,41637,63,214578
17520,0.000863,172.31.40.0-255,66,41703,63,214578
17521,0.000866,74.125.68.0-255,1484,43187,63,214578
17522,0.000868,172.31.40.0-255,66,43253,63,214578
17523,0.000892,74.125.68.0-255,5379,48632,63,214578
17524,0.000894,172.31.40.0-255,66,48698,63,214578
17525,0.000897,74.125.68.0-255,1484,50182,63,214578
17526,0.000899,172.31.40.0-255,66,50248,63,214578
17527,0.000903,74.125.68.0-255,2902,53150,63,214578
17528,0.000942,74.125.68.0-255,5738,58888,63,214578
17529,0.000946,74.125.68.0-255,1484,60372,63,214578
17530,0.00095,74.125.68.0-255,2902,63274,63,214578
17531,0.000998,74.125.68.0-255,2812,66086,63,214578
17532,0.001064,74.125.68.0-255,131,66217,63,214578
17533,0.001269,74.125.68.0-255,1484,67701,63,214578
17534,0.001277,74.125.68.0-255,2902,70603,63,214578
17535,0.0013,74.125.68.0-255,2902,73505,63,214578
17536,0.001317,74.125.68.0-255,4320,77825,63,214578
17537,0.00136,74.125.68.0-255,2902,80727,63,214578
17538,0.001373,74.125.68.0-255,4320,85047,63,214578
17539,0.001394,74.125.68.0-255,5738,90785,63,214578
17540,0.001407,74.125.68.0-255,2902,93687,63,214578
17541,0.00141,74.125.68.0-255,1484,95171,63,214578
17542,0.001448,74.125.68.0-255,2902,98073,63,214578
17543,0.001462,74.125.68.0-255,2184,100257,63,214578
17544,0.001507,74.125.68.0-255,1484,101741,63,214578
17545,0.001522,74.125.68.0-255,2902,104643,63,214578
17546,0.001547,74.125.68.0-255,2902,107545,63,214578
17547,0.001568,74.125.68.0-255,2902,110447,63,214578
17548,0.001581,74.125.68.0-255,2902,113349,63,214578
17549,0.001597,74.125.68.0-255,3667,117016,63,214578
17550,0.001608,74.125.68.0-255,1484,118500,63,214578
17551,0.001611,74.125.68.0-255,1484,119984,63,214578
17552,0.001627,74.125.68.0-255,1484,121468,63,214578
17553,0.00163,74.125.68.0-255,1484,122952,63,214578
17554,0.00165,74.125.68.0-255,4320,127272,63,214578
17555,0.001653,74.125.68.0-255,1484,128756,63,214578
17556,0.001666,74.125.68.0-255,2902,131658,63,214578
17557,0.001694,74.125.68.0-255,4320,135978,63,214578
17558,0.00171,74.125.68.0-255,1484,137462,63,214578
17559,0.001714,74.125.68.0-255,2902,140364,63,214578
17560,0.001733,74.125.68.0-255,4320,144684,63,214578
17561,0.001752,74.125.68.0-255,2902,147586,63,214578
17562,0.001767,74.125.68.0-255,3602,151188,63,214578
17563,0.001852,74.125.68.0-255,1484,152672,63,214578
17564,0.001867,74.125.68.0-255,2902,155574,63,214578
17565,0.001892,74.125.68.0-255,1484,157058,63,214578
17566,0.001907,74.125.68.0-255,4320,161378,63,214578
17567,0.00191,74.125.68.0-255,1484,162862,63,214578
17568,0.001915,74.125.68.0-255,2902,165764,63,214578
17569,0.001934,74.125.68.0-255,1484,167248,63,214578
17570,0.001949,74.125.68.0-255,4320,171568,63,214578
17571,0.001953,74.125.68.0-255,2902,174470,63,214578
17572,0.001965,74.125.68.0-255,2902,177372,63,214578
17573,0.001976,74.125.68.0-255,1484,178856,63,214578
17574,0.002009,74.125.68.0-255,4320,183176,63,214578
17575,0.002026,74.125.68.0-255,2184,185360,63,214578
17576,0.002293,74.125.68.0-255,1484,186844,63,214578
17577,0.002296,74.125.68.0-255,1484,188328,63,214578
17578,0.002314,74.125.68.0-255,1484,189812,63,214578
17579,0.002317,74.125.68.0-255,1484,191296,63,214578
17580,0.006488,172.31.40.0-255,66,191362,63,214578
17581,0.008802,74.125.68.0-255,5738,197100,63,214578
17582,0.008809,172.31.40.0-255,66,197166,63,214578
17583,0.011092,74.125.68.0-255,5738,202904,63,214578
17584,0.014369,172.31.40.0-255,66,202970,63,214578
17585,0.016687,74.125.68.0-255,5738,208708,63,214578
17586,0.016699,172.31.40.0-255,66,208774,63,214578
17587,0.019001,74.125.68.0-255,5738,214512,63,214578
17588,0.019016,172.31.40.0-255,66,214578,63,214578
17589,0.0,172.217.26.0-255,153,153,63,115718
17590,1.4e-05,172.31.40.0-255,66,219,63,115718
17591,2.1e-05,172.217.26.0-255,1484,1703,63,115718
17592,2.5e-05,172.31.40.0-255,66,1769,63,115718
17593,3e-05,172.217.26.0-255,2902,4671,63,115718
17594,4.2e-05,172.31.40.0-255,66,4737,63,115718
17595,5e-05,172.217.26.0-255,7156,11893,63,115718
17596,5.4e-05,172.31.40.0-255,66,11959,63,115718
17597,5.9e-05,172.217.26.0-255,2032,13991,63,115718
17598,6.1e-05,172.31.40.0-255,66,14057,63,115718
17599,0.00106,172.217.26.0-255,1484,15541,63,115718
17600,0.001067,172.31.40.0-255,66,15607,63,115718
17601,0.001075,172.217.26.0-255,2902,18509,63,115718
17602,0.001078,172.31.40.0-255,66,18575,63,115718
17603,0.00109,172.217.26.0-255,5738,24313,63,115718
17604,0.001092,172.31.40.0-255,66,24379,63,115718
17605,0.0011,172.217.26.0-255,6797,31176,63,115718
17606,0.001117,172.31.40.0-255,66,31242,63,115718
17607,0.001163,172.217.26.0-255,1484,32726,63,115718
17608,0.001166,172.31.40.0-255,66,32792,63,115718
17609,0.001171,172.217.26.0-255,2902,35694,63,115718
17610,0.001173,172.31.40.0-255,66,35760,63,115718
17611,0.001208,172.217.26.0-255,5738,41498,63,115718
17612,0.001212,172.31.40.0-255,66,41564,63,115718
17613,0.001219,172.217.26.0-255,6797,48361,63,115718
17614,0.001221,172.31.40.0-255,66,48427,63,115718
17615,0.001262,172.217.26.0-255,1484,49911,63,115718
17616,0.001265,172.31.40.0-255,66,49977,63,115718
17617,0.00127,172.217.26.0-255,2902,52879,63,115718
17618,0.001272,172.31.40.0-255,66,52945,63,115718
17619,0.001279,172.217.26.0-255,5738,58683,63,115718
17620,0.001281,172.31.40.0-255,66,58749,63,115718
17621,0.001284,172.217.26.0-255,1484,60233,63,115718
17622,0.001326,172.217.26.0-255,5379,65612,63,115718
17623,0.00133,172.31.40.0-255,66,65678,63,115718
17624,0.001332,172.217.26.0-255,393,66071,63,115718
17625,0.001783,172.31.40.0-255,66,66137,63,115718
17626,0.00185,172.217.26.0-255,115,66252,63,115718
17627,0.003219,172.217.26.0-255,2902,69154,63,115718
17628,0.003226,172.31.40.0-255,66,69220,63,115718
17629,0.004253,172.217.26.0-255,1484,70704,63,115718
17630,0.005113,172.217.26.0-255,4320,75024,63,115718
17631,0.005116,172.31.40.0-255,66,75090,63,115718
17632,0.007021,172.217.26.0-255,5738,80828,63,115718
17633,0.007026,172.31.40.0-255,66,80894,63,115718
17634,0.008918,172.217.26.0-255,5738,86632,63,115718
17635,0.008924,172.31.40.0-255,66,86698,63,115718
17636,0.010818,172.217.26.0-255,5738,92436,63,115718
17637,0.010826,172.31.40.0-255,66,92502,63,115718
17638,0.012721,172.217.26.0-255,5738,98240,63,115718
17639,0.012728,172.31.40.0-255,66,98306,63,115718
17640,0.014625,172.217.26.0-255,5738,104044,63,115718
17641,0.014632,172.31.40.0-255,66,104110,63,115718
17642,0.016531,172.217.26.0-255,5738,109848,63,115718
17643,0.016537,172.31.40.0-255,66,109914,63,115718
17644,0.018428,172.217.26.0-255,5738,115652,63,115718
17645,0.018434,172.31.40.0-255,66,115718,63,115718
17646,0.0,172.217.194.0-255,155,155,63,206448
17647,2.2e-05,172.31.40.0-255,66,221,63,206448
17648,2.9e-05,172.217.194.0-255,1484,1705,63,206448
17649,3.5e-05,172.31.40.0-255,66,1771,63,206448
17650,4.1e-05,172.217.194.0-255,2902,4673,63,206448
17651,4.5e-05,172.31.40.0-255,66,4739,63,206448
17652,5.2e-05,172.217.194.0-255,5738,10477,63,206448
17653,5.5e-05,172.31.40.0-255,66,10543,63,206448
17654,9.7e-05,172.217.194.0-255,3452,13995,63,206448
17655,9.9e-05,172.31.40.0-255,66,14061,63,206448
17656,0.000103,172.217.194.0-255,1484,15545,63,206448
17657,0.000105,172.31.40.0-255,66,15611,63,206448
17658,0.000122,172.217.194.0-255,2902,18513,63,206448
17659,0.000125,172.31.40.0-255,66,18579,63,206448
17660,0.000137,172.31.40.0-255,66,18645,63,206448
17661,0.000141,172.217.194.0-255,2543,21188,63,206448
17662,0.000144,172.31.40.0-255,66,21254,63,206448
17663,0.000268,172.217.194.0-255,1484,22738,63,206448
17664,0.000272,172.31.40.0-255,66,22804,63,206448
17665,0.000277,172.217.194.0-255,2902,25706,63,206448
17666,0.00028,172.31.40.0-255,66,25772,63,206448
17667,0.000284,172.217.194.0-255,2902,28674,63,206448
17668,0.000287,172.31.40.0-255,66,28740,63,206448
17669,0.000308,172.217.194.0-255,2902,31642,63,206448
17670,0.00031,172.31.40.0-255,66,31708,63,206448
17671,0.000318,172.217.194.0-255,6797,38505,63,206448
17672,0.00032,172.31.40.0-255,66,38571,63,206448
17673,0.000355,172.217.194.0-255,5738,44309,63,206448
17674,0.000357,172.31.40.0-255,66,44375,63,206448
17675,0.000379,172.31.40.0-255,66,44441,63,206448
17676,0.000393,172.217.194.0-255,2800,47241,63,206448
17677,0.000395,172.31.40.0-255,66,47307,63,206448
17678,0.000474,172.217.194.0-255,114,47421,63,206448
17679,0.00066,172.217.194.0-255,1484,48905,63,206448
17680,0.000665,172.31.40.0-255,66,48971,63,206448
17681,0.000671,172.217.194.0-255,2902,51873,63,206448
17682,0.000673,172.31.40.0-255,66,51939,63,206448
17683,0.000678,172.217.194.0-255,4320,56259,63,206448
17684,0.00068,172.31.40.0-255,66,56325,63,206448
17685,0.000702,172.217.194.0-255,1484,57809,63,206448
17686,0.000708,172.217.194.0-255,2902,60711,63,206448
17687,0.00071,172.31.40.0-255,66,60777,63,206448
17688,0.000737,172.31.40.0-255,66,60843,63,206448
17689,0.000772,172.217.194.0-255,7156,67999,63,206448
17690,0.000775,172.31.40.0-255,66,68065,63,206448
17691,0.000796,172.217.194.0-255,4253,72318,63,206448
17692,0.000799,172.31.40.0-255,66,72384,63,206448
17693,0.000837,172.217.194.0-255,1484,73868,63,206448
17694,0.000849,172.217.194.0-255,2902,76770,63,206448
17695,0.000853,172.31.40.0-255,66,76836,63,206448
17696,0.000857,172.217.194.0-255,2902,79738,63,206448
17697,0.000859,172.31.40.0-255,66,79804,63,206448
17698,0.000875,172.217.194.0-255,2902,82706,63,206448
17699,0.000878,172.31.40.0-255,66,82772,63,206448
17700,0.000895,172.217.194.0-255,1484,84256,63,206448
17701,0.000916,172.31.40.0-255,66,84322,63,206448
17702,0.00094,172.217.194.0-255,2902,87224,63,206448
17703,0.000942,172.31.40.0-255,66,87290,63,206448
17704,0.000955,172.31.40.0-255,66,87356,63,206448
17705,0.000957,172.217.194.0-255,766,88122,63,206448
17706,0.001075,172.217.194.0-255,1484,89606,63,206448
17707,0.00108,172.31.40.0-255,66,89672,63,206448
17708,0.001085,172.217.194.0-255,2902,92574,63,206448
17709,0.001088,172.31.40.0-255,66,92640,63,206448
17710,0.001113,172.217.194.0-255,5738,98378,63,206448
17711,0.001118,172.31.40.0-255,66,98444,63,206448
17712,0.001137,172.217.194.0-255,1484,99928,63,206448
17713,0.001149,172.31.40.0-255,66,99994,63,206448
17714,0.001172,172.217.194.0-255,2902,102896,63,206448
17715,0.001175,172.31.40.0-255,66,102962,63,206448
17716,0.001206,172.31.40.0-255,66,103028,63,206448
17717,0.001235,172.217.194.0-255,1484,104512,63,206448
17718,0.00124,172.217.194.0-255,2902,107414,63,206448
17719,0.001242,172.31.40.0-255,66,107480,63,206448
17720,0.001259,172.217.194.0-255,5738,113218,63,206448
17721,0.001262,172.31.40.0-255,66,113284,63,206448
17722,0.001269,172.217.194.0-255,7156,120440,63,206448
17723,0.00127,172.31.40.0-255,66,120506,63,206448
17724,0.001291,172.217.194.0-255,4320,124826,63,206448
17725,0.001294,172.31.40.0-255,66,124892,63,206448
17726,0.001309,172.31.40.0-255,66,124958,63,206448
17727,0.001325,172.217.194.0-255,6438,131396,63,206448
17728,0.001327,172.31.40.0-255,66,131462,63,206448
17729,0.001345,172.217.194.0-255,7156,138618,63,206448
17730,0.001347,172.31.40.0-255,66,138684,63,206448
17731,0.001392,172.31.40.0-255,66,138750,63,206448
17732,0.001398,172.217.194.0-255,6438,145188,63,206448
17733,0.0014,172.31.40.0-255,66,145254,63,206448
17734,0.001556,172.217.194.0-255,1484,146738,63,206448
17735,0.001562,172.217.194.0-255,2902,149640,63,206448
17736,0.001565,172.31.40.0-255,66,149706,63,206448
17737,0.00157,172.217.194.0-255,4320,154026,63,206448
17738,0.001572,172.31.40.0-255,66,154092,63,206448
17739,0.001585,172.217.194.0-255,1484,155576,63,206448
17740,0.00159,172.217.194.0-255,4320,159896,63,206448
17741,0.001592,172.31.40.0-255,66,159962,63,206448
17742,0.00162,172.31.40.0-255,66,160028,63,206448
17743,0.00165,172.31.40.0-255,66,160094,63,206448
17744,0.001663,172.217.194.0-255,2184,162278,63,206448
17745,0.001666,172.31.40.0-255,66,162344,63,206448
17746,0.001944,172.217.194.0-255,1484,163828,63,206448
17747,0.001949,172.217.194.0-255,2902,166730,63,206448
17748,0.001952,172.31.40.0-255,66,166796,63,206448
17749,0.001958,172.217.194.0-255,5738,172534,63,206448
17750,0.00196,172.31.40.0-255,66,172600,63,206448
17751,0.001971,172.217.194.0-255,1484,174084,63,206448
17752,0.001989,172.217.194.0-255,7156,181240,63,206448
17753,0.001991,172.31.40.0-255,66,181306,63,206448
17754,0.002014,172.217.194.0-255,4320,185626,63,206448
17755,0.002016,172.31.40.0-255,66,185692,63,206448
17756,0.002028,172.217.194.0-255,2902,188594,63,206448
17757,0.00203,172.31.40.0-255,66,188660,63,206448
17758,0.002062,172.31.40.0-255,66,188726,63,206448
17759,0.002073,172.31.40.0-255,66,188792,63,206448
17760,0.002141,172.31.40.0-255,66,188858,63,206448
17761,0.002165,172.217.194.0-255,2184,191042,63,206448
17762,0.002167,172.31.40.0-255,66,191108,63,206448
17763,0.00218,172.31.40.0-255,66,191174,63,206448
17764,0.002197,172.217.194.0-255,3602,194776,63,206448
17765,0.002205,172.31.40.0-255,66,194842,63,206448
17766,0.002226,172.217.194.0-255,2902,197744,63,206448
17767,0.002232,172.217.194.0-255,4320,202064,63,206448
17768,0.00224,172.31.40.0-255,66,202130,63,206448
17769,0.002272,172.31.40.0-255,66,202196,63,206448
17770,0.002286,172.217.194.0-255,2902,205098,63,206448
17771,0.002296,172.31.40.0-255,66,205164,63,206448
17772,0.002332,172.31.40.0-255,66,205230,63,206448
17773,0.004598,172.217.194.0-255,981,206211,63,206448
17774,0.010355,172.31.40.0-255,66,206277,63,206448
17775,0.010396,172.31.40.0-255,105,206382,63,206448
17776,0.012611,172.217.194.0-255,66,206448,63,206448
17777,0.0,172.217.194.0-255,153,153,63,190198
17778,1.6e-05,172.31.40.0-255,66,219,63,190198
17779,2.3e-05,172.217.194.0-255,1484,1703,63,190198
17780,2.7e-05,172.31.40.0-255,66,1769,63,190198
17781,3.2e-05,172.217.194.0-255,2902,4671,63,190198
17782,3.5e-05,172.31.40.0-255,66,4737,63,190198
17783,5.1e-05,172.217.194.0-255,7156,11893,63,190198
17784,5.5e-05,172.31.40.0-255,66,11959,63,190198
17785,6.2e-05,172.217.194.0-255,6392,18351,63,190198
17786,6.5e-05,172.31.40.0-255,66,18417,63,190198
17787,0.000126,172.31.40.0-255,66,18483,63,190198
17788,0.000149,172.217.194.0-255,1484,19967,63,190198
17789,0.000152,172.31.40.0-255,66,20033,63,190198
17790,0.000157,172.217.194.0-255,2902,22935,63,190198
17791,0.000159,172.31.40.0-255,66,23001,63,190198
17792,0.00019,172.217.194.0-255,5738,28739,63,190198
17793,0.000193,172.31.40.0-255,66,28805,63,190198
17794,0.000207,172.31.40.0-255,66,28871,63,190198
17795,0.000222,172.31.40.0-255,66,28937,63,190198
17796,0.000292,172.217.194.0-255,2460,31397,63,190198
17797,0.000295,172.31.40.0-255,66,31463,63,190198
17798,0.000322,172.217.194.0-255,114,31577,63,190198
17799,0.000325,172.31.40.0-255,66,31643,63,190198
17800,0.000463,172.217.194.0-255,1484,33127,63,190198
17801,0.000468,172.31.40.0-255,66,33193,63,190198
17802,0.000474,172.217.194.0-255,2902,36095,63,190198
17803,0.000477,172.31.40.0-255,66,36161,63,190198
17804,0.000488,172.217.194.0-255,4320,40481,63,190198
17805,0.000491,172.31.40.0-255,66,40547,63,190198
17806,0.000514,172.217.194.0-255,1484,42031,63,190198
17807,0.000526,172.217.194.0-255,5738,47769,63,190198
17808,0.000543,172.217.194.0-255,5738,53507,63,190198
17809,0.000562,172.217.194.0-255,7156,60663,63,190198
17810,0.000568,172.217.194.0-255,5020,65683,63,190198
17811,0.00062,172.31.40.0-255,66,65749,63,190198
17812,0.000837,172.217.194.0-255,385,66134,63,190198
17813,0.000936,172.217.194.0-255,1484,67618,63,190198
17814,0.000942,172.217.194.0-255,2902,70520,63,190198
17815,0.00096,172.217.194.0-255,5738,76258,63,190198
17816,0.000978,172.31.40.0-255,66,76324,63,190198
17817,0.00099,172.217.194.0-255,5738,82062,63,190198
17818,0.000994,172.31.40.0-255,66,82128,63,190198
17819,0.001016,172.217.194.0-255,7156,89284,63,190198
17820,0.00105,172.31.40.0-255,66,89350,63,190198
17821,0.001171,172.217.194.0-255,1484,90834,63,190198
17822,0.001176,172.217.194.0-255,1484,92318,63,190198
17823,0.001188,172.31.40.0-255,66,92384,63,190198
17824,0.001201,172.217.194.0-255,1484,93868,63,190198
17825,0.001211,172.217.194.0-255,5738,99606,63,190198
17826,0.001216,172.217.194.0-255,2902,102508,63,190198
17827,0.001237,172.217.194.0-255,5738,108246,63,190198
17828,0.001244,172.31.40.0-255,66,108312,63,190198
17829,0.001297,172.31.40.0-255,66,108378,63,190198
17830,0.001347,172.31.40.0-255,66,108444,63,190198
17831,0.001375,172.217.194.0-255,4320,112764,63,190198
17832,0.001378,172.217.194.0-255,766,113530,63,190198
17833,0.001382,172.31.40.0-255,66,113596,63,190198
17834,0.001406,172.217.194.0-255,1484,115080,63,190198
17835,0.001421,172.217.194.0-255,2902,117982,63,190198
17836,0.001435,172.217.194.0-255,5738,123720,63,190198
17837,0.001452,172.217.194.0-255,4320,128040,63,190198
17838,0.001459,172.31.40.0-255,66,128106,63,190198
17839,0.001517,172.31.40.0-255,66,128172,63,190198
17840,0.001563,172.217.194.0-255,1484,129656,63,190198
17841,0.001568,172.217.194.0-255,2902,132558,63,190198
17842,0.001574,172.31.40.0-255,66,132624,63,190198
17843,0.001581,172.217.194.0-255,1484,134108,63,190198
17844,0.001608,172.217.194.0-255,4320,138428,63,190198
17845,0.001687,172.31.40.0-255,66,138494,63,190198
17846,0.001897,172.217.194.0-255,1484,139978,63,190198
17847,0.001905,172.217.194.0-255,2902,142880,63,190198
17848,0.001908,172.217.194.0-255,1484,144364,63,190198
17849,0.001924,172.217.194.0-255,4320,148684,63,190198
17850,0.001928,172.217.194.0-255,1484,150168,63,190198
17851,0.001933,172.31.40.0-255,66,150234,63,190198
17852,0.001987,172.217.194.0-255,4320,154554,63,190198
17853,0.00201,172.217.194.0-255,766,155320,63,190198
17854,0.002021,172.31.40.0-255,66,155386,63,190198
17855,0.002095,172.217.194.0-255,1484,156870,63,190198
17856,0.002111,172.217.194.0-255,2902,159772,63,190198
17857,0.002134,172.217.194.0-255,5738,165510,63,190198
17858,0.002139,172.217.194.0-255,4320,169830,63,190198
17859,0.002142,172.31.40.0-255,66,169896,63,190198
17860,0.002153,172.31.40.0-255,66,169962,63,190198
17861,0.002211,172.31.40.0-255,66,170028,63,190198
17862,0.002271,172.31.40.0-255,66,170094,63,190198
17863,0.002315,172.31.40.0-255,66,170160,63,190198
17864,0.002346,172.217.194.0-255,7156,177316,63,190198
17865,0.002364,172.217.194.0-255,4320,181636,63,190198
17866,0.00237,172.217.194.0-255,4320,185956,63,190198
17867,0.002388,172.217.194.0-255,3768,189724,63,190198
17868,0.002391,172.31.40.0-255,66,189790,63,190198
17869,0.002396,172.31.40.0-255,66,189856,63,190198
17870,0.004715,172.217.194.0-255,105,189961,63,190198
17871,0.013221,172.31.40.0-255,66,190027,63,190198
17872,0.01327,172.31.40.0-255,105,190132,63,190198
17873,0.015583,172.217.194.0-255,66,190198,63,190198
17874,0.0,172.253.118.0-255,153,153,63,303372
17875,1.9e-05,172.31.40.0-255,66,219,63,303372
17876,2.7e-05,172.253.118.0-255,1484,1703,63,303372
17877,3.1e-05,172.31.40.0-255,66,1769,63,303372
17878,3.7e-05,172.253.118.0-255,2902,4671,63,303372
17879,4e-05,172.31.40.0-255,66,4737,63,303372
17880,4.4e-05,172.253.118.0-255,1484,6221,63,303372
17881,4.6e-05,172.31.40.0-255,66,6287,63,303372
17882,7.2e-05,172.253.118.0-255,5738,12025,63,303372
17883,7.5e-05,172.31.40.0-255,66,12091,63,303372
17884,9.8e-05,172.31.40.0-255,66,12157,63,303372
17885,0.000109,172.31.40.0-255,66,12223,63,303372
17886,0.000161,172.253.118.0-255,2543,14766,63,303372
17887,0.000163,172.31.40.0-255,66,14832,63,303372
17888,0.00032,172.253.118.0-255,1484,16316,63,303372
17889,0.000324,172.31.40.0-255,66,16382,63,303372
17890,0.000332,172.253.118.0-255,2902,19284,63,303372
17891,0.000334,172.31.40.0-255,66,19350,63,303372
17892,0.000341,172.253.118.0-255,5738,25088,63,303372
17893,0.000343,172.31.40.0-255,66,25154,63,303372
17894,0.000348,172.253.118.0-255,4320,29474,63,303372
17895,0.00035,172.31.40.0-255,66,29540,63,303372
17896,0.000376,172.253.118.0-255,1484,31024,63,303372
17897,0.000379,172.31.40.0-255,66,31090,63,303372
17898,0.000409,172.31.40.0-255,66,31156,63,303372
17899,0.000417,172.253.118.0-255,6797,37953,63,303372
17900,0.000419,172.31.40.0-255,66,38019,63,303372
17901,0.001646,172.253.118.0-255,646,38665,63,303372
17902,0.001653,172.31.40.0-255,66,38731,63,303372
17903,0.001908,172.253.118.0-255,1484,40215,63,303372
17904,0.001914,172.253.118.0-255,1484,41699,63,303372
17905,0.001917,172.31.40.0-255,66,41765,63,303372
17906,0.001938,172.253.118.0-255,1484,43249,63,303372
17907,0.001945,172.253.118.0-255,5738,48987,63,303372
17908,0.001947,172.31.40.0-255,66,49053,63,303372
17909,0.001954,172.253.118.0-255,5738,54791,63,303372
17910,0.001956,172.31.40.0-255,66,54857,63,303372
17911,0.001997,172.253.118.0-255,4320,59177,63,303372
17912,0.001999,172.31.40.0-255,66,59243,63,303372
17913,0.002016,172.253.118.0-255,7156,66399,63,303372
17914,0.002018,172.31.40.0-255,66,66465,63,303372
17915,0.002047,172.253.118.0-255,5738,72203,63,303372
17916,0.002049,172.31.40.0-255,66,72269,63,303372
17917,0.002066,172.253.118.0-255,766,73035,63,303372
17918,0.002722,172.253.118.0-255,1484,74519,63,303372
17919,0.002724,172.31.40.0-255,66,74585,63,303372
17920,0.002729,172.253.118.0-255,2902,77487,63,303372
17921,0.002732,172.31.40.0-255,66,77553,63,303372
17922,0.002758,172.253.118.0-255,5738,83291,63,303372
17923,0.002761,172.31.40.0-255,66,83357,63,303372
17924,0.002767,172.253.118.0-255,5738,89095,63,303372
17925,0.002769,172.31.40.0-255,66,89161,63,303372
17926,0.002783,172.253.118.0-255,4320,93481,63,303372
17927,0.002786,172.31.40.0-255,66,93547,63,303372
17928,0.002817,172.253.118.0-255,7156,100703,63,303372
17929,0.002819,172.31.40.0-255,66,100769,63,303372
17930,0.002845,172.253.118.0-255,6438,107207,63,303372
17931,0.002847,172.31.40.0-255,66,107273,63,303372
17932,0.002903,172.253.118.0-255,1484,108757,63,303372
17933,0.002908,172.253.118.0-255,2902,111659,63,303372
17934,0.002911,172.31.40.0-255,66,111725,63,303372
17935,0.002937,172.253.118.0-255,2902,114627,63,303372
17936,0.002939,172.31.40.0-255,66,114693,63,303372
17937,0.002955,172.253.118.0-255,2902,117595,63,303372
17938,0.002957,172.31.40.0-255,66,117661,63,303372
17939,0.002962,172.253.118.0-255,2902,120563,63,303372
17940,0.002965,172.31.40.0-255,66,120629,63,303372
17941,0.002993,172.31.40.0-255,66,120695,63,303372
17942,0.003024,172.253.118.0-255,2902,123597,63,303372
17943,0.003026,172.31.40.0-255,66,123663,63,303372
17944,0.003056,172.31.40.0-255,66,123729,63,303372
17945,0.003092,172.253.118.0-255,1484,125213,63,303372
17946,0.003118,172.253.118.0-255,2902,128115,63,303372
17947,0.003121,172.31.40.0-255,66,128181,63,303372
17948,0.003125,172.253.118.0-255,1484,129665,63,303372
17949,0.003142,172.253.118.0-255,1484,131149,63,303372
17950,0.003145,172.31.40.0-255,66,131215,63,303372
17951,0.003164,172.253.118.0-255,4320,135535,63,303372
17952,0.003167,172.31.40.0-255,66,135601,63,303372
17953,0.003174,172.253.118.0-255,7156,142757,63,303372
17954,0.003177,172.31.40.0-255,66,142823,63,303372
17955,0.003205,172.253.118.0-255,5738,148561,63,303372
17956,0.003208,172.31.40.0-255,66,148627,63,303372
17957,0.003214,172.253.118.0-255,5738,154365,63,303372
17958,0.003216,172.31.40.0-255,66,154431,63,303372
17959,0.003241,172.253.118.0-255,3602,158033,63,303372
17960,0.003243,172.31.40.0-255,66,158099,63,303372
17961,0.003279,172.253.118.0-255,1484,159583,63,303372
17962,0.003294,172.253.118.0-255,2902,162485,63,303372
17963,0.003296,172.31.40.0-255,66,162551,63,303372
17964,0.003317,172.253.118.0-255,5738,168289,63,303372
17965,0.003321,172.31.40.0-255,66,168355,63,303372
17966,0.003358,172.253.118.0-255,1484,169839,63,303372
17967,0.003385,172.31.40.0-255,66,169905,63,303372
17968,0.003393,172.253.118.0-255,7156,177061,63,303372
17969,0.003395,172.31.40.0-255,66,177127,63,303372
17970,0.003412,172.253.118.0-255,3602,180729,63,303372
17971,0.003415,172.31.40.0-255,66,180795,63,303372
17972,0.004167,172.253.118.0-255,1484,182279,63,303372
17973,0.004179,172.253.118.0-255,2902,185181,63,303372
17974,0.004182,172.31.40.0-255,66,185247,63,303372
17975,0.004214,172.253.118.0-255,5738,190985,63,303372
17976,0.004217,172.31.40.0-255,66,191051,63,303372
17977,0.004221,172.253.118.0-255,2902,193953,63,303372
17978,0.004223,172.31.40.0-255,66,194019,63,303372
17979,0.004264,172.253.118.0-255,4320,198339,63,303372
17980,0.004267,172.31.40.0-255,66,198405,63,303372
17981,0.004286,172.253.118.0-255,5738,204143,63,303372
17982,0.004289,172.31.40.0-255,66,204209,63,303372
17983,0.004293,172.253.118.0-255,4320,208529,63,303372
17984,0.004295,172.31.40.0-255,66,208595,63,303372
17985,0.004299,172.253.118.0-255,2902,211497,63,303372
17986,0.004301,172.31.40.0-255,66,211563,63,303372
17987,0.004305,172.253.118.0-255,3602,215165,63,303372
17988,0.004308,172.31.40.0-255,66,215231,63,303372
17989,0.004467,172.253.118.0-255,1484,216715,63,303372
17990,0.004473,172.253.118.0-255,2902,219617,63,303372
17991,0.004476,172.31.40.0-255,66,219683,63,303372
17992,0.004496,172.253.118.0-255,1484,221167,63,303372
17993,0.004517,172.253.118.0-255,4320,225487,63,303372
17994,0.00452,172.31.40.0-255,66,225553,63,303372
17995,0.004523,172.253.118.0-255,1484,227037,63,303372
17996,0.004554,172.253.118.0-255,5738,232775,63,303372
17997,0.004557,172.31.40.0-255,66,232841,63,303372
17998,0.004576,172.253.118.0-255,2902,235743,63,303372
17999,0.004579,172.31.40.0-255,66,235809,63,303372
18000,0.00459,172.31.40.0-255,66,235875,63,303372
18001,0.004629,172.31.40.0-255,66,235941,63,303372
18002,0.004631,172.253.118.0-255,1484,237425,63,303372
18003,0.004648,172.253.118.0-255,2902,240327,63,303372
18004,0.004651,172.31.40.0-255,66,240393,63,303372
18005,0.004681,172.31.40.0-255,66,240459,63,303372
18006,0.00471,172.253.118.0-255,2184,242643,63,303372
18007,0.005087,172.253.118.0-255,1484,244127,63,303372
18008,0.005101,172.253.118.0-255,1484,245611,63,303372
18009,0.005111,172.253.118.0-255,1484,247095,63,303372
18010,0.005114,172.253.118.0-255,1484,248579,63,303372
18011,0.005134,172.253.118.0-255,4320,252899,63,303372
18012,0.005139,172.253.118.0-255,4320,257219,63,303372
18013,0.005153,172.253.118.0-255,1484,258703,63,303372
18014,0.005168,172.253.118.0-255,4320,263023,63,303372
18015,0.00519,172.253.118.0-255,5738,268761,63,303372
18016,0.005195,172.253.118.0-255,4320,273081,63,303372
18017,0.005198,172.253.118.0-255,1484,274565,63,303372
18018,0.005201,172.253.118.0-255,2184,276749,63,303372
18019,0.005355,172.253.118.0-255,1484,278233,63,303372
18020,0.005359,172.253.118.0-255,1484,279717,63,303372
18021,0.00537,172.253.118.0-255,1484,281201,63,303372
18022,0.005373,172.253.118.0-255,1484,282685,63,303372
18023,0.005396,172.253.118.0-255,4320,287005,63,303372
18024,0.005402,172.253.118.0-255,4320,291325,63,303372
18025,0.005404,172.253.118.0-255,1484,292809,63,303372
18026,0.005407,172.253.118.0-255,1484,294293,63,303372
18027,0.005409,172.253.118.0-255,1484,295777,63,303372
18028,0.005482,172.253.118.0-255,7156,302933,63,303372
18029,0.005507,172.253.118.0-255,97,303030,63,303372
18030,0.00551,172.253.118.0-255,105,303135,63,303372
18031,0.00726,172.31.40.0-255,66,303201,63,303372
18032,0.010084,172.31.40.0-255,105,303306,63,303372
18033,0.012316,172.253.118.0-255,66,303372,63,303372
18034,0.0,74.125.24.0-255,153,153,63,182239
18035,2.9e-05,172.31.40.0-255,66,219,63,182239
18036,3.7e-05,74.125.24.0-255,1484,1703,63,182239
18037,4.2e-05,172.31.40.0-255,66,1769,63,182239
18038,4.8e-05,74.125.24.0-255,2902,4671,63,182239
18039,5.2e-05,172.31.40.0-255,66,4737,63,182239
18040,6e-05,74.125.24.0-255,7156,11893,63,182239
18041,6.3e-05,172.31.40.0-255,66,11959,63,182239
18042,7.1e-05,74.125.24.0-255,6355,18314,63,182239
18043,7.4e-05,172.31.40.0-255,66,18380,63,182239
18044,8.2e-05,74.125.24.0-255,7156,25536,63,182239
18045,8.5e-05,172.31.40.0-255,66,25602,63,182239
18046,9.1e-05,74.125.24.0-255,4320,29922,63,182239
18047,9.4e-05,172.31.40.0-255,66,29988,63,182239
18048,0.000129,172.31.40.0-255,66,30054,63,182239
18049,0.000136,74.125.24.0-255,6438,36492,63,182239
18050,0.000139,172.31.40.0-255,66,36558,63,182239
18051,0.000194,74.125.24.0-255,1484,38042,63,182239
18052,0.000197,172.31.40.0-255,66,38108,63,182239
18053,0.00021,74.125.24.0-255,2902,41010,63,182239
18054,0.000212,172.31.40.0-255,66,41076,63,182239
18055,0.000215,74.125.24.0-255,1484,42560,63,182239
18056,0.000218,172.31.40.0-255,66,42626,63,182239
18057,0.000241,74.125.24.0-255,4320,46946,63,182239
18058,0.000244,172.31.40.0-255,66,47012,63,182239
18059,0.000289,74.125.24.0-255,7154,54166,63,182239
18060,0.000291,172.31.40.0-255,66,54232,63,182239
18061,0.000294,74.125.24.0-255,329,54561,63,182239
18062,0.000296,172.31.40.0-255,66,54627,63,182239
18063,0.00046,74.125.24.0-255,1484,56111,63,182239
18064,0.000466,172.31.40.0-255,66,56177,63,182239
18065,0.000471,74.125.24.0-255,2902,59079,63,182239
18066,0.000473,172.31.40.0-255,66,59145,63,182239
18067,0.000503,74.125.24.0-255,5738,64883,63,182239
18068,0.000506,172.31.40.0-255,66,64949,63,182239
18069,0.000513,74.125.24.0-255,5738,70687,63,182239
18070,0.000515,172.31.40.0-255,66,70753,63,182239
18071,0.000531,74.125.24.0-255,4320,75073,63,182239
18072,0.000533,172.31.40.0-255,66,75139,63,182239
18073,0.000538,74.125.24.0-255,2902,78041,63,182239
18074,0.00054,172.31.40.0-255,66,78107,63,182239
18075,0.000573,172.31.40.0-255,66,78173,63,182239
18076,0.000576,74.125.24.0-255,1484,79657,63,182239
18077,0.000613,74.125.24.0-255,766,80423,63,182239
18078,0.000615,172.31.40.0-255,66,80489,63,182239
18079,0.000706,74.125.24.0-255,1484,81973,63,182239
18080,0.000712,74.125.24.0-255,2902,84875,63,182239
18081,0.000716,172.31.40.0-255,66,84941,63,182239
18082,0.000721,74.125.24.0-255,2902,87843,63,182239
18083,0.000723,172.31.40.0-255,66,87909,63,182239
18084,0.000741,74.125.24.0-255,2902,90811,63,182239
18085,0.000743,172.31.40.0-255,66,90877,63,182239
18086,0.000755,172.31.40.0-255,66,90943,63,182239
18087,0.000773,74.125.24.0-255,4320,95263,63,182239
18088,0.000775,172.31.40.0-255,66,95329,63,182239
18089,0.00078,74.125.24.0-255,4320,99649,63,182239
18090,0.000783,172.31.40.0-255,66,99715,63,182239
18091,0.000813,74.125.24.0-255,6438,106153,63,182239
18092,0.000817,172.31.40.0-255,66,106219,63,182239
18093,0.000975,74.125.24.0-255,1484,107703,63,182239
18094,0.000996,74.125.24.0-255,2902,110605,63,182239
18095,0.000999,172.31.40.0-255,66,110671,63,182239
18096,0.001007,74.125.24.0-255,5738,116409,63,182239
18097,0.001009,172.31.40.0-255,66,116475,63,182239
18098,0.001034,74.125.24.0-255,7156,123631,63,182239
18099,0.001037,172.31.40.0-255,66,123697,63,182239
18100,0.001114,172.31.40.0-255,66,123763,63,182239
18101,0.001261,74.125.24.0-255,1484,125247,63,182239
18102,0.00129,74.125.24.0-255,2902,128149,63,182239
18103,0.001294,172.31.40.0-255,66,128215,63,182239
18104,0.001301,74.125.24.0-255,5738,133953,63,182239
18105,0.001304,172.31.40.0-255,66,134019,63,182239
18106,0.001307,74.125.24.0-255,1484,135503,63,182239
18107,0.001343,172.31.40.0-255,66,135569,63,182239
18108,0.001355,172.31.40.0-255,66,135635,63,182239
18109,0.001637,74.125.24.0-255,1484,137119,63,182239
18110,0.001654,74.125.24.0-255,2902,140021,63,182239
18111,0.001657,172.31.40.0-255,66,140087,63,182239
18112,0.001661,74.125.24.0-255,1484,141571,63,182239
18113,0.001683,74.125.24.0-255,4320,145891,63,182239
18114,0.001686,172.31.40.0-255,66,145957,63,182239
18115,0.001701,172.31.40.0-255,66,146023,63,182239
18116,0.001711,172.31.40.0-255,66,146089,63,182239
18117,0.001745,74.125.24.0-255,2184,148273,63,182239
18118,0.001748,172.31.40.0-255,66,148339,63,182239
18119,0.001862,74.125.24.0-255,1484,149823,63,182239
18120,0.001867,74.125.24.0-255,2902,152725,63,182239
18121,0.00187,172.31.40.0-255,66,152791,63,182239
18122,0.001906,74.125.24.0-255,1484,154275,63,182239
18123,0.001922,74.125.24.0-255,4320,158595,63,182239
18124,0.001924,172.31.40.0-255,66,158661,63,182239
18125,0.001927,74.125.24.0-255,1484,160145,63,182239
18126,0.001943,172.31.40.0-255,66,160211,63,182239
18127,0.00195,74.125.24.0-255,5738,165949,63,182239
18128,0.001952,172.31.40.0-255,66,166015,63,182239
18129,0.002036,172.31.40.0-255,66,166081,63,182239
18130,0.002057,172.31.40.0-255,66,166147,63,182239
18131,0.002094,74.125.24.0-255,5738,171885,63,182239
18132,0.002097,172.31.40.0-255,66,171951,63,182239
18133,0.002102,172.31.40.0-255,66,172017,63,182239
18134,0.002146,172.31.40.0-255,66,172083,63,182239
18135,0.002169,74.125.24.0-255,5738,177821,63,182239
18136,0.002194,172.31.40.0-255,66,177887,63,182239
18137,0.002223,172.31.40.0-255,66,177953,63,182239
18138,0.002268,74.125.24.0-255,3944,181897,63,182239
18139,0.002284,74.125.24.0-255,105,182002,63,182239
18140,0.002288,172.31.40.0-255,66,182068,63,182239
18141,0.009496,172.31.40.0-255,105,182173,63,182239
18142,0.011978,74.125.24.0-255,66,182239,63,182239
18143,0.0,172.217.194.0-255,156,156,63,113123
18144,2.6e-05,172.31.40.0-255,66,222,63,113123
18145,3.4e-05,172.217.194.0-255,1484,1706,63,113123
18146,3.9e-05,172.31.40.0-255,66,1772,63,113123
18147,5.4e-05,172.217.194.0-255,2902,4674,63,113123
18148,5.8e-05,172.31.40.0-255,66,4740,63,113123
18149,6.6e-05,172.217.194.0-255,7156,11896,63,113123
18150,6.9e-05,172.31.40.0-255,66,11962,63,113123
18151,8.2e-05,172.31.40.0-255,66,12028,63,113123
18152,0.000108,172.217.194.0-255,4738,16766,63,113123
18153,0.000117,172.31.40.0-255,66,16832,63,113123
18154,0.000121,172.217.194.0-255,2543,19375,63,113123
18155,0.000125,172.31.40.0-255,66,19441,63,113123
18156,0.000127,172.217.194.0-255,1484,20925,63,113123
18157,0.000129,172.31.40.0-255,66,20991,63,113123
18158,0.000134,172.217.194.0-255,2902,23893,63,113123
18159,0.000136,172.31.40.0-255,66,23959,63,113123
18160,0.000142,172.217.194.0-255,5738,29697,63,113123
18161,0.000146,172.31.40.0-255,66,29763,63,113123
18162,0.000208,172.31.40.0-255,66,29829,63,113123
18163,0.000219,172.31.40.0-255,66,29895,63,113123
18164,0.000382,172.217.194.0-255,364,30259,63,113123
18165,0.000386,172.31.40.0-255,66,30325,63,113123
18166,0.000556,172.217.194.0-255,1484,31809,63,113123
18167,0.000561,172.31.40.0-255,66,31875,63,113123
18168,0.000569,172.217.194.0-255,2902,34777,63,113123
18169,0.000572,172.31.40.0-255,66,34843,63,113123
18170,0.000576,172.217.194.0-255,2902,37745,63,113123
18171,0.000578,172.31.40.0-255,66,37811,63,113123
18172,0.000626,172.217.194.0-255,2902,40713,63,113123
18173,0.00063,172.31.40.0-255,66,40779,63,113123
18174,0.000644,172.31.40.0-255,66,40845,63,113123
18175,0.000657,172.31.40.0-255,66,40911,63,113123
18176,0.00069,172.217.194.0-255,1484,42395,63,113123
18177,0.000696,172.217.194.0-255,2902,45297,63,113123
18178,0.000699,172.31.40.0-255,66,45363,63,113123
18179,0.000705,172.217.194.0-255,5738,51101,63,113123
18180,0.000708,172.31.40.0-255,66,51167,63,113123
18181,0.000719,172.31.40.0-255,66,51233,63,113123
18182,0.000754,172.217.194.0-255,4320,55553,63,113123
18183,0.000757,172.31.40.0-255,66,55619,63,113123
18184,0.00077,172.31.40.0-255,66,55685,63,113123
18185,0.001005,172.217.194.0-255,1484,57169,63,113123
18186,0.001009,172.217.194.0-255,2902,60071,63,113123
18187,0.001012,172.217.194.0-255,1484,61555,63,113123
18188,0.001017,172.31.40.0-255,66,61621,63,113123
18189,0.00103,172.217.194.0-255,4320,65941,63,113123
18190,0.001033,172.31.40.0-255,66,66007,63,113123
18191,0.001038,172.217.194.0-255,2902,68909,63,113123
18192,0.001044,172.31.40.0-255,66,68975,63,113123
18193,0.001067,172.217.194.0-255,4320,73295,63,113123
18194,0.00107,172.31.40.0-255,66,73361,63,113123
18195,0.001084,172.31.40.0-255,66,73427,63,113123
18196,0.001088,172.217.194.0-255,2184,75611,63,113123
18197,0.00109,172.31.40.0-255,66,75677,63,113123
18198,0.001712,172.217.194.0-255,1484,77161,63,113123
18199,0.001718,172.217.194.0-255,2902,80063,63,113123
18200,0.001722,172.31.40.0-255,66,80129,63,113123
18201,0.001755,172.217.194.0-255,5738,85867,63,113123
18202,0.001758,172.31.40.0-255,66,85933,63,113123
18203,0.001771,172.31.40.0-255,66,85999,63,113123
18204,0.001805,172.217.194.0-255,1484,87483,63,113123
18205,0.001856,172.31.40.0-255,66,87549,63,113123
18206,0.00191,172.217.194.0-255,1484,89033,63,113123
18207,0.001914,172.217.194.0-255,2902,91935,63,113123
18208,0.001917,172.31.40.0-255,66,92001,63,113123
18209,0.001951,172.217.194.0-255,5738,97739,63,113123
18210,0.001954,172.31.40.0-255,66,97805,63,113123
18211,0.001972,172.31.40.0-255,66,97871,63,113123
18212,0.001984,172.31.40.0-255,66,97937,63,113123
18213,0.002068,172.31.40.0-255,66,98003,63,113123
18214,0.002079,172.31.40.0-255,66,98069,63,113123
18215,0.002082,172.217.194.0-255,1484,99553,63,113123
18216,0.002097,172.217.194.0-255,4320,103873,63,113123
18217,0.0021,172.31.40.0-255,66,103939,63,113123
18218,0.002152,172.31.40.0-255,66,104005,63,113123
18219,0.002179,172.31.40.0-255,66,104071,63,113123
18220,0.002196,172.31.40.0-255,66,104137,63,113123
18221,0.002246,172.31.40.0-255,66,104203,63,113123
18222,0.002265,172.31.40.0-255,66,104269,63,113123
18223,0.002293,172.31.40.0-255,66,104335,63,113123
18224,0.002332,172.217.194.0-255,5020,109355,63,113123
18225,0.002335,172.31.40.0-255,66,109421,63,113123
18226,0.002341,172.217.194.0-255,3294,112715,63,113123
18227,0.002344,172.31.40.0-255,66,112781,63,113123
18228,0.002347,172.217.194.0-255,105,112886,63,113123
18229,0.014127,172.31.40.0-255,66,112952,63,113123
18230,0.014179,172.31.40.0-255,105,113057,63,113123
18231,0.016512,172.217.194.0-255,66,113123,63,113123
18232,0.0,74.125.200.0-255,150,150,63,121799
18233,2.4e-05,172.31.40.0-255,66,216,63,121799
18234,3.2e-05,74.125.200.0-255,1484,1700,63,121799
18235,3.8e-05,172.31.40.0-255,66,1766,63,121799
18236,5.1e-05,74.125.200.0-255,2902,4668,63,121799
18237,5.5e-05,172.31.40.0-255,66,4734,63,121799
18238,6.3e-05,74.125.200.0-255,5738,10472,63,121799
18239,6.7e-05,172.31.40.0-255,66,10538,63,121799
18240,7e-05,74.125.200.0-255,1484,12022,63,121799
18241,7.2e-05,172.31.40.0-255,66,12088,63,121799
18242,0.000104,74.125.200.0-255,2001,14089,63,121799
18243,0.000107,172.31.40.0-255,66,14155,63,121799
18244,0.000299,74.125.200.0-255,1484,15639,63,121799
18245,0.000305,172.31.40.0-255,66,15705,63,121799
18246,0.000309,74.125.200.0-255,1484,17189,63,121799
18247,0.000311,172.31.40.0-255,66,17255,63,121799
18248,0.000335,74.125.200.0-255,1484,18739,63,121799
18249,0.000338,172.31.40.0-255,66,18805,63,121799
18250,0.000344,74.125.200.0-255,5738,24543,63,121799
18251,0.000347,172.31.40.0-255,66,24609,63,121799
18252,0.000351,74.125.200.0-255,2902,27511,63,121799
18253,0.000353,172.31.40.0-255,66,27577,63,121799
18254,0.000358,74.125.200.0-255,3961,31538,63,121799
18255,0.000362,172.31.40.0-255,66,31604,63,121799
18256,0.000464,74.125.200.0-255,1484,33088,63,121799
18257,0.000468,172.31.40.0-255,66,33154,63,121799
18258,0.000472,74.125.200.0-255,1484,34638,63,121799
18259,0.000474,172.31.40.0-255,66,34704,63,121799
18260,0.000501,74.125.200.0-255,2902,37606,63,121799
18261,0.000504,172.31.40.0-255,66,37672,63,121799
18262,0.000511,74.125.200.0-255,5738,43410,63,121799
18263,0.000513,172.31.40.0-255,66,43476,63,121799
18264,0.000541,74.125.200.0-255,5738,49214,63,121799
18265,0.000544,172.31.40.0-255,66,49280,63,121799
18266,0.000563,74.125.200.0-255,3961,53241,63,121799
18267,0.000572,172.31.40.0-255,66,53307,63,121799
18268,0.000584,172.31.40.0-255,66,53373,63,121799
18269,0.000588,74.125.200.0-255,2543,55916,63,121799
18270,0.00059,172.31.40.0-255,66,55982,63,121799
18271,0.00063,74.125.200.0-255,414,56396,63,121799
18272,0.000656,74.125.200.0-255,331,56727,63,121799
18273,0.001168,172.31.40.0-255,66,56793,63,121799
18274,0.001844,74.125.200.0-255,1484,58277,63,121799
18275,0.001855,74.125.200.0-255,2902,61179,63,121799
18276,0.00186,172.31.40.0-255,66,61245,63,121799
18277,0.001868,74.125.200.0-255,4320,65565,63,121799
18278,0.00187,172.31.40.0-255,66,65631,63,121799
18279,0.001889,74.125.200.0-255,5738,71369,63,121799
18280,0.001892,172.31.40.0-255,66,71435,63,121799
18281,0.001913,74.125.200.0-255,2902,74337,63,121799
18282,0.001916,172.31.40.0-255,66,74403,63,121799
18283,0.001927,172.31.40.0-255,66,74469,63,121799
18284,0.001964,74.125.200.0-255,2902,77371,63,121799
18285,0.001966,172.31.40.0-255,66,77437,63,121799
18286,0.001994,74.125.200.0-255,5020,82457,63,121799
18287,0.001997,172.31.40.0-255,66,82523,63,121799
18288,0.00423,74.125.200.0-255,5738,88261,63,121799
18289,0.004237,172.31.40.0-255,66,88327,63,121799
18290,0.006482,74.125.200.0-255,5738,94065,63,121799
18291,0.006488,172.31.40.0-255,66,94131,63,121799
18292,0.008748,74.125.200.0-255,4320,98451,63,121799
18293,0.008756,172.31.40.0-255,66,98517,63,121799
18294,0.008782,74.125.200.0-255,1484,100001,63,121799
18295,0.010997,74.125.200.0-255,4320,104321,63,121799
18296,0.011011,172.31.40.0-255,66,104387,63,121799
18297,0.013265,74.125.200.0-255,5738,110125,63,121799
18298,0.013275,172.31.40.0-255,66,110191,63,121799
18299,0.015505,74.125.200.0-255,5738,115929,63,121799
18300,0.015512,172.31.40.0-255,66,115995,63,121799
18301,0.017769,74.125.200.0-255,5738,121733,63,121799
18302,0.017781,172.31.40.0-255,66,121799,63,121799
18303,0.0,172.217.194.0-255,297,297,63,232568
18304,2.5e-05,172.31.40.0-255,66,363,63,232568
18305,3.1e-05,172.217.194.0-255,1484,1847,63,232568
18306,3.7e-05,172.31.40.0-255,66,1913,63,232568
18307,4.4e-05,172.217.194.0-255,4320,6233,63,232568
18308,4.8e-05,172.31.40.0-255,66,6299,63,232568
18309,5.5e-05,172.217.194.0-255,5738,12037,63,232568
18310,5.8e-05,172.31.40.0-255,66,12103,63,232568
18311,8.7e-05,172.217.194.0-255,3188,15291,63,232568
18312,8.9e-05,172.31.40.0-255,66,15357,63,232568
18313,0.000102,172.31.40.0-255,66,15423,63,232568
18314,0.000125,172.217.194.0-255,2902,18325,63,232568
18315,0.000128,172.31.40.0-255,66,18391,63,232568
18316,0.000145,172.217.194.0-255,2543,20934,63,232568
18317,0.000147,172.31.40.0-255,66,21000,63,232568
18318,0.000212,172.217.194.0-255,1484,22484,63,232568
18319,0.000216,172.31.40.0-255,66,22550,63,232568
18320,0.000221,172.217.194.0-255,2902,25452,63,232568
18321,0.000223,172.31.40.0-255,66,25518,63,232568
18322,0.000229,172.217.194.0-255,5738,31256,63,232568
18323,0.000231,172.31.40.0-255,66,31322,63,232568
18324,0.000278,172.217.194.0-255,5738,37060,63,232568
18325,0.000282,172.31.40.0-255,66,37126,63,232568
18326,0.000312,172.31.40.0-255,66,37192,63,232568
18327,0.000335,172.217.194.0-255,7156,44348,63,232568
18328,0.000338,172.31.40.0-255,66,44414,63,232568
18329,0.000357,172.217.194.0-255,2849,47263,63,232568
18330,0.000359,172.31.40.0-255,66,47329,63,232568
18331,0.000404,172.217.194.0-255,1484,48813,63,232568
18332,0.000407,172.31.40.0-255,66,48879,63,232568
18333,0.000412,172.217.194.0-255,2902,51781,63,232568
18334,0.000414,172.31.40.0-255,66,51847,63,232568
18335,0.00042,172.217.194.0-255,4320,56167,63,232568
18336,0.000422,172.31.40.0-255,66,56233,63,232568
18337,0.000441,172.217.194.0-255,1484,57717,63,232568
18338,0.000454,172.31.40.0-255,66,57783,63,232568
18339,0.000478,172.217.194.0-255,3961,61744,63,232568
18340,0.00048,172.31.40.0-255,66,61810,63,232568
18341,0.000485,172.217.194.0-255,4320,66130,63,232568
18342,0.000487,172.31.40.0-255,66,66196,63,232568
18343,0.000507,172.217.194.0-255,6797,72993,63,232568
18344,0.000509,172.31.40.0-255,66,73059,63,232568
18345,0.000516,172.217.194.0-255,5738,78797,63,232568
18346,0.000518,172.31.40.0-255,66,78863,63,232568
18347,0.000545,172.217.194.0-255,5738,84601,63,232568
18348,0.000548,172.31.40.0-255,66,84667,63,232568
18349,0.000555,172.217.194.0-255,5738,90405,63,232568
18350,0.000558,172.31.40.0-255,66,90471,63,232568
18351,0.000579,172.217.194.0-255,1484,91955,63,232568
18352,0.000599,172.217.194.0-255,5738,97693,63,232568
18353,0.000602,172.31.40.0-255,66,97759,63,232568
18354,0.000632,172.31.40.0-255,66,97825,63,232568
18355,0.000638,172.217.194.0-255,4320,102145,63,232568
18356,0.000641,172.31.40.0-255,66,102211,63,232568
18357,0.000645,172.217.194.0-255,2902,105113,63,232568
18358,0.000647,172.31.40.0-255,66,105179,63,232568
18359,0.000671,172.217.194.0-255,2902,108081,63,232568
18360,0.000674,172.31.40.0-255,66,108147,63,232568
18361,0.000686,172.31.40.0-255,66,108213,63,232568
18362,0.000693,172.217.194.0-255,5738,113951,63,232568
18363,0.000695,172.31.40.0-255,66,114017,63,232568
18364,0.000702,172.217.194.0-255,6438,120455,63,232568
18365,0.000705,172.31.40.0-255,66,120521,63,232568
18366,0.000726,172.217.194.0-255,5738,126259,63,232568
18367,0.000745,172.217.194.0-255,1800,128059,63,232568
18368,0.000751,172.217.194.0-255,4320,132379,63,232568
18369,0.000769,172.217.194.0-255,5738,138117,63,232568
18370,0.0008,172.217.194.0-255,1484,139601,63,232568
18371,0.000856,172.217.194.0-255,7156,146757,63,232568
18372,0.000876,172.217.194.0-255,4320,151077,63,232568
18373,0.000903,172.217.194.0-255,4320,155397,63,232568
18374,0.001,172.217.194.0-255,1484,156881,63,232568
18375,0.001017,172.217.194.0-255,1484,158365,63,232568
18376,0.001036,172.217.194.0-255,1484,159849,63,232568
18377,0.001043,172.217.194.0-255,5738,165587,63,232568
18378,0.001049,172.217.194.0-255,5738,171325,63,232568
18379,0.001082,172.31.40.0-255,66,171391,63,232568
18380,0.001104,172.217.194.0-255,4320,175711,63,232568
18381,0.001133,172.217.194.0-255,766,176477,63,232568
18382,0.001153,172.31.40.0-255,66,176543,63,232568
18383,0.001172,172.217.194.0-255,1484,178027,63,232568
18384,0.001177,172.217.194.0-255,2902,180929,63,232568
18385,0.00119,172.217.194.0-255,2902,183831,63,232568
18386,0.001202,172.217.194.0-255,2902,186733,63,232568
18387,0.001205,172.31.40.0-255,66,186799,63,232568
18388,0.00121,172.31.40.0-255,66,186865,63,232568
18389,0.001226,172.217.194.0-255,5738,192603,63,232568
18390,0.001243,172.31.40.0-255,66,192669,63,232568
18391,0.001265,172.217.194.0-255,5020,197689,63,232568
18392,0.001271,172.31.40.0-255,66,197755,63,232568
18393,0.001299,172.217.194.0-255,5738,203493,63,232568
18394,0.001302,172.217.194.0-255,1484,204977,63,232568
18395,0.001307,172.31.40.0-255,66,205043,63,232568
18396,0.001332,172.217.194.0-255,7156,212199,63,232568
18397,0.001346,172.31.40.0-255,66,212265,63,232568
18398,0.001364,172.217.194.0-255,7156,219421,63,232568
18399,0.00137,172.217.194.0-255,3602,223023,63,232568
18400,0.001382,172.217.194.0-255,2902,225925,63,232568
18401,0.001396,172.217.194.0-255,1484,227409,63,232568
18402,0.001404,172.31.40.0-255,66,227475,63,232568
18403,0.001434,172.217.194.0-255,1484,228959,63,232568
18404,0.001448,172.31.40.0-255,66,229025,63,232568
18405,0.001465,172.31.40.0-255,66,229091,63,232568
18406,0.001511,172.217.194.0-255,2902,231993,63,232568
18407,0.001521,172.31.40.0-255,66,232059,63,232568
18408,0.001554,172.217.194.0-255,105,232164,63,232568
18409,0.001571,172.31.40.0-255,66,232230,63,232568
18410,0.003144,172.31.40.0-255,101,232331,63,232568
18411,0.00547,172.217.194.0-255,66,232397,63,232568
18412,0.014897,172.31.40.0-255,105,232502,63,232568
18413,0.017193,172.217.194.0-255,66,232568,63,232568
18414,0.0,74.125.24.0-255,155,155,63,229398
18415,2.5e-05,172.31.40.0-255,66,221,63,229398
18416,3.3e-05,74.125.24.0-255,1484,1705,63,229398
18417,3.8e-05,172.31.40.0-255,66,1771,63,229398
18418,4.4e-05,74.125.24.0-255,2902,4673,63,229398
18419,4.8e-05,172.31.40.0-255,66,4739,63,229398
18420,5.6e-05,74.125.24.0-255,7156,11895,63,229398
18421,5.9e-05,172.31.40.0-255,66,11961,63,229398
18422,6.4e-05,74.125.24.0-255,2137,14098,63,229398
18423,6.7e-05,172.31.40.0-255,66,14164,63,229398
18424,0.0001,74.125.24.0-255,7156,21320,63,229398
18425,0.000103,172.31.40.0-255,66,21386,63,229398
18426,0.000135,74.125.24.0-255,4320,25706,63,229398
18427,0.000138,172.31.40.0-255,66,25772,63,229398
18428,0.000159,172.31.40.0-255,66,25838,63,229398
18429,0.000175,172.31.40.0-255,66,25904,63,229398
18430,0.000191,74.125.24.0-255,3513,29417,63,229398
18431,0.000193,172.31.40.0-255,66,29483,63,229398
18432,0.000197,74.125.24.0-255,415,29898,63,229398
18433,0.000199,172.31.40.0-255,66,29964,63,229398
18434,0.000379,74.125.24.0-255,1484,31448,63,229398
18435,0.000385,172.31.40.0-255,66,31514,63,229398
18436,0.000391,74.125.24.0-255,2902,34416,63,229398
18437,0.000393,172.31.40.0-255,66,34482,63,229398
18438,0.0004,74.125.24.0-255,5738,40220,63,229398
18439,0.000402,172.31.40.0-255,66,40286,63,229398
18440,0.000409,74.125.24.0-255,5738,46024,63,229398
18441,0.000412,172.31.40.0-255,66,46090,63,229398
18442,0.000416,74.125.24.0-255,2902,48992,63,229398
18443,0.000418,172.31.40.0-255,66,49058,63,229398
18444,0.000458,74.125.24.0-255,5020,54078,63,229398
18445,0.000542,172.31.40.0-255,66,54144,63,229398
18446,0.000791,74.125.24.0-255,1484,55628,63,229398
18447,0.000809,74.125.24.0-255,2902,58530,63,229398
18448,0.000814,74.125.24.0-255,2902,61432,63,229398
18449,0.000819,172.31.40.0-255,66,61498,63,229398
18450,0.000833,74.125.24.0-255,2902,64400,63,229398
18451,0.000836,74.125.24.0-255,1484,65884,63,229398
18452,0.000848,172.31.40.0-255,66,65950,63,229398
18453,0.000876,74.125.24.0-255,7156,73106,63,229398
18454,0.000903,74.125.24.0-255,3602,76708,63,229398
18455,0.000925,172.31.40.0-255,66,76774,63,229398
18456,0.001143,74.125.24.0-255,1484,78258,63,229398
18457,0.001149,74.125.24.0-255,2902,81160,63,229398
18458,0.00116,172.31.40.0-255,66,81226,63,229398
18459,0.001177,74.125.24.0-255,5738,86964,63,229398
18460,0.001189,172.31.40.0-255,66,87030,63,229398
18461,0.001227,74.125.24.0-255,7156,94186,63,229398
18462,0.001243,74.125.24.0-255,1484,95670,63,229398
18463,0.001247,172.31.40.0-255,66,95736,63,229398
18464,0.001265,74.125.24.0-255,2184,97920,63,229398
18465,0.001274,172.31.40.0-255,66,97986,63,229398
18466,0.001292,74.125.24.0-255,1484,99470,63,229398
18467,0.001311,74.125.24.0-255,2902,102372,63,229398
18468,0.001317,74.125.24.0-255,4320,106692,63,229398
18469,0.00132,74.125.24.0-255,1484,108176,63,229398
18470,0.001357,172.31.40.0-255,66,108242,63,229398
18471,0.00138,172.31.40.0-255,66,108308,63,229398
18472,0.001457,74.125.24.0-255,1484,109792,63,229398
18473,0.001507,74.125.24.0-255,2902,112694,63,229398
18474,0.001514,74.125.24.0-255,5738,118432,63,229398
18475,0.001532,172.31.40.0-255,66,118498,63,229398
18476,0.001548,74.125.24.0-255,2902,121400,63,229398
18477,0.001556,74.125.24.0-255,7156,128556,63,229398
18478,0.00157,74.125.24.0-255,3602,132158,63,229398
18479,0.00158,172.31.40.0-255,66,132224,63,229398
18480,0.001665,74.125.24.0-255,1484,133708,63,229398
18481,0.00167,74.125.24.0-255,1484,135192,63,229398
18482,0.001683,74.125.24.0-255,1484,136676,63,229398
18483,0.00169,74.125.24.0-255,5738,142414,63,229398
18484,0.001696,172.31.40.0-255,66,142480,63,229398
18485,0.00171,74.125.24.0-255,4320,146800,63,229398
18486,0.001746,74.125.24.0-255,7156,153956,63,229398
18487,0.001755,172.31.40.0-255,66,154022,63,229398
18488,0.001774,74.125.24.0-255,1484,155506,63,229398
18489,0.00179,74.125.24.0-255,2184,157690,63,229398
18490,0.001794,172.31.40.0-255,66,157756,63,229398
18491,0.00187,74.125.24.0-255,1484,159240,63,229398
18492,0.001874,74.125.24.0-255,1484,160724,63,229398
18493,0.001887,74.125.24.0-255,1484,162208,63,229398
18494,0.001895,172.31.40.0-255,66,162274,63,229398
18495,0.001908,74.125.24.0-255,5738,168012,63,229398
18496,0.001928,172.31.40.0-255,66,168078,63,229398
18497,0.001944,172.31.40.0-255,66,168144,63,229398
18498,0.001985,74.125.24.0-255,2184,170328,63,229398
18499,0.001989,74.125.24.0-255,2902,173230,63,229398
18500,0.002006,172.31.40.0-255,66,173296,63,229398
18501,0.002014,74.125.24.0-255,7156,180452,63,229398
18502,0.002019,172.31.40.0-255,66,180518,63,229398
18503,0.002031,74.125.24.0-255,7156,187674,63,229398
18504,0.002047,74.125.24.0-255,2902,190576,63,229398
18505,0.002066,172.31.40.0-255,66,190642,63,229398
18506,0.002076,74.125.24.0-255,2902,193544,63,229398
18507,0.002081,74.125.24.0-255,2184,195728,63,229398
18508,0.002103,172.31.40.0-255,66,195794,63,229398
18509,0.002322,74.125.24.0-255,1484,197278,63,229398
18510,0.002336,74.125.24.0-255,2902,200180,63,229398
18511,0.00235,172.31.40.0-255,66,200246,63,229398
18512,0.002357,74.125.24.0-255,5738,205984,63,229398
18513,0.002362,172.31.40.0-255,66,206050,63,229398
18514,0.002401,172.31.40.0-255,66,206116,63,229398
18515,0.004728,74.125.24.0-255,5738,211854,63,229398
18516,0.004735,172.31.40.0-255,66,211920,63,229398
18517,0.007059,74.125.24.0-255,5738,217658,63,229398
18518,0.013741,172.31.40.0-255,66,217724,63,229398
18519,0.013966,74.125.24.0-255,1484,219208,63,229398
18520,0.01609,74.125.24.0-255,4320,223528,63,229398
18521,0.016097,172.31.40.0-255,66,223594,63,229398
18522,0.018441,74.125.24.0-255,5738,229332,63,229398
18523,0.018538,172.31.40.0-255,66,229398,63,229398
18524,0.0,74.125.130.0-255,153,153,63,186318
18525,2.2e-05,172.31.40.0-255,66,219,63,186318
18526,2.9e-05,74.125.130.0-255,1484,1703,63,186318
18527,3.3e-05,172.31.40.0-255,66,1769,63,186318
18528,3.8e-05,74.125.130.0-255,2902,4671,63,186318
18529,4.1e-05,172.31.40.0-255,66,4737,63,186318
18530,4.6e-05,74.125.130.0-255,4320,9057,63,186318
18531,5.4e-05,172.31.40.0-255,66,9123,63,186318
18532,7.3e-05,74.125.130.0-255,2902,12025,63,186318
18533,7.6e-05,172.31.40.0-255,66,12091,63,186318
18534,8.3e-05,74.125.130.0-255,2033,14124,63,186318
18535,8.5e-05,172.31.40.0-255,66,14190,63,186318
18536,0.000125,74.125.130.0-255,1484,15674,63,186318
18537,0.000126,172.31.40.0-255,66,15740,63,186318
18538,0.000132,74.125.130.0-255,2902,18642,63,186318
18539,0.000133,172.31.40.0-255,66,18708,63,186318
18540,0.000164,74.125.130.0-255,5738,24446,63,186318
18541,0.000166,172.31.40.0-255,66,24512,63,186318
18542,0.00017,74.125.130.0-255,2902,27414,63,186318
18543,0.000172,172.31.40.0-255,66,27480,63,186318
18544,0.000176,74.125.130.0-255,3961,31441,63,186318
18545,0.000182,172.31.40.0-255,66,31507,63,186318
18546,0.000305,74.125.130.0-255,1484,32991,63,186318
18547,0.000309,172.31.40.0-255,66,33057,63,186318
18548,0.000312,74.125.130.0-255,1484,34541,63,186318
18549,0.000314,172.31.40.0-255,66,34607,63,186318
18550,0.000337,74.125.130.0-255,2902,37509,63,186318
18551,0.00034,172.31.40.0-255,66,37575,63,186318
18552,0.000346,74.125.130.0-255,5738,43313,63,186318
18553,0.000348,172.31.40.0-255,66,43379,63,186318
18554,0.000385,74.125.130.0-255,4320,47699,63,186318
18555,0.000388,172.31.40.0-255,66,47765,63,186318
18556,0.000393,74.125.130.0-255,5379,53144,63,186318
18557,0.000395,172.31.40.0-255,66,53210,63,186318
18558,0.000421,74.125.130.0-255,4320,57530,63,186318
18559,0.000423,172.31.40.0-255,66,57596,63,186318
18560,0.000446,74.125.130.0-255,2902,60498,63,186318
18561,0.000448,172.31.40.0-255,66,60564,63,186318
18562,0.000475,74.125.130.0-255,5379,65943,63,186318
18563,0.000477,172.31.40.0-255,66,66009,63,186318
18564,0.000512,74.125.130.0-255,361,66370,63,186318
18565,0.000551,74.125.130.0-255,382,66752,63,186318
18566,0.00078,74.125.130.0-255,1484,68236,63,186318
18567,0.000785,172.31.40.0-255,66,68302,63,186318
18568,0.000791,74.125.130.0-255,2902,71204,63,186318
18569,0.000793,172.31.40.0-255,66,71270,63,186318
18570,0.00083,74.125.130.0-255,5738,77008,63,186318
18571,0.000833,172.31.40.0-255,66,77074,63,186318
18572,0.000837,74.125.130.0-255,1484,78558,63,186318
18573,0.000841,74.125.130.0-255,2902,81460,63,186318
18574,0.000843,172.31.40.0-255,66,81526,63,186318
18575,0.00085,74.125.130.0-255,5738,87264,63,186318
18576,0.000852,172.31.40.0-255,66,87330,63,186318
18577,0.000874,74.125.130.0-255,4320,91650,63,186318
18578,0.000876,172.31.40.0-255,66,91716,63,186318
18579,0.000904,74.125.130.0-255,4320,96036,63,186318
18580,0.000907,172.31.40.0-255,66,96102,63,186318
18581,0.000921,74.125.130.0-255,2902,99004,63,186318
18582,0.000923,172.31.40.0-255,66,99070,63,186318
18583,0.000943,74.125.130.0-255,2184,101254,63,186318
18584,0.000946,172.31.40.0-255,66,101320,63,186318
18585,0.001568,74.125.130.0-255,1484,102804,63,186318
18586,0.001581,74.125.130.0-255,2902,105706,63,186318
18587,0.001585,172.31.40.0-255,66,105772,63,186318
18588,0.001592,74.125.130.0-255,4320,110092,63,186318
18589,0.001594,172.31.40.0-255,66,110158,63,186318
18590,0.00164,74.125.130.0-255,2902,113060,63,186318
18591,0.001642,172.31.40.0-255,66,113126,63,186318
18592,0.001676,74.125.130.0-255,2902,116028,63,186318
18593,0.001679,172.31.40.0-255,66,116094,63,186318
18594,0.001687,74.125.130.0-255,7156,123250,63,186318
18595,0.001689,172.31.40.0-255,66,123316,63,186318
18596,0.0017,172.31.40.0-255,66,123382,63,186318
18597,0.001705,74.125.130.0-255,3602,126984,63,186318
18598,0.001707,172.31.40.0-255,66,127050,63,186318
18599,0.00188,74.125.130.0-255,1484,128534,63,186318
18600,0.001886,74.125.130.0-255,1484,130018,63,186318
18601,0.00189,172.31.40.0-255,66,130084,63,186318
18602,0.001902,74.125.130.0-255,1484,131568,63,186318
18603,0.001913,74.125.130.0-255,5738,137306,63,186318
18604,0.001916,172.31.40.0-255,66,137372,63,186318
18605,0.001967,172.31.40.0-255,66,137438,63,186318
18606,0.001994,74.125.130.0-255,1484,138922,63,186318
18607,0.002008,172.31.40.0-255,66,138988,63,186318
18608,0.002013,74.125.130.0-255,2184,141172,63,186318
18609,0.002014,172.31.40.0-255,66,141238,63,186318
18610,0.004022,74.125.130.0-255,5738,146976,63,186318
18611,0.00403,172.31.40.0-255,66,147042,63,186318
18612,0.00604,74.125.130.0-255,4320,151362,63,186318
18613,0.006044,172.31.40.0-255,66,151428,63,186318
18614,0.006073,74.125.130.0-255,1484,152912,63,186318
18615,0.008056,74.125.130.0-255,4320,157232,63,186318
18616,0.008063,172.31.40.0-255,66,157298,63,186318
18617,0.010086,74.125.130.0-255,5738,163036,63,186318
18618,0.010095,172.31.40.0-255,66,163102,63,186318
18619,0.01212,74.125.130.0-255,5738,168840,63,186318
18620,0.012128,172.31.40.0-255,66,168906,63,186318
18621,0.014153,74.125.130.0-255,5738,174644,63,186318
18622,0.01416,172.31.40.0-255,66,174710,63,186318
18623,0.016183,74.125.130.0-255,5738,180448,63,186318
18624,0.016192,172.31.40.0-255,66,180514,63,186318
18625,0.018209,74.125.130.0-255,5738,186252,63,186318
18626,0.018215,172.31.40.0-255,66,186318,63,186318
18627,0.0,172.217.194.0-255,150,150,63,143483
18628,1.4e-05,172.31.40.0-255,66,216,63,143483
18629,2e-05,172.217.194.0-255,1484,1700,63,143483
18630,2.4e-05,172.31.40.0-255,66,1766,63,143483
18631,3.1e-05,172.217.194.0-255,2902,4668,63,143483
18632,4.3e-05,172.31.40.0-255,66,4734,63,143483
18633,4.9e-05,172.217.194.0-255,5738,10472,63,143483
18634,5.2e-05,172.31.40.0-255,66,10538,63,143483
18635,9.4e-05,172.31.40.0-255,66,10604,63,143483
18636,0.000119,172.217.194.0-255,2902,13506,63,143483
18637,0.000121,172.31.40.0-255,66,13572,63,143483
18638,0.000145,172.217.194.0-255,5738,19310,63,143483
18639,0.000152,172.31.40.0-255,66,19376,63,143483
18640,0.000157,172.217.194.0-255,3961,23337,63,143483
18641,0.000159,172.31.40.0-255,66,23403,63,143483
18642,0.000204,172.217.194.0-255,1484,24887,63,143483
18643,0.000208,172.31.40.0-255,66,24953,63,143483
18644,0.000211,172.217.194.0-255,1484,26437,63,143483
18645,0.000213,172.31.40.0-255,66,26503,63,143483
18646,0.000233,172.217.194.0-255,1484,27987,63,143483
18647,0.000235,172.31.40.0-255,66,28053,63,143483
18648,0.000246,172.217.194.0-255,5738,33791,63,143483
18649,0.000248,172.31.40.0-255,66,33857,63,143483
18650,0.000272,172.217.194.0-255,1484,35341,63,143483
18651,0.000275,172.31.40.0-255,66,35407,63,143483
18652,0.000301,172.217.194.0-255,5379,40786,63,143483
18653,0.000308,172.31.40.0-255,66,40852,63,143483
18654,0.00084,172.217.194.0-255,1484,42336,63,143483
18655,0.000846,172.217.194.0-255,2902,45238,63,143483
18656,0.000854,172.31.40.0-255,66,45304,63,143483
18657,0.000858,172.31.40.0-255,66,45370,63,143483
18658,0.000876,172.217.194.0-255,5738,51108,63,143483
18659,0.000878,172.31.40.0-255,66,51174,63,143483
18660,0.000896,172.217.194.0-255,4320,55494,63,143483
18661,0.000898,172.31.40.0-255,66,55560,63,143483
18662,0.000928,172.217.194.0-255,3123,58683,63,143483
18663,0.000931,172.31.40.0-255,66,58749,63,143483
18664,0.001103,172.217.194.0-255,1484,60233,63,143483
18665,0.001109,172.217.194.0-255,2902,63135,63,143483
18666,0.001112,172.31.40.0-255,66,63201,63,143483
18667,0.001142,172.217.194.0-255,5738,68939,63,143483
18668,0.001145,172.31.40.0-255,66,69005,63,143483
18669,0.001153,172.217.194.0-255,6797,75802,63,143483
18670,0.001155,172.31.40.0-255,66,75868,63,143483
18671,0.001192,172.217.194.0-255,1484,77352,63,143483
18672,0.001198,172.217.194.0-255,2902,80254,63,143483
18673,0.0012,172.31.40.0-255,66,80320,63,143483
18674,0.001207,172.217.194.0-255,5738,86058,63,143483
18675,0.001209,172.31.40.0-255,66,86124,63,143483
18676,0.001251,172.217.194.0-255,6797,92921,63,143483
18677,0.001254,172.31.40.0-255,66,92987,63,143483
18678,0.002129,172.217.194.0-255,1484,94471,63,143483
18679,0.002139,172.217.194.0-255,2902,97373,63,143483
18680,0.002144,172.31.40.0-255,66,97439,63,143483
18681,0.002152,172.217.194.0-255,5738,103177,63,143483
18682,0.002154,172.31.40.0-255,66,103243,63,143483
18683,0.002173,172.31.40.0-255,66,103309,63,143483
18684,0.002186,172.31.40.0-255,66,103375,63,143483
18685,0.002188,172.217.194.0-255,766,104141,63,143483
18686,0.00248,172.31.40.0-255,66,104207,63,143483
18687,0.004469,172.217.194.0-255,4320,108527,63,143483
18688,0.004475,172.31.40.0-255,66,108593,63,143483
18689,0.004757,172.217.194.0-255,1484,110077,63,143483
18690,0.006753,172.217.194.0-255,4320,114397,63,143483
18691,0.006759,172.31.40.0-255,66,114463,63,143483
18692,0.009048,172.217.194.0-255,5738,120201,63,143483
18693,0.009055,172.31.40.0-255,66,120267,63,143483
18694,0.011342,172.217.194.0-255,5738,126005,63,143483
18695,0.01135,172.31.40.0-255,66,126071,63,143483
18696,0.013627,172.217.194.0-255,5738,131809,63,143483
18697,0.013635,172.31.40.0-255,66,131875,63,143483
18698,0.015904,172.217.194.0-255,5738,137613,63,143483
18699,0.015912,172.31.40.0-255,66,137679,63,143483
18700,0.018187,172.217.194.0-255,5738,143417,63,143483
18701,0.018196,172.31.40.0-255,66,143483,63,143483
18702,0.0,172.217.24.0-255,153,153,63,147650
18703,2.1e-05,172.31.40.0-255,66,219,63,147650
18704,2.8e-05,172.217.24.0-255,1484,1703,63,147650
18705,3.2e-05,172.31.40.0-255,66,1769,63,147650
18706,3.7e-05,172.217.24.0-255,2902,4671,63,147650
18707,4e-05,172.31.40.0-255,66,4737,63,147650
18708,4.5e-05,172.217.24.0-255,4320,9057,63,147650
18709,4.7e-05,172.31.40.0-255,66,9123,63,147650
18710,7.4e-05,172.217.24.0-255,1484,10607,63,147650
18711,7.7e-05,172.31.40.0-255,66,10673,63,147650
18712,0.000105,172.217.24.0-255,7156,17829,63,147650
18713,0.000107,172.31.40.0-255,66,17895,63,147650
18714,0.000129,172.217.24.0-255,4828,22723,63,147650
18715,0.000135,172.31.40.0-255,66,22789,63,147650
18716,0.000145,172.31.40.0-255,66,22855,63,147650
18717,0.000196,172.217.24.0-255,1484,24339,63,147650
18718,0.000198,172.31.40.0-255,66,24405,63,147650
18719,0.000202,172.217.24.0-255,1484,25889,63,147650
18720,0.000203,172.31.40.0-255,66,25955,63,147650
18721,0.000235,172.217.24.0-255,1484,27439,63,147650
18722,0.000237,172.31.40.0-255,66,27505,63,147650
18723,0.000243,172.217.24.0-255,4320,31825,63,147650
18724,0.000245,172.31.40.0-255,66,31891,63,147650
18725,0.00025,172.217.24.0-255,5738,37629,63,147650
18726,0.000252,172.31.40.0-255,66,37695,63,147650
18727,0.000313,172.31.40.0-255,66,37761,63,147650
18728,0.00032,172.217.24.0-255,6797,44558,63,147650
18729,0.000322,172.31.40.0-255,66,44624,63,147650
18730,0.00033,172.217.24.0-255,395,45019,63,147650
18731,0.000333,172.31.40.0-255,66,45085,63,147650
18732,0.001183,172.217.24.0-255,348,45433,63,147650
18733,0.00121,172.31.40.0-255,66,45499,63,147650
18734,0.001329,172.217.24.0-255,1484,46983,63,147650
18735,0.001337,172.217.24.0-255,2902,49885,63,147650
18736,0.001341,172.31.40.0-255,66,49951,63,147650
18737,0.001346,172.217.24.0-255,1484,51435,63,147650
18738,0.001372,172.217.24.0-255,1484,52919,63,147650
18739,0.001376,172.31.40.0-255,66,52985,63,147650
18740,0.001382,172.217.24.0-255,4320,57305,63,147650
18741,0.001384,172.31.40.0-255,66,57371,63,147650
18742,0.001387,172.217.24.0-255,1484,58855,63,147650
18743,0.001422,172.31.40.0-255,66,58921,63,147650
18744,0.00144,172.31.40.0-255,66,58987,63,147650
18745,0.001469,172.217.24.0-255,2543,61530,63,147650
18746,0.001472,172.31.40.0-255,66,61596,63,147650
18747,0.001712,172.217.24.0-255,1484,63080,63,147650
18748,0.00172,172.217.24.0-255,2902,65982,63,147650
18749,0.001724,172.31.40.0-255,66,66048,63,147650
18750,0.001731,172.217.24.0-255,5738,71786,63,147650
18751,0.001733,172.31.40.0-255,66,71852,63,147650
18752,0.001765,172.31.40.0-255,66,71918,63,147650
18753,0.001784,172.217.24.0-255,2902,74820,63,147650
18754,0.001787,172.31.40.0-255,66,74886,63,147650
18755,0.001796,172.31.40.0-255,66,74952,63,147650
18756,0.00183,172.217.24.0-255,3602,78554,63,147650
18757,0.001833,172.31.40.0-255,66,78620,63,147650
18758,0.001867,172.217.24.0-255,1484,80104,63,147650
18759,0.001894,172.217.24.0-255,2902,83006,63,147650
18760,0.001897,172.31.40.0-255,66,83072,63,147650
18761,0.001903,172.217.24.0-255,5738,88810,63,147650
18762,0.001905,172.31.40.0-255,66,88876,63,147650
18763,0.001939,172.31.40.0-255,66,88942,63,147650
18764,0.001949,172.31.40.0-255,66,89008,63,147650
18765,0.001978,172.217.24.0-255,2902,91910,63,147650
18766,0.001981,172.31.40.0-255,66,91976,63,147650
18767,0.001989,172.217.24.0-255,2184,94160,63,147650
18768,0.001991,172.31.40.0-255,66,94226,63,147650
18769,0.003919,172.217.24.0-255,2902,97128,63,147650
18770,0.003924,172.31.40.0-255,66,97194,63,147650
18771,0.003958,172.217.24.0-255,2902,100096,63,147650
18772,0.003961,172.31.40.0-255,66,100162,63,147650
18773,0.005856,172.217.24.0-255,2902,103064,63,147650
18774,0.005862,172.31.40.0-255,66,103130,63,147650
18775,0.00589,172.217.24.0-255,2902,106032,63,147650
18776,0.005893,172.31.40.0-255,66,106098,63,147650
18777,0.00781,172.217.24.0-255,2902,109000,63,147650
18778,0.007817,172.31.40.0-255,66,109066,63,147650
18779,0.007845,172.217.24.0-255,2902,111968,63,147650
18780,0.007848,172.31.40.0-255,66,112034,63,147650
18781,0.009759,172.217.24.0-255,2902,114936,63,147650
18782,0.009766,172.31.40.0-255,66,115002,63,147650
18783,0.00981,172.217.24.0-255,2902,117904,63,147650
18784,0.009814,172.31.40.0-255,66,117970,63,147650
18785,0.011708,172.217.24.0-255,2902,120872,63,147650
18786,0.011716,172.31.40.0-255,66,120938,63,147650
18787,0.01175,172.217.24.0-255,2902,123840,63,147650
18788,0.011753,172.31.40.0-255,66,123906,63,147650
18789,0.013676,172.217.24.0-255,2902,126808,63,147650
18790,0.013688,172.31.40.0-255,66,126874,63,147650
18791,0.013716,172.217.24.0-255,2902,129776,63,147650
18792,0.01372,172.31.40.0-255,66,129842,63,147650
18793,0.015623,172.217.24.0-255,2902,132744,63,147650
18794,0.01563,172.31.40.0-255,66,132810,63,147650
18795,0.015643,172.217.24.0-255,2902,135712,63,147650
18796,0.015651,172.31.40.0-255,66,135778,63,147650
18797,0.017563,172.217.24.0-255,2902,138680,63,147650
18798,0.017569,172.31.40.0-255,66,138746,63,147650
18799,0.017606,172.217.24.0-255,2902,141648,63,147650
18800,0.01761,172.31.40.0-255,66,141714,63,147650
18801,0.019509,172.217.24.0-255,2902,144616,63,147650
18802,0.019515,172.31.40.0-255,66,144682,63,147650
18803,0.019546,172.217.24.0-255,2902,147584,63,147650
18804,0.019549,172.31.40.0-255,66,147650,63,147650
18805,0.0,172.217.194.0-255,146,146,63,77903
18806,2.9e-05,172.31.40.0-255,66,212,63,77903
18807,3.7e-05,172.217.194.0-255,1484,1696,63,77903
18808,4.2e-05,172.31.40.0-255,66,1762,63,77903
18809,5.2e-05,172.217.194.0-255,2902,4664,63,77903
18810,5.8e-05,172.31.40.0-255,66,4730,63,77903
18811,6.5e-05,172.217.194.0-255,7156,11886,63,77903
18812,6.9e-05,172.31.40.0-255,66,11952,63,77903
18813,7.2e-05,172.217.194.0-255,1484,13436,63,77903
18814,7.6e-05,172.31.40.0-255,66,13502,63,77903
18815,0.000112,172.31.40.0-255,66,13568,63,77903
18816,0.000123,172.31.40.0-255,66,13634,63,77903
18817,0.000166,172.217.194.0-255,5738,19372,63,77903
18818,0.000169,172.31.40.0-255,66,19438,63,77903
18819,0.00019,172.31.40.0-255,66,19504,63,77903
18820,0.001175,172.217.194.0-255,1484,20988,63,77903
18821,0.001185,172.31.40.0-255,66,21054,63,77903
18822,0.001196,172.217.194.0-255,2902,23956,63,77903
18823,0.001199,172.31.40.0-255,66,24022,63,77903
18824,0.001206,172.217.194.0-255,5738,29760,63,77903
18825,0.001209,172.31.40.0-255,66,29826,63,77903
18826,0.001232,172.217.194.0-255,2902,32728,63,77903
18827,0.001235,172.31.40.0-255,66,32794,63,77903
18828,0.001258,172.217.194.0-255,4283,37077,63,77903
18829,0.001261,172.31.40.0-255,66,37143,63,77903
18830,0.003561,172.217.194.0-255,1484,38627,63,77903
18831,0.003578,172.31.40.0-255,66,38693,63,77903
18832,0.00362,172.217.194.0-255,4320,43013,63,77903
18833,0.003623,172.31.40.0-255,66,43079,63,77903
18834,0.005941,172.217.194.0-255,5738,48817,63,77903
18835,0.005953,172.31.40.0-255,66,48883,63,77903
18836,0.008304,172.217.194.0-255,5738,54621,63,77903
18837,0.008319,172.31.40.0-255,66,54687,63,77903
18838,0.0107,172.217.194.0-255,5738,60425,63,77903
18839,0.010718,172.31.40.0-255,66,60491,63,77903
18840,0.013076,172.217.194.0-255,5738,66229,63,77903
18841,0.013095,172.31.40.0-255,66,66295,63,77903
18842,0.015428,172.217.194.0-255,5738,72033,63,77903
18843,0.015446,172.31.40.0-255,66,72099,63,77903
18844,0.017814,172.217.194.0-255,5738,77837,63,77903
18845,0.017833,172.31.40.0-255,66,77903,63,77903
18846,0.0,172.217.194.0-255,150,150,63,147444
18847,2.3e-05,172.31.40.0-255,66,216,63,147444
18848,3e-05,172.217.194.0-255,1484,1700,63,147444
18849,3.4e-05,172.31.40.0-255,66,1766,63,147444
18850,3.9e-05,172.217.194.0-255,2902,4668,63,147444
18851,4.2e-05,172.31.40.0-255,66,4734,63,147444
18852,5e-05,172.217.194.0-255,7156,11890,63,147444
18853,6e-05,172.31.40.0-255,66,11956,63,147444
18854,6.4e-05,172.217.194.0-255,2029,13985,63,147444
18855,6.7e-05,172.31.40.0-255,66,14051,63,147444
18856,0.00011,172.31.40.0-255,66,14117,63,147444
18857,0.000118,172.217.194.0-255,5379,19496,63,147444
18858,0.000123,172.31.40.0-255,66,19562,63,147444
18859,0.000758,172.217.194.0-255,1484,21046,63,147444
18860,0.000765,172.31.40.0-255,66,21112,63,147444
18861,0.000775,172.217.194.0-255,2902,24014,63,147444
18862,0.000778,172.31.40.0-255,66,24080,63,147444
18863,0.000791,172.217.194.0-255,5738,29818,63,147444
18864,0.000795,172.31.40.0-255,66,29884,63,147444
18865,0.000833,172.31.40.0-255,66,29950,63,147444
18866,0.000844,172.31.40.0-255,66,30016,63,147444
18867,0.000881,172.217.194.0-255,7089,37105,63,147444
18868,0.000884,172.31.40.0-255,66,37171,63,147444
18869,0.001097,172.217.194.0-255,363,37534,63,147444
18870,0.001104,172.31.40.0-255,66,37600,63,147444
18871,0.001235,172.217.194.0-255,1484,39084,63,147444
18872,0.00124,172.31.40.0-255,66,39150,63,147444
18873,0.001246,172.217.194.0-255,2902,42052,63,147444
18874,0.001248,172.31.40.0-255,66,42118,63,147444
18875,0.001254,172.217.194.0-255,5738,47856,63,147444
18876,0.001261,172.31.40.0-255,66,47922,63,147444
18877,0.001301,172.31.40.0-255,66,47988,63,147444
18878,0.001326,172.217.194.0-255,1484,49472,63,147444
18879,0.001341,172.217.194.0-255,7156,56628,63,147444
18880,0.001347,172.31.40.0-255,66,56694,63,147444
18881,0.001354,172.217.194.0-255,2184,58878,63,147444
18882,0.001356,172.217.194.0-255,1484,60362,63,147444
18883,0.00136,172.31.40.0-255,66,60428,63,147444
18884,0.001388,172.217.194.0-255,5738,66166,63,147444
18885,0.001411,172.217.194.0-255,7156,73322,63,147444
18886,0.001415,172.31.40.0-255,66,73388,63,147444
18887,0.001428,172.217.194.0-255,2902,76290,63,147444
18888,0.001443,172.31.40.0-255,66,76356,63,147444
18889,0.001452,172.217.194.0-255,6438,82794,63,147444
18890,0.001456,172.31.40.0-255,66,82860,63,147444
18891,0.00161,172.217.194.0-255,1484,84344,63,147444
18892,0.001624,172.217.194.0-255,2902,87246,63,147444
18893,0.001626,172.31.40.0-255,66,87312,63,147444
18894,0.001629,172.217.194.0-255,1484,88796,63,147444
18895,0.001655,172.217.194.0-255,4320,93116,63,147444
18896,0.001661,172.217.194.0-255,7156,100272,63,147444
18897,0.00167,172.31.40.0-255,66,100338,63,147444
18898,0.001694,172.217.194.0-255,5738,106076,63,147444
18899,0.001718,172.31.40.0-255,66,106142,63,147444
18900,0.001741,172.217.194.0-255,1484,107626,63,147444
18901,0.001753,172.217.194.0-255,2902,110528,63,147444
18902,0.001799,172.217.194.0-255,5738,116266,63,147444
18903,0.001809,172.31.40.0-255,66,116332,63,147444
18904,0.001814,172.31.40.0-255,66,116398,63,147444
18905,0.001837,172.217.194.0-255,5738,122136,63,147444
18906,0.001848,172.31.40.0-255,66,122202,63,147444
18907,0.001876,172.217.194.0-255,1484,123686,63,147444
18908,0.00191,172.217.194.0-255,2902,126588,63,147444
18909,0.001912,172.31.40.0-255,66,126654,63,147444
18910,0.001918,172.31.40.0-255,66,126720,63,147444
18911,0.001992,172.217.194.0-255,7156,133876,63,147444
18912,0.001998,172.31.40.0-255,66,133942,63,147444
18913,0.002008,172.217.194.0-255,7156,141098,63,147444
18914,0.002012,172.31.40.0-255,66,141164,63,147444
18915,0.002038,172.217.194.0-255,766,141930,63,147444
18916,0.002069,172.31.40.0-255,66,141996,63,147444
18917,0.002086,172.217.194.0-255,4320,146316,63,147444
18918,0.002099,172.31.40.0-255,66,146382,63,147444
18919,0.002195,172.31.40.0-255,66,146448,63,147444
18920,0.00225,172.217.194.0-255,105,146553,63,147444
18921,0.002252,172.217.194.0-255,129,146682,63,147444
18922,0.002271,172.31.40.0-255,66,146748,63,147444
18923,0.003973,172.31.40.0-255,105,146853,63,147444
18924,0.004004,172.31.40.0-255,105,146958,63,147444
18925,0.004162,172.31.40.0-255,90,147048,63,147444
18926,0.004169,172.31.40.0-255,66,147114,63,147444
18927,0.006512,172.217.194.0-255,66,147180,63,147444
18928,0.00653,172.217.194.0-255,66,147246,63,147444
18929,0.006715,172.217.194.0-255,66,147312,63,147444
18930,0.006739,172.217.194.0-255,66,147378,63,147444
18931,0.006746,172.31.40.0-255,66,147444,63,147444
18932,0.0,172.31.40.0-255,105,105,63,276
18933,0.001825,157.240.24.0-255,105,210,63,276
18934,0.001839,172.31.40.0-255,66,276,63,276
18935,0.0,74.125.24.0-255,297,297,63,145871
18936,1.6e-05,172.31.40.0-255,66,363,63,145871
18937,2.3e-05,74.125.24.0-255,1484,1847,63,145871
18938,2.8e-05,172.31.40.0-255,66,1913,63,145871
18939,3.5e-05,74.125.24.0-255,4320,6233,63,145871
18940,3.9e-05,172.31.40.0-255,66,6299,63,145871
18941,7.1e-05,74.125.24.0-255,2902,9201,63,145871
18942,7.4e-05,172.31.40.0-255,66,9267,63,145871
18943,0.00011,74.125.24.0-255,4755,14022,63,145871
18944,0.000114,172.31.40.0-255,66,14088,63,145871
18945,0.000171,74.125.24.0-255,1484,15572,63,145871
18946,0.000174,172.31.40.0-255,66,15638,63,145871
18947,0.00019,74.125.24.0-255,2902,18540,63,145871
18948,0.000193,172.31.40.0-255,66,18606,63,145871
18949,0.000225,74.125.24.0-255,5738,24344,63,145871
18950,0.000228,172.31.40.0-255,66,24410,63,145871
18951,0.0003,74.125.24.0-255,6797,31207,63,145871
18952,0.000304,172.31.40.0-255,66,31273,63,145871
18953,0.000431,74.125.24.0-255,1484,32757,63,145871
18954,0.000436,172.31.40.0-255,66,32823,63,145871
18955,0.000441,74.125.24.0-255,2902,35725,63,145871
18956,0.000444,172.31.40.0-255,66,35791,63,145871
18957,0.000466,74.125.24.0-255,1484,37275,63,145871
18958,0.00047,172.31.40.0-255,66,37341,63,145871
18959,0.000484,74.125.24.0-255,2902,40243,63,145871
18960,0.000486,172.31.40.0-255,66,40309,63,145871
18961,0.000515,74.125.24.0-255,1484,41793,63,145871
18962,0.000517,172.31.40.0-255,66,41859,63,145871
18963,0.000536,74.125.24.0-255,4320,46179,63,145871
18964,0.000539,172.31.40.0-255,66,46245,63,145871
18965,0.000595,74.125.24.0-255,2543,48788,63,145871
18966,0.000597,172.31.40.0-255,66,48854,63,145871
18967,0.000624,74.125.24.0-255,1484,50338,63,145871
18968,0.000643,74.125.24.0-255,2902,53240,63,145871
18969,0.000659,74.125.24.0-255,2902,56142,63,145871
18970,0.000828,172.31.40.0-255,66,56208,63,145871
18971,0.000993,74.125.24.0-255,411,56619,63,145871
18972,0.001177,74.125.24.0-255,1484,58103,63,145871
18973,0.001191,74.125.24.0-255,2902,61005,63,145871
18974,0.001195,172.31.40.0-255,66,61071,63,145871
18975,0.001204,172.31.40.0-255,66,61137,63,145871
18976,0.001212,74.125.24.0-255,1484,62621,63,145871
18977,0.001228,74.125.24.0-255,1484,64105,63,145871
18978,0.001236,172.31.40.0-255,66,64171,63,145871
18979,0.001265,74.125.24.0-255,4320,68491,63,145871
18980,0.001268,172.31.40.0-255,66,68557,63,145871
18981,0.001283,74.125.24.0-255,2902,71459,63,145871
18982,0.001303,172.31.40.0-255,66,71525,63,145871
18983,0.001356,172.31.40.0-255,66,71591,63,145871
18984,0.001377,74.125.24.0-255,5738,77329,63,145871
18985,0.00139,172.31.40.0-255,66,77395,63,145871
18986,0.00153,74.125.24.0-255,5020,82415,63,145871
18987,0.001534,172.31.40.0-255,66,82481,63,145871
18988,0.001598,74.125.24.0-255,2902,85383,63,145871
18989,0.001617,172.31.40.0-255,66,85449,63,145871
18990,0.001641,172.31.40.0-255,66,85515,63,145871
18991,0.001876,74.125.24.0-255,7156,92671,63,145871
18992,0.00188,172.31.40.0-255,66,92737,63,145871
18993,0.001898,74.125.24.0-255,5020,97757,63,145871
18994,0.001918,172.31.40.0-255,66,97823,63,145871
18995,0.002023,74.125.24.0-255,5738,103561,63,145871
18996,0.002042,172.31.40.0-255,66,103627,63,145871
18997,0.00206,172.31.40.0-255,66,103693,63,145871
18998,0.002103,172.31.40.0-255,66,103759,63,145871
18999,0.002454,74.125.24.0-255,7156,110915,63,145871
19000,0.00246,172.31.40.0-255,66,110981,63,145871
19001,0.002507,172.31.40.0-255,66,111047,63,145871
19002,0.004763,74.125.24.0-255,5738,116785,63,145871
19003,0.004771,172.31.40.0-255,66,116851,63,145871
19004,0.007047,74.125.24.0-255,5738,122589,63,145871
19005,0.009083,172.31.40.0-255,66,122655,63,145871
19006,0.011354,74.125.24.0-255,5738,128393,63,145871
19007,0.011363,172.31.40.0-255,66,128459,63,145871
19008,0.01363,74.125.24.0-255,5738,134197,63,145871
19009,0.013638,172.31.40.0-255,66,134263,63,145871
19010,0.015955,74.125.24.0-255,5738,140001,63,145871
19011,0.015963,172.31.40.0-255,66,140067,63,145871
19012,0.01826,74.125.24.0-255,5738,145805,63,145871
19013,0.018269,172.31.40.0-255,66,145871,63,145871
19014,0.0,172.217.194.0-255,153,153,63,123830
19015,2.1e-05,172.31.40.0-255,66,219,63,123830
19016,2.8e-05,172.217.194.0-255,1484,1703,63,123830
19017,3.3e-05,172.31.40.0-255,66,1769,63,123830
19018,3.9e-05,172.217.194.0-255,2902,4671,63,123830
19019,4.9e-05,172.31.40.0-255,66,4737,63,123830
19020,5.7e-05,172.217.194.0-255,7156,11893,63,123830
19021,6e-05,172.31.40.0-255,66,11959,63,123830
19022,7.2e-05,172.31.40.0-255,66,12025,63,123830
19023,0.000117,172.31.40.0-255,66,12091,63,123830
19024,0.000162,172.217.194.0-255,1484,13575,63,123830
19025,0.000164,172.31.40.0-255,66,13641,63,123830
19026,0.000169,172.217.194.0-255,2902,16543,63,123830
19027,0.000192,172.31.40.0-255,66,16609,63,123830
19028,0.000199,172.217.194.0-255,5738,22347,63,123830
19029,0.000203,172.31.40.0-255,66,22413,63,123830
19030,0.00021,172.217.194.0-255,6797,29210,63,123830
19031,0.000213,172.31.40.0-255,66,29276,63,123830
19032,0.00054,172.217.194.0-255,1484,30760,63,123830
19033,0.000545,172.31.40.0-255,66,30826,63,123830
19034,0.000551,172.217.194.0-255,2902,33728,63,123830
19035,0.000553,172.31.40.0-255,66,33794,63,123830
19036,0.00056,172.217.194.0-255,5738,39532,63,123830
19037,0.000563,172.31.40.0-255,66,39598,63,123830
19038,0.000574,172.217.194.0-255,6797,46395,63,123830
19039,0.000577,172.31.40.0-255,66,46461,63,123830
19040,0.000615,172.217.194.0-255,1484,47945,63,123830
19041,0.000618,172.31.40.0-255,66,48011,63,123830
19042,0.00065,172.217.194.0-255,2902,50913,63,123830
19043,0.000654,172.31.40.0-255,66,50979,63,123830
19044,0.00066,172.217.194.0-255,5738,56717,63,123830
19045,0.000662,172.31.40.0-255,66,56783,63,123830
19046,0.000705,172.31.40.0-255,66,56849,63,123830
19047,0.000708,172.217.194.0-255,1484,58333,63,123830
19048,0.000712,172.217.194.0-255,1484,59817,63,123830
19049,0.000714,172.31.40.0-255,66,59883,63,123830
19050,0.000733,172.217.194.0-255,1484,61367,63,123830
19051,0.000744,172.217.194.0-255,5738,67105,63,123830
19052,0.000746,172.31.40.0-255,66,67171,63,123830
19053,0.000784,172.217.194.0-255,4320,71491,63,123830
19054,0.000786,172.31.40.0-255,66,71557,63,123830
19055,0.000804,172.217.194.0-255,2543,74100,63,123830
19056,0.000807,172.31.40.0-255,66,74166,63,123830
19057,0.001657,172.217.194.0-255,1484,75650,63,123830
19058,0.001666,172.217.194.0-255,2902,78552,63,123830
19059,0.00167,172.31.40.0-255,66,78618,63,123830
19060,0.001677,172.217.194.0-255,5738,84356,63,123830
19061,0.001678,172.31.40.0-255,66,84422,63,123830
19062,0.001734,172.31.40.0-255,66,84488,63,123830
19063,0.001774,172.31.40.0-255,66,84554,63,123830
19064,0.004145,172.217.194.0-255,5738,90292,63,123830
19065,0.004151,172.31.40.0-255,66,90358,63,123830
19066,0.006513,172.217.194.0-255,4320,94678,63,123830
19067,0.006519,172.31.40.0-255,66,94744,63,123830
19068,0.006536,172.217.194.0-255,1484,96228,63,123830
19069,0.008897,172.217.194.0-255,4320,100548,63,123830
19070,0.008903,172.31.40.0-255,66,100614,63,123830
19071,0.011331,172.217.194.0-255,5738,106352,63,123830
19072,0.01134,172.31.40.0-255,66,106418,63,123830
19073,0.013713,172.217.194.0-255,5738,112156,63,123830
19074,0.013724,172.31.40.0-255,66,112222,63,123830
19075,0.016124,172.217.194.0-255,5738,117960,63,123830
19076,0.016133,172.31.40.0-255,66,118026,63,123830
19077,0.018548,172.217.194.0-255,5738,123764,63,123830
19078,0.018555,172.31.40.0-255,66,123830,63,123830
19079,0.0,172.217.194.0-255,152,152,63,146415
19080,2e-05,172.31.40.0-255,66,218,63,146415
19081,2.7e-05,172.217.194.0-255,1484,1702,63,146415
19082,3.1e-05,172.31.40.0-255,66,1768,63,146415
19083,3.7e-05,172.217.194.0-255,2902,4670,63,146415
19084,4e-05,172.31.40.0-255,66,4736,63,146415
19085,4.7e-05,172.217.194.0-255,7156,11892,63,146415
19086,5.1e-05,172.31.40.0-255,66,11958,63,146415
19087,5.5e-05,172.217.194.0-255,2092,14050,63,146415
19088,5.8e-05,172.31.40.0-255,66,14116,63,146415
19089,6.1e-05,172.217.194.0-255,1484,15600,63,146415
19090,6.4e-05,172.31.40.0-255,66,15666,63,146415
19091,0.000105,172.31.40.0-255,66,15732,63,146415
19092,0.000118,172.31.40.0-255,66,15798,63,146415
19093,0.000136,172.217.194.0-255,1484,17282,63,146415
19094,0.000139,172.31.40.0-255,66,17348,63,146415
19095,0.000142,172.217.194.0-255,1484,18832,63,146415
19096,0.000144,172.31.40.0-255,66,18898,63,146415
19097,0.000181,172.31.40.0-255,66,18964,63,146415
19098,0.000212,172.31.40.0-255,66,19030,63,146415
19099,0.001009,172.217.194.0-255,366,19396,63,146415
19100,0.001015,172.31.40.0-255,66,19462,63,146415
19101,0.001282,172.217.194.0-255,1484,20946,63,146415
19102,0.001288,172.31.40.0-255,66,21012,63,146415
19103,0.001295,172.217.194.0-255,2902,23914,63,146415
19104,0.001297,172.31.40.0-255,66,23980,63,146415
19105,0.001303,172.217.194.0-255,5738,29718,63,146415
19106,0.001305,172.31.40.0-255,66,29784,63,146415
19107,0.001312,172.217.194.0-255,5738,35522,63,146415
19108,0.001314,172.31.40.0-255,66,35588,63,146415
19109,0.001355,172.31.40.0-255,66,35654,63,146415
19110,0.001358,172.217.194.0-255,766,36420,63,146415
19111,0.00148,172.217.194.0-255,1484,37904,63,146415
19112,0.001485,172.31.40.0-255,66,37970,63,146415
19113,0.00149,172.217.194.0-255,2902,40872,63,146415
19114,0.001492,172.31.40.0-255,66,40938,63,146415
19115,0.00151,172.217.194.0-255,5738,46676,63,146415
19116,0.001512,172.31.40.0-255,66,46742,63,146415
19117,0.001534,172.217.194.0-255,4320,51062,63,146415
19118,0.001537,172.31.40.0-255,66,51128,63,146415
19119,0.001571,172.31.40.0-255,66,51194,63,146415
19120,0.001575,172.217.194.0-255,1484,52678,63,146415
19121,0.001596,172.217.194.0-255,6438,59116,63,146415
19122,0.001599,172.31.40.0-255,66,59182,63,146415
19123,0.001611,172.31.40.0-255,66,59248,63,146415
19124,0.001617,172.217.194.0-255,4320,63568,63,146415
19125,0.001619,172.31.40.0-255,66,63634,63,146415
19126,0.001671,172.31.40.0-255,66,63700,63,146415
19127,0.001682,172.31.40.0-255,66,63766,63,146415
19128,0.001687,172.217.194.0-255,2902,66668,63,146415
19129,0.001689,172.31.40.0-255,66,66734,63,146415
19130,0.00174,172.31.40.0-255,66,66800,63,146415
19131,0.001753,172.217.194.0-255,2902,69702,63,146415
19132,0.001756,172.31.40.0-255,66,69768,63,146415
19133,0.00176,172.217.194.0-255,3602,73370,63,146415
19134,0.001763,172.31.40.0-255,66,73436,63,146415
19135,0.001771,172.217.194.0-255,7156,80592,63,146415
19136,0.001773,172.31.40.0-255,66,80658,63,146415
19137,0.001821,172.31.40.0-255,66,80724,63,146415
19138,0.001837,172.31.40.0-255,66,80790,63,146415
19139,0.00187,172.217.194.0-255,7156,87946,63,146415
19140,0.001873,172.31.40.0-255,66,88012,63,146415
19141,0.001889,172.217.194.0-255,2902,90914,63,146415
19142,0.001891,172.31.40.0-255,66,90980,63,146415
19143,0.001937,172.31.40.0-255,66,91046,63,146415
19144,0.001987,172.31.40.0-255,66,91112,63,146415
19145,0.002006,172.217.194.0-255,2902,94014,63,146415
19146,0.002009,172.31.40.0-255,66,94080,63,146415
19147,0.002015,172.217.194.0-255,5020,99100,63,146415
19148,0.002018,172.31.40.0-255,66,99166,63,146415
19149,0.002041,172.31.40.0-255,66,99232,63,146415
19150,0.002079,172.217.194.0-255,5738,104970,63,146415
19151,0.002087,172.31.40.0-255,66,105036,63,146415
19152,0.002116,172.217.194.0-255,1484,106520,63,146415
19153,0.00212,172.31.40.0-255,66,106586,63,146415
19154,0.002142,172.217.194.0-255,2902,109488,63,146415
19155,0.002148,172.217.194.0-255,5738,115226,63,146415
19156,0.002154,172.217.194.0-255,4320,119546,63,146415
19157,0.002162,172.31.40.0-255,66,119612,63,146415
19158,0.002179,172.217.194.0-255,5738,125350,63,146415
19159,0.002201,172.31.40.0-255,66,125416,63,146415
19160,0.002207,172.217.194.0-255,2902,128318,63,146415
19161,0.002244,172.217.194.0-255,3602,131920,63,146415
19162,0.002247,172.31.40.0-255,66,131986,63,146415
19163,0.00227,172.31.40.0-255,66,132052,63,146415
19164,0.004274,172.217.194.0-255,1484,133536,63,146415
19165,0.004295,172.217.194.0-255,4320,137856,63,146415
19166,0.004299,172.31.40.0-255,66,137922,63,146415
19167,0.006363,172.217.194.0-255,5738,143660,63,146415
19168,0.006378,172.31.40.0-255,66,143726,63,146415
19169,0.008364,172.217.194.0-255,2452,146178,63,146415
19170,0.008376,172.31.40.0-255,66,146244,63,146415
19171,0.014879,172.31.40.0-255,105,146349,63,146415
19172,0.016966,172.217.194.0-255,66,146415,63,146415
19173,0.0,172.217.194.0-255,154,154,63,167607
19174,2.3e-05,172.31.40.0-255,66,220,63,167607
19175,3.1e-05,172.217.194.0-255,1484,1704,63,167607
19176,3.5e-05,172.31.40.0-255,66,1770,63,167607
19177,4.1e-05,172.217.194.0-255,2902,4672,63,167607
19178,4.5e-05,172.31.40.0-255,66,4738,63,167607
19179,5.3e-05,172.217.194.0-255,7156,11894,63,167607
19180,5.6e-05,172.31.40.0-255,66,11960,63,167607
19181,8.3e-05,172.217.194.0-255,2029,13989,63,167607
19182,8.6e-05,172.31.40.0-255,66,14055,63,167607
19183,0.000152,172.217.194.0-255,1484,15539,63,167607
19184,0.000155,172.31.40.0-255,66,15605,63,167607
19185,0.00016,172.217.194.0-255,2902,18507,63,167607
19186,0.000163,172.31.40.0-255,66,18573,63,167607
19187,0.000183,172.217.194.0-255,5738,24311,63,167607
19188,0.000186,172.31.40.0-255,66,24377,63,167607
19189,0.000232,172.31.40.0-255,66,24443,63,167607
19190,0.000258,172.217.194.0-255,3961,28404,63,167607
19191,0.000261,172.31.40.0-255,66,28470,63,167607
19192,0.000274,172.31.40.0-255,66,28536,63,167607
19193,0.000844,172.217.194.0-255,1484,30020,63,167607
19194,0.000848,172.31.40.0-255,66,30086,63,167607
19195,0.000853,172.217.194.0-255,2902,32988,63,167607
19196,0.000856,172.31.40.0-255,66,33054,63,167607
19197,0.000858,172.217.194.0-255,1484,34538,63,167607
19198,0.00086,172.31.40.0-255,66,34604,63,167607
19199,0.000876,172.217.194.0-255,4320,38924,63,167607
19200,0.000879,172.31.40.0-255,66,38990,63,167607
19201,0.000907,172.217.194.0-255,6797,45787,63,167607
19202,0.00091,172.31.40.0-255,66,45853,63,167607
19203,0.00093,172.217.194.0-255,1484,47337,63,167607
19204,0.000934,172.217.194.0-255,1484,48821,63,167607
19205,0.000937,172.31.40.0-255,66,48887,63,167607
19206,0.000957,172.217.194.0-255,1484,50371,63,167607
19207,0.000963,172.217.194.0-255,5738,56109,63,167607
19208,0.000966,172.31.40.0-255,66,56175,63,167607
19209,0.000979,172.217.194.0-255,2902,59077,63,167607
19210,0.000981,172.31.40.0-255,66,59143,63,167607
19211,0.000998,172.217.194.0-255,3961,63104,63,167607
19212,0.001,172.31.40.0-255,66,63170,63,167607
19213,0.001007,172.217.194.0-255,5738,68908,63,167607
19214,0.001009,172.31.40.0-255,66,68974,63,167607
19215,0.001026,172.217.194.0-255,1484,70458,63,167607
19216,0.001053,172.217.194.0-255,4320,74778,63,167607
19217,0.001055,172.31.40.0-255,66,74844,63,167607
19218,0.001079,172.217.194.0-255,5959,80803,63,167607
19219,0.001081,172.31.40.0-255,66,80869,63,167607
19220,0.001378,172.217.194.0-255,1484,82353,63,167607
19221,0.001386,172.217.194.0-255,2902,85255,63,167607
19222,0.00139,172.31.40.0-255,66,85321,63,167607
19223,0.001417,172.217.194.0-255,5738,91059,63,167607
19224,0.00142,172.31.40.0-255,66,91125,63,167607
19225,0.001456,172.217.194.0-255,5738,96863,63,167607
19226,0.001459,172.31.40.0-255,66,96929,63,167607
19227,0.001478,172.217.194.0-255,7156,104085,63,167607
19228,0.001481,172.31.40.0-255,66,104151,63,167607
19229,0.001493,172.31.40.0-255,66,104217,63,167607
19230,0.001823,172.217.194.0-255,1484,105701,63,167607
19231,0.001846,172.217.194.0-255,2902,108603,63,167607
19232,0.001851,172.31.40.0-255,66,108669,63,167607
19233,0.001858,172.217.194.0-255,5738,114407,63,167607
19234,0.00186,172.31.40.0-255,66,114473,63,167607
19235,0.001863,172.217.194.0-255,1484,115957,63,167607
19236,0.001878,172.217.194.0-255,2902,118859,63,167607
19237,0.00188,172.31.40.0-255,66,118925,63,167607
19238,0.001893,172.31.40.0-255,66,118991,63,167607
19239,0.001896,172.217.194.0-255,1484,120475,63,167607
19240,0.00192,172.217.194.0-255,6438,126913,63,167607
19241,0.001925,172.31.40.0-255,66,126979,63,167607
19242,0.00428,172.217.194.0-255,5738,132717,63,167607
19243,0.004288,172.31.40.0-255,66,132783,63,167607
19244,0.006619,172.217.194.0-255,5738,138521,63,167607
19245,0.006624,172.31.40.0-255,66,138587,63,167607
19246,0.008972,172.217.194.0-255,5738,144325,63,167607
19247,0.008978,172.31.40.0-255,66,144391,63,167607
19248,0.011321,172.217.194.0-255,5738,150129,63,167607
19249,0.01133,172.31.40.0-255,66,150195,63,167607
19250,0.013672,172.217.194.0-255,5738,155933,63,167607
19251,0.013682,172.31.40.0-255,66,155999,63,167607
19252,0.016025,172.217.194.0-255,5738,161737,63,167607
19253,0.016035,172.31.40.0-255,66,161803,63,167607
19254,0.018367,172.217.194.0-255,5738,167541,63,167607
19255,0.018376,172.31.40.0-255,66,167607,63,167607
19256,0.0,172.217.194.0-255,150,150,63,94306
19257,1.3e-05,172.31.40.0-255,66,216,63,94306
19258,3.3e-05,172.217.194.0-255,1484,1700,63,94306
19259,3.7e-05,172.31.40.0-255,66,1766,63,94306
19260,4.1e-05,172.217.194.0-255,1484,3250,63,94306
19261,4.3e-05,172.31.40.0-255,66,3316,63,94306
19262,6.8e-05,172.217.194.0-255,1484,4800,63,94306
19263,7.1e-05,172.31.40.0-255,66,4866,63,94306
19264,7.9e-05,172.217.194.0-255,5738,10604,63,94306
19265,8.1e-05,172.31.40.0-255,66,10670,63,94306
19266,0.000102,172.217.194.0-255,5738,16408,63,94306
19267,0.000104,172.31.40.0-255,66,16474,63,94306
19268,0.000127,172.31.40.0-255,66,16540,63,94306
19269,0.000157,172.217.194.0-255,6797,23337,63,94306
19270,0.000159,172.31.40.0-255,66,23403,63,94306
19271,0.000194,172.217.194.0-255,1484,24887,63,94306
19272,0.000197,172.31.40.0-255,66,24953,63,94306
19273,0.000211,172.217.194.0-255,2902,27855,63,94306
19274,0.000213,172.31.40.0-255,66,27921,63,94306
19275,0.000241,172.217.194.0-255,5738,33659,63,94306
19276,0.000243,172.31.40.0-255,66,33725,63,94306
19277,0.000282,172.31.40.0-255,66,33791,63,94306
19278,0.000299,172.217.194.0-255,1484,35275,63,94306
19279,0.000301,172.31.40.0-255,66,35341,63,94306
19280,0.000347,172.31.40.0-255,66,35407,63,94306
19281,0.000351,172.217.194.0-255,98,35505,63,94306
19282,0.000353,172.31.40.0-255,66,35571,63,94306
19283,0.00094,172.217.194.0-255,365,35936,63,94306
19284,0.000948,172.31.40.0-255,66,36002,63,94306
19285,0.001135,172.217.194.0-255,1484,37486,63,94306
19286,0.001142,172.217.194.0-255,2902,40388,63,94306
19287,0.001146,172.31.40.0-255,66,40454,63,94306
19288,0.001174,172.217.194.0-255,5738,46192,63,94306
19289,0.001177,172.31.40.0-255,66,46258,63,94306
19290,0.001189,172.31.40.0-255,66,46324,63,94306
19291,0.001222,172.217.194.0-255,1484,47808,63,94306
19292,0.00125,172.31.40.0-255,66,47874,63,94306
19293,0.003497,172.217.194.0-255,5738,53612,63,94306
19294,0.003504,172.31.40.0-255,66,53678,63,94306
19295,0.005767,172.217.194.0-255,5738,59416,63,94306
19296,0.005774,172.31.40.0-255,66,59482,63,94306
19297,0.008033,172.217.194.0-255,5738,65220,63,94306
19298,0.008043,172.31.40.0-255,66,65286,63,94306
19299,0.010311,172.217.194.0-255,5738,71024,63,94306
19300,0.010327,172.31.40.0-255,66,71090,63,94306
19301,0.01261,172.217.194.0-255,5738,76828,63,94306
19302,0.012626,172.31.40.0-255,66,76894,63,94306
19303,0.014904,172.217.194.0-255,5738,82632,63,94306
19304,0.014922,172.31.40.0-255,66,82698,63,94306
19305,0.017194,172.217.194.0-255,5738,88436,63,94306
19306,0.017207,172.31.40.0-255,66,88502,63,94306
19307,0.019454,172.217.194.0-255,5738,94240,63,94306
19308,0.01947,172.31.40.0-255,66,94306,63,94306
19309,0.0,74.125.24.0-255,153,153,63,253045
19310,3.4e-05,172.31.40.0-255,66,219,63,253045
19311,4.1e-05,74.125.24.0-255,1484,1703,63,253045
19312,4.5e-05,172.31.40.0-255,66,1769,63,253045
19313,5e-05,74.125.24.0-255,2902,4671,63,253045
19314,5.2e-05,172.31.40.0-255,66,4737,63,253045
19315,6.5e-05,74.125.24.0-255,7156,11893,63,253045
19316,6.8e-05,172.31.40.0-255,66,11959,63,253045
19317,7.2e-05,74.125.24.0-255,2038,13997,63,253045
19318,7.5e-05,172.31.40.0-255,66,14063,63,253045
19319,8e-05,74.125.24.0-255,4320,18383,63,253045
19320,8.3e-05,172.31.40.0-255,66,18449,63,253045
19321,0.000112,74.125.24.0-255,7156,25605,63,253045
19322,0.000116,172.31.40.0-255,66,25671,63,253045
19323,0.000122,74.125.24.0-255,5379,31050,63,253045
19324,0.000124,172.31.40.0-255,66,31116,63,253045
19325,0.000204,74.125.24.0-255,1484,32600,63,253045
19326,0.000208,172.31.40.0-255,66,32666,63,253045
19327,0.000213,74.125.24.0-255,2902,35568,63,253045
19328,0.000215,172.31.40.0-255,66,35634,63,253045
19329,0.000218,74.125.24.0-255,1484,37118,63,253045
19330,0.00022,172.31.40.0-255,66,37184,63,253045
19331,0.000252,74.125.24.0-255,4320,41504,63,253045
19332,0.00026,172.31.40.0-255,66,41570,63,253045
19333,0.000273,172.31.40.0-255,66,41636,63,253045
19334,0.000282,172.31.40.0-255,66,41702,63,253045
19335,0.000312,74.125.24.0-255,2902,44604,63,253045
19336,0.000315,172.31.40.0-255,66,44670,63,253045
19337,0.000318,74.125.24.0-255,1398,46068,63,253045
19338,0.00032,172.31.40.0-255,66,46134,63,253045
19339,0.00035,74.125.24.0-255,381,46515,63,253045
19340,0.000457,74.125.24.0-255,1484,47999,63,253045
19341,0.000461,172.31.40.0-255,66,48065,63,253045
19342,0.000467,74.125.24.0-255,2902,50967,63,253045
19343,0.000469,172.31.40.0-255,66,51033,63,253045
19344,0.000507,74.125.24.0-255,5738,56771,63,253045
19345,0.000511,172.31.40.0-255,66,56837,63,253045
19346,0.000517,74.125.24.0-255,6797,63634,63,253045
19347,0.000519,172.31.40.0-255,66,63700,63,253045
19348,0.000566,172.31.40.0-255,66,63766,63,253045
19349,0.000612,74.125.24.0-255,2902,66668,63,253045
19350,0.000617,172.31.40.0-255,66,66734,63,253045
19351,0.00064,74.125.24.0-255,3413,70147,63,253045
19352,0.000643,172.31.40.0-255,66,70213,63,253045
19353,0.000668,74.125.24.0-255,1484,71697,63,253045
19354,0.000688,74.125.24.0-255,2902,74599,63,253045
19355,0.000692,172.31.40.0-255,66,74665,63,253045
19356,0.000698,74.125.24.0-255,5738,80403,63,253045
19357,0.0007,172.31.40.0-255,66,80469,63,253045
19358,0.000731,74.125.24.0-255,7156,87625,63,253045
19359,0.000734,172.31.40.0-255,66,87691,63,253045
19360,0.000741,74.125.24.0-255,5738,93429,63,253045
19361,0.000744,172.31.40.0-255,66,93495,63,253045
19362,0.000788,172.31.40.0-255,66,93561,63,253045
19363,0.000792,74.125.24.0-255,2184,95745,63,253045
19364,0.000794,172.31.40.0-255,66,95811,63,253045
19365,0.001096,74.125.24.0-255,1484,97295,63,253045
19366,0.001102,74.125.24.0-255,2902,100197,63,253045
19367,0.001105,172.31.40.0-255,66,100263,63,253045
19368,0.001139,74.125.24.0-255,4320,104583,63,253045
19369,0.001143,172.31.40.0-255,66,104649,63,253045
19370,0.00115,74.125.24.0-255,5738,110387,63,253045
19371,0.001153,172.31.40.0-255,66,110453,63,253045
19372,0.001169,74.125.24.0-255,2902,113355,63,253045
19373,0.001172,172.31.40.0-255,66,113421,63,253045
19374,0.001179,74.125.24.0-255,7156,120577,63,253045
19375,0.001181,172.31.40.0-255,66,120643,63,253045
19376,0.001247,172.31.40.0-255,66,120709,63,253045
19377,0.001575,74.125.24.0-255,1484,122193,63,253045
19378,0.00158,74.125.24.0-255,1484,123677,63,253045
19379,0.001583,172.31.40.0-255,66,123743,63,253045
19380,0.001615,74.125.24.0-255,1484,125227,63,253045
19381,0.001624,74.125.24.0-255,5738,130965,63,253045
19382,0.001626,172.31.40.0-255,66,131031,63,253045
19383,0.001638,172.31.40.0-255,66,131097,63,253045
19384,0.001664,74.125.24.0-255,1484,132581,63,253045
19385,0.001687,74.125.24.0-255,7156,139737,63,253045
19386,0.00169,172.31.40.0-255,66,139803,63,253045
19387,0.001717,74.125.24.0-255,3602,143405,63,253045
19388,0.00172,172.31.40.0-255,66,143471,63,253045
19389,0.001809,74.125.24.0-255,1484,144955,63,253045
19390,0.001814,74.125.24.0-255,2902,147857,63,253045
19391,0.001817,172.31.40.0-255,66,147923,63,253045
19392,0.001848,74.125.24.0-255,4320,152243,63,253045
19393,0.001851,172.31.40.0-255,66,152309,63,253045
19394,0.001862,172.31.40.0-255,66,152375,63,253045
19395,0.001899,172.31.40.0-255,66,152441,63,253045
19396,0.001938,74.125.24.0-255,5020,157461,63,253045
19397,0.001941,172.31.40.0-255,66,157527,63,253045
19398,0.001944,74.125.24.0-255,1484,159011,63,253045
19399,0.001948,74.125.24.0-255,2902,161913,63,253045
19400,0.00195,172.31.40.0-255,66,161979,63,253045
19401,0.001956,74.125.24.0-255,5738,167717,63,253045
19402,0.001958,172.31.40.0-255,66,167783,63,253045
19403,0.001979,74.125.24.0-255,1484,169267,63,253045
19404,0.002031,172.31.40.0-255,66,169333,63,253045
19405,0.002043,172.31.40.0-255,66,169399,63,253045
19406,0.002054,172.31.40.0-255,66,169465,63,253045
19407,0.002084,74.125.24.0-255,4320,173785,63,253045
19408,0.002087,172.31.40.0-255,66,173851,63,253045
19409,0.002102,172.31.40.0-255,66,173917,63,253045
19410,0.002107,74.125.24.0-255,3602,177519,63,253045
19411,0.00211,172.31.40.0-255,66,177585,63,253045
19412,0.002186,74.125.24.0-255,1484,179069,63,253045
19413,0.002204,74.125.24.0-255,2902,181971,63,253045
19414,0.002207,172.31.40.0-255,66,182037,63,253045
19415,0.002213,74.125.24.0-255,5738,187775,63,253045
19416,0.002215,172.31.40.0-255,66,187841,63,253045
19417,0.002241,74.125.24.0-255,2902,190743,63,253045
19418,0.002245,172.31.40.0-255,66,190809,63,253045
19419,0.002281,74.125.24.0-255,4320,195129,63,253045
19420,0.002285,172.31.40.0-255,66,195195,63,253045
19421,0.002304,172.31.40.0-255,66,195261,63,253045
19422,0.002309,74.125.24.0-255,2184,197445,63,253045
19423,0.002311,172.31.40.0-255,66,197511,63,253045
19424,0.00234,74.125.24.0-255,1484,198995,63,253045
19425,0.002345,74.125.24.0-255,2902,201897,63,253045
19426,0.002348,172.31.40.0-255,66,201963,63,253045
19427,0.002382,74.125.24.0-255,2902,204865,63,253045
19428,0.002386,172.31.40.0-255,66,204931,63,253045
19429,0.002417,74.125.24.0-255,2902,207833,63,253045
19430,0.002421,172.31.40.0-255,66,207899,63,253045
19431,0.002431,172.31.40.0-255,66,207965,63,253045
19432,0.002435,74.125.24.0-255,4320,212285,63,253045
19433,0.002437,172.31.40.0-255,66,212351,63,253045
19434,0.004825,74.125.24.0-255,1484,213835,63,253045
19435,0.004845,74.125.24.0-255,4320,218155,63,253045
19436,0.004849,172.31.40.0-255,66,218221,63,253045
19437,0.00729,74.125.24.0-255,5738,223959,63,253045
19438,0.007297,172.31.40.0-255,66,224025,63,253045
19439,0.009654,74.125.24.0-255,5738,229763,63,253045
19440,0.009659,172.31.40.0-255,66,229829,63,253045
19441,0.012009,74.125.24.0-255,5738,235567,63,253045
19442,0.012016,172.31.40.0-255,66,235633,63,253045
19443,0.014386,74.125.24.0-255,5738,241371,63,253045
19444,0.014396,172.31.40.0-255,66,241437,63,253045
19445,0.016761,74.125.24.0-255,5738,247175,63,253045
19446,0.016769,172.31.40.0-255,66,247241,63,253045
19447,0.019141,74.125.24.0-255,5738,252979,63,253045
19448,0.019148,172.31.40.0-255,66,253045,63,253045
19449,0.0,74.125.24.0-255,153,153,63,156412
19450,1.9e-05,172.31.40.0-255,66,219,63,156412
19451,2.6e-05,74.125.24.0-255,1484,1703,63,156412
19452,3e-05,172.31.40.0-255,66,1769,63,156412
19453,3.6e-05,74.125.24.0-255,2902,4671,63,156412
19454,3.8e-05,172.31.40.0-255,66,4737,63,156412
19455,5.3e-05,74.125.24.0-255,4320,9057,63,156412
19456,5.5e-05,172.31.40.0-255,66,9123,63,156412
19457,8.6e-05,74.125.24.0-255,7156,16279,63,156412
19458,8.9e-05,172.31.40.0-255,66,16345,63,156412
19459,0.000118,74.125.24.0-255,1991,18336,63,156412
19460,0.00012,172.31.40.0-255,66,18402,63,156412
19461,0.000132,172.31.40.0-255,66,18468,63,156412
19462,0.000139,74.125.24.0-255,1484,19952,63,156412
19463,0.000141,172.31.40.0-255,66,20018,63,156412
19464,0.000171,74.125.24.0-255,1125,21143,63,156412
19465,0.000173,172.31.40.0-255,66,21209,63,156412
19466,0.000181,74.125.24.0-255,2902,24111,63,156412
19467,0.000183,172.31.40.0-255,66,24177,63,156412
19468,0.000189,74.125.24.0-255,5738,29915,63,156412
19469,0.000192,172.31.40.0-255,66,29981,63,156412
19470,0.000215,74.125.24.0-255,1484,31465,63,156412
19471,0.000218,172.31.40.0-255,66,31531,63,156412
19472,0.000224,74.125.24.0-255,5738,37269,63,156412
19473,0.000226,172.31.40.0-255,66,37335,63,156412
19474,0.000229,74.125.24.0-255,1125,38460,63,156412
19475,0.000231,172.31.40.0-255,66,38526,63,156412
19476,0.000732,74.125.24.0-255,1484,40010,63,156412
19477,0.000738,74.125.24.0-255,2902,42912,63,156412
19478,0.000743,172.31.40.0-255,66,42978,63,156412
19479,0.000747,172.31.40.0-255,66,43044,63,156412
19480,0.000763,74.125.24.0-255,5738,48782,63,156412
19481,0.000765,172.31.40.0-255,66,48848,63,156412
19482,0.000771,74.125.24.0-255,4320,53168,63,156412
19483,0.000773,172.31.40.0-255,66,53234,63,156412
19484,0.000803,74.125.24.0-255,2543,55777,63,156412
19485,0.000806,172.31.40.0-255,66,55843,63,156412
19486,0.000835,74.125.24.0-255,1484,57327,63,156412
19487,0.000861,74.125.24.0-255,2902,60229,63,156412
19488,0.000864,172.31.40.0-255,66,60295,63,156412
19489,0.00087,74.125.24.0-255,5738,66033,63,156412
19490,0.000872,172.31.40.0-255,66,66099,63,156412
19491,0.000882,74.125.24.0-255,4320,70419,63,156412
19492,0.000885,172.31.40.0-255,66,70485,63,156412
19493,0.000913,74.125.24.0-255,3961,74446,63,156412
19494,0.000916,172.31.40.0-255,66,74512,63,156412
19495,0.000926,172.31.40.0-255,66,74578,63,156412
19496,0.000931,74.125.24.0-255,2902,77480,63,156412
19497,0.000933,172.31.40.0-255,66,77546,63,156412
19498,0.000958,74.125.24.0-255,4540,82086,63,156412
19499,0.000961,172.31.40.0-255,66,82152,63,156412
19500,0.001281,74.125.24.0-255,1484,83636,63,156412
19501,0.001288,74.125.24.0-255,2902,86538,63,156412
19502,0.001291,172.31.40.0-255,66,86604,63,156412
19503,0.001296,74.125.24.0-255,2902,89506,63,156412
19504,0.001297,172.31.40.0-255,66,89572,63,156412
19505,0.001327,74.125.24.0-255,2902,92474,63,156412
19506,0.00133,172.31.40.0-255,66,92540,63,156412
19507,0.001345,172.31.40.0-255,66,92606,63,156412
19508,0.001373,74.125.24.0-255,4320,96926,63,156412
19509,0.001376,172.31.40.0-255,66,96992,63,156412
19510,0.001386,172.31.40.0-255,66,97058,63,156412
19511,0.001412,74.125.24.0-255,1636,98694,63,156412
19512,0.001415,172.31.40.0-255,66,98760,63,156412
19513,0.002501,74.125.24.0-255,1484,100244,63,156412
19514,0.002512,74.125.24.0-255,2902,103146,63,156412
19515,0.002516,172.31.40.0-255,66,103212,63,156412
19516,0.002548,74.125.24.0-255,4320,107532,63,156412
19517,0.002551,172.31.40.0-255,66,107598,63,156412
19518,0.002558,74.125.24.0-255,5738,113336,63,156412
19519,0.00256,172.31.40.0-255,66,113402,63,156412
19520,0.002574,172.31.40.0-255,66,113468,63,156412
19521,0.00258,74.125.24.0-255,4320,117788,63,156412
19522,0.002582,172.31.40.0-255,66,117854,63,156412
19523,0.002615,74.125.24.0-255,3602,121456,63,156412
19524,0.002618,172.31.40.0-255,66,121522,63,156412
19525,0.005143,74.125.24.0-255,1484,123006,63,156412
19526,0.005176,74.125.24.0-255,4320,127326,63,156412
19527,0.005179,172.31.40.0-255,66,127392,63,156412
19528,0.007787,74.125.24.0-255,5738,133130,63,156412
19529,0.007795,172.31.40.0-255,66,133196,63,156412
19530,0.010361,74.125.24.0-255,5738,138934,63,156412
19531,0.010368,172.31.40.0-255,66,139000,63,156412
19532,0.012953,74.125.24.0-255,5738,144738,63,156412
19533,0.012963,172.31.40.0-255,66,144804,63,156412
19534,0.015539,74.125.24.0-255,5738,150542,63,156412
19535,0.01555,172.31.40.0-255,66,150608,63,156412
19536,0.018109,74.125.24.0-255,5738,156346,63,156412
19537,0.018117,172.31.40.0-255,66,156412,63,156412
19538,0.0,172.217.194.0-255,152,152,63,161910
19539,1.5e-05,172.31.40.0-255,66,218,63,161910
19540,2.1e-05,172.217.194.0-255,1484,1702,63,161910
19541,2.5e-05,172.31.40.0-255,66,1768,63,161910
19542,3.1e-05,172.217.194.0-255,2902,4670,63,161910
19543,4.1e-05,172.31.40.0-255,66,4736,63,161910
19544,4.9e-05,172.217.194.0-255,7156,11892,63,161910
19545,5.1e-05,172.31.40.0-255,66,11958,63,161910
19546,5.5e-05,172.217.194.0-255,2119,14077,63,161910
19547,5.8e-05,172.31.40.0-255,66,14143,63,161910
19548,9.9e-05,172.217.194.0-255,1484,15627,63,161910
19549,0.000102,172.31.40.0-255,66,15693,63,161910
19550,0.000107,172.217.194.0-255,2902,18595,63,161910
19551,0.000109,172.31.40.0-255,66,18661,63,161910
19552,0.000132,172.217.194.0-255,5738,24399,63,161910
19553,0.000135,172.31.40.0-255,66,24465,63,161910
19554,0.000141,172.217.194.0-255,4320,28785,63,161910
19555,0.000143,172.31.40.0-255,66,28851,63,161910
19556,0.000169,172.217.194.0-255,2543,31394,63,161910
19557,0.000172,172.31.40.0-255,66,31460,63,161910
19558,0.000254,172.217.194.0-255,1484,32944,63,161910
19559,0.000258,172.31.40.0-255,66,33010,63,161910
19560,0.000263,172.217.194.0-255,2902,35912,63,161910
19561,0.000266,172.31.40.0-255,66,35978,63,161910
19562,0.000275,172.217.194.0-255,4320,40298,63,161910
19563,0.000277,172.31.40.0-255,66,40364,63,161910
19564,0.000312,172.217.194.0-255,1484,41848,63,161910
19565,0.000314,172.31.40.0-255,66,41914,63,161910
19566,0.000328,172.31.40.0-255,66,41980,63,161910
19567,0.000366,172.31.40.0-255,66,42046,63,161910
19568,0.000492,172.217.194.0-255,646,42692,63,161910
19569,0.000674,172.217.194.0-255,1484,44176,63,161910
19570,0.000678,172.31.40.0-255,66,44242,63,161910
19571,0.000684,172.217.194.0-255,2902,47144,63,161910
19572,0.000686,172.31.40.0-255,66,47210,63,161910
19573,0.000719,172.217.194.0-255,5738,52948,63,161910
19574,0.000722,172.31.40.0-255,66,53014,63,161910
19575,0.000772,172.31.40.0-255,66,53080,63,161910
19576,0.000777,172.217.194.0-255,2902,55982,63,161910
19577,0.000779,172.31.40.0-255,66,56048,63,161910
19578,0.000821,172.31.40.0-255,66,56114,63,161910
19579,0.001004,172.217.194.0-255,1484,57598,63,161910
19580,0.001021,172.217.194.0-255,2902,60500,63,161910
19581,0.001024,172.31.40.0-255,66,60566,63,161910
19582,0.001029,172.217.194.0-255,2902,63468,63,161910
19583,0.001031,172.31.40.0-255,66,63534,63,161910
19584,0.001063,172.217.194.0-255,7156,70690,63,161910
19585,0.001065,172.31.40.0-255,66,70756,63,161910
19586,0.001104,172.31.40.0-255,66,70822,63,161910
19587,0.001146,172.217.194.0-255,3602,74424,63,161910
19588,0.001149,172.31.40.0-255,66,74490,63,161910
19589,0.001373,172.217.194.0-255,1484,75974,63,161910
19590,0.001378,172.217.194.0-255,2902,78876,63,161910
19591,0.001384,172.31.40.0-255,66,78942,63,161910
19592,0.001403,172.217.194.0-255,5738,84680,63,161910
19593,0.001406,172.31.40.0-255,66,84746,63,161910
19594,0.001444,172.31.40.0-255,66,84812,63,161910
19595,0.001502,172.217.194.0-255,7156,91968,63,161910
19596,0.001505,172.31.40.0-255,66,92034,63,161910
19597,0.001508,172.217.194.0-255,1484,93518,63,161910
19598,0.001532,172.217.194.0-255,2184,95702,63,161910
19599,0.001535,172.31.40.0-255,66,95768,63,161910
19600,0.001539,172.217.194.0-255,1484,97252,63,161910
19601,0.001572,172.31.40.0-255,66,97318,63,161910
19602,0.001609,172.31.40.0-255,66,97384,63,161910
19603,0.001661,172.217.194.0-255,4320,101704,63,161910
19604,0.001665,172.31.40.0-255,66,101770,63,161910
19605,0.001689,172.217.194.0-255,2184,103954,63,161910
19606,0.001692,172.31.40.0-255,66,104020,63,161910
19607,0.001818,172.217.194.0-255,1484,105504,63,161910
19608,0.001824,172.217.194.0-255,2902,108406,63,161910
19609,0.001827,172.31.40.0-255,66,108472,63,161910
19610,0.001853,172.217.194.0-255,5738,114210,63,161910
19611,0.001856,172.31.40.0-255,66,114276,63,161910
19612,0.001859,172.217.194.0-255,1484,115760,63,161910
19613,0.001863,172.217.194.0-255,1484,117244,63,161910
19614,0.001865,172.31.40.0-255,66,117310,63,161910
19615,0.001894,172.217.194.0-255,7156,124466,63,161910
19616,0.001897,172.31.40.0-255,66,124532,63,161910
19617,0.001901,172.217.194.0-255,1484,126016,63,161910
19618,0.001942,172.31.40.0-255,66,126082,63,161910
19619,0.002004,172.217.194.0-255,1484,127566,63,161910
19620,0.002009,172.217.194.0-255,2902,130468,63,161910
19621,0.002012,172.31.40.0-255,66,130534,63,161910
19622,0.002018,172.217.194.0-255,4320,134854,63,161910
19623,0.00202,172.31.40.0-255,66,134920,63,161910
19624,0.002037,172.217.194.0-255,1484,136404,63,161910
19625,0.00204,172.217.194.0-255,1484,137888,63,161910
19626,0.002042,172.31.40.0-255,66,137954,63,161910
19627,0.002087,172.31.40.0-255,66,138020,63,161910
19628,0.002123,172.31.40.0-255,66,138086,63,161910
19629,0.002165,172.31.40.0-255,66,138152,63,161910
19630,0.002207,172.31.40.0-255,66,138218,63,161910
19631,0.002277,172.217.194.0-255,1484,139702,63,161910
19632,0.002301,172.217.194.0-255,6438,146140,63,161910
19633,0.002304,172.31.40.0-255,66,146206,63,161910
19634,0.002351,172.217.194.0-255,5738,151944,63,161910
19635,0.002355,172.31.40.0-255,66,152010,63,161910
19636,0.002408,172.31.40.0-255,66,152076,63,161910
19637,0.00251,172.217.194.0-255,2902,154978,63,161910
19638,0.002514,172.31.40.0-255,66,155044,63,161910
19639,0.00255,172.31.40.0-255,66,155110,63,161910
19640,0.002621,172.217.194.0-255,5738,160848,63,161910
19641,0.002625,172.31.40.0-255,66,160914,63,161910
19642,0.002662,172.31.40.0-255,66,160980,63,161910
19643,0.002717,172.31.40.0-255,66,161046,63,161910
19644,0.005024,172.217.194.0-255,168,161214,63,161910
19645,0.013332,172.31.40.0-255,105,161319,63,161910
19646,0.013381,172.31.40.0-255,105,161424,63,161910
19647,0.013656,172.31.40.0-255,90,161514,63,161910
19648,0.013666,172.31.40.0-255,66,161580,63,161910
19649,0.015609,172.217.194.0-255,66,161646,63,161910
19650,0.015665,172.217.194.0-255,66,161712,63,161910
19651,0.015924,172.217.194.0-255,66,161778,63,161910
19652,0.015958,172.217.194.0-255,66,161844,63,161910
19653,0.015966,172.31.40.0-255,66,161910,63,161910
19654,0.0,172.217.194.0-255,153,153,63,203950
19655,1.7e-05,172.31.40.0-255,66,219,63,203950
19656,2.5e-05,172.217.194.0-255,1484,1703,63,203950
19657,2.9e-05,172.31.40.0-255,66,1769,63,203950
19658,3.5e-05,172.217.194.0-255,2902,4671,63,203950
19659,3.7e-05,172.31.40.0-255,66,4737,63,203950
19660,4.5e-05,172.217.194.0-255,7156,11893,63,203950
19661,4.7e-05,172.31.40.0-255,66,11959,63,203950
19662,8.2e-05,172.217.194.0-255,2101,14060,63,203950
19663,8.5e-05,172.31.40.0-255,66,14126,63,203950
19664,0.000123,172.217.194.0-255,2902,17028,63,203950
19665,0.000125,172.31.40.0-255,66,17094,63,203950
19666,0.00013,172.217.194.0-255,2902,19996,63,203950
19667,0.000132,172.31.40.0-255,66,20062,63,203950
19668,0.000147,172.217.194.0-255,2902,22964,63,203950
19669,0.000149,172.31.40.0-255,66,23030,63,203950
19670,0.000178,172.31.40.0-255,66,23096,63,203950
19671,0.000198,172.217.194.0-255,2543,25639,63,203950
19672,0.0002,172.31.40.0-255,66,25705,63,203950
19673,0.000214,172.31.40.0-255,66,25771,63,203950
19674,0.000227,172.217.194.0-255,1484,27255,63,203950
19675,0.000229,172.31.40.0-255,66,27321,63,203950
19676,0.00024,172.217.194.0-255,1125,28446,63,203950
19677,0.000242,172.31.40.0-255,66,28512,63,203950
19678,0.000496,172.217.194.0-255,1484,29996,63,203950
19679,0.000502,172.31.40.0-255,66,30062,63,203950
19680,0.000507,172.217.194.0-255,2902,32964,63,203950
19681,0.00051,172.31.40.0-255,66,33030,63,203950
19682,0.000516,172.217.194.0-255,5738,38768,63,203950
19683,0.000519,172.31.40.0-255,66,38834,63,203950
19684,0.000532,172.217.194.0-255,1484,40318,63,203950
19685,0.000557,172.217.194.0-255,5379,45697,63,203950
19686,0.000566,172.31.40.0-255,66,45763,63,203950
19687,0.000577,172.31.40.0-255,66,45829,63,203950
19688,0.000602,172.217.194.0-255,5738,51567,63,203950
19689,0.000606,172.31.40.0-255,66,51633,63,203950
19690,0.000625,172.217.194.0-255,3961,55594,63,203950
19691,0.000628,172.31.40.0-255,66,55660,63,203950
19692,0.000649,172.217.194.0-255,2902,58562,63,203950
19693,0.000652,172.31.40.0-255,66,58628,63,203950
19694,0.000685,172.31.40.0-255,66,58694,63,203950
19695,0.000933,172.217.194.0-255,1484,60178,63,203950
19696,0.000952,172.217.194.0-255,2902,63080,63,203950
19697,0.000955,172.31.40.0-255,66,63146,63,203950
19698,0.000962,172.217.194.0-255,5738,68884,63,203950
19699,0.000965,172.31.40.0-255,66,68950,63,203950
19700,0.001004,172.31.40.0-255,66,69016,63,203950
19701,0.001035,172.217.194.0-255,4320,73336,63,203950
19702,0.001038,172.31.40.0-255,66,73402,63,203950
19703,0.001064,172.217.194.0-255,6438,79840,63,203950
19704,0.001067,172.31.40.0-255,66,79906,63,203950
19705,0.001304,172.217.194.0-255,1484,81390,63,203950
19706,0.001325,172.217.194.0-255,2902,84292,63,203950
19707,0.001328,172.31.40.0-255,66,84358,63,203950
19708,0.001333,172.217.194.0-255,2902,87260,63,203950
19709,0.001335,172.31.40.0-255,66,87326,63,203950
19710,0.001351,172.217.194.0-255,2902,90228,63,203950
19711,0.001354,172.31.40.0-255,66,90294,63,203950
19712,0.001366,172.31.40.0-255,66,90360,63,203950
19713,0.001385,172.217.194.0-255,1484,91844,63,203950
19714,0.001398,172.31.40.0-255,66,91910,63,203950
19715,0.001522,172.217.194.0-255,1484,93394,63,203950
19716,0.00154,172.217.194.0-255,2902,96296,63,203950
19717,0.001543,172.31.40.0-255,66,96362,63,203950
19718,0.001551,172.217.194.0-255,5738,102100,63,203950
19719,0.001552,172.31.40.0-255,66,102166,63,203950
19720,0.001582,172.217.194.0-255,7156,109322,63,203950
19721,0.001584,172.31.40.0-255,66,109388,63,203950
19722,0.00161,172.217.194.0-255,5738,115126,63,203950
19723,0.001627,172.31.40.0-255,66,115192,63,203950
19724,0.00163,172.31.40.0-255,66,115258,63,203950
19725,0.001668,172.217.194.0-255,1484,116742,63,203950
19726,0.001683,172.217.194.0-255,2902,119644,63,203950
19727,0.001685,172.217.194.0-255,1484,121128,63,203950
19728,0.001689,172.31.40.0-255,66,121194,63,203950
19729,0.001714,172.217.194.0-255,4320,125514,63,203950
19730,0.001718,172.31.40.0-255,66,125580,63,203950
19731,0.001731,172.31.40.0-255,66,125646,63,203950
19732,0.001757,172.217.194.0-255,4320,129966,63,203950
19733,0.001762,172.31.40.0-255,66,130032,63,203950
19734,0.001773,172.217.194.0-255,6438,136470,63,203950
19735,0.001775,172.31.40.0-255,66,136536,63,203950
19736,0.001835,172.217.194.0-255,1484,138020,63,203950
19737,0.001841,172.217.194.0-255,2902,140922,63,203950
19738,0.001844,172.31.40.0-255,66,140988,63,203950
19739,0.001867,172.217.194.0-255,5738,146726,63,203950
19740,0.00187,172.31.40.0-255,66,146792,63,203950
19741,0.00189,172.217.194.0-255,4320,151112,63,203950
19742,0.001892,172.31.40.0-255,66,151178,63,203950
19743,0.001924,172.31.40.0-255,66,151244,63,203950
19744,0.001957,172.31.40.0-255,66,151310,63,203950
19745,0.001972,172.217.194.0-255,766,152076,63,203950
19746,0.002015,172.217.194.0-255,1484,153560,63,203950
19747,0.002018,172.31.40.0-255,66,153626,63,203950
19748,0.002034,172.217.194.0-255,1484,155110,63,203950
19749,0.002054,172.217.194.0-255,1484,156594,63,203950
19750,0.002057,172.31.40.0-255,66,156660,63,203950
19751,0.002064,172.217.194.0-255,4320,160980,63,203950
19752,0.002066,172.31.40.0-255,66,161046,63,203950
19753,0.002084,172.217.194.0-255,2902,163948,63,203950
19754,0.002086,172.31.40.0-255,66,164014,63,203950
19755,0.002111,172.217.194.0-255,5738,169752,63,203950
19756,0.002114,172.31.40.0-255,66,169818,63,203950
19757,0.00212,172.217.194.0-255,7156,176974,63,203950
19758,0.002122,172.31.40.0-255,66,177040,63,203950
19759,0.002145,172.217.194.0-255,1484,178524,63,203950
19760,0.002183,172.31.40.0-255,66,178590,63,203950
19761,0.00225,172.31.40.0-255,66,178656,63,203950
19762,0.002257,172.217.194.0-255,6438,185094,63,203950
19763,0.002259,172.31.40.0-255,66,185160,63,203950
19764,0.002262,172.217.194.0-255,1484,186644,63,203950
19765,0.002311,172.31.40.0-255,66,186710,63,203950
19766,0.002317,172.217.194.0-255,5738,192448,63,203950
19767,0.00232,172.31.40.0-255,66,192514,63,203950
19768,0.002354,172.31.40.0-255,66,192580,63,203950
19769,0.002368,172.31.40.0-255,66,192646,63,203950
19770,0.004678,172.217.194.0-255,5738,198384,63,203950
19771,0.004685,172.31.40.0-255,66,198450,63,203950
19772,0.006971,172.217.194.0-255,5263,203713,63,203950
19773,0.006974,172.31.40.0-255,66,203779,63,203950
19774,0.013219,172.31.40.0-255,105,203884,63,203950
19775,0.015476,172.217.194.0-255,66,203950,63,203950
19776,0.0,74.125.130.0-255,148,148,63,193644
19777,2.4e-05,172.31.40.0-255,66,214,63,193644
19778,3e-05,74.125.130.0-255,1484,1698,63,193644
19779,3.4e-05,172.31.40.0-255,66,1764,63,193644
19780,3.7e-05,74.125.130.0-255,1484,3248,63,193644
19781,4e-05,172.31.40.0-255,66,3314,63,193644
19782,4.6e-05,74.125.130.0-255,2902,6216,63,193644
19783,4.8e-05,172.31.40.0-255,66,6282,63,193644
19784,5.2e-05,74.125.130.0-255,1484,7766,63,193644
19785,5.5e-05,172.31.40.0-255,66,7832,63,193644
19786,8.2e-05,74.125.130.0-255,4320,12152,63,193644
19787,8.5e-05,172.31.40.0-255,66,12218,63,193644
19788,8.9e-05,74.125.130.0-255,2156,14374,63,193644
19789,9.1e-05,172.31.40.0-255,66,14440,63,193644
19790,0.000137,74.125.130.0-255,1484,15924,63,193644
19791,0.000139,172.31.40.0-255,66,15990,63,193644
19792,0.000158,74.125.130.0-255,2902,18892,63,193644
19793,0.000161,172.31.40.0-255,66,18958,63,193644
19794,0.000191,74.125.130.0-255,5738,24696,63,193644
19795,0.000194,172.31.40.0-255,66,24762,63,193644
19796,0.000196,74.125.130.0-255,1484,26246,63,193644
19797,0.000198,172.31.40.0-255,66,26312,63,193644
19798,0.000223,74.125.130.0-255,1484,27796,63,193644
19799,0.000226,172.31.40.0-255,66,27862,63,193644
19800,0.00025,74.125.130.0-255,3961,31823,63,193644
19801,0.000252,172.31.40.0-255,66,31889,63,193644
19802,0.000362,74.125.130.0-255,1484,33373,63,193644
19803,0.000366,172.31.40.0-255,66,33439,63,193644
19804,0.000372,74.125.130.0-255,2902,36341,63,193644
19805,0.000374,172.31.40.0-255,66,36407,63,193644
19806,0.000377,74.125.130.0-255,1484,37891,63,193644
19807,0.000379,172.31.40.0-255,66,37957,63,193644
19808,0.0004,74.125.130.0-255,2902,40859,63,193644
19809,0.000403,172.31.40.0-255,66,40925,63,193644
19810,0.000409,74.125.130.0-255,5738,46663,63,193644
19811,0.000411,172.31.40.0-255,66,46729,63,193644
19812,0.000426,74.125.130.0-255,2902,49631,63,193644
19813,0.000429,172.31.40.0-255,66,49697,63,193644
19814,0.000456,74.125.130.0-255,2543,52240,63,193644
19815,0.000459,172.31.40.0-255,66,52306,63,193644
19816,0.000465,74.125.130.0-255,5738,58044,63,193644
19817,0.000467,172.31.40.0-255,66,58110,63,193644
19818,0.000491,172.31.40.0-255,66,58176,63,193644
19819,0.000539,74.125.130.0-255,121,58297,63,193644
19820,0.000558,74.125.130.0-255,381,58678,63,193644
19821,0.001023,172.31.40.0-255,66,58744,63,193644
19822,0.001038,74.125.130.0-255,1484,60228,63,193644
19823,0.001045,74.125.130.0-255,2902,63130,63,193644
19824,0.001047,172.31.40.0-255,66,63196,63,193644
19825,0.001077,74.125.130.0-255,5738,68934,63,193644
19826,0.00108,172.31.40.0-255,66,69000,63,193644
19827,0.001084,74.125.130.0-255,1484,70484,63,193644
19828,0.001103,74.125.130.0-255,5738,76222,63,193644
19829,0.001105,172.31.40.0-255,66,76288,63,193644
19830,0.001108,74.125.130.0-255,1484,77772,63,193644
19831,0.001134,74.125.130.0-255,7156,84928,63,193644
19832,0.001137,172.31.40.0-255,66,84994,63,193644
19833,0.001142,74.125.130.0-255,4320,89314,63,193644
19834,0.001144,172.31.40.0-255,66,89380,63,193644
19835,0.001157,74.125.130.0-255,3602,92982,63,193644
19836,0.00116,172.31.40.0-255,66,93048,63,193644
19837,0.001342,74.125.130.0-255,1484,94532,63,193644
19838,0.001347,74.125.130.0-255,2902,97434,63,193644
19839,0.001349,172.31.40.0-255,66,97500,63,193644
19840,0.001353,74.125.130.0-255,1484,98984,63,193644
19841,0.001374,74.125.130.0-255,2902,101886,63,193644
19842,0.001377,172.31.40.0-255,66,101952,63,193644
19843,0.001384,74.125.130.0-255,7156,109108,63,193644
19844,0.001386,172.31.40.0-255,66,109174,63,193644
19845,0.0014,74.125.130.0-255,1484,110658,63,193644
19846,0.001407,74.125.130.0-255,5738,116396,63,193644
19847,0.00141,172.31.40.0-255,66,116462,63,193644
19848,0.001419,74.125.130.0-255,7156,123618,63,193644
19849,0.001421,172.31.40.0-255,66,123684,63,193644
19850,0.001456,74.125.130.0-255,3602,127286,63,193644
19851,0.001459,172.31.40.0-255,66,127352,63,193644
19852,0.002138,74.125.130.0-255,1484,128836,63,193644
19853,0.002148,74.125.130.0-255,2902,131738,63,193644
19854,0.002153,172.31.40.0-255,66,131804,63,193644
19855,0.002179,74.125.130.0-255,5738,137542,63,193644
19856,0.002181,172.31.40.0-255,66,137608,63,193644
19857,0.002186,74.125.130.0-255,2902,140510,63,193644
19858,0.002187,172.31.40.0-255,66,140576,63,193644
19859,0.002219,74.125.130.0-255,4320,144896,63,193644
19860,0.002222,172.31.40.0-255,66,144962,63,193644
19861,0.002231,172.31.40.0-255,66,145028,63,193644
19862,0.002259,74.125.130.0-255,1484,146512,63,193644
19863,0.002275,74.125.130.0-255,6438,152950,63,193644
19864,0.002277,172.31.40.0-255,66,153016,63,193644
19865,0.004589,74.125.130.0-255,5738,158754,63,193644
19866,0.004595,172.31.40.0-255,66,158820,63,193644
19867,0.006902,74.125.130.0-255,5738,164558,63,193644
19868,0.006906,172.31.40.0-255,66,164624,63,193644
19869,0.009217,74.125.130.0-255,5738,170362,63,193644
19870,0.009225,172.31.40.0-255,66,170428,63,193644
19871,0.011552,74.125.130.0-255,5738,176166,63,193644
19872,0.011559,172.31.40.0-255,66,176232,63,193644
19873,0.013881,74.125.130.0-255,5738,181970,63,193644
19874,0.013889,172.31.40.0-255,66,182036,63,193644
19875,0.016217,74.125.130.0-255,5738,187774,63,193644
19876,0.016224,172.31.40.0-255,66,187840,63,193644
19877,0.01855,74.125.130.0-255,5738,193578,63,193644
19878,0.018557,172.31.40.0-255,66,193644,63,193644
19879,0.0,172.217.194.0-255,152,152,63,142052
19880,2.3e-05,172.31.40.0-255,66,218,63,142052
19881,3.1e-05,172.217.194.0-255,1484,1702,63,142052
19882,3.5e-05,172.31.40.0-255,66,1768,63,142052
19883,4.1e-05,172.217.194.0-255,2902,4670,63,142052
19884,5.2e-05,172.31.40.0-255,66,4736,63,142052
19885,5.6e-05,172.217.194.0-255,1484,6220,63,142052
19886,5.9e-05,172.31.40.0-255,66,6286,63,142052
19887,9.1e-05,172.217.194.0-255,1484,7770,63,142052
19888,9.4e-05,172.31.40.0-255,66,7836,63,142052
19889,0.000129,172.217.194.0-255,6321,14157,63,142052
19890,0.000132,172.31.40.0-255,66,14223,63,142052
19891,0.000174,172.217.194.0-255,1484,15707,63,142052
19892,0.000176,172.31.40.0-255,66,15773,63,142052
19893,0.000181,172.217.194.0-255,2902,18675,63,142052
19894,0.000183,172.31.40.0-255,66,18741,63,142052
19895,0.000188,172.217.194.0-255,2902,21643,63,142052
19896,0.000194,172.31.40.0-255,66,21709,63,142052
19897,0.000214,172.217.194.0-255,2902,24611,63,142052
19898,0.000216,172.31.40.0-255,66,24677,63,142052
19899,0.000225,172.217.194.0-255,6797,31474,63,142052
19900,0.000228,172.31.40.0-255,66,31540,63,142052
19901,0.000503,172.217.194.0-255,1484,33024,63,142052
19902,0.000509,172.31.40.0-255,66,33090,63,142052
19903,0.000515,172.217.194.0-255,2902,35992,63,142052
19904,0.000517,172.31.40.0-255,66,36058,63,142052
19905,0.000522,172.217.194.0-255,2902,38960,63,142052
19906,0.000529,172.31.40.0-255,66,39026,63,142052
19907,0.000551,172.217.194.0-255,2902,41928,63,142052
19908,0.000553,172.31.40.0-255,66,41994,63,142052
19909,0.000582,172.217.194.0-255,4320,46314,63,142052
19910,0.000585,172.31.40.0-255,66,46380,63,142052
19911,0.000619,172.31.40.0-255,66,46446,63,142052
19912,0.000626,172.217.194.0-255,7156,53602,63,142052
19913,0.000629,172.31.40.0-255,66,53668,63,142052
19914,0.000657,172.217.194.0-255,2543,56211,63,142052
19915,0.00066,172.31.40.0-255,66,56277,63,142052
19916,0.000895,172.217.194.0-255,645,56922,63,142052
19917,0.001124,172.217.194.0-255,1484,58406,63,142052
19918,0.001128,172.31.40.0-255,66,58472,63,142052
19919,0.001134,172.217.194.0-255,2902,61374,63,142052
19920,0.001136,172.31.40.0-255,66,61440,63,142052
19921,0.00116,172.217.194.0-255,2902,64342,63,142052
19922,0.001162,172.31.40.0-255,66,64408,63,142052
19923,0.001202,172.217.194.0-255,2902,67310,63,142052
19924,0.001205,172.31.40.0-255,66,67376,63,142052
19925,0.001215,172.31.40.0-255,66,67442,63,142052
19926,0.001245,172.31.40.0-255,66,67508,63,142052
19927,0.001269,172.217.194.0-255,3602,71110,63,142052
19928,0.001271,172.31.40.0-255,66,71176,63,142052
19929,0.001832,172.217.194.0-255,1484,72660,63,142052
19930,0.00184,172.217.194.0-255,2902,75562,63,142052
19931,0.001844,172.31.40.0-255,66,75628,63,142052
19932,0.001849,172.217.194.0-255,1484,77112,63,142052
19933,0.001873,172.217.194.0-255,4320,81432,63,142052
19934,0.001875,172.31.40.0-255,66,81498,63,142052
19935,0.001879,172.217.194.0-255,1484,82982,63,142052
19936,0.001906,172.217.194.0-255,5738,88720,63,142052
19937,0.001908,172.31.40.0-255,66,88786,63,142052
19938,0.00192,172.217.194.0-255,1484,90270,63,142052
19939,0.001945,172.31.40.0-255,66,90336,63,142052
19940,0.001972,172.217.194.0-255,2902,93238,63,142052
19941,0.001974,172.31.40.0-255,66,93304,63,142052
19942,0.001977,172.217.194.0-255,1484,94788,63,142052
19943,0.00198,172.217.194.0-255,766,95554,63,142052
19944,0.001982,172.31.40.0-255,66,95620,63,142052
19945,0.004037,172.217.194.0-255,5738,101358,63,142052
19946,0.004044,172.31.40.0-255,66,101424,63,142052
19947,0.006131,172.217.194.0-255,5738,107162,63,142052
19948,0.006135,172.31.40.0-255,66,107228,63,142052
19949,0.008209,172.217.194.0-255,5738,112966,63,142052
19950,0.008212,172.31.40.0-255,66,113032,63,142052
19951,0.010289,172.217.194.0-255,5738,118770,63,142052
19952,0.010297,172.31.40.0-255,66,118836,63,142052
19953,0.012383,172.217.194.0-255,5738,124574,63,142052
19954,0.012391,172.31.40.0-255,66,124640,63,142052
19955,0.014497,172.217.194.0-255,5738,130378,63,142052
19956,0.014505,172.31.40.0-255,66,130444,63,142052
19957,0.016594,172.217.194.0-255,5738,136182,63,142052
19958,0.016602,172.31.40.0-255,66,136248,63,142052
19959,0.018673,172.217.194.0-255,5738,141986,63,142052
19960,0.018682,172.31.40.0-255,66,142052,63,142052
19961,0.0,74.125.130.0-255,150,150,63,190311
19962,1.7e-05,172.31.40.0-255,66,216,63,190311
19963,2.4e-05,74.125.130.0-255,1484,1700,63,190311
19964,2.8e-05,172.31.40.0-255,66,1766,63,190311
19965,3.4e-05,74.125.130.0-255,2902,4668,63,190311
19966,3.8e-05,172.31.40.0-255,66,4734,63,190311
19967,5.4e-05,74.125.130.0-255,2902,7636,63,190311
19968,5.7e-05,172.31.40.0-255,66,7702,63,190311
19969,7.7e-05,74.125.130.0-255,1484,9186,63,190311
19970,8e-05,172.31.40.0-255,66,9252,63,190311
19971,8.3e-05,74.125.130.0-255,1484,10736,63,190311
19972,8.5e-05,172.31.40.0-255,66,10802,63,190311
19973,0.000101,74.125.130.0-255,3555,14357,63,190311
19974,0.000104,172.31.40.0-255,66,14423,63,190311
19975,0.000255,74.125.130.0-255,1484,15907,63,190311
19976,0.00026,172.31.40.0-255,66,15973,63,190311
19977,0.000275,74.125.130.0-255,2902,18875,63,190311
19978,0.000278,172.31.40.0-255,66,18941,63,190311
19979,0.000297,74.125.130.0-255,1484,20425,63,190311
19980,0.000299,172.31.40.0-255,66,20491,63,190311
19981,0.000304,74.125.130.0-255,2902,23393,63,190311
19982,0.000306,172.31.40.0-255,66,23459,63,190311
19983,0.000327,74.125.130.0-255,1484,24943,63,190311
19984,0.000329,172.31.40.0-255,66,25009,63,190311
19985,0.000352,74.125.130.0-255,4320,29329,63,190311
19986,0.000354,172.31.40.0-255,66,29395,63,190311
19987,0.000357,74.125.130.0-255,1484,30879,63,190311
19988,0.000359,172.31.40.0-255,66,30945,63,190311
19989,0.000373,74.125.130.0-255,2543,33488,63,190311
19990,0.000376,172.31.40.0-255,66,33554,63,190311
19991,0.000393,74.125.130.0-255,1484,35038,63,190311
19992,0.000395,172.31.40.0-255,66,35104,63,190311
19993,0.000423,74.125.130.0-255,2902,38006,63,190311
19994,0.000426,172.31.40.0-255,66,38072,63,190311
19995,0.00043,74.125.130.0-255,2902,40974,63,190311
19996,0.000432,172.31.40.0-255,66,41040,63,190311
19997,0.000448,74.125.130.0-255,2902,43942,63,190311
19998,0.00045,172.31.40.0-255,66,44008,63,190311
19999,0.000453,74.125.130.0-255,1484,45492,63,190311
20000,0.000458,74.125.130.0-255,2902,48394,63,190311
20001,0.00046,172.31.40.0-255,66,48460,63,190311
20002,0.000495,74.125.130.0-255,5738,54198,63,190311
20003,0.000498,172.31.40.0-255,66,54264,63,190311
20004,0.000502,74.125.130.0-255,1484,55748,63,190311
20005,0.000507,74.125.130.0-255,2902,58650,63,190311
20006,0.000509,172.31.40.0-255,66,58716,63,190311
20007,0.000521,74.125.130.0-255,1484,60200,63,190311
20008,0.00054,74.125.130.0-255,4320,64520,63,190311
20009,0.000543,172.31.40.0-255,66,64586,63,190311
20010,0.000546,74.125.130.0-255,1484,66070,63,190311
20011,0.000588,74.125.130.0-255,1080,67150,63,190311
20012,0.000591,172.31.40.0-255,66,67216,63,190311
20013,0.000812,74.125.130.0-255,363,67579,63,190311
20014,0.001099,74.125.130.0-255,1484,69063,63,190311
20015,0.001104,172.31.40.0-255,66,69129,63,190311
20016,0.001109,74.125.130.0-255,1484,70613,63,190311
20017,0.001124,74.125.130.0-255,1484,72097,63,190311
20018,0.001126,172.31.40.0-255,66,72163,63,190311
20019,0.001149,74.125.130.0-255,4320,76483,63,190311
20020,0.001153,172.31.40.0-255,66,76549,63,190311
20021,0.001192,172.31.40.0-255,66,76615,63,190311
20022,0.001228,74.125.130.0-255,4320,80935,63,190311
20023,0.001231,172.31.40.0-255,66,81001,63,190311
20024,0.001254,74.125.130.0-255,5738,86739,63,190311
20025,0.001257,172.31.40.0-255,66,86805,63,190311
20026,0.001263,74.125.130.0-255,4320,91125,63,190311
20027,0.001265,172.31.40.0-255,66,91191,63,190311
20028,0.001289,74.125.130.0-255,2184,93375,63,190311
20029,0.001292,172.31.40.0-255,66,93441,63,190311
20030,0.001708,74.125.130.0-255,1484,94925,63,190311
20031,0.001715,74.125.130.0-255,1484,96409,63,190311
20032,0.001719,172.31.40.0-255,66,96475,63,190311
20033,0.001737,74.125.130.0-255,1484,97959,63,190311
20034,0.001743,74.125.130.0-255,5738,103697,63,190311
20035,0.001745,172.31.40.0-255,66,103763,63,190311
20036,0.001769,74.125.130.0-255,7156,110919,63,190311
20037,0.001771,172.31.40.0-255,66,110985,63,190311
20038,0.001824,172.31.40.0-255,66,111051,63,190311
20039,0.001861,74.125.130.0-255,3602,114653,63,190311
20040,0.001864,172.31.40.0-255,66,114719,63,190311
20041,0.001943,74.125.130.0-255,1484,116203,63,190311
20042,0.001948,74.125.130.0-255,1484,117687,63,190311
20043,0.001951,172.31.40.0-255,66,117753,63,190311
20044,0.001962,74.125.130.0-255,1484,119237,63,190311
20045,0.001981,74.125.130.0-255,4320,123557,63,190311
20046,0.001984,172.31.40.0-255,66,123623,63,190311
20047,0.002003,74.125.130.0-255,1484,125107,63,190311
20048,0.002006,74.125.130.0-255,1484,126591,63,190311
20049,0.002008,172.31.40.0-255,66,126657,63,190311
20050,0.002012,74.125.130.0-255,2902,129559,63,190311
20051,0.002015,172.31.40.0-255,66,129625,63,190311
20052,0.002045,74.125.130.0-255,5738,135363,63,190311
20053,0.002049,172.31.40.0-255,66,135429,63,190311
20054,0.002054,74.125.130.0-255,2902,138331,63,190311
20055,0.002057,172.31.40.0-255,66,138397,63,190311
20056,0.002078,74.125.130.0-255,4320,142717,63,190311
20057,0.00208,172.31.40.0-255,66,142783,63,190311
20058,0.002122,74.125.130.0-255,6438,149221,63,190311
20059,0.002126,172.31.40.0-255,66,149287,63,190311
20060,0.004531,74.125.130.0-255,5738,155025,63,190311
20061,0.00454,172.31.40.0-255,66,155091,63,190311
20062,0.006911,74.125.130.0-255,2902,157993,63,190311
20063,0.006914,172.31.40.0-255,66,158059,63,190311
20064,0.006934,74.125.130.0-255,2902,160961,63,190311
20065,0.006936,172.31.40.0-255,66,161027,63,190311
20066,0.009279,74.125.130.0-255,2902,163929,63,190311
20067,0.009287,172.31.40.0-255,66,163995,63,190311
20068,0.009318,74.125.130.0-255,2902,166897,63,190311
20069,0.009321,172.31.40.0-255,66,166963,63,190311
20070,0.011658,74.125.130.0-255,2902,169865,63,190311
20071,0.011668,172.31.40.0-255,66,169931,63,190311
20072,0.011692,74.125.130.0-255,2902,172833,63,190311
20073,0.011694,172.31.40.0-255,66,172899,63,190311
20074,0.01404,74.125.130.0-255,5738,178637,63,190311
20075,0.014048,172.31.40.0-255,66,178703,63,190311
20076,0.016433,74.125.130.0-255,5738,184441,63,190311
20077,0.016445,172.31.40.0-255,66,184507,63,190311
20078,0.018824,74.125.130.0-255,5738,190245,63,190311
20079,0.018833,172.31.40.0-255,66,190311,63,190311
20080,0.0,74.125.200.0-255,148,148,63,168195
20081,2.2e-05,172.31.40.0-255,66,214,63,168195
20082,2.9e-05,74.125.200.0-255,1484,1698,63,168195
20083,3.4e-05,172.31.40.0-255,66,1764,63,168195
20084,3.9e-05,74.125.200.0-255,2902,4666,63,168195
20085,4.4e-05,172.31.40.0-255,66,4732,63,168195
20086,4.9e-05,74.125.200.0-255,4320,9052,63,168195
20087,5.2e-05,172.31.40.0-255,66,9118,63,168195
20088,5.9e-05,74.125.200.0-255,4944,14062,63,168195
20089,6.2e-05,172.31.40.0-255,66,14128,63,168195
20090,0.00022,74.125.200.0-255,1484,15612,63,168195
20091,0.000225,172.31.40.0-255,66,15678,63,168195
20092,0.000232,74.125.200.0-255,2902,18580,63,168195
20093,0.000234,172.31.40.0-255,66,18646,63,168195
20094,0.000259,74.125.200.0-255,5738,24384,63,168195
20095,0.000262,172.31.40.0-255,66,24450,63,168195
20096,0.000268,74.125.200.0-255,4320,28770,63,168195
20097,0.00027,172.31.40.0-255,66,28836,63,168195
20098,0.000295,74.125.200.0-255,2543,31379,63,168195
20099,0.000298,172.31.40.0-255,66,31445,63,168195
20100,0.000579,74.125.200.0-255,1484,32929,63,168195
20101,0.000584,172.31.40.0-255,66,32995,63,168195
20102,0.000599,74.125.200.0-255,1484,34479,63,168195
20103,0.000602,172.31.40.0-255,66,34545,63,168195
20104,0.000619,74.125.200.0-255,1484,36029,63,168195
20105,0.000621,172.31.40.0-255,66,36095,63,168195
20106,0.000627,74.125.200.0-255,4320,40415,63,168195
20107,0.000629,172.31.40.0-255,66,40481,63,168195
20108,0.000656,74.125.200.0-255,2902,43383,63,168195
20109,0.000659,172.31.40.0-255,66,43449,63,168195
20110,0.000675,74.125.200.0-255,2902,46351,63,168195
20111,0.000678,172.31.40.0-255,66,46417,63,168195
20112,0.000692,74.125.200.0-255,4320,50737,63,168195
20113,0.000694,172.31.40.0-255,66,50803,63,168195
20114,0.000712,74.125.200.0-255,2543,53346,63,168195
20115,0.000715,172.31.40.0-255,66,53412,63,168195
20116,0.000719,74.125.200.0-255,2902,56314,63,168195
20117,0.000721,172.31.40.0-255,66,56380,63,168195
20118,0.000757,74.125.200.0-255,1484,57864,63,168195
20119,0.00079,172.31.40.0-255,66,57930,63,168195
20120,0.000793,74.125.200.0-255,129,58059,63,168195
20121,0.000909,74.125.200.0-255,346,58405,63,168195
20122,0.001123,172.31.40.0-255,66,58471,63,168195
20123,0.001298,74.125.200.0-255,1484,59955,63,168195
20124,0.001308,74.125.200.0-255,2902,62857,63,168195
20125,0.001312,172.31.40.0-255,66,62923,63,168195
20126,0.00135,74.125.200.0-255,1484,64407,63,168195
20127,0.001378,74.125.200.0-255,1484,65891,63,168195
20128,0.001382,172.31.40.0-255,66,65957,63,168195
20129,0.001437,74.125.200.0-255,1484,67441,63,168195
20130,0.001454,74.125.200.0-255,2902,70343,63,168195
20131,0.001458,172.31.40.0-255,66,70409,63,168195
20132,0.001462,74.125.200.0-255,1484,71893,63,168195
20133,0.001479,74.125.200.0-255,2902,74795,63,168195
20134,0.001481,172.31.40.0-255,66,74861,63,168195
20135,0.001488,74.125.200.0-255,5738,80599,63,168195
20136,0.00149,172.31.40.0-255,66,80665,63,168195
20137,0.00151,74.125.200.0-255,1484,82149,63,168195
20138,0.001523,74.125.200.0-255,1484,83633,63,168195
20139,0.001526,172.31.40.0-255,66,83699,63,168195
20140,0.001542,74.125.200.0-255,1484,85183,63,168195
20141,0.001545,74.125.200.0-255,1484,86667,63,168195
20142,0.001547,172.31.40.0-255,66,86733,63,168195
20143,0.001576,74.125.200.0-255,4320,91053,63,168195
20144,0.001579,172.31.40.0-255,66,91119,63,168195
20145,0.001584,74.125.200.0-255,2184,93303,63,168195
20146,0.001586,172.31.40.0-255,66,93369,63,168195
20147,0.00185,74.125.200.0-255,1484,94853,63,168195
20148,0.001877,74.125.200.0-255,1484,96337,63,168195
20149,0.001881,172.31.40.0-255,66,96403,63,168195
20150,0.001887,74.125.200.0-255,2902,99305,63,168195
20151,0.00189,172.31.40.0-255,66,99371,63,168195
20152,0.001927,74.125.200.0-255,2902,102273,63,168195
20153,0.001931,172.31.40.0-255,66,102339,63,168195
20154,0.001944,74.125.200.0-255,2902,105241,63,168195
20155,0.001946,172.31.40.0-255,66,105307,63,168195
20156,0.001973,74.125.200.0-255,4320,109627,63,168195
20157,0.001976,172.31.40.0-255,66,109693,63,168195
20158,0.001995,74.125.200.0-255,2902,112595,63,168195
20159,0.001998,172.31.40.0-255,66,112661,63,168195
20160,0.002015,74.125.200.0-255,1484,114145,63,168195
20161,0.002029,74.125.200.0-255,4320,118465,63,168195
20162,0.002033,172.31.40.0-255,66,118531,63,168195
20163,0.00206,74.125.200.0-255,2902,121433,63,168195
20164,0.002063,172.31.40.0-255,66,121499,63,168195
20165,0.004066,74.125.200.0-255,2902,124401,63,168195
20166,0.004074,172.31.40.0-255,66,124467,63,168195
20167,0.004094,74.125.200.0-255,2902,127369,63,168195
20168,0.004097,172.31.40.0-255,66,127435,63,168195
20169,0.006104,74.125.200.0-255,2902,130337,63,168195
20170,0.00611,172.31.40.0-255,66,130403,63,168195
20171,0.006126,74.125.200.0-255,2902,133305,63,168195
20172,0.006129,172.31.40.0-255,66,133371,63,168195
20173,0.008156,74.125.200.0-255,5738,139109,63,168195
20174,0.008162,172.31.40.0-255,66,139175,63,168195
20175,0.010214,74.125.200.0-255,5738,144913,63,168195
20176,0.010225,172.31.40.0-255,66,144979,63,168195
20177,0.01227,74.125.200.0-255,5738,150717,63,168195
20178,0.012279,172.31.40.0-255,66,150783,63,168195
20179,0.014323,74.125.200.0-255,5738,156521,63,168195
20180,0.014333,172.31.40.0-255,66,156587,63,168195
20181,0.016383,74.125.200.0-255,5738,162325,63,168195
20182,0.016395,172.31.40.0-255,66,162391,63,168195
20183,0.01844,74.125.200.0-255,5738,168129,63,168195
20184,0.018447,172.31.40.0-255,66,168195,63,168195
20185,0.0,74.125.200.0-255,153,153,63,206654
20186,2.1e-05,172.31.40.0-255,66,219,63,206654
20187,2.8e-05,74.125.200.0-255,1484,1703,63,206654
20188,3.4e-05,172.31.40.0-255,66,1769,63,206654
20189,3.9e-05,74.125.200.0-255,2902,4671,63,206654
20190,5e-05,172.31.40.0-255,66,4737,63,206654
20191,5.4e-05,74.125.200.0-255,1484,6221,63,206654
20192,5.6e-05,172.31.40.0-255,66,6287,63,206654
20193,6e-05,74.125.200.0-255,1484,7771,63,206654
20194,6.3e-05,172.31.40.0-255,66,7837,63,206654
20195,8.3e-05,74.125.200.0-255,1484,9321,63,206654
20196,8.7e-05,172.31.40.0-255,66,9387,63,206654
20197,0.000115,74.125.200.0-255,4984,14371,63,206654
20198,0.000118,172.31.40.0-255,66,14437,63,206654
20199,0.000139,74.125.200.0-255,1484,15921,63,206654
20200,0.000141,172.31.40.0-255,66,15987,63,206654
20201,0.000175,74.125.200.0-255,4320,20307,63,206654
20202,0.000177,172.31.40.0-255,66,20373,63,206654
20203,0.000205,74.125.200.0-255,7156,27529,63,206654
20204,0.000208,172.31.40.0-255,66,27595,63,206654
20205,0.000212,74.125.200.0-255,2902,30497,63,206654
20206,0.000215,172.31.40.0-255,66,30563,63,206654
20207,0.000235,74.125.200.0-255,1125,31688,63,206654
20208,0.000237,172.31.40.0-255,66,31754,63,206654
20209,0.000265,74.125.200.0-255,1484,33238,63,206654
20210,0.000268,172.31.40.0-255,66,33304,63,206654
20211,0.000271,74.125.200.0-255,1484,34788,63,206654
20212,0.000273,172.31.40.0-255,66,34854,63,206654
20213,0.000295,74.125.200.0-255,2902,37756,63,206654
20214,0.000299,172.31.40.0-255,66,37822,63,206654
20215,0.000315,172.31.40.0-255,66,37888,63,206654
20216,0.000343,74.125.200.0-255,1125,39013,63,206654
20217,0.000753,74.125.200.0-255,1484,40497,63,206654
20218,0.000759,172.31.40.0-255,66,40563,63,206654
20219,0.000765,74.125.200.0-255,2902,43465,63,206654
20220,0.000768,172.31.40.0-255,66,43531,63,206654
20221,0.00078,74.125.200.0-255,5738,49269,63,206654
20222,0.000782,172.31.40.0-255,66,49335,63,206654
20223,0.000812,74.125.200.0-255,6797,56132,63,206654
20224,0.000815,172.31.40.0-255,66,56198,63,206654
20225,0.000925,74.125.200.0-255,1484,57682,63,206654
20226,0.000942,74.125.200.0-255,2902,60584,63,206654
20227,0.000945,172.31.40.0-255,66,60650,63,206654
20228,0.000951,74.125.200.0-255,2902,63552,63,206654
20229,0.000952,172.31.40.0-255,66,63618,63,206654
20230,0.000956,74.125.200.0-255,1484,65102,63,206654
20231,0.000979,74.125.200.0-255,2902,68004,63,206654
20232,0.000982,172.31.40.0-255,66,68070,63,206654
20233,0.001009,74.125.200.0-255,4320,72390,63,206654
20234,0.001011,172.31.40.0-255,66,72456,63,206654
20235,0.001048,74.125.200.0-255,5379,77835,63,206654
20236,0.00105,172.31.40.0-255,66,77901,63,206654
20237,0.001056,74.125.200.0-255,4320,82221,63,206654
20238,0.001059,172.31.40.0-255,66,82287,63,206654
20239,0.00107,74.125.200.0-255,5738,88025,63,206654
20240,0.001073,172.31.40.0-255,66,88091,63,206654
20241,0.001076,74.125.200.0-255,2543,90634,63,206654
20242,0.001078,172.31.40.0-255,66,90700,63,206654
20243,0.001142,74.125.200.0-255,1484,92184,63,206654
20244,0.001165,74.125.200.0-255,2902,95086,63,206654
20245,0.001169,172.31.40.0-255,66,95152,63,206654
20246,0.001174,74.125.200.0-255,2902,98054,63,206654
20247,0.001176,172.31.40.0-255,66,98120,63,206654
20248,0.001202,74.125.200.0-255,1484,99604,63,206654
20249,0.001231,172.31.40.0-255,66,99670,63,206654
20250,0.001388,74.125.200.0-255,1484,101154,63,206654
20251,0.001401,74.125.200.0-255,2902,104056,63,206654
20252,0.001403,172.31.40.0-255,66,104122,63,206654
20253,0.001433,74.125.200.0-255,5738,109860,63,206654
20254,0.001436,172.31.40.0-255,66,109926,63,206654
20255,0.001444,74.125.200.0-255,7156,117082,63,206654
20256,0.001447,172.31.40.0-255,66,117148,63,206654
20257,0.001479,172.31.40.0-255,66,117214,63,206654
20258,0.001508,74.125.200.0-255,4320,121534,63,206654
20259,0.001511,172.31.40.0-255,66,121600,63,206654
20260,0.001515,74.125.200.0-255,2184,123784,63,206654
20261,0.001517,172.31.40.0-255,66,123850,63,206654
20262,0.002024,74.125.200.0-255,1484,125334,63,206654
20263,0.002047,74.125.200.0-255,2902,128236,63,206654
20264,0.002051,172.31.40.0-255,66,128302,63,206654
20265,0.002057,74.125.200.0-255,2902,131204,63,206654
20266,0.002059,172.31.40.0-255,66,131270,63,206654
20267,0.002087,74.125.200.0-255,2902,134172,63,206654
20268,0.002089,172.31.40.0-255,66,134238,63,206654
20269,0.002097,74.125.200.0-255,7156,141394,63,206654
20270,0.002099,172.31.40.0-255,66,141460,63,206654
20271,0.002113,172.31.40.0-255,66,141526,63,206654
20272,0.002141,74.125.200.0-255,6824,148350,63,206654
20273,0.002144,172.31.40.0-255,66,148416,63,206654
20274,0.002147,74.125.200.0-255,1484,149900,63,206654
20275,0.002175,74.125.200.0-255,5738,155638,63,206654
20276,0.002178,172.31.40.0-255,66,155704,63,206654
20277,0.002189,172.31.40.0-255,66,155770,63,206654
20278,0.002195,74.125.200.0-255,5738,161508,63,206654
20279,0.002197,172.31.40.0-255,66,161574,63,206654
20280,0.002225,74.125.200.0-255,4320,165894,63,206654
20281,0.002227,172.31.40.0-255,66,165960,63,206654
20282,0.002238,172.31.40.0-255,66,166026,63,206654
20283,0.004569,74.125.200.0-255,5738,171764,63,206654
20284,0.004576,172.31.40.0-255,66,171830,63,206654
20285,0.006901,74.125.200.0-255,5738,177568,63,206654
20286,0.006905,172.31.40.0-255,66,177634,63,206654
20287,0.009246,74.125.200.0-255,5738,183372,63,206654
20288,0.009253,172.31.40.0-255,66,183438,63,206654
20289,0.011581,74.125.200.0-255,5738,189176,63,206654
20290,0.011589,172.31.40.0-255,66,189242,63,206654
20291,0.013925,74.125.200.0-255,5738,194980,63,206654
20292,0.013934,172.31.40.0-255,66,195046,63,206654
20293,0.016272,74.125.200.0-255,5738,200784,63,206654
20294,0.01628,172.31.40.0-255,66,200850,63,206654
20295,0.018629,74.125.200.0-255,5738,206588,63,206654
20296,0.018646,172.31.40.0-255,66,206654,63,206654
20297,0.0,172.217.194.0-255,152,152,63,199633
20298,1.6e-05,172.31.40.0-255,66,218,63,199633
20299,2.2e-05,172.217.194.0-255,1484,1702,63,199633
20300,2.6e-05,172.31.40.0-255,66,1768,63,199633
20301,3.8e-05,172.217.194.0-255,2902,4670,63,199633
20302,4.1e-05,172.31.40.0-255,66,4736,63,199633
20303,7.5e-05,172.217.194.0-255,7156,11892,63,199633
20304,7.8e-05,172.31.40.0-255,66,11958,63,199633
20305,8.3e-05,172.217.194.0-255,2137,14095,63,199633
20306,8.5e-05,172.31.40.0-255,66,14161,63,199633
20307,0.000148,172.217.194.0-255,1484,15645,63,199633
20308,0.00015,172.31.40.0-255,66,15711,63,199633
20309,0.000155,172.217.194.0-255,2902,18613,63,199633
20310,0.000158,172.31.40.0-255,66,18679,63,199633
20311,0.000185,172.217.194.0-255,5738,24417,63,199633
20312,0.000187,172.31.40.0-255,66,24483,63,199633
20313,0.000226,172.217.194.0-255,4320,28803,63,199633
20314,0.000229,172.31.40.0-255,66,28869,63,199633
20315,0.000262,172.217.194.0-255,3961,32830,63,199633
20316,0.000264,172.31.40.0-255,66,32896,63,199633
20317,0.000275,172.31.40.0-255,66,32962,63,199633
20318,0.000286,172.217.194.0-255,6797,39759,63,199633
20319,0.000288,172.31.40.0-255,66,39825,63,199633
20320,0.000328,172.217.194.0-255,2902,42727,63,199633
20321,0.00033,172.31.40.0-255,66,42793,63,199633
20322,0.000336,172.217.194.0-255,4320,47113,63,199633
20323,0.000338,172.31.40.0-255,66,47179,63,199633
20324,0.000341,172.217.194.0-255,1484,48663,63,199633
20325,0.000343,172.31.40.0-255,66,48729,63,199633
20326,0.000382,172.217.194.0-255,7156,55885,63,199633
20327,0.000385,172.31.40.0-255,66,55951,63,199633
20328,0.000388,172.217.194.0-255,1401,57352,63,199633
20329,0.000391,172.217.194.0-255,113,57465,63,199633
20330,0.000413,172.217.194.0-255,386,57851,63,199633
20331,0.000415,172.31.40.0-255,66,57917,63,199633
20332,0.000552,172.217.194.0-255,1484,59401,63,199633
20333,0.000575,172.217.194.0-255,2902,62303,63,199633
20334,0.000578,172.31.40.0-255,66,62369,63,199633
20335,0.000585,172.217.194.0-255,5738,68107,63,199633
20336,0.000587,172.31.40.0-255,66,68173,63,199633
20337,0.000597,172.217.194.0-255,5738,73911,63,199633
20338,0.0006,172.31.40.0-255,66,73977,63,199633
20339,0.000625,172.217.194.0-255,1125,75102,63,199633
20340,0.000628,172.217.194.0-255,1484,76586,63,199633
20341,0.000634,172.31.40.0-255,66,76652,63,199633
20342,0.000662,172.217.194.0-255,4320,80972,63,199633
20343,0.000664,172.31.40.0-255,66,81038,63,199633
20344,0.000676,172.31.40.0-255,66,81104,63,199633
20345,0.000683,172.217.194.0-255,1125,82229,63,199633
20346,0.000824,172.217.194.0-255,1484,83713,63,199633
20347,0.000828,172.31.40.0-255,66,83779,63,199633
20348,0.000834,172.217.194.0-255,2902,86681,63,199633
20349,0.000836,172.31.40.0-255,66,86747,63,199633
20350,0.000849,172.217.194.0-255,5738,92485,63,199633
20351,0.000852,172.31.40.0-255,66,92551,63,199633
20352,0.000895,172.31.40.0-255,66,92617,63,199633
20353,0.000935,172.31.40.0-255,66,92683,63,199633
20354,0.000938,172.217.194.0-255,1484,94167,63,199633
20355,0.000997,172.217.194.0-255,2902,97069,63,199633
20356,0.001,172.31.40.0-255,66,97135,63,199633
20357,0.001006,172.217.194.0-255,5738,102873,63,199633
20358,0.001009,172.31.40.0-255,66,102939,63,199633
20359,0.001025,172.31.40.0-255,66,103005,63,199633
20360,0.001036,172.31.40.0-255,66,103071,63,199633
20361,0.001041,172.217.194.0-255,5020,108091,63,199633
20362,0.001044,172.31.40.0-255,66,108157,63,199633
20363,0.001091,172.217.194.0-255,1484,109641,63,199633
20364,0.001095,172.217.194.0-255,2902,112543,63,199633
20365,0.001099,172.31.40.0-255,66,112609,63,199633
20366,0.001126,172.217.194.0-255,5738,118347,63,199633
20367,0.00113,172.31.40.0-255,66,118413,63,199633
20368,0.001143,172.217.194.0-255,7156,125569,63,199633
20369,0.00115,172.31.40.0-255,66,125635,63,199633
20370,0.001178,172.217.194.0-255,5738,131373,63,199633
20371,0.001181,172.31.40.0-255,66,131439,63,199633
20372,0.001196,172.31.40.0-255,66,131505,63,199633
20373,0.0012,172.217.194.0-255,2184,133689,63,199633
20374,0.001202,172.31.40.0-255,66,133755,63,199633
20375,0.001366,172.217.194.0-255,1484,135239,63,199633
20376,0.001373,172.217.194.0-255,2902,138141,63,199633
20377,0.001376,172.31.40.0-255,66,138207,63,199633
20378,0.001379,172.217.194.0-255,1484,139691,63,199633
20379,0.001411,172.217.194.0-255,4320,144011,63,199633
20380,0.001414,172.31.40.0-255,66,144077,63,199633
20381,0.001431,172.31.40.0-255,66,144143,63,199633
20382,0.00146,172.217.194.0-255,7156,151299,63,199633
20383,0.001463,172.31.40.0-255,66,151365,63,199633
20384,0.001491,172.217.194.0-255,5020,156385,63,199633
20385,0.001505,172.31.40.0-255,66,156451,63,199633
20386,0.001513,172.31.40.0-255,66,156517,63,199633
20387,0.001524,172.217.194.0-255,5738,162255,63,199633
20388,0.001531,172.31.40.0-255,66,162321,63,199633
20389,0.001569,172.31.40.0-255,66,162387,63,199633
20390,0.001594,172.217.194.0-255,1484,163871,63,199633
20391,0.001599,172.217.194.0-255,2902,166773,63,199633
20392,0.001601,172.31.40.0-255,66,166839,63,199633
20393,0.001633,172.217.194.0-255,5738,172577,63,199633
20394,0.001636,172.31.40.0-255,66,172643,63,199633
20395,0.001639,172.217.194.0-255,1484,174127,63,199633
20396,0.001696,172.31.40.0-255,66,174193,63,199633
20397,0.001776,172.217.194.0-255,1484,175677,63,199633
20398,0.001782,172.217.194.0-255,2902,178579,63,199633
20399,0.001785,172.31.40.0-255,66,178645,63,199633
20400,0.001816,172.217.194.0-255,5738,184383,63,199633
20401,0.001824,172.217.194.0-255,7156,191539,63,199633
20402,0.001883,172.217.194.0-255,2184,193723,63,199633
20403,0.001892,172.31.40.0-255,66,193789,63,199633
20404,0.001924,172.217.194.0-255,4320,198109,63,199633
20405,0.001937,172.31.40.0-255,66,198175,63,199633
20406,0.001974,172.31.40.0-255,66,198241,63,199633
20407,0.002052,172.217.194.0-255,984,199225,63,199633
20408,0.002055,172.31.40.0-255,66,199291,63,199633
20409,0.002124,172.217.194.0-255,105,199396,63,199633
20410,0.004601,172.31.40.0-255,66,199462,63,199633
20411,0.004637,172.31.40.0-255,105,199567,63,199633
20412,0.006916,172.217.194.0-255,66,199633,63,199633
20413,0.0,74.125.24.0-255,153,153,63,159901
20414,1.6e-05,172.31.40.0-255,66,219,63,159901
20415,2.3e-05,74.125.24.0-255,1484,1703,63,159901
20416,2.7e-05,172.31.40.0-255,66,1769,63,159901
20417,3.3e-05,74.125.24.0-255,2902,4671,63,159901
20418,3.7e-05,172.31.40.0-255,66,4737,63,159901
20419,4.3e-05,74.125.24.0-255,5738,10475,63,159901
20420,4.6e-05,172.31.40.0-255,66,10541,63,159901
20421,9.3e-05,172.31.40.0-255,66,10607,63,159901
20422,0.000101,74.125.24.0-255,6797,17404,63,159901
20423,0.000103,172.31.40.0-255,66,17470,63,159901
20424,0.000138,74.125.24.0-255,1484,18954,63,159901
20425,0.000141,172.31.40.0-255,66,19020,63,159901
20426,0.000146,74.125.24.0-255,2902,21922,63,159901
20427,0.000147,172.31.40.0-255,66,21988,63,159901
20428,0.000153,74.125.24.0-255,4320,26308,63,159901
20429,0.000155,172.31.40.0-255,66,26374,63,159901
20430,0.000169,74.125.24.0-255,1484,27858,63,159901
20431,0.000171,172.31.40.0-255,66,27924,63,159901
20432,0.000178,74.125.24.0-255,6797,34721,63,159901
20433,0.00018,172.31.40.0-255,66,34787,63,159901
20434,0.000234,172.31.40.0-255,66,34853,63,159901
20435,0.000238,74.125.24.0-255,2854,37707,63,159901
20436,0.00024,172.31.40.0-255,66,37773,63,159901
20437,0.000243,74.125.24.0-255,111,37884,63,159901
20438,0.000246,172.31.40.0-255,66,37950,63,159901
20439,0.000269,74.125.24.0-255,331,38281,63,159901
20440,0.000272,172.31.40.0-255,66,38347,63,159901
20441,0.000612,74.125.24.0-255,1484,39831,63,159901
20442,0.000618,172.31.40.0-255,66,39897,63,159901
20443,0.000624,74.125.24.0-255,2902,42799,63,159901
20444,0.000631,74.125.24.0-255,5738,48537,63,159901
20445,0.000634,74.125.24.0-255,1484,50021,63,159901
20446,0.000642,172.31.40.0-255,66,50087,63,159901
20447,0.000677,172.31.40.0-255,66,50153,63,159901
20448,0.000697,172.31.40.0-255,66,50219,63,159901
20449,0.000704,74.125.24.0-255,766,50985,63,159901
20450,0.001001,74.125.24.0-255,1484,52469,63,159901
20451,0.001006,172.31.40.0-255,66,52535,63,159901
20452,0.001013,74.125.24.0-255,2902,55437,63,159901
20453,0.001019,74.125.24.0-255,5738,61175,63,159901
20454,0.001024,172.31.40.0-255,66,61241,63,159901
20455,0.001056,172.31.40.0-255,66,61307,63,159901
20456,0.001121,172.31.40.0-255,66,61373,63,159901
20457,0.00114,172.31.40.0-255,66,61439,63,159901
20458,0.001153,74.125.24.0-255,4320,65759,63,159901
20459,0.001185,172.31.40.0-255,66,65825,63,159901
20460,0.001194,74.125.24.0-255,4320,70145,63,159901
20461,0.001198,172.31.40.0-255,66,70211,63,159901
20462,0.001211,74.125.24.0-255,3602,73813,63,159901
20463,0.001281,74.125.24.0-255,3602,77415,63,159901
20464,0.001285,172.31.40.0-255,66,77481,63,159901
20465,0.001289,172.31.40.0-255,66,77547,63,159901
20466,0.001298,74.125.24.0-255,1484,79031,63,159901
20467,0.0013,74.125.24.0-255,1484,80515,63,159901
20468,0.001312,74.125.24.0-255,1484,81999,63,159901
20469,0.001318,74.125.24.0-255,5738,87737,63,159901
20470,0.001326,172.31.40.0-255,66,87803,63,159901
20471,0.001359,74.125.24.0-255,1484,89287,63,159901
20472,0.001369,172.31.40.0-255,66,89353,63,159901
20473,0.001373,172.31.40.0-255,66,89419,63,159901
20474,0.001392,74.125.24.0-255,2184,91603,63,159901
20475,0.001411,172.31.40.0-255,66,91669,63,159901
20476,0.001419,74.125.24.0-255,2902,94571,63,159901
20477,0.001429,74.125.24.0-255,2902,97473,63,159901
20478,0.001432,172.31.40.0-255,66,97539,63,159901
20479,0.001448,74.125.24.0-255,4320,101859,63,159901
20480,0.001457,172.31.40.0-255,66,101925,63,159901
20481,0.001507,172.31.40.0-255,66,101991,63,159901
20482,0.001532,74.125.24.0-255,4320,106311,63,159901
20483,0.001538,172.31.40.0-255,66,106377,63,159901
20484,0.001581,74.125.24.0-255,6438,112815,63,159901
20485,0.001596,172.31.40.0-255,66,112881,63,159901
20486,0.001614,74.125.24.0-255,1484,114365,63,159901
20487,0.001626,74.125.24.0-255,2902,117267,63,159901
20488,0.001634,172.31.40.0-255,66,117333,63,159901
20489,0.001651,74.125.24.0-255,5738,123071,63,159901
20490,0.001656,74.125.24.0-255,2902,125973,63,159901
20491,0.001666,172.31.40.0-255,66,126039,63,159901
20492,0.001689,74.125.24.0-255,1484,127523,63,159901
20493,0.001711,74.125.24.0-255,4320,131843,63,159901
20494,0.001715,172.31.40.0-255,66,131909,63,159901
20495,0.001729,74.125.24.0-255,5020,136929,63,159901
20496,0.00175,172.31.40.0-255,66,136995,63,159901
20497,0.001843,74.125.24.0-255,1484,138479,63,159901
20498,0.001858,74.125.24.0-255,2902,141381,63,159901
20499,0.001861,74.125.24.0-255,1484,142865,63,159901
20500,0.001876,74.125.24.0-255,4320,147185,63,159901
20501,0.001879,74.125.24.0-255,1484,148669,63,159901
20502,0.001889,172.31.40.0-255,66,148735,63,159901
20503,0.001955,74.125.24.0-255,7156,155891,63,159901
20504,0.001967,172.31.40.0-255,66,155957,63,159901
20505,0.001982,74.125.24.0-255,3602,159559,63,159901
20506,0.002017,74.125.24.0-255,105,159664,63,159901
20507,0.002036,172.31.40.0-255,66,159730,63,159901
20508,0.010058,172.31.40.0-255,105,159835,63,159901
20509,0.012344,74.125.24.0-255,66,159901,63,159901
20510,0.0,172.217.194.0-255,152,152,63,130088
20511,2.1e-05,172.31.40.0-255,66,218,63,130088
20512,2.8e-05,172.217.194.0-255,1484,1702,63,130088
20513,3.3e-05,172.31.40.0-255,66,1768,63,130088
20514,3.9e-05,172.217.194.0-255,2902,4670,63,130088
20515,4.2e-05,172.31.40.0-255,66,4736,63,130088
20516,4.6e-05,172.217.194.0-255,2902,7638,63,130088
20517,5e-05,172.31.40.0-255,66,7704,63,130088
20518,5.6e-05,172.217.194.0-255,4320,12024,63,130088
20519,5.8e-05,172.31.40.0-255,66,12090,63,130088
20520,9.8e-05,172.31.40.0-255,66,12156,63,130088
20521,0.000109,172.31.40.0-255,66,12222,63,130088
20522,0.000145,172.217.194.0-255,2902,15124,63,130088
20523,0.000148,172.31.40.0-255,66,15190,63,130088
20524,0.000151,172.217.194.0-255,1484,16674,63,130088
20525,0.000153,172.31.40.0-255,66,16740,63,130088
20526,0.000171,172.217.194.0-255,2902,19642,63,130088
20527,0.000174,172.31.40.0-255,66,19708,63,130088
20528,0.000184,172.31.40.0-255,66,19774,63,130088
20529,0.000187,172.217.194.0-255,1125,20899,63,130088
20530,0.000189,172.31.40.0-255,66,20965,63,130088
20531,0.000226,172.217.194.0-255,4320,25285,63,130088
20532,0.000229,172.31.40.0-255,66,25351,63,130088
20533,0.000253,172.217.194.0-255,5738,31089,63,130088
20534,0.000256,172.31.40.0-255,66,31155,63,130088
20535,0.000277,172.217.194.0-255,1484,32639,63,130088
20536,0.000281,172.31.40.0-255,66,32705,63,130088
20537,0.000287,172.217.194.0-255,5379,38084,63,130088
20538,0.000289,172.31.40.0-255,66,38150,63,130088
20539,0.000292,172.217.194.0-255,413,38563,63,130088
20540,0.000889,172.217.194.0-255,364,38927,63,130088
20541,0.000917,172.217.194.0-255,1484,40411,63,130088
20542,0.000921,172.31.40.0-255,66,40477,63,130088
20543,0.000952,172.217.194.0-255,2902,43379,63,130088
20544,0.000955,172.31.40.0-255,66,43445,63,130088
20545,0.00096,172.217.194.0-255,4320,47765,63,130088
20546,0.000962,172.31.40.0-255,66,47831,63,130088
20547,0.001012,172.31.40.0-255,66,47897,63,130088
20548,0.001083,172.217.194.0-255,1484,49381,63,130088
20549,0.001088,172.217.194.0-255,2902,52283,63,130088
20550,0.001091,172.31.40.0-255,66,52349,63,130088
20551,0.001118,172.217.194.0-255,5738,58087,63,130088
20552,0.00112,172.31.40.0-255,66,58153,63,130088
20553,0.001124,172.217.194.0-255,1484,59637,63,130088
20554,0.001143,172.217.194.0-255,4320,63957,63,130088
20555,0.001145,172.31.40.0-255,66,64023,63,130088
20556,0.001156,172.217.194.0-255,1125,65148,63,130088
20557,0.001409,172.31.40.0-255,66,65214,63,130088
20558,0.001948,172.217.194.0-255,1484,66698,63,130088
20559,0.001957,172.217.194.0-255,2902,69600,63,130088
20560,0.001961,172.31.40.0-255,66,69666,63,130088
20561,0.001988,172.217.194.0-255,5738,75404,63,130088
20562,0.00199,172.31.40.0-255,66,75470,63,130088
20563,0.001995,172.217.194.0-255,2902,78372,63,130088
20564,0.001998,172.31.40.0-255,66,78438,63,130088
20565,0.002027,172.31.40.0-255,66,78504,63,130088
20566,0.002034,172.217.194.0-255,7156,85660,63,130088
20567,0.002036,172.31.40.0-255,66,85726,63,130088
20568,0.002055,172.217.194.0-255,3602,89328,63,130088
20569,0.002057,172.31.40.0-255,66,89394,63,130088
20570,0.004366,172.217.194.0-255,1484,90878,63,130088
20571,0.004387,172.217.194.0-255,4320,95198,63,130088
20572,0.004391,172.31.40.0-255,66,95264,63,130088
20573,0.006721,172.217.194.0-255,5738,101002,63,130088
20574,0.006728,172.31.40.0-255,66,101068,63,130088
20575,0.009063,172.217.194.0-255,5738,106806,63,130088
20576,0.009069,172.31.40.0-255,66,106872,63,130088
20577,0.011426,172.217.194.0-255,5738,112610,63,130088
20578,0.011435,172.31.40.0-255,66,112676,63,130088
20579,0.013782,172.217.194.0-255,5738,118414,63,130088
20580,0.013793,172.31.40.0-255,66,118480,63,130088
20581,0.016109,172.217.194.0-255,5738,124218,63,130088
20582,0.01612,172.31.40.0-255,66,124284,63,130088
20583,0.018424,172.217.194.0-255,5738,130022,63,130088
20584,0.018433,172.31.40.0-255,66,130088,63,130088
20585,0.0,172.31.40.0-255,66,66,63,66
20586,0.0,172.217.194.0-255,153,153,63,221745
20587,3.5e-05,172.31.40.0-255,66,219,63,221745
20588,4.2e-05,172.217.194.0-255,1484,1703,63,221745
20589,4.6e-05,172.31.40.0-255,66,1769,63,221745
20590,5.1e-05,172.217.194.0-255,2902,4671,63,221745
20591,5.3e-05,172.31.40.0-255,66,4737,63,221745
20592,6.1e-05,172.217.194.0-255,7156,11893,63,221745
20593,6.4e-05,172.31.40.0-255,66,11959,63,221745
20594,6.7e-05,172.217.194.0-255,2100,14059,63,221745
20595,7e-05,172.31.40.0-255,66,14125,63,221745
20596,0.000107,172.217.194.0-255,2902,17027,63,221745
20597,0.00011,172.31.40.0-255,66,17093,63,221745
20598,0.000113,172.217.194.0-255,1484,18577,63,221745
20599,0.000114,172.31.40.0-255,66,18643,63,221745
20600,0.000133,172.217.194.0-255,2902,21545,63,221745
20601,0.000136,172.31.40.0-255,66,21611,63,221745
20602,0.000138,172.217.194.0-255,1484,23095,63,221745
20603,0.00014,172.31.40.0-255,66,23161,63,221745
20604,0.000175,172.217.194.0-255,7156,30317,63,221745
20605,0.000178,172.31.40.0-255,66,30383,63,221745
20606,0.000181,172.217.194.0-255,1125,31508,63,221745
20607,0.000182,172.31.40.0-255,66,31574,63,221745
20608,0.000186,172.217.194.0-255,1484,33058,63,221745
20609,0.000189,172.31.40.0-255,66,33124,63,221745
20610,0.000214,172.217.194.0-255,4320,37444,63,221745
20611,0.000217,172.31.40.0-255,66,37510,63,221745
20612,0.000237,172.217.194.0-255,2902,40412,63,221745
20613,0.000239,172.31.40.0-255,66,40478,63,221745
20614,0.000257,172.217.194.0-255,7156,47634,63,221745
20615,0.000259,172.31.40.0-255,66,47700,63,221745
20616,0.000262,172.217.194.0-255,1125,48825,63,221745
20617,0.000264,172.31.40.0-255,66,48891,63,221745
20618,0.001037,172.217.194.0-255,1484,50375,63,221745
20619,0.001048,172.217.194.0-255,2902,53277,63,221745
20620,0.001053,172.31.40.0-255,66,53343,63,221745
20621,0.001058,172.217.194.0-255,1484,54827,63,221745
20622,0.00108,172.217.194.0-255,4320,59147,63,221745
20623,0.001083,172.31.40.0-255,66,59213,63,221745
20624,0.001088,172.217.194.0-255,4320,63533,63,221745
20625,0.001091,172.31.40.0-255,66,63599,63,221745
20626,0.001133,172.217.194.0-255,2543,66142,63,221745
20627,0.001136,172.31.40.0-255,66,66208,63,221745
20628,0.001252,172.217.194.0-255,1484,67692,63,221745
20629,0.001277,172.217.194.0-255,2902,70594,63,221745
20630,0.00128,172.31.40.0-255,66,70660,63,221745
20631,0.001287,172.217.194.0-255,5738,76398,63,221745
20632,0.001289,172.31.40.0-255,66,76464,63,221745
20633,0.001301,172.31.40.0-255,66,76530,63,221745
20634,0.001342,172.217.194.0-255,4320,80850,63,221745
20635,0.001345,172.31.40.0-255,66,80916,63,221745
20636,0.00137,172.31.40.0-255,66,80982,63,221745
20637,0.001627,172.217.194.0-255,645,81627,63,221745
20638,0.001667,172.217.194.0-255,1484,83111,63,221745
20639,0.00167,172.31.40.0-255,66,83177,63,221745
20640,0.001699,172.217.194.0-255,2902,86079,63,221745
20641,0.001702,172.31.40.0-255,66,86145,63,221745
20642,0.001707,172.217.194.0-255,5738,91883,63,221745
20643,0.00171,172.31.40.0-255,66,91949,63,221745
20644,0.001715,172.217.194.0-255,5738,97687,63,221745
20645,0.001717,172.31.40.0-255,66,97753,63,221745
20646,0.001734,172.217.194.0-255,7156,104909,63,221745
20647,0.001737,172.31.40.0-255,66,104975,63,221745
20648,0.001747,172.31.40.0-255,66,105041,63,221745
20649,0.001769,172.217.194.0-255,766,105807,63,221745
20650,0.002099,172.217.194.0-255,1484,107291,63,221745
20651,0.002101,172.31.40.0-255,66,107357,63,221745
20652,0.002106,172.217.194.0-255,2902,110259,63,221745
20653,0.002108,172.31.40.0-255,66,110325,63,221745
20654,0.002119,172.217.194.0-255,1484,111809,63,221745
20655,0.002132,172.217.194.0-255,4320,116129,63,221745
20656,0.002135,172.31.40.0-255,66,116195,63,221745
20657,0.00214,172.217.194.0-255,5738,121933,63,221745
20658,0.002142,172.31.40.0-255,66,121999,63,221745
20659,0.002202,172.31.40.0-255,66,122065,63,221745
20660,0.002207,172.217.194.0-255,5020,127085,63,221745
20661,0.002209,172.31.40.0-255,66,127151,63,221745
20662,0.002215,172.217.194.0-255,5738,132889,63,221745
20663,0.002217,172.31.40.0-255,66,132955,63,221745
20664,0.002224,172.217.194.0-255,7156,140111,63,221745
20665,0.002226,172.31.40.0-255,66,140177,63,221745
20666,0.002248,172.217.194.0-255,5738,145915,63,221745
20667,0.002251,172.31.40.0-255,66,145981,63,221745
20668,0.002262,172.31.40.0-255,66,146047,63,221745
20669,0.0023,172.217.194.0-255,5738,151785,63,221745
20670,0.002302,172.31.40.0-255,66,151851,63,221745
20671,0.002341,172.31.40.0-255,66,151917,63,221745
20672,0.002346,172.217.194.0-255,4320,156237,63,221745
20673,0.002348,172.31.40.0-255,66,156303,63,221745
20674,0.002371,172.217.194.0-255,6438,162741,63,221745
20675,0.002374,172.31.40.0-255,66,162807,63,221745
20676,0.00238,172.217.194.0-255,7156,169963,63,221745
20677,0.002382,172.31.40.0-255,66,170029,63,221745
20678,0.002394,172.217.194.0-255,4320,174349,63,221745
20679,0.002397,172.31.40.0-255,66,174415,63,221745
20680,0.002415,172.31.40.0-255,66,174481,63,221745
20681,0.002434,172.217.194.0-255,2902,177383,63,221745
20682,0.002436,172.31.40.0-255,66,177449,63,221745
20683,0.002441,172.217.194.0-255,4320,181769,63,221745
20684,0.002443,172.31.40.0-255,66,181835,63,221745
20685,0.002465,172.217.194.0-255,5020,186855,63,221745
20686,0.002467,172.31.40.0-255,66,186921,63,221745
20687,0.005084,172.217.194.0-255,5738,192659,63,221745
20688,0.005089,172.31.40.0-255,66,192725,63,221745
20689,0.007745,172.217.194.0-255,5738,198463,63,221745
20690,0.007776,172.31.40.0-255,66,198529,63,221745
20691,0.010444,172.217.194.0-255,5738,204267,63,221745
20692,0.010461,172.31.40.0-255,66,204333,63,221745
20693,0.013112,172.217.194.0-255,5738,210071,63,221745
20694,0.013129,172.31.40.0-255,66,210137,63,221745
20695,0.015763,172.217.194.0-255,5738,215875,63,221745
20696,0.015782,172.31.40.0-255,66,215941,63,221745
20697,0.018424,172.217.194.0-255,5738,221679,63,221745
20698,0.018437,172.31.40.0-255,66,221745,63,221745
20699,0.0,74.125.130.0-255,153,153,63,256436
20700,2.3e-05,172.31.40.0-255,66,219,63,256436
20701,3e-05,74.125.130.0-255,1484,1703,63,256436
20702,3.4e-05,172.31.40.0-255,66,1769,63,256436
20703,3.7e-05,74.125.130.0-255,1484,3253,63,256436
20704,3.9e-05,172.31.40.0-255,66,3319,63,256436
20705,5.3e-05,74.125.130.0-255,2902,6221,63,256436
20706,5.6e-05,172.31.40.0-255,66,6287,63,256436
20707,6.3e-05,74.125.130.0-255,5738,12025,63,256436
20708,6.5e-05,172.31.40.0-255,66,12091,63,256436
20709,6.9e-05,74.125.130.0-255,2068,14159,63,256436
20710,7.1e-05,172.31.40.0-255,66,14225,63,256436
20711,0.000287,74.125.130.0-255,1484,15709,63,256436
20712,0.000294,172.31.40.0-255,66,15775,63,256436
20713,0.000299,74.125.130.0-255,2902,18677,63,256436
20714,0.000301,172.31.40.0-255,66,18743,63,256436
20715,0.000304,74.125.130.0-255,1484,20227,63,256436
20716,0.000306,172.31.40.0-255,66,20293,63,256436
20717,0.000336,74.125.130.0-255,2902,23195,63,256436
20718,0.000339,172.31.40.0-255,66,23261,63,256436
20719,0.000344,74.125.130.0-255,4320,27581,63,256436
20720,0.000347,172.31.40.0-255,66,27647,63,256436
20721,0.000365,74.125.130.0-255,1484,29131,63,256436
20722,0.000367,172.31.40.0-255,66,29197,63,256436
20723,0.000371,74.125.130.0-255,2543,31740,63,256436
20724,0.000373,172.31.40.0-255,66,31806,63,256436
20725,0.000378,74.125.130.0-255,2902,34708,63,256436
20726,0.000385,172.31.40.0-255,66,34774,63,256436
20727,0.000417,74.125.130.0-255,7156,41930,63,256436
20728,0.00042,172.31.40.0-255,66,41996,63,256436
20729,0.000426,74.125.130.0-255,5738,47734,63,256436
20730,0.000428,172.31.40.0-255,66,47800,63,256436
20731,0.000459,74.125.130.0-255,7156,54956,63,256436
20732,0.000461,172.31.40.0-255,66,55022,63,256436
20733,0.000466,74.125.130.0-255,2902,57924,63,256436
20734,0.000468,172.31.40.0-255,66,57990,63,256436
20735,0.000496,74.125.130.0-255,5738,63728,63,256436
20736,0.000499,172.31.40.0-255,66,63794,63,256436
20737,0.000521,74.125.130.0-255,2184,65978,63,256436
20738,0.000523,172.31.40.0-255,66,66044,63,256436
20739,0.000551,74.125.130.0-255,389,66433,63,256436
20740,0.000669,74.125.130.0-255,1484,67917,63,256436
20741,0.000674,172.31.40.0-255,66,67983,63,256436
20742,0.000679,74.125.130.0-255,2902,70885,63,256436
20743,0.000682,172.31.40.0-255,66,70951,63,256436
20744,0.000705,74.125.130.0-255,5738,76689,63,256436
20745,0.000707,172.31.40.0-255,66,76755,63,256436
20746,0.00071,74.125.130.0-255,1484,78239,63,256436
20747,0.000735,74.125.130.0-255,4320,82559,63,256436
20748,0.000738,172.31.40.0-255,66,82625,63,256436
20749,0.000745,74.125.130.0-255,7156,89781,63,256436
20750,0.000747,172.31.40.0-255,66,89847,63,256436
20751,0.000782,172.31.40.0-255,66,89913,63,256436
20752,0.00081,74.125.130.0-255,385,90298,63,256436
20753,0.000966,74.125.130.0-255,1484,91782,63,256436
20754,0.00097,172.31.40.0-255,66,91848,63,256436
20755,0.000975,74.125.130.0-255,2902,94750,63,256436
20756,0.000977,172.31.40.0-255,66,94816,63,256436
20757,0.000999,74.125.130.0-255,5738,100554,63,256436
20758,0.001002,172.31.40.0-255,66,100620,63,256436
20759,0.001007,74.125.130.0-255,2902,103522,63,256436
20760,0.001009,172.31.40.0-255,66,103588,63,256436
20761,0.001042,74.125.130.0-255,4320,107908,63,256436
20762,0.001044,172.31.40.0-255,66,107974,63,256436
20763,0.001055,172.31.40.0-255,66,108040,63,256436
20764,0.00106,74.125.130.0-255,4320,112360,63,256436
20765,0.001063,172.31.40.0-255,66,112426,63,256436
20766,0.001119,74.125.130.0-255,3602,116028,63,256436
20767,0.001121,172.31.40.0-255,66,116094,63,256436
20768,0.001297,74.125.130.0-255,1484,117578,63,256436
20769,0.001316,74.125.130.0-255,2902,120480,63,256436
20770,0.00132,172.31.40.0-255,66,120546,63,256436
20771,0.001351,74.125.130.0-255,4320,124866,63,256436
20772,0.001361,172.31.40.0-255,66,124932,63,256436
20773,0.001363,172.31.40.0-255,66,124998,63,256436
20774,0.001374,74.125.130.0-255,4320,129318,63,256436
20775,0.001376,172.31.40.0-255,66,129384,63,256436
20776,0.001402,74.125.130.0-255,4320,133704,63,256436
20777,0.001405,172.31.40.0-255,66,133770,63,256436
20778,0.001417,74.125.130.0-255,4320,138090,63,256436
20779,0.001419,172.31.40.0-255,66,138156,63,256436
20780,0.001442,74.125.130.0-255,3602,141758,63,256436
20781,0.001444,172.31.40.0-255,66,141824,63,256436
20782,0.001512,74.125.130.0-255,1484,143308,63,256436
20783,0.001525,74.125.130.0-255,1484,144792,63,256436
20784,0.001528,172.31.40.0-255,66,144858,63,256436
20785,0.001558,74.125.130.0-255,1484,146342,63,256436
20786,0.001564,74.125.130.0-255,5738,152080,63,256436
20787,0.001566,172.31.40.0-255,66,152146,63,256436
20788,0.001571,74.125.130.0-255,2902,155048,63,256436
20789,0.001572,172.31.40.0-255,66,155114,63,256436
20790,0.001606,74.125.130.0-255,4320,159434,63,256436
20791,0.001609,172.31.40.0-255,66,159500,63,256436
20792,0.001618,172.31.40.0-255,66,159566,63,256436
20793,0.001624,74.125.130.0-255,5738,165304,63,256436
20794,0.001626,172.31.40.0-255,66,165370,63,256436
20795,0.001656,74.125.130.0-255,2184,167554,63,256436
20796,0.001658,172.31.40.0-255,66,167620,63,256436
20797,0.001807,74.125.130.0-255,1484,169104,63,256436
20798,0.00181,74.125.130.0-255,1484,170588,63,256436
20799,0.001814,172.31.40.0-255,66,170654,63,256436
20800,0.001822,74.125.130.0-255,1484,172138,63,256436
20801,0.001847,74.125.130.0-255,5738,177876,63,256436
20802,0.001849,172.31.40.0-255,66,177942,63,256436
20803,0.001878,74.125.130.0-255,2902,180844,63,256436
20804,0.00188,172.31.40.0-255,66,180910,63,256436
20805,0.001915,172.31.40.0-255,66,180976,63,256436
20806,0.001918,74.125.130.0-255,1484,182460,63,256436
20807,0.001955,172.31.40.0-255,66,182526,63,256436
20808,0.002193,74.125.130.0-255,1484,184010,63,256436
20809,0.002199,74.125.130.0-255,2902,186912,63,256436
20810,0.002201,172.31.40.0-255,66,186978,63,256436
20811,0.002231,74.125.130.0-255,4320,191298,63,256436
20812,0.002234,172.31.40.0-255,66,191364,63,256436
20813,0.002244,74.125.130.0-255,5738,197102,63,256436
20814,0.00225,172.31.40.0-255,66,197168,63,256436
20815,0.002281,172.31.40.0-255,66,197234,63,256436
20816,0.002286,74.125.130.0-255,4320,201554,63,256436
20817,0.002287,172.31.40.0-255,66,201620,63,256436
20818,0.002339,74.125.130.0-255,2902,204522,63,256436
20819,0.002341,172.31.40.0-255,66,204588,63,256436
20820,0.002369,172.31.40.0-255,66,204654,63,256436
20821,0.002409,172.31.40.0-255,66,204720,63,256436
20822,0.002413,74.125.130.0-255,4320,209040,63,256436
20823,0.002415,172.31.40.0-255,66,209106,63,256436
20824,0.002447,74.125.130.0-255,2184,211290,63,256436
20825,0.00245,172.31.40.0-255,66,211356,63,256436
20826,0.002488,74.125.130.0-255,1484,212840,63,256436
20827,0.002503,74.125.130.0-255,2902,215742,63,256436
20828,0.002505,172.31.40.0-255,66,215808,63,256436
20829,0.002537,74.125.130.0-255,5738,221546,63,256436
20830,0.002539,172.31.40.0-255,66,221612,63,256436
20831,0.005048,74.125.130.0-255,5738,227350,63,256436
20832,0.005066,172.31.40.0-255,66,227416,63,256436
20833,0.007638,74.125.130.0-255,5738,233154,63,256436
20834,0.007655,172.31.40.0-255,66,233220,63,256436
20835,0.010163,74.125.130.0-255,5738,238958,63,256436
20836,0.010167,172.31.40.0-255,66,239024,63,256436
20837,0.012693,74.125.130.0-255,5738,244762,63,256436
20838,0.012701,172.31.40.0-255,66,244828,63,256436
20839,0.015214,74.125.130.0-255,5738,250566,63,256436
20840,0.015228,172.31.40.0-255,66,250632,63,256436
20841,0.017746,74.125.130.0-255,5738,256370,63,256436
20842,0.01776,172.31.40.0-255,66,256436,63,256436
20843,0.0,74.125.24.0-255,153,153,63,139399
20844,2.4e-05,172.31.40.0-255,66,219,63,139399
20845,3.1e-05,74.125.24.0-255,1484,1703,63,139399
20846,3.6e-05,172.31.40.0-255,66,1769,63,139399
20847,3.9e-05,74.125.24.0-255,1484,3253,63,139399
20848,5.1e-05,172.31.40.0-255,66,3319,63,139399
20849,5.9e-05,74.125.24.0-255,4320,7639,63,139399
20850,6.2e-05,172.31.40.0-255,66,7705,63,139399
20851,0.000102,74.125.24.0-255,6293,13998,63,139399
20852,0.000105,172.31.40.0-255,66,14064,63,139399
20853,0.000112,74.125.24.0-255,7156,21220,63,139399
20854,0.000115,172.31.40.0-255,66,21286,63,139399
20855,0.000137,74.125.24.0-255,1484,22770,63,139399
20856,0.000139,172.31.40.0-255,66,22836,63,139399
20857,0.00018,172.31.40.0-255,66,22902,63,139399
20858,0.000186,74.125.24.0-255,4320,27222,63,139399
20859,0.000188,172.31.40.0-255,66,27288,63,139399
20860,0.000229,172.31.40.0-255,66,27354,63,139399
20861,0.000244,172.31.40.0-255,66,27420,63,139399
20862,0.00025,74.125.24.0-255,4232,31652,63,139399
20863,0.000252,172.31.40.0-255,66,31718,63,139399
20864,0.000349,74.125.24.0-255,385,32103,63,139399
20865,0.000352,172.31.40.0-255,66,32169,63,139399
20866,0.000491,74.125.24.0-255,1484,33653,63,139399
20867,0.000495,172.31.40.0-255,66,33719,63,139399
20868,0.000501,74.125.24.0-255,2902,36621,63,139399
20869,0.000503,172.31.40.0-255,66,36687,63,139399
20870,0.000529,74.125.24.0-255,5738,42425,63,139399
20871,0.000531,172.31.40.0-255,66,42491,63,139399
20872,0.000541,74.125.24.0-255,4320,46811,63,139399
20873,0.000543,172.31.40.0-255,66,46877,63,139399
20874,0.000581,172.31.40.0-255,66,46943,63,139399
20875,0.000623,172.31.40.0-255,66,47009,63,139399
20876,0.000947,74.125.24.0-255,1484,48493,63,139399
20877,0.000954,74.125.24.0-255,2902,51395,63,139399
20878,0.000958,172.31.40.0-255,66,51461,63,139399
20879,0.000965,74.125.24.0-255,5738,57199,63,139399
20880,0.000967,172.31.40.0-255,66,57265,63,139399
20881,0.000986,74.125.24.0-255,4320,61585,63,139399
20882,0.000992,172.31.40.0-255,66,61651,63,139399
20883,0.001031,172.31.40.0-255,66,61717,63,139399
20884,0.001048,172.31.40.0-255,66,61783,63,139399
20885,0.00105,74.125.24.0-255,766,62549,63,139399
20886,0.001077,74.125.24.0-255,1484,64033,63,139399
20887,0.00108,172.31.40.0-255,66,64099,63,139399
20888,0.001085,74.125.24.0-255,4320,68419,63,139399
20889,0.001087,172.31.40.0-255,66,68485,63,139399
20890,0.001123,172.31.40.0-255,66,68551,63,139399
20891,0.001126,74.125.24.0-255,1484,70035,63,139399
20892,0.001161,172.31.40.0-255,66,70101,63,139399
20893,0.001166,74.125.24.0-255,2902,73003,63,139399
20894,0.001168,172.31.40.0-255,66,73069,63,139399
20895,0.001201,74.125.24.0-255,6438,79507,63,139399
20896,0.001204,172.31.40.0-255,66,79573,63,139399
20897,0.001207,74.125.24.0-255,1484,81057,63,139399
20898,0.00122,74.125.24.0-255,2902,83959,63,139399
20899,0.001226,172.31.40.0-255,66,84025,63,139399
20900,0.001233,74.125.24.0-255,5738,89763,63,139399
20901,0.001235,172.31.40.0-255,66,89829,63,139399
20902,0.001239,74.125.24.0-255,1484,91313,63,139399
20903,0.001286,172.31.40.0-255,66,91379,63,139399
20904,0.001306,172.31.40.0-255,66,91445,63,139399
20905,0.001309,74.125.24.0-255,766,92211,63,139399
20906,0.001339,74.125.24.0-255,1484,93695,63,139399
20907,0.001342,172.31.40.0-255,66,93761,63,139399
20908,0.001346,74.125.24.0-255,1484,95245,63,139399
20909,0.001374,74.125.24.0-255,2902,98147,63,139399
20910,0.001376,172.31.40.0-255,66,98213,63,139399
20911,0.001384,74.125.24.0-255,5738,103951,63,139399
20912,0.001387,172.31.40.0-255,66,104017,63,139399
20913,0.001392,74.125.24.0-255,4320,108337,63,139399
20914,0.001395,172.31.40.0-255,66,108403,63,139399
20915,0.001425,74.125.24.0-255,7156,115559,63,139399
20916,0.001428,172.31.40.0-255,66,115625,63,139399
20917,0.001438,172.31.40.0-255,66,115691,63,139399
20918,0.001466,74.125.24.0-255,2184,117875,63,139399
20919,0.001472,172.31.40.0-255,66,117941,63,139399
20920,0.001576,74.125.24.0-255,1484,119425,63,139399
20921,0.001582,74.125.24.0-255,2902,122327,63,139399
20922,0.001585,172.31.40.0-255,66,122393,63,139399
20923,0.001592,74.125.24.0-255,5738,128131,63,139399
20924,0.001595,172.31.40.0-255,66,128197,63,139399
20925,0.001635,74.125.24.0-255,1484,129681,63,139399
20926,0.001676,172.31.40.0-255,66,129747,63,139399
20927,0.001687,172.31.40.0-255,66,129813,63,139399
20928,0.001729,172.31.40.0-255,66,129879,63,139399
20929,0.001732,74.125.24.0-255,1484,131363,63,139399
20930,0.001746,172.31.40.0-255,66,131429,63,139399
20931,0.001774,172.31.40.0-255,66,131495,63,139399
20932,0.001796,172.31.40.0-255,66,131561,63,139399
20933,0.001861,74.125.24.0-255,2184,133745,63,139399
20934,0.001864,74.125.24.0-255,2902,136647,63,139399
20935,0.001939,74.125.24.0-255,2313,138960,63,139399
20936,0.001957,74.125.24.0-255,97,139057,63,139399
20937,0.002011,74.125.24.0-255,105,139162,63,139399
20938,0.006397,172.31.40.0-255,66,139228,63,139399
20939,0.009073,172.31.40.0-255,105,139333,63,139399
20940,0.01142,74.125.24.0-255,66,139399,63,139399
20941,0.0,172.217.194.0-255,152,152,63,92252
20942,2.2e-05,172.31.40.0-255,66,218,63,92252
20943,2.9e-05,172.217.194.0-255,1484,1702,63,92252
20944,3.4e-05,172.31.40.0-255,66,1768,63,92252
20945,4.9e-05,172.217.194.0-255,2902,4670,63,92252
20946,5.3e-05,172.31.40.0-255,66,4736,63,92252
20947,5.9e-05,172.217.194.0-255,4320,9056,63,92252
20948,6.2e-05,172.31.40.0-255,66,9122,63,92252
20949,7.4e-05,172.31.40.0-255,66,9188,63,92252
20950,0.000109,172.31.40.0-255,66,9254,63,92252
20951,0.000134,172.217.194.0-255,2543,11797,63,92252
20952,0.000137,172.31.40.0-255,66,11863,63,92252
20953,0.000158,172.217.194.0-255,1484,13347,63,92252
20954,0.000161,172.31.40.0-255,66,13413,63,92252
20955,0.000165,172.217.194.0-255,2902,16315,63,92252
20956,0.000167,172.31.40.0-255,66,16381,63,92252
20957,0.000173,172.217.194.0-255,4320,20701,63,92252
20958,0.000175,172.31.40.0-255,66,20767,63,92252
20959,0.000206,172.217.194.0-255,1484,22251,63,92252
20960,0.000209,172.31.40.0-255,66,22317,63,92252
20961,0.000215,172.217.194.0-255,5738,28055,63,92252
20962,0.000217,172.31.40.0-255,66,28121,63,92252
20963,0.000232,172.31.40.0-255,66,28187,63,92252
20964,0.000237,172.217.194.0-255,4249,32436,63,92252
20965,0.000239,172.31.40.0-255,66,32502,63,92252
20966,0.000268,172.217.194.0-255,399,32901,63,92252
20967,0.000271,172.31.40.0-255,66,32967,63,92252
20968,0.000385,172.217.194.0-255,1484,34451,63,92252
20969,0.00039,172.31.40.0-255,66,34517,63,92252
20970,0.000396,172.217.194.0-255,2902,37419,63,92252
20971,0.000399,172.31.40.0-255,66,37485,63,92252
20972,0.00041,172.217.194.0-255,4320,41805,63,92252
20973,0.000413,172.31.40.0-255,66,41871,63,92252
20974,0.000437,172.217.194.0-255,1484,43355,63,92252
20975,0.00046,172.31.40.0-255,66,43421,63,92252
20976,0.000473,172.31.40.0-255,66,43487,63,92252
20977,0.000476,172.217.194.0-255,1125,44612,63,92252
20978,0.000826,172.217.194.0-255,1484,46096,63,92252
20979,0.000832,172.217.194.0-255,2902,48998,63,92252
20980,0.000838,172.31.40.0-255,66,49064,63,92252
20981,0.000846,172.31.40.0-255,66,49130,63,92252
20982,0.000853,172.217.194.0-255,5738,54868,63,92252
20983,0.000859,172.31.40.0-255,66,54934,63,92252
20984,0.000916,172.31.40.0-255,66,55000,63,92252
20985,0.000928,172.31.40.0-255,66,55066,63,92252
20986,0.001467,172.217.194.0-255,1484,56550,63,92252
20987,0.001474,172.217.194.0-255,2902,59452,63,92252
20988,0.001478,172.31.40.0-255,66,59518,63,92252
20989,0.001482,172.217.194.0-255,1484,61002,63,92252
20990,0.001512,172.217.194.0-255,4320,65322,63,92252
20991,0.001515,172.31.40.0-255,66,65388,63,92252
20992,0.001522,172.217.194.0-255,7156,72544,63,92252
20993,0.001524,172.31.40.0-255,66,72610,63,92252
20994,0.001566,172.31.40.0-255,66,72676,63,92252
20995,0.00157,172.217.194.0-255,2184,74860,63,92252
20996,0.001572,172.31.40.0-255,66,74926,63,92252
20997,0.001653,172.217.194.0-255,1484,76410,63,92252
20998,0.001668,172.217.194.0-255,2902,79312,63,92252
20999,0.001671,172.31.40.0-255,66,79378,63,92252
21000,0.001678,172.217.194.0-255,5738,85116,63,92252
21001,0.00168,172.31.40.0-255,66,85182,63,92252
21002,0.001725,172.31.40.0-255,66,85248,63,92252
21003,0.001728,172.31.40.0-255,66,85314,63,92252
21004,0.001736,172.217.194.0-255,1484,86798,63,92252
21005,0.001764,172.217.194.0-255,4320,91118,63,92252
21006,0.001766,172.31.40.0-255,66,91184,63,92252
21007,0.001851,172.31.40.0-255,66,91250,63,92252
21008,0.001853,172.31.40.0-255,66,91316,63,92252
21009,0.001906,172.31.40.0-255,66,91382,63,92252
21010,0.001918,172.31.40.0-255,66,91448,63,92252
21011,0.001951,172.31.40.0-255,66,91514,63,92252
21012,0.001984,172.31.40.0-255,66,91580,63,92252
21013,0.001998,172.31.40.0-255,66,91646,63,92252
21014,0.002009,172.31.40.0-255,66,91712,63,92252
21015,0.002052,172.31.40.0-255,66,91778,63,92252
21016,0.002066,172.31.40.0-255,66,91844,63,92252
21017,0.002108,172.31.40.0-255,66,91910,63,92252
21018,0.00211,172.217.194.0-255,105,92015,63,92252
21019,0.003781,172.31.40.0-255,66,92081,63,92252
21020,0.003817,172.31.40.0-255,105,92186,63,92252
21021,0.006323,172.217.194.0-255,66,92252,63,92252
21022,0.0,74.125.24.0-255,152,152,63,135888
21023,2.1e-05,172.31.40.0-255,66,218,63,135888
21024,2.7e-05,74.125.24.0-255,1484,1702,63,135888
21025,3.2e-05,172.31.40.0-255,66,1768,63,135888
21026,3.8e-05,74.125.24.0-255,2902,4670,63,135888
21027,4.1e-05,172.31.40.0-255,66,4736,63,135888
21028,5.8e-05,74.125.24.0-255,1484,6220,63,135888
21029,6.1e-05,172.31.40.0-255,66,6286,63,135888
21030,8.2e-05,74.125.24.0-255,4320,10606,63,135888
21031,8.5e-05,172.31.40.0-255,66,10672,63,135888
21032,9.1e-05,74.125.24.0-255,3457,14129,63,135888
21033,9.4e-05,172.31.40.0-255,66,14195,63,135888
21034,0.000144,74.125.24.0-255,1484,15679,63,135888
21035,0.000147,172.31.40.0-255,66,15745,63,135888
21036,0.00015,74.125.24.0-255,1484,17229,63,135888
21037,0.000152,172.31.40.0-255,66,17295,63,135888
21038,0.000167,74.125.24.0-255,1484,18779,63,135888
21039,0.000169,172.31.40.0-255,66,18845,63,135888
21040,0.000176,74.125.24.0-255,5738,24583,63,135888
21041,0.000179,172.31.40.0-255,66,24649,63,135888
21042,0.000209,74.125.24.0-255,4320,28969,63,135888
21043,0.000212,172.31.40.0-255,66,29035,63,135888
21044,0.000234,74.125.24.0-255,2543,31578,63,135888
21045,0.000236,172.31.40.0-255,66,31644,63,135888
21046,0.000243,74.125.24.0-255,5738,37382,63,135888
21047,0.000245,172.31.40.0-255,66,37448,63,135888
21048,0.00026,74.125.24.0-255,5738,43186,63,135888
21049,0.000263,172.31.40.0-255,66,43252,63,135888
21050,0.000326,74.125.24.0-255,5379,48631,63,135888
21051,0.00033,172.31.40.0-255,66,48697,63,135888
21052,0.00092,74.125.24.0-255,1484,50181,63,135888
21053,0.000926,172.31.40.0-255,66,50247,63,135888
21054,0.000932,74.125.24.0-255,2902,53149,63,135888
21055,0.000934,172.31.40.0-255,66,53215,63,135888
21056,0.000965,74.125.24.0-255,5738,58953,63,135888
21057,0.000968,172.31.40.0-255,66,59019,63,135888
21058,0.000974,74.125.24.0-255,4320,63339,63,135888
21059,0.000976,172.31.40.0-255,66,63405,63,135888
21060,0.001014,74.125.24.0-255,3122,66527,63,135888
21061,0.001017,172.31.40.0-255,66,66593,63,135888
21062,0.001723,74.125.24.0-255,1484,68077,63,135888
21063,0.001734,74.125.24.0-255,2902,70979,63,135888
21064,0.001739,172.31.40.0-255,66,71045,63,135888
21065,0.001748,74.125.24.0-255,5738,76783,63,135888
21066,0.00175,172.31.40.0-255,66,76849,63,135888
21067,0.00179,172.31.40.0-255,66,76915,63,135888
21068,0.001808,74.125.24.0-255,1484,78399,63,135888
21069,0.001816,74.125.24.0-255,7156,85555,63,135888
21070,0.001818,172.31.40.0-255,66,85621,63,135888
21071,0.001836,74.125.24.0-255,3602,89223,63,135888
21072,0.001838,172.31.40.0-255,66,89289,63,135888
21073,0.003906,74.125.24.0-255,5738,95027,63,135888
21074,0.003911,172.31.40.0-255,66,95093,63,135888
21075,0.006033,74.125.24.0-255,5738,100831,63,135888
21076,0.006036,172.31.40.0-255,66,100897,63,135888
21077,0.007107,172.31.40.0-255,101,100998,63,135888
21078,0.008147,74.125.24.0-255,5738,106736,63,135888
21079,0.008154,172.31.40.0-255,66,106802,63,135888
21080,0.009166,74.125.24.0-255,66,106868,63,135888
21081,0.010259,74.125.24.0-255,5738,112606,63,135888
21082,0.010267,172.31.40.0-255,66,112672,63,135888
21083,0.012345,74.125.24.0-255,5738,118410,63,135888
21084,0.012353,172.31.40.0-255,66,118476,63,135888
21085,0.014447,74.125.24.0-255,5738,124214,63,135888
21086,0.014455,172.31.40.0-255,66,124280,63,135888
21087,0.016558,74.125.24.0-255,5738,130018,63,135888
21088,0.016566,172.31.40.0-255,66,130084,63,135888
21089,0.01865,74.125.24.0-255,5738,135822,63,135888
21090,0.018658,172.31.40.0-255,66,135888,63,135888
21091,0.0,74.125.68.0-255,150,150,63,231665
21092,2.2e-05,172.31.40.0-255,66,216,63,231665
21093,3e-05,74.125.68.0-255,1484,1700,63,231665
21094,3.4e-05,172.31.40.0-255,66,1766,63,231665
21095,3.9e-05,74.125.68.0-255,2902,4668,63,231665
21096,4.2e-05,172.31.40.0-255,66,4734,63,231665
21097,4.6e-05,74.125.68.0-255,2902,7636,63,231665
21098,5.1e-05,172.31.40.0-255,66,7702,63,231665
21099,6.9e-05,74.125.68.0-255,2902,10604,63,231665
21100,7.2e-05,172.31.40.0-255,66,10670,63,231665
21101,7.8e-05,74.125.68.0-255,3544,14214,63,231665
21102,8.1e-05,172.31.40.0-255,66,14280,63,231665
21103,0.000257,74.125.68.0-255,1484,15764,63,231665
21104,0.000262,172.31.40.0-255,66,15830,63,231665
21105,0.000266,74.125.68.0-255,1484,17314,63,231665
21106,0.000268,172.31.40.0-255,66,17380,63,231665
21107,0.000283,74.125.68.0-255,1484,18864,63,231665
21108,0.000286,172.31.40.0-255,66,18930,63,231665
21109,0.000291,74.125.68.0-255,2902,21832,63,231665
21110,0.000293,172.31.40.0-255,66,21898,63,231665
21111,0.000299,74.125.68.0-255,4320,26218,63,231665
21112,0.000301,172.31.40.0-255,66,26284,63,231665
21113,0.00034,74.125.68.0-255,5379,31663,63,231665
21114,0.000344,172.31.40.0-255,66,31729,63,231665
21115,0.000375,74.125.68.0-255,5738,37467,63,231665
21116,0.000378,172.31.40.0-255,66,37533,63,231665
21117,0.000382,74.125.68.0-255,2902,40435,63,231665
21118,0.000385,172.31.40.0-255,66,40501,63,231665
21119,0.000408,172.31.40.0-255,66,40567,63,231665
21120,0.000447,74.125.68.0-255,1484,42051,63,231665
21121,0.00045,172.31.40.0-255,66,42117,63,231665
21122,0.000455,74.125.68.0-255,2902,45019,63,231665
21123,0.000458,172.31.40.0-255,66,45085,63,231665
21124,0.000474,74.125.68.0-255,5738,50823,63,231665
21125,0.000477,172.31.40.0-255,66,50889,63,231665
21126,0.000481,74.125.68.0-255,2902,53791,63,231665
21127,0.000483,172.31.40.0-255,66,53857,63,231665
21128,0.000516,74.125.68.0-255,4271,58128,63,231665
21129,0.00052,172.31.40.0-255,66,58194,63,231665
21130,0.000523,74.125.68.0-255,110,58304,63,231665
21131,0.000647,74.125.68.0-255,331,58635,63,231665
21132,0.000996,172.31.40.0-255,66,58701,63,231665
21133,0.001039,74.125.68.0-255,1484,60185,63,231665
21134,0.001044,74.125.68.0-255,2902,63087,63,231665
21135,0.001047,172.31.40.0-255,66,63153,63,231665
21136,0.001061,74.125.68.0-255,1484,64637,63,231665
21137,0.001078,74.125.68.0-255,4320,68957,63,231665
21138,0.00108,172.31.40.0-255,66,69023,63,231665
21139,0.001097,74.125.68.0-255,5738,74761,63,231665
21140,0.001099,172.31.40.0-255,66,74827,63,231665
21141,0.001113,74.125.68.0-255,2902,77729,63,231665
21142,0.001115,172.31.40.0-255,66,77795,63,231665
21143,0.001121,74.125.68.0-255,4320,82115,63,231665
21144,0.001123,172.31.40.0-255,66,82181,63,231665
21145,0.001151,74.125.68.0-255,5738,87919,63,231665
21146,0.001153,172.31.40.0-255,66,87985,63,231665
21147,0.001156,74.125.68.0-255,1484,89469,63,231665
21148,0.001177,74.125.68.0-255,3602,93071,63,231665
21149,0.00118,172.31.40.0-255,66,93137,63,231665
21150,0.0014,74.125.68.0-255,1484,94621,63,231665
21151,0.001406,74.125.68.0-255,2902,97523,63,231665
21152,0.001409,172.31.40.0-255,66,97589,63,231665
21153,0.001412,74.125.68.0-255,1484,99073,63,231665
21154,0.001427,74.125.68.0-255,4320,103393,63,231665
21155,0.00143,172.31.40.0-255,66,103459,63,231665
21156,0.001461,74.125.68.0-255,5738,109197,63,231665
21157,0.001465,172.31.40.0-255,66,109263,63,231665
21158,0.001474,74.125.68.0-255,2902,112165,63,231665
21159,0.001477,172.31.40.0-255,66,112231,63,231665
21160,0.001489,172.31.40.0-255,66,112297,63,231665
21161,0.001493,74.125.68.0-255,2902,115199,63,231665
21162,0.001495,172.31.40.0-255,66,115265,63,231665
21163,0.001518,74.125.68.0-255,2184,117449,63,231665
21164,0.00152,172.31.40.0-255,66,117515,63,231665
21165,0.001954,74.125.68.0-255,1484,118999,63,231665
21166,0.001962,74.125.68.0-255,1484,120483,63,231665
21167,0.001966,172.31.40.0-255,66,120549,63,231665
21168,0.001986,74.125.68.0-255,1484,122033,63,231665
21169,0.001994,74.125.68.0-255,5738,127771,63,231665
21170,0.001996,172.31.40.0-255,66,127837,63,231665
21171,0.002001,74.125.68.0-255,4320,132157,63,231665
21172,0.002003,172.31.40.0-255,66,132223,63,231665
21173,0.002016,74.125.68.0-255,2902,135125,63,231665
21174,0.002018,172.31.40.0-255,66,135191,63,231665
21175,0.002039,74.125.68.0-255,1484,136675,63,231665
21176,0.002057,74.125.68.0-255,7156,143831,63,231665
21177,0.00206,172.31.40.0-255,66,143897,63,231665
21178,0.002067,74.125.68.0-255,7156,151053,63,231665
21179,0.002069,172.31.40.0-255,66,151119,63,231665
21180,0.002121,74.125.68.0-255,766,151885,63,231665
21181,0.002124,74.125.68.0-255,1484,153369,63,231665
21182,0.002127,172.31.40.0-255,66,153435,63,231665
21183,0.002131,74.125.68.0-255,2902,156337,63,231665
21184,0.002133,172.31.40.0-255,66,156403,63,231665
21185,0.002148,74.125.68.0-255,1484,157887,63,231665
21186,0.002154,74.125.68.0-255,5738,163625,63,231665
21187,0.002156,172.31.40.0-255,66,163691,63,231665
21188,0.002188,74.125.68.0-255,7156,170847,63,231665
21189,0.002191,172.31.40.0-255,66,170913,63,231665
21190,0.002194,74.125.68.0-255,1484,172397,63,231665
21191,0.002216,74.125.68.0-255,7156,179553,63,231665
21192,0.002218,172.31.40.0-255,66,179619,63,231665
21193,0.00224,74.125.68.0-255,4320,183939,63,231665
21194,0.002243,172.31.40.0-255,66,184005,63,231665
21195,0.002259,74.125.68.0-255,2184,186189,63,231665
21196,0.002263,172.31.40.0-255,66,186255,63,231665
21197,0.002444,74.125.68.0-255,1484,187739,63,231665
21198,0.002504,74.125.68.0-255,1484,189223,63,231665
21199,0.002509,172.31.40.0-255,66,189289,63,231665
21200,0.002528,74.125.68.0-255,1484,190773,63,231665
21201,0.002545,74.125.68.0-255,1484,192257,63,231665
21202,0.002547,172.31.40.0-255,66,192323,63,231665
21203,0.002551,74.125.68.0-255,1484,193807,63,231665
21204,0.002571,74.125.68.0-255,2902,196709,63,231665
21205,0.002574,172.31.40.0-255,66,196775,63,231665
21206,0.005048,74.125.68.0-255,1484,198259,63,231665
21207,0.005082,74.125.68.0-255,4320,202579,63,231665
21208,0.005088,172.31.40.0-255,66,202645,63,231665
21209,0.007604,74.125.68.0-255,5738,208383,63,231665
21210,0.007611,172.31.40.0-255,66,208449,63,231665
21211,0.01013,74.125.68.0-255,5738,214187,63,231665
21212,0.010138,172.31.40.0-255,66,214253,63,231665
21213,0.012662,74.125.68.0-255,5738,219991,63,231665
21214,0.01267,172.31.40.0-255,66,220057,63,231665
21215,0.015197,74.125.68.0-255,5738,225795,63,231665
21216,0.015205,172.31.40.0-255,66,225861,63,231665
21217,0.017757,74.125.68.0-255,5738,231599,63,231665
21218,0.017765,172.31.40.0-255,66,231665,63,231665
21219,0.0,172.217.194.0-255,153,153,63,154722
21220,2.1e-05,172.31.40.0-255,66,219,63,154722
21221,2.8e-05,172.217.194.0-255,1484,1703,63,154722
21222,3.2e-05,172.31.40.0-255,66,1769,63,154722
21223,3.6e-05,172.217.194.0-255,2902,4671,63,154722
21224,4.5e-05,172.31.40.0-255,66,4737,63,154722
21225,5.3e-05,172.217.194.0-255,4320,9057,63,154722
21226,5.7e-05,172.31.40.0-255,66,9123,63,154722
21227,6.2e-05,172.217.194.0-255,4875,13998,63,154722
21228,6.5e-05,172.31.40.0-255,66,14064,63,154722
21229,0.000105,172.31.40.0-255,66,14130,63,154722
21230,0.000111,172.217.194.0-255,5379,19509,63,154722
21231,0.000113,172.31.40.0-255,66,19575,63,154722
21232,0.000164,172.217.194.0-255,1484,21059,63,154722
21233,0.000167,172.31.40.0-255,66,21125,63,154722
21234,0.00017,172.217.194.0-255,1484,22609,63,154722
21235,0.000172,172.31.40.0-255,66,22675,63,154722
21236,0.000194,172.217.194.0-255,1484,24159,63,154722
21237,0.000196,172.31.40.0-255,66,24225,63,154722
21238,0.000202,172.217.194.0-255,5738,29963,63,154722
21239,0.000205,172.31.40.0-255,66,30029,63,154722
21240,0.000251,172.31.40.0-255,66,30095,63,154722
21241,0.000255,172.217.194.0-255,2902,32997,63,154722
21242,0.000257,172.31.40.0-255,66,33063,63,154722
21243,0.000281,172.217.194.0-255,5738,38801,63,154722
21244,0.000283,172.31.40.0-255,66,38867,63,154722
21245,0.000302,172.217.194.0-255,2902,41769,63,154722
21246,0.000304,172.31.40.0-255,66,41835,63,154722
21247,0.000322,172.217.194.0-255,1745,43580,63,154722
21248,0.000324,172.31.40.0-255,66,43646,63,154722
21249,0.000485,172.217.194.0-255,1484,45130,63,154722
21250,0.00049,172.217.194.0-255,1484,46614,63,154722
21251,0.000504,172.217.194.0-255,1484,48098,63,154722
21252,0.000516,172.217.194.0-255,4320,52418,63,154722
21253,0.000525,172.31.40.0-255,66,52484,63,154722
21254,0.000528,172.217.194.0-255,1484,53968,63,154722
21255,0.00055,172.31.40.0-255,66,54034,63,154722
21256,0.000581,172.217.194.0-255,4320,58354,63,154722
21257,0.000586,172.31.40.0-255,66,58420,63,154722
21258,0.00063,172.31.40.0-255,66,58486,63,154722
21259,0.001153,172.217.194.0-255,1484,59970,63,154722
21260,0.001158,172.217.194.0-255,2902,62872,63,154722
21261,0.001161,172.31.40.0-255,66,62938,63,154722
21262,0.001167,172.217.194.0-255,4320,67258,63,154722
21263,0.001168,172.31.40.0-255,66,67324,63,154722
21264,0.00118,172.217.194.0-255,1484,68808,63,154722
21265,0.00119,172.217.194.0-255,7156,75964,63,154722
21266,0.001219,172.31.40.0-255,66,76030,63,154722
21267,0.001249,172.217.194.0-255,5738,81768,63,154722
21268,0.001254,172.31.40.0-255,66,81834,63,154722
21269,0.001294,172.217.194.0-255,1484,83318,63,154722
21270,0.001305,172.217.194.0-255,1484,84802,63,154722
21271,0.001308,172.31.40.0-255,66,84868,63,154722
21272,0.001359,172.217.194.0-255,1484,86352,63,154722
21273,0.001362,172.217.194.0-255,2184,88536,63,154722
21274,0.001366,172.217.194.0-255,2902,91438,63,154722
21275,0.001376,172.217.194.0-255,1484,92922,63,154722
21276,0.001381,172.31.40.0-255,66,92988,63,154722
21277,0.00139,172.217.194.0-255,2902,95890,63,154722
21278,0.001394,172.31.40.0-255,66,95956,63,154722
21279,0.001409,172.217.194.0-255,5738,101694,63,154722
21280,0.001445,172.217.194.0-255,1484,103178,63,154722
21281,0.001455,172.31.40.0-255,66,103244,63,154722
21282,0.001493,172.31.40.0-255,66,103310,63,154722
21283,0.001695,172.217.194.0-255,1484,104794,63,154722
21284,0.001702,172.217.194.0-255,2902,107696,63,154722
21285,0.00172,172.217.194.0-255,2902,110598,63,154722
21286,0.001723,172.31.40.0-255,66,110664,63,154722
21287,0.001732,172.217.194.0-255,2902,113566,63,154722
21288,0.001746,172.31.40.0-255,66,113632,63,154722
21289,0.001777,172.217.194.0-255,4320,117952,63,154722
21290,0.001789,172.217.194.0-255,1484,119436,63,154722
21291,0.001797,172.31.40.0-255,66,119502,63,154722
21292,0.001877,172.31.40.0-255,66,119568,63,154722
21293,0.001998,172.217.194.0-255,1484,121052,63,154722
21294,0.002002,172.217.194.0-255,1484,122536,63,154722
21295,0.002006,172.31.40.0-255,66,122602,63,154722
21296,0.002037,172.217.194.0-255,1484,124086,63,154722
21297,0.002044,172.217.194.0-255,5738,129824,63,154722
21298,0.002095,172.31.40.0-255,66,129890,63,154722
21299,0.002146,172.31.40.0-255,66,129956,63,154722
21300,0.002153,172.217.194.0-255,1484,131440,63,154722
21301,0.004245,172.217.194.0-255,4320,135760,63,154722
21302,0.011739,172.217.194.0-255,1484,137244,63,154722
21303,0.013564,172.31.40.0-255,66,137310,63,154722
21304,0.015657,172.217.194.0-255,5738,143048,63,154722
21305,0.015662,172.31.40.0-255,66,143114,63,154722
21306,0.017737,172.217.194.0-255,5738,148852,63,154722
21307,0.017743,172.31.40.0-255,66,148918,63,154722
21308,0.019808,172.217.194.0-255,5738,154656,63,154722
21309,0.019816,172.31.40.0-255,66,154722,63,154722
21310,0.0,74.125.24.0-255,153,153,63,197093
21311,1.5e-05,172.31.40.0-255,66,219,63,197093
21312,2.2e-05,74.125.24.0-255,1484,1703,63,197093
21313,2.6e-05,172.31.40.0-255,66,1769,63,197093
21314,3.1e-05,74.125.24.0-255,2902,4671,63,197093
21315,4.3e-05,172.31.40.0-255,66,4737,63,197093
21316,5.1e-05,74.125.24.0-255,7156,11893,63,197093
21317,5.4e-05,172.31.40.0-255,66,11959,63,197093
21318,5.7e-05,74.125.24.0-255,1484,13443,63,197093
21319,5.9e-05,172.31.40.0-255,66,13509,63,197093
21320,0.000102,172.31.40.0-255,66,13575,63,197093
21321,0.000108,74.125.24.0-255,4320,17895,63,197093
21322,0.00011,172.31.40.0-255,66,17961,63,197093
21323,0.000145,74.125.24.0-255,2543,20504,63,197093
21324,0.000147,172.31.40.0-255,66,20570,63,197093
21325,0.000229,74.125.24.0-255,1484,22054,63,197093
21326,0.000232,172.31.40.0-255,66,22120,63,197093
21327,0.000251,74.125.24.0-255,2902,25022,63,197093
21328,0.000254,172.31.40.0-255,66,25088,63,197093
21329,0.000275,74.125.24.0-255,5738,30826,63,197093
21330,0.000278,172.31.40.0-255,66,30892,63,197093
21331,0.000304,74.125.24.0-255,4320,35212,63,197093
21332,0.000307,172.31.40.0-255,66,35278,63,197093
21333,0.000341,172.31.40.0-255,66,35344,63,197093
21334,0.000378,74.125.24.0-255,4320,39664,63,197093
21335,0.00038,172.31.40.0-255,66,39730,63,197093
21336,0.000412,74.125.24.0-255,5691,45421,63,197093
21337,0.000415,172.31.40.0-255,66,45487,63,197093
21338,0.000444,74.125.24.0-255,111,45598,63,197093
21339,0.000446,172.31.40.0-255,66,45664,63,197093
21340,0.000576,74.125.24.0-255,1484,47148,63,197093
21341,0.000593,74.125.24.0-255,2902,50050,63,197093
21342,0.000597,172.31.40.0-255,66,50116,63,197093
21343,0.000634,74.125.24.0-255,5738,55854,63,197093
21344,0.000637,172.31.40.0-255,66,55920,63,197093
21345,0.000673,172.31.40.0-255,66,55986,63,197093
21346,0.000691,74.125.24.0-255,5379,61365,63,197093
21347,0.000694,172.31.40.0-255,66,61431,63,197093
21348,0.00072,74.125.24.0-255,5738,67169,63,197093
21349,0.000723,172.31.40.0-255,66,67235,63,197093
21350,0.000748,74.125.24.0-255,3961,71196,63,197093
21351,0.00075,74.125.24.0-255,329,71525,63,197093
21352,0.000754,172.31.40.0-255,66,71591,63,197093
21353,0.000857,74.125.24.0-255,1484,73075,63,197093
21354,0.000862,172.31.40.0-255,66,73141,63,197093
21355,0.000865,74.125.24.0-255,1484,74625,63,197093
21356,0.000886,74.125.24.0-255,1484,76109,63,197093
21357,0.000889,172.31.40.0-255,66,76175,63,197093
21358,0.000897,74.125.24.0-255,5738,81913,63,197093
21359,0.0009,172.31.40.0-255,66,81979,63,197093
21360,0.000935,74.125.24.0-255,4320,86299,63,197093
21361,0.000938,172.31.40.0-255,66,86365,63,197093
21362,0.000971,74.125.24.0-255,5738,92103,63,197093
21363,0.000975,172.31.40.0-255,66,92169,63,197093
21364,0.000987,172.31.40.0-255,66,92235,63,197093
21365,0.000992,74.125.24.0-255,2184,94419,63,197093
21366,0.000994,172.31.40.0-255,66,94485,63,197093
21367,0.001509,74.125.24.0-255,1484,95969,63,197093
21368,0.001538,74.125.24.0-255,2902,98871,63,197093
21369,0.001542,172.31.40.0-255,66,98937,63,197093
21370,0.001546,74.125.24.0-255,1484,100421,63,197093
21371,0.00158,74.125.24.0-255,4320,104741,63,197093
21372,0.001582,172.31.40.0-255,66,104807,63,197093
21373,0.001588,74.125.24.0-255,4320,109127,63,197093
21374,0.00159,172.31.40.0-255,66,109193,63,197093
21375,0.001602,74.125.24.0-255,5738,114931,63,197093
21376,0.001604,172.31.40.0-255,66,114997,63,197093
21377,0.001616,172.31.40.0-255,66,115063,63,197093
21378,0.001621,74.125.24.0-255,2184,117247,63,197093
21379,0.001623,172.31.40.0-255,66,117313,63,197093
21380,0.001666,74.125.24.0-255,1484,118797,63,197093
21381,0.001669,74.125.24.0-255,1484,120281,63,197093
21382,0.001672,172.31.40.0-255,66,120347,63,197093
21383,0.001699,74.125.24.0-255,1484,121831,63,197093
21384,0.001706,74.125.24.0-255,5738,127569,63,197093
21385,0.001708,172.31.40.0-255,66,127635,63,197093
21386,0.001747,74.125.24.0-255,2902,130537,63,197093
21387,0.001751,172.31.40.0-255,66,130603,63,197093
21388,0.001754,172.31.40.0-255,66,130669,63,197093
21389,0.001792,172.31.40.0-255,66,130735,63,197093
21390,0.001854,74.125.24.0-255,1484,132219,63,197093
21391,0.001872,74.125.24.0-255,2902,135121,63,197093
21392,0.001876,172.31.40.0-255,66,135187,63,197093
21393,0.00191,74.125.24.0-255,2902,138089,63,197093
21394,0.001913,172.31.40.0-255,66,138155,63,197093
21395,0.00193,74.125.24.0-255,2902,141057,63,197093
21396,0.001933,172.31.40.0-255,66,141123,63,197093
21397,0.00194,74.125.24.0-255,7156,148279,63,197093
21398,0.001942,172.31.40.0-255,66,148345,63,197093
21399,0.001984,172.31.40.0-255,66,148411,63,197093
21400,0.002014,74.125.24.0-255,5738,154149,63,197093
21401,0.002018,172.31.40.0-255,66,154215,63,197093
21402,0.002054,74.125.24.0-255,2184,156399,63,197093
21403,0.002057,172.31.40.0-255,66,156465,63,197093
21404,0.004427,74.125.24.0-255,5738,162203,63,197093
21405,0.004435,172.31.40.0-255,66,162269,63,197093
21406,0.006844,74.125.24.0-255,5738,168007,63,197093
21407,0.006848,172.31.40.0-255,66,168073,63,197093
21408,0.009258,74.125.24.0-255,5738,173811,63,197093
21409,0.009264,172.31.40.0-255,66,173877,63,197093
21410,0.01164,74.125.24.0-255,5738,179615,63,197093
21411,0.011658,172.31.40.0-255,66,179681,63,197093
21412,0.014051,74.125.24.0-255,5738,185419,63,197093
21413,0.014071,172.31.40.0-255,66,185485,63,197093
21414,0.016474,74.125.24.0-255,5738,191223,63,197093
21415,0.01649,172.31.40.0-255,66,191289,63,197093
21416,0.018889,74.125.24.0-255,5738,197027,63,197093
21417,0.018906,172.31.40.0-255,66,197093,63,197093
21418,0.0,74.125.200.0-255,153,153,63,234879
21419,2.1e-05,172.31.40.0-255,66,219,63,234879
21420,2.8e-05,74.125.200.0-255,1484,1703,63,234879
21421,3.2e-05,172.31.40.0-255,66,1769,63,234879
21422,3.8e-05,74.125.200.0-255,2902,4671,63,234879
21423,5.1e-05,172.31.40.0-255,66,4737,63,234879
21424,5.9e-05,74.125.200.0-255,7156,11893,63,234879
21425,6.2e-05,172.31.40.0-255,66,11959,63,234879
21426,6.6e-05,74.125.200.0-255,2138,14097,63,234879
21427,6.9e-05,172.31.40.0-255,66,14163,63,234879
21428,0.000181,74.125.200.0-255,1484,15647,63,234879
21429,0.000185,172.31.40.0-255,66,15713,63,234879
21430,0.000191,74.125.200.0-255,2902,18615,63,234879
21431,0.000194,172.31.40.0-255,66,18681,63,234879
21432,0.000205,74.125.200.0-255,4320,23001,63,234879
21433,0.000208,172.31.40.0-255,66,23067,63,234879
21434,0.000239,74.125.200.0-255,5738,28805,63,234879
21435,0.000242,172.31.40.0-255,66,28871,63,234879
21436,0.000249,74.125.200.0-255,6797,35668,63,234879
21437,0.000251,172.31.40.0-255,66,35734,63,234879
21438,0.000254,74.125.200.0-255,1484,37218,63,234879
21439,0.000256,172.31.40.0-255,66,37284,63,234879
21440,0.000282,74.125.200.0-255,5738,43022,63,234879
21441,0.000285,172.31.40.0-255,66,43088,63,234879
21442,0.000314,74.125.200.0-255,5379,48467,63,234879
21443,0.000317,172.31.40.0-255,66,48533,63,234879
21444,0.001063,74.125.200.0-255,1484,50017,63,234879
21445,0.00107,172.31.40.0-255,66,50083,63,234879
21446,0.001078,74.125.200.0-255,2902,52985,63,234879
21447,0.00108,172.31.40.0-255,66,53051,63,234879
21448,0.001116,74.125.200.0-255,5738,58789,63,234879
21449,0.001118,172.31.40.0-255,66,58855,63,234879
21450,0.001123,74.125.200.0-255,2902,61757,63,234879
21451,0.001125,172.31.40.0-255,66,61823,63,234879
21452,0.001146,74.125.200.0-255,2902,64725,63,234879
21453,0.001148,172.31.40.0-255,66,64791,63,234879
21454,0.001185,172.31.40.0-255,66,64857,63,234879
21455,0.001192,74.125.200.0-255,5738,70595,63,234879
21456,0.001194,172.31.40.0-255,66,70661,63,234879
21457,0.001228,74.125.200.0-255,4543,75204,63,234879
21458,0.00123,172.31.40.0-255,66,75270,63,234879
21459,0.001234,74.125.200.0-255,1484,76754,63,234879
21460,0.001258,74.125.200.0-255,4320,81074,63,234879
21461,0.00126,172.31.40.0-255,66,81140,63,234879
21462,0.001299,172.31.40.0-255,66,81206,63,234879
21463,0.001311,74.125.200.0-255,2902,84108,63,234879
21464,0.001313,172.31.40.0-255,66,84174,63,234879
21465,0.00134,74.125.200.0-255,3961,88135,63,234879
21466,0.001342,172.31.40.0-255,66,88201,63,234879
21467,0.001349,74.125.200.0-255,7156,95357,63,234879
21468,0.001363,74.125.200.0-255,1484,96841,63,234879
21469,0.001377,74.125.200.0-255,1992,98833,63,234879
21470,0.001409,74.125.200.0-255,1484,100317,63,234879
21471,0.001423,74.125.200.0-255,1484,101801,63,234879
21472,0.001434,74.125.200.0-255,1484,103285,63,234879
21473,0.001463,74.125.200.0-255,1484,104769,63,234879
21474,0.001481,74.125.200.0-255,4320,109089,63,234879
21475,0.001519,74.125.200.0-255,2902,111991,63,234879
21476,0.001536,74.125.200.0-255,2184,114175,63,234879
21477,0.001733,74.125.200.0-255,1484,115659,63,234879
21478,0.001741,74.125.200.0-255,2902,118561,63,234879
21479,0.001766,74.125.200.0-255,5738,124299,63,234879
21480,0.001771,74.125.200.0-255,4320,128619,63,234879
21481,0.001792,74.125.200.0-255,5738,134357,63,234879
21482,0.001808,74.125.200.0-255,5738,140095,63,234879
21483,0.001811,74.125.200.0-255,1484,141579,63,234879
21484,0.001827,74.125.200.0-255,6438,148017,63,234879
21485,0.001875,74.125.200.0-255,4320,152337,63,234879
21486,0.001902,74.125.200.0-255,2902,155239,63,234879
21487,0.001931,74.125.200.0-255,2902,158141,63,234879
21488,0.001947,74.125.200.0-255,4320,162461,63,234879
21489,0.002007,74.125.200.0-255,1484,163945,63,234879
21490,0.002037,74.125.200.0-255,7156,171101,63,234879
21491,0.002041,74.125.200.0-255,2902,174003,63,234879
21492,0.002106,74.125.200.0-255,5738,179741,63,234879
21493,0.002129,74.125.200.0-255,7156,186897,63,234879
21494,0.002205,74.125.200.0-255,1484,188381,63,234879
21495,0.002215,74.125.200.0-255,2902,191283,63,234879
21496,0.002219,74.125.200.0-255,2902,194185,63,234879
21497,0.002244,74.125.200.0-255,2902,197087,63,234879
21498,0.002249,74.125.200.0-255,2902,199989,63,234879
21499,0.00228,74.125.200.0-255,4320,204309,63,234879
21500,0.002287,74.125.200.0-255,5738,210047,63,234879
21501,0.002304,74.125.200.0-255,2902,212949,63,234879
21502,0.007792,172.31.40.0-255,66,213015,63,234879
21503,0.01035,74.125.200.0-255,5738,218753,63,234879
21504,0.010361,172.31.40.0-255,66,218819,63,234879
21505,0.012885,74.125.200.0-255,4320,223139,63,234879
21506,0.012889,172.31.40.0-255,66,223205,63,234879
21507,0.012904,74.125.200.0-255,1484,224689,63,234879
21508,0.01543,74.125.200.0-255,4320,229009,63,234879
21509,0.015442,172.31.40.0-255,66,229075,63,234879
21510,0.018044,74.125.200.0-255,5738,234813,63,234879
21511,0.018061,172.31.40.0-255,66,234879,63,234879
21512,0.0,74.125.130.0-255,153,153,63,223434
21513,2.3e-05,172.31.40.0-255,66,219,63,223434
21514,2.9e-05,74.125.130.0-255,1484,1703,63,223434
21515,3.4e-05,172.31.40.0-255,66,1769,63,223434
21516,3.8e-05,74.125.130.0-255,1484,3253,63,223434
21517,4.7e-05,172.31.40.0-255,66,3319,63,223434
21518,5.2e-05,74.125.130.0-255,2902,6221,63,223434
21519,5.5e-05,172.31.40.0-255,66,6287,63,223434
21520,5.9e-05,74.125.130.0-255,1484,7771,63,223434
21521,6.1e-05,172.31.40.0-255,66,7837,63,223434
21522,9.5e-05,74.125.130.0-255,4320,12157,63,223434
21523,9.8e-05,172.31.40.0-255,66,12223,63,223434
21524,0.000102,74.125.130.0-255,2125,14348,63,223434
21525,0.000105,172.31.40.0-255,66,14414,63,223434
21526,0.000109,74.125.130.0-255,2902,17316,63,223434
21527,0.000111,172.31.40.0-255,66,17382,63,223434
21528,0.000116,74.125.130.0-255,2902,20284,63,223434
21529,0.000118,172.31.40.0-255,66,20350,63,223434
21530,0.000148,74.125.130.0-255,4320,24670,63,223434
21531,0.000151,172.31.40.0-255,66,24736,63,223434
21532,0.000159,74.125.130.0-255,6797,31533,63,223434
21533,0.000161,172.31.40.0-255,66,31599,63,223434
21534,0.00026,74.125.130.0-255,1484,33083,63,223434
21535,0.000264,172.31.40.0-255,66,33149,63,223434
21536,0.000268,74.125.130.0-255,1484,34633,63,223434
21537,0.00027,172.31.40.0-255,66,34699,63,223434
21538,0.000306,74.125.130.0-255,1484,36183,63,223434
21539,0.000309,172.31.40.0-255,66,36249,63,223434
21540,0.000314,74.125.130.0-255,2902,39151,63,223434
21541,0.000317,172.31.40.0-255,66,39217,63,223434
21542,0.000322,74.125.130.0-255,4320,43537,63,223434
21543,0.000324,172.31.40.0-255,66,43603,63,223434
21544,0.000328,74.125.130.0-255,2902,46505,63,223434
21545,0.000331,172.31.40.0-255,66,46571,63,223434
21546,0.000364,74.125.130.0-255,5738,52309,63,223434
21547,0.000367,172.31.40.0-255,66,52375,63,223434
21548,0.000372,74.125.130.0-255,4320,56695,63,223434
21549,0.000374,172.31.40.0-255,66,56761,63,223434
21550,0.00038,74.125.130.0-255,5738,62499,63,223434
21551,0.000382,172.31.40.0-255,66,62565,63,223434
21552,0.000388,74.125.130.0-255,3602,66167,63,223434
21553,0.00039,172.31.40.0-255,66,66233,63,223434
21554,0.00043,74.125.130.0-255,678,66911,63,223434
21555,0.000641,74.125.130.0-255,1484,68395,63,223434
21556,0.000646,172.31.40.0-255,66,68461,63,223434
21557,0.00065,74.125.130.0-255,1484,69945,63,223434
21558,0.000673,74.125.130.0-255,1484,71429,63,223434
21559,0.000675,172.31.40.0-255,66,71495,63,223434
21560,0.000705,74.125.130.0-255,5738,77233,63,223434
21561,0.000708,172.31.40.0-255,66,77299,63,223434
21562,0.000711,74.125.130.0-255,1484,78783,63,223434
21563,0.000716,74.125.130.0-255,2902,81685,63,223434
21564,0.000718,172.31.40.0-255,66,81751,63,223434
21565,0.000725,74.125.130.0-255,5738,87489,63,223434
21566,0.000727,172.31.40.0-255,66,87555,63,223434
21567,0.000774,172.31.40.0-255,66,87621,63,223434
21568,0.000802,74.125.130.0-255,3602,91223,63,223434
21569,0.000805,172.31.40.0-255,66,91289,63,223434
21570,0.001257,74.125.130.0-255,1484,92773,63,223434
21571,0.001279,74.125.130.0-255,2902,95675,63,223434
21572,0.001283,172.31.40.0-255,66,95741,63,223434
21573,0.00129,74.125.130.0-255,5738,101479,63,223434
21574,0.001292,172.31.40.0-255,66,101545,63,223434
21575,0.001296,74.125.130.0-255,2902,104447,63,223434
21576,0.001303,172.31.40.0-255,66,104513,63,223434
21577,0.001307,74.125.130.0-255,2902,107415,63,223434
21578,0.00131,172.31.40.0-255,66,107481,63,223434
21579,0.001333,74.125.130.0-255,1484,108965,63,223434
21580,0.001338,74.125.130.0-255,2902,111867,63,223434
21581,0.001341,172.31.40.0-255,66,111933,63,223434
21582,0.001377,74.125.130.0-255,5738,117671,63,223434
21583,0.001379,172.31.40.0-255,66,117737,63,223434
21584,0.001385,74.125.130.0-255,4320,122057,63,223434
21585,0.001387,172.31.40.0-255,66,122123,63,223434
21586,0.001395,74.125.130.0-255,4470,126593,63,223434
21587,0.001397,172.31.40.0-255,66,126659,63,223434
21588,0.001426,74.125.130.0-255,1484,128143,63,223434
21589,0.001453,74.125.130.0-255,5738,133881,63,223434
21590,0.001456,172.31.40.0-255,66,133947,63,223434
21591,0.001466,172.31.40.0-255,66,134013,63,223434
21592,0.001477,172.31.40.0-255,66,134079,63,223434
21593,0.001522,74.125.130.0-255,6438,140517,63,223434
21594,0.001525,172.31.40.0-255,66,140583,63,223434
21595,0.001794,74.125.130.0-255,1484,142067,63,223434
21596,0.001799,74.125.130.0-255,1484,143551,63,223434
21597,0.001802,172.31.40.0-255,66,143617,63,223434
21598,0.001827,74.125.130.0-255,1484,145101,63,223434
21599,0.001832,74.125.130.0-255,2902,148003,63,223434
21600,0.001834,172.31.40.0-255,66,148069,63,223434
21601,0.001859,74.125.130.0-255,2902,150971,63,223434
21602,0.001862,172.31.40.0-255,66,151037,63,223434
21603,0.00187,74.125.130.0-255,6797,157834,63,223434
21604,0.001872,172.31.40.0-255,66,157900,63,223434
21605,0.001898,74.125.130.0-255,7156,165056,63,223434
21606,0.001901,172.31.40.0-255,66,165122,63,223434
21607,0.001907,74.125.130.0-255,5738,170860,63,223434
21608,0.001909,172.31.40.0-255,66,170926,63,223434
21609,0.001949,74.125.130.0-255,7156,178082,63,223434
21610,0.001952,172.31.40.0-255,66,178148,63,223434
21611,0.001955,74.125.130.0-255,1484,179632,63,223434
21612,0.001988,172.31.40.0-255,66,179698,63,223434
21613,0.002017,74.125.130.0-255,2184,181882,63,223434
21614,0.00202,172.31.40.0-255,66,181948,63,223434
21615,0.004241,74.125.130.0-255,2902,184850,63,223434
21616,0.004249,172.31.40.0-255,66,184916,63,223434
21617,0.004297,74.125.130.0-255,2902,187818,63,223434
21618,0.0043,172.31.40.0-255,66,187884,63,223434
21619,0.006502,74.125.130.0-255,2902,190786,63,223434
21620,0.006505,172.31.40.0-255,66,190852,63,223434
21621,0.006552,74.125.130.0-255,2902,193754,63,223434
21622,0.006554,172.31.40.0-255,66,193820,63,223434
21623,0.008754,74.125.130.0-255,2902,196722,63,223434
21624,0.00876,172.31.40.0-255,66,196788,63,223434
21625,0.008787,74.125.130.0-255,1484,198272,63,223434
21626,0.0088,74.125.130.0-255,1484,199756,63,223434
21627,0.008802,172.31.40.0-255,66,199822,63,223434
21628,0.011029,74.125.130.0-255,2902,202724,63,223434
21629,0.011038,172.31.40.0-255,66,202790,63,223434
21630,0.011069,74.125.130.0-255,2902,205692,63,223434
21631,0.011072,172.31.40.0-255,66,205758,63,223434
21632,0.013288,74.125.130.0-255,2902,208660,63,223434
21633,0.013296,172.31.40.0-255,66,208726,63,223434
21634,0.013322,74.125.130.0-255,2902,211628,63,223434
21635,0.013324,172.31.40.0-255,66,211694,63,223434
21636,0.015556,74.125.130.0-255,2902,214596,63,223434
21637,0.015563,172.31.40.0-255,66,214662,63,223434
21638,0.015585,74.125.130.0-255,2902,217564,63,223434
21639,0.015587,172.31.40.0-255,66,217630,63,223434
21640,0.017835,74.125.130.0-255,5738,223368,63,223434
21641,0.017844,172.31.40.0-255,66,223434,63,223434
21642,0.0,74.125.24.0-255,150,150,63,219782
21643,1.3e-05,172.31.40.0-255,66,216,63,219782
21644,1.9e-05,74.125.24.0-255,1484,1700,63,219782
21645,2.3e-05,172.31.40.0-255,66,1766,63,219782
21646,2.9e-05,74.125.24.0-255,2902,4668,63,219782
21647,3.8e-05,172.31.40.0-255,66,4734,63,219782
21648,4.3e-05,74.125.24.0-255,2902,7636,63,219782
21649,4.6e-05,172.31.40.0-255,66,7702,63,219782
21650,8.4e-05,74.125.24.0-255,4320,12022,63,219782
21651,8.7e-05,172.31.40.0-255,66,12088,63,219782
21652,0.000109,172.31.40.0-255,66,12154,63,219782
21653,0.000113,74.125.24.0-255,2543,14697,63,219782
21654,0.000115,172.31.40.0-255,66,14763,63,219782
21655,0.000161,74.125.24.0-255,1484,16247,63,219782
21656,0.000164,172.31.40.0-255,66,16313,63,219782
21657,0.000168,74.125.24.0-255,2902,19215,63,219782
21658,0.000171,172.31.40.0-255,66,19281,63,219782
21659,0.000198,74.125.24.0-255,4320,23601,63,219782
21660,0.000201,172.31.40.0-255,66,23667,63,219782
21661,0.000224,74.125.24.0-255,1484,25151,63,219782
21662,0.000233,172.31.40.0-255,66,25217,63,219782
21663,0.000239,74.125.24.0-255,4320,29537,63,219782
21664,0.000242,172.31.40.0-255,66,29603,63,219782
21665,0.000246,74.125.24.0-255,2543,32146,63,219782
21666,0.000248,172.31.40.0-255,66,32212,63,219782
21667,0.000585,74.125.24.0-255,1484,33696,63,219782
21668,0.00059,74.125.24.0-255,2902,36598,63,219782
21669,0.000601,172.31.40.0-255,66,36664,63,219782
21670,0.000606,172.31.40.0-255,66,36730,63,219782
21671,0.000613,74.125.24.0-255,5738,42468,63,219782
21672,0.000615,172.31.40.0-255,66,42534,63,219782
21673,0.00066,74.125.24.0-255,4320,46854,63,219782
21674,0.000664,172.31.40.0-255,66,46920,63,219782
21675,0.00069,74.125.24.0-255,2543,49463,63,219782
21676,0.000693,172.31.40.0-255,66,49529,63,219782
21677,0.000697,74.125.24.0-255,1484,51013,63,219782
21678,0.000721,74.125.24.0-255,2902,53915,63,219782
21679,0.000724,172.31.40.0-255,66,53981,63,219782
21680,0.000731,74.125.24.0-255,5738,59719,63,219782
21681,0.000733,172.31.40.0-255,66,59785,63,219782
21682,0.000751,74.125.24.0-255,1484,61269,63,219782
21683,0.000778,74.125.24.0-255,5958,67227,63,219782
21684,0.000781,172.31.40.0-255,66,67293,63,219782
21685,0.00081,74.125.24.0-255,2902,70195,63,219782
21686,0.000814,172.31.40.0-255,66,70261,63,219782
21687,0.000818,74.125.24.0-255,4320,74581,63,219782
21688,0.000821,172.31.40.0-255,66,74647,63,219782
21689,0.000853,172.31.40.0-255,66,74713,63,219782
21690,0.000856,74.125.24.0-255,1125,75838,63,219782
21691,0.000926,74.125.24.0-255,1484,77322,63,219782
21692,0.000929,172.31.40.0-255,66,77388,63,219782
21693,0.000935,74.125.24.0-255,2902,80290,63,219782
21694,0.000937,172.31.40.0-255,66,80356,63,219782
21695,0.000943,74.125.24.0-255,5738,86094,63,219782
21696,0.00095,172.31.40.0-255,66,86160,63,219782
21697,0.00099,172.31.40.0-255,66,86226,63,219782
21698,0.00103,74.125.24.0-255,5738,91964,63,219782
21699,0.001034,172.31.40.0-255,66,92030,63,219782
21700,0.001071,172.31.40.0-255,66,92096,63,219782
21701,0.001079,74.125.24.0-255,7156,99252,63,219782
21702,0.001081,172.31.40.0-255,66,99318,63,219782
21703,0.001114,74.125.24.0-255,7156,106474,63,219782
21704,0.001117,172.31.40.0-255,66,106540,63,219782
21705,0.001137,172.31.40.0-255,66,106606,63,219782
21706,0.001142,74.125.24.0-255,3602,110208,63,219782
21707,0.001144,172.31.40.0-255,66,110274,63,219782
21708,0.001168,74.125.24.0-255,2902,113176,63,219782
21709,0.001172,172.31.40.0-255,66,113242,63,219782
21710,0.001193,74.125.24.0-255,4320,117562,63,219782
21711,0.001199,172.31.40.0-255,66,117628,63,219782
21712,0.001209,172.31.40.0-255,66,117694,63,219782
21713,0.001247,172.31.40.0-255,66,117760,63,219782
21714,0.001266,74.125.24.0-255,5738,123498,63,219782
21715,0.001268,172.31.40.0-255,66,123564,63,219782
21716,0.001271,74.125.24.0-255,766,124330,63,219782
21717,0.001468,74.125.24.0-255,1484,125814,63,219782
21718,0.001472,172.31.40.0-255,66,125880,63,219782
21719,0.001478,74.125.24.0-255,2902,128782,63,219782
21720,0.00148,172.31.40.0-255,66,128848,63,219782
21721,0.001503,74.125.24.0-255,4320,133168,63,219782
21722,0.001505,172.31.40.0-255,66,133234,63,219782
21723,0.001532,74.125.24.0-255,1484,134718,63,219782
21724,0.001538,74.125.24.0-255,4320,139038,63,219782
21725,0.00154,172.31.40.0-255,66,139104,63,219782
21726,0.001565,74.125.24.0-255,2902,142006,63,219782
21727,0.001568,172.31.40.0-255,66,142072,63,219782
21728,0.001578,172.31.40.0-255,66,142138,63,219782
21729,0.001654,172.31.40.0-255,66,142204,63,219782
21730,0.001736,74.125.24.0-255,1484,143688,63,219782
21731,0.001761,74.125.24.0-255,2902,146590,63,219782
21732,0.001765,172.31.40.0-255,66,146656,63,219782
21733,0.001768,74.125.24.0-255,1484,148140,63,219782
21734,0.001797,74.125.24.0-255,4320,152460,63,219782
21735,0.0018,172.31.40.0-255,66,152526,63,219782
21736,0.001823,172.31.40.0-255,66,152592,63,219782
21737,0.001848,74.125.24.0-255,1484,154076,63,219782
21738,0.001855,74.125.24.0-255,5738,159814,63,219782
21739,0.001857,172.31.40.0-255,66,159880,63,219782
21740,0.001888,74.125.24.0-255,5020,164900,63,219782
21741,0.001891,172.31.40.0-255,66,164966,63,219782
21742,0.002092,74.125.24.0-255,1484,166450,63,219782
21743,0.002109,74.125.24.0-255,1484,167934,63,219782
21744,0.002112,172.31.40.0-255,66,168000,63,219782
21745,0.002164,74.125.24.0-255,1484,169484,63,219782
21746,0.002172,74.125.24.0-255,5738,175222,63,219782
21747,0.002175,172.31.40.0-255,66,175288,63,219782
21748,0.002194,172.31.40.0-255,66,175354,63,219782
21749,0.002201,74.125.24.0-255,7156,182510,63,219782
21750,0.002203,172.31.40.0-255,66,182576,63,219782
21751,0.002231,74.125.24.0-255,3602,186178,63,219782
21752,0.002233,172.31.40.0-255,66,186244,63,219782
21753,0.004782,74.125.24.0-255,1484,187728,63,219782
21754,0.004851,74.125.24.0-255,2902,190630,63,219782
21755,0.004856,172.31.40.0-255,66,190696,63,219782
21756,0.004868,74.125.24.0-255,1484,192180,63,219782
21757,0.007472,74.125.24.0-255,4320,196500,63,219782
21758,0.007478,172.31.40.0-255,66,196566,63,219782
21759,0.010072,74.125.24.0-255,5738,202304,63,219782
21760,0.010079,172.31.40.0-255,66,202370,63,219782
21761,0.012741,74.125.24.0-255,5738,208108,63,219782
21762,0.012749,172.31.40.0-255,66,208174,63,219782
21763,0.015395,74.125.24.0-255,5738,213912,63,219782
21764,0.015408,172.31.40.0-255,66,213978,63,219782
21765,0.017998,74.125.24.0-255,5738,219716,63,219782
21766,0.018007,172.31.40.0-255,66,219782,63,219782
21767,0.0,74.125.68.0-255,153,153,63,258020
21768,2.2e-05,172.31.40.0-255,66,219,63,258020
21769,2.9e-05,74.125.68.0-255,1484,1703,63,258020
21770,3.4e-05,172.31.40.0-255,66,1769,63,258020
21771,6.5e-05,74.125.68.0-255,2902,4671,63,258020
21772,6.8e-05,172.31.40.0-255,66,4737,63,258020
21773,9.6e-05,74.125.68.0-255,2902,7639,63,258020
21774,9.8e-05,172.31.40.0-255,66,7705,63,258020
21775,0.000105,74.125.68.0-255,4320,12025,63,258020
21776,0.000108,172.31.40.0-255,66,12091,63,258020
21777,0.000115,74.125.68.0-255,1484,13575,63,258020
21778,0.000118,172.31.40.0-255,66,13641,63,258020
21779,0.000156,74.125.68.0-255,604,14245,63,258020
21780,0.000159,172.31.40.0-255,66,14311,63,258020
21781,0.000203,74.125.68.0-255,1484,15795,63,258020
21782,0.000207,172.31.40.0-255,66,15861,63,258020
21783,0.000223,74.125.68.0-255,1484,17345,63,258020
21784,0.000226,172.31.40.0-255,66,17411,63,258020
21785,0.000231,74.125.68.0-255,2902,20313,63,258020
21786,0.000234,172.31.40.0-255,66,20379,63,258020
21787,0.000237,74.125.68.0-255,1484,21863,63,258020
21788,0.000239,172.31.40.0-255,66,21929,63,258020
21789,0.000262,74.125.68.0-255,4320,26249,63,258020
21790,0.000265,172.31.40.0-255,66,26315,63,258020
21791,0.000285,74.125.68.0-255,5379,31694,63,258020
21792,0.000287,172.31.40.0-255,66,31760,63,258020
21793,0.000395,74.125.68.0-255,1484,33244,63,258020
21794,0.000398,172.31.40.0-255,66,33310,63,258020
21795,0.000404,74.125.68.0-255,2902,36212,63,258020
21796,0.000406,172.31.40.0-255,66,36278,63,258020
21797,0.000413,74.125.68.0-255,5738,42016,63,258020
21798,0.00042,172.31.40.0-255,66,42082,63,258020
21799,0.000457,74.125.68.0-255,6797,48879,63,258020
21800,0.00046,172.31.40.0-255,66,48945,63,258020
21801,0.000467,74.125.68.0-255,7156,56101,63,258020
21802,0.000469,172.31.40.0-255,66,56167,63,258020
21803,0.000523,172.31.40.0-255,66,56233,63,258020
21804,0.000526,74.125.68.0-255,645,56878,63,258020
21805,0.000635,74.125.68.0-255,1484,58362,63,258020
21806,0.000639,172.31.40.0-255,66,58428,63,258020
21807,0.000645,74.125.68.0-255,2902,61330,63,258020
21808,0.000647,172.31.40.0-255,66,61396,63,258020
21809,0.000676,74.125.68.0-255,5738,67134,63,258020
21810,0.000679,172.31.40.0-255,66,67200,63,258020
21811,0.000683,74.125.68.0-255,2902,70102,63,258020
21812,0.000685,172.31.40.0-255,66,70168,63,258020
21813,0.000707,74.125.68.0-255,2902,73070,63,258020
21814,0.00071,172.31.40.0-255,66,73136,63,258020
21815,0.000719,74.125.68.0-255,7156,80292,63,258020
21816,0.000721,172.31.40.0-255,66,80358,63,258020
21817,0.000746,74.125.68.0-255,4320,84678,63,258020
21818,0.000748,172.31.40.0-255,66,84744,63,258020
21819,0.000778,74.125.68.0-255,5738,90482,63,258020
21820,0.000781,172.31.40.0-255,66,90548,63,258020
21821,0.000784,74.125.68.0-255,766,91314,63,258020
21822,0.000942,74.125.68.0-255,1484,92798,63,258020
21823,0.000947,172.31.40.0-255,66,92864,63,258020
21824,0.000953,74.125.68.0-255,2902,95766,63,258020
21825,0.000955,172.31.40.0-255,66,95832,63,258020
21826,0.000975,74.125.68.0-255,5738,101570,63,258020
21827,0.000978,74.125.68.0-255,1484,103054,63,258020
21828,0.000981,172.31.40.0-255,66,103120,63,258020
21829,0.001004,74.125.68.0-255,2902,106022,63,258020
21830,0.001007,172.31.40.0-255,66,106088,63,258020
21831,0.001031,74.125.68.0-255,1484,107572,63,258020
21832,0.001034,74.125.68.0-255,1484,109056,63,258020
21833,0.001037,172.31.40.0-255,66,109122,63,258020
21834,0.001062,74.125.68.0-255,1484,110606,63,258020
21835,0.001069,74.125.68.0-255,5738,116344,63,258020
21836,0.001072,172.31.40.0-255,66,116410,63,258020
21837,0.001113,172.31.40.0-255,66,116476,63,258020
21838,0.001115,74.125.68.0-255,766,117242,63,258020
21839,0.001184,74.125.68.0-255,1484,118726,63,258020
21840,0.001188,172.31.40.0-255,66,118792,63,258020
21841,0.001194,74.125.68.0-255,2902,121694,63,258020
21842,0.001196,172.31.40.0-255,66,121760,63,258020
21843,0.001226,74.125.68.0-255,5738,127498,63,258020
21844,0.001229,172.31.40.0-255,66,127564,63,258020
21845,0.001236,74.125.68.0-255,5738,133302,63,258020
21846,0.001238,172.31.40.0-255,66,133368,63,258020
21847,0.001262,74.125.68.0-255,2902,136270,63,258020
21848,0.001264,172.31.40.0-255,66,136336,63,258020
21849,0.001268,74.125.68.0-255,1484,137820,63,258020
21850,0.001306,172.31.40.0-255,66,137886,63,258020
21851,0.001312,74.125.68.0-255,4320,142206,63,258020
21852,0.001314,172.31.40.0-255,66,142272,63,258020
21853,0.001317,74.125.68.0-255,766,143038,63,258020
21854,0.001354,74.125.68.0-255,1484,144522,63,258020
21855,0.001356,172.31.40.0-255,66,144588,63,258020
21856,0.001385,74.125.68.0-255,4320,148908,63,258020
21857,0.001389,172.31.40.0-255,66,148974,63,258020
21858,0.001394,74.125.68.0-255,4320,153294,63,258020
21859,0.001396,172.31.40.0-255,66,153360,63,258020
21860,0.00143,74.125.68.0-255,5738,159098,63,258020
21861,0.001433,172.31.40.0-255,66,159164,63,258020
21862,0.001451,172.31.40.0-255,66,159230,63,258020
21863,0.001453,74.125.68.0-255,1484,160714,63,258020
21864,0.001476,74.125.68.0-255,2902,163616,63,258020
21865,0.001478,172.31.40.0-255,66,163682,63,258020
21866,0.001504,74.125.68.0-255,3602,167284,63,258020
21867,0.001506,172.31.40.0-255,66,167350,63,258020
21868,0.001512,74.125.68.0-255,4320,171670,63,258020
21869,0.001514,172.31.40.0-255,66,171736,63,258020
21870,0.001556,172.31.40.0-255,66,171802,63,258020
21871,0.001561,74.125.68.0-255,4320,176122,63,258020
21872,0.001564,172.31.40.0-255,66,176188,63,258020
21873,0.001616,74.125.68.0-255,7156,183344,63,258020
21874,0.001621,172.31.40.0-255,66,183410,63,258020
21875,0.001655,74.125.68.0-255,6438,189848,63,258020
21876,0.001659,172.31.40.0-255,66,189914,63,258020
21877,0.001706,74.125.68.0-255,1484,191398,63,258020
21878,0.001711,74.125.68.0-255,1484,192882,63,258020
21879,0.001713,172.31.40.0-255,66,192948,63,258020
21880,0.001771,74.125.68.0-255,1484,194432,63,258020
21881,0.001791,74.125.68.0-255,2902,197334,63,258020
21882,0.001794,172.31.40.0-255,66,197400,63,258020
21883,0.001799,74.125.68.0-255,4320,201720,63,258020
21884,0.001802,172.31.40.0-255,66,201786,63,258020
21885,0.001812,74.125.68.0-255,4320,206106,63,258020
21886,0.001819,172.31.40.0-255,66,206172,63,258020
21887,0.001841,74.125.68.0-255,1484,207656,63,258020
21888,0.001853,172.31.40.0-255,66,207722,63,258020
21889,0.001882,74.125.68.0-255,1484,209206,63,258020
21890,0.001887,74.125.68.0-255,4320,213526,63,258020
21891,0.00189,172.31.40.0-255,66,213592,63,258020
21892,0.001893,74.125.68.0-255,766,214358,63,258020
21893,0.003952,74.125.68.0-255,4320,218678,63,258020
21894,0.003966,172.31.40.0-255,66,218744,63,258020
21895,0.00603,74.125.68.0-255,5738,224482,63,258020
21896,0.006038,172.31.40.0-255,66,224548,63,258020
21897,0.008109,74.125.68.0-255,5738,230286,63,258020
21898,0.008121,172.31.40.0-255,66,230352,63,258020
21899,0.010169,74.125.68.0-255,4320,234672,63,258020
21900,0.010176,172.31.40.0-255,66,234738,63,258020
21901,0.010201,74.125.68.0-255,1484,236222,63,258020
21902,0.012255,74.125.68.0-255,4320,240542,63,258020
21903,0.012268,172.31.40.0-255,66,240608,63,258020
21904,0.014337,74.125.68.0-255,5738,246346,63,258020
21905,0.014354,172.31.40.0-255,66,246412,63,258020
21906,0.016431,74.125.68.0-255,5738,252150,63,258020
21907,0.016448,172.31.40.0-255,66,252216,63,258020
21908,0.018535,74.125.68.0-255,5738,257954,63,258020
21909,0.018558,172.31.40.0-255,66,258020,63,258020
21910,0.0,172.217.194.0-255,305,305,63,152116
21911,2.8e-05,172.31.40.0-255,66,371,63,152116
21912,3.4e-05,172.217.194.0-255,1484,1855,63,152116
21913,3.8e-05,172.31.40.0-255,66,1921,63,152116
21914,4.4e-05,172.217.194.0-255,4320,6241,63,152116
21915,5.4e-05,172.31.40.0-255,66,6307,63,152116
21916,6e-05,172.217.194.0-255,4320,10627,63,152116
21917,6.3e-05,172.31.40.0-255,66,10693,63,152116
21918,0.000109,172.217.194.0-255,4676,15369,63,152116
21919,0.000112,172.31.40.0-255,66,15435,63,152116
21920,0.000126,172.31.40.0-255,66,15501,63,152116
21921,0.000128,172.217.194.0-255,1125,16626,63,152116
21922,0.000132,172.31.40.0-255,66,16692,63,152116
21923,0.000154,172.217.194.0-255,1484,18176,63,152116
21924,0.000157,172.31.40.0-255,66,18242,63,152116
21925,0.000191,172.217.194.0-255,4320,22562,63,152116
21926,0.000194,172.31.40.0-255,66,22628,63,152116
21927,0.000197,172.217.194.0-255,1484,24112,63,152116
21928,0.000199,172.31.40.0-255,66,24178,63,152116
21929,0.000224,172.217.194.0-255,7156,31334,63,152116
21930,0.000227,172.31.40.0-255,66,31400,63,152116
21931,0.000253,172.217.194.0-255,3961,35361,63,152116
21932,0.000255,172.31.40.0-255,66,35427,63,152116
21933,0.000269,172.31.40.0-255,66,35493,63,152116
21934,0.000293,172.217.194.0-255,1125,36618,63,152116
21935,0.000297,172.31.40.0-255,66,36684,63,152116
21936,0.0003,172.217.194.0-255,375,37059,63,152116
21937,0.000316,172.31.40.0-255,66,37125,63,152116
21938,0.000319,172.217.194.0-255,399,37524,63,152116
21939,0.000322,172.31.40.0-255,66,37590,63,152116
21940,0.00042,172.217.194.0-255,1484,39074,63,152116
21941,0.000424,172.217.194.0-255,1484,40558,63,152116
21942,0.000427,172.31.40.0-255,66,40624,63,152116
21943,0.000452,172.217.194.0-255,1484,42108,63,152116
21944,0.000459,172.217.194.0-255,5738,47846,63,152116
21945,0.000462,172.31.40.0-255,66,47912,63,152116
21946,0.000475,172.31.40.0-255,66,47978,63,152116
21947,0.000504,172.217.194.0-255,1484,49462,63,152116
21948,0.000518,172.31.40.0-255,66,49528,63,152116
21949,0.000563,172.217.194.0-255,1484,51012,63,152116
21950,0.000569,172.217.194.0-255,2902,53914,63,152116
21951,0.000572,172.31.40.0-255,66,53980,63,152116
21952,0.000576,172.217.194.0-255,1484,55464,63,152116
21953,0.000595,172.217.194.0-255,4320,59784,63,152116
21954,0.000598,172.31.40.0-255,66,59850,63,152116
21955,0.000642,172.31.40.0-255,66,59916,63,152116
21956,0.000655,172.31.40.0-255,66,59982,63,152116
21957,0.000802,172.217.194.0-255,1484,61466,63,152116
21958,0.000807,172.217.194.0-255,2902,64368,63,152116
21959,0.00081,172.31.40.0-255,66,64434,63,152116
21960,0.000814,172.217.194.0-255,1484,65918,63,152116
21961,0.000839,172.217.194.0-255,4320,70238,63,152116
21962,0.000842,172.31.40.0-255,66,70304,63,152116
21963,0.000845,172.217.194.0-255,1484,71788,63,152116
21964,0.000885,172.31.40.0-255,66,71854,63,152116
21965,0.000889,172.217.194.0-255,2902,74756,63,152116
21966,0.000892,172.31.40.0-255,66,74822,63,152116
21967,0.000925,172.31.40.0-255,66,74888,63,152116
21968,0.000956,172.217.194.0-255,1484,76372,63,152116
21969,0.000961,172.217.194.0-255,2902,79274,63,152116
21970,0.000964,172.31.40.0-255,66,79340,63,152116
21971,0.00097,172.217.194.0-255,5738,85078,63,152116
21972,0.000974,172.31.40.0-255,66,85144,63,152116
21973,0.000986,172.217.194.0-255,1484,86628,63,152116
21974,0.00102,172.31.40.0-255,66,86694,63,152116
21975,0.001023,172.217.194.0-255,1484,88178,63,152116
21976,0.001049,172.217.194.0-255,7156,95334,63,152116
21977,0.001054,172.31.40.0-255,66,95400,63,152116
21978,0.001061,172.217.194.0-255,2184,97584,63,152116
21979,0.001063,172.31.40.0-255,66,97650,63,152116
21980,0.001092,172.217.194.0-255,4320,101970,63,152116
21981,0.001097,172.31.40.0-255,66,102036,63,152116
21982,0.001122,172.217.194.0-255,5738,107774,63,152116
21983,0.001125,172.31.40.0-255,66,107840,63,152116
21984,0.001133,172.217.194.0-255,7156,114996,63,152116
21985,0.001136,172.31.40.0-255,66,115062,63,152116
21986,0.001162,172.217.194.0-255,1484,116546,63,152116
21987,0.001169,172.217.194.0-255,4320,120866,63,152116
21988,0.001171,172.31.40.0-255,66,120932,63,152116
21989,0.001205,172.31.40.0-255,66,120998,63,152116
21990,0.001213,172.217.194.0-255,7156,128154,63,152116
21991,0.001215,172.31.40.0-255,66,128220,63,152116
21992,0.001251,172.31.40.0-255,66,128286,63,152116
21993,0.001278,172.31.40.0-255,66,128352,63,152116
21994,0.001281,172.217.194.0-255,1484,129836,63,152116
21995,0.001336,172.31.40.0-255,66,129902,63,152116
21996,0.00135,172.31.40.0-255,66,129968,63,152116
21997,0.001361,172.31.40.0-255,66,130034,63,152116
21998,0.00139,172.217.194.0-255,2184,132218,63,152116
21999,0.001394,172.31.40.0-255,66,132284,63,152116
22000,0.001397,172.217.194.0-255,1484,133768,63,152116
22001,0.001401,172.217.194.0-255,2902,136670,63,152116
22002,0.001404,172.31.40.0-255,66,136736,63,152116
22003,0.00141,172.217.194.0-255,5738,142474,63,152116
22004,0.001412,172.31.40.0-255,66,142540,63,152116
22005,0.00145,172.217.194.0-255,4320,146860,63,152116
22006,0.001454,172.31.40.0-255,66,146926,63,152116
22007,0.00149,172.31.40.0-255,66,146992,63,152116
22008,0.0015,172.31.40.0-255,66,147058,63,152116
22009,0.001511,172.31.40.0-255,66,147124,63,152116
22010,0.001519,172.31.40.0-255,66,147190,63,152116
22011,0.001564,172.217.194.0-255,4320,151510,63,152116
22012,0.001568,172.31.40.0-255,66,151576,63,152116
22013,0.00161,172.31.40.0-255,66,151642,63,152116
22014,0.001634,172.31.40.0-255,66,151708,63,152116
22015,0.001645,172.31.40.0-255,66,151774,63,152116
22016,0.001648,172.217.194.0-255,105,151879,63,152116
22017,0.003327,172.31.40.0-255,66,151945,63,152116
22018,0.003353,172.31.40.0-255,105,152050,63,152116
22019,0.005863,172.217.194.0-255,66,152116,63,152116
22020,0.0,172.217.194.0-255,153,153,63,155250
22021,2.2e-05,172.31.40.0-255,66,219,63,155250
22022,2.8e-05,172.217.194.0-255,1484,1703,63,155250
22023,3.4e-05,172.31.40.0-255,66,1769,63,155250
22024,4.1e-05,172.217.194.0-255,2902,4671,63,155250
22025,4.5e-05,172.31.40.0-255,66,4737,63,155250
22026,5e-05,172.217.194.0-255,4320,9057,63,155250
22027,5.4e-05,172.31.40.0-255,66,9123,63,155250
22028,7.8e-05,172.217.194.0-255,4900,14023,63,155250
22029,8.2e-05,172.31.40.0-255,66,14089,63,155250
22030,0.000156,172.217.194.0-255,1484,15573,63,155250
22031,0.000159,172.31.40.0-255,66,15639,63,155250
22032,0.000164,172.217.194.0-255,2902,18541,63,155250
22033,0.000166,172.31.40.0-255,66,18607,63,155250
22034,0.000183,172.217.194.0-255,5738,24345,63,155250
22035,0.000186,172.31.40.0-255,66,24411,63,155250
22036,0.000216,172.217.194.0-255,2902,27313,63,155250
22037,0.000218,172.31.40.0-255,66,27379,63,155250
22038,0.000241,172.31.40.0-255,66,27445,63,155250
22039,0.000271,172.217.194.0-255,7156,34601,63,155250
22040,0.000275,172.31.40.0-255,66,34667,63,155250
22041,0.000298,172.217.194.0-255,3961,38628,63,155250
22042,0.000301,172.31.40.0-255,66,38694,63,155250
22043,0.000429,172.217.194.0-255,1484,40178,63,155250
22044,0.000433,172.31.40.0-255,66,40244,63,155250
22045,0.000438,172.217.194.0-255,2902,43146,63,155250
22046,0.00044,172.31.40.0-255,66,43212,63,155250
22047,0.000447,172.217.194.0-255,5738,48950,63,155250
22048,0.000451,172.31.40.0-255,66,49016,63,155250
22049,0.000485,172.217.194.0-255,7098,56114,63,155250
22050,0.000488,172.31.40.0-255,66,56180,63,155250
22051,0.000491,172.217.194.0-255,376,56556,63,155250
22052,0.000726,172.217.194.0-255,1484,58040,63,155250
22053,0.000731,172.31.40.0-255,66,58106,63,155250
22054,0.000737,172.217.194.0-255,2902,61008,63,155250
22055,0.000739,172.31.40.0-255,66,61074,63,155250
22056,0.000746,172.217.194.0-255,5738,66812,63,155250
22057,0.000747,172.31.40.0-255,66,66878,63,155250
22058,0.000792,172.31.40.0-255,66,66944,63,155250
22059,0.000805,172.31.40.0-255,66,67010,63,155250
22060,0.000821,172.217.194.0-255,2184,69194,63,155250
22061,0.000824,172.31.40.0-255,66,69260,63,155250
22062,0.00089,172.217.194.0-255,1484,70744,63,155250
22063,0.000896,172.217.194.0-255,2902,73646,63,155250
22064,0.000899,172.31.40.0-255,66,73712,63,155250
22065,0.000903,172.217.194.0-255,1484,75196,63,155250
22066,0.000923,172.217.194.0-255,4320,79516,63,155250
22067,0.000928,172.31.40.0-255,66,79582,63,155250
22068,0.00094,172.217.194.0-255,2902,82484,63,155250
22069,0.000942,172.31.40.0-255,66,82550,63,155250
22070,0.000972,172.217.194.0-255,1484,84034,63,155250
22071,0.000977,172.31.40.0-255,66,84100,63,155250
22072,0.000987,172.217.194.0-255,2902,87002,63,155250
22073,0.000989,172.31.40.0-255,66,87068,63,155250
22074,0.001031,172.31.40.0-255,66,87134,63,155250
22075,0.001034,172.217.194.0-255,1484,88618,63,155250
22076,0.001057,172.31.40.0-255,66,88684,63,155250
22077,0.001093,172.31.40.0-255,66,88750,63,155250
22078,0.001106,172.31.40.0-255,66,88816,63,155250
22079,0.001131,172.217.194.0-255,7156,95972,63,155250
22080,0.001134,172.31.40.0-255,66,96038,63,155250
22081,0.001153,172.217.194.0-255,4320,100358,63,155250
22082,0.001156,172.31.40.0-255,66,100424,63,155250
22083,0.001189,172.31.40.0-255,66,100490,63,155250
22084,0.001238,172.31.40.0-255,66,100556,63,155250
22085,0.001261,172.217.194.0-255,2902,103458,63,155250
22086,0.001265,172.31.40.0-255,66,103524,63,155250
22087,0.001279,172.31.40.0-255,66,103590,63,155250
22088,0.001284,172.217.194.0-255,5020,108610,63,155250
22089,0.001287,172.31.40.0-255,66,108676,63,155250
22090,0.001409,172.217.194.0-255,1484,110160,63,155250
22091,0.001414,172.217.194.0-255,1484,111644,63,155250
22092,0.001417,172.31.40.0-255,66,111710,63,155250
22093,0.001437,172.217.194.0-255,1484,113194,63,155250
22094,0.001444,172.217.194.0-255,5738,118932,63,155250
22095,0.001447,172.31.40.0-255,66,118998,63,155250
22096,0.001466,172.31.40.0-255,66,119064,63,155250
22097,0.001481,172.217.194.0-255,1484,120548,63,155250
22098,0.001493,172.31.40.0-255,66,120614,63,155250
22099,0.001495,172.217.194.0-255,766,121380,63,155250
22100,0.001578,172.217.194.0-255,1484,122864,63,155250
22101,0.001583,172.217.194.0-255,2902,125766,63,155250
22102,0.001585,172.217.194.0-255,1484,127250,63,155250
22103,0.001592,172.31.40.0-255,66,127316,63,155250
22104,0.0016,172.31.40.0-255,66,127382,63,155250
22105,0.001606,172.217.194.0-255,4320,131702,63,155250
22106,0.001609,172.31.40.0-255,66,131768,63,155250
22107,0.001613,172.217.194.0-255,2902,134670,63,155250
22108,0.001616,172.31.40.0-255,66,134736,63,155250
22109,0.001653,172.31.40.0-255,66,134802,63,155250
22110,0.001656,172.217.194.0-255,1484,136286,63,155250
22111,0.001687,172.31.40.0-255,66,136352,63,155250
22112,0.002073,172.217.194.0-255,1484,137836,63,155250
22113,0.00208,172.217.194.0-255,2902,140738,63,155250
22114,0.002083,172.31.40.0-255,66,140804,63,155250
22115,0.002088,172.217.194.0-255,2902,143706,63,155250
22116,0.00209,172.31.40.0-255,66,143772,63,155250
22117,0.002111,172.217.194.0-255,2902,146674,63,155250
22118,0.002114,172.31.40.0-255,66,146740,63,155250
22119,0.002127,172.31.40.0-255,66,146806,63,155250
22120,0.002138,172.31.40.0-255,66,146872,63,155250
22121,0.00218,172.217.194.0-255,7156,154028,63,155250
22122,0.002184,172.31.40.0-255,66,154094,63,155250
22123,0.002222,172.31.40.0-255,66,154160,63,155250
22124,0.002234,172.31.40.0-255,66,154226,63,155250
22125,0.002275,172.31.40.0-255,66,154292,63,155250
22126,0.002313,172.31.40.0-255,66,154358,63,155250
22127,0.004508,172.217.194.0-255,655,155013,63,155250
22128,0.017061,172.31.40.0-255,66,155079,63,155250
22129,0.017115,172.31.40.0-255,105,155184,63,155250
22130,0.019294,172.217.194.0-255,66,155250,63,155250
22131,0.0,74.125.200.0-255,155,155,63,194928
22132,2.5e-05,172.31.40.0-255,66,221,63,194928
22133,3.1e-05,74.125.200.0-255,1484,1705,63,194928
22134,3.6e-05,172.31.40.0-255,66,1771,63,194928
22135,4.2e-05,74.125.200.0-255,2902,4673,63,194928
22136,5.2e-05,172.31.40.0-255,66,4739,63,194928
22137,5.8e-05,74.125.200.0-255,4320,9059,63,194928
22138,6e-05,172.31.40.0-255,66,9125,63,194928
22139,7.5e-05,74.125.200.0-255,2902,12027,63,194928
22140,7.7e-05,172.31.40.0-255,66,12093,63,194928
22141,0.000102,74.125.200.0-255,2030,14123,63,194928
22142,0.000105,172.31.40.0-255,66,14189,63,194928
22143,0.000232,74.125.200.0-255,1484,15673,63,194928
22144,0.000236,172.31.40.0-255,66,15739,63,194928
22145,0.000242,74.125.200.0-255,2902,18641,63,194928
22146,0.000245,172.31.40.0-255,66,18707,63,194928
22147,0.00028,74.125.200.0-255,5738,24445,63,194928
22148,0.000282,172.31.40.0-255,66,24511,63,194928
22149,0.000287,74.125.200.0-255,2902,27413,63,194928
22150,0.000289,172.31.40.0-255,66,27479,63,194928
22151,0.000315,74.125.200.0-255,3961,31440,63,194928
22152,0.000323,172.31.40.0-255,66,31506,63,194928
22153,0.000407,74.125.200.0-255,1484,32990,63,194928
22154,0.00041,172.31.40.0-255,66,33056,63,194928
22155,0.000416,74.125.200.0-255,2902,35958,63,194928
22156,0.000418,172.31.40.0-255,66,36024,63,194928
22157,0.000446,74.125.200.0-255,4320,40344,63,194928
22158,0.000449,172.31.40.0-255,66,40410,63,194928
22159,0.000481,172.31.40.0-255,66,40476,63,194928
22160,0.000487,74.125.200.0-255,4320,44796,63,194928
22161,0.000489,172.31.40.0-255,66,44862,63,194928
22162,0.000544,74.125.200.0-255,5738,50600,63,194928
22163,0.000547,172.31.40.0-255,66,50666,63,194928
22164,0.000577,74.125.200.0-255,5651,56317,63,194928
22165,0.000579,172.31.40.0-255,66,56383,63,194928
22166,0.000583,74.125.200.0-255,132,56515,63,194928
22167,0.000587,74.125.200.0-255,347,56862,63,194928
22168,0.00078,74.125.200.0-255,1484,58346,63,194928
22169,0.000784,172.31.40.0-255,66,58412,63,194928
22170,0.000789,74.125.200.0-255,2902,61314,63,194928
22171,0.000791,172.31.40.0-255,66,61380,63,194928
22172,0.000839,74.125.200.0-255,5738,67118,63,194928
22173,0.000841,172.31.40.0-255,66,67184,63,194928
22174,0.000886,74.125.200.0-255,7156,74340,63,194928
22175,0.000888,172.31.40.0-255,66,74406,63,194928
22176,0.000894,74.125.200.0-255,5738,80144,63,194928
22177,0.000896,172.31.40.0-255,66,80210,63,194928
22178,0.000903,74.125.200.0-255,5738,85948,63,194928
22179,0.00091,172.31.40.0-255,66,86014,63,194928
22180,0.000932,74.125.200.0-255,1484,87498,63,194928
22181,0.000938,74.125.200.0-255,3602,91100,63,194928
22182,0.000945,172.31.40.0-255,66,91166,63,194928
22183,0.001403,74.125.200.0-255,1484,92650,63,194928
22184,0.00141,74.125.200.0-255,2902,95552,63,194928
22185,0.001414,172.31.40.0-255,66,95618,63,194928
22186,0.001418,74.125.200.0-255,1484,97102,63,194928
22187,0.001448,74.125.200.0-255,2902,100004,63,194928
22188,0.001451,172.31.40.0-255,66,100070,63,194928
22189,0.001458,74.125.200.0-255,5738,105808,63,194928
22190,0.001459,172.31.40.0-255,66,105874,63,194928
22191,0.00149,172.31.40.0-255,66,105940,63,194928
22192,0.001513,74.125.200.0-255,1484,107424,63,194928
22193,0.00153,74.125.200.0-255,7156,114580,63,194928
22194,0.001533,172.31.40.0-255,66,114646,63,194928
22195,0.001557,74.125.200.0-255,2184,116830,63,194928
22196,0.001559,172.31.40.0-255,66,116896,63,194928
22197,0.001705,74.125.200.0-255,1484,118380,63,194928
22198,0.00172,74.125.200.0-255,2902,121282,63,194928
22199,0.001723,172.31.40.0-255,66,121348,63,194928
22200,0.001727,74.125.200.0-255,1484,122832,63,194928
22201,0.001751,74.125.200.0-255,2902,125734,63,194928
22202,0.001753,172.31.40.0-255,66,125800,63,194928
22203,0.001792,172.31.40.0-255,66,125866,63,194928
22204,0.001795,74.125.200.0-255,1484,127350,63,194928
22205,0.001799,74.125.200.0-255,2902,130252,63,194928
22206,0.0018,172.31.40.0-255,66,130318,63,194928
22207,0.001829,74.125.200.0-255,5738,136056,63,194928
22208,0.001831,172.31.40.0-255,66,136122,63,194928
22209,0.001835,74.125.200.0-255,1484,137606,63,194928
22210,0.001883,74.125.200.0-255,5020,142626,63,194928
22211,0.001887,172.31.40.0-255,66,142692,63,194928
22212,0.003802,74.125.200.0-255,5738,148430,63,194928
22213,0.003809,172.31.40.0-255,66,148496,63,194928
22214,0.005704,74.125.200.0-255,5738,154234,63,194928
22215,0.005707,172.31.40.0-255,66,154300,63,194928
22216,0.007621,74.125.200.0-255,5738,160038,63,194928
22217,0.007628,172.31.40.0-255,66,160104,63,194928
22218,0.009543,74.125.200.0-255,5738,165842,63,194928
22219,0.00955,172.31.40.0-255,66,165908,63,194928
22220,0.011468,74.125.200.0-255,5738,171646,63,194928
22221,0.011476,172.31.40.0-255,66,171712,63,194928
22222,0.013387,74.125.200.0-255,5738,177450,63,194928
22223,0.013395,172.31.40.0-255,66,177516,63,194928
22224,0.015312,74.125.200.0-255,5738,183254,63,194928
22225,0.01532,172.31.40.0-255,66,183320,63,194928
22226,0.017235,74.125.200.0-255,5738,189058,63,194928
22227,0.017242,172.31.40.0-255,66,189124,63,194928
22228,0.019152,74.125.200.0-255,5738,194862,63,194928
22229,0.019159,172.31.40.0-255,66,194928,63,194928
22230,0.0,74.125.130.0-255,151,151,63,193827
22231,1.6e-05,172.31.40.0-255,66,217,63,193827
22232,2.3e-05,74.125.130.0-255,1484,1701,63,193827
22233,2.7e-05,172.31.40.0-255,66,1767,63,193827
22234,3.3e-05,74.125.130.0-255,2902,4669,63,193827
22235,3.7e-05,172.31.40.0-255,66,4735,63,193827
22236,6.1e-05,74.125.130.0-255,1484,6219,63,193827
22237,6.4e-05,172.31.40.0-255,66,6285,63,193827
22238,7e-05,74.125.130.0-255,2902,9187,63,193827
22239,7.3e-05,172.31.40.0-255,66,9253,63,193827
22240,0.0001,74.125.130.0-255,6294,15547,63,193827
22241,0.000103,172.31.40.0-255,66,15613,63,193827
22242,0.000132,74.125.130.0-255,7156,22769,63,193827
22243,0.000135,172.31.40.0-255,66,22835,63,193827
22244,0.000138,74.125.130.0-255,1484,24319,63,193827
22245,0.000141,172.31.40.0-255,66,24385,63,193827
22246,0.000163,74.125.130.0-255,6797,31182,63,193827
22247,0.000166,172.31.40.0-255,66,31248,63,193827
22248,0.000274,74.125.130.0-255,1484,32732,63,193827
22249,0.000278,172.31.40.0-255,66,32798,63,193827
22250,0.000283,74.125.130.0-255,2902,35700,63,193827
22251,0.000285,172.31.40.0-255,66,35766,63,193827
22252,0.000298,74.125.130.0-255,1484,37250,63,193827
22253,0.000301,172.31.40.0-255,66,37316,63,193827
22254,0.000324,74.125.130.0-255,2902,40218,63,193827
22255,0.000326,172.31.40.0-255,66,40284,63,193827
22256,0.000341,74.125.130.0-255,5738,46022,63,193827
22257,0.000344,172.31.40.0-255,66,46088,63,193827
22258,0.000359,74.125.130.0-255,3961,50049,63,193827
22259,0.000362,172.31.40.0-255,66,50115,63,193827
22260,0.000368,74.125.130.0-255,5738,55853,63,193827
22261,0.000371,172.31.40.0-255,66,55919,63,193827
22262,0.000395,74.125.130.0-255,4320,60239,63,193827
22263,0.000398,172.31.40.0-255,66,60305,63,193827
22264,0.000405,74.125.130.0-255,5633,65938,63,193827
22265,0.000407,172.31.40.0-255,66,66004,63,193827
22266,0.00041,74.125.130.0-255,119,66123,63,193827
22267,0.000561,74.125.130.0-255,1484,67607,63,193827
22268,0.000566,172.31.40.0-255,66,67673,63,193827
22269,0.000571,74.125.130.0-255,2902,70575,63,193827
22270,0.000574,172.31.40.0-255,66,70641,63,193827
22271,0.000604,74.125.130.0-255,4320,74961,63,193827
22272,0.000607,172.31.40.0-255,66,75027,63,193827
22273,0.000613,74.125.130.0-255,5738,80765,63,193827
22274,0.000616,172.31.40.0-255,66,80831,63,193827
22275,0.000638,74.125.130.0-255,1484,82315,63,193827
22276,0.00066,74.125.130.0-255,6797,89112,63,193827
22277,0.000664,172.31.40.0-255,66,89178,63,193827
22278,0.000669,74.125.130.0-255,4320,93498,63,193827
22279,0.000671,172.31.40.0-255,66,93564,63,193827
22280,0.000692,74.125.130.0-255,4320,97884,63,193827
22281,0.000696,172.31.40.0-255,66,97950,63,193827
22282,0.000708,172.31.40.0-255,66,98016,63,193827
22283,0.000747,74.125.130.0-255,5738,103754,63,193827
22284,0.00075,172.31.40.0-255,66,103820,63,193827
22285,0.000767,74.125.130.0-255,3335,107155,63,193827
22286,0.00077,172.31.40.0-255,66,107221,63,193827
22287,0.000869,74.125.130.0-255,1484,108705,63,193827
22288,0.000895,74.125.130.0-255,2902,111607,63,193827
22289,0.000899,172.31.40.0-255,66,111673,63,193827
22290,0.000923,74.125.130.0-255,4320,115993,63,193827
22291,0.000925,172.31.40.0-255,66,116059,63,193827
22292,0.00093,74.125.130.0-255,2902,118961,63,193827
22293,0.000932,172.31.40.0-255,66,119027,63,193827
22294,0.000952,74.125.130.0-255,5738,124765,63,193827
22295,0.000955,172.31.40.0-255,66,124831,63,193827
22296,0.000961,74.125.130.0-255,5738,130569,63,193827
22297,0.000964,172.31.40.0-255,66,130635,63,193827
22298,0.00097,74.125.130.0-255,7156,137791,63,193827
22299,0.000973,172.31.40.0-255,66,137857,63,193827
22300,0.000998,74.125.130.0-255,3602,141459,63,193827
22301,0.001001,172.31.40.0-255,66,141525,63,193827
22302,0.002997,74.125.130.0-255,1484,143009,63,193827
22303,0.003023,74.125.130.0-255,4320,147329,63,193827
22304,0.003028,172.31.40.0-255,66,147395,63,193827
22305,0.005074,74.125.130.0-255,5738,153133,63,193827
22306,0.00508,172.31.40.0-255,66,153199,63,193827
22307,0.007112,74.125.130.0-255,5738,158937,63,193827
22308,0.007116,172.31.40.0-255,66,159003,63,193827
22309,0.009145,74.125.130.0-255,5738,164741,63,193827
22310,0.009153,172.31.40.0-255,66,164807,63,193827
22311,0.011195,74.125.130.0-255,5738,170545,63,193827
22312,0.011203,172.31.40.0-255,66,170611,63,193827
22313,0.01323,74.125.130.0-255,5738,176349,63,193827
22314,0.013253,172.31.40.0-255,66,176415,63,193827
22315,0.015285,74.125.130.0-255,5738,182153,63,193827
22316,0.015294,172.31.40.0-255,66,182219,63,193827
22317,0.017323,74.125.130.0-255,5738,187957,63,193827
22318,0.017331,172.31.40.0-255,66,188023,63,193827
22319,0.019355,74.125.130.0-255,5738,193761,63,193827
22320,0.019364,172.31.40.0-255,66,193827,63,193827
22321,0.0,172.217.194.0-255,146,146,63,185334
22322,2.1e-05,172.31.40.0-255,66,212,63,185334
22323,2.8e-05,172.217.194.0-255,1484,1696,63,185334
22324,3.2e-05,172.31.40.0-255,66,1762,63,185334
22325,4.6e-05,172.217.194.0-255,2902,4664,63,185334
22326,5e-05,172.31.40.0-255,66,4730,63,185334
22327,5.6e-05,172.217.194.0-255,4320,9050,63,185334
22328,5.9e-05,172.31.40.0-255,66,9116,63,185334
22329,6.2e-05,172.217.194.0-255,1484,10600,63,185334
22330,6.4e-05,172.31.40.0-255,66,10666,63,185334
22331,8.6e-05,172.217.194.0-255,3446,14112,63,185334
22332,9.4e-05,172.31.40.0-255,66,14178,63,185334
22333,0.000146,172.217.194.0-255,1484,15662,63,185334
22334,0.000149,172.31.40.0-255,66,15728,63,185334
22335,0.000154,172.217.194.0-255,2902,18630,63,185334
22336,0.000155,172.31.40.0-255,66,18696,63,185334
22337,0.000179,172.217.194.0-255,5738,24434,63,185334
22338,0.000182,172.31.40.0-255,66,24500,63,185334
22339,0.000245,172.31.40.0-255,66,24566,63,185334
22340,0.000258,172.31.40.0-255,66,24632,63,185334
22341,0.000298,172.31.40.0-255,66,24698,63,185334
22342,0.000313,172.217.194.0-255,413,25111,63,185334
22343,0.000315,172.31.40.0-255,66,25177,63,185334
22344,0.000369,172.217.194.0-255,361,25538,63,185334
22345,0.000372,172.31.40.0-255,66,25604,63,185334
22346,0.000601,172.217.194.0-255,1484,27088,63,185334
22347,0.000606,172.31.40.0-255,66,27154,63,185334
22348,0.000612,172.217.194.0-255,2902,30056,63,185334
22349,0.000614,172.31.40.0-255,66,30122,63,185334
22350,0.00062,172.217.194.0-255,5738,35860,63,185334
22351,0.000678,172.31.40.0-255,66,35926,63,185334
22352,0.000684,172.217.194.0-255,4320,40246,63,185334
22353,0.000689,172.31.40.0-255,66,40312,63,185334
22354,0.000742,172.31.40.0-255,66,40378,63,185334
22355,0.001119,172.217.194.0-255,1484,41862,63,185334
22356,0.001126,172.217.194.0-255,2902,44764,63,185334
22357,0.001129,172.31.40.0-255,66,44830,63,185334
22358,0.001136,172.217.194.0-255,4320,49150,63,185334
22359,0.001151,172.217.194.0-255,1484,50634,63,185334
22360,0.001175,172.31.40.0-255,66,50700,63,185334
22361,0.001183,172.217.194.0-255,2902,53602,63,185334
22362,0.001188,172.31.40.0-255,66,53668,63,185334
22363,0.00123,172.31.40.0-255,66,53734,63,185334
22364,0.001636,172.217.194.0-255,1484,55218,63,185334
22365,0.001642,172.217.194.0-255,2902,58120,63,185334
22366,0.001645,172.31.40.0-255,66,58186,63,185334
22367,0.00168,172.217.194.0-255,5738,63924,63,185334
22368,0.001695,172.217.194.0-255,1484,65408,63,185334
22369,0.001709,172.31.40.0-255,66,65474,63,185334
22370,0.001732,172.31.40.0-255,66,65540,63,185334
22371,0.001945,172.217.194.0-255,1484,67024,63,185334
22372,0.001951,172.217.194.0-255,2902,69926,63,185334
22373,0.001955,172.31.40.0-255,66,69992,63,185334
22374,0.001989,172.217.194.0-255,5738,75730,63,185334
22375,0.002004,172.31.40.0-255,66,75796,63,185334
22376,0.002029,172.217.194.0-255,1484,77280,63,185334
22377,0.002057,172.31.40.0-255,66,77346,63,185334
22378,0.002231,172.217.194.0-255,1484,78830,63,185334
22379,0.002244,172.217.194.0-255,2902,81732,63,185334
22380,0.002248,172.31.40.0-255,66,81798,63,185334
22381,0.002295,172.217.194.0-255,2902,84700,63,185334
22382,0.002313,172.217.194.0-255,2902,87602,63,185334
22383,0.002328,172.217.194.0-255,5738,93340,63,185334
22384,0.002432,172.217.194.0-255,1484,94824,63,185334
22385,0.002447,172.217.194.0-255,2902,97726,63,185334
22386,0.002469,172.217.194.0-255,5738,103464,63,185334
22387,0.002479,172.217.194.0-255,1484,104948,63,185334
22388,0.002511,172.217.194.0-255,766,105714,63,185334
22389,0.002516,172.31.40.0-255,78,105792,63,185334
22390,0.002649,172.217.194.0-255,1484,107276,63,185334
22391,0.002677,172.217.194.0-255,2902,110178,63,185334
22392,0.002685,172.217.194.0-255,5738,115916,63,185334
22393,0.002715,172.217.194.0-255,4320,120236,63,185334
22394,0.002719,172.217.194.0-255,2902,123138,63,185334
22395,0.002722,172.217.194.0-255,1484,124622,63,185334
22396,0.002729,172.217.194.0-255,6438,131060,63,185334
22397,0.0028,172.217.194.0-255,1484,132544,63,185334
22398,0.002805,172.217.194.0-255,2902,135446,63,185334
22399,0.002808,172.217.194.0-255,1484,136930,63,185334
22400,0.002823,172.217.194.0-255,1484,138414,63,185334
22401,0.002826,172.217.194.0-255,1484,139898,63,185334
22402,0.002832,172.217.194.0-255,4320,144218,63,185334
22403,0.002843,172.217.194.0-255,1484,145702,63,185334
22404,0.002861,172.217.194.0-255,2902,148604,63,185334
22405,0.002889,172.217.194.0-255,5738,154342,63,185334
22406,0.002906,172.217.194.0-255,766,155108,63,185334
22407,0.002954,172.217.194.0-255,7156,162264,63,185334
22408,0.003255,172.217.194.0-255,1484,163748,63,185334
22409,0.003262,172.217.194.0-255,2902,166650,63,185334
22410,0.003267,172.217.194.0-255,2902,169552,63,185334
22411,0.003284,172.217.194.0-255,2902,172454,63,185334
22412,0.003291,172.217.194.0-255,5738,178192,63,185334
22413,0.003321,172.217.194.0-255,2902,181094,63,185334
22414,0.003361,172.217.194.0-255,2184,183278,63,185334
22415,0.003363,172.217.194.0-255,1484,184762,63,185334
22416,0.003365,172.217.194.0-255,218,184980,63,185334
22417,0.003426,172.217.194.0-255,105,185085,63,185334
22418,0.010294,172.31.40.0-255,78,185163,63,185334
22419,0.012655,172.31.40.0-255,105,185268,63,185334
22420,0.014723,172.217.194.0-255,66,185334,63,185334
22421,0.0,74.125.24.0-255,153,153,63,151711
22422,2.2e-05,172.31.40.0-255,66,219,63,151711
22423,3e-05,74.125.24.0-255,1484,1703,63,151711
22424,3.4e-05,172.31.40.0-255,66,1769,63,151711
22425,4e-05,74.125.24.0-255,2902,4671,63,151711
22426,5.1e-05,172.31.40.0-255,66,4737,63,151711
22427,5.5e-05,74.125.24.0-255,1484,6221,63,151711
22428,5.7e-05,172.31.40.0-255,66,6287,63,151711
22429,6.5e-05,74.125.24.0-255,5738,12025,63,151711
22430,6.8e-05,172.31.40.0-255,66,12091,63,151711
22431,9.3e-05,74.125.24.0-255,4320,16411,63,151711
22432,9.7e-05,172.31.40.0-255,66,16477,63,151711
22433,0.000135,172.31.40.0-255,66,16543,63,151711
22434,0.000156,172.31.40.0-255,66,16609,63,151711
22435,0.000163,74.125.24.0-255,7156,23765,63,151711
22436,0.000165,172.31.40.0-255,66,23831,63,151711
22437,0.000195,74.125.24.0-255,766,24597,63,151711
22438,0.000199,172.31.40.0-255,66,24663,63,151711
22439,0.000203,74.125.24.0-255,2902,27565,63,151711
22440,0.000206,172.31.40.0-255,66,27631,63,151711
22441,0.000242,172.31.40.0-255,66,27697,63,151711
22442,0.000245,74.125.24.0-255,134,27831,63,151711
22443,0.000247,172.31.40.0-255,66,27897,63,151711
22444,0.00025,74.125.24.0-255,1484,29381,63,151711
22445,0.000252,172.31.40.0-255,66,29447,63,151711
22446,0.000284,74.125.24.0-255,2902,32349,63,151711
22447,0.000287,172.31.40.0-255,66,32415,63,151711
22448,0.000295,74.125.24.0-255,7156,39571,63,151711
22449,0.000297,172.31.40.0-255,66,39637,63,151711
22450,0.000303,74.125.24.0-255,5076,44713,63,151711
22451,0.00031,172.31.40.0-255,66,44779,63,151711
22452,0.000985,74.125.24.0-255,1484,46263,63,151711
22453,0.000993,74.125.24.0-255,2902,49165,63,151711
22454,0.000997,172.31.40.0-255,66,49231,63,151711
22455,0.001005,74.125.24.0-255,5738,54969,63,151711
22456,0.001007,172.31.40.0-255,66,55035,63,151711
22457,0.00101,74.125.24.0-255,1484,56519,63,151711
22458,0.001038,74.125.24.0-255,5738,62257,63,151711
22459,0.00104,172.31.40.0-255,66,62323,63,151711
22460,0.001044,74.125.24.0-255,2902,65225,63,151711
22461,0.001047,172.31.40.0-255,66,65291,63,151711
22462,0.001087,172.31.40.0-255,66,65357,63,151711
22463,0.001091,74.125.24.0-255,2184,67541,63,151711
22464,0.001093,172.31.40.0-255,66,67607,63,151711
22465,0.00127,74.125.24.0-255,1484,69091,63,151711
22466,0.001284,74.125.24.0-255,2902,71993,63,151711
22467,0.001289,74.125.24.0-255,4320,76313,63,151711
22468,0.001294,172.31.40.0-255,66,76379,63,151711
22469,0.001298,172.31.40.0-255,66,76445,63,151711
22470,0.001308,74.125.24.0-255,1484,77929,63,151711
22471,0.00132,74.125.24.0-255,7156,85085,63,151711
22472,0.001322,172.31.40.0-255,66,85151,63,151711
22473,0.001359,74.125.24.0-255,1484,86635,63,151711
22474,0.001373,172.31.40.0-255,66,86701,63,151711
22475,0.001384,172.31.40.0-255,66,86767,63,151711
22476,0.001402,172.31.40.0-255,66,86833,63,151711
22477,0.001449,172.31.40.0-255,66,86899,63,151711
22478,0.001476,74.125.24.0-255,4320,91219,63,151711
22479,0.001478,172.31.40.0-255,66,91285,63,151711
22480,0.001483,74.125.24.0-255,2184,93469,63,151711
22481,0.001485,172.31.40.0-255,66,93535,63,151711
22482,0.001533,74.125.24.0-255,1484,95019,63,151711
22483,0.001547,74.125.24.0-255,2902,97921,63,151711
22484,0.001551,172.31.40.0-255,66,97987,63,151711
22485,0.001587,74.125.24.0-255,5738,103725,63,151711
22486,0.001591,172.31.40.0-255,66,103791,63,151711
22487,0.001603,172.31.40.0-255,66,103857,63,151711
22488,0.001637,172.31.40.0-255,66,103923,63,151711
22489,0.001665,74.125.24.0-255,2184,106107,63,151711
22490,0.001667,172.31.40.0-255,66,106173,63,151711
22491,0.001712,74.125.24.0-255,1484,107657,63,151711
22492,0.001729,74.125.24.0-255,1484,109141,63,151711
22493,0.001733,172.31.40.0-255,66,109207,63,151711
22494,0.001761,74.125.24.0-255,1484,110691,63,151711
22495,0.001768,74.125.24.0-255,5738,116429,63,151711
22496,0.001771,172.31.40.0-255,66,116495,63,151711
22497,0.00179,172.31.40.0-255,66,116561,63,151711
22498,0.001794,74.125.24.0-255,2902,119463,63,151711
22499,0.001796,172.31.40.0-255,66,119529,63,151711
22500,0.00182,172.31.40.0-255,66,119595,63,151711
22501,0.001829,74.125.24.0-255,2902,122497,63,151711
22502,0.001833,172.31.40.0-255,66,122563,63,151711
22503,0.00187,172.31.40.0-255,66,122629,63,151711
22504,0.001883,172.31.40.0-255,66,122695,63,151711
22505,0.001956,172.31.40.0-255,66,122761,63,151711
22506,0.001982,172.31.40.0-255,66,122827,63,151711
22507,0.002012,74.125.24.0-255,6438,129265,63,151711
22508,0.002016,172.31.40.0-255,66,129331,63,151711
22509,0.002047,74.125.24.0-255,6438,135769,63,151711
22510,0.00206,74.125.24.0-255,1484,137253,63,151711
22511,0.002069,172.31.40.0-255,66,137319,63,151711
22512,0.002114,74.125.24.0-255,4320,141639,63,151711
22513,0.002156,172.31.40.0-255,66,141705,63,151711
22514,0.002163,74.125.24.0-255,7156,148861,63,151711
22515,0.002168,172.31.40.0-255,66,148927,63,151711
22516,0.002195,74.125.24.0-255,2376,151303,63,151711
22517,0.002219,172.31.40.0-255,66,151369,63,151711
22518,0.002244,74.125.24.0-255,105,151474,63,151711
22519,0.004441,172.31.40.0-255,66,151540,63,151711
22520,0.004478,172.31.40.0-255,105,151645,63,151711
22521,0.006718,74.125.24.0-255,66,151711,63,151711
22522,0.0,74.125.68.0-255,152,152,63,329164
22523,3e-05,172.31.40.0-255,66,218,63,329164
22524,3.8e-05,74.125.68.0-255,1484,1702,63,329164
22525,4.2e-05,172.31.40.0-255,66,1768,63,329164
22526,4.8e-05,74.125.68.0-255,2902,4670,63,329164
22527,5.2e-05,172.31.40.0-255,66,4736,63,329164
22528,5.8e-05,74.125.68.0-255,5738,10474,63,329164
22529,6.1e-05,172.31.40.0-255,66,10540,63,329164
22530,6.9e-05,74.125.68.0-255,6394,16934,63,329164
22531,7.2e-05,172.31.40.0-255,66,17000,63,329164
22532,0.000112,172.31.40.0-255,66,17066,63,329164
22533,0.000132,74.125.68.0-255,1484,18550,63,329164
22534,0.000135,172.31.40.0-255,66,18616,63,329164
22535,0.000152,74.125.68.0-255,3961,22577,63,329164
22536,0.000154,172.31.40.0-255,66,22643,63,329164
22537,0.000198,74.125.68.0-255,5738,28381,63,329164
22538,0.0002,172.31.40.0-255,66,28447,63,329164
22539,0.000223,74.125.68.0-255,7156,35603,63,329164
22540,0.000226,172.31.40.0-255,66,35669,63,329164
22541,0.000255,74.125.68.0-255,3961,39630,63,329164
22542,0.000257,172.31.40.0-255,66,39696,63,329164
22543,0.000455,74.125.68.0-255,1484,41180,63,329164
22544,0.000461,172.31.40.0-255,66,41246,63,329164
22545,0.000467,74.125.68.0-255,2902,44148,63,329164
22546,0.000469,172.31.40.0-255,66,44214,63,329164
22547,0.000498,74.125.68.0-255,5738,49952,63,329164
22548,0.000501,172.31.40.0-255,66,50018,63,329164
22549,0.000508,74.125.68.0-255,6797,56815,63,329164
22550,0.00051,172.31.40.0-255,66,56881,63,329164
22551,0.000546,74.125.68.0-255,5738,62619,63,329164
22552,0.000549,172.31.40.0-255,66,62685,63,329164
22553,0.000568,74.125.68.0-255,5738,68423,63,329164
22554,0.000571,172.31.40.0-255,66,68489,63,329164
22555,0.000618,74.125.68.0-255,5379,73868,63,329164
22556,0.000621,172.31.40.0-255,66,73934,63,329164
22557,0.000625,74.125.68.0-255,2902,76836,63,329164
22558,0.000627,172.31.40.0-255,66,76902,63,329164
22559,0.000642,74.125.68.0-255,2902,79804,63,329164
22560,0.000645,172.31.40.0-255,66,79870,63,329164
22561,0.000649,74.125.68.0-255,2902,82772,63,329164
22562,0.000651,172.31.40.0-255,66,82838,63,329164
22563,0.000656,74.125.68.0-255,4320,87158,63,329164
22564,0.000659,172.31.40.0-255,66,87224,63,329164
22565,0.000697,74.125.68.0-255,3961,91185,63,329164
22566,0.000701,172.31.40.0-255,66,91251,63,329164
22567,0.000842,74.125.68.0-255,1484,92735,63,329164
22568,0.000866,74.125.68.0-255,2902,95637,63,329164
22569,0.000869,172.31.40.0-255,66,95703,63,329164
22570,0.000876,74.125.68.0-255,5738,101441,63,329164
22571,0.000879,172.31.40.0-255,66,101507,63,329164
22572,0.000912,74.125.68.0-255,4320,105827,63,329164
22573,0.000915,172.31.40.0-255,66,105893,63,329164
22574,0.00094,74.125.68.0-255,7156,113049,63,329164
22575,0.000953,74.125.68.0-255,2902,115951,63,329164
22576,0.000967,74.125.68.0-255,5738,121689,63,329164
22577,0.000975,172.31.40.0-255,66,121755,63,329164
22578,0.000992,74.125.68.0-255,3602,125357,63,329164
22579,0.001002,172.31.40.0-255,66,125423,63,329164
22580,0.001014,74.125.68.0-255,1484,126907,63,329164
22581,0.001017,74.125.68.0-255,1484,128391,63,329164
22582,0.001021,74.125.68.0-255,2902,131293,63,329164
22583,0.001024,74.125.68.0-255,1484,132777,63,329164
22584,0.001042,74.125.68.0-255,4320,137097,63,329164
22585,0.001059,74.125.68.0-255,4355,141452,63,329164
22586,0.001062,172.31.40.0-255,66,141518,63,329164
22587,0.001067,172.31.40.0-255,66,141584,63,329164
22588,0.001107,74.125.68.0-255,1484,143068,63,329164
22589,0.001111,74.125.68.0-255,1484,144552,63,329164
22590,0.001128,74.125.68.0-255,1484,146036,63,329164
22591,0.001143,74.125.68.0-255,5738,151774,63,329164
22592,0.001147,74.125.68.0-255,1484,153258,63,329164
22593,0.001158,74.125.68.0-255,1484,154742,63,329164
22594,0.001161,74.125.68.0-255,1484,156226,63,329164
22595,0.001171,172.31.40.0-255,66,156292,63,329164
22596,0.00118,74.125.68.0-255,2902,159194,63,329164
22597,0.001198,74.125.68.0-255,7156,166350,63,329164
22598,0.001202,172.31.40.0-255,66,166416,63,329164
22599,0.001217,172.31.40.0-255,66,166482,63,329164
22600,0.001225,74.125.68.0-255,1484,167966,63,329164
22601,0.001232,74.125.68.0-255,7156,175122,63,329164
22602,0.001234,74.125.68.0-255,766,175888,63,329164
22603,0.001245,172.31.40.0-255,66,175954,63,329164
22604,0.001283,74.125.68.0-255,1484,177438,63,329164
22605,0.001301,74.125.68.0-255,4320,181758,63,329164
22606,0.001321,74.125.68.0-255,4320,186078,63,329164
22607,0.001331,172.31.40.0-255,66,186144,63,329164
22608,0.001334,74.125.68.0-255,1484,187628,63,329164
22609,0.001352,74.125.68.0-255,5738,193366,63,329164
22610,0.001363,172.31.40.0-255,66,193432,63,329164
22611,0.001374,74.125.68.0-255,5738,199170,63,329164
22612,0.001378,74.125.68.0-255,4320,203490,63,329164
22613,0.001384,172.31.40.0-255,66,203556,63,329164
22614,0.00141,74.125.68.0-255,1484,205040,63,329164
22615,0.001428,74.125.68.0-255,5020,210060,63,329164
22616,0.00144,172.31.40.0-255,66,210126,63,329164
22617,0.001526,74.125.68.0-255,1484,211610,63,329164
22618,0.001539,74.125.68.0-255,1484,213094,63,329164
22619,0.001555,74.125.68.0-255,1484,214578,63,329164
22620,0.001561,74.125.68.0-255,5738,220316,63,329164
22621,0.001564,74.125.68.0-255,1484,221800,63,329164
22622,0.001568,172.31.40.0-255,66,221866,63,329164
22623,0.001574,172.31.40.0-255,66,221932,63,329164
22624,0.001582,74.125.68.0-255,1484,223416,63,329164
22625,0.001621,74.125.68.0-255,2902,226318,63,329164
22626,0.001626,172.31.40.0-255,66,226384,63,329164
22627,0.001649,74.125.68.0-255,7156,233540,63,329164
22628,0.001657,74.125.68.0-255,766,234306,63,329164
22629,0.001664,172.31.40.0-255,66,234372,63,329164
22630,0.001758,74.125.68.0-255,1484,235856,63,329164
22631,0.001762,74.125.68.0-255,1484,237340,63,329164
22632,0.001774,74.125.68.0-255,2902,240242,63,329164
22633,0.001781,172.31.40.0-255,66,240308,63,329164
22634,0.001838,74.125.68.0-255,4320,244628,63,329164
22635,0.001854,74.125.68.0-255,1484,246112,63,329164
22636,0.00186,74.125.68.0-255,4320,250432,63,329164
22637,0.001867,74.125.68.0-255,5738,256170,63,329164
22638,0.001869,74.125.68.0-255,1484,257654,63,329164
22639,0.001879,172.31.40.0-255,66,257720,63,329164
22640,0.00191,74.125.68.0-255,766,258486,63,329164
22641,0.001921,172.31.40.0-255,66,258552,63,329164
22642,0.001943,74.125.68.0-255,1484,260036,63,329164
22643,0.001965,74.125.68.0-255,4320,264356,63,329164
22644,0.001968,74.125.68.0-255,1484,265840,63,329164
22645,0.001993,74.125.68.0-255,7156,272996,63,329164
22646,0.001997,172.31.40.0-255,66,273062,63,329164
22647,0.002002,172.31.40.0-255,66,273128,63,329164
22648,0.002034,74.125.68.0-255,4320,277448,63,329164
22649,0.002055,74.125.68.0-255,1484,278932,63,329164
22650,0.002065,172.31.40.0-255,66,278998,63,329164
22651,0.002078,74.125.68.0-255,5020,284018,63,329164
22652,0.002102,172.31.40.0-255,66,284084,63,329164
22653,0.004121,74.125.68.0-255,5738,289822,63,329164
22654,0.004128,172.31.40.0-255,66,289888,63,329164
22655,0.006148,74.125.68.0-255,5738,295626,63,329164
22656,0.006159,172.31.40.0-255,66,295692,63,329164
22657,0.008177,74.125.68.0-255,4320,300012,63,329164
22658,0.008182,172.31.40.0-255,66,300078,63,329164
22659,0.008202,74.125.68.0-255,1484,301562,63,329164
22660,0.010201,74.125.68.0-255,4320,305882,63,329164
22661,0.010207,172.31.40.0-255,66,305948,63,329164
22662,0.012237,74.125.68.0-255,5738,311686,63,329164
22663,0.012253,172.31.40.0-255,66,311752,63,329164
22664,0.014289,74.125.68.0-255,5738,317490,63,329164
22665,0.014296,172.31.40.0-255,66,317556,63,329164
22666,0.01632,74.125.68.0-255,5738,323294,63,329164
22667,0.016328,172.31.40.0-255,66,323360,63,329164
22668,0.018354,74.125.68.0-255,5738,329098,63,329164
22669,0.018362,172.31.40.0-255,66,329164,63,329164
22670,0.0,74.125.24.0-255,299,299,63,227250
22671,2.4e-05,172.31.40.0-255,66,365,63,227250
22672,3.1e-05,74.125.24.0-255,1484,1849,63,227250
22673,3.6e-05,172.31.40.0-255,66,1915,63,227250
22674,4.3e-05,74.125.24.0-255,4320,6235,63,227250
22675,5.3e-05,172.31.40.0-255,66,6301,63,227250
22676,5.7e-05,74.125.24.0-255,1484,7785,63,227250
22677,5.9e-05,172.31.40.0-255,66,7851,63,227250
22678,6.3e-05,74.125.24.0-255,1484,9335,63,227250
22679,6.5e-05,172.31.40.0-255,66,9401,63,227250
22680,9.3e-05,74.125.24.0-255,6094,15495,63,227250
22681,9.6e-05,172.31.40.0-255,66,15561,63,227250
22682,0.000111,172.31.40.0-255,66,15627,63,227250
22683,0.000198,172.31.40.0-255,66,15693,63,227250
22684,0.000205,74.125.24.0-255,5020,20713,63,227250
22685,0.000207,172.31.40.0-255,66,20779,63,227250
22686,0.00021,74.125.24.0-255,1484,22263,63,227250
22687,0.000212,172.31.40.0-255,66,22329,63,227250
22688,0.000216,74.125.24.0-255,2902,25231,63,227250
22689,0.000218,172.31.40.0-255,66,25297,63,227250
22690,0.000249,74.125.24.0-255,5738,31035,63,227250
22691,0.000252,172.31.40.0-255,66,31101,63,227250
22692,0.00026,74.125.24.0-255,7087,38188,63,227250
22693,0.000262,172.31.40.0-255,66,38254,63,227250
22694,0.000404,74.125.24.0-255,386,38640,63,227250
22695,0.000408,172.31.40.0-255,66,38706,63,227250
22696,0.000444,74.125.24.0-255,1484,40190,63,227250
22697,0.000446,172.31.40.0-255,66,40256,63,227250
22698,0.000465,74.125.24.0-255,4320,44576,63,227250
22699,0.000468,172.31.40.0-255,66,44642,63,227250
22700,0.000472,74.125.24.0-255,2902,47544,63,227250
22701,0.000499,74.125.24.0-255,7156,54700,63,227250
22702,0.000527,74.125.24.0-255,4320,59020,63,227250
22703,0.000545,74.125.24.0-255,2902,61922,63,227250
22704,0.000559,74.125.24.0-255,1484,63406,63,227250
22705,0.000575,74.125.24.0-255,4320,67726,63,227250
22706,0.000594,74.125.24.0-255,2902,70628,63,227250
22707,0.000598,74.125.24.0-255,2184,72812,63,227250
22708,0.000642,74.125.24.0-255,1484,74296,63,227250
22709,0.000645,74.125.24.0-255,1484,75780,63,227250
22710,0.000657,172.31.40.0-255,66,75846,63,227250
22711,0.000661,74.125.24.0-255,1484,77330,63,227250
22712,0.000687,74.125.24.0-255,5738,83068,63,227250
22713,0.000726,172.31.40.0-255,66,83134,63,227250
22714,0.000731,74.125.24.0-255,2902,86036,63,227250
22715,0.000746,74.125.24.0-255,2184,88220,63,227250
22716,0.00075,74.125.24.0-255,2902,91122,63,227250
22717,0.000758,172.31.40.0-255,66,91188,63,227250
22718,0.000777,74.125.24.0-255,5738,96926,63,227250
22719,0.000785,74.125.24.0-255,7156,104082,63,227250
22720,0.000802,74.125.24.0-255,1484,105566,63,227250
22721,0.000807,172.31.40.0-255,66,105632,63,227250
22722,0.000839,74.125.24.0-255,3602,109234,63,227250
22723,0.000858,172.31.40.0-255,66,109300,63,227250
22724,0.000865,74.125.24.0-255,1484,110784,63,227250
22725,0.000891,74.125.24.0-255,2902,113686,63,227250
22726,0.000896,74.125.24.0-255,5738,119424,63,227250
22727,0.000899,74.125.24.0-255,1484,120908,63,227250
22728,0.000913,74.125.24.0-255,5738,126646,63,227250
22729,0.000916,172.31.40.0-255,66,126712,63,227250
22730,0.000928,74.125.24.0-255,5738,132450,63,227250
22731,0.000945,172.31.40.0-255,66,132516,63,227250
22732,0.000969,74.125.24.0-255,2184,134700,63,227250
22733,0.00098,172.31.40.0-255,66,134766,63,227250
22734,0.001057,74.125.24.0-255,1484,136250,63,227250
22735,0.001069,74.125.24.0-255,1484,137734,63,227250
22736,0.001089,74.125.24.0-255,1484,139218,63,227250
22737,0.001095,74.125.24.0-255,5738,144956,63,227250
22738,0.001134,172.31.40.0-255,66,145022,63,227250
22739,0.001163,74.125.24.0-255,5738,150760,63,227250
22740,0.001183,74.125.24.0-255,5020,155780,63,227250
22741,0.001191,172.31.40.0-255,66,155846,63,227250
22742,0.001871,74.125.24.0-255,1484,157330,63,227250
22743,0.001892,74.125.24.0-255,2902,160232,63,227250
22744,0.001895,172.31.40.0-255,66,160298,63,227250
22745,0.0019,74.125.24.0-255,2902,163200,63,227250
22746,0.001906,172.31.40.0-255,66,163266,63,227250
22747,0.001938,74.125.24.0-255,7156,170422,63,227250
22748,0.001941,172.31.40.0-255,66,170488,63,227250
22749,0.001946,74.125.24.0-255,2902,173390,63,227250
22750,0.001983,172.31.40.0-255,66,173456,63,227250
22751,0.001995,74.125.24.0-255,2902,176358,63,227250
22752,0.002004,74.125.24.0-255,3602,179960,63,227250
22753,0.002022,172.31.40.0-255,66,180026,63,227250
22754,0.004111,74.125.24.0-255,5738,185764,63,227250
22755,0.004118,172.31.40.0-255,66,185830,63,227250
22756,0.006188,74.125.24.0-255,5738,191568,63,227250
22757,0.006195,172.31.40.0-255,66,191634,63,227250
22758,0.008269,74.125.24.0-255,2902,194536,63,227250
22759,0.008274,172.31.40.0-255,66,194602,63,227250
22760,0.0083,74.125.24.0-255,2902,197504,63,227250
22761,0.008318,172.31.40.0-255,66,197570,63,227250
22762,0.010338,74.125.24.0-255,2902,200472,63,227250
22763,0.010351,172.31.40.0-255,66,200538,63,227250
22764,0.010383,74.125.24.0-255,2902,203440,63,227250
22765,0.010435,172.31.40.0-255,66,203506,63,227250
22766,0.012436,74.125.24.0-255,2902,206408,63,227250
22767,0.012451,172.31.40.0-255,66,206474,63,227250
22768,0.012517,74.125.24.0-255,2902,209376,63,227250
22769,0.012546,172.31.40.0-255,66,209442,63,227250
22770,0.01454,74.125.24.0-255,2902,212344,63,227250
22771,0.014549,172.31.40.0-255,66,212410,63,227250
22772,0.014613,74.125.24.0-255,2902,215312,63,227250
22773,0.014628,172.31.40.0-255,66,215378,63,227250
22774,0.016623,74.125.24.0-255,2902,218280,63,227250
22775,0.016631,172.31.40.0-255,66,218346,63,227250
22776,0.0167,74.125.24.0-255,2902,221248,63,227250
22777,0.016732,172.31.40.0-255,66,221314,63,227250
22778,0.01871,74.125.24.0-255,2902,224216,63,227250
22779,0.018717,172.31.40.0-255,66,224282,63,227250
22780,0.018799,74.125.24.0-255,2902,227184,63,227250
22781,0.018819,172.31.40.0-255,66,227250,63,227250
22782,0.0,172.31.40.0-255,105,105,63,276
22783,0.001789,157.240.24.0-255,105,210,63,276
22784,0.001804,172.31.40.0-255,66,276,63,276
22785,0.0,172.217.194.0-255,152,152,63,130987
22786,2.5e-05,172.31.40.0-255,66,218,63,130987
22787,3.2e-05,172.217.194.0-255,1484,1702,63,130987
22788,3.7e-05,172.31.40.0-255,66,1768,63,130987
22789,5e-05,172.217.194.0-255,2902,4670,63,130987
22790,5.4e-05,172.31.40.0-255,66,4736,63,130987
22791,8.5e-05,172.217.194.0-255,7156,11892,63,130987
22792,9.2e-05,172.31.40.0-255,66,11958,63,130987
22793,9.6e-05,172.217.194.0-255,1484,13442,63,130987
22794,9.8e-05,172.31.40.0-255,66,13508,63,130987
22795,0.000111,172.31.40.0-255,66,13574,63,130987
22796,0.000138,172.217.194.0-255,2134,15708,63,130987
22797,0.000141,172.31.40.0-255,66,15774,63,130987
22798,0.000153,172.217.194.0-255,6797,22571,63,130987
22799,0.000155,172.31.40.0-255,66,22637,63,130987
22800,0.000176,172.217.194.0-255,1484,24121,63,130987
22801,0.000179,172.31.40.0-255,66,24187,63,130987
22802,0.000182,172.217.194.0-255,1484,25671,63,130987
22803,0.000188,172.31.40.0-255,66,25737,63,130987
22804,0.000213,172.217.194.0-255,1484,27221,63,130987
22805,0.000216,172.31.40.0-255,66,27287,63,130987
22806,0.000223,172.217.194.0-255,5738,33025,63,130987
22807,0.000225,172.31.40.0-255,66,33091,63,130987
22808,0.000236,172.217.194.0-255,5738,38829,63,130987
22809,0.000239,172.31.40.0-255,66,38895,63,130987
22810,0.000268,172.217.194.0-255,6797,45692,63,130987
22811,0.000271,172.31.40.0-255,66,45758,63,130987
22812,0.000303,172.31.40.0-255,66,45824,63,130987
22813,0.000306,172.217.194.0-255,429,46253,63,130987
22814,0.000308,172.31.40.0-255,66,46319,63,130987
22815,0.000536,172.217.194.0-255,1484,47803,63,130987
22816,0.000543,172.217.194.0-255,1484,49287,63,130987
22817,0.000547,172.31.40.0-255,66,49353,63,130987
22818,0.000577,172.217.194.0-255,1484,50837,63,130987
22819,0.000584,172.217.194.0-255,5738,56575,63,130987
22820,0.000587,172.31.40.0-255,66,56641,63,130987
22821,0.000592,172.217.194.0-255,5738,62379,63,130987
22822,0.000595,172.31.40.0-255,66,62445,63,130987
22823,0.000605,172.217.194.0-255,2902,65347,63,130987
22824,0.000607,172.31.40.0-255,66,65413,63,130987
22825,0.000646,172.31.40.0-255,66,65479,63,130987
22826,0.000652,172.217.194.0-255,5020,70499,63,130987
22827,0.000655,172.31.40.0-255,66,70565,63,130987
22828,0.001981,172.217.194.0-255,1484,72049,63,130987
22829,0.001989,172.217.194.0-255,2902,74951,63,130987
22830,0.001994,172.31.40.0-255,66,75017,63,130987
22831,0.002027,172.217.194.0-255,5738,80755,63,130987
22832,0.00203,172.31.40.0-255,66,80821,63,130987
22833,0.002041,172.31.40.0-255,66,80887,63,130987
22834,0.002064,172.217.194.0-255,4320,85207,63,130987
22835,0.002071,172.31.40.0-255,66,85273,63,130987
22836,0.002078,172.217.194.0-255,5738,91011,63,130987
22837,0.00208,172.31.40.0-255,66,91077,63,130987
22838,0.002115,172.217.194.0-255,5020,96097,63,130987
22839,0.002118,172.31.40.0-255,66,96163,63,130987
22840,0.004704,172.217.194.0-255,5738,101901,63,130987
22841,0.004712,172.31.40.0-255,66,101967,63,130987
22842,0.007279,172.217.194.0-255,5738,107705,63,130987
22843,0.007283,172.31.40.0-255,66,107771,63,130987
22844,0.009866,172.217.194.0-255,5738,113509,63,130987
22845,0.009875,172.31.40.0-255,66,113575,63,130987
22846,0.012453,172.217.194.0-255,5738,119313,63,130987
22847,0.012464,172.31.40.0-255,66,119379,63,130987
22848,0.015056,172.217.194.0-255,5738,125117,63,130987
22849,0.015066,172.31.40.0-255,66,125183,63,130987
22850,0.01765,172.217.194.0-255,5738,130921,63,130987
22851,0.017659,172.31.40.0-255,66,130987,63,130987
22852,0.0,172.217.160.0-255,152,152,63,90637
22853,2.4e-05,172.31.40.0-255,66,218,63,90637
22854,3.1e-05,172.217.160.0-255,1484,1702,63,90637
22855,3.6e-05,172.31.40.0-255,66,1768,63,90637
22856,5.1e-05,172.217.160.0-255,2902,4670,63,90637
22857,5.5e-05,172.31.40.0-255,66,4736,63,90637
22858,9e-05,172.217.160.0-255,7156,11892,63,90637
22859,9.4e-05,172.31.40.0-255,66,11958,63,90637
22860,0.000206,172.217.160.0-255,2048,14006,63,90637
22861,0.00021,172.31.40.0-255,66,14072,63,90637
22862,0.000306,172.217.160.0-255,1484,15556,63,90637
22863,0.00031,172.31.40.0-255,66,15622,63,90637
22864,0.000316,172.217.160.0-255,2902,18524,63,90637
22865,0.000319,172.31.40.0-255,66,18590,63,90637
22866,0.000371,172.217.160.0-255,5738,24328,63,90637
22867,0.000374,172.31.40.0-255,66,24394,63,90637
22868,0.000488,172.217.160.0-255,4320,28714,63,90637
22869,0.000493,172.31.40.0-255,66,28780,63,90637
22870,0.000567,172.217.160.0-255,2543,31323,63,90637
22871,0.000571,172.31.40.0-255,66,31389,63,90637
22872,0.000616,172.217.160.0-255,4320,35709,63,90637
22873,0.000619,172.31.40.0-255,66,35775,63,90637
22874,0.000638,172.217.160.0-255,4320,40095,63,90637
22875,0.000641,172.31.40.0-255,66,40161,63,90637
22876,0.000802,172.31.40.0-255,66,40227,63,90637
22877,0.000961,172.31.40.0-255,66,40293,63,90637
22878,0.001127,172.217.160.0-255,7156,47449,63,90637
22879,0.001131,172.31.40.0-255,66,47515,63,90637
22880,0.001155,172.217.160.0-255,1398,48913,63,90637
22881,0.001157,172.31.40.0-255,66,48979,63,90637
22882,0.00131,172.31.40.0-255,66,49045,63,90637
22883,0.001499,172.217.160.0-255,1125,50170,63,90637
22884,0.001519,172.31.40.0-255,66,50236,63,90637
22885,0.001859,172.217.160.0-255,5379,55615,63,90637
22886,0.001864,172.31.40.0-255,66,55681,63,90637
22887,0.007885,172.31.40.0-255,66,55747,63,90637
22888,0.008809,172.217.160.0-255,1484,57231,63,90637
22889,0.009499,172.217.160.0-255,4320,61551,63,90637
22890,0.009506,172.31.40.0-255,66,61617,63,90637
22891,0.011116,172.217.160.0-255,5738,67355,63,90637
22892,0.012539,172.31.40.0-255,66,67421,63,90637
22893,0.014166,172.217.160.0-255,5738,73159,63,90637
22894,0.014177,172.31.40.0-255,66,73225,63,90637
22895,0.015794,172.217.160.0-255,5738,78963,63,90637
22896,0.015806,172.31.40.0-255,66,79029,63,90637
22897,0.017434,172.217.160.0-255,5738,84767,63,90637
22898,0.017451,172.31.40.0-255,66,84833,63,90637
22899,0.019092,172.217.160.0-255,5738,90571,63,90637
22900,0.0191,172.31.40.0-255,66,90637,63,90637
22901,0.0,74.125.68.0-255,149,149,63,194432
22902,2.2e-05,172.31.40.0-255,66,215,63,194432
22903,2.9e-05,74.125.68.0-255,1484,1699,63,194432
22904,3.3e-05,172.31.40.0-255,66,1765,63,194432
22905,4.1e-05,74.125.68.0-255,2902,4667,63,194432
22906,4.5e-05,172.31.40.0-255,66,4733,63,194432
22907,4.8e-05,74.125.68.0-255,1484,6217,63,194432
22908,5.1e-05,172.31.40.0-255,66,6283,63,194432
22909,5.7e-05,74.125.68.0-255,2902,9185,63,194432
22910,6e-05,172.31.40.0-255,66,9251,63,194432
22911,0.000101,74.125.68.0-255,4847,14098,63,194432
22912,0.000104,172.31.40.0-255,66,14164,63,194432
22913,0.000196,74.125.68.0-255,1484,15648,63,194432
22914,0.000199,172.31.40.0-255,66,15714,63,194432
22915,0.000205,74.125.68.0-255,2902,18616,63,194432
22916,0.000207,172.31.40.0-255,66,18682,63,194432
22917,0.000226,74.125.68.0-255,4320,23002,63,194432
22918,0.000229,172.31.40.0-255,66,23068,63,194432
22919,0.000253,74.125.68.0-255,1484,24552,63,194432
22920,0.000255,172.31.40.0-255,66,24618,63,194432
22921,0.000263,74.125.68.0-255,6797,31415,63,194432
22922,0.000265,172.31.40.0-255,66,31481,63,194432
22923,0.000295,74.125.68.0-255,7156,38637,63,194432
22924,0.000297,172.31.40.0-255,66,38703,63,194432
22925,0.000303,74.125.68.0-255,4320,43023,63,194432
22926,0.000306,172.31.40.0-255,66,43089,63,194432
22927,0.000325,74.125.68.0-255,1484,44573,63,194432
22928,0.000327,172.31.40.0-255,66,44639,63,194432
22929,0.000345,74.125.68.0-255,3961,48600,63,194432
22930,0.000348,172.31.40.0-255,66,48666,63,194432
22931,0.000389,74.125.68.0-255,4320,52986,63,194432
22932,0.000392,172.31.40.0-255,66,53052,63,194432
22933,0.000395,74.125.68.0-255,1484,54536,63,194432
22934,0.000411,74.125.68.0-255,2902,57438,63,194432
22935,0.000414,172.31.40.0-255,66,57504,63,194432
22936,0.000421,74.125.68.0-255,5738,63242,63,194432
22937,0.000423,172.31.40.0-255,66,63308,63,194432
22938,0.00045,74.125.68.0-255,2543,65851,63,194432
22939,0.000452,172.31.40.0-255,66,65917,63,194432
22940,0.000476,74.125.68.0-255,679,66596,63,194432
22941,0.000561,74.125.68.0-255,1484,68080,63,194432
22942,0.000565,172.31.40.0-255,66,68146,63,194432
22943,0.000585,74.125.68.0-255,2902,71048,63,194432
22944,0.000588,172.31.40.0-255,66,71114,63,194432
22945,0.000594,74.125.68.0-255,4320,75434,63,194432
22946,0.000596,172.31.40.0-255,66,75500,63,194432
22947,0.000614,74.125.68.0-255,1484,76984,63,194432
22948,0.000622,74.125.68.0-255,6797,83781,63,194432
22949,0.000624,172.31.40.0-255,66,83847,63,194432
22950,0.000679,74.125.68.0-255,1484,85331,63,194432
22951,0.000692,74.125.68.0-255,2902,88233,63,194432
22952,0.000695,172.31.40.0-255,66,88299,63,194432
22953,0.000714,74.125.68.0-255,1484,89783,63,194432
22954,0.000729,74.125.68.0-255,2902,92685,63,194432
22955,0.000732,172.31.40.0-255,66,92751,63,194432
22956,0.000748,74.125.68.0-255,5738,98489,63,194432
22957,0.00075,172.31.40.0-255,66,98555,63,194432
22958,0.00077,74.125.68.0-255,2543,101098,63,194432
22959,0.000772,172.31.40.0-255,66,101164,63,194432
22960,0.001411,74.125.68.0-255,1484,102648,63,194432
22961,0.001428,74.125.68.0-255,2902,105550,63,194432
22962,0.001432,172.31.40.0-255,66,105616,63,194432
22963,0.001437,74.125.68.0-255,2902,108518,63,194432
22964,0.00144,172.31.40.0-255,66,108584,63,194432
22965,0.001463,74.125.68.0-255,2902,111486,63,194432
22966,0.001466,172.31.40.0-255,66,111552,63,194432
22967,0.001474,74.125.68.0-255,7156,118708,63,194432
22968,0.001476,172.31.40.0-255,66,118774,63,194432
22969,0.001507,172.31.40.0-255,66,118840,63,194432
22970,0.001512,74.125.68.0-255,4320,123160,63,194432
22971,0.001514,172.31.40.0-255,66,123226,63,194432
22972,0.001527,74.125.68.0-255,2902,126128,63,194432
22973,0.00153,172.31.40.0-255,66,126194,63,194432
22974,0.001546,74.125.68.0-255,766,126960,63,194432
22975,0.001855,172.31.40.0-255,66,127026,63,194432
22976,0.002074,74.125.68.0-255,1484,128510,63,194432
22977,0.002084,74.125.68.0-255,2902,131412,63,194432
22978,0.002089,172.31.40.0-255,66,131478,63,194432
22979,0.002096,74.125.68.0-255,2902,134380,63,194432
22980,0.002098,172.31.40.0-255,66,134446,63,194432
22981,0.002113,74.125.68.0-255,2902,137348,63,194432
22982,0.002115,172.31.40.0-255,66,137414,63,194432
22983,0.002122,74.125.68.0-255,4320,141734,63,194432
22984,0.002123,172.31.40.0-255,66,141800,63,194432
22985,0.002139,74.125.68.0-255,2902,144702,63,194432
22986,0.002141,172.31.40.0-255,66,144768,63,194432
22987,0.002152,172.31.40.0-255,66,144834,63,194432
22988,0.002189,172.31.40.0-255,66,144900,63,194432
22989,0.002266,74.125.68.0-255,1484,146384,63,194432
22990,0.002287,74.125.68.0-255,2902,149286,63,194432
22991,0.002291,172.31.40.0-255,66,149352,63,194432
22992,0.002316,74.125.68.0-255,4320,153672,63,194432
22993,0.002319,172.31.40.0-255,66,153738,63,194432
22994,0.004574,74.125.68.0-255,1484,155222,63,194432
22995,0.0046,74.125.68.0-255,4320,159542,63,194432
22996,0.004604,172.31.40.0-255,66,159608,63,194432
22997,0.006888,74.125.68.0-255,5738,165346,63,194432
22998,0.006894,172.31.40.0-255,66,165412,63,194432
22999,0.009182,74.125.68.0-255,5738,171150,63,194432
23000,0.00919,172.31.40.0-255,66,171216,63,194432
23001,0.011484,74.125.68.0-255,5738,176954,63,194432
23002,0.011493,172.31.40.0-255,66,177020,63,194432
23003,0.013818,74.125.68.0-255,5738,182758,63,194432
23004,0.013826,172.31.40.0-255,66,182824,63,194432
23005,0.016108,74.125.68.0-255,5738,188562,63,194432
23006,0.016116,172.31.40.0-255,66,188628,63,194432
23007,0.018402,74.125.68.0-255,5738,194366,63,194432
23008,0.018411,172.31.40.0-255,66,194432,63,194432
23009,0.0,172.217.194.0-255,153,153,63,240206
23010,2.5e-05,172.31.40.0-255,66,219,63,240206
23011,3.3e-05,172.217.194.0-255,1484,1703,63,240206
23012,3.7e-05,172.31.40.0-255,66,1769,63,240206
23013,4.3e-05,172.217.194.0-255,2902,4671,63,240206
23014,4.5e-05,172.31.40.0-255,66,4737,63,240206
23015,7e-05,172.217.194.0-255,7156,11893,63,240206
23016,7.3e-05,172.31.40.0-255,66,11959,63,240206
23017,9.7e-05,172.217.194.0-255,2148,14107,63,240206
23018,9.9e-05,172.31.40.0-255,66,14173,63,240206
23019,0.000132,172.217.194.0-255,2902,17075,63,240206
23020,0.000135,172.31.40.0-255,66,17141,63,240206
23021,0.000138,172.217.194.0-255,1484,18625,63,240206
23022,0.00014,172.31.40.0-255,66,18691,63,240206
23023,0.000161,172.217.194.0-255,5738,24429,63,240206
23024,0.000163,172.31.40.0-255,66,24495,63,240206
23025,0.000202,172.217.194.0-255,6797,31292,63,240206
23026,0.000204,172.31.40.0-255,66,31358,63,240206
23027,0.000503,172.217.194.0-255,1484,32842,63,240206
23028,0.000506,172.31.40.0-255,66,32908,63,240206
23029,0.000511,172.217.194.0-255,2902,35810,63,240206
23030,0.000513,172.31.40.0-255,66,35876,63,240206
23031,0.000517,172.217.194.0-255,1484,37360,63,240206
23032,0.000519,172.31.40.0-255,66,37426,63,240206
23033,0.000543,172.217.194.0-255,4320,41746,63,240206
23034,0.000547,172.31.40.0-255,66,41812,63,240206
23035,0.000557,172.31.40.0-255,66,41878,63,240206
23036,0.000564,172.217.194.0-255,5738,47616,63,240206
23037,0.000566,172.31.40.0-255,66,47682,63,240206
23038,0.000595,172.217.194.0-255,2902,50584,63,240206
23039,0.000598,172.31.40.0-255,66,50650,63,240206
23040,0.000605,172.217.194.0-255,6797,57447,63,240206
23041,0.000608,172.31.40.0-255,66,57513,63,240206
23042,0.000821,172.217.194.0-255,647,58160,63,240206
23043,0.000957,172.217.194.0-255,1484,59644,63,240206
23044,0.000959,172.31.40.0-255,66,59710,63,240206
23045,0.000964,172.217.194.0-255,2902,62612,63,240206
23046,0.000966,172.31.40.0-255,66,62678,63,240206
23047,0.000981,172.217.194.0-255,4320,66998,63,240206
23048,0.000984,172.31.40.0-255,66,67064,63,240206
23049,0.001006,172.217.194.0-255,1484,68548,63,240206
23050,0.001012,172.217.194.0-255,4320,72868,63,240206
23051,0.001014,172.31.40.0-255,66,72934,63,240206
23052,0.001041,172.31.40.0-255,66,73000,63,240206
23053,0.001044,172.217.194.0-255,1484,74484,63,240206
23054,0.001093,172.217.194.0-255,7156,81640,63,240206
23055,0.001095,172.31.40.0-255,66,81706,63,240206
23056,0.001111,172.217.194.0-255,2184,83890,63,240206
23057,0.001113,172.31.40.0-255,66,83956,63,240206
23058,0.001136,172.217.194.0-255,1484,85440,63,240206
23059,0.001153,172.217.194.0-255,2902,88342,63,240206
23060,0.001156,172.31.40.0-255,66,88408,63,240206
23061,0.001162,172.217.194.0-255,5738,94146,63,240206
23062,0.001164,172.31.40.0-255,66,94212,63,240206
23063,0.001169,172.217.194.0-255,2902,97114,63,240206
23064,0.001171,172.31.40.0-255,66,97180,63,240206
23065,0.001209,172.31.40.0-255,66,97246,63,240206
23066,0.001221,172.31.40.0-255,66,97312,63,240206
23067,0.001235,172.217.194.0-255,2184,99496,63,240206
23068,0.001237,172.31.40.0-255,66,99562,63,240206
23069,0.001648,172.217.194.0-255,1484,101046,63,240206
23070,0.001654,172.217.194.0-255,2902,103948,63,240206
23071,0.001657,172.31.40.0-255,66,104014,63,240206
23072,0.00168,172.217.194.0-255,4320,108334,63,240206
23073,0.001683,172.31.40.0-255,66,108400,63,240206
23074,0.001686,172.217.194.0-255,1484,109884,63,240206
23075,0.001709,172.217.194.0-255,7156,117040,63,240206
23076,0.001712,172.31.40.0-255,66,117106,63,240206
23077,0.00172,172.217.194.0-255,7156,124262,63,240206
23078,0.001722,172.31.40.0-255,66,124328,63,240206
23079,0.001725,172.217.194.0-255,1484,125812,63,240206
23080,0.001744,172.217.194.0-255,7156,132968,63,240206
23081,0.001746,172.31.40.0-255,66,133034,63,240206
23082,0.001749,172.217.194.0-255,766,133800,63,240206
23083,0.001775,172.217.194.0-255,1484,135284,63,240206
23084,0.001777,172.31.40.0-255,66,135350,63,240206
23085,0.001795,172.217.194.0-255,4320,139670,63,240206
23086,0.001798,172.31.40.0-255,66,139736,63,240206
23087,0.001862,172.31.40.0-255,66,139802,63,240206
23088,0.001875,172.31.40.0-255,66,139868,63,240206
23089,0.001887,172.31.40.0-255,66,139934,63,240206
23090,0.002259,172.217.194.0-255,1484,141418,63,240206
23091,0.002265,172.217.194.0-255,1484,142902,63,240206
23092,0.002268,172.31.40.0-255,66,142968,63,240206
23093,0.002292,172.217.194.0-255,1484,144452,63,240206
23094,0.002298,172.217.194.0-255,5738,150190,63,240206
23095,0.002301,172.31.40.0-255,66,150256,63,240206
23096,0.002306,172.217.194.0-255,4320,154576,63,240206
23097,0.002308,172.31.40.0-255,66,154642,63,240206
23098,0.002327,172.217.194.0-255,5738,160380,63,240206
23099,0.00233,172.31.40.0-255,66,160446,63,240206
23100,0.002361,172.217.194.0-255,4320,164766,63,240206
23101,0.002364,172.31.40.0-255,66,164832,63,240206
23102,0.00239,172.31.40.0-255,66,164898,63,240206
23103,0.002787,172.217.194.0-255,1484,166382,63,240206
23104,0.002801,172.217.194.0-255,2902,169284,63,240206
23105,0.002803,172.31.40.0-255,66,169350,63,240206
23106,0.002826,172.217.194.0-255,2902,172252,63,240206
23107,0.002829,172.31.40.0-255,66,172318,63,240206
23108,0.002834,172.217.194.0-255,4320,176638,63,240206
23109,0.002837,172.31.40.0-255,66,176704,63,240206
23110,0.002852,172.31.40.0-255,66,176770,63,240206
23111,0.002878,172.31.40.0-255,66,176836,63,240206
23112,0.002907,172.217.194.0-255,5020,181856,63,240206
23113,0.002909,172.31.40.0-255,66,181922,63,240206
23114,0.002924,172.31.40.0-255,66,181988,63,240206
23115,0.002934,172.31.40.0-255,66,182054,63,240206
23116,0.002996,172.31.40.0-255,66,182120,63,240206
23117,0.003014,172.217.194.0-255,1484,183604,63,240206
23118,0.003032,172.217.194.0-255,2902,186506,63,240206
23119,0.003035,172.31.40.0-255,66,186572,63,240206
23120,0.003041,172.217.194.0-255,4320,190892,63,240206
23121,0.003043,172.31.40.0-255,66,190958,63,240206
23122,0.003075,172.31.40.0-255,66,191024,63,240206
23123,0.003081,172.217.194.0-255,5738,196762,63,240206
23124,0.003084,172.31.40.0-255,66,196828,63,240206
23125,0.003101,172.217.194.0-255,4320,201148,63,240206
23126,0.003103,172.31.40.0-255,66,201214,63,240206
23127,0.003107,172.217.194.0-255,2902,204116,63,240206
23128,0.00311,172.31.40.0-255,66,204182,63,240206
23129,0.003128,172.217.194.0-255,2184,206366,63,240206
23130,0.00313,172.31.40.0-255,66,206432,63,240206
23131,0.003133,172.217.194.0-255,1484,207916,63,240206
23132,0.003156,172.217.194.0-255,2902,210818,63,240206
23133,0.003158,172.31.40.0-255,66,210884,63,240206
23134,0.003164,172.217.194.0-255,5738,216622,63,240206
23135,0.003166,172.31.40.0-255,66,216688,63,240206
23136,0.00317,172.217.194.0-255,2902,219590,63,240206
23137,0.003173,172.31.40.0-255,66,219656,63,240206
23138,0.003222,172.31.40.0-255,66,219722,63,240206
23139,0.003235,172.31.40.0-255,66,219788,63,240206
23140,0.003238,172.217.194.0-255,1484,221272,63,240206
23141,0.003253,172.31.40.0-255,66,221338,63,240206
23142,0.003258,172.217.194.0-255,4320,225658,63,240206
23143,0.00326,172.31.40.0-255,66,225724,63,240206
23144,0.003266,172.217.194.0-255,4320,230044,63,240206
23145,0.003268,172.31.40.0-255,66,230110,63,240206
23146,0.003274,172.217.194.0-255,4320,234430,63,240206
23147,0.003278,172.31.40.0-255,66,234496,63,240206
23148,0.003305,172.217.194.0-255,5302,239798,63,240206
23149,0.003307,172.31.40.0-255,66,239864,63,240206
23150,0.00331,172.217.194.0-255,105,239969,63,240206
23151,0.007536,172.31.40.0-255,66,240035,63,240206
23152,0.007582,172.31.40.0-255,105,240140,63,240206
23153,0.009576,172.217.194.0-255,66,240206,63,240206
23154,0.0,74.125.130.0-255,160,160,63,228446
23155,2.1e-05,172.31.40.0-255,66,226,63,228446
23156,2.8e-05,74.125.130.0-255,1484,1710,63,228446
23157,3.3e-05,172.31.40.0-255,66,1776,63,228446
23158,3.9e-05,74.125.130.0-255,2902,4678,63,228446
23159,5e-05,172.31.40.0-255,66,4744,63,228446
23160,5.7e-05,74.125.130.0-255,7156,11900,63,228446
23161,6.1e-05,172.31.40.0-255,66,11966,63,228446
23162,9.2e-05,74.125.130.0-255,2074,14040,63,228446
23163,9.5e-05,172.31.40.0-255,66,14106,63,228446
23164,0.000222,74.125.130.0-255,1484,15590,63,228446
23165,0.000226,172.31.40.0-255,66,15656,63,228446
23166,0.000231,74.125.130.0-255,2902,18558,63,228446
23167,0.000234,172.31.40.0-255,66,18624,63,228446
23168,0.000256,74.125.130.0-255,5738,24362,63,228446
23169,0.000259,172.31.40.0-255,66,24428,63,228446
23170,0.000262,74.125.130.0-255,1484,25912,63,228446
23171,0.000264,172.31.40.0-255,66,25978,63,228446
23172,0.000299,74.125.130.0-255,5379,31357,63,228446
23173,0.000302,172.31.40.0-255,66,31423,63,228446
23174,0.000598,74.125.130.0-255,1484,32907,63,228446
23175,0.000603,172.31.40.0-255,66,32973,63,228446
23176,0.000628,74.125.130.0-255,1484,34457,63,228446
23177,0.00063,172.31.40.0-255,66,34523,63,228446
23178,0.00065,74.125.130.0-255,1484,36007,63,228446
23179,0.000658,172.31.40.0-255,66,36073,63,228446
23180,0.000664,74.125.130.0-255,5738,41811,63,228446
23181,0.000666,172.31.40.0-255,66,41877,63,228446
23182,0.000672,74.125.130.0-255,6797,48674,63,228446
23183,0.000674,172.31.40.0-255,66,48740,63,228446
23184,0.000736,74.125.130.0-255,1484,50224,63,228446
23185,0.000739,172.31.40.0-255,66,50290,63,228446
23186,0.000743,74.125.130.0-255,2902,53192,63,228446
23187,0.000745,172.31.40.0-255,66,53258,63,228446
23188,0.000773,74.125.130.0-255,5738,58996,63,228446
23189,0.000775,172.31.40.0-255,66,59062,63,228446
23190,0.000812,74.125.130.0-255,6797,65859,63,228446
23191,0.000814,172.31.40.0-255,66,65925,63,228446
23192,0.000841,74.125.130.0-255,1484,67409,63,228446
23193,0.000852,74.125.130.0-255,1484,68893,63,228446
23194,0.000854,172.31.40.0-255,66,68959,63,228446
23195,0.000878,74.125.130.0-255,1484,70443,63,228446
23196,0.000884,74.125.130.0-255,5738,76181,63,228446
23197,0.000886,172.31.40.0-255,66,76247,63,228446
23198,0.000892,74.125.130.0-255,6797,83044,63,228446
23199,0.000895,172.31.40.0-255,66,83110,63,228446
23200,0.000931,74.125.130.0-255,1484,84594,63,228446
23201,0.000948,74.125.130.0-255,4320,88914,63,228446
23202,0.000951,172.31.40.0-255,66,88980,63,228446
23203,0.000956,74.125.130.0-255,4320,93300,63,228446
23204,0.000958,172.31.40.0-255,66,93366,63,228446
23205,0.000977,74.125.130.0-255,2902,96268,63,228446
23206,0.000979,172.31.40.0-255,66,96334,63,228446
23207,0.001013,74.125.130.0-255,4540,100874,63,228446
23208,0.001015,172.31.40.0-255,66,100940,63,228446
23209,0.001201,74.125.130.0-255,1484,102424,63,228446
23210,0.001207,74.125.130.0-255,2902,105326,63,228446
23211,0.00121,172.31.40.0-255,66,105392,63,228446
23212,0.001215,74.125.130.0-255,4320,109712,63,228446
23213,0.001216,172.31.40.0-255,66,109778,63,228446
23214,0.001243,74.125.130.0-255,1484,111262,63,228446
23215,0.001248,74.125.130.0-255,4320,115582,63,228446
23216,0.00125,172.31.40.0-255,66,115648,63,228446
23217,0.001271,74.125.130.0-255,5738,121386,63,228446
23218,0.001273,172.31.40.0-255,66,121452,63,228446
23219,0.00131,74.125.130.0-255,2902,124354,63,228446
23220,0.001312,172.31.40.0-255,66,124420,63,228446
23221,0.001323,172.31.40.0-255,66,124486,63,228446
23222,0.001347,74.125.130.0-255,766,125252,63,228446
23223,0.001578,74.125.130.0-255,1484,126736,63,228446
23224,0.001583,172.31.40.0-255,66,126802,63,228446
23225,0.001588,74.125.130.0-255,2902,129704,63,228446
23226,0.00159,172.31.40.0-255,66,129770,63,228446
23227,0.001595,74.125.130.0-255,4320,134090,63,228446
23228,0.001597,172.31.40.0-255,66,134156,63,228446
23229,0.00161,74.125.130.0-255,1484,135640,63,228446
23230,0.001633,74.125.130.0-255,5738,141378,63,228446
23231,0.001636,172.31.40.0-255,66,141444,63,228446
23232,0.001671,74.125.130.0-255,7156,148600,63,228446
23233,0.001674,172.31.40.0-255,66,148666,63,228446
23234,0.001708,172.31.40.0-255,66,148732,63,228446
23235,0.001829,74.125.130.0-255,1484,150216,63,228446
23236,0.00185,74.125.130.0-255,2902,153118,63,228446
23237,0.001854,172.31.40.0-255,66,153184,63,228446
23238,0.00186,74.125.130.0-255,4320,157504,63,228446
23239,0.001863,172.31.40.0-255,66,157570,63,228446
23240,0.001895,74.125.130.0-255,1484,159054,63,228446
23241,0.0019,74.125.130.0-255,4320,163374,63,228446
23242,0.001903,172.31.40.0-255,66,163440,63,228446
23243,0.001911,74.125.130.0-255,5738,169178,63,228446
23244,0.001913,172.31.40.0-255,66,169244,63,228446
23245,0.001935,74.125.130.0-255,4320,173564,63,228446
23246,0.001937,172.31.40.0-255,66,173630,63,228446
23247,0.00197,74.125.130.0-255,7156,180786,63,228446
23248,0.001974,172.31.40.0-255,66,180852,63,228446
23249,0.001986,74.125.130.0-255,2184,183036,63,228446
23250,0.001992,172.31.40.0-255,66,183102,63,228446
23251,0.004056,74.125.130.0-255,2902,186004,63,228446
23252,0.004063,172.31.40.0-255,66,186070,63,228446
23253,0.004088,74.125.130.0-255,2902,188972,63,228446
23254,0.004091,172.31.40.0-255,66,189038,63,228446
23255,0.006156,74.125.130.0-255,2902,191940,63,228446
23256,0.006163,172.31.40.0-255,66,192006,63,228446
23257,0.006183,74.125.130.0-255,2902,194908,63,228446
23258,0.006186,172.31.40.0-255,66,194974,63,228446
23259,0.008289,74.125.130.0-255,5738,200712,63,228446
23260,0.008294,172.31.40.0-255,66,200778,63,228446
23261,0.0104,74.125.130.0-255,4320,205098,63,228446
23262,0.010406,172.31.40.0-255,66,205164,63,228446
23263,0.010432,74.125.130.0-255,1484,206648,63,228446
23264,0.012503,74.125.130.0-255,4320,210968,63,228446
23265,0.012511,172.31.40.0-255,66,211034,63,228446
23266,0.014611,74.125.130.0-255,5738,216772,63,228446
23267,0.01462,172.31.40.0-255,66,216838,63,228446
23268,0.016718,74.125.130.0-255,5738,222576,63,228446
23269,0.016727,172.31.40.0-255,66,222642,63,228446
23270,0.018823,74.125.130.0-255,5738,228380,63,228446
23271,0.018832,172.31.40.0-255,66,228446,63,228446
23272,0.0,172.217.194.0-255,153,153,63,156025
23273,1.9e-05,172.31.40.0-255,66,219,63,156025
23274,2.6e-05,172.217.194.0-255,1484,1703,63,156025
23275,3e-05,172.31.40.0-255,66,1769,63,156025
23276,3.6e-05,172.217.194.0-255,2902,4671,63,156025
23277,3.8e-05,172.31.40.0-255,66,4737,63,156025
23278,4.6e-05,172.217.194.0-255,7156,11893,63,156025
23279,4.9e-05,172.31.40.0-255,66,11959,63,156025
23280,8.3e-05,172.217.194.0-255,2067,14026,63,156025
23281,8.6e-05,172.31.40.0-255,66,14092,63,156025
23282,0.000186,172.217.194.0-255,1484,15576,63,156025
23283,0.000189,172.31.40.0-255,66,15642,63,156025
23284,0.00021,172.217.194.0-255,2902,18544,63,156025
23285,0.000213,172.31.40.0-255,66,18610,63,156025
23286,0.000241,172.217.194.0-255,5738,24348,63,156025
23287,0.000243,172.31.40.0-255,66,24414,63,156025
23288,0.000267,172.217.194.0-255,6797,31211,63,156025
23289,0.000269,172.31.40.0-255,66,31277,63,156025
23290,0.000366,172.217.194.0-255,1484,32761,63,156025
23291,0.000369,172.31.40.0-255,66,32827,63,156025
23292,0.000387,172.217.194.0-255,1484,34311,63,156025
23293,0.000389,172.31.40.0-255,66,34377,63,156025
23294,0.000411,172.217.194.0-255,1484,35861,63,156025
23295,0.000413,172.31.40.0-255,66,35927,63,156025
23296,0.00042,172.217.194.0-255,5738,41665,63,156025
23297,0.000422,172.31.40.0-255,66,41731,63,156025
23298,0.000472,172.217.194.0-255,7156,48887,63,156025
23299,0.000475,172.31.40.0-255,66,48953,63,156025
23300,0.0005,172.217.194.0-255,6797,55750,63,156025
23301,0.000502,172.31.40.0-255,66,55816,63,156025
23302,0.000588,172.217.194.0-255,4320,60136,63,156025
23303,0.000592,172.31.40.0-255,66,60202,63,156025
23304,0.000612,172.217.194.0-255,5629,65831,63,156025
23305,0.000616,172.217.194.0-255,118,65949,63,156025
23306,0.000636,172.31.40.0-255,66,66015,63,156025
23307,0.000663,172.217.194.0-255,1484,67499,63,156025
23308,0.000667,172.217.194.0-255,1484,68983,63,156025
23309,0.000671,172.31.40.0-255,66,69049,63,156025
23310,0.000683,172.217.194.0-255,1484,70533,63,156025
23311,0.000688,172.217.194.0-255,2902,73435,63,156025
23312,0.000721,172.217.194.0-255,4320,77755,63,156025
23313,0.000753,172.217.194.0-255,5738,83493,63,156025
23314,0.000768,172.217.194.0-255,2543,86036,63,156025
23315,0.000915,172.217.194.0-255,5379,91415,63,156025
23316,0.001015,172.31.40.0-255,66,91481,63,156025
23317,0.001915,172.217.194.0-255,1484,92965,63,156025
23318,0.001925,172.217.194.0-255,2902,95867,63,156025
23319,0.00193,172.31.40.0-255,66,95933,63,156025
23320,0.001935,172.217.194.0-255,1484,97417,63,156025
23321,0.001953,172.217.194.0-255,4320,101737,63,156025
23322,0.00198,172.217.194.0-255,2902,104639,63,156025
23323,0.002002,172.217.194.0-255,7156,111795,63,156025
23324,0.0021,172.217.194.0-255,1484,113279,63,156025
23325,0.002182,172.217.194.0-255,2184,115463,63,156025
23326,0.002199,172.217.194.0-255,2902,118365,63,156025
23327,0.002232,172.217.194.0-255,7156,125521,63,156025
23328,0.002294,172.217.194.0-255,4320,129841,63,156025
23329,0.002517,172.217.194.0-255,2902,132743,63,156025
23330,0.007544,172.31.40.0-255,66,132809,63,156025
23331,0.009821,172.217.194.0-255,5738,138547,63,156025
23332,0.009829,172.31.40.0-255,66,138613,63,156025
23333,0.012118,172.217.194.0-255,5738,144351,63,156025
23334,0.013418,172.31.40.0-255,66,144417,63,156025
23335,0.015698,172.217.194.0-255,5738,150155,63,156025
23336,0.015709,172.31.40.0-255,66,150221,63,156025
23337,0.018024,172.217.194.0-255,5738,155959,63,156025
23338,0.018032,172.31.40.0-255,66,156025,63,156025
23339,0.0,172.217.194.0-255,152,152,63,129569
23340,2.5e-05,172.31.40.0-255,66,218,63,129569
23341,3.3e-05,172.217.194.0-255,1484,1702,63,129569
23342,3.8e-05,172.31.40.0-255,66,1768,63,129569
23343,4.4e-05,172.217.194.0-255,2902,4670,63,129569
23344,4.7e-05,172.31.40.0-255,66,4736,63,129569
23345,5.6e-05,172.217.194.0-255,7156,11892,63,129569
23346,5.8e-05,172.31.40.0-255,66,11958,63,129569
23347,6.3e-05,172.217.194.0-255,2151,14109,63,129569
23348,6.6e-05,172.31.40.0-255,66,14175,63,129569
23349,0.000131,172.217.194.0-255,1484,15659,63,129569
23350,0.000134,172.31.40.0-255,66,15725,63,129569
23351,0.000138,172.217.194.0-255,1484,17209,63,129569
23352,0.000141,172.31.40.0-255,66,17275,63,129569
23353,0.000153,172.217.194.0-255,1484,18759,63,129569
23354,0.000155,172.31.40.0-255,66,18825,63,129569
23355,0.00016,172.217.194.0-255,2902,21727,63,129569
23356,0.000162,172.31.40.0-255,66,21793,63,129569
23357,0.000175,172.217.194.0-255,2902,24695,63,129569
23358,0.000177,172.31.40.0-255,66,24761,63,129569
23359,0.00021,172.217.194.0-255,6797,31558,63,129569
23360,0.000214,172.31.40.0-255,66,31624,63,129569
23361,0.000259,172.217.194.0-255,4320,35944,63,129569
23362,0.000262,172.31.40.0-255,66,36010,63,129569
23363,0.00028,172.217.194.0-255,2902,38912,63,129569
23364,0.000283,172.31.40.0-255,66,38978,63,129569
23365,0.000285,172.217.194.0-255,1484,40462,63,129569
23366,0.000287,172.31.40.0-255,66,40528,63,129569
23367,0.00033,172.31.40.0-255,66,40594,63,129569
23368,0.000375,172.31.40.0-255,66,40660,63,129569
23369,0.00045,172.217.194.0-255,1484,42144,63,129569
23370,0.000471,172.217.194.0-255,7096,49240,63,129569
23371,0.000474,172.217.194.0-255,377,49617,63,129569
23372,0.000585,172.31.40.0-255,66,49683,63,129569
23373,0.00075,172.217.194.0-255,1484,51167,63,129569
23374,0.000757,172.217.194.0-255,2902,54069,63,129569
23375,0.000774,172.217.194.0-255,5738,59807,63,129569
23376,0.000789,172.31.40.0-255,66,59873,63,129569
23377,0.000797,172.217.194.0-255,5738,65611,63,129569
23378,0.00081,172.217.194.0-255,4320,69931,63,129569
23379,0.000813,172.31.40.0-255,66,69997,63,129569
23380,0.000833,172.217.194.0-255,2902,72899,63,129569
23381,0.00084,172.217.194.0-255,5738,78637,63,129569
23382,0.000856,172.217.194.0-255,5020,83657,63,129569
23383,0.000863,172.31.40.0-255,66,83723,63,129569
23384,0.001615,172.217.194.0-255,1484,85207,63,129569
23385,0.001624,172.217.194.0-255,2902,88109,63,129569
23386,0.001628,172.31.40.0-255,66,88175,63,129569
23387,0.001634,172.217.194.0-255,2902,91077,63,129569
23388,0.001648,172.217.194.0-255,1484,92561,63,129569
23389,0.001651,172.217.194.0-255,1484,94045,63,129569
23390,0.001665,172.217.194.0-255,7156,101201,63,129569
23391,0.001692,172.217.194.0-255,2902,104103,63,129569
23392,0.001731,172.217.194.0-255,2184,106287,63,129569
23393,0.00576,172.31.40.0-255,66,106353,63,129569
23394,0.008231,172.217.194.0-255,5738,112091,63,129569
23395,0.008241,172.31.40.0-255,66,112157,63,129569
23396,0.010795,172.217.194.0-255,5738,117895,63,129569
23397,0.010803,172.31.40.0-255,66,117961,63,129569
23398,0.013273,172.217.194.0-255,5738,123699,63,129569
23399,0.013282,172.31.40.0-255,66,123765,63,129569
23400,0.015793,172.217.194.0-255,5738,129503,63,129569
23401,0.018395,172.31.40.0-255,66,129569,63,129569
23402,0.0,172.217.194.0-255,150,150,63,192160
23403,2.3e-05,172.31.40.0-255,66,216,63,192160
23404,2.9e-05,172.217.194.0-255,1484,1700,63,192160
23405,3.3e-05,172.31.40.0-255,66,1766,63,192160
23406,3.9e-05,172.217.194.0-255,2902,4668,63,192160
23407,4.2e-05,172.31.40.0-255,66,4734,63,192160
23408,4.9e-05,172.217.194.0-255,5738,10472,63,192160
23409,5.2e-05,172.31.40.0-255,66,10538,63,192160
23410,9.5e-05,172.217.194.0-255,3516,14054,63,192160
23411,9.7e-05,172.31.40.0-255,66,14120,63,192160
23412,0.000175,172.217.194.0-255,1484,15604,63,192160
23413,0.000179,172.31.40.0-255,66,15670,63,192160
23414,0.000183,172.217.194.0-255,2902,18572,63,192160
23415,0.000186,172.31.40.0-255,66,18638,63,192160
23416,0.0002,172.217.194.0-255,2902,21540,63,192160
23417,0.000203,172.31.40.0-255,66,21606,63,192160
23418,0.000223,172.217.194.0-255,2902,24508,63,192160
23419,0.000225,172.31.40.0-255,66,24574,63,192160
23420,0.000243,172.217.194.0-255,1484,26058,63,192160
23421,0.000245,172.31.40.0-255,66,26124,63,192160
23422,0.000279,172.31.40.0-255,66,26190,63,192160
23423,0.00029,172.31.40.0-255,66,26256,63,192160
23424,0.000293,172.217.194.0-255,1484,27740,63,192160
23425,0.000295,172.31.40.0-255,66,27806,63,192160
23426,0.000331,172.31.40.0-255,66,27872,63,192160
23427,0.000348,172.217.194.0-255,5020,32892,63,192160
23428,0.00035,172.31.40.0-255,66,32958,63,192160
23429,0.000353,172.217.194.0-255,677,33635,63,192160
23430,0.000355,172.31.40.0-255,66,33701,63,192160
23431,0.000377,172.217.194.0-255,1484,35185,63,192160
23432,0.000406,172.217.194.0-255,4320,39505,63,192160
23433,0.000409,172.31.40.0-255,66,39571,63,192160
23434,0.000433,172.217.194.0-255,7156,46727,63,192160
23435,0.000435,172.31.40.0-255,66,46793,63,192160
23436,0.000439,172.217.194.0-255,1484,48277,63,192160
23437,0.000455,172.217.194.0-255,2902,51179,63,192160
23438,0.000458,172.31.40.0-255,66,51245,63,192160
23439,0.000511,172.31.40.0-255,66,51311,63,192160
23440,0.000531,172.217.194.0-255,2902,54213,63,192160
23441,0.000533,172.31.40.0-255,66,54279,63,192160
23442,0.000539,172.217.194.0-255,5020,59299,63,192160
23443,0.000559,172.217.194.0-255,1484,60783,63,192160
23444,0.000563,172.217.194.0-255,2902,63685,63,192160
23445,0.000567,172.217.194.0-255,2902,66587,63,192160
23446,0.000584,172.217.194.0-255,2902,69489,63,192160
23447,0.000648,172.217.194.0-255,4320,73809,63,192160
23448,0.000668,172.217.194.0-255,7156,80965,63,192160
23449,0.000672,172.217.194.0-255,1484,82449,63,192160
23450,0.000707,172.217.194.0-255,2902,85351,63,192160
23451,0.000731,172.217.194.0-255,4320,89671,63,192160
23452,0.000738,172.31.40.0-255,66,89737,63,192160
23453,0.000758,172.217.194.0-255,5020,94757,63,192160
23454,0.000785,172.31.40.0-255,66,94823,63,192160
23455,0.001533,172.217.194.0-255,1484,96307,63,192160
23456,0.001563,172.217.194.0-255,2902,99209,63,192160
23457,0.001567,172.31.40.0-255,66,99275,63,192160
23458,0.001586,172.217.194.0-255,2902,102177,63,192160
23459,0.001589,172.31.40.0-255,66,102243,63,192160
23460,0.001611,172.217.194.0-255,2902,105145,63,192160
23461,0.001615,172.31.40.0-255,66,105211,63,192160
23462,0.001618,172.217.194.0-255,1484,106695,63,192160
23463,0.001622,172.217.194.0-255,2902,109597,63,192160
23464,0.001624,172.31.40.0-255,66,109663,63,192160
23465,0.001648,172.217.194.0-255,5738,115401,63,192160
23466,0.00165,172.31.40.0-255,66,115467,63,192160
23467,0.001672,172.217.194.0-255,4320,119787,63,192160
23468,0.00168,172.217.194.0-255,7156,126943,63,192160
23469,0.001687,172.31.40.0-255,66,127009,63,192160
23470,0.001695,172.217.194.0-255,2184,129193,63,192160
23471,0.0017,172.31.40.0-255,66,129259,63,192160
23472,0.001749,172.217.194.0-255,1484,130743,63,192160
23473,0.001754,172.217.194.0-255,2902,133645,63,192160
23474,0.001765,172.31.40.0-255,66,133711,63,192160
23475,0.001782,172.217.194.0-255,5738,139449,63,192160
23476,0.001804,172.31.40.0-255,66,139515,63,192160
23477,0.001843,172.217.194.0-255,2902,142417,63,192160
23478,0.00185,172.31.40.0-255,66,142483,63,192160
23479,0.001886,172.217.194.0-255,4320,146803,63,192160
23480,0.001894,172.31.40.0-255,66,146869,63,192160
23481,0.00192,172.31.40.0-255,66,146935,63,192160
23482,0.001933,172.217.194.0-255,6438,153373,63,192160
23483,0.001986,172.217.194.0-255,2902,156275,63,192160
23484,0.00203,172.217.194.0-255,7156,163431,63,192160
23485,0.002045,172.31.40.0-255,66,163497,63,192160
23486,0.00205,172.217.194.0-255,3602,167099,63,192160
23487,0.00206,172.31.40.0-255,66,167165,63,192160
23488,0.002065,172.217.194.0-255,4320,171485,63,192160
23489,0.002099,172.31.40.0-255,66,171551,63,192160
23490,0.002105,172.31.40.0-255,66,171617,63,192160
23491,0.002149,172.31.40.0-255,66,171683,63,192160
23492,0.002171,172.31.40.0-255,66,171749,63,192160
23493,0.002191,172.217.194.0-255,4320,176069,63,192160
23494,0.002214,172.217.194.0-255,7156,183225,63,192160
23495,0.002221,172.31.40.0-255,66,183291,63,192160
23496,0.002235,172.217.194.0-255,7156,190447,63,192160
23497,0.002248,172.217.194.0-255,717,191164,63,192160
23498,0.00225,172.217.194.0-255,105,191269,63,192160
23499,0.002253,172.217.194.0-255,129,191398,63,192160
23500,0.002262,172.31.40.0-255,66,191464,63,192160
23501,0.013076,172.31.40.0-255,105,191569,63,192160
23502,0.013127,172.31.40.0-255,105,191674,63,192160
23503,0.013376,172.31.40.0-255,90,191764,63,192160
23504,0.013395,172.31.40.0-255,66,191830,63,192160
23505,0.015704,172.217.194.0-255,66,191896,63,192160
23506,0.015739,172.217.194.0-255,66,191962,63,192160
23507,0.015999,172.217.194.0-255,66,192028,63,192160
23508,0.016084,172.217.194.0-255,66,192094,63,192160
23509,0.016096,172.31.40.0-255,66,192160,63,192160
23510,0.0,172.217.194.0-255,66,66,63,66
23511,0.0,74.125.24.0-255,152,152,63,98733
23512,1.8e-05,172.31.40.0-255,66,218,63,98733
23513,2.5e-05,74.125.24.0-255,1484,1702,63,98733
23514,3e-05,172.31.40.0-255,66,1768,63,98733
23515,3.6e-05,74.125.24.0-255,2902,4670,63,98733
23516,3.8e-05,172.31.40.0-255,66,4736,63,98733
23517,4.6e-05,74.125.24.0-255,7156,11892,63,98733
23518,4.9e-05,172.31.40.0-255,66,11958,63,98733
23519,7.5e-05,74.125.24.0-255,1930,13888,63,98733
23520,7.8e-05,172.31.40.0-255,66,13954,63,98733
23521,9.2e-05,172.31.40.0-255,66,14020,63,98733
23522,9.8e-05,74.125.24.0-255,5379,19399,63,98733
23523,0.000101,172.31.40.0-255,66,19465,63,98733
23524,0.000246,74.125.24.0-255,1484,20949,63,98733
23525,0.00025,172.31.40.0-255,66,21015,63,98733
23526,0.000257,74.125.24.0-255,2902,23917,63,98733
23527,0.000259,172.31.40.0-255,66,23983,63,98733
23528,0.000307,74.125.24.0-255,5738,29721,63,98733
23529,0.000311,172.31.40.0-255,66,29787,63,98733
23530,0.000322,172.31.40.0-255,66,29853,63,98733
23531,0.000342,172.31.40.0-255,66,29919,63,98733
23532,0.000603,74.125.24.0-255,110,30029,63,98733
23533,0.00061,172.31.40.0-255,66,30095,63,98733
23534,0.000752,74.125.24.0-255,1484,31579,63,98733
23535,0.000756,172.31.40.0-255,66,31645,63,98733
23536,0.000761,74.125.24.0-255,1484,33129,63,98733
23537,0.000763,172.31.40.0-255,66,33195,63,98733
23538,0.000796,74.125.24.0-255,1484,34679,63,98733
23539,0.000799,172.31.40.0-255,66,34745,63,98733
23540,0.000806,74.125.24.0-255,5738,40483,63,98733
23541,0.000808,172.31.40.0-255,66,40549,63,98733
23542,0.000823,172.31.40.0-255,66,40615,63,98733
23543,0.00084,172.31.40.0-255,66,40681,63,98733
23544,0.000843,74.125.24.0-255,334,41015,63,98733
23545,0.001249,74.125.24.0-255,1484,42499,63,98733
23546,0.001255,172.31.40.0-255,66,42565,63,98733
23547,0.001261,74.125.24.0-255,2902,45467,63,98733
23548,0.001264,172.31.40.0-255,66,45533,63,98733
23549,0.001291,74.125.24.0-255,1484,47017,63,98733
23550,0.001298,74.125.24.0-255,5738,52755,63,98733
23551,0.001301,172.31.40.0-255,66,52821,63,98733
23552,0.001334,172.31.40.0-255,66,52887,63,98733
23553,0.001344,172.31.40.0-255,66,52953,63,98733
23554,0.001369,74.125.24.0-255,766,53719,63,98733
23555,0.003617,74.125.24.0-255,4320,58039,63,98733
23556,0.003623,172.31.40.0-255,66,58105,63,98733
23557,0.005866,74.125.24.0-255,5738,63843,63,98733
23558,0.00587,172.31.40.0-255,66,63909,63,98733
23559,0.008136,74.125.24.0-255,5738,69647,63,98733
23560,0.008142,172.31.40.0-255,66,69713,63,98733
23561,0.010394,74.125.24.0-255,5738,75451,63,98733
23562,0.010402,172.31.40.0-255,66,75517,63,98733
23563,0.012672,74.125.24.0-255,5738,81255,63,98733
23564,0.01268,172.31.40.0-255,66,81321,63,98733
23565,0.014962,74.125.24.0-255,5738,87059,63,98733
23566,0.014971,172.31.40.0-255,66,87125,63,98733
23567,0.017248,74.125.24.0-255,5738,92863,63,98733
23568,0.017256,172.31.40.0-255,66,92929,63,98733
23569,0.019509,74.125.24.0-255,5738,98667,63,98733
23570,0.019516,172.31.40.0-255,66,98733,63,98733
23571,0.0,74.125.200.0-255,153,153,63,205871
23572,1.4e-05,172.31.40.0-255,66,219,63,205871
23573,4e-05,74.125.200.0-255,1484,1703,63,205871
23574,4.4e-05,172.31.40.0-255,66,1769,63,205871
23575,5e-05,74.125.200.0-255,2902,4671,63,205871
23576,5.2e-05,172.31.40.0-255,66,4737,63,205871
23577,6.7e-05,74.125.200.0-255,4320,9057,63,205871
23578,6.9e-05,172.31.40.0-255,66,9123,63,205871
23579,9.3e-05,74.125.200.0-255,1484,10607,63,205871
23580,9.5e-05,172.31.40.0-255,66,10673,63,205871
23581,0.000101,74.125.200.0-255,3421,14094,63,205871
23582,0.000103,172.31.40.0-255,66,14160,63,205871
23583,0.000131,74.125.200.0-255,4320,18480,63,205871
23584,0.000135,172.31.40.0-255,66,18546,63,205871
23585,0.000152,74.125.200.0-255,2902,21448,63,205871
23586,0.000154,172.31.40.0-255,66,21514,63,205871
23587,0.000159,74.125.200.0-255,4320,25834,63,205871
23588,0.000161,172.31.40.0-255,66,25900,63,205871
23589,0.000211,74.125.200.0-255,5379,31279,63,205871
23590,0.000214,172.31.40.0-255,66,31345,63,205871
23591,0.000442,74.125.200.0-255,1484,32829,63,205871
23592,0.000446,172.31.40.0-255,66,32895,63,205871
23593,0.000461,74.125.200.0-255,1484,34379,63,205871
23594,0.000463,172.31.40.0-255,66,34445,63,205871
23595,0.000481,74.125.200.0-255,2902,37347,63,205871
23596,0.000486,74.125.200.0-255,5738,43085,63,205871
23597,0.00049,172.31.40.0-255,66,43151,63,205871
23598,0.000492,172.31.40.0-255,66,43217,63,205871
23599,0.000511,74.125.200.0-255,5379,48596,63,205871
23600,0.000513,172.31.40.0-255,66,48662,63,205871
23601,0.000559,74.125.200.0-255,1484,50146,63,205871
23602,0.000562,172.31.40.0-255,66,50212,63,205871
23603,0.000578,74.125.200.0-255,2902,53114,63,205871
23604,0.000581,172.31.40.0-255,66,53180,63,205871
23605,0.000584,74.125.200.0-255,1484,54664,63,205871
23606,0.000609,74.125.200.0-255,4320,58984,63,205871
23607,0.000611,172.31.40.0-255,66,59050,63,205871
23608,0.000617,74.125.200.0-255,5738,64788,63,205871
23609,0.000619,172.31.40.0-255,66,64854,63,205871
23610,0.000657,74.125.200.0-255,1125,65979,63,205871
23611,0.000872,74.125.200.0-255,646,66625,63,205871
23612,0.000877,172.31.40.0-255,66,66691,63,205871
23613,0.001017,74.125.200.0-255,1484,68175,63,205871
23614,0.001022,74.125.200.0-255,1484,69659,63,205871
23615,0.001025,172.31.40.0-255,66,69725,63,205871
23616,0.001041,74.125.200.0-255,1484,71209,63,205871
23617,0.001046,74.125.200.0-255,5738,76947,63,205871
23618,0.001048,172.31.40.0-255,66,77013,63,205871
23619,0.001074,74.125.200.0-255,2902,79915,63,205871
23620,0.001076,172.31.40.0-255,66,79981,63,205871
23621,0.001081,74.125.200.0-255,4320,84301,63,205871
23622,0.001082,172.31.40.0-255,66,84367,63,205871
23623,0.001106,74.125.200.0-255,4320,88687,63,205871
23624,0.001109,172.31.40.0-255,66,88753,63,205871
23625,0.001127,74.125.200.0-255,4320,93073,63,205871
23626,0.001129,172.31.40.0-255,66,93139,63,205871
23627,0.001175,74.125.200.0-255,7156,100295,63,205871
23628,0.001178,172.31.40.0-255,66,100361,63,205871
23629,0.001182,74.125.200.0-255,766,101127,63,205871
23630,0.001513,74.125.200.0-255,1484,102611,63,205871
23631,0.001519,172.31.40.0-255,66,102677,63,205871
23632,0.001534,74.125.200.0-255,2902,105579,63,205871
23633,0.001536,172.31.40.0-255,66,105645,63,205871
23634,0.00154,74.125.200.0-255,1484,107129,63,205871
23635,0.00156,74.125.200.0-255,4320,111449,63,205871
23636,0.001563,172.31.40.0-255,66,111515,63,205871
23637,0.001568,74.125.200.0-255,5738,117253,63,205871
23638,0.00157,172.31.40.0-255,66,117319,63,205871
23639,0.001586,74.125.200.0-255,7156,124475,63,205871
23640,0.001588,172.31.40.0-255,66,124541,63,205871
23641,0.001612,74.125.200.0-255,1484,126025,63,205871
23642,0.001638,172.31.40.0-255,66,126091,63,205871
23643,0.001719,74.125.200.0-255,1484,127575,63,205871
23644,0.001723,74.125.200.0-255,1484,129059,63,205871
23645,0.001725,172.31.40.0-255,66,129125,63,205871
23646,0.001744,74.125.200.0-255,1484,130609,63,205871
23647,0.00175,74.125.200.0-255,5738,136347,63,205871
23648,0.001753,172.31.40.0-255,66,136413,63,205871
23649,0.001776,74.125.200.0-255,5738,142151,63,205871
23650,0.001778,172.31.40.0-255,66,142217,63,205871
23651,0.001812,74.125.200.0-255,7156,149373,63,205871
23652,0.001815,172.31.40.0-255,66,149439,63,205871
23653,0.001861,172.31.40.0-255,66,149505,63,205871
23654,0.001885,74.125.200.0-255,766,150271,63,205871
23655,0.002117,74.125.200.0-255,1484,151755,63,205871
23656,0.002119,172.31.40.0-255,66,151821,63,205871
23657,0.002123,74.125.200.0-255,2902,154723,63,205871
23658,0.002125,172.31.40.0-255,66,154789,63,205871
23659,0.002138,74.125.200.0-255,1484,156273,63,205871
23660,0.002162,74.125.200.0-255,4320,160593,63,205871
23661,0.002164,172.31.40.0-255,66,160659,63,205871
23662,0.002169,74.125.200.0-255,2902,163561,63,205871
23663,0.002171,172.31.40.0-255,66,163627,63,205871
23664,0.002184,74.125.200.0-255,1484,165111,63,205871
23665,0.002206,172.31.40.0-255,66,165177,63,205871
23666,0.002248,172.31.40.0-255,66,165243,63,205871
23667,0.004544,74.125.200.0-255,5738,170981,63,205871
23668,0.004548,172.31.40.0-255,66,171047,63,205871
23669,0.006821,74.125.200.0-255,5738,176785,63,205871
23670,0.006828,172.31.40.0-255,66,176851,63,205871
23671,0.00911,74.125.200.0-255,5738,182589,63,205871
23672,0.009117,172.31.40.0-255,66,182655,63,205871
23673,0.011392,74.125.200.0-255,5738,188393,63,205871
23674,0.0114,172.31.40.0-255,66,188459,63,205871
23675,0.013673,74.125.200.0-255,5738,194197,63,205871
23676,0.013684,172.31.40.0-255,66,194263,63,205871
23677,0.015968,74.125.200.0-255,5738,200001,63,205871
23678,0.015978,172.31.40.0-255,66,200067,63,205871
23679,0.018254,74.125.200.0-255,5738,205805,63,205871
23680,0.018262,172.31.40.0-255,66,205871,63,205871
23681,0.0,172.217.194.0-255,297,297,63,216944
23682,1.9e-05,172.31.40.0-255,66,363,63,216944
23683,2.6e-05,172.217.194.0-255,1484,1847,63,216944
23684,3e-05,172.31.40.0-255,66,1913,63,216944
23685,3.6e-05,172.217.194.0-255,4320,6233,63,216944
23686,4.9e-05,172.31.40.0-255,66,6299,63,216944
23687,5.6e-05,172.217.194.0-255,5738,12037,63,216944
23688,5.9e-05,172.31.40.0-255,66,12103,63,216944
23689,9.5e-05,172.31.40.0-255,66,12169,63,216944
23690,0.000102,172.217.194.0-255,6797,18966,63,216944
23691,0.000105,172.31.40.0-255,66,19032,63,216944
23692,0.000159,172.217.194.0-255,1484,20516,63,216944
23693,0.000161,172.31.40.0-255,66,20582,63,216944
23694,0.00019,172.217.194.0-255,2902,23484,63,216944
23695,0.000192,172.31.40.0-255,66,23550,63,216944
23696,0.000199,172.217.194.0-255,5738,29288,63,216944
23697,0.000201,172.31.40.0-255,66,29354,63,216944
23698,0.00024,172.31.40.0-255,66,29420,63,216944
23699,0.000273,172.31.40.0-255,66,29486,63,216944
23700,0.000302,172.217.194.0-255,118,29604,63,216944
23701,0.000305,172.31.40.0-255,66,29670,63,216944
23702,0.000348,172.217.194.0-255,1484,31154,63,216944
23703,0.000351,172.31.40.0-255,66,31220,63,216944
23704,0.000354,172.217.194.0-255,1484,32704,63,216944
23705,0.000356,172.31.40.0-255,66,32770,63,216944
23706,0.000382,172.217.194.0-255,1484,34254,63,216944
23707,0.000384,172.31.40.0-255,66,34320,63,216944
23708,0.000391,172.217.194.0-255,5738,40058,63,216944
23709,0.000393,172.31.40.0-255,66,40124,63,216944
23710,0.000427,172.217.194.0-255,1484,41608,63,216944
23711,0.000438,172.217.194.0-255,501,42109,63,216944
23712,0.000558,172.31.40.0-255,66,42175,63,216944
23713,0.000586,172.217.194.0-255,1484,43659,63,216944
23714,0.000612,172.217.194.0-255,2902,46561,63,216944
23715,0.000618,172.217.194.0-255,4320,50881,63,216944
23716,0.000626,172.217.194.0-255,1484,52365,63,216944
23717,0.00064,172.217.194.0-255,7156,59521,63,216944
23718,0.00065,172.31.40.0-255,66,59587,63,216944
23719,0.00067,172.217.194.0-255,5738,65325,63,216944
23720,0.000694,172.31.40.0-255,66,65391,63,216944
23721,0.00115,172.217.194.0-255,1484,66875,63,216944
23722,0.001156,172.217.194.0-255,2902,69777,63,216944
23723,0.00116,172.31.40.0-255,66,69843,63,216944
23724,0.001163,172.217.194.0-255,1484,71327,63,216944
23725,0.001194,172.217.194.0-255,4320,75647,63,216944
23726,0.001211,172.217.194.0-255,4320,79967,63,216944
23727,0.001227,172.217.194.0-255,6438,86405,63,216944
23728,0.001243,172.31.40.0-255,66,86471,63,216944
23729,0.001728,172.217.194.0-255,1484,87955,63,216944
23730,0.001746,172.217.194.0-255,2902,90857,63,216944
23731,0.001749,172.31.40.0-255,66,90923,63,216944
23732,0.001754,172.217.194.0-255,2902,93825,63,216944
23733,0.001783,172.217.194.0-255,2902,96727,63,216944
23734,0.001789,172.217.194.0-255,5738,102465,63,216944
23735,0.001849,172.217.194.0-255,5020,107485,63,216944
23736,0.001853,172.31.40.0-255,66,107551,63,216944
23737,0.001858,172.31.40.0-255,66,107617,63,216944
23738,0.001876,172.217.194.0-255,1484,109101,63,216944
23739,0.001885,172.217.194.0-255,2902,112003,63,216944
23740,0.001887,172.217.194.0-255,1484,113487,63,216944
23741,0.001906,172.217.194.0-255,4320,117807,63,216944
23742,0.001918,172.217.194.0-255,1484,119291,63,216944
23743,0.001925,172.31.40.0-255,66,119357,63,216944
23744,0.001967,172.31.40.0-255,66,119423,63,216944
23745,0.002013,172.31.40.0-255,66,119489,63,216944
23746,0.002025,172.217.194.0-255,5020,124509,63,216944
23747,0.002051,172.217.194.0-255,4320,128829,63,216944
23748,0.002064,172.217.194.0-255,4320,133149,63,216944
23749,0.002067,172.31.40.0-255,66,133215,63,216944
23750,0.002078,172.217.194.0-255,2902,136117,63,216944
23751,0.002099,172.217.194.0-255,5020,141137,63,216944
23752,0.002109,172.31.40.0-255,66,141203,63,216944
23753,0.002121,172.217.194.0-255,4320,145523,63,216944
23754,0.002146,172.217.194.0-255,5738,151261,63,216944
23755,0.002153,172.217.194.0-255,5738,156999,63,216944
23756,0.00216,172.31.40.0-255,66,157065,63,216944
23757,0.002171,172.217.194.0-255,5738,162803,63,216944
23758,0.002181,172.217.194.0-255,5738,168541,63,216944
23759,0.002201,172.217.194.0-255,6438,174979,63,216944
23760,0.002214,172.31.40.0-255,66,175045,63,216944
23761,0.002242,172.217.194.0-255,1484,176529,63,216944
23762,0.002255,172.217.194.0-255,2902,179431,63,216944
23763,0.002261,172.217.194.0-255,5738,185169,63,216944
23764,0.00228,172.217.194.0-255,5738,190907,63,216944
23765,0.002284,172.31.40.0-255,66,190973,63,216944
23766,0.002295,172.217.194.0-255,4320,195293,63,216944
23767,0.002321,172.217.194.0-255,1484,196777,63,216944
23768,0.002336,172.217.194.0-255,3602,200379,63,216944
23769,0.00235,172.31.40.0-255,66,200445,63,216944
23770,0.00236,172.217.194.0-255,4320,204765,63,216944
23771,0.002365,172.31.40.0-255,66,204831,63,216944
23772,0.002404,172.217.194.0-255,1484,206315,63,216944
23773,0.002412,172.217.194.0-255,7156,213471,63,216944
23774,0.002434,172.217.194.0-255,1484,214955,63,216944
23775,0.00247,172.217.194.0-255,1484,216439,63,216944
23776,0.002483,172.31.40.0-255,66,216505,63,216944
23777,0.002545,172.217.194.0-255,97,216602,63,216944
23778,0.002567,172.217.194.0-255,105,216707,63,216944
23779,0.002571,172.31.40.0-255,66,216773,63,216944
23780,0.018513,172.31.40.0-255,66,216839,63,216944
23781,0.01856,172.31.40.0-255,105,216944,63,216944
23782,0.0,172.217.194.0-255,150,150,63,204342
23783,2.2e-05,172.31.40.0-255,66,216,63,204342
23784,3e-05,172.217.194.0-255,1484,1700,63,204342
23785,3.5e-05,172.31.40.0-255,66,1766,63,204342
23786,4.1e-05,172.217.194.0-255,2902,4668,63,204342
23787,4.5e-05,172.31.40.0-255,66,4734,63,204342
23788,5.3e-05,172.217.194.0-255,7156,11890,63,204342
23789,5.6e-05,172.31.40.0-255,66,11956,63,204342
23790,6e-05,172.217.194.0-255,2067,14023,63,204342
23791,6.3e-05,172.31.40.0-255,66,14089,63,204342
23792,0.000208,172.217.194.0-255,1484,15573,63,204342
23793,0.000213,172.31.40.0-255,66,15639,63,204342
23794,0.000219,172.217.194.0-255,2902,18541,63,204342
23795,0.000221,172.31.40.0-255,66,18607,63,204342
23796,0.000252,172.217.194.0-255,5738,24345,63,204342
23797,0.000255,172.31.40.0-255,66,24411,63,204342
23798,0.000261,172.217.194.0-255,4320,28731,63,204342
23799,0.000263,172.31.40.0-255,66,28797,63,204342
23800,0.000279,172.217.194.0-255,2543,31340,63,204342
23801,0.000281,172.31.40.0-255,66,31406,63,204342
23802,0.000306,172.217.194.0-255,7156,38562,63,204342
23803,0.000309,172.31.40.0-255,66,38628,63,204342
23804,0.000325,172.31.40.0-255,66,38694,63,204342
23805,0.000337,172.31.40.0-255,66,38760,63,204342
23806,0.000355,172.217.194.0-255,1089,39849,63,204342
23807,0.000358,172.31.40.0-255,66,39915,63,204342
23808,0.000609,172.217.194.0-255,385,40300,63,204342
23809,0.000615,172.31.40.0-255,66,40366,63,204342
23810,0.000884,172.217.194.0-255,1484,41850,63,204342
23811,0.000889,172.31.40.0-255,66,41916,63,204342
23812,0.000895,172.217.194.0-255,2902,44818,63,204342
23813,0.000897,172.31.40.0-255,66,44884,63,204342
23814,0.000926,172.217.194.0-255,5738,50622,63,204342
23815,0.000929,172.31.40.0-255,66,50688,63,204342
23816,0.000935,172.217.194.0-255,4320,55008,63,204342
23817,0.000937,172.31.40.0-255,66,55074,63,204342
23818,0.000957,172.31.40.0-255,66,55140,63,204342
23819,0.000988,172.217.194.0-255,7156,62296,63,204342
23820,0.000992,172.31.40.0-255,66,62362,63,204342
23821,0.001012,172.217.194.0-255,3602,65964,63,204342
23822,0.001014,172.31.40.0-255,66,66030,63,204342
23823,0.001295,172.217.194.0-255,1484,67514,63,204342
23824,0.001302,172.217.194.0-255,2902,70416,63,204342
23825,0.001306,172.31.40.0-255,66,70482,63,204342
23826,0.001351,172.217.194.0-255,5738,76220,63,204342
23827,0.001354,172.31.40.0-255,66,76286,63,204342
23828,0.001361,172.217.194.0-255,5738,82024,63,204342
23829,0.001363,172.31.40.0-255,66,82090,63,204342
23830,0.001377,172.31.40.0-255,66,82156,63,204342
23831,0.001406,172.217.194.0-255,5020,87176,63,204342
23832,0.00141,172.31.40.0-255,66,87242,63,204342
23833,0.001514,172.217.194.0-255,1484,88726,63,204342
23834,0.001521,172.217.194.0-255,2902,91628,63,204342
23835,0.001524,172.31.40.0-255,66,91694,63,204342
23836,0.001543,172.217.194.0-255,5738,97432,63,204342
23837,0.001548,172.217.194.0-255,4320,101752,63,204342
23838,0.001552,172.31.40.0-255,66,101818,63,204342
23839,0.001554,172.31.40.0-255,66,101884,63,204342
23840,0.001572,172.217.194.0-255,2902,104786,63,204342
23841,0.001575,172.31.40.0-255,66,104852,63,204342
23842,0.001589,172.31.40.0-255,66,104918,63,204342
23843,0.001607,172.217.194.0-255,2902,107820,63,204342
23844,0.00161,172.31.40.0-255,66,107886,63,204342
23845,0.001614,172.217.194.0-255,2184,110070,63,204342
23846,0.001616,172.31.40.0-255,66,110136,63,204342
23847,0.001635,172.217.194.0-255,2902,113038,63,204342
23848,0.001637,172.31.40.0-255,66,113104,63,204342
23849,0.001654,172.217.194.0-255,4320,117424,63,204342
23850,0.001656,172.31.40.0-255,66,117490,63,204342
23851,0.001691,172.31.40.0-255,66,117556,63,204342
23852,0.001698,172.217.194.0-255,5738,123294,63,204342
23853,0.0017,172.31.40.0-255,66,123360,63,204342
23854,0.001756,172.217.194.0-255,7156,130516,63,204342
23855,0.001761,172.31.40.0-255,66,130582,63,204342
23856,0.00178,172.217.194.0-255,5020,135602,63,204342
23857,0.001783,172.31.40.0-255,66,135668,63,204342
23858,0.001797,172.31.40.0-255,66,135734,63,204342
23859,0.00181,172.31.40.0-255,66,135800,63,204342
23860,0.001832,172.217.194.0-255,1484,137284,63,204342
23861,0.001852,172.217.194.0-255,7156,144440,63,204342
23862,0.001855,172.31.40.0-255,66,144506,63,204342
23863,0.001879,172.217.194.0-255,2184,146690,63,204342
23864,0.001882,172.31.40.0-255,66,146756,63,204342
23865,0.001894,172.31.40.0-255,66,146822,63,204342
23866,0.001959,172.217.194.0-255,5020,151842,63,204342
23867,0.001964,172.217.194.0-255,5738,157580,63,204342
23868,0.001969,172.31.40.0-255,66,157646,63,204342
23869,0.001972,172.31.40.0-255,66,157712,63,204342
23870,0.00198,172.31.40.0-255,66,157778,63,204342
23871,0.001994,172.31.40.0-255,66,157844,63,204342
23872,0.002059,172.31.40.0-255,66,157910,63,204342
23873,0.004086,172.217.194.0-255,5738,163648,63,204342
23874,0.004095,172.31.40.0-255,66,163714,63,204342
23875,0.006157,172.217.194.0-255,5738,169452,63,204342
23876,0.006175,172.31.40.0-255,66,169518,63,204342
23877,0.00823,172.217.194.0-255,5738,175256,63,204342
23878,0.008244,172.31.40.0-255,66,175322,63,204342
23879,0.010288,172.217.194.0-255,5738,181060,63,204342
23880,0.010299,172.31.40.0-255,66,181126,63,204342
23881,0.012346,172.217.194.0-255,5738,186864,63,204342
23882,0.012351,172.31.40.0-255,66,186930,63,204342
23883,0.014402,172.217.194.0-255,5738,192668,63,204342
23884,0.014412,172.31.40.0-255,66,192734,63,204342
23885,0.016479,172.217.194.0-255,5738,198472,63,204342
23886,0.016499,172.31.40.0-255,66,198538,63,204342
23887,0.018573,172.217.194.0-255,5738,204276,63,204342
23888,0.018589,172.31.40.0-255,66,204342,63,204342
23889,0.0,172.217.194.0-255,153,153,63,250423
23890,2.4e-05,172.31.40.0-255,66,219,63,250423
23891,3.1e-05,172.217.194.0-255,1484,1703,63,250423
23892,3.6e-05,172.31.40.0-255,66,1769,63,250423
23893,4.2e-05,172.217.194.0-255,2902,4671,63,250423
23894,4.5e-05,172.31.40.0-255,66,4737,63,250423
23895,5.3e-05,172.217.194.0-255,7156,11893,63,250423
23896,5.6e-05,172.31.40.0-255,66,11959,63,250423
23897,6e-05,172.217.194.0-255,2029,13988,63,250423
23898,6.4e-05,172.31.40.0-255,66,14054,63,250423
23899,0.00011,172.31.40.0-255,66,14120,63,250423
23900,0.000116,172.217.194.0-255,5379,19499,63,250423
23901,0.000119,172.31.40.0-255,66,19565,63,250423
23902,0.000215,172.217.194.0-255,1484,21049,63,250423
23903,0.000218,172.31.40.0-255,66,21115,63,250423
23904,0.000239,172.217.194.0-255,2902,24017,63,250423
23905,0.000241,172.31.40.0-255,66,24083,63,250423
23906,0.000263,172.217.194.0-255,5738,29821,63,250423
23907,0.000267,172.31.40.0-255,66,29887,63,250423
23908,0.000272,172.217.194.0-255,4320,34207,63,250423
23909,0.000275,172.31.40.0-255,66,34273,63,250423
23910,0.000289,172.217.194.0-255,2543,36816,63,250423
23911,0.000291,172.31.40.0-255,66,36882,63,250423
23912,0.000313,172.31.40.0-255,66,36948,63,250423
23913,0.000329,172.217.194.0-255,2902,39850,63,250423
23914,0.000331,172.31.40.0-255,66,39916,63,250423
23915,0.000335,172.217.194.0-255,2834,42750,63,250423
23916,0.000337,172.31.40.0-255,66,42816,63,250423
23917,0.00038,172.217.194.0-255,4618,47434,63,250423
23918,0.000383,172.31.40.0-255,66,47500,63,250423
23919,0.000389,172.217.194.0-255,5738,53238,63,250423
23920,0.000424,172.217.194.0-255,2902,56140,63,250423
23921,0.00044,172.217.194.0-255,3961,60101,63,250423
23922,0.000465,172.217.194.0-255,4320,64421,63,250423
23923,0.000481,172.217.194.0-255,2902,67323,63,250423
23924,0.000546,172.217.194.0-255,1125,68448,63,250423
23925,0.000605,172.31.40.0-255,66,68514,63,250423
23926,0.000861,172.217.194.0-255,1484,69998,63,250423
23927,0.000866,172.217.194.0-255,1484,71482,63,250423
23928,0.000877,172.217.194.0-255,1484,72966,63,250423
23929,0.000885,172.217.194.0-255,5738,78704,63,250423
23930,0.000898,172.31.40.0-255,66,78770,63,250423
23931,0.000908,172.217.194.0-255,4320,83090,63,250423
23932,0.000914,172.31.40.0-255,66,83156,63,250423
23933,0.000932,172.217.194.0-255,7156,90312,63,250423
23934,0.000946,172.217.194.0-255,3602,93914,63,250423
23935,0.000962,172.31.40.0-255,66,93980,63,250423
23936,0.001008,172.217.194.0-255,1484,95464,63,250423
23937,0.001013,172.217.194.0-255,2902,98366,63,250423
23938,0.001031,172.31.40.0-255,66,98432,63,250423
23939,0.001037,172.217.194.0-255,4320,102752,63,250423
23940,0.001043,172.217.194.0-255,5738,108490,63,250423
23941,0.001055,172.217.194.0-255,2902,111392,63,250423
23942,0.001058,172.31.40.0-255,66,111458,63,250423
23943,0.00108,172.31.40.0-255,66,111524,63,250423
23944,0.00112,172.31.40.0-255,66,111590,63,250423
23945,0.001177,172.217.194.0-255,1484,113074,63,250423
23946,0.001184,172.217.194.0-255,2902,115976,63,250423
23947,0.001188,172.217.194.0-255,4320,120296,63,250423
23948,0.001205,172.217.194.0-255,1484,121780,63,250423
23949,0.001212,172.217.194.0-255,5738,127518,63,250423
23950,0.00124,172.217.194.0-255,7156,134674,63,250423
23951,0.001289,172.217.194.0-255,2184,136858,63,250423
23952,0.001305,172.217.194.0-255,2902,139760,63,250423
23953,0.001332,172.217.194.0-255,7156,146916,63,250423
23954,0.001336,172.217.194.0-255,2902,149818,63,250423
23955,0.001339,172.217.194.0-255,1484,151302,63,250423
23956,0.001353,172.217.194.0-255,2902,154204,63,250423
23957,0.001395,172.217.194.0-255,7156,161360,63,250423
23958,0.001418,172.217.194.0-255,766,162126,63,250423
23959,0.001429,172.217.194.0-255,1484,163610,63,250423
23960,0.001473,172.217.194.0-255,6438,170048,63,250423
23961,0.001559,172.217.194.0-255,1484,171532,63,250423
23962,0.001563,172.217.194.0-255,1484,173016,63,250423
23963,0.001576,172.217.194.0-255,1484,174500,63,250423
23964,0.001582,172.217.194.0-255,4320,178820,63,250423
23965,0.001599,172.217.194.0-255,1484,180304,63,250423
23966,0.001604,172.217.194.0-255,4320,184624,63,250423
23967,0.001615,172.217.194.0-255,1484,186108,63,250423
23968,0.001627,172.217.194.0-255,4320,190428,63,250423
23969,0.001643,172.217.194.0-255,5738,196166,63,250423
23970,0.001646,172.217.194.0-255,1484,197650,63,250423
23971,0.001666,172.217.194.0-255,6438,204088,63,250423
23972,0.001722,172.217.194.0-255,1484,205572,63,250423
23973,0.001738,172.217.194.0-255,2902,208474,63,250423
23974,0.001765,172.217.194.0-255,5738,214212,63,250423
23975,0.001789,172.217.194.0-255,4320,218532,63,250423
23976,0.001814,172.217.194.0-255,5738,224270,63,250423
23977,0.001862,172.217.194.0-255,5020,229290,63,250423
23978,0.00187,172.217.194.0-255,5738,235028,63,250423
23979,0.001899,172.217.194.0-255,1484,236512,63,250423
23980,0.001942,172.217.194.0-255,2902,239414,63,250423
23981,0.001967,172.217.194.0-255,766,240180,63,250423
23982,0.002064,172.217.194.0-255,4320,244500,63,250423
23983,0.002081,172.217.194.0-255,5125,249625,63,250423
23984,0.002098,172.217.194.0-255,105,249730,63,250423
23985,0.002118,172.217.194.0-255,129,249859,63,250423
23986,0.009219,172.31.40.0-255,66,249925,63,250423
23987,0.017336,172.31.40.0-255,105,250030,63,250423
23988,0.0174,172.31.40.0-255,105,250135,63,250423
23989,0.017768,172.31.40.0-255,90,250225,63,250423
23990,0.01779,172.31.40.0-255,66,250291,63,250423
23991,0.019931,172.217.194.0-255,66,250357,63,250423
23992,0.019993,172.217.194.0-255,66,250423,63,250423
23993,0.0,172.217.160.0-255,150,150,63,114053
23994,2.5e-05,172.31.40.0-255,66,216,63,114053
23995,3.1e-05,172.217.160.0-255,1484,1700,63,114053
23996,3.6e-05,172.31.40.0-255,66,1766,63,114053
23997,4.2e-05,172.217.160.0-255,2902,4668,63,114053
23998,4.7e-05,172.31.40.0-255,66,4734,63,114053
23999,5.4e-05,172.217.160.0-255,7156,11890,63,114053
24000,5.8e-05,172.31.40.0-255,66,11956,63,114053
24001,7.3e-05,172.31.40.0-255,66,12022,63,114053
24002,9.4e-05,172.217.160.0-255,3420,15442,63,114053
24003,9.7e-05,172.31.40.0-255,66,15508,63,114053
24004,0.000103,172.217.160.0-255,2543,18051,63,114053
24005,0.000106,172.31.40.0-255,66,18117,63,114053
24006,0.000146,172.217.160.0-255,1484,19601,63,114053
24007,0.000148,172.31.40.0-255,66,19667,63,114053
24008,0.000153,172.217.160.0-255,2902,22569,63,114053
24009,0.000156,172.31.40.0-255,66,22635,63,114053
24010,0.000162,172.217.160.0-255,5738,28373,63,114053
24011,0.000165,172.31.40.0-255,66,28439,63,114053
24012,0.000171,172.217.160.0-255,6797,35236,63,114053
24013,0.000174,172.31.40.0-255,66,35302,63,114053
24014,0.00021,172.31.40.0-255,66,35368,63,114053
24015,0.000215,172.217.160.0-255,2832,38200,63,114053
24016,0.000217,172.31.40.0-255,66,38266,63,114053
24017,0.000653,172.217.160.0-255,100,38366,63,114053
24018,0.000659,172.31.40.0-255,66,38432,63,114053
24019,0.000765,172.217.160.0-255,1484,39916,63,114053
24020,0.000769,172.31.40.0-255,66,39982,63,114053
24021,0.000775,172.217.160.0-255,2902,42884,63,114053
24022,0.000778,172.31.40.0-255,66,42950,63,114053
24023,0.000784,172.217.160.0-255,5738,48688,63,114053
24024,0.000787,172.31.40.0-255,66,48754,63,114053
24025,0.000818,172.217.160.0-255,1484,50238,63,114053
24026,0.000845,172.31.40.0-255,66,50304,63,114053
24027,0.000858,172.31.40.0-255,66,50370,63,114053
24028,0.000861,172.217.160.0-255,1125,51495,63,114053
24029,0.001408,172.31.40.0-255,66,51561,63,114053
24030,0.002519,172.217.160.0-255,4320,55881,63,114053
24031,0.002527,172.31.40.0-255,66,55947,63,114053
24032,0.00306,172.217.160.0-255,1484,57431,63,114053
24033,0.004191,172.217.160.0-255,4320,61751,63,114053
24034,0.004194,172.31.40.0-255,66,61817,63,114053
24035,0.005854,172.217.160.0-255,5738,67555,63,114053
24036,0.00586,172.31.40.0-255,66,67621,63,114053
24037,0.007519,172.217.160.0-255,5738,73359,63,114053
24038,0.007525,172.31.40.0-255,66,73425,63,114053
24039,0.009185,172.217.160.0-255,5738,79163,63,114053
24040,0.009192,172.31.40.0-255,66,79229,63,114053
24041,0.01089,172.217.160.0-255,5738,84967,63,114053
24042,0.010898,172.31.40.0-255,66,85033,63,114053
24043,0.01256,172.217.160.0-255,5738,90771,63,114053
24044,0.012569,172.31.40.0-255,66,90837,63,114053
24045,0.014232,172.217.160.0-255,5738,96575,63,114053
24046,0.01424,172.31.40.0-255,66,96641,63,114053
24047,0.015913,172.217.160.0-255,5738,102379,63,114053
24048,0.015923,172.31.40.0-255,66,102445,63,114053
24049,0.017588,172.217.160.0-255,5738,108183,63,114053
24050,0.017595,172.31.40.0-255,66,108249,63,114053
24051,0.019265,172.217.160.0-255,5738,113987,63,114053
24052,0.019273,172.31.40.0-255,66,114053,63,114053
24053,0.0,172.217.194.0-255,153,153,63,181101
24054,1.7e-05,172.31.40.0-255,66,219,63,181101
24055,2.4e-05,172.217.194.0-255,1484,1703,63,181101
24056,2.9e-05,172.31.40.0-255,66,1769,63,181101
24057,3.5e-05,172.217.194.0-255,2902,4671,63,181101
24058,3.8e-05,172.31.40.0-255,66,4737,63,181101
24059,4.7e-05,172.217.194.0-255,7156,11893,63,181101
24060,5e-05,172.31.40.0-255,66,11959,63,181101
24061,7.4e-05,172.217.194.0-255,2063,14022,63,181101
24062,7.7e-05,172.31.40.0-255,66,14088,63,181101
24063,0.000499,172.217.194.0-255,1484,15572,63,181101
24064,0.000505,172.31.40.0-255,66,15638,63,181101
24065,0.000513,172.217.194.0-255,2902,18540,63,181101
24066,0.000515,172.31.40.0-255,66,18606,63,181101
24067,0.000546,172.217.194.0-255,5738,24344,63,181101
24068,0.000548,172.31.40.0-255,66,24410,63,181101
24069,0.00058,172.217.194.0-255,6797,31207,63,181101
24070,0.000585,172.31.40.0-255,66,31273,63,181101
24071,0.000816,172.217.194.0-255,1484,32757,63,181101
24072,0.000821,172.31.40.0-255,66,32823,63,181101
24073,0.000826,172.217.194.0-255,1484,34307,63,181101
24074,0.000828,172.31.40.0-255,66,34373,63,181101
24075,0.000844,172.217.194.0-255,1484,35857,63,181101
24076,0.000846,172.31.40.0-255,66,35923,63,181101
24077,0.000849,172.217.194.0-255,1484,37407,63,181101
24078,0.000852,172.31.40.0-255,66,37473,63,181101
24079,0.000879,172.217.194.0-255,4320,41793,63,181101
24080,0.000883,172.31.40.0-255,66,41859,63,181101
24081,0.000886,172.217.194.0-255,1484,43343,63,181101
24082,0.000888,172.31.40.0-255,66,43409,63,181101
24083,0.00091,172.217.194.0-255,5379,48788,63,181101
24084,0.000914,172.31.40.0-255,66,48854,63,181101
24085,0.000921,172.217.194.0-255,7156,56010,63,181101
24086,0.000923,172.31.40.0-255,66,56076,63,181101
24087,0.000945,172.217.194.0-255,1484,57560,63,181101
24088,0.000967,172.217.194.0-255,5738,63298,63,181101
24089,0.000969,172.31.40.0-255,66,63364,63,181101
24090,0.000972,172.217.194.0-255,1484,64848,63,181101
24091,0.000984,172.217.194.0-255,1715,66563,63,181101
24092,0.000986,172.31.40.0-255,66,66629,63,181101
24093,0.001212,172.217.194.0-255,1484,68113,63,181101
24094,0.001221,172.217.194.0-255,2902,71015,63,181101
24095,0.001225,172.31.40.0-255,66,71081,63,181101
24096,0.001233,172.217.194.0-255,5738,76819,63,181101
24097,0.001235,172.31.40.0-255,66,76885,63,181101
24098,0.001255,172.217.194.0-255,5738,82623,63,181101
24099,0.001257,172.31.40.0-255,66,82689,63,181101
24100,0.001282,172.217.194.0-255,7156,89845,63,181101
24101,0.001285,172.31.40.0-255,66,89911,63,181101
24102,0.001299,172.31.40.0-255,66,89977,63,181101
24103,0.001577,172.217.194.0-255,1484,91461,63,181101
24104,0.001595,172.217.194.0-255,2902,94363,63,181101
24105,0.001597,172.31.40.0-255,66,94429,63,181101
24106,0.0016,172.217.194.0-255,1484,95913,63,181101
24107,0.001621,172.217.194.0-255,4320,100233,63,181101
24108,0.001624,172.31.40.0-255,66,100299,63,181101
24109,0.001643,172.217.194.0-255,5738,106037,63,181101
24110,0.001646,172.31.40.0-255,66,106103,63,181101
24111,0.001671,172.217.194.0-255,7156,113259,63,181101
24112,0.001674,172.31.40.0-255,66,113325,63,181101
24113,0.001711,172.217.194.0-255,2902,116227,63,181101
24114,0.001713,172.31.40.0-255,66,116293,63,181101
24115,0.001739,172.31.40.0-255,66,116359,63,181101
24116,0.001788,172.217.194.0-255,1484,117843,63,181101
24117,0.00181,172.217.194.0-255,2902,120745,63,181101
24118,0.001813,172.31.40.0-255,66,120811,63,181101
24119,0.001817,172.217.194.0-255,2902,123713,63,181101
24120,0.001819,172.31.40.0-255,66,123779,63,181101
24121,0.001842,172.217.194.0-255,2902,126681,63,181101
24122,0.001844,172.31.40.0-255,66,126747,63,181101
24123,0.001889,172.217.194.0-255,2902,129649,63,181101
24124,0.001903,172.217.194.0-255,7156,136805,63,181101
24125,0.001925,172.217.194.0-255,3602,140407,63,181101
24126,0.00335,172.31.40.0-255,66,140473,63,181101
24127,0.005653,172.217.194.0-255,5738,146211,63,181101
24128,0.005661,172.31.40.0-255,66,146277,63,181101
24129,0.00796,172.217.194.0-255,5738,152015,63,181101
24130,0.007968,172.31.40.0-255,66,152081,63,181101
24131,0.010253,172.217.194.0-255,5738,157819,63,181101
24132,0.010262,172.31.40.0-255,66,157885,63,181101
24133,0.01256,172.217.194.0-255,5738,163623,63,181101
24134,0.012567,172.31.40.0-255,66,163689,63,181101
24135,0.014891,172.217.194.0-255,5738,169427,63,181101
24136,0.0149,172.31.40.0-255,66,169493,63,181101
24137,0.01722,172.217.194.0-255,5738,175231,63,181101
24138,0.01723,172.31.40.0-255,66,175297,63,181101
24139,0.019526,172.217.194.0-255,5738,181035,63,181101
24140,0.019535,172.31.40.0-255,66,181101,63,181101
24141,0.0,172.217.194.0-255,153,153,63,227902
24142,2.1e-05,172.31.40.0-255,66,219,63,227902
24143,2.8e-05,172.217.194.0-255,1484,1703,63,227902
24144,3.2e-05,172.31.40.0-255,66,1769,63,227902
24145,3.6e-05,172.217.194.0-255,2902,4671,63,227902
24146,3.8e-05,172.31.40.0-255,66,4737,63,227902
24147,4.3e-05,172.217.194.0-255,4320,9057,63,227902
24148,4.7e-05,172.31.40.0-255,66,9123,63,227902
24149,5.2e-05,172.217.194.0-255,4784,13907,63,227902
24150,5.5e-05,172.31.40.0-255,66,13973,63,227902
24151,8.4e-05,172.217.194.0-255,1484,15457,63,227902
24152,8.7e-05,172.31.40.0-255,66,15523,63,227902
24153,9.2e-05,172.217.194.0-255,2902,18425,63,227902
24154,9.4e-05,172.31.40.0-255,66,18491,63,227902
24155,0.000105,172.217.194.0-255,1484,19975,63,227902
24156,0.000107,172.31.40.0-255,66,20041,63,227902
24157,0.000133,172.217.194.0-255,4320,24361,63,227902
24158,0.000135,172.31.40.0-255,66,24427,63,227902
24159,0.000142,172.217.194.0-255,6797,31224,63,227902
24160,0.000144,172.31.40.0-255,66,31290,63,227902
24161,0.000191,172.217.194.0-255,1484,32774,63,227902
24162,0.000193,172.31.40.0-255,66,32840,63,227902
24163,0.000209,172.217.194.0-255,2902,35742,63,227902
24164,0.000211,172.31.40.0-255,66,35808,63,227902
24165,0.000216,172.217.194.0-255,4320,40128,63,227902
24166,0.000218,172.31.40.0-255,66,40194,63,227902
24167,0.000228,172.217.194.0-255,1484,41678,63,227902
24168,0.00023,172.31.40.0-255,66,41744,63,227902
24169,0.000235,172.217.194.0-255,4320,46064,63,227902
24170,0.000237,172.31.40.0-255,66,46130,63,227902
24171,0.000252,172.217.194.0-255,2543,48673,63,227902
24172,0.000253,172.31.40.0-255,66,48739,63,227902
24173,0.00026,172.217.194.0-255,5738,54477,63,227902
24174,0.000262,172.31.40.0-255,66,54543,63,227902
24175,0.000281,172.31.40.0-255,66,54609,63,227902
24176,0.000284,172.217.194.0-255,2543,57152,63,227902
24177,0.000286,172.31.40.0-255,66,57218,63,227902
24178,0.000318,172.217.194.0-255,680,57898,63,227902
24179,0.000551,172.217.194.0-255,1484,59382,63,227902
24180,0.000557,172.31.40.0-255,66,59448,63,227902
24181,0.000562,172.217.194.0-255,2902,62350,63,227902
24182,0.000565,172.31.40.0-255,66,62416,63,227902
24183,0.000583,172.217.194.0-255,5738,68154,63,227902
24184,0.000585,172.31.40.0-255,66,68220,63,227902
24185,0.000592,172.217.194.0-255,7156,75376,63,227902
24186,0.000594,172.31.40.0-255,66,75442,63,227902
24187,0.000619,172.217.194.0-255,1484,76926,63,227902
24188,0.000649,172.217.194.0-255,4320,81246,63,227902
24189,0.000653,172.31.40.0-255,66,81312,63,227902
24190,0.000682,172.31.40.0-255,66,81378,63,227902
24191,0.001209,172.217.194.0-255,1484,82862,63,227902
24192,0.001215,172.217.194.0-255,2902,85764,63,227902
24193,0.001218,172.31.40.0-255,66,85830,63,227902
24194,0.001223,172.217.194.0-255,2902,88732,63,227902
24195,0.001224,172.31.40.0-255,66,88798,63,227902
24196,0.001241,172.217.194.0-255,2902,91700,63,227902
24197,0.001242,172.31.40.0-255,66,91766,63,227902
24198,0.001246,172.217.194.0-255,2902,94668,63,227902
24199,0.001248,172.31.40.0-255,66,94734,63,227902
24200,0.001282,172.31.40.0-255,66,94800,63,227902
24201,0.0013,172.217.194.0-255,2902,97702,63,227902
24202,0.001302,172.31.40.0-255,66,97768,63,227902
24203,0.001331,172.31.40.0-255,66,97834,63,227902
24204,0.001561,172.217.194.0-255,1484,99318,63,227902
24205,0.001565,172.217.194.0-255,1484,100802,63,227902
24206,0.001568,172.31.40.0-255,66,100868,63,227902
24207,0.001584,172.217.194.0-255,1484,102352,63,227902
24208,0.00159,172.217.194.0-255,5738,108090,63,227902
24209,0.001592,172.31.40.0-255,66,108156,63,227902
24210,0.00163,172.31.40.0-255,66,108222,63,227902
24211,0.00166,172.217.194.0-255,4320,112542,63,227902
24212,0.001662,172.31.40.0-255,66,112608,63,227902
24213,0.001678,172.217.194.0-255,6438,119046,63,227902
24214,0.001681,172.31.40.0-255,66,119112,63,227902
24215,0.001702,172.217.194.0-255,4320,123432,63,227902
24216,0.001704,172.31.40.0-255,66,123498,63,227902
24217,0.001707,172.217.194.0-255,1484,124982,63,227902
24218,0.001723,172.217.194.0-255,4320,129302,63,227902
24219,0.001725,172.31.40.0-255,66,129368,63,227902
24220,0.001731,172.217.194.0-255,7156,136524,63,227902
24221,0.001733,172.31.40.0-255,66,136590,63,227902
24222,0.001764,172.217.194.0-255,4320,140910,63,227902
24223,0.001774,172.31.40.0-255,66,140976,63,227902
24224,0.00178,172.31.40.0-255,66,141042,63,227902
24225,0.001784,172.217.194.0-255,3602,144644,63,227902
24226,0.001786,172.31.40.0-255,66,144710,63,227902
24227,0.001805,172.31.40.0-255,66,144776,63,227902
24228,0.001831,172.217.194.0-255,4320,149096,63,227902
24229,0.001833,172.31.40.0-255,66,149162,63,227902
24230,0.00187,172.31.40.0-255,66,149228,63,227902
24231,0.00189,172.217.194.0-255,6438,155666,63,227902
24232,0.001892,172.31.40.0-255,66,155732,63,227902
24233,0.00195,172.217.194.0-255,1484,157216,63,227902
24234,0.001962,172.217.194.0-255,2902,160118,63,227902
24235,0.001965,172.31.40.0-255,66,160184,63,227902
24236,0.001985,172.217.194.0-255,5738,165922,63,227902
24237,0.001988,172.31.40.0-255,66,165988,63,227902
24238,0.002004,172.217.194.0-255,1484,167472,63,227902
24239,0.002039,172.31.40.0-255,66,167538,63,227902
24240,0.002049,172.31.40.0-255,66,167604,63,227902
24241,0.002061,172.217.194.0-255,1484,169088,63,227902
24242,0.002065,172.217.194.0-255,2184,171272,63,227902
24243,0.002067,172.31.40.0-255,66,171338,63,227902
24244,0.002097,172.217.194.0-255,1484,172822,63,227902
24245,0.002111,172.217.194.0-255,1484,174306,63,227902
24246,0.002113,172.31.40.0-255,66,174372,63,227902
24247,0.002118,172.217.194.0-255,4320,178692,63,227902
24248,0.00212,172.31.40.0-255,66,178758,63,227902
24249,0.002153,172.31.40.0-255,66,178824,63,227902
24250,0.002155,172.217.194.0-255,1484,180308,63,227902
24251,0.002183,172.31.40.0-255,66,180374,63,227902
24252,0.002212,172.31.40.0-255,66,180440,63,227902
24253,0.002224,172.217.194.0-255,2184,182624,63,227902
24254,0.002227,172.31.40.0-255,66,182690,63,227902
24255,0.002238,172.31.40.0-255,66,182756,63,227902
24256,0.002274,172.217.194.0-255,4320,187076,63,227902
24257,0.002277,172.31.40.0-255,66,187142,63,227902
24258,0.002318,172.31.40.0-255,66,187208,63,227902
24259,0.002327,172.31.40.0-255,66,187274,63,227902
24260,0.00457,172.217.194.0-255,5738,193012,63,227902
24261,0.004578,172.31.40.0-255,66,193078,63,227902
24262,0.006833,172.217.194.0-255,5738,198816,63,227902
24263,0.006837,172.31.40.0-255,66,198882,63,227902
24264,0.009084,172.217.194.0-255,5738,204620,63,227902
24265,0.009091,172.31.40.0-255,66,204686,63,227902
24266,0.011367,172.217.194.0-255,5738,210424,63,227902
24267,0.011382,172.31.40.0-255,66,210490,63,227902
24268,0.01363,172.217.194.0-255,5738,216228,63,227902
24269,0.013641,172.31.40.0-255,66,216294,63,227902
24270,0.01589,172.217.194.0-255,5738,222032,63,227902
24271,0.015901,172.31.40.0-255,66,222098,63,227902
24272,0.018171,172.217.194.0-255,5738,227836,63,227902
24273,0.018186,172.31.40.0-255,66,227902,63,227902
24274,0.0,74.125.24.0-255,153,153,63,130991
24275,2.3e-05,172.31.40.0-255,66,219,63,130991
24276,3e-05,74.125.24.0-255,1484,1703,63,130991
24277,3.5e-05,172.31.40.0-255,66,1769,63,130991
24278,4e-05,74.125.24.0-255,2902,4671,63,130991
24279,4.3e-05,172.31.40.0-255,66,4737,63,130991
24280,5.1e-05,74.125.24.0-255,7156,11893,63,130991
24281,5.5e-05,172.31.40.0-255,66,11959,63,130991
24282,8.7e-05,74.125.24.0-255,2041,14000,63,130991
24283,8.9e-05,172.31.40.0-255,66,14066,63,130991
24284,0.000124,172.31.40.0-255,66,14132,63,130991
24285,0.000214,74.125.24.0-255,1484,15616,63,130991
24286,0.000217,172.31.40.0-255,66,15682,63,130991
24287,0.00024,74.125.24.0-255,3961,19643,63,130991
24288,0.000244,172.31.40.0-255,66,19709,63,130991
24289,0.000767,74.125.24.0-255,1484,21193,63,130991
24290,0.000773,172.31.40.0-255,66,21259,63,130991
24291,0.000781,74.125.24.0-255,2902,24161,63,130991
24292,0.000784,172.31.40.0-255,66,24227,63,130991
24293,0.000791,74.125.24.0-255,5738,29965,63,130991
24294,0.000793,172.31.40.0-255,66,30031,63,130991
24295,0.000846,74.125.24.0-255,4320,34351,63,130991
24296,0.00085,172.31.40.0-255,66,34417,63,130991
24297,0.000913,172.31.40.0-255,66,34483,63,130991
24298,0.000931,74.125.24.0-255,3961,38444,63,130991
24299,0.000934,172.31.40.0-255,66,38510,63,130991
24300,0.001002,74.125.24.0-255,6797,45307,63,130991
24301,0.001006,172.31.40.0-255,66,45373,63,130991
24302,0.001075,74.125.24.0-255,4320,49693,63,130991
24303,0.00108,172.31.40.0-255,66,49759,63,130991
24304,0.0011,74.125.24.0-255,2902,52661,63,130991
24305,0.001103,172.31.40.0-255,66,52727,63,130991
24306,0.001165,74.125.24.0-255,5738,58465,63,130991
24307,0.00117,172.31.40.0-255,66,58531,63,130991
24308,0.001196,172.31.40.0-255,66,58597,63,130991
24309,0.001318,172.31.40.0-255,66,58663,63,130991
24310,0.001349,74.125.24.0-255,2184,60847,63,130991
24311,0.001352,172.31.40.0-255,66,60913,63,130991
24312,0.001377,74.125.24.0-255,1484,62397,63,130991
24313,0.001402,172.31.40.0-255,66,62463,63,130991
24314,0.001502,74.125.24.0-255,3841,66304,63,130991
24315,0.001531,74.125.24.0-255,2902,69206,63,130991
24316,0.001573,74.125.24.0-255,6079,75285,63,130991
24317,0.001913,74.125.24.0-255,7156,82441,63,130991
24318,0.001931,74.125.24.0-255,3602,86043,63,130991
24319,0.002012,74.125.24.0-255,5738,91781,63,130991
24320,0.002335,74.125.24.0-255,4320,96101,63,130991
24321,0.006351,172.31.40.0-255,66,96167,63,130991
24322,0.008395,74.125.24.0-255,5738,101905,63,130991
24323,0.008402,172.31.40.0-255,66,101971,63,130991
24324,0.010495,74.125.24.0-255,5738,107709,63,130991
24325,0.010503,172.31.40.0-255,66,107775,63,130991
24326,0.012567,74.125.24.0-255,5738,113513,63,130991
24327,0.012575,172.31.40.0-255,66,113579,63,130991
24328,0.014655,74.125.24.0-255,5738,119317,63,130991
24329,0.014664,172.31.40.0-255,66,119383,63,130991
24330,0.01674,74.125.24.0-255,5738,125121,63,130991
24331,0.016759,172.31.40.0-255,66,125187,63,130991
24332,0.01884,74.125.24.0-255,5738,130925,63,130991
24333,0.018854,172.31.40.0-255,66,130991,63,130991
24334,0.0,172.217.194.0-255,153,153,63,236444
24335,1.6e-05,172.31.40.0-255,66,219,63,236444
24336,2.3e-05,172.217.194.0-255,1484,1703,63,236444
24337,2.7e-05,172.31.40.0-255,66,1769,63,236444
24338,3.2e-05,172.217.194.0-255,2902,4671,63,236444
24339,3.5e-05,172.31.40.0-255,66,4737,63,236444
24340,5e-05,172.217.194.0-255,7156,11893,63,236444
24341,5.3e-05,172.31.40.0-255,66,11959,63,236444
24342,5.7e-05,172.217.194.0-255,2039,13998,63,236444
24343,5.9e-05,172.31.40.0-255,66,14064,63,236444
24344,0.000287,172.217.194.0-255,1484,15548,63,236444
24345,0.000292,172.31.40.0-255,66,15614,63,236444
24346,0.000299,172.217.194.0-255,2902,18516,63,236444
24347,0.000301,172.31.40.0-255,66,18582,63,236444
24348,0.000312,172.217.194.0-255,5738,24320,63,236444
24349,0.000314,172.31.40.0-255,66,24386,63,236444
24350,0.000359,172.217.194.0-255,6797,31183,63,236444
24351,0.000362,172.31.40.0-255,66,31249,63,236444
24352,0.000407,172.217.194.0-255,1484,32733,63,236444
24353,0.000411,172.31.40.0-255,66,32799,63,236444
24354,0.00042,172.217.194.0-255,2902,35701,63,236444
24355,0.000421,172.31.40.0-255,66,35767,63,236444
24356,0.000428,172.217.194.0-255,1484,37251,63,236444
24357,0.00043,172.31.40.0-255,66,37317,63,236444
24358,0.000463,172.217.194.0-255,4320,41637,63,236444
24359,0.000465,172.31.40.0-255,66,41703,63,236444
24360,0.000472,172.217.194.0-255,6797,48500,63,236444
24361,0.000474,172.31.40.0-255,66,48566,63,236444
24362,0.000503,172.217.194.0-255,1484,50050,63,236444
24363,0.000505,172.31.40.0-255,66,50116,63,236444
24364,0.000513,172.217.194.0-255,2902,53018,63,236444
24365,0.000515,172.31.40.0-255,66,53084,63,236444
24366,0.00052,172.217.194.0-255,5738,58822,63,236444
24367,0.000522,172.31.40.0-255,66,58888,63,236444
24368,0.00055,172.217.194.0-255,5738,64626,63,236444
24369,0.000552,172.31.40.0-255,66,64692,63,236444
24370,0.000575,172.217.194.0-255,1435,66127,63,236444
24371,0.000624,172.217.194.0-255,99,66226,63,236444
24372,0.000655,172.217.194.0-255,365,66591,63,236444
24373,0.000658,172.31.40.0-255,66,66657,63,236444
24374,0.000822,172.217.194.0-255,1484,68141,63,236444
24375,0.000826,172.217.194.0-255,1484,69625,63,236444
24376,0.000828,172.31.40.0-255,66,69691,63,236444
24377,0.000851,172.217.194.0-255,1484,71175,63,236444
24378,0.000858,172.217.194.0-255,5738,76913,63,236444
24379,0.00086,172.31.40.0-255,66,76979,63,236444
24380,0.000865,172.217.194.0-255,5738,82717,63,236444
24381,0.000867,172.31.40.0-255,66,82783,63,236444
24382,0.000891,172.217.194.0-255,2902,85685,63,236444
24383,0.000893,172.31.40.0-255,66,85751,63,236444
24384,0.000922,172.31.40.0-255,66,85817,63,236444
24385,0.00094,172.217.194.0-255,5020,90837,63,236444
24386,0.000942,172.31.40.0-255,66,90903,63,236444
24387,0.001028,172.217.194.0-255,1484,92387,63,236444
24388,0.001032,172.217.194.0-255,1484,93871,63,236444
24389,0.001034,172.31.40.0-255,66,93937,63,236444
24390,0.001061,172.217.194.0-255,1484,95421,63,236444
24391,0.001067,172.217.194.0-255,5738,101159,63,236444
24392,0.001069,172.31.40.0-255,66,101225,63,236444
24393,0.001116,172.31.40.0-255,66,101291,63,236444
24394,0.001144,172.217.194.0-255,2902,104193,63,236444
24395,0.001146,172.31.40.0-255,66,104259,63,236444
24396,0.001168,172.31.40.0-255,66,104325,63,236444
24397,0.00126,172.217.194.0-255,1484,105809,63,236444
24398,0.001279,172.217.194.0-255,2902,108711,63,236444
24399,0.001283,172.31.40.0-255,66,108777,63,236444
24400,0.001308,172.217.194.0-255,2902,111679,63,236444
24401,0.001311,172.217.194.0-255,1484,113163,63,236444
24402,0.001316,172.31.40.0-255,66,113229,63,236444
24403,0.001344,172.217.194.0-255,5738,118967,63,236444
24404,0.001347,172.31.40.0-255,66,119033,63,236444
24405,0.00136,172.31.40.0-255,66,119099,63,236444
24406,0.001391,172.217.194.0-255,4320,123419,63,236444
24407,0.001395,172.31.40.0-255,66,123485,63,236444
24408,0.0014,172.217.194.0-255,3602,127087,63,236444
24409,0.001403,172.31.40.0-255,66,127153,63,236444
24410,0.001409,172.217.194.0-255,5738,132891,63,236444
24411,0.001411,172.31.40.0-255,66,132957,63,236444
24412,0.001418,172.217.194.0-255,7156,140113,63,236444
24413,0.001421,172.31.40.0-255,66,140179,63,236444
24414,0.00145,172.217.194.0-255,7156,147335,63,236444
24415,0.001453,172.31.40.0-255,66,147401,63,236444
24416,0.001499,172.217.194.0-255,7156,154557,63,236444
24417,0.001502,172.31.40.0-255,66,154623,63,236444
24418,0.001509,172.217.194.0-255,6438,161061,63,236444
24419,0.001511,172.31.40.0-255,66,161127,63,236444
24420,0.001574,172.217.194.0-255,1484,162611,63,236444
24421,0.001593,172.217.194.0-255,2902,165513,63,236444
24422,0.001596,172.31.40.0-255,66,165579,63,236444
24423,0.001621,172.217.194.0-255,4320,169899,63,236444
24424,0.00163,172.31.40.0-255,66,169965,63,236444
24425,0.001633,172.217.194.0-255,1484,171449,63,236444
24426,0.001654,172.217.194.0-255,4320,175769,63,236444
24427,0.001656,172.31.40.0-255,66,175835,63,236444
24428,0.001687,172.217.194.0-255,4320,180155,63,236444
24429,0.00169,172.31.40.0-255,66,180221,63,236444
24430,0.001711,172.31.40.0-255,66,180287,63,236444
24431,0.001713,172.217.194.0-255,1484,181771,63,236444
24432,0.001717,172.217.194.0-255,2902,184673,63,236444
24433,0.001719,172.31.40.0-255,66,184739,63,236444
24434,0.001757,172.217.194.0-255,5738,190477,63,236444
24435,0.00176,172.31.40.0-255,66,190543,63,236444
24436,0.001772,172.217.194.0-255,5738,196281,63,236444
24437,0.001775,172.31.40.0-255,66,196347,63,236444
24438,0.00179,172.31.40.0-255,66,196413,63,236444
24439,0.001822,172.217.194.0-255,5020,201433,63,236444
24440,0.001826,172.31.40.0-255,66,201499,63,236444
24441,0.001899,172.217.194.0-255,1484,202983,63,236444
24442,0.001905,172.217.194.0-255,2902,205885,63,236444
24443,0.001908,172.31.40.0-255,66,205951,63,236444
24444,0.00193,172.217.194.0-255,5738,211689,63,236444
24445,0.001933,172.31.40.0-255,66,211755,63,236444
24446,0.001998,172.217.194.0-255,4320,216075,63,236444
24447,0.002003,172.31.40.0-255,66,216141,63,236444
24448,0.002005,172.31.40.0-255,66,216207,63,236444
24449,0.002014,172.217.194.0-255,2902,219109,63,236444
24450,0.002017,172.31.40.0-255,66,219175,63,236444
24451,0.002019,172.217.194.0-255,1484,220659,63,236444
24452,0.002044,172.217.194.0-255,2184,222843,63,236444
24453,0.002047,172.31.40.0-255,66,222909,63,236444
24454,0.002052,172.217.194.0-255,4320,227229,63,236444
24455,0.002054,172.31.40.0-255,66,227295,63,236444
24456,0.002057,172.217.194.0-255,1484,228779,63,236444
24457,0.002098,172.31.40.0-255,66,228845,63,236444
24458,0.002111,172.31.40.0-255,66,228911,63,236444
24459,0.002118,172.217.194.0-255,5738,234649,63,236444
24460,0.002121,172.31.40.0-255,66,234715,63,236444
24461,0.002179,172.31.40.0-255,66,234781,63,236444
24462,0.002194,172.31.40.0-255,66,234847,63,236444
24463,0.002232,172.31.40.0-255,66,234913,63,236444
24464,0.002274,172.31.40.0-255,66,234979,63,236444
24465,0.002277,172.217.194.0-255,940,235919,63,236444
24466,0.004462,172.217.194.0-255,105,236024,63,236444
24467,0.011362,172.31.40.0-255,66,236090,63,236444
24468,0.011404,172.31.40.0-255,105,236195,63,236444
24469,0.01195,172.217.194.0-255,105,236300,63,236444
24470,0.011959,172.31.40.0-255,78,236378,63,236444
24471,0.013597,172.217.194.0-255,66,236444,63,236444
24472,0.0,74.125.24.0-255,152,152,63,148088
24473,1.4e-05,172.31.40.0-255,66,218,63,148088
24474,2.1e-05,74.125.24.0-255,1484,1702,63,148088
24475,2.5e-05,172.31.40.0-255,66,1768,63,148088
24476,3.1e-05,74.125.24.0-255,2902,4670,63,148088
24477,3.4e-05,172.31.40.0-255,66,4736,63,148088
24478,4.2e-05,74.125.24.0-255,7156,11892,63,148088
24479,4.5e-05,172.31.40.0-255,66,11958,63,148088
24480,7.2e-05,74.125.24.0-255,2156,14114,63,148088
24481,7.4e-05,172.31.40.0-255,66,14180,63,148088
24482,7.9e-05,74.125.24.0-255,2902,17082,63,148088
24483,8.2e-05,172.31.40.0-255,66,17148,63,148088
24484,0.000106,74.125.24.0-255,7156,24304,63,148088
24485,0.000108,172.31.40.0-255,66,24370,63,148088
24486,0.000142,74.125.24.0-255,6797,31167,63,148088
24487,0.000144,172.31.40.0-255,66,31233,63,148088
24488,0.000438,74.125.24.0-255,1484,32717,63,148088
24489,0.000444,172.31.40.0-255,66,32783,63,148088
24490,0.000452,74.125.24.0-255,2902,35685,63,148088
24491,0.000454,172.31.40.0-255,66,35751,63,148088
24492,0.000462,74.125.24.0-255,5738,41489,63,148088
24493,0.000464,172.31.40.0-255,66,41555,63,148088
24494,0.000493,172.31.40.0-255,66,41621,63,148088
24495,0.000514,74.125.24.0-255,3961,45582,63,148088
24496,0.000517,172.31.40.0-255,66,45648,63,148088
24497,0.000554,172.31.40.0-255,66,45714,63,148088
24498,0.000573,74.125.24.0-255,2543,48257,63,148088
24499,0.000576,172.31.40.0-255,66,48323,63,148088
24500,0.000841,74.125.24.0-255,645,48968,63,148088
24501,0.000845,172.31.40.0-255,66,49034,63,148088
24502,0.000952,74.125.24.0-255,1484,50518,63,148088
24503,0.000966,74.125.24.0-255,2902,53420,63,148088
24504,0.000969,172.31.40.0-255,66,53486,63,148088
24505,0.001,74.125.24.0-255,5738,59224,63,148088
24506,0.001003,172.31.40.0-255,66,59290,63,148088
24507,0.001007,74.125.24.0-255,1484,60774,63,148088
24508,0.001025,74.125.24.0-255,4320,65094,63,148088
24509,0.001029,172.31.40.0-255,66,65160,63,148088
24510,0.001037,74.125.24.0-255,1484,66644,63,148088
24511,0.00106,172.31.40.0-255,66,66710,63,148088
24512,0.001064,74.125.24.0-255,2902,69612,63,148088
24513,0.001066,172.31.40.0-255,66,69678,63,148088
24514,0.00108,74.125.24.0-255,2184,71862,63,148088
24515,0.001083,172.31.40.0-255,66,71928,63,148088
24516,0.001352,74.125.24.0-255,1484,73412,63,148088
24517,0.001358,74.125.24.0-255,2902,76314,63,148088
24518,0.001361,172.31.40.0-255,66,76380,63,148088
24519,0.001367,74.125.24.0-255,2902,79282,63,148088
24520,0.001368,172.31.40.0-255,66,79348,63,148088
24521,0.001384,74.125.24.0-255,2902,82250,63,148088
24522,0.001386,172.31.40.0-255,66,82316,63,148088
24523,0.0014,74.125.24.0-255,1484,83800,63,148088
24524,0.001426,172.31.40.0-255,66,83866,63,148088
24525,0.001468,172.31.40.0-255,66,83932,63,148088
24526,0.001486,74.125.24.0-255,2184,86116,63,148088
24527,0.001489,172.31.40.0-255,66,86182,63,148088
24528,0.002233,74.125.24.0-255,1484,87666,63,148088
24529,0.002245,74.125.24.0-255,2902,90568,63,148088
24530,0.002249,172.31.40.0-255,66,90634,63,148088
24531,0.002258,74.125.24.0-255,5738,96372,63,148088
24532,0.00226,172.31.40.0-255,66,96438,63,148088
24533,0.002264,74.125.24.0-255,2902,99340,63,148088
24534,0.002266,172.31.40.0-255,66,99406,63,148088
24535,0.002305,172.31.40.0-255,66,99472,63,148088
24536,0.002322,74.125.24.0-255,1484,100956,63,148088
24537,0.00233,74.125.24.0-255,6438,107394,63,148088
24538,0.002332,172.31.40.0-255,66,107460,63,148088
24539,0.004633,74.125.24.0-255,5738,113198,63,148088
24540,0.004638,172.31.40.0-255,66,113264,63,148088
24541,0.006924,74.125.24.0-255,5738,119002,63,148088
24542,0.00693,172.31.40.0-255,66,119068,63,148088
24543,0.009233,74.125.24.0-255,5738,124806,63,148088
24544,0.009256,172.31.40.0-255,66,124872,63,148088
24545,0.011566,74.125.24.0-255,5738,130610,63,148088
24546,0.011574,172.31.40.0-255,66,130676,63,148088
24547,0.013882,74.125.24.0-255,5738,136414,63,148088
24548,0.013891,172.31.40.0-255,66,136480,63,148088
24549,0.016245,74.125.24.0-255,5738,142218,63,148088
24550,0.016255,172.31.40.0-255,66,142284,63,148088
24551,0.018576,74.125.24.0-255,5738,148022,63,148088
24552,0.018584,172.31.40.0-255,66,148088,63,148088
24553,0.0,74.125.24.0-255,153,153,63,108288
24554,2.1e-05,172.31.40.0-255,66,219,63,108288
24555,2.7e-05,74.125.24.0-255,1484,1703,63,108288
24556,3.1e-05,172.31.40.0-255,66,1769,63,108288
24557,3.6e-05,74.125.24.0-255,2902,4671,63,108288
24558,3.9e-05,172.31.40.0-255,66,4737,63,108288
24559,5.2e-05,74.125.24.0-255,5738,10475,63,108288
24560,5.5e-05,172.31.40.0-255,66,10541,63,108288
24561,0.000118,74.125.24.0-255,2902,13443,63,108288
24562,0.000121,172.31.40.0-255,66,13509,63,108288
24563,0.000161,172.31.40.0-255,66,13575,63,108288
24564,0.000304,172.31.40.0-255,66,13641,63,108288
24565,0.000335,74.125.24.0-255,1484,15125,63,108288
24566,0.000337,172.31.40.0-255,66,15191,63,108288
24567,0.000422,74.125.24.0-255,7156,22347,63,108288
24568,0.000427,172.31.40.0-255,66,22413,63,108288
24569,0.00047,172.31.40.0-255,66,22479,63,108288
24570,0.000727,74.125.24.0-255,5651,28130,63,108288
24571,0.000732,172.31.40.0-255,66,28196,63,108288
24572,0.000794,74.125.24.0-255,2902,31098,63,108288
24573,0.000798,172.31.40.0-255,66,31164,63,108288
24574,0.000843,172.31.40.0-255,66,31230,63,108288
24575,0.001185,74.125.24.0-255,766,31996,63,108288
24576,0.001189,172.31.40.0-255,66,32062,63,108288
24577,0.001217,74.125.24.0-255,1484,33546,63,108288
24578,0.00122,172.31.40.0-255,66,33612,63,108288
24579,0.001253,74.125.24.0-255,4320,37932,63,108288
24580,0.001256,172.31.40.0-255,66,37998,63,108288
24581,0.001289,74.125.24.0-255,5738,43736,63,108288
24582,0.001304,74.125.24.0-255,4320,48056,63,108288
24583,0.001312,172.31.40.0-255,66,48122,63,108288
24584,0.001406,74.125.24.0-255,5738,53860,63,108288
24585,0.001412,172.31.40.0-255,66,53926,63,108288
24586,0.001432,74.125.24.0-255,2902,56828,63,108288
24587,0.001446,172.31.40.0-255,66,56894,63,108288
24588,0.001519,74.125.24.0-255,7156,64050,63,108288
24589,0.001538,74.125.24.0-255,2184,66234,63,108288
24590,0.00155,172.31.40.0-255,66,66300,63,108288
24591,0.001641,74.125.24.0-255,5738,72038,63,108288
24592,0.001645,172.31.40.0-255,66,72104,63,108288
24593,0.001677,74.125.24.0-255,4320,76424,63,108288
24594,0.001682,172.31.40.0-255,66,76490,63,108288
24595,0.001757,74.125.24.0-255,5738,82228,63,108288
24596,0.001766,172.31.40.0-255,66,82294,63,108288
24597,0.001805,172.31.40.0-255,66,82360,63,108288
24598,0.001953,74.125.24.0-255,4320,86680,63,108288
24599,0.001957,172.31.40.0-255,66,86746,63,108288
24600,0.002004,74.125.24.0-255,3602,90348,63,108288
24601,0.002016,172.31.40.0-255,66,90414,63,108288
24602,0.002256,74.125.24.0-255,5738,96152,63,108288
24603,0.002261,172.31.40.0-255,66,96218,63,108288
24604,0.002322,172.31.40.0-255,66,96284,63,108288
24605,0.002493,172.31.40.0-255,66,96350,63,108288
24606,0.002578,172.31.40.0-255,66,96416,63,108288
24607,0.00306,172.31.40.0-255,66,96482,63,108288
24608,0.013599,74.125.24.0-255,1484,97966,63,108288
24609,0.014463,172.31.40.0-255,66,98032,63,108288
24610,0.016896,74.125.24.0-255,4320,102352,63,108288
24611,0.016903,172.31.40.0-255,66,102418,63,108288
24612,0.01692,74.125.24.0-255,1484,103902,63,108288
24613,0.019273,74.125.24.0-255,4320,108222,63,108288
24614,0.01928,172.31.40.0-255,66,108288,63,108288
24615,0.0,74.125.24.0-255,152,152,63,156553
24616,2.3e-05,172.31.40.0-255,66,218,63,156553
24617,4.1e-05,74.125.24.0-255,1484,1702,63,156553
24618,4.6e-05,172.31.40.0-255,66,1768,63,156553
24619,5.2e-05,74.125.24.0-255,2902,4670,63,156553
24620,5.5e-05,172.31.40.0-255,66,4736,63,156553
24621,7.6e-05,74.125.24.0-255,2902,7638,63,156553
24622,7.8e-05,172.31.40.0-255,66,7704,63,156553
24623,8.4e-05,74.125.24.0-255,4320,12024,63,156553
24624,8.6e-05,172.31.40.0-255,66,12090,63,156553
24625,0.000128,74.125.24.0-255,7156,19246,63,156553
24626,0.00013,172.31.40.0-255,66,19312,63,156553
24627,0.000154,74.125.24.0-255,1967,21279,63,156553
24628,0.000156,172.31.40.0-255,66,21345,63,156553
24629,0.000171,172.31.40.0-255,66,21411,63,156553
24630,0.000241,74.125.24.0-255,1484,22895,63,156553
24631,0.000244,172.31.40.0-255,66,22961,63,156553
24632,0.000247,74.125.24.0-255,1484,24445,63,156553
24633,0.00025,172.31.40.0-255,66,24511,63,156553
24634,0.000267,74.125.24.0-255,1484,25995,63,156553
24635,0.000269,172.31.40.0-255,66,26061,63,156553
24636,0.000274,74.125.24.0-255,5738,31799,63,156553
24637,0.000277,172.31.40.0-255,66,31865,63,156553
24638,0.000282,74.125.24.0-255,4320,36185,63,156553
24639,0.000285,172.31.40.0-255,66,36251,63,156553
24640,0.000336,172.31.40.0-255,66,36317,63,156553
24641,0.000344,74.125.24.0-255,7071,43388,63,156553
24642,0.000346,172.31.40.0-255,66,43454,63,156553
24643,0.000367,74.125.24.0-255,384,43838,63,156553
24644,0.000369,172.31.40.0-255,66,43904,63,156553
24645,0.000488,74.125.24.0-255,1484,45388,63,156553
24646,0.00051,74.125.24.0-255,2902,48290,63,156553
24647,0.000514,74.125.24.0-255,2902,51192,63,156553
24648,0.000536,74.125.24.0-255,2902,54094,63,156553
24649,0.000541,74.125.24.0-255,4320,58414,63,156553
24650,0.000544,172.31.40.0-255,66,58480,63,156553
24651,0.00055,172.31.40.0-255,66,58546,63,156553
24652,0.000589,74.125.24.0-255,6797,65343,63,156553
24653,0.000595,172.31.40.0-255,66,65409,63,156553
24654,0.000653,74.125.24.0-255,1484,66893,63,156553
24655,0.000658,74.125.24.0-255,1484,68377,63,156553
24656,0.00067,172.31.40.0-255,66,68443,63,156553
24657,0.00068,74.125.24.0-255,1484,69927,63,156553
24658,0.000687,74.125.24.0-255,5738,75665,63,156553
24659,0.000691,74.125.24.0-255,2902,78567,63,156553
24660,0.000697,74.125.24.0-255,4320,82887,63,156553
24661,0.000702,172.31.40.0-255,66,82953,63,156553
24662,0.000722,74.125.24.0-255,5738,88691,63,156553
24663,0.000725,74.125.24.0-255,1484,90175,63,156553
24664,0.000732,172.31.40.0-255,66,90241,63,156553
24665,0.000752,172.31.40.0-255,66,90307,63,156553
24666,0.000836,74.125.24.0-255,1484,91791,63,156553
24667,0.00084,74.125.24.0-255,1484,93275,63,156553
24668,0.00085,172.31.40.0-255,66,93341,63,156553
24669,0.000862,74.125.24.0-255,1484,94825,63,156553
24670,0.00087,74.125.24.0-255,5738,100563,63,156553
24671,0.000884,74.125.24.0-255,5738,106301,63,156553
24672,0.000902,74.125.24.0-255,7156,113457,63,156553
24673,0.000905,74.125.24.0-255,1484,114941,63,156553
24674,0.000909,172.31.40.0-255,66,115007,63,156553
24675,0.000962,74.125.24.0-255,766,115773,63,156553
24676,0.000972,172.31.40.0-255,66,115839,63,156553
24677,0.001217,74.125.24.0-255,1484,117323,63,156553
24678,0.001222,74.125.24.0-255,2902,120225,63,156553
24679,0.001227,172.31.40.0-255,66,120291,63,156553
24680,0.001236,74.125.24.0-255,2902,123193,63,156553
24681,0.001251,74.125.24.0-255,2902,126095,63,156553
24682,0.001257,74.125.24.0-255,4320,130415,63,156553
24683,0.001267,172.31.40.0-255,66,130481,63,156553
24684,0.001288,74.125.24.0-255,2902,133383,63,156553
24685,0.0013,172.31.40.0-255,66,133449,63,156553
24686,0.001399,172.31.40.0-255,66,133515,63,156553
24687,0.001452,74.125.24.0-255,2902,136417,63,156553
24688,0.001485,172.31.40.0-255,66,136483,63,156553
24689,0.001508,74.125.24.0-255,7156,143639,63,156553
24690,0.00152,172.31.40.0-255,66,143705,63,156553
24691,0.001548,74.125.24.0-255,4320,148025,63,156553
24692,0.001552,172.31.40.0-255,66,148091,63,156553
24693,0.001588,74.125.24.0-255,6438,154529,63,156553
24694,0.001617,172.31.40.0-255,66,154595,63,156553
24695,0.001631,172.31.40.0-255,66,154661,63,156553
24696,0.001696,172.31.40.0-255,66,154727,63,156553
24697,0.001703,74.125.24.0-255,1484,156211,63,156553
24698,0.001736,74.125.24.0-255,105,156316,63,156553
24699,0.001753,172.31.40.0-255,66,156382,63,156553
24700,0.011277,172.31.40.0-255,105,156487,63,156553
24701,0.013522,74.125.24.0-255,66,156553,63,156553
24702,0.0,172.31.40.0-255,66,66,63,66
24703,0.0,74.125.68.0-255,150,150,63,256156
24704,2.1e-05,172.31.40.0-255,66,216,63,256156
24705,2.9e-05,74.125.68.0-255,1484,1700,63,256156
24706,3.6e-05,172.31.40.0-255,66,1766,63,256156
24707,4.2e-05,74.125.68.0-255,2902,4668,63,256156
24708,4.5e-05,172.31.40.0-255,66,4734,63,256156
24709,5.3e-05,74.125.68.0-255,5738,10472,63,256156
24710,5.6e-05,172.31.40.0-255,66,10538,63,256156
24711,8.1e-05,74.125.68.0-255,1484,12022,63,256156
24712,8.4e-05,172.31.40.0-255,66,12088,63,256156
24713,9e-05,74.125.68.0-255,4320,16408,63,256156
24714,9.2e-05,172.31.40.0-255,66,16474,63,256156
24715,0.00011,74.125.68.0-255,3519,19993,63,256156
24716,0.000113,172.31.40.0-255,66,20059,63,256156
24717,0.000121,74.125.68.0-255,7156,27215,63,256156
24718,0.000123,172.31.40.0-255,66,27281,63,256156
24719,0.000154,74.125.68.0-255,3961,31242,63,256156
24720,0.000157,172.31.40.0-255,66,31308,63,256156
24721,0.0002,74.125.68.0-255,1484,32792,63,256156
24722,0.000202,172.31.40.0-255,66,32858,63,256156
24723,0.000218,74.125.68.0-255,2902,35760,63,256156
24724,0.000221,172.31.40.0-255,66,35826,63,256156
24725,0.000247,74.125.68.0-255,4320,40146,63,256156
24726,0.000249,172.31.40.0-255,66,40212,63,256156
24727,0.000255,74.125.68.0-255,5738,45950,63,256156
24728,0.000258,172.31.40.0-255,66,46016,63,256156
24729,0.000288,74.125.68.0-255,2543,48559,63,256156
24730,0.00029,172.31.40.0-255,66,48625,63,256156
24731,0.000555,74.125.68.0-255,1484,50109,63,256156
24732,0.00056,172.31.40.0-255,66,50175,63,256156
24733,0.000565,74.125.68.0-255,1484,51659,63,256156
24734,0.000566,172.31.40.0-255,66,51725,63,256156
24735,0.000571,74.125.68.0-255,2902,54627,63,256156
24736,0.000574,172.31.40.0-255,66,54693,63,256156
24737,0.000577,74.125.68.0-255,1484,56177,63,256156
24738,0.000601,74.125.68.0-255,4320,60497,63,256156
24739,0.000604,172.31.40.0-255,66,60563,63,256156
24740,0.00063,74.125.68.0-255,5379,65942,63,256156
24741,0.000633,172.31.40.0-255,66,66008,63,256156
24742,0.000663,74.125.68.0-255,2902,68910,63,256156
24743,0.000666,172.31.40.0-255,66,68976,63,256156
24744,0.000685,74.125.68.0-255,2902,71878,63,256156
24745,0.000688,172.31.40.0-255,66,71944,63,256156
24746,0.000695,74.125.68.0-255,7156,79100,63,256156
24747,0.000698,172.31.40.0-255,66,79166,63,256156
24748,0.00073,74.125.68.0-255,3961,83127,63,256156
24749,0.000734,172.31.40.0-255,66,83193,63,256156
24750,0.000765,74.125.68.0-255,2065,85258,63,256156
24751,0.000768,172.31.40.0-255,66,85324,63,256156
24752,0.000771,74.125.68.0-255,1484,86808,63,256156
24753,0.000786,74.125.68.0-255,1484,88292,63,256156
24754,0.000788,172.31.40.0-255,66,88358,63,256156
24755,0.000793,74.125.68.0-255,2902,91260,63,256156
24756,0.000795,172.31.40.0-255,66,91326,63,256156
24757,0.000812,74.125.68.0-255,4320,95646,63,256156
24758,0.000815,172.31.40.0-255,66,95712,63,256156
24759,0.00082,74.125.68.0-255,5379,101091,63,256156
24760,0.000823,172.31.40.0-255,66,101157,63,256156
24761,0.000967,74.125.68.0-255,1484,102641,63,256156
24762,0.000985,74.125.68.0-255,2902,105543,63,256156
24763,0.000988,172.31.40.0-255,66,105609,63,256156
24764,0.001007,74.125.68.0-255,2902,108511,63,256156
24765,0.00101,172.31.40.0-255,66,108577,63,256156
24766,0.001028,74.125.68.0-255,2902,111479,63,256156
24767,0.00103,172.31.40.0-255,66,111545,63,256156
24768,0.001036,74.125.68.0-255,4320,115865,63,256156
24769,0.001038,172.31.40.0-255,66,115931,63,256156
24770,0.001058,74.125.68.0-255,1993,117924,63,256156
24771,0.00106,172.31.40.0-255,66,117990,63,256156
24772,0.001173,74.125.68.0-255,1484,119474,63,256156
24773,0.001179,74.125.68.0-255,2902,122376,63,256156
24774,0.001182,172.31.40.0-255,66,122442,63,256156
24775,0.001236,74.125.68.0-255,2902,125344,63,256156
24776,0.001239,172.31.40.0-255,66,125410,63,256156
24777,0.001257,74.125.68.0-255,1484,126894,63,256156
24778,0.00128,74.125.68.0-255,2902,129796,63,256156
24779,0.001283,172.31.40.0-255,66,129862,63,256156
24780,0.001286,74.125.68.0-255,1484,131346,63,256156
24781,0.001313,74.125.68.0-255,2902,134248,63,256156
24782,0.001316,172.31.40.0-255,66,134314,63,256156
24783,0.001319,74.125.68.0-255,1484,135798,63,256156
24784,0.001332,74.125.68.0-255,1484,137282,63,256156
24785,0.001336,172.31.40.0-255,66,137348,63,256156
24786,0.001354,74.125.68.0-255,1484,138832,63,256156
24787,0.001367,74.125.68.0-255,2902,141734,63,256156
24788,0.001369,172.31.40.0-255,66,141800,63,256156
24789,0.001373,74.125.68.0-255,1484,143284,63,256156
24790,0.001394,74.125.68.0-255,2902,146186,63,256156
24791,0.001397,172.31.40.0-255,66,146252,63,256156
24792,0.001425,74.125.68.0-255,1484,147736,63,256156
24793,0.001439,74.125.68.0-255,1484,149220,63,256156
24794,0.001442,172.31.40.0-255,66,149286,63,256156
24795,0.001476,74.125.68.0-255,1484,150770,63,256156
24796,0.001492,74.125.68.0-255,2184,152954,63,256156
24797,0.001496,172.31.40.0-255,66,153020,63,256156
24798,0.001658,74.125.68.0-255,1484,154504,63,256156
24799,0.001671,74.125.68.0-255,1484,155988,63,256156
24800,0.001675,172.31.40.0-255,66,156054,63,256156
24801,0.001698,74.125.68.0-255,2902,158956,63,256156
24802,0.001701,172.31.40.0-255,66,159022,63,256156
24803,0.001718,74.125.68.0-255,2902,161924,63,256156
24804,0.001721,172.31.40.0-255,66,161990,63,256156
24805,0.001735,74.125.68.0-255,2902,164892,63,256156
24806,0.001737,172.31.40.0-255,66,164958,63,256156
24807,0.001742,74.125.68.0-255,2902,167860,63,256156
24808,0.001744,172.31.40.0-255,66,167926,63,256156
24809,0.001767,74.125.68.0-255,4320,172246,63,256156
24810,0.00177,172.31.40.0-255,66,172312,63,256156
24811,0.001792,74.125.68.0-255,1484,173796,63,256156
24812,0.001833,74.125.68.0-255,1484,175280,63,256156
24813,0.001836,172.31.40.0-255,66,175346,63,256156
24814,0.001842,74.125.68.0-255,2902,178248,63,256156
24815,0.001844,172.31.40.0-255,66,178314,63,256156
24816,0.001872,74.125.68.0-255,4320,182634,63,256156
24817,0.001875,172.31.40.0-255,66,182700,63,256156
24818,0.001893,74.125.68.0-255,1484,184184,63,256156
24819,0.001896,74.125.68.0-255,1484,185668,63,256156
24820,0.001898,172.31.40.0-255,66,185734,63,256156
24821,0.001903,74.125.68.0-255,2184,187918,63,256156
24822,0.001905,172.31.40.0-255,66,187984,63,256156
24823,0.002026,74.125.68.0-255,1484,189468,63,256156
24824,0.002041,74.125.68.0-255,2902,192370,63,256156
24825,0.002044,172.31.40.0-255,66,192436,63,256156
24826,0.002084,74.125.68.0-255,5738,198174,63,256156
24827,0.002087,172.31.40.0-255,66,198240,63,256156
24828,0.00209,74.125.68.0-255,1484,199724,63,256156
24829,0.002108,74.125.68.0-255,2902,202626,63,256156
24830,0.00211,172.31.40.0-255,66,202692,63,256156
24831,0.002126,74.125.68.0-255,5738,208430,63,256156
24832,0.002128,172.31.40.0-255,66,208496,63,256156
24833,0.002131,74.125.68.0-255,1484,209980,63,256156
24834,0.002145,74.125.68.0-255,2902,212882,63,256156
24835,0.002148,172.31.40.0-255,66,212948,63,256156
24836,0.002325,74.125.68.0-255,1484,214432,63,256156
24837,0.002377,74.125.68.0-255,2902,217334,63,256156
24838,0.002381,172.31.40.0-255,66,217400,63,256156
24839,0.002385,74.125.68.0-255,1484,218884,63,256156
24840,0.002418,74.125.68.0-255,2902,221786,63,256156
24841,0.002421,172.31.40.0-255,66,221852,63,256156
24842,0.002424,74.125.68.0-255,766,222618,63,256156
24843,0.00302,172.31.40.0-255,66,222684,63,256156
24844,0.005038,74.125.68.0-255,4320,227004,63,256156
24845,0.005045,172.31.40.0-255,66,227070,63,256156
24846,0.00564,74.125.68.0-255,1484,228554,63,256156
24847,0.007659,74.125.68.0-255,4320,232874,63,256156
24848,0.007663,172.31.40.0-255,66,232940,63,256156
24849,0.010317,74.125.68.0-255,5738,238678,63,256156
24850,0.010326,172.31.40.0-255,66,238744,63,256156
24851,0.012951,74.125.68.0-255,5738,244482,63,256156
24852,0.01296,172.31.40.0-255,66,244548,63,256156
24853,0.015613,74.125.68.0-255,5738,250286,63,256156
24854,0.015627,172.31.40.0-255,66,250352,63,256156
24855,0.018267,74.125.68.0-255,5738,256090,63,256156
24856,0.018285,172.31.40.0-255,66,256156,63,256156
24857,0.0,172.253.118.0-255,295,295,63,227305
24858,2.2e-05,172.31.40.0-255,66,361,63,227305
24859,2.9e-05,172.253.118.0-255,1484,1845,63,227305
24860,3.3e-05,172.31.40.0-255,66,1911,63,227305
24861,4e-05,172.253.118.0-255,4320,6231,63,227305
24862,4.4e-05,172.31.40.0-255,66,6297,63,227305
24863,4.9e-05,172.253.118.0-255,2902,9199,63,227305
24864,5.2e-05,172.31.40.0-255,66,9265,63,227305
24865,8.9e-05,172.31.40.0-255,66,9331,63,227305
24866,0.000106,172.253.118.0-255,5738,15069,63,227305
24867,0.000109,172.31.40.0-255,66,15135,63,227305
24868,0.000127,172.253.118.0-255,6797,21932,63,227305
24869,0.00013,172.31.40.0-255,66,21998,63,227305
24870,0.000222,172.253.118.0-255,1484,23482,63,227305
24871,0.000225,172.31.40.0-255,66,23548,63,227305
24872,0.000231,172.253.118.0-255,2902,26450,63,227305
24873,0.000233,172.31.40.0-255,66,26516,63,227305
24874,0.000254,172.253.118.0-255,5738,32254,63,227305
24875,0.000257,172.31.40.0-255,66,32320,63,227305
24876,0.000282,172.253.118.0-255,5738,38058,63,227305
24877,0.000285,172.31.40.0-255,66,38124,63,227305
24878,0.000304,172.31.40.0-255,66,38190,63,227305
24879,0.000316,172.31.40.0-255,66,38256,63,227305
24880,0.000348,172.253.118.0-255,1482,39738,63,227305
24881,0.00035,172.31.40.0-255,66,39804,63,227305
24882,0.000408,172.253.118.0-255,1484,41288,63,227305
24883,0.00041,172.31.40.0-255,66,41354,63,227305
24884,0.000423,172.253.118.0-255,2902,44256,63,227305
24885,0.000426,172.31.40.0-255,66,44322,63,227305
24886,0.000455,172.253.118.0-255,5738,50060,63,227305
24887,0.000459,172.31.40.0-255,66,50126,63,227305
24888,0.000464,172.253.118.0-255,4320,54446,63,227305
24889,0.000467,172.31.40.0-255,66,54512,63,227305
24890,0.00049,172.253.118.0-255,2226,56738,63,227305
24891,0.000493,172.31.40.0-255,66,56804,63,227305
24892,0.000674,172.253.118.0-255,1484,58288,63,227305
24893,0.000682,172.253.118.0-255,2902,61190,63,227305
24894,0.000686,172.31.40.0-255,66,61256,63,227305
24895,0.000693,172.253.118.0-255,5738,66994,63,227305
24896,0.000695,172.31.40.0-255,66,67060,63,227305
24897,0.000713,172.253.118.0-255,7156,74216,63,227305
24898,0.000716,172.31.40.0-255,66,74282,63,227305
24899,0.000754,172.31.40.0-255,66,74348,63,227305
24900,0.000758,172.253.118.0-255,2184,76532,63,227305
24901,0.00076,172.31.40.0-255,66,76598,63,227305
24902,0.001055,172.253.118.0-255,1484,78082,63,227305
24903,0.001061,172.253.118.0-255,2902,80984,63,227305
24904,0.001064,172.31.40.0-255,66,81050,63,227305
24905,0.001069,172.253.118.0-255,2902,83952,63,227305
24906,0.001072,172.31.40.0-255,66,84018,63,227305
24907,0.001086,172.253.118.0-255,2902,86920,63,227305
24908,0.001089,172.31.40.0-255,66,86986,63,227305
24909,0.001094,172.253.118.0-255,4320,91306,63,227305
24910,0.001096,172.31.40.0-255,66,91372,63,227305
24911,0.001131,172.31.40.0-255,66,91438,63,227305
24912,0.001137,172.253.118.0-255,5738,97176,63,227305
24913,0.001139,172.31.40.0-255,66,97242,63,227305
24914,0.001156,172.253.118.0-255,1484,98726,63,227305
24915,0.001171,172.253.118.0-255,3602,102328,63,227305
24916,0.001174,172.31.40.0-255,66,102394,63,227305
24917,0.001233,172.253.118.0-255,1484,103878,63,227305
24918,0.001268,172.253.118.0-255,1484,105362,63,227305
24919,0.001271,172.31.40.0-255,66,105428,63,227305
24920,0.001291,172.253.118.0-255,1484,106912,63,227305
24921,0.001295,172.253.118.0-255,4320,111232,63,227305
24922,0.001314,172.31.40.0-255,66,111298,63,227305
24923,0.001325,172.31.40.0-255,66,111364,63,227305
24924,0.001339,172.31.40.0-255,66,111430,63,227305
24925,0.001358,172.253.118.0-255,3602,115032,63,227305
24926,0.001384,172.31.40.0-255,66,115098,63,227305
24927,0.001399,172.253.118.0-255,4320,119418,63,227305
24928,0.001404,172.253.118.0-255,2902,122320,63,227305
24929,0.001421,172.31.40.0-255,66,122386,63,227305
24930,0.001434,172.253.118.0-255,2902,125288,63,227305
24931,0.001446,172.31.40.0-255,66,125354,63,227305
24932,0.001457,172.253.118.0-255,5738,131092,63,227305
24933,0.001462,172.31.40.0-255,66,131158,63,227305
24934,0.001511,172.253.118.0-255,2184,133342,63,227305
24935,0.001526,172.31.40.0-255,66,133408,63,227305
24936,0.00179,172.253.118.0-255,1484,134892,63,227305
24937,0.001796,172.253.118.0-255,2902,137794,63,227305
24938,0.001799,172.31.40.0-255,66,137860,63,227305
24939,0.001806,172.253.118.0-255,5738,143598,63,227305
24940,0.001808,172.31.40.0-255,66,143664,63,227305
24941,0.001814,172.253.118.0-255,4320,147984,63,227305
24942,0.001841,172.253.118.0-255,5738,153722,63,227305
24943,0.001846,172.31.40.0-255,66,153788,63,227305
24944,0.001856,172.253.118.0-255,5738,159526,63,227305
24945,0.00186,172.31.40.0-255,66,159592,63,227305
24946,0.001895,172.31.40.0-255,66,159658,63,227305
24947,0.001973,172.253.118.0-255,1484,161142,63,227305
24948,0.001979,172.253.118.0-255,2902,164044,63,227305
24949,0.001982,172.31.40.0-255,66,164110,63,227305
24950,0.001989,172.253.118.0-255,5738,169848,63,227305
24951,0.002025,172.253.118.0-255,1484,171332,63,227305
24952,0.002044,172.31.40.0-255,66,171398,63,227305
24953,0.002051,172.253.118.0-255,5738,177136,63,227305
24954,0.002057,172.31.40.0-255,66,177202,63,227305
24955,0.002081,172.253.118.0-255,2902,180104,63,227305
24956,0.002088,172.31.40.0-255,66,180170,63,227305
24957,0.002164,172.31.40.0-255,66,180236,63,227305
24958,0.0022,172.253.118.0-255,1484,181720,63,227305
24959,0.002219,172.253.118.0-255,2902,184622,63,227305
24960,0.002227,172.253.118.0-255,5738,190360,63,227305
24961,0.002241,172.31.40.0-255,66,190426,63,227305
24962,0.002286,172.253.118.0-255,7156,197582,63,227305
24963,0.002307,172.253.118.0-255,5738,203320,63,227305
24964,0.00232,172.253.118.0-255,1484,204804,63,227305
24965,0.00233,172.31.40.0-255,66,204870,63,227305
24966,0.002339,172.253.118.0-255,2902,207772,63,227305
24967,0.002344,172.253.118.0-255,4320,212092,63,227305
24968,0.00235,172.31.40.0-255,66,212158,63,227305
24969,0.002361,172.253.118.0-255,1484,213642,63,227305
24970,0.002373,172.253.118.0-255,2902,216544,63,227305
24971,0.002402,172.253.118.0-255,5738,222282,63,227305
24972,0.002404,172.31.40.0-255,66,222348,63,227305
24973,0.002414,172.253.118.0-255,1484,223832,63,227305
24974,0.002418,172.31.40.0-255,66,223898,63,227305
24975,0.002427,172.253.118.0-255,2902,226800,63,227305
24976,0.002458,172.31.40.0-255,66,226866,63,227305
24977,0.002485,172.253.118.0-255,97,226963,63,227305
24978,0.002487,172.253.118.0-255,105,227068,63,227305
24979,0.002506,172.31.40.0-255,66,227134,63,227305
24980,0.009498,172.31.40.0-255,105,227239,63,227305
24981,0.012013,172.253.118.0-255,66,227305,63,227305
24982,0.0,74.125.24.0-255,150,150,63,266277
24983,2.5e-05,172.31.40.0-255,66,216,63,266277
24984,3.2e-05,74.125.24.0-255,1484,1700,63,266277
24985,3.8e-05,172.31.40.0-255,66,1766,63,266277
24986,4.5e-05,74.125.24.0-255,2902,4668,63,266277
24987,4.8e-05,172.31.40.0-255,66,4734,63,266277
24988,5.6e-05,74.125.24.0-255,5738,10472,63,266277
24989,6.1e-05,172.31.40.0-255,66,10538,63,266277
24990,7.4e-05,172.31.40.0-255,66,10604,63,266277
24991,8e-05,74.125.24.0-255,4320,14924,63,266277
24992,8.3e-05,172.31.40.0-255,66,14990,63,266277
24993,0.000102,74.125.24.0-255,1484,16474,63,266277
24994,0.000105,172.31.40.0-255,66,16540,63,266277
24995,0.000122,74.125.24.0-255,2902,19442,63,266277
24996,0.000126,172.31.40.0-255,66,19508,63,266277
24997,0.000146,74.125.24.0-255,1125,20633,63,266277
24998,0.000149,172.31.40.0-255,66,20699,63,266277
24999,0.0002,74.125.24.0-255,1484,22183,63,266277
25000,0.000203,172.31.40.0-255,66,22249,63,266277
25001,0.000209,74.125.24.0-255,2902,25151,63,266277
25002,0.000211,172.31.40.0-255,66,25217,63,266277
25003,0.000239,74.125.24.0-255,5738,30955,63,266277
25004,0.000242,172.31.40.0-255,66,31021,63,266277
25005,0.000284,172.31.40.0-255,66,31087,63,266277
25006,0.000291,74.125.24.0-255,5738,36825,63,266277
25007,0.000293,172.31.40.0-255,66,36891,63,266277
25008,0.000313,74.125.24.0-255,2902,39793,63,266277
25009,0.000316,172.31.40.0-255,66,39859,63,266277
25010,0.000328,74.125.24.0-255,1484,41343,63,266277
25011,0.00033,172.31.40.0-255,66,41409,63,266277
25012,0.00035,74.125.24.0-255,5646,47055,63,266277
25013,0.000353,172.31.40.0-255,66,47121,63,266277
25014,0.000356,74.125.24.0-255,388,47509,63,266277
25015,0.000424,74.125.24.0-255,1484,48993,63,266277
25016,0.000428,172.31.40.0-255,66,49059,63,266277
25017,0.000431,74.125.24.0-255,1484,50543,63,266277
25018,0.000442,74.125.24.0-255,1484,52027,63,266277
25019,0.000445,172.31.40.0-255,66,52093,63,266277
25020,0.000453,74.125.24.0-255,5738,57831,63,266277
25021,0.000455,172.31.40.0-255,66,57897,63,266277
25022,0.000474,74.125.24.0-255,4320,62217,63,266277
25023,0.000477,172.31.40.0-255,66,62283,63,266277
25024,0.000498,74.125.24.0-255,1994,64277,63,266277
25025,0.000501,172.31.40.0-255,66,64343,63,266277
25026,0.000621,74.125.24.0-255,1484,65827,63,266277
25027,0.000628,74.125.24.0-255,2902,68729,63,266277
25028,0.000632,172.31.40.0-255,66,68795,63,266277
25029,0.000658,74.125.24.0-255,5738,74533,63,266277
25030,0.000663,172.31.40.0-255,66,74599,63,266277
25031,0.000678,74.125.24.0-255,2902,77501,63,266277
25032,0.000681,172.31.40.0-255,66,77567,63,266277
25033,0.000715,172.31.40.0-255,66,77633,63,266277
25034,0.000718,74.125.24.0-255,1484,79117,63,266277
25035,0.000737,74.125.24.0-255,5738,84855,63,266277
25036,0.00074,172.31.40.0-255,66,84921,63,266277
25037,0.000761,74.125.24.0-255,3602,88523,63,266277
25038,0.000764,172.31.40.0-255,66,88589,63,266277
25039,0.001298,74.125.24.0-255,1484,90073,63,266277
25040,0.001329,74.125.24.0-255,2902,92975,63,266277
25041,0.001334,172.31.40.0-255,66,93041,63,266277
25042,0.001356,74.125.24.0-255,4320,97361,63,266277
25043,0.001359,172.31.40.0-255,66,97427,63,266277
25044,0.001386,74.125.24.0-255,4320,101747,63,266277
25045,0.001388,172.31.40.0-255,66,101813,63,266277
25046,0.001413,74.125.24.0-255,2902,104715,63,266277
25047,0.001415,172.31.40.0-255,66,104781,63,266277
25048,0.001426,172.31.40.0-255,66,104847,63,266277
25049,0.001445,74.125.24.0-255,5738,110585,63,266277
25050,0.001449,172.31.40.0-255,66,110651,63,266277
25051,0.001457,74.125.24.0-255,1484,112135,63,266277
25052,0.00147,74.125.24.0-255,2184,114319,63,266277
25053,0.001472,172.31.40.0-255,66,114385,63,266277
25054,0.001506,74.125.24.0-255,1484,115869,63,266277
25055,0.001522,74.125.24.0-255,2902,118771,63,266277
25056,0.001525,172.31.40.0-255,66,118837,63,266277
25057,0.00158,74.125.24.0-255,5738,124575,63,266277
25058,0.001583,172.31.40.0-255,66,124641,63,266277
25059,0.001591,74.125.24.0-255,7156,131797,63,266277
25060,0.001593,172.31.40.0-255,66,131863,63,266277
25061,0.001608,172.31.40.0-255,66,131929,63,266277
25062,0.001612,74.125.24.0-255,2184,134113,63,266277
25063,0.001614,172.31.40.0-255,66,134179,63,266277
25064,0.001643,74.125.24.0-255,1484,135663,63,266277
25065,0.001657,74.125.24.0-255,2902,138565,63,266277
25066,0.00166,172.31.40.0-255,66,138631,63,266277
25067,0.001668,74.125.24.0-255,5738,144369,63,266277
25068,0.00167,172.31.40.0-255,66,144435,63,266277
25069,0.001703,172.31.40.0-255,66,144501,63,266277
25070,0.001748,172.31.40.0-255,66,144567,63,266277
25071,0.001759,74.125.24.0-255,6438,151005,63,266277
25072,0.001762,172.31.40.0-255,66,151071,63,266277
25073,0.001773,172.31.40.0-255,66,151137,63,266277
25074,0.001808,74.125.24.0-255,7156,158293,63,266277
25075,0.001812,172.31.40.0-255,66,158359,63,266277
25076,0.00185,172.31.40.0-255,66,158425,63,266277
25077,0.002104,74.125.24.0-255,1484,159909,63,266277
25078,0.002111,74.125.24.0-255,2902,162811,63,266277
25079,0.002114,172.31.40.0-255,66,162877,63,266277
25080,0.002121,74.125.24.0-255,5738,168615,63,266277
25081,0.002123,172.31.40.0-255,66,168681,63,266277
25082,0.002158,172.31.40.0-255,66,168747,63,266277
25083,0.002165,74.125.24.0-255,7156,175903,63,266277
25084,0.002168,172.31.40.0-255,66,175969,63,266277
25085,0.0022,74.125.24.0-255,3602,179571,63,266277
25086,0.002203,172.31.40.0-255,66,179637,63,266277
25087,0.002237,74.125.24.0-255,2902,182539,63,266277
25088,0.002241,172.31.40.0-255,66,182605,63,266277
25089,0.002259,74.125.24.0-255,1484,184089,63,266277
25090,0.002263,74.125.24.0-255,1484,185573,63,266277
25091,0.002265,172.31.40.0-255,66,185639,63,266277
25092,0.002273,74.125.24.0-255,5738,191377,63,266277
25093,0.002275,172.31.40.0-255,66,191443,63,266277
25094,0.002286,74.125.24.0-255,1484,192927,63,266277
25095,0.002321,172.31.40.0-255,66,192993,63,266277
25096,0.002345,74.125.24.0-255,5738,198731,63,266277
25097,0.002347,172.31.40.0-255,66,198797,63,266277
25098,0.00235,74.125.24.0-255,1484,200281,63,266277
25099,0.002382,172.31.40.0-255,66,200347,63,266277
25100,0.002386,74.125.24.0-255,2902,203249,63,266277
25101,0.002389,172.31.40.0-255,66,203315,63,266277
25102,0.002431,172.31.40.0-255,66,203381,63,266277
25103,0.002437,74.125.24.0-255,5738,209119,63,266277
25104,0.00244,172.31.40.0-255,66,209185,63,266277
25105,0.002492,74.125.24.0-255,5020,214205,63,266277
25106,0.002495,172.31.40.0-255,66,214271,63,266277
25107,0.002502,74.125.24.0-255,5738,220009,63,266277
25108,0.002504,172.31.40.0-255,66,220075,63,266277
25109,0.002511,74.125.24.0-255,7156,227231,63,266277
25110,0.002513,172.31.40.0-255,66,227297,63,266277
25111,0.00252,74.125.24.0-255,5738,233035,63,266277
25112,0.002523,172.31.40.0-255,66,233101,63,266277
25113,0.00255,74.125.24.0-255,2902,236003,63,266277
25114,0.002553,172.31.40.0-255,66,236069,63,266277
25115,0.002561,74.125.24.0-255,5738,241807,63,266277
25116,0.002563,172.31.40.0-255,66,241873,63,266277
25117,0.002582,74.125.24.0-255,6438,248311,63,266277
25118,0.002584,172.31.40.0-255,66,248377,63,266277
25119,0.005152,74.125.24.0-255,5738,254115,63,266277
25120,0.005161,172.31.40.0-255,66,254181,63,266277
25121,0.007713,74.125.24.0-255,5738,259919,63,266277
25122,0.007729,172.31.40.0-255,66,259985,63,266277
25123,0.010289,74.125.24.0-255,5738,265723,63,266277
25124,0.010306,172.31.40.0-255,66,265789,63,266277
25125,0.012808,74.125.24.0-255,251,266040,63,266277
25126,0.015578,172.31.40.0-255,66,266106,63,266277
25127,0.015618,172.31.40.0-255,105,266211,63,266277
25128,0.018141,74.125.24.0-255,66,266277,63,266277
25129,0.0,74.125.200.0-255,149,149,63,149298
25130,2.3e-05,172.31.40.0-255,66,215,63,149298
25131,3.1e-05,74.125.200.0-255,1484,1699,63,149298
25132,3.6e-05,172.31.40.0-255,66,1765,63,149298
25133,3.9e-05,74.125.200.0-255,1484,3249,63,149298
25134,4.3e-05,172.31.40.0-255,66,3315,63,149298
25135,4.8e-05,74.125.200.0-255,2902,6217,63,149298
25136,5.1e-05,172.31.40.0-255,66,6283,63,149298
25137,8.2e-05,74.125.200.0-255,5738,12021,63,149298
25138,8.6e-05,172.31.40.0-255,66,12087,63,149298
25139,9e-05,74.125.200.0-255,2002,14089,63,149298
25140,9.2e-05,172.31.40.0-255,66,14155,63,149298
25141,0.000232,74.125.200.0-255,1484,15639,63,149298
25142,0.000236,172.31.40.0-255,66,15705,63,149298
25143,0.000242,74.125.200.0-255,2902,18607,63,149298
25144,0.000244,172.31.40.0-255,66,18673,63,149298
25145,0.000272,74.125.200.0-255,4320,22993,63,149298
25146,0.000274,172.31.40.0-255,66,23059,63,149298
25147,0.000293,74.125.200.0-255,1484,24543,63,149298
25148,0.000296,172.31.40.0-255,66,24609,63,149298
25149,0.000299,74.125.200.0-255,1484,26093,63,149298
25150,0.000301,172.31.40.0-255,66,26159,63,149298
25151,0.000306,74.125.200.0-255,2902,29061,63,149298
25152,0.000309,172.31.40.0-255,66,29127,63,149298
25153,0.000341,74.125.200.0-255,5379,34506,63,149298
25154,0.000344,172.31.40.0-255,66,34572,63,149298
25155,0.000347,74.125.200.0-255,1484,36056,63,149298
25156,0.000349,172.31.40.0-255,66,36122,63,149298
25157,0.000368,74.125.200.0-255,4320,40442,63,149298
25158,0.00037,172.31.40.0-255,66,40508,63,149298
25159,0.000389,74.125.200.0-255,7156,47664,63,149298
25160,0.000392,172.31.40.0-255,66,47730,63,149298
25161,0.000418,74.125.200.0-255,5738,53468,63,149298
25162,0.000421,172.31.40.0-255,66,53534,63,149298
25163,0.000426,74.125.200.0-255,4320,57854,63,149298
25164,0.000428,172.31.40.0-255,66,57920,63,149298
25165,0.000448,74.125.200.0-255,5738,63658,63,149298
25166,0.000451,172.31.40.0-255,66,63724,63,149298
25167,0.000465,74.125.200.0-255,2184,65908,63,149298
25168,0.000468,172.31.40.0-255,66,65974,63,149298
25169,0.00048,74.125.200.0-255,708,66682,63,149298
25170,0.000702,74.125.200.0-255,1484,68166,63,149298
25171,0.000707,172.31.40.0-255,66,68232,63,149298
25172,0.000713,74.125.200.0-255,2902,71134,63,149298
25173,0.000715,172.31.40.0-255,66,71200,63,149298
25174,0.000731,74.125.200.0-255,4320,75520,63,149298
25175,0.000734,172.31.40.0-255,66,75586,63,149298
25176,0.000756,74.125.200.0-255,1484,77070,63,149298
25177,0.000762,74.125.200.0-255,4320,81390,63,149298
25178,0.000765,172.31.40.0-255,66,81456,63,149298
25179,0.000771,74.125.200.0-255,5738,87194,63,149298
25180,0.000774,172.31.40.0-255,66,87260,63,149298
25181,0.000828,74.125.200.0-255,7156,94416,63,149298
25182,0.000831,172.31.40.0-255,66,94482,63,149298
25183,0.000859,74.125.200.0-255,4320,98802,63,149298
25184,0.000863,172.31.40.0-255,66,98868,63,149298
25185,0.000867,74.125.200.0-255,2184,101052,63,149298
25186,0.00087,172.31.40.0-255,66,101118,63,149298
25187,0.002807,74.125.200.0-255,5738,106856,63,149298
25188,0.002815,172.31.40.0-255,66,106922,63,149298
25189,0.004752,74.125.200.0-255,4320,111242,63,149298
25190,0.004756,172.31.40.0-255,66,111308,63,149298
25191,0.004771,74.125.200.0-255,1484,112792,63,149298
25192,0.00671,74.125.200.0-255,2902,115694,63,149298
25193,0.006714,172.31.40.0-255,66,115760,63,149298
25194,0.006732,74.125.200.0-255,1484,117244,63,149298
25195,0.008671,74.125.200.0-255,4320,121564,63,149298
25196,0.008685,172.31.40.0-255,66,121630,63,149298
25197,0.01063,74.125.200.0-255,5738,127368,63,149298
25198,0.010643,172.31.40.0-255,66,127434,63,149298
25199,0.012602,74.125.200.0-255,5738,133172,63,149298
25200,0.012611,172.31.40.0-255,66,133238,63,149298
25201,0.01456,74.125.200.0-255,5738,138976,63,149298
25202,0.014569,172.31.40.0-255,66,139042,63,149298
25203,0.016511,74.125.200.0-255,4320,143362,63,149298
25204,0.01652,172.31.40.0-255,66,143428,63,149298
25205,0.016553,74.125.200.0-255,1484,144912,63,149298
25206,0.018469,74.125.200.0-255,4320,149232,63,149298
25207,0.018476,172.31.40.0-255,66,149298,63,149298
25208,0.0,216.58.221.0-255,152,152,63,145742
25209,2.4e-05,172.31.40.0-255,66,218,63,145742
25210,3.1e-05,216.58.221.0-255,1484,1702,63,145742
25211,3.6e-05,172.31.40.0-255,66,1768,63,145742
25212,4.2e-05,216.58.221.0-255,2902,4670,63,145742
25213,5.4e-05,172.31.40.0-255,66,4736,63,145742
25214,6.2e-05,216.58.221.0-255,5738,10474,63,145742
25215,6.5e-05,172.31.40.0-255,66,10540,63,145742
25216,7.3e-05,216.58.221.0-255,6391,16931,63,145742
25217,7.6e-05,172.31.40.0-255,66,16997,63,145742
25218,9.1e-05,172.31.40.0-255,66,17063,63,145742
25219,0.000211,216.58.221.0-255,1484,18547,63,145742
25220,0.000215,172.31.40.0-255,66,18613,63,145742
25221,0.000221,216.58.221.0-255,2902,21515,63,145742
25222,0.000223,172.31.40.0-255,66,21581,63,145742
25223,0.000226,216.58.221.0-255,1484,23065,63,145742
25224,0.000228,172.31.40.0-255,66,23131,63,145742
25225,0.000239,216.58.221.0-255,2902,26033,63,145742
25226,0.000241,172.31.40.0-255,66,26099,63,145742
25227,0.000246,216.58.221.0-255,2902,29001,63,145742
25228,0.000248,172.31.40.0-255,66,29067,63,145742
25229,0.000284,216.58.221.0-255,2902,31969,63,145742
25230,0.000287,172.31.40.0-255,66,32035,63,145742
25231,0.000292,216.58.221.0-255,2543,34578,63,145742
25232,0.000294,172.31.40.0-255,66,34644,63,145742
25233,0.001108,216.58.221.0-255,1484,36128,63,145742
25234,0.001115,172.31.40.0-255,66,36194,63,145742
25235,0.001126,216.58.221.0-255,2902,39096,63,145742
25236,0.001128,172.31.40.0-255,66,39162,63,145742
25237,0.001141,216.58.221.0-255,5738,44900,63,145742
25238,0.001143,172.31.40.0-255,66,44966,63,145742
25239,0.001147,216.58.221.0-255,1484,46450,63,145742
25240,0.00118,216.58.221.0-255,5379,51829,63,145742
25241,0.001182,172.31.40.0-255,66,51895,63,145742
25242,0.001222,216.58.221.0-255,1484,53379,63,145742
25243,0.001228,216.58.221.0-255,2902,56281,63,145742
25244,0.00123,172.31.40.0-255,66,56347,63,145742
25245,0.00124,216.58.221.0-255,5738,62085,63,145742
25246,0.001242,172.31.40.0-255,66,62151,63,145742
25247,0.001252,216.58.221.0-255,4320,66471,63,145742
25248,0.001254,172.31.40.0-255,66,66537,63,145742
25249,0.00129,216.58.221.0-255,2543,69080,63,145742
25250,0.001294,172.31.40.0-255,66,69146,63,145742
25251,0.001324,216.58.221.0-255,3483,72629,63,145742
25252,0.001327,172.31.40.0-255,66,72695,63,145742
25253,0.001339,172.31.40.0-255,66,72761,63,145742
25254,0.001344,216.58.221.0-255,2902,75663,63,145742
25255,0.001346,172.31.40.0-255,66,75729,63,145742
25256,0.00137,216.58.221.0-255,2543,78272,63,145742
25257,0.001374,172.31.40.0-255,66,78338,63,145742
25258,0.001768,216.58.221.0-255,1484,79822,63,145742
25259,0.001778,216.58.221.0-255,2902,82724,63,145742
25260,0.001783,172.31.40.0-255,66,82790,63,145742
25261,0.00179,216.58.221.0-255,4320,87110,63,145742
25262,0.001792,172.31.40.0-255,66,87176,63,145742
25263,0.001819,216.58.221.0-255,1484,88660,63,145742
25264,0.001827,216.58.221.0-255,5738,94398,63,145742
25265,0.00183,172.31.40.0-255,66,94464,63,145742
25266,0.001832,216.58.221.0-255,460,94924,63,145742
25267,0.003757,216.58.221.0-255,4320,99244,63,145742
25268,0.003762,172.31.40.0-255,66,99310,63,145742
25269,0.005696,216.58.221.0-255,5738,105048,63,145742
25270,0.005703,172.31.40.0-255,66,105114,63,145742
25271,0.00764,216.58.221.0-255,5738,110852,63,145742
25272,0.007646,172.31.40.0-255,66,110918,63,145742
25273,0.009591,216.58.221.0-255,5738,116656,63,145742
25274,0.009597,172.31.40.0-255,66,116722,63,145742
25275,0.011545,216.58.221.0-255,5738,122460,63,145742
25276,0.011554,172.31.40.0-255,66,122526,63,145742
25277,0.013497,216.58.221.0-255,5738,128264,63,145742
25278,0.013504,172.31.40.0-255,66,128330,63,145742
25279,0.015459,216.58.221.0-255,5738,134068,63,145742
25280,0.015467,172.31.40.0-255,66,134134,63,145742
25281,0.017401,216.58.221.0-255,5738,139872,63,145742
25282,0.017408,172.31.40.0-255,66,139938,63,145742
25283,0.019346,216.58.221.0-255,5738,145676,63,145742
25284,0.019353,172.31.40.0-255,66,145742,63,145742
25285,0.0,172.31.40.0-255,105,105,63,276
25286,0.001767,157.240.24.0-255,105,210,63,276
25287,0.001778,172.31.40.0-255,66,276,63,276
25288,0.0,216.58.203.0-255,153,153,63,241580
25289,2.2e-05,172.31.40.0-255,66,219,63,241580
25290,3e-05,216.58.203.0-255,1484,1703,63,241580
25291,3.5e-05,172.31.40.0-255,66,1769,63,241580
25292,4.1e-05,216.58.203.0-255,2902,4671,63,241580
25293,4.5e-05,172.31.40.0-255,66,4737,63,241580
25294,5.1e-05,216.58.203.0-255,5738,10475,63,241580
25295,5.5e-05,172.31.40.0-255,66,10541,63,241580
25296,6.1e-05,216.58.203.0-255,4320,14861,63,241580
25297,6.4e-05,172.31.40.0-255,66,14927,63,241580
25298,0.000104,172.31.40.0-255,66,14993,63,241580
25299,0.000111,216.58.203.0-255,7156,22149,63,241580
25300,0.000113,172.31.40.0-255,66,22215,63,241580
25301,0.000124,216.58.203.0-255,1125,23340,63,241580
25302,0.000126,172.31.40.0-255,66,23406,63,241580
25303,0.000154,216.58.203.0-255,1484,24890,63,241580
25304,0.000156,172.31.40.0-255,66,24956,63,241580
25305,0.00016,216.58.203.0-255,1484,26440,63,241580
25306,0.000162,172.31.40.0-255,66,26506,63,241580
25307,0.000192,216.58.203.0-255,1484,27990,63,241580
25308,0.000194,172.31.40.0-255,66,28056,63,241580
25309,0.000202,216.58.203.0-255,5738,33794,63,241580
25310,0.000204,172.31.40.0-255,66,33860,63,241580
25311,0.000207,216.58.203.0-255,1484,35344,63,241580
25312,0.000209,172.31.40.0-255,66,35410,63,241580
25313,0.000236,216.58.203.0-255,5379,40789,63,241580
25314,0.000238,172.31.40.0-255,66,40855,63,241580
25315,0.000343,216.58.203.0-255,1484,42339,63,241580
25316,0.000346,172.31.40.0-255,66,42405,63,241580
25317,0.000369,216.58.203.0-255,2902,45307,63,241580
25318,0.000372,172.31.40.0-255,66,45373,63,241580
25319,0.000376,216.58.203.0-255,4320,49693,63,241580
25320,0.000378,172.31.40.0-255,66,49759,63,241580
25321,0.000382,216.58.203.0-255,2902,52661,63,241580
25322,0.000384,172.31.40.0-255,66,52727,63,241580
25323,0.000411,216.58.203.0-255,5707,58434,63,241580
25324,0.000413,172.31.40.0-255,66,58500,63,241580
25325,0.000635,216.58.203.0-255,114,58614,63,241580
25326,0.000736,216.58.203.0-255,1484,60098,63,241580
25327,0.00074,172.31.40.0-255,66,60164,63,241580
25328,0.000745,216.58.203.0-255,2902,63066,63,241580
25329,0.000746,172.31.40.0-255,66,63132,63,241580
25330,0.000759,216.58.203.0-255,2902,66034,63,241580
25331,0.000761,172.31.40.0-255,66,66100,63,241580
25332,0.0008,216.58.203.0-255,7156,73256,63,241580
25333,0.000802,172.31.40.0-255,66,73322,63,241580
25334,0.000806,216.58.203.0-255,2543,75865,63,241580
25335,0.000808,172.31.40.0-255,66,75931,63,241580
25336,0.000838,216.58.203.0-255,2902,78833,63,241580
25337,0.000841,172.31.40.0-255,66,78899,63,241580
25338,0.000866,216.58.203.0-255,7156,86055,63,241580
25339,0.000869,172.31.40.0-255,66,86121,63,241580
25340,0.000875,216.58.203.0-255,5738,91859,63,241580
25341,0.000877,172.31.40.0-255,66,91925,63,241580
25342,0.000911,216.58.203.0-255,1391,93316,63,241580
25343,0.00109,216.58.203.0-255,1484,94800,63,241580
25344,0.001093,172.31.40.0-255,66,94866,63,241580
25345,0.0011,216.58.203.0-255,2902,97768,63,241580
25346,0.001102,172.31.40.0-255,66,97834,63,241580
25347,0.001105,216.58.203.0-255,1484,99318,63,241580
25348,0.001124,216.58.203.0-255,2902,102220,63,241580
25349,0.001127,172.31.40.0-255,66,102286,63,241580
25350,0.001137,172.31.40.0-255,66,102352,63,241580
25351,0.001156,216.58.203.0-255,2902,105254,63,241580
25352,0.001159,172.31.40.0-255,66,105320,63,241580
25353,0.0012,172.31.40.0-255,66,105386,63,241580
25354,0.001203,216.58.203.0-255,766,106152,63,241580
25355,0.001285,216.58.203.0-255,1484,107636,63,241580
25356,0.001289,172.31.40.0-255,66,107702,63,241580
25357,0.001294,216.58.203.0-255,2902,110604,63,241580
25358,0.001296,172.31.40.0-255,66,110670,63,241580
25359,0.001303,216.58.203.0-255,5738,116408,63,241580
25360,0.001305,172.31.40.0-255,66,116474,63,241580
25361,0.001309,216.58.203.0-255,2902,119376,63,241580
25362,0.001311,172.31.40.0-255,66,119442,63,241580
25363,0.001329,216.58.203.0-255,4320,123762,63,241580
25364,0.001332,172.31.40.0-255,66,123828,63,241580
25365,0.001334,216.58.203.0-255,1484,125312,63,241580
25366,0.001371,172.31.40.0-255,66,125378,63,241580
25367,0.001387,216.58.203.0-255,1484,126862,63,241580
25368,0.001392,216.58.203.0-255,2184,129046,63,241580
25369,0.001395,172.31.40.0-255,66,129112,63,241580
25370,0.001415,216.58.203.0-255,1484,130596,63,241580
25371,0.00142,216.58.203.0-255,2902,133498,63,241580
25372,0.001423,172.31.40.0-255,66,133564,63,241580
25373,0.001426,216.58.203.0-255,1484,135048,63,241580
25374,0.001446,216.58.203.0-255,4320,139368,63,241580
25375,0.001448,172.31.40.0-255,66,139434,63,241580
25376,0.001483,216.58.203.0-255,2902,142336,63,241580
25377,0.001486,172.31.40.0-255,66,142402,63,241580
25378,0.00151,216.58.203.0-255,7156,149558,63,241580
25379,0.001513,172.31.40.0-255,66,149624,63,241580
25380,0.00153,216.58.203.0-255,2902,152526,63,241580
25381,0.001533,172.31.40.0-255,66,152592,63,241580
25382,0.001539,216.58.203.0-255,5738,158330,63,241580
25383,0.001542,172.31.40.0-255,66,158396,63,241580
25384,0.00156,216.58.203.0-255,1484,159880,63,241580
25385,0.001565,216.58.203.0-255,2902,162782,63,241580
25386,0.001567,172.31.40.0-255,66,162848,63,241580
25387,0.00159,216.58.203.0-255,766,163614,63,241580
25388,0.001596,216.58.203.0-255,4320,167934,63,241580
25389,0.001599,172.31.40.0-255,66,168000,63,241580
25390,0.001611,172.31.40.0-255,66,168066,63,241580
25391,0.001618,216.58.203.0-255,7156,175222,63,241580
25392,0.001621,172.31.40.0-255,66,175288,63,241580
25393,0.001631,172.31.40.0-255,66,175354,63,241580
25394,0.001636,216.58.203.0-255,3602,178956,63,241580
25395,0.001638,172.31.40.0-255,66,179022,63,241580
25396,0.001641,216.58.203.0-255,1484,180506,63,241580
25397,0.003266,216.58.203.0-255,4320,184826,63,241580
25398,0.003273,172.31.40.0-255,66,184892,63,241580
25399,0.0049,216.58.203.0-255,4320,189212,63,241580
25400,0.004903,172.31.40.0-255,66,189278,63,241580
25401,0.004921,216.58.203.0-255,1484,190762,63,241580
25402,0.006547,216.58.203.0-255,4320,195082,63,241580
25403,0.006552,172.31.40.0-255,66,195148,63,241580
25404,0.008222,216.58.203.0-255,5738,200886,63,241580
25405,0.008229,172.31.40.0-255,66,200952,63,241580
25406,0.009887,216.58.203.0-255,5738,206690,63,241580
25407,0.009892,172.31.40.0-255,66,206756,63,241580
25408,0.011534,216.58.203.0-255,5738,212494,63,241580
25409,0.01154,172.31.40.0-255,66,212560,63,241580
25410,0.013186,216.58.203.0-255,5738,218298,63,241580
25411,0.013193,172.31.40.0-255,66,218364,63,241580
25412,0.014828,216.58.203.0-255,5738,224102,63,241580
25413,0.014835,172.31.40.0-255,66,224168,63,241580
25414,0.016468,216.58.203.0-255,5738,229906,63,241580
25415,0.016475,172.31.40.0-255,66,229972,63,241580
25416,0.018108,216.58.203.0-255,5738,235710,63,241580
25417,0.018114,172.31.40.0-255,66,235776,63,241580
25418,0.019756,216.58.203.0-255,5738,241514,63,241580
25419,0.019763,172.31.40.0-255,66,241580,63,241580
25420,0.0,172.31.40.0-255,105,105,63,276
25421,0.001778,157.240.24.0-255,105,210,63,276
25422,0.001793,172.31.40.0-255,66,276,63,276
25423,0.0,172.31.40.0-255,105,105,63,276
25424,0.001796,157.240.24.0-255,105,210,63,276
25425,0.001809,172.31.40.0-255,66,276,63,276
25426,0.0,74.125.24.0-255,153,153,63,251364
25427,2.2e-05,172.31.40.0-255,66,219,63,251364
25428,3e-05,74.125.24.0-255,1484,1703,63,251364
25429,3.4e-05,172.31.40.0-255,66,1769,63,251364
25430,4e-05,74.125.24.0-255,2902,4671,63,251364
25431,4.4e-05,172.31.40.0-255,66,4737,63,251364
25432,5.2e-05,74.125.24.0-255,7156,11893,63,251364
25433,5.5e-05,172.31.40.0-255,66,11959,63,251364
25434,6e-05,74.125.24.0-255,3456,15415,63,251364
25435,6.3e-05,172.31.40.0-255,66,15481,63,251364
25436,7.2e-05,74.125.24.0-255,7156,22637,63,251364
25437,7.5e-05,172.31.40.0-255,66,22703,63,251364
25438,0.000106,74.125.24.0-255,5738,28441,63,251364
25439,0.000109,172.31.40.0-255,66,28507,63,251364
25440,0.000113,74.125.24.0-255,2543,31050,63,251364
25441,0.000115,172.31.40.0-255,66,31116,63,251364
25442,0.00012,74.125.24.0-255,2902,34018,63,251364
25443,0.000123,172.31.40.0-255,66,34084,63,251364
25444,0.000154,74.125.24.0-255,7156,41240,63,251364
25445,0.000156,172.31.40.0-255,66,41306,63,251364
25446,0.000162,74.125.24.0-255,5738,47044,63,251364
25447,0.000164,172.31.40.0-255,66,47110,63,251364
25448,0.000191,74.125.24.0-255,1125,48235,63,251364
25449,0.000194,172.31.40.0-255,66,48301,63,251364
25450,0.000197,74.125.24.0-255,1484,49785,63,251364
25451,0.000199,172.31.40.0-255,66,49851,63,251364
25452,0.000212,74.125.24.0-255,1484,51335,63,251364
25453,0.000214,172.31.40.0-255,66,51401,63,251364
25454,0.000232,74.125.24.0-255,2902,54303,63,251364
25455,0.000235,172.31.40.0-255,66,54369,63,251364
25456,0.00024,74.125.24.0-255,4320,58689,63,251364
25457,0.000242,172.31.40.0-255,66,58755,63,251364
25458,0.000264,74.125.24.0-255,5738,64493,63,251364
25459,0.000267,172.31.40.0-255,66,64559,63,251364
25460,0.00027,74.125.24.0-255,1125,65684,63,251364
25461,0.00031,74.125.24.0-255,646,66330,63,251364
25462,0.000312,172.31.40.0-255,66,66396,63,251364
25463,0.000502,74.125.24.0-255,1484,67880,63,251364
25464,0.000508,74.125.24.0-255,2902,70782,63,251364
25465,0.000511,172.31.40.0-255,66,70848,63,251364
25466,0.000553,74.125.24.0-255,5738,76586,63,251364
25467,0.000556,172.31.40.0-255,66,76652,63,251364
25468,0.000559,74.125.24.0-255,1484,78136,63,251364
25469,0.000582,74.125.24.0-255,5738,83874,63,251364
25470,0.000584,172.31.40.0-255,66,83940,63,251364
25471,0.00059,74.125.24.0-255,5738,89678,63,251364
25472,0.000592,172.31.40.0-255,66,89744,63,251364
25473,0.000607,74.125.24.0-255,2902,92646,63,251364
25474,0.000609,172.31.40.0-255,66,92712,63,251364
25475,0.000657,172.31.40.0-255,66,92778,63,251364
25476,0.000994,74.125.24.0-255,1484,94262,63,251364
25477,0.001015,74.125.24.0-255,2902,97164,63,251364
25478,0.001018,172.31.40.0-255,66,97230,63,251364
25479,0.001026,74.125.24.0-255,5738,102968,63,251364
25480,0.001028,172.31.40.0-255,66,103034,63,251364
25481,0.001036,74.125.24.0-255,7156,110190,63,251364
25482,0.001038,172.31.40.0-255,66,110256,63,251364
25483,0.001064,74.125.24.0-255,5738,115994,63,251364
25484,0.001067,172.31.40.0-255,66,116060,63,251364
25485,0.00107,74.125.24.0-255,1484,117544,63,251364
25486,0.001105,172.31.40.0-255,66,117610,63,251364
25487,0.001183,74.125.24.0-255,1484,119094,63,251364
25488,0.001205,74.125.24.0-255,2902,121996,63,251364
25489,0.001208,172.31.40.0-255,66,122062,63,251364
25490,0.001215,74.125.24.0-255,5738,127800,63,251364
25491,0.001217,172.31.40.0-255,66,127866,63,251364
25492,0.001224,74.125.24.0-255,5738,133604,63,251364
25493,0.001226,172.31.40.0-255,66,133670,63,251364
25494,0.001242,74.125.24.0-255,1484,135154,63,251364
25495,0.001278,172.31.40.0-255,66,135220,63,251364
25496,0.0013,74.125.24.0-255,4320,139540,63,251364
25497,0.001303,172.31.40.0-255,66,139606,63,251364
25498,0.001307,74.125.24.0-255,2184,141790,63,251364
25499,0.00131,172.31.40.0-255,66,141856,63,251364
25500,0.001372,74.125.24.0-255,1484,143340,63,251364
25501,0.00139,74.125.24.0-255,2902,146242,63,251364
25502,0.001394,172.31.40.0-255,66,146308,63,251364
25503,0.001401,74.125.24.0-255,5738,152046,63,251364
25504,0.001403,172.31.40.0-255,66,152112,63,251364
25505,0.001436,74.125.24.0-255,1484,153596,63,251364
25506,0.00144,172.31.40.0-255,66,153662,63,251364
25507,0.001466,74.125.24.0-255,5738,159400,63,251364
25508,0.001469,172.31.40.0-255,66,159466,63,251364
25509,0.001486,74.125.24.0-255,3602,163068,63,251364
25510,0.001488,172.31.40.0-255,66,163134,63,251364
25511,0.001522,74.125.24.0-255,2902,166036,63,251364
25512,0.001526,172.31.40.0-255,66,166102,63,251364
25513,0.001547,74.125.24.0-255,1484,167586,63,251364
25514,0.001553,74.125.24.0-255,4320,171906,63,251364
25515,0.001556,172.31.40.0-255,66,171972,63,251364
25516,0.001568,172.31.40.0-255,66,172038,63,251364
25517,0.001594,74.125.24.0-255,1484,173522,63,251364
25518,0.001631,172.31.40.0-255,66,173588,63,251364
25519,0.001665,172.31.40.0-255,66,173654,63,251364
25520,0.001677,74.125.24.0-255,2902,176556,63,251364
25521,0.00168,172.31.40.0-255,66,176622,63,251364
25522,0.001696,172.31.40.0-255,66,176688,63,251364
25523,0.00172,74.125.24.0-255,2902,179590,63,251364
25524,0.001723,172.31.40.0-255,66,179656,63,251364
25525,0.001765,172.31.40.0-255,66,179722,63,251364
25526,0.001771,74.125.24.0-255,4320,184042,63,251364
25527,0.001774,172.31.40.0-255,66,184108,63,251364
25528,0.001791,74.125.24.0-255,4320,188428,63,251364
25529,0.001795,172.31.40.0-255,66,188494,63,251364
25530,0.001801,74.125.24.0-255,5738,194232,63,251364
25531,0.001803,172.31.40.0-255,66,194298,63,251364
25532,0.001847,172.31.40.0-255,66,194364,63,251364
25533,0.001853,74.125.24.0-255,5020,199384,63,251364
25534,0.001855,172.31.40.0-255,66,199450,63,251364
25535,0.00191,172.31.40.0-255,66,199516,63,251364
25536,0.001927,172.31.40.0-255,66,199582,63,251364
25537,0.001929,74.125.24.0-255,766,200348,63,251364
25538,0.002551,74.125.24.0-255,1484,201832,63,251364
25539,0.002556,172.31.40.0-255,66,201898,63,251364
25540,0.002562,74.125.24.0-255,2902,204800,63,251364
25541,0.002564,172.31.40.0-255,66,204866,63,251364
25542,0.00257,74.125.24.0-255,5738,210604,63,251364
25543,0.002572,172.31.40.0-255,66,210670,63,251364
25544,0.002579,74.125.24.0-255,5738,216408,63,251364
25545,0.002581,172.31.40.0-255,66,216474,63,251364
25546,0.002584,74.125.24.0-255,1484,217958,63,251364
25547,0.005139,74.125.24.0-255,4320,222278,63,251364
25548,0.005145,172.31.40.0-255,66,222344,63,251364
25549,0.007717,74.125.24.0-255,5738,228082,63,251364
25550,0.007722,172.31.40.0-255,66,228148,63,251364
25551,0.01032,74.125.24.0-255,5738,233886,63,251364
25552,0.010327,172.31.40.0-255,66,233952,63,251364
25553,0.012912,74.125.24.0-255,5738,239690,63,251364
25554,0.012922,172.31.40.0-255,66,239756,63,251364
25555,0.015504,74.125.24.0-255,5738,245494,63,251364
25556,0.015512,172.31.40.0-255,66,245560,63,251364
25557,0.01809,74.125.24.0-255,5738,251298,63,251364
25558,0.018102,172.31.40.0-255,66,251364,63,251364
25559,0.0,74.125.24.0-255,153,153,63,217786
25560,2.4e-05,172.31.40.0-255,66,219,63,217786
25561,3.2e-05,74.125.24.0-255,1484,1703,63,217786
25562,3.6e-05,172.31.40.0-255,66,1769,63,217786
25563,4.2e-05,74.125.24.0-255,2902,4671,63,217786
25564,5.3e-05,172.31.40.0-255,66,4737,63,217786
25565,5.8e-05,74.125.24.0-255,4320,9057,63,217786
25566,6.1e-05,172.31.40.0-255,66,9123,63,217786
25567,6.4e-05,74.125.24.0-255,1484,10607,63,217786
25568,6.7e-05,172.31.40.0-255,66,10673,63,217786
25569,0.0001,74.125.24.0-255,3436,14109,63,217786
25570,0.000104,172.31.40.0-255,66,14175,63,217786
25571,0.000187,74.125.24.0-255,1484,15659,63,217786
25572,0.000191,172.31.40.0-255,66,15725,63,217786
25573,0.000197,74.125.24.0-255,2902,18627,63,217786
25574,0.000199,172.31.40.0-255,66,18693,63,217786
25575,0.00024,74.125.24.0-255,5738,24431,63,217786
25576,0.000243,172.31.40.0-255,66,24497,63,217786
25577,0.00025,74.125.24.0-255,5738,30235,63,217786
25578,0.000252,172.31.40.0-255,66,30301,63,217786
25579,0.000256,74.125.24.0-255,2902,33203,63,217786
25580,0.000263,172.31.40.0-255,66,33269,63,217786
25581,0.000298,172.31.40.0-255,66,33335,63,217786
25582,0.000317,172.31.40.0-255,66,33401,63,217786
25583,0.000347,74.125.24.0-255,1484,34885,63,217786
25584,0.00035,172.31.40.0-255,66,34951,63,217786
25585,0.000357,74.125.24.0-255,6438,41389,63,217786
25586,0.000359,172.31.40.0-255,66,41455,63,217786
25587,0.000383,74.125.24.0-255,645,42100,63,217786
25588,0.000385,172.31.40.0-255,66,42166,63,217786
25589,0.000499,74.125.24.0-255,1484,43650,63,217786
25590,0.000505,74.125.24.0-255,2902,46552,63,217786
25591,0.000531,74.125.24.0-255,2902,49454,63,217786
25592,0.000551,74.125.24.0-255,2902,52356,63,217786
25593,0.000583,74.125.24.0-255,2902,55258,63,217786
25594,0.000602,74.125.24.0-255,7156,62414,63,217786
25595,0.000614,74.125.24.0-255,1636,64050,63,217786
25596,0.000663,172.31.40.0-255,66,64116,63,217786
25597,0.000698,74.125.24.0-255,1484,65600,63,217786
25598,0.000714,74.125.24.0-255,2902,68502,63,217786
25599,0.00073,74.125.24.0-255,2902,71404,63,217786
25600,0.000743,74.125.24.0-255,2902,74306,63,217786
25601,0.000746,74.125.24.0-255,1484,75790,63,217786
25602,0.00075,172.31.40.0-255,66,75856,63,217786
25603,0.000778,74.125.24.0-255,2902,78758,63,217786
25604,0.000803,172.31.40.0-255,66,78824,63,217786
25605,0.00082,74.125.24.0-255,2529,81353,63,217786
25606,0.000828,74.125.24.0-255,7156,88509,63,217786
25607,0.000839,74.125.24.0-255,115,88624,63,217786
25608,0.000853,172.31.40.0-255,66,88690,63,217786
25609,0.001124,74.125.24.0-255,1484,90174,63,217786
25610,0.001129,74.125.24.0-255,1484,91658,63,217786
25611,0.001144,74.125.24.0-255,1484,93142,63,217786
25612,0.001154,172.31.40.0-255,66,93208,63,217786
25613,0.001161,74.125.24.0-255,5738,98946,63,217786
25614,0.001164,74.125.24.0-255,1484,100430,63,217786
25615,0.001175,172.31.40.0-255,66,100496,63,217786
25616,0.001212,74.125.24.0-255,2902,103398,63,217786
25617,0.001246,172.31.40.0-255,66,103464,63,217786
25618,0.001626,74.125.24.0-255,1484,104948,63,217786
25619,0.001632,74.125.24.0-255,2902,107850,63,217786
25620,0.001636,172.31.40.0-255,66,107916,63,217786
25621,0.001667,74.125.24.0-255,5738,113654,63,217786
25622,0.001674,74.125.24.0-255,7156,120810,63,217786
25623,0.001689,74.125.24.0-255,4320,125130,63,217786
25624,0.001693,172.31.40.0-255,66,125196,63,217786
25625,0.001714,172.31.40.0-255,66,125262,63,217786
25626,0.001735,74.125.24.0-255,5738,131000,63,217786
25627,0.001752,74.125.24.0-255,6438,137438,63,217786
25628,0.001759,172.31.40.0-255,66,137504,63,217786
25629,0.001766,74.125.24.0-255,1484,138988,63,217786
25630,0.001808,172.31.40.0-255,66,139054,63,217786
25631,0.001855,74.125.24.0-255,1484,140538,63,217786
25632,0.001859,74.125.24.0-255,2902,143440,63,217786
25633,0.001865,74.125.24.0-255,5738,149178,63,217786
25634,0.001895,74.125.24.0-255,4320,153498,63,217786
25635,0.001907,74.125.24.0-255,766,154264,63,217786
25636,0.001955,74.125.24.0-255,1484,155748,63,217786
25637,0.001961,74.125.24.0-255,4320,160068,63,217786
25638,0.001963,74.125.24.0-255,1484,161552,63,217786
25639,0.001968,172.31.40.0-255,66,161618,63,217786
25640,0.001978,74.125.24.0-255,2902,164520,63,217786
25641,0.001995,74.125.24.0-255,5738,170258,63,217786
25642,0.001998,172.31.40.0-255,66,170324,63,217786
25643,0.002057,172.31.40.0-255,66,170390,63,217786
25644,0.002136,172.31.40.0-255,66,170456,63,217786
25645,0.002164,74.125.24.0-255,1484,171940,63,217786
25646,0.002167,74.125.24.0-255,1484,173424,63,217786
25647,0.002171,172.31.40.0-255,66,173490,63,217786
25648,0.002182,74.125.24.0-255,1484,174974,63,217786
25649,0.002193,74.125.24.0-255,5738,180712,63,217786
25650,0.002207,74.125.24.0-255,2902,183614,63,217786
25651,0.002216,172.31.40.0-255,66,183680,63,217786
25652,0.002253,74.125.24.0-255,7156,190836,63,217786
25653,0.002256,172.31.40.0-255,66,190902,63,217786
25654,0.002276,74.125.24.0-255,3602,194504,63,217786
25655,0.00229,172.31.40.0-255,66,194570,63,217786
25656,0.004558,74.125.24.0-255,5738,200308,63,217786
25657,0.004566,172.31.40.0-255,66,200374,63,217786
25658,0.006839,74.125.24.0-255,5738,206112,63,217786
25659,0.010155,172.31.40.0-255,66,206178,63,217786
25660,0.012463,74.125.24.0-255,5738,211916,63,217786
25661,0.012469,172.31.40.0-255,66,211982,63,217786
25662,0.014804,74.125.24.0-255,5738,217720,63,217786
25663,0.019252,172.31.40.0-255,66,217786,63,217786
25664,0.0,172.217.194.0-255,298,298,63,204164
25665,3.5e-05,172.31.40.0-255,66,364,63,204164
25666,4.3e-05,172.217.194.0-255,1484,1848,63,204164
25667,4.8e-05,172.31.40.0-255,66,1914,63,204164
25668,5.5e-05,172.217.194.0-255,4320,6234,63,204164
25669,5.8e-05,172.31.40.0-255,66,6300,63,204164
25670,7.1e-05,172.31.40.0-255,66,6366,63,204164
25671,7.8e-05,172.217.194.0-255,7156,13522,63,204164
25672,8.2e-05,172.31.40.0-255,66,13588,63,204164
25673,0.000121,172.217.194.0-255,4320,17908,63,204164
25674,0.000124,172.31.40.0-255,66,17974,63,204164
25675,0.000146,172.217.194.0-255,3961,21935,63,204164
25676,0.000149,172.31.40.0-255,66,22001,63,204164
25677,0.000172,172.217.194.0-255,1484,23485,63,204164
25678,0.000174,172.31.40.0-255,66,23551,63,204164
25679,0.000193,172.217.194.0-255,2902,26453,63,204164
25680,0.000196,172.31.40.0-255,66,26519,63,204164
25681,0.0002,172.217.194.0-255,2902,29421,63,204164
25682,0.000202,172.31.40.0-255,66,29487,63,204164
25683,0.000218,172.217.194.0-255,2902,32389,63,204164
25684,0.00022,172.31.40.0-255,66,32455,63,204164
25685,0.000223,172.217.194.0-255,1484,33939,63,204164
25686,0.000225,172.31.40.0-255,66,34005,63,204164
25687,0.000263,172.31.40.0-255,66,34071,63,204164
25688,0.000284,172.217.194.0-255,5738,39809,63,204164
25689,0.000286,172.31.40.0-255,66,39875,63,204164
25690,0.000307,172.217.194.0-255,6770,46645,63,204164
25691,0.000309,172.31.40.0-255,66,46711,63,204164
25692,0.000441,172.217.194.0-255,1484,48195,63,204164
25693,0.000444,172.31.40.0-255,66,48261,63,204164
25694,0.000449,172.217.194.0-255,1484,49745,63,204164
25695,0.000465,172.217.194.0-255,1484,51229,63,204164
25696,0.000472,172.217.194.0-255,5738,56967,63,204164
25697,0.000475,172.217.194.0-255,1484,58451,63,204164
25698,0.000558,172.217.194.0-255,2902,61353,63,204164
25699,0.000575,172.217.194.0-255,3961,65314,63,204164
25700,0.0007,172.31.40.0-255,66,65380,63,204164
25701,0.000808,172.217.194.0-255,1484,66864,63,204164
25702,0.000815,172.217.194.0-255,2902,69766,63,204164
25703,0.000821,172.217.194.0-255,4320,74086,63,204164
25704,0.000826,172.31.40.0-255,66,74152,63,204164
25705,0.000835,172.217.194.0-255,1484,75636,63,204164
25706,0.000841,172.217.194.0-255,4320,79956,63,204164
25707,0.000862,172.31.40.0-255,66,80022,63,204164
25708,0.000872,172.217.194.0-255,2902,82924,63,204164
25709,0.000919,172.31.40.0-255,66,82990,63,204164
25710,0.001256,172.217.194.0-255,1484,84474,63,204164
25711,0.001262,172.217.194.0-255,2902,87376,63,204164
25712,0.001279,172.217.194.0-255,2902,90278,63,204164
25713,0.001286,172.31.40.0-255,66,90344,63,204164
25714,0.001292,172.31.40.0-255,66,90410,63,204164
25715,0.001307,172.217.194.0-255,2902,93312,63,204164
25716,0.001311,172.217.194.0-255,2902,96214,63,204164
25717,0.001325,172.217.194.0-255,7156,103370,63,204164
25718,0.00134,172.217.194.0-255,2902,106272,63,204164
25719,0.001347,172.217.194.0-255,7156,113428,63,204164
25720,0.00135,172.31.40.0-255,66,113494,63,204164
25721,0.001355,172.31.40.0-255,66,113560,63,204164
25722,0.001364,172.217.194.0-255,1484,115044,63,204164
25723,0.001384,172.217.194.0-255,2184,117228,63,204164
25724,0.001393,172.31.40.0-255,66,117294,63,204164
25725,0.001424,172.217.194.0-255,2902,120196,63,204164
25726,0.001436,172.217.194.0-255,1484,121680,63,204164
25727,0.001439,172.217.194.0-255,1484,123164,63,204164
25728,0.001445,172.31.40.0-255,66,123230,63,204164
25729,0.001465,172.217.194.0-255,4320,127550,63,204164
25730,0.00148,172.217.194.0-255,1484,129034,63,204164
25731,0.00149,172.31.40.0-255,66,129100,63,204164
25732,0.001497,172.217.194.0-255,5738,134838,63,204164
25733,0.001502,172.31.40.0-255,66,134904,63,204164
25734,0.001514,172.217.194.0-255,4320,139224,63,204164
25735,0.001548,172.31.40.0-255,66,139290,63,204164
25736,0.001986,172.217.194.0-255,1484,140774,63,204164
25737,0.00201,172.217.194.0-255,2902,143676,63,204164
25738,0.002016,172.217.194.0-255,5738,149414,63,204164
25739,0.002021,172.31.40.0-255,66,149480,63,204164
25740,0.002041,172.217.194.0-255,2902,152382,63,204164
25741,0.002102,172.217.194.0-255,7156,159538,63,204164
25742,0.002105,172.31.40.0-255,66,159604,63,204164
25743,0.002111,172.31.40.0-255,66,159670,63,204164
25744,0.002124,172.217.194.0-255,2902,162572,63,204164
25745,0.002127,172.217.194.0-255,766,163338,63,204164
25746,0.002145,172.31.40.0-255,66,163404,63,204164
25747,0.004183,172.217.194.0-255,1484,164888,63,204164
25748,0.00422,172.217.194.0-255,4320,169208,63,204164
25749,0.004225,172.31.40.0-255,66,169274,63,204164
25750,0.006303,172.217.194.0-255,5738,175012,63,204164
25751,0.00631,172.31.40.0-255,66,175078,63,204164
25752,0.008415,172.217.194.0-255,5738,180816,63,204164
25753,0.008433,172.31.40.0-255,66,180882,63,204164
25754,0.010544,172.217.194.0-255,5738,186620,63,204164
25755,0.01056,172.31.40.0-255,66,186686,63,204164
25756,0.012643,172.217.194.0-255,4320,191006,63,204164
25757,0.012656,172.217.194.0-255,1484,192490,63,204164
25758,0.014459,172.31.40.0-255,66,192556,63,204164
25759,0.016579,172.217.194.0-255,5738,198294,63,204164
25760,0.016596,172.31.40.0-255,66,198360,63,204164
25761,0.018696,172.217.194.0-255,5738,204098,63,204164
25762,0.018713,172.31.40.0-255,66,204164,63,204164
25763,0.0,74.125.24.0-255,148,148,63,83378
25764,2.1e-05,172.31.40.0-255,66,214,63,83378
25765,2.8e-05,74.125.24.0-255,1484,1698,63,83378
25766,3.2e-05,172.31.40.0-255,66,1764,63,83378
25767,3.9e-05,74.125.24.0-255,2902,4666,63,83378
25768,4.3e-05,172.31.40.0-255,66,4732,63,83378
25769,8.9e-05,74.125.24.0-255,5738,10470,63,83378
25770,9.3e-05,172.31.40.0-255,66,10536,63,83378
25771,0.000191,74.125.24.0-255,5738,16274,63,83378
25772,0.000195,172.31.40.0-255,66,16340,63,83378
25773,0.000209,74.125.24.0-255,3528,19868,63,83378
25774,0.000211,172.31.40.0-255,66,19934,63,83378
25775,0.000371,74.125.24.0-255,5738,25672,63,83378
25776,0.000376,172.31.40.0-255,66,25738,63,83378
25777,0.000399,74.125.24.0-255,5379,31117,63,83378
25778,0.000402,172.31.40.0-255,66,31183,63,83378
25779,0.000586,74.125.24.0-255,2902,34085,63,83378
25780,0.000603,172.31.40.0-255,66,34151,63,83378
25781,0.000638,172.31.40.0-255,66,34217,63,83378
25782,0.000952,74.125.24.0-255,4320,38537,63,83378
25783,0.000957,172.31.40.0-255,66,38603,63,83378
25784,0.000984,172.31.40.0-255,66,38669,63,83378
25785,0.001246,74.125.24.0-255,7156,45825,63,83378
25786,0.001254,172.31.40.0-255,66,45891,63,83378
25787,0.001298,172.31.40.0-255,66,45957,63,83378
25788,0.001316,74.125.24.0-255,6719,52676,63,83378
25789,0.001319,172.31.40.0-255,66,52742,63,83378
25790,0.001927,172.31.40.0-255,66,52808,63,83378
25791,0.003852,74.125.24.0-255,1484,54292,63,83378
25792,0.005536,172.31.40.0-255,66,54358,63,83378
25793,0.00786,74.125.24.0-255,5738,60096,63,83378
25794,0.007866,172.31.40.0-255,66,60162,63,83378
25795,0.010167,74.125.24.0-255,5738,65900,63,83378
25796,0.010173,172.31.40.0-255,66,65966,63,83378
25797,0.012501,74.125.24.0-255,5738,71704,63,83378
25798,0.012509,172.31.40.0-255,66,71770,63,83378
25799,0.014881,74.125.24.0-255,5738,77508,63,83378
25800,0.017296,172.31.40.0-255,66,77574,63,83378
25801,0.019606,74.125.24.0-255,5738,83312,63,83378
25802,0.019618,172.31.40.0-255,66,83378,63,83378
25803,0.0,74.125.24.0-255,156,156,63,224961
25804,2e-05,172.31.40.0-255,66,222,63,224961
25805,2.7e-05,74.125.24.0-255,1484,1706,63,224961
25806,3.1e-05,172.31.40.0-255,66,1772,63,224961
25807,3.7e-05,74.125.24.0-255,2902,4674,63,224961
25808,4.1e-05,172.31.40.0-255,66,4740,63,224961
25809,4.6e-05,74.125.24.0-255,5738,10478,63,224961
25810,4.9e-05,172.31.40.0-255,66,10544,63,224961
25811,8.3e-05,74.125.24.0-255,2902,13446,63,224961
25812,8.5e-05,172.31.40.0-255,66,13512,63,224961
25813,0.000112,172.31.40.0-255,66,13578,63,224961
25814,0.000117,74.125.24.0-255,4320,17898,63,224961
25815,0.000119,172.31.40.0-255,66,17964,63,224961
25816,0.000141,74.125.24.0-255,1484,19448,63,224961
25817,0.000143,172.31.40.0-255,66,19514,63,224961
25818,0.000158,74.125.24.0-255,3961,23475,63,224961
25819,0.00016,172.31.40.0-255,66,23541,63,224961
25820,0.000262,74.125.24.0-255,1484,25025,63,224961
25821,0.000266,172.31.40.0-255,66,25091,63,224961
25822,0.000271,74.125.24.0-255,2902,27993,63,224961
25823,0.000273,172.31.40.0-255,66,28059,63,224961
25824,0.000295,74.125.24.0-255,5738,33797,63,224961
25825,0.000298,172.31.40.0-255,66,33863,63,224961
25826,0.00032,74.125.24.0-255,6797,40660,63,224961
25827,0.000322,172.31.40.0-255,66,40726,63,224961
25828,0.000351,74.125.24.0-255,5738,46464,63,224961
25829,0.000353,172.31.40.0-255,66,46530,63,224961
25830,0.000375,74.125.24.0-255,5738,52268,63,224961
25831,0.000377,172.31.40.0-255,66,52334,63,224961
25832,0.000394,74.125.24.0-255,4320,56654,63,224961
25833,0.000396,172.31.40.0-255,66,56720,63,224961
25834,0.000406,74.125.24.0-255,1399,58119,63,224961
25835,0.000436,74.125.24.0-255,136,58255,63,224961
25836,0.000536,74.125.24.0-255,1484,59739,63,224961
25837,0.00054,172.31.40.0-255,66,59805,63,224961
25838,0.000545,74.125.24.0-255,2902,62707,63,224961
25839,0.000547,172.31.40.0-255,66,62773,63,224961
25840,0.00055,74.125.24.0-255,1484,64257,63,224961
25841,0.000569,74.125.24.0-255,4320,68577,63,224961
25842,0.000572,172.31.40.0-255,66,68643,63,224961
25843,0.000591,74.125.24.0-255,1484,70127,63,224961
25844,0.000607,74.125.24.0-255,5379,75506,63,224961
25845,0.000609,172.31.40.0-255,66,75572,63,224961
25846,0.000622,74.125.24.0-255,2902,78474,63,224961
25847,0.000625,172.31.40.0-255,66,78540,63,224961
25848,0.000643,74.125.24.0-255,4320,82860,63,224961
25849,0.000646,172.31.40.0-255,66,82926,63,224961
25850,0.000651,74.125.24.0-255,5738,88664,63,224961
25851,0.000653,172.31.40.0-255,66,88730,63,224961
25852,0.000675,74.125.24.0-255,4237,92967,63,224961
25853,0.000677,172.31.40.0-255,66,93033,63,224961
25854,0.001097,74.125.24.0-255,1484,94517,63,224961
25855,0.001116,74.125.24.0-255,2902,97419,63,224961
25856,0.001119,172.31.40.0-255,66,97485,63,224961
25857,0.001125,74.125.24.0-255,4320,101805,63,224961
25858,0.001127,172.31.40.0-255,66,101871,63,224961
25859,0.001137,74.125.24.0-255,1484,103355,63,224961
25860,0.00115,74.125.24.0-255,2902,106257,63,224961
25861,0.001152,172.31.40.0-255,66,106323,63,224961
25862,0.001172,74.125.24.0-255,7156,113479,63,224961
25863,0.001174,172.31.40.0-255,66,113545,63,224961
25864,0.001186,172.31.40.0-255,66,113611,63,224961
25865,0.001206,74.125.24.0-255,2184,115795,63,224961
25866,0.001208,172.31.40.0-255,66,115861,63,224961
25867,0.001712,74.125.24.0-255,1484,117345,63,224961
25868,0.00173,74.125.24.0-255,2902,120247,63,224961
25869,0.001734,172.31.40.0-255,66,120313,63,224961
25870,0.001742,74.125.24.0-255,5738,126051,63,224961
25871,0.001744,172.31.40.0-255,66,126117,63,224961
25872,0.00177,74.125.24.0-255,7156,133273,63,224961
25873,0.001773,172.31.40.0-255,66,133339,63,224961
25874,0.001776,74.125.24.0-255,1484,134823,63,224961
25875,0.001796,74.125.24.0-255,7156,141979,63,224961
25876,0.001799,172.31.40.0-255,66,142045,63,224961
25877,0.001847,172.31.40.0-255,66,142111,63,224961
25878,0.002206,74.125.24.0-255,1484,143595,63,224961
25879,0.002214,74.125.24.0-255,2902,146497,63,224961
25880,0.002218,172.31.40.0-255,66,146563,63,224961
25881,0.002227,74.125.24.0-255,5738,152301,63,224961
25882,0.002228,172.31.40.0-255,66,152367,63,224961
25883,0.002264,172.31.40.0-255,66,152433,63,224961
25884,0.002271,74.125.24.0-255,7156,159589,63,224961
25885,0.002274,172.31.40.0-255,66,159655,63,224961
25886,0.002298,74.125.24.0-255,3602,163257,63,224961
25887,0.002301,172.31.40.0-255,66,163323,63,224961
25888,0.002329,74.125.24.0-255,4320,167643,63,224961
25889,0.002331,172.31.40.0-255,66,167709,63,224961
25890,0.002365,172.31.40.0-255,66,167775,63,224961
25891,0.002368,74.125.24.0-255,1484,169259,63,224961
25892,0.002401,172.31.40.0-255,66,169325,63,224961
25893,0.002418,74.125.24.0-255,1484,170809,63,224961
25894,0.00245,172.31.40.0-255,66,170875,63,224961
25895,0.002481,172.31.40.0-255,66,170941,63,224961
25896,0.002487,74.125.24.0-255,5020,175961,63,224961
25897,0.00249,172.31.40.0-255,66,176027,63,224961
25898,0.002502,172.31.40.0-255,66,176093,63,224961
25899,0.002527,172.31.40.0-255,66,176159,63,224961
25900,0.002532,74.125.24.0-255,2902,179061,63,224961
25901,0.002534,172.31.40.0-255,66,179127,63,224961
25902,0.002568,74.125.24.0-255,6438,185565,63,224961
25903,0.002571,172.31.40.0-255,66,185631,63,224961
25904,0.002574,74.125.24.0-255,1484,187115,63,224961
25905,0.002577,74.125.24.0-255,1484,188599,63,224961
25906,0.002579,172.31.40.0-255,66,188665,63,224961
25907,0.002581,74.125.24.0-255,1484,190149,63,224961
25908,0.00262,172.31.40.0-255,66,190215,63,224961
25909,0.00264,74.125.24.0-255,4320,194535,63,224961
25910,0.002643,172.31.40.0-255,66,194601,63,224961
25911,0.002653,172.31.40.0-255,66,194667,63,224961
25912,0.002657,74.125.24.0-255,2902,197569,63,224961
25913,0.002659,172.31.40.0-255,66,197635,63,224961
25914,0.002694,172.31.40.0-255,66,197701,63,224961
25915,0.00273,74.125.24.0-255,1484,199185,63,224961
25916,0.002749,74.125.24.0-255,7156,206341,63,224961
25917,0.002752,172.31.40.0-255,66,206407,63,224961
25918,0.002764,172.31.40.0-255,66,206473,63,224961
25919,0.002788,172.31.40.0-255,66,206539,63,224961
25920,0.002805,74.125.24.0-255,3602,210141,63,224961
25921,0.002807,172.31.40.0-255,66,210207,63,224961
25922,0.002814,74.125.24.0-255,5738,215945,63,224961
25923,0.002817,172.31.40.0-255,66,216011,63,224961
25924,0.002819,74.125.24.0-255,1484,217495,63,224961
25925,0.00288,172.31.40.0-255,66,217561,63,224961
25926,0.002885,74.125.24.0-255,5738,223299,63,224961
25927,0.002888,172.31.40.0-255,66,223365,63,224961
25928,0.00289,74.125.24.0-255,1211,224576,63,224961
25929,0.002893,74.125.24.0-255,97,224673,63,224961
25930,0.002942,74.125.24.0-255,105,224778,63,224961
25931,0.013968,74.125.24.0-255,105,224883,63,224961
25932,0.013986,172.31.40.0-255,78,224961,63,224961
25933,0.0,172.217.194.0-255,150,150,63,212405
25934,1.5e-05,172.31.40.0-255,66,216,63,212405
25935,2.3e-05,172.217.194.0-255,1484,1700,63,212405
25936,2.8e-05,172.31.40.0-255,66,1766,63,212405
25937,3.3e-05,172.217.194.0-255,2902,4668,63,212405
25938,3.7e-05,172.31.40.0-255,66,4734,63,212405
25939,4.5e-05,172.217.194.0-255,7156,11890,63,212405
25940,4.8e-05,172.31.40.0-255,66,11956,63,212405
25941,5.2e-05,172.217.194.0-255,1950,13906,63,212405
25942,5.5e-05,172.31.40.0-255,66,13972,63,212405
25943,0.000109,172.31.40.0-255,66,14038,63,212405
25944,0.000115,172.217.194.0-255,5379,19417,63,212405
25945,0.000118,172.31.40.0-255,66,19483,63,212405
25946,0.000224,172.217.194.0-255,1484,20967,63,212405
25947,0.000228,172.31.40.0-255,66,21033,63,212405
25948,0.000233,172.217.194.0-255,2902,23935,63,212405
25949,0.000235,172.31.40.0-255,66,24001,63,212405
25950,0.000239,172.217.194.0-255,2902,26903,63,212405
25951,0.000242,172.31.40.0-255,66,26969,63,212405
25952,0.000268,172.217.194.0-255,2902,29871,63,212405
25953,0.000271,172.31.40.0-255,66,29937,63,212405
25954,0.000277,172.217.194.0-255,5738,35675,63,212405
25955,0.000279,172.31.40.0-255,66,35741,63,212405
25956,0.000294,172.31.40.0-255,66,35807,63,212405
25957,0.000299,172.217.194.0-255,4236,40043,63,212405
25958,0.000302,172.31.40.0-255,66,40109,63,212405
25959,0.000341,172.217.194.0-255,119,40228,63,212405
25960,0.000345,172.31.40.0-255,66,40294,63,212405
25961,0.000374,172.217.194.0-255,381,40675,63,212405
25962,0.000377,172.31.40.0-255,66,40741,63,212405
25963,0.000652,172.217.194.0-255,1484,42225,63,212405
25964,0.000659,172.217.194.0-255,2902,45127,63,212405
25965,0.000662,172.31.40.0-255,66,45193,63,212405
25966,0.00067,172.217.194.0-255,5738,50931,63,212405
25967,0.000672,172.31.40.0-255,66,50997,63,212405
25968,0.000703,172.31.40.0-255,66,51063,63,212405
25969,0.00072,172.217.194.0-255,1484,52547,63,212405
25970,0.000735,172.31.40.0-255,66,52613,63,212405
25971,0.000819,172.217.194.0-255,1484,54097,63,212405
25972,0.000824,172.217.194.0-255,2902,56999,63,212405
25973,0.000827,172.31.40.0-255,66,57065,63,212405
25974,0.000831,172.217.194.0-255,1484,58549,63,212405
25975,0.000852,172.217.194.0-255,4320,62869,63,212405
25976,0.000855,172.31.40.0-255,66,62935,63,212405
25977,0.000862,172.217.194.0-255,7156,70091,63,212405
25978,0.000864,172.31.40.0-255,66,70157,63,212405
25979,0.000881,172.217.194.0-255,5738,75895,63,212405
25980,0.000883,172.31.40.0-255,66,75961,63,212405
25981,0.000886,172.217.194.0-255,1484,77445,63,212405
25982,0.000924,172.217.194.0-255,7156,84601,63,212405
25983,0.000927,172.31.40.0-255,66,84667,63,212405
25984,0.000944,172.217.194.0-255,2184,86851,63,212405
25985,0.000946,172.31.40.0-255,66,86917,63,212405
25986,0.001029,172.217.194.0-255,1484,88401,63,212405
25987,0.001035,172.217.194.0-255,2902,91303,63,212405
25988,0.001038,172.31.40.0-255,66,91369,63,212405
25989,0.001042,172.217.194.0-255,2902,94271,63,212405
25990,0.001044,172.31.40.0-255,66,94337,63,212405
25991,0.001063,172.217.194.0-255,2902,97239,63,212405
25992,0.001065,172.31.40.0-255,66,97305,63,212405
25993,0.001072,172.217.194.0-255,7156,104461,63,212405
25994,0.001074,172.31.40.0-255,66,104527,63,212405
25995,0.001114,172.31.40.0-255,66,104593,63,212405
25996,0.001118,172.217.194.0-255,2184,106777,63,212405
25997,0.001119,172.31.40.0-255,66,106843,63,212405
25998,0.001174,172.217.194.0-255,2902,109745,63,212405
25999,0.001176,172.31.40.0-255,66,109811,63,212405
26000,0.001179,172.217.194.0-255,1484,111295,63,212405
26001,0.001186,172.217.194.0-255,5738,117033,63,212405
26002,0.001188,172.31.40.0-255,66,117099,63,212405
26003,0.001211,172.217.194.0-255,7156,124255,63,212405
26004,0.001214,172.31.40.0-255,66,124321,63,212405
26005,0.001246,172.217.194.0-255,5738,130059,63,212405
26006,0.001249,172.31.40.0-255,66,130125,63,212405
26007,0.001261,172.31.40.0-255,66,130191,63,212405
26008,0.001308,172.217.194.0-255,1484,131675,63,212405
26009,0.001312,172.217.194.0-255,1484,133159,63,212405
26010,0.001315,172.31.40.0-255,66,133225,63,212405
26011,0.001328,172.217.194.0-255,1484,134709,63,212405
26012,0.001334,172.217.194.0-255,5738,140447,63,212405
26013,0.001337,172.31.40.0-255,66,140513,63,212405
26014,0.001367,172.31.40.0-255,66,140579,63,212405
26015,0.00139,172.217.194.0-255,2902,143481,63,212405
26016,0.001404,172.31.40.0-255,66,143547,63,212405
26017,0.001412,172.31.40.0-255,66,143613,63,212405
26018,0.001427,172.217.194.0-255,4320,147933,63,212405
26019,0.00143,172.31.40.0-255,66,147999,63,212405
26020,0.001464,172.31.40.0-255,66,148065,63,212405
26021,0.001485,172.31.40.0-255,66,148131,63,212405
26022,0.001488,172.217.194.0-255,766,148897,63,212405
26023,0.001528,172.217.194.0-255,1484,150381,63,212405
26024,0.001531,172.31.40.0-255,66,150447,63,212405
26025,0.001546,172.217.194.0-255,2902,153349,63,212405
26026,0.001549,172.31.40.0-255,66,153415,63,212405
26027,0.001552,172.217.194.0-255,1484,154899,63,212405
26028,0.001578,172.217.194.0-255,4320,159219,63,212405
26029,0.001581,172.31.40.0-255,66,159285,63,212405
26030,0.001589,172.217.194.0-255,7156,166441,63,212405
26031,0.001591,172.31.40.0-255,66,166507,63,212405
26032,0.001595,172.217.194.0-255,2902,169409,63,212405
26033,0.001597,172.31.40.0-255,66,169475,63,212405
26034,0.001629,172.217.194.0-255,5738,175213,63,212405
26035,0.001632,172.31.40.0-255,66,175279,63,212405
26036,0.001643,172.31.40.0-255,66,175345,63,212405
26037,0.001689,172.217.194.0-255,1484,176829,63,212405
26038,0.001694,172.217.194.0-255,2902,179731,63,212405
26039,0.001698,172.31.40.0-255,66,179797,63,212405
26040,0.00173,172.217.194.0-255,5738,185535,63,212405
26041,0.001733,172.31.40.0-255,66,185601,63,212405
26042,0.001746,172.31.40.0-255,66,185667,63,212405
26043,0.001784,172.217.194.0-255,7156,192823,63,212405
26044,0.001786,172.31.40.0-255,66,192889,63,212405
26045,0.001802,172.217.194.0-255,5020,197909,63,212405
26046,0.001805,172.31.40.0-255,66,197975,63,212405
26047,0.001816,172.31.40.0-255,66,198041,63,212405
26048,0.001842,172.217.194.0-255,4320,202361,63,212405
26049,0.001845,172.31.40.0-255,66,202427,63,212405
26050,0.001897,172.31.40.0-255,66,202493,63,212405
26051,0.001918,172.217.194.0-255,5738,208231,63,212405
26052,0.001922,172.31.40.0-255,66,208297,63,212405
26053,0.001939,172.31.40.0-255,66,208363,63,212405
26054,0.001953,172.31.40.0-255,66,208429,63,212405
26055,0.001957,172.217.194.0-255,3103,211532,63,212405
26056,0.001959,172.31.40.0-255,66,211598,63,212405
26057,0.001962,172.217.194.0-255,105,211703,63,212405
26058,0.001965,172.217.194.0-255,129,211832,63,212405
26059,0.010939,172.217.194.0-255,129,211961,63,212405
26060,0.010958,172.31.40.0-255,78,212039,63,212405
26061,0.01931,172.31.40.0-255,105,212144,63,212405
26062,0.01937,172.31.40.0-255,105,212249,63,212405
26063,0.019588,172.31.40.0-255,90,212339,63,212405
26064,0.019608,172.31.40.0-255,66,212405,63,212405
26065,0.0,74.125.68.0-255,153,153,63,267564
26066,1.5e-05,172.31.40.0-255,66,219,63,267564
26067,2.3e-05,74.125.68.0-255,1484,1703,63,267564
26068,2.7e-05,172.31.40.0-255,66,1769,63,267564
26069,3.3e-05,74.125.68.0-255,2902,4671,63,267564
26070,3.6e-05,172.31.40.0-255,66,4737,63,267564
26071,6.3e-05,74.125.68.0-255,7156,11893,63,267564
26072,6.6e-05,172.31.40.0-255,66,11959,63,267564
26073,0.000106,74.125.68.0-255,2137,14096,63,267564
26074,0.000108,172.31.40.0-255,66,14162,63,267564
26075,0.000179,74.125.68.0-255,1484,15646,63,267564
26076,0.000183,172.31.40.0-255,66,15712,63,267564
26077,0.0002,74.125.68.0-255,2902,18614,63,267564
26078,0.000203,172.31.40.0-255,66,18680,63,267564
26079,0.000207,74.125.68.0-255,2902,21582,63,267564
26080,0.00021,172.31.40.0-255,66,21648,63,267564
26081,0.00024,74.125.68.0-255,4320,25968,63,267564
26082,0.000243,172.31.40.0-255,66,26034,63,267564
26083,0.000262,74.125.68.0-255,2902,28936,63,267564
26084,0.000265,172.31.40.0-255,66,29002,63,267564
26085,0.000287,74.125.68.0-255,6797,35799,63,267564
26086,0.00029,172.31.40.0-255,66,35865,63,267564
26087,0.000298,74.125.68.0-255,7156,43021,63,267564
26088,0.0003,172.31.40.0-255,66,43087,63,267564
26089,0.000321,74.125.68.0-255,2902,45989,63,267564
26090,0.000323,172.31.40.0-255,66,46055,63,267564
26091,0.000335,172.31.40.0-255,66,46121,63,267564
26092,0.000358,74.125.68.0-255,2902,49023,63,267564
26093,0.000362,172.31.40.0-255,66,49089,63,267564
26094,0.000381,74.125.68.0-255,6438,55527,63,267564
26095,0.000384,172.31.40.0-255,66,55593,63,267564
26096,0.000387,74.125.68.0-255,398,55991,63,267564
26097,0.000445,74.125.68.0-255,1484,57475,63,267564
26098,0.00045,172.31.40.0-255,66,57541,63,267564
26099,0.000464,74.125.68.0-255,2902,60443,63,267564
26100,0.000466,172.31.40.0-255,66,60509,63,267564
26101,0.000496,74.125.68.0-255,5738,66247,63,267564
26102,0.000499,172.31.40.0-255,66,66313,63,267564
26103,0.000502,74.125.68.0-255,1484,67797,63,267564
26104,0.000518,74.125.68.0-255,4320,72117,63,267564
26105,0.000521,172.31.40.0-255,66,72183,63,267564
26106,0.00054,74.125.68.0-255,4320,76503,63,267564
26107,0.000543,172.31.40.0-255,66,76569,63,267564
26108,0.000554,172.31.40.0-255,66,76635,63,267564
26109,0.000572,74.125.68.0-255,1484,78119,63,267564
26110,0.000576,74.125.68.0-255,1883,80002,63,267564
26111,0.000578,172.31.40.0-255,66,80068,63,267564
26112,0.000597,74.125.68.0-255,2902,82970,63,267564
26113,0.0006,172.31.40.0-255,66,83036,63,267564
26114,0.000602,74.125.68.0-255,1484,84520,63,267564
26115,0.000641,74.125.68.0-255,2902,87422,63,267564
26116,0.000645,172.31.40.0-255,66,87488,63,267564
26117,0.000651,74.125.68.0-255,5738,93226,63,267564
26118,0.000653,172.31.40.0-255,66,93292,63,267564
26119,0.000677,74.125.68.0-255,3961,97253,63,267564
26120,0.000679,172.31.40.0-255,66,97319,63,267564
26121,0.000932,74.125.68.0-255,1484,98803,63,267564
26122,0.000947,74.125.68.0-255,2902,101705,63,267564
26123,0.00095,172.31.40.0-255,66,101771,63,267564
26124,0.000972,74.125.68.0-255,4320,106091,63,267564
26125,0.000974,172.31.40.0-255,66,106157,63,267564
26126,0.000981,74.125.68.0-255,5738,111895,63,267564
26127,0.000983,172.31.40.0-255,66,111961,63,267564
26128,0.001009,74.125.68.0-255,4320,116281,63,267564
26129,0.001012,172.31.40.0-255,66,116347,63,267564
26130,0.001036,74.125.68.0-255,7156,123503,63,267564
26131,0.001039,172.31.40.0-255,66,123569,63,267564
26132,0.001044,74.125.68.0-255,4320,127889,63,267564
26133,0.001046,172.31.40.0-255,66,127955,63,267564
26134,0.001076,74.125.68.0-255,3602,131557,63,267564
26135,0.001081,172.31.40.0-255,66,131623,63,267564
26136,0.001183,74.125.68.0-255,1484,133107,63,267564
26137,0.001198,74.125.68.0-255,2902,136009,63,267564
26138,0.001203,172.31.40.0-255,66,136075,63,267564
26139,0.001217,74.125.68.0-255,5738,141813,63,267564
26140,0.001219,172.31.40.0-255,66,141879,63,267564
26141,0.00126,74.125.68.0-255,7156,149035,63,267564
26142,0.001264,172.31.40.0-255,66,149101,63,267564
26143,0.001268,74.125.68.0-255,1484,150585,63,267564
26144,0.001296,172.31.40.0-255,66,150651,63,267564
26145,0.001317,74.125.68.0-255,2184,152835,63,267564
26146,0.001319,172.31.40.0-255,66,152901,63,267564
26147,0.001385,74.125.68.0-255,1484,154385,63,267564
26148,0.001402,74.125.68.0-255,2902,157287,63,267564
26149,0.001406,172.31.40.0-255,66,157353,63,267564
26150,0.001419,74.125.68.0-255,4320,161673,63,267564
26151,0.001422,172.31.40.0-255,66,161739,63,267564
26152,0.001453,74.125.68.0-255,1484,163223,63,267564
26153,0.001461,74.125.68.0-255,7156,170379,63,267564
26154,0.001463,172.31.40.0-255,66,170445,63,267564
26155,0.001478,74.125.68.0-255,2902,173347,63,267564
26156,0.00148,172.31.40.0-255,66,173413,63,267564
26157,0.00152,172.31.40.0-255,66,173479,63,267564
26158,0.001524,74.125.68.0-255,2184,175663,63,267564
26159,0.001526,172.31.40.0-255,66,175729,63,267564
26160,0.001547,74.125.68.0-255,2902,178631,63,267564
26161,0.001549,172.31.40.0-255,66,178697,63,267564
26162,0.001567,74.125.68.0-255,2902,181599,63,267564
26163,0.00157,172.31.40.0-255,66,181665,63,267564
26164,0.001598,74.125.68.0-255,4320,185985,63,267564
26165,0.001601,172.31.40.0-255,66,186051,63,267564
26166,0.001606,74.125.68.0-255,4320,190371,63,267564
26167,0.001608,172.31.40.0-255,66,190437,63,267564
26168,0.001635,172.31.40.0-255,66,190503,63,267564
26169,0.001654,74.125.68.0-255,1484,191987,63,267564
26170,0.001666,74.125.68.0-255,6438,198425,63,267564
26171,0.001669,172.31.40.0-255,66,198491,63,267564
26172,0.001761,74.125.68.0-255,1484,199975,63,267564
26173,0.001765,74.125.68.0-255,1484,201459,63,267564
26174,0.001769,172.31.40.0-255,66,201525,63,267564
26175,0.001784,74.125.68.0-255,1484,203009,63,267564
26176,0.001787,74.125.68.0-255,1484,204493,63,267564
26177,0.001789,172.31.40.0-255,66,204559,63,267564
26178,0.001795,74.125.68.0-255,2902,207461,63,267564
26179,0.001798,172.31.40.0-255,66,207527,63,267564
26180,0.001828,74.125.68.0-255,5738,213265,63,267564
26181,0.001832,172.31.40.0-255,66,213331,63,267564
26182,0.001837,74.125.68.0-255,2902,216233,63,267564
26183,0.001839,172.31.40.0-255,66,216299,63,267564
26184,0.001853,74.125.68.0-255,4320,220619,63,267564
26185,0.001856,172.31.40.0-255,66,220685,63,267564
26186,0.001862,74.125.68.0-255,4320,225005,63,267564
26187,0.001864,172.31.40.0-255,66,225071,63,267564
26188,0.001884,74.125.68.0-255,4320,229391,63,267564
26189,0.001886,172.31.40.0-255,66,229457,63,267564
26190,0.001892,74.125.68.0-255,3602,233059,63,267564
26191,0.001894,172.31.40.0-255,66,233125,63,267564
26192,0.001993,74.125.68.0-255,1484,234609,63,267564
26193,0.002008,74.125.68.0-255,2902,237511,63,267564
26194,0.002012,172.31.40.0-255,66,237577,63,267564
26195,0.002035,74.125.68.0-255,5738,243315,63,267564
26196,0.002038,172.31.40.0-255,66,243381,63,267564
26197,0.002042,74.125.68.0-255,2902,246283,63,267564
26198,0.002044,172.31.40.0-255,66,246349,63,267564
26199,0.002049,74.125.68.0-255,4320,250669,63,267564
26200,0.002052,172.31.40.0-255,66,250735,63,267564
26201,0.00211,172.31.40.0-255,66,250801,63,267564
26202,0.00212,172.31.40.0-255,66,250867,63,267564
26203,0.002135,74.125.68.0-255,2902,253769,63,267564
26204,0.002138,172.31.40.0-255,66,253835,63,267564
26205,0.002161,74.125.68.0-255,5738,259573,63,267564
26206,0.002164,172.31.40.0-255,66,259639,63,267564
26207,0.002176,172.31.40.0-255,66,259705,63,267564
26208,0.002212,172.31.40.0-255,66,259771,63,267564
26209,0.002228,74.125.68.0-255,1484,261255,63,267564
26210,0.002255,172.31.40.0-255,66,261321,63,267564
26211,0.002261,74.125.68.0-255,5738,267059,63,267564
26212,0.002263,172.31.40.0-255,66,267125,63,267564
26213,0.002295,172.31.40.0-255,66,267191,63,267564
26214,0.004517,74.125.68.0-255,136,267327,63,267564
26215,0.012425,172.31.40.0-255,66,267393,63,267564
26216,0.012477,172.31.40.0-255,105,267498,63,267564
26217,0.014699,74.125.68.0-255,66,267564,63,267564
26218,0.0,74.125.24.0-255,152,152,63,182873
26219,1.6e-05,172.31.40.0-255,66,218,63,182873
26220,2.2e-05,74.125.24.0-255,1484,1702,63,182873
26221,2.7e-05,172.31.40.0-255,66,1768,63,182873
26222,3.3e-05,74.125.24.0-255,2902,4670,63,182873
26223,3.6e-05,172.31.40.0-255,66,4736,63,182873
26224,6.8e-05,74.125.24.0-255,7156,11892,63,182873
26225,7.1e-05,172.31.40.0-255,66,11958,63,182873
26226,7.5e-05,74.125.24.0-255,2036,13994,63,182873
26227,7.7e-05,172.31.40.0-255,66,14060,63,182873
26228,0.000162,74.125.24.0-255,1484,15544,63,182873
26229,0.000166,172.31.40.0-255,66,15610,63,182873
26230,0.000172,74.125.24.0-255,2902,18512,63,182873
26231,0.000174,172.31.40.0-255,66,18578,63,182873
26232,0.000178,74.125.24.0-255,2902,21480,63,182873
26233,0.00018,172.31.40.0-255,66,21546,63,182873
26234,0.000199,74.125.24.0-255,2902,24448,63,182873
26235,0.000202,172.31.40.0-255,66,24514,63,182873
26236,0.000205,74.125.24.0-255,1484,25998,63,182873
26237,0.000207,172.31.40.0-255,66,26064,63,182873
26238,0.000231,172.31.40.0-255,66,26130,63,182873
26239,0.00026,74.125.24.0-255,1125,27255,63,182873
26240,0.000263,172.31.40.0-255,66,27321,63,182873
26241,0.000276,172.31.40.0-255,66,27387,63,182873
26242,0.000282,74.125.24.0-255,4320,31707,63,182873
26243,0.000284,172.31.40.0-255,66,31773,63,182873
26244,0.000325,172.31.40.0-255,66,31839,63,182873
26245,0.000887,74.125.24.0-255,646,32485,63,182873
26246,0.000892,172.31.40.0-255,66,32551,63,182873
26247,0.001067,74.125.24.0-255,1484,34035,63,182873
26248,0.001077,74.125.24.0-255,2902,36937,63,182873
26249,0.001081,172.31.40.0-255,66,37003,63,182873
26250,0.001089,74.125.24.0-255,5738,42741,63,182873
26251,0.001091,172.31.40.0-255,66,42807,63,182873
26252,0.001117,74.125.24.0-255,2902,45709,63,182873
26253,0.001118,172.31.40.0-255,66,45775,63,182873
26254,0.001148,74.125.24.0-255,2902,48677,63,182873
26255,0.00115,172.31.40.0-255,66,48743,63,182873
26256,0.001166,172.31.40.0-255,66,48809,63,182873
26257,0.001171,74.125.24.0-255,3961,52770,63,182873
26258,0.001173,172.31.40.0-255,66,52836,63,182873
26259,0.001662,74.125.24.0-255,1484,54320,63,182873
26260,0.001671,74.125.24.0-255,2902,57222,63,182873
26261,0.001676,172.31.40.0-255,66,57288,63,182873
26262,0.001683,74.125.24.0-255,5738,63026,63,182873
26263,0.001685,172.31.40.0-255,66,63092,63,182873
26264,0.00172,172.31.40.0-255,66,63158,63,182873
26265,0.001744,74.125.24.0-255,4320,67478,63,182873
26266,0.001746,172.31.40.0-255,66,67544,63,182873
26267,0.001758,172.31.40.0-255,66,67610,63,182873
26268,0.001761,74.125.24.0-255,766,68376,63,182873
26269,0.001924,74.125.24.0-255,1484,69860,63,182873
26270,0.001926,172.31.40.0-255,66,69926,63,182873
26271,0.001931,74.125.24.0-255,2902,72828,63,182873
26272,0.001934,172.31.40.0-255,66,72894,63,182873
26273,0.001937,74.125.24.0-255,1484,74378,63,182873
26274,0.001957,74.125.24.0-255,4320,78698,63,182873
26275,0.00196,172.31.40.0-255,66,78764,63,182873
26276,0.001963,74.125.24.0-255,1484,80248,63,182873
26277,0.001992,74.125.24.0-255,7156,87404,63,182873
26278,0.001995,172.31.40.0-255,66,87470,63,182873
26279,0.002039,172.31.40.0-255,66,87536,63,182873
26280,0.002063,74.125.24.0-255,6438,93974,63,182873
26281,0.002065,172.31.40.0-255,66,94040,63,182873
26282,0.00208,74.125.24.0-255,1484,95524,63,182873
26283,0.002101,74.125.24.0-255,2902,98426,63,182873
26284,0.002103,172.31.40.0-255,66,98492,63,182873
26285,0.00211,74.125.24.0-255,5738,104230,63,182873
26286,0.002112,172.31.40.0-255,66,104296,63,182873
26287,0.002118,74.125.24.0-255,4320,108616,63,182873
26288,0.00212,172.31.40.0-255,66,108682,63,182873
26289,0.002143,74.125.24.0-255,5738,114420,63,182873
26290,0.002145,172.31.40.0-255,66,114486,63,182873
26291,0.002148,74.125.24.0-255,1484,115970,63,182873
26292,0.002171,172.31.40.0-255,66,116036,63,182873
26293,0.002188,74.125.24.0-255,3602,119638,63,182873
26294,0.00219,172.31.40.0-255,66,119704,63,182873
26295,0.002203,172.31.40.0-255,66,119770,63,182873
26296,0.002241,74.125.24.0-255,2902,122672,63,182873
26297,0.002244,172.31.40.0-255,66,122738,63,182873
26298,0.002271,172.31.40.0-255,66,122804,63,182873
26299,0.00229,74.125.24.0-255,3602,126406,63,182873
26300,0.002292,172.31.40.0-255,66,126472,63,182873
26301,0.002295,74.125.24.0-255,1484,127956,63,182873
26302,0.002298,74.125.24.0-255,1484,129440,63,182873
26303,0.0023,172.31.40.0-255,66,129506,63,182873
26304,0.002317,74.125.24.0-255,1484,130990,63,182873
26305,0.002323,74.125.24.0-255,5738,136728,63,182873
26306,0.002326,172.31.40.0-255,66,136794,63,182873
26307,0.002356,172.31.40.0-255,66,136860,63,182873
26308,0.002367,74.125.24.0-255,1484,138344,63,182873
26309,0.002407,74.125.24.0-255,4320,142664,63,182873
26310,0.00241,172.31.40.0-255,66,142730,63,182873
26311,0.002433,74.125.24.0-255,6438,149168,63,182873
26312,0.002436,172.31.40.0-255,66,149234,63,182873
26313,0.004981,74.125.24.0-255,4320,153554,63,182873
26314,0.004985,172.31.40.0-255,66,153620,63,182873
26315,0.005001,74.125.24.0-255,1484,155104,63,182873
26316,0.006858,172.31.40.0-255,101,155205,63,182873
26317,0.007524,74.125.24.0-255,4320,159525,63,182873
26318,0.00753,172.31.40.0-255,66,159591,63,182873
26319,0.009397,74.125.24.0-255,1484,161075,63,182873
26320,0.010076,74.125.24.0-255,4320,165395,63,182873
26321,0.010081,172.31.40.0-255,66,165461,63,182873
26322,0.012654,74.125.24.0-255,5738,171199,63,182873
26323,0.012661,172.31.40.0-255,66,171265,63,182873
26324,0.015219,74.125.24.0-255,5738,177003,63,182873
26325,0.015229,172.31.40.0-255,66,177069,63,182873
26326,0.017763,74.125.24.0-255,5738,182807,63,182873
26327,0.01777,172.31.40.0-255,66,182873,63,182873
26328,0.0,172.217.194.0-255,153,153,63,210963
26329,3.5e-05,172.31.40.0-255,66,219,63,210963
26330,4.2e-05,172.217.194.0-255,1484,1703,63,210963
26331,4.6e-05,172.31.40.0-255,66,1769,63,210963
26332,5e-05,172.217.194.0-255,2902,4671,63,210963
26333,6e-05,172.31.40.0-255,66,4737,63,210963
26334,6.8e-05,172.217.194.0-255,7156,11893,63,210963
26335,7.1e-05,172.31.40.0-255,66,11959,63,210963
26336,7.4e-05,172.217.194.0-255,1984,13943,63,210963
26337,7.6e-05,172.31.40.0-255,66,14009,63,210963
26338,0.000298,172.217.194.0-255,1484,15493,63,210963
26339,0.000303,172.31.40.0-255,66,15559,63,210963
26340,0.00031,172.217.194.0-255,2902,18461,63,210963
26341,0.000313,172.31.40.0-255,66,18527,63,210963
26342,0.000324,172.217.194.0-255,5738,24265,63,210963
26343,0.000327,172.31.40.0-255,66,24331,63,210963
26344,0.000352,172.217.194.0-255,1484,25815,63,210963
26345,0.000355,172.31.40.0-255,66,25881,63,210963
26346,0.00039,172.217.194.0-255,5379,31260,63,210963
26347,0.000394,172.31.40.0-255,66,31326,63,210963
26348,0.000715,172.217.194.0-255,1484,32810,63,210963
26349,0.00072,172.31.40.0-255,66,32876,63,210963
26350,0.000729,172.217.194.0-255,2902,35778,63,210963
26351,0.000732,172.31.40.0-255,66,35844,63,210963
26352,0.000744,172.217.194.0-255,2902,38746,63,210963
26353,0.000747,172.31.40.0-255,66,38812,63,210963
26354,0.000776,172.217.194.0-255,2902,41714,63,210963
26355,0.00078,172.31.40.0-255,66,41780,63,210963
26356,0.000788,172.217.194.0-255,7156,48936,63,210963
26357,0.00079,172.31.40.0-255,66,49002,63,210963
26358,0.00083,172.217.194.0-255,2543,51545,63,210963
26359,0.000834,172.31.40.0-255,66,51611,63,210963
26360,0.000846,172.31.40.0-255,66,51677,63,210963
26361,0.000851,172.217.194.0-255,3961,55638,63,210963
26362,0.000852,172.31.40.0-255,66,55704,63,210963
26363,0.001085,172.217.194.0-255,645,56349,63,210963
26364,0.00123,172.217.194.0-255,1484,57833,63,210963
26365,0.001235,172.31.40.0-255,66,57899,63,210963
26366,0.001241,172.217.194.0-255,2902,60801,63,210963
26367,0.001243,172.31.40.0-255,66,60867,63,210963
26368,0.001274,172.217.194.0-255,5738,66605,63,210963
26369,0.001277,172.31.40.0-255,66,66671,63,210963
26370,0.00128,172.217.194.0-255,1484,68155,63,210963
26371,0.001285,172.217.194.0-255,2902,71057,63,210963
26372,0.001287,172.31.40.0-255,66,71123,63,210963
26373,0.001317,172.31.40.0-255,66,71189,63,210963
26374,0.001327,172.31.40.0-255,66,71255,63,210963
26375,0.001581,172.217.194.0-255,1484,72739,63,210963
26376,0.001585,172.217.194.0-255,1484,74223,63,210963
26377,0.001589,172.31.40.0-255,66,74289,63,210963
26378,0.001614,172.217.194.0-255,1484,75773,63,210963
26379,0.00162,172.217.194.0-255,5738,81511,63,210963
26380,0.001625,172.31.40.0-255,66,81577,63,210963
26381,0.001664,172.217.194.0-255,2902,84479,63,210963
26382,0.001668,172.31.40.0-255,66,84545,63,210963
26383,0.001671,172.31.40.0-255,66,84611,63,210963
26384,0.0017,172.31.40.0-255,66,84677,63,210963
26385,0.001703,172.217.194.0-255,1484,86161,63,210963
26386,0.001706,172.217.194.0-255,1484,87645,63,210963
26387,0.001708,172.31.40.0-255,66,87711,63,210963
26388,0.001742,172.217.194.0-255,1484,89195,63,210963
26389,0.001748,172.217.194.0-255,5738,94933,63,210963
26390,0.001757,172.31.40.0-255,66,94999,63,210963
26391,0.001771,172.31.40.0-255,66,95065,63,210963
26392,0.001808,172.217.194.0-255,4320,99385,63,210963
26393,0.00181,172.31.40.0-255,66,99451,63,210963
26394,0.001835,172.217.194.0-255,4320,103771,63,210963
26395,0.001838,172.31.40.0-255,66,103837,63,210963
26396,0.001842,172.217.194.0-255,2184,106021,63,210963
26397,0.001844,172.31.40.0-255,66,106087,63,210963
26398,0.001877,172.217.194.0-255,1484,107571,63,210963
26399,0.001891,172.217.194.0-255,2902,110473,63,210963
26400,0.001894,172.31.40.0-255,66,110539,63,210963
26401,0.0019,172.217.194.0-255,4320,114859,63,210963
26402,0.001902,172.31.40.0-255,66,114925,63,210963
26403,0.00192,172.217.194.0-255,1484,116409,63,210963
26404,0.001942,172.217.194.0-255,5738,122147,63,210963
26405,0.001944,172.31.40.0-255,66,122213,63,210963
26406,0.001974,172.217.194.0-255,4320,126533,63,210963
26407,0.001977,172.31.40.0-255,66,126599,63,210963
26408,0.001982,172.217.194.0-255,2902,129501,63,210963
26409,0.001983,172.31.40.0-255,66,129567,63,210963
26410,0.00202,172.31.40.0-255,66,129633,63,210963
26411,0.002127,172.217.194.0-255,1484,131117,63,210963
26412,0.002141,172.217.194.0-255,2902,134019,63,210963
26413,0.002144,172.31.40.0-255,66,134085,63,210963
26414,0.002172,172.217.194.0-255,5738,139823,63,210963
26415,0.002175,172.31.40.0-255,66,139889,63,210963
26416,0.002179,172.217.194.0-255,2902,142791,63,210963
26417,0.00218,172.31.40.0-255,66,142857,63,210963
26418,0.002209,172.217.194.0-255,7156,150013,63,210963
26419,0.002211,172.31.40.0-255,66,150079,63,210963
26420,0.002221,172.31.40.0-255,66,150145,63,210963
26421,0.002255,172.217.194.0-255,2902,153047,63,210963
26422,0.002258,172.31.40.0-255,66,153113,63,210963
26423,0.002262,172.217.194.0-255,2184,155297,63,210963
26424,0.002264,172.31.40.0-255,66,155363,63,210963
26425,0.002308,172.217.194.0-255,1484,156847,63,210963
26426,0.002324,172.217.194.0-255,2902,159749,63,210963
26427,0.002327,172.31.40.0-255,66,159815,63,210963
26428,0.002339,172.217.194.0-255,2902,162717,63,210963
26429,0.002344,172.31.40.0-255,66,162783,63,210963
26430,0.002376,172.217.194.0-255,2902,165685,63,210963
26431,0.002379,172.31.40.0-255,66,165751,63,210963
26432,0.002383,172.217.194.0-255,4320,170071,63,210963
26433,0.00239,172.31.40.0-255,66,170137,63,210963
26434,0.004705,172.217.194.0-255,1484,171621,63,210963
26435,0.004726,172.217.194.0-255,1484,173105,63,210963
26436,0.00473,172.31.40.0-255,66,173171,63,210963
26437,0.004756,172.217.194.0-255,2902,176073,63,210963
26438,0.004758,172.31.40.0-255,66,176139,63,210963
26439,0.007087,172.217.194.0-255,5738,181877,63,210963
26440,0.007096,172.31.40.0-255,66,181943,63,210963
26441,0.009448,172.217.194.0-255,5738,187681,63,210963
26442,0.009459,172.31.40.0-255,66,187747,63,210963
26443,0.011797,172.217.194.0-255,5738,193485,63,210963
26444,0.011804,172.31.40.0-255,66,193551,63,210963
26445,0.014173,172.217.194.0-255,5738,199289,63,210963
26446,0.014185,172.31.40.0-255,66,199355,63,210963
26447,0.016526,172.217.194.0-255,5738,205093,63,210963
26448,0.016533,172.31.40.0-255,66,205159,63,210963
26449,0.018876,172.217.194.0-255,5738,210897,63,210963
26450,0.018882,172.31.40.0-255,66,210963,63,210963
26451,0.0,172.217.194.0-255,146,146,63,138798
26452,2.1e-05,172.31.40.0-255,66,212,63,138798
26453,2.8e-05,172.217.194.0-255,1484,1696,63,138798
26454,3.4e-05,172.31.40.0-255,66,1762,63,138798
26455,4e-05,172.217.194.0-255,2902,4664,63,138798
26456,5.1e-05,172.31.40.0-255,66,4730,63,138798
26457,5.9e-05,172.217.194.0-255,7156,11886,63,138798
26458,6.2e-05,172.31.40.0-255,66,11952,63,138798
26459,6.6e-05,172.217.194.0-255,2131,14083,63,138798
26460,6.8e-05,172.31.40.0-255,66,14149,63,138798
26461,9.5e-05,172.217.194.0-255,2902,17051,63,138798
26462,9.8e-05,172.31.40.0-255,66,17117,63,138798
26463,0.000106,172.217.194.0-255,7156,24273,63,138798
26464,0.000108,172.31.40.0-255,66,24339,63,138798
26465,0.000112,172.217.194.0-255,2902,27241,63,138798
26466,0.000114,172.31.40.0-255,66,27307,63,138798
26467,0.000138,172.217.194.0-255,1484,28791,63,138798
26468,0.000144,172.31.40.0-255,66,28857,63,138798
26469,0.000179,172.217.194.0-255,2543,31400,63,138798
26470,0.000182,172.31.40.0-255,66,31466,63,138798
26471,0.000216,172.217.194.0-255,2902,34368,63,138798
26472,0.000219,172.31.40.0-255,66,34434,63,138798
26473,0.000252,172.217.194.0-255,4320,38754,63,138798
26474,0.000255,172.31.40.0-255,66,38820,63,138798
26475,0.00027,172.31.40.0-255,66,38886,63,138798
26476,0.000323,172.31.40.0-255,66,38952,63,138798
26477,0.000326,172.217.194.0-255,391,39343,63,138798
26478,0.000328,172.31.40.0-255,66,39409,63,138798
26479,0.00072,172.217.194.0-255,383,39792,63,138798
26480,0.000726,172.31.40.0-255,66,39858,63,138798
26481,0.000989,172.217.194.0-255,1484,41342,63,138798
26482,0.001004,172.217.194.0-255,2902,44244,63,138798
26483,0.001007,172.31.40.0-255,66,44310,63,138798
26484,0.001041,172.217.194.0-255,5738,50048,63,138798
26485,0.001044,172.31.40.0-255,66,50114,63,138798
26486,0.00108,172.31.40.0-255,66,50180,63,138798
26487,0.001107,172.217.194.0-255,5738,55918,63,138798
26488,0.00111,172.31.40.0-255,66,55984,63,138798
26489,0.00112,172.217.194.0-255,4320,60304,63,138798
26490,0.001122,172.31.40.0-255,66,60370,63,138798
26491,0.001144,172.217.194.0-255,766,61136,63,138798
26492,0.001206,172.217.194.0-255,1484,62620,63,138798
26493,0.001211,172.31.40.0-255,66,62686,63,138798
26494,0.00122,172.217.194.0-255,2902,65588,63,138798
26495,0.001222,172.31.40.0-255,66,65654,63,138798
26496,0.001233,172.217.194.0-255,5738,71392,63,138798
26497,0.001235,172.31.40.0-255,66,71458,63,138798
26498,0.001276,172.31.40.0-255,66,71524,63,138798
26499,0.0013,172.217.194.0-255,1484,73008,63,138798
26500,0.001332,172.31.40.0-255,66,73074,63,138798
26501,0.001934,172.217.194.0-255,1484,74558,63,138798
26502,0.001943,172.217.194.0-255,2902,77460,63,138798
26503,0.001947,172.31.40.0-255,66,77526,63,138798
26504,0.001951,172.217.194.0-255,1484,79010,63,138798
26505,0.00198,172.217.194.0-255,4320,83330,63,138798
26506,0.001982,172.31.40.0-255,66,83396,63,138798
26507,0.001987,172.217.194.0-255,4320,87716,63,138798
26508,0.001989,172.31.40.0-255,66,87782,63,138798
26509,0.002029,172.217.194.0-255,5738,93520,63,138798
26510,0.002032,172.31.40.0-255,66,93586,63,138798
26511,0.002058,172.217.194.0-255,5738,99324,63,138798
26512,0.002061,172.31.40.0-255,66,99390,63,138798
26513,0.002075,172.31.40.0-255,66,99456,63,138798
26514,0.004499,172.217.194.0-255,5738,105194,63,138798
26515,0.004507,172.31.40.0-255,66,105260,63,138798
26516,0.006804,172.217.194.0-255,4320,109580,63,138798
26517,0.006811,172.31.40.0-255,66,109646,63,138798
26518,0.006839,172.217.194.0-255,1484,111130,63,138798
26519,0.009137,172.217.194.0-255,4320,115450,63,138798
26520,0.009144,172.31.40.0-255,66,115516,63,138798
26521,0.01166,172.217.194.0-255,5738,121254,63,138798
26522,0.011669,172.31.40.0-255,66,121320,63,138798
26523,0.013986,172.217.194.0-255,5738,127058,63,138798
26524,0.013994,172.31.40.0-255,66,127124,63,138798
26525,0.016322,172.217.194.0-255,5738,132862,63,138798
26526,0.016333,172.31.40.0-255,66,132928,63,138798
26527,0.018692,172.217.194.0-255,4320,137248,63,138798
26528,0.018701,172.31.40.0-255,66,137314,63,138798
26529,0.018728,172.217.194.0-255,1484,138798,63,138798
26530,0.0,74.125.130.0-255,153,153,63,329150
26531,2.5e-05,172.31.40.0-255,66,219,63,329150
26532,3.4e-05,74.125.130.0-255,1484,1703,63,329150
26533,3.8e-05,172.31.40.0-255,66,1769,63,329150
26534,4.4e-05,74.125.130.0-255,2902,4671,63,329150
26535,4.7e-05,172.31.40.0-255,66,4737,63,329150
26536,5.3e-05,74.125.130.0-255,4320,9057,63,329150
26537,5.7e-05,172.31.40.0-255,66,9123,63,329150
26538,6.4e-05,74.125.130.0-255,4786,13909,63,329150
26539,6.7e-05,172.31.40.0-255,66,13975,63,329150
26540,0.000116,74.125.130.0-255,1484,15459,63,329150
26541,0.000119,172.31.40.0-255,66,15525,63,329150
26542,0.000124,74.125.130.0-255,2902,18427,63,329150
26543,0.000126,172.31.40.0-255,66,18493,63,329150
26544,0.000139,74.125.130.0-255,1484,19977,63,329150
26545,0.000141,172.31.40.0-255,66,20043,63,329150
26546,0.000146,74.125.130.0-255,2902,22945,63,329150
26547,0.000149,172.31.40.0-255,66,23011,63,329150
26548,0.000173,74.125.130.0-255,5738,28749,63,329150
26549,0.000176,172.31.40.0-255,66,28815,63,329150
26550,0.0002,74.125.130.0-255,2543,31358,63,329150
26551,0.000203,172.31.40.0-255,66,31424,63,329150
26552,0.000309,74.125.130.0-255,1484,32908,63,329150
26553,0.000314,172.31.40.0-255,66,32974,63,329150
26554,0.000318,74.125.130.0-255,1484,34458,63,329150
26555,0.00032,172.31.40.0-255,66,34524,63,329150
26556,0.000335,74.125.130.0-255,1484,36008,63,329150
26557,0.000338,172.31.40.0-255,66,36074,63,329150
26558,0.000345,74.125.130.0-255,5738,41812,63,329150
26559,0.000347,172.31.40.0-255,66,41878,63,329150
26560,0.000351,74.125.130.0-255,2902,44780,63,329150
26561,0.000353,172.31.40.0-255,66,44846,63,329150
26562,0.000359,74.125.130.0-255,3961,48807,63,329150
26563,0.000361,172.31.40.0-255,66,48873,63,329150
26564,0.000391,74.125.130.0-255,5738,54611,63,329150
26565,0.000394,172.31.40.0-255,66,54677,63,329150
26566,0.000415,74.125.130.0-255,2902,57579,63,329150
26567,0.000417,172.31.40.0-255,66,57645,63,329150
26568,0.000422,74.125.130.0-255,2902,60547,63,329150
26569,0.000424,172.31.40.0-255,66,60613,63,329150
26570,0.000455,74.125.130.0-255,5652,66265,63,329150
26571,0.000459,172.31.40.0-255,66,66331,63,329150
26572,0.000484,74.125.130.0-255,405,66736,63,329150
26573,0.000642,74.125.130.0-255,1484,68220,63,329150
26574,0.000646,172.31.40.0-255,66,68286,63,329150
26575,0.000651,74.125.130.0-255,1484,69770,63,329150
26576,0.000654,74.125.130.0-255,1484,71254,63,329150
26577,0.000657,172.31.40.0-255,66,71320,63,329150
26578,0.000679,74.125.130.0-255,1484,72804,63,329150
26579,0.000686,74.125.130.0-255,5738,78542,63,329150
26580,0.000689,172.31.40.0-255,66,78608,63,329150
26581,0.000723,74.125.130.0-255,6797,85405,63,329150
26582,0.000727,172.31.40.0-255,66,85471,63,329150
26583,0.000753,74.125.130.0-255,7156,92627,63,329150
26584,0.000756,172.31.40.0-255,66,92693,63,329150
26585,0.000772,74.125.130.0-255,5738,98431,63,329150
26586,0.000776,172.31.40.0-255,66,98497,63,329150
26587,0.000812,74.125.130.0-255,2543,101040,63,329150
26588,0.000815,172.31.40.0-255,66,101106,63,329150
26589,0.00094,74.125.130.0-255,1484,102590,63,329150
26590,0.000944,74.125.130.0-255,1484,104074,63,329150
26591,0.000947,172.31.40.0-255,66,104140,63,329150
26592,0.000959,74.125.130.0-255,1484,105624,63,329150
26593,0.000964,74.125.130.0-255,4320,109944,63,329150
26594,0.000966,172.31.40.0-255,66,110010,63,329150
26595,0.000979,74.125.130.0-255,1484,111494,63,329150
26596,0.000999,74.125.130.0-255,7156,118650,63,329150
26597,0.001002,172.31.40.0-255,66,118716,63,329150
26598,0.001008,74.125.130.0-255,4320,123036,63,329150
26599,0.00101,172.31.40.0-255,66,123102,63,329150
26600,0.001026,74.125.130.0-255,5738,128840,63,329150
26601,0.001029,172.31.40.0-255,66,128906,63,329150
26602,0.001085,74.125.130.0-255,6438,135344,63,329150
26603,0.001089,172.31.40.0-255,66,135410,63,329150
26604,0.001127,74.125.130.0-255,1484,136894,63,329150
26605,0.001145,74.125.130.0-255,2902,139796,63,329150
26606,0.001149,172.31.40.0-255,66,139862,63,329150
26607,0.001154,74.125.130.0-255,4320,144182,63,329150
26608,0.001157,172.31.40.0-255,66,144248,63,329150
26609,0.001191,74.125.130.0-255,5738,149986,63,329150
26610,0.001194,172.31.40.0-255,66,150052,63,329150
26611,0.0012,74.125.130.0-255,2902,152954,63,329150
26612,0.001202,172.31.40.0-255,66,153020,63,329150
26613,0.001223,172.31.40.0-255,66,153086,63,329150
26614,0.001228,74.125.130.0-255,4320,157406,63,329150
26615,0.001231,172.31.40.0-255,66,157472,63,329150
26616,0.001269,74.125.130.0-255,3602,161074,63,329150
26617,0.001272,172.31.40.0-255,66,161140,63,329150
26618,0.00134,74.125.130.0-255,1484,162624,63,329150
26619,0.001354,74.125.130.0-255,2902,165526,63,329150
26620,0.001358,172.31.40.0-255,66,165592,63,329150
26621,0.001361,74.125.130.0-255,1484,167076,63,329150
26622,0.001375,74.125.130.0-255,2902,169978,63,329150
26623,0.001378,172.31.40.0-255,66,170044,63,329150
26624,0.001381,74.125.130.0-255,1484,171528,63,329150
26625,0.001401,74.125.130.0-255,4320,175848,63,329150
26626,0.001404,172.31.40.0-255,66,175914,63,329150
26627,0.001436,172.31.40.0-255,66,175980,63,329150
26628,0.001439,74.125.130.0-255,1484,177464,63,329150
26629,0.001451,74.125.130.0-255,1484,178948,63,329150
26630,0.001453,172.31.40.0-255,66,179014,63,329150
26631,0.001482,74.125.130.0-255,7156,186170,63,329150
26632,0.001485,172.31.40.0-255,66,186236,63,329150
26633,0.001488,74.125.130.0-255,766,187002,63,329150
26634,0.001634,74.125.130.0-255,1484,188486,63,329150
26635,0.001638,172.31.40.0-255,66,188552,63,329150
26636,0.001642,74.125.130.0-255,1484,190036,63,329150
26637,0.001659,74.125.130.0-255,1484,191520,63,329150
26638,0.001661,172.31.40.0-255,66,191586,63,329150
26639,0.001669,74.125.130.0-255,5738,197324,63,329150
26640,0.001671,172.31.40.0-255,66,197390,63,329150
26641,0.0017,74.125.130.0-255,7156,204546,63,329150
26642,0.001703,172.31.40.0-255,66,204612,63,329150
26643,0.001724,74.125.130.0-255,5738,210350,63,329150
26644,0.001729,172.31.40.0-255,66,210416,63,329150
26645,0.001736,74.125.130.0-255,2902,213318,63,329150
26646,0.001739,172.31.40.0-255,66,213384,63,329150
26647,0.001789,172.31.40.0-255,66,213450,63,329150
26648,0.001818,74.125.130.0-255,4320,217770,63,329150
26649,0.001822,172.31.40.0-255,66,217836,63,329150
26650,0.001833,74.125.130.0-255,1484,219320,63,329150
26651,0.001846,74.125.130.0-255,7156,226476,63,329150
26652,0.001849,172.31.40.0-255,66,226542,63,329150
26653,0.001873,74.125.130.0-255,5738,232280,63,329150
26654,0.001876,172.31.40.0-255,66,232346,63,329150
26655,0.001898,74.125.130.0-255,4320,236666,63,329150
26656,0.0019,172.31.40.0-255,66,236732,63,329150
26657,0.001913,172.31.40.0-255,66,236798,63,329150
26658,0.001918,74.125.130.0-255,4320,241118,63,329150
26659,0.001921,172.31.40.0-255,66,241184,63,329150
26660,0.001941,74.125.130.0-255,2902,244086,63,329150
26661,0.001943,172.31.40.0-255,66,244152,63,329150
26662,0.001967,74.125.130.0-255,2902,247054,63,329150
26663,0.00197,172.31.40.0-255,66,247120,63,329150
26664,0.001977,74.125.130.0-255,7156,254276,63,329150
26665,0.00198,172.31.40.0-255,66,254342,63,329150
26666,0.002011,74.125.130.0-255,4320,258662,63,329150
26667,0.002014,172.31.40.0-255,66,258728,63,329150
26668,0.002025,172.31.40.0-255,66,258794,63,329150
26669,0.002042,74.125.130.0-255,2184,260978,63,329150
26670,0.002044,172.31.40.0-255,66,261044,63,329150
26671,0.002291,74.125.130.0-255,1484,262528,63,329150
26672,0.002305,74.125.130.0-255,2902,265430,63,329150
26673,0.002309,172.31.40.0-255,66,265496,63,329150
26674,0.002321,74.125.130.0-255,2902,268398,63,329150
26675,0.002324,172.31.40.0-255,66,268464,63,329150
26676,0.0024,74.125.130.0-255,4320,272784,63,329150
26677,0.002403,172.31.40.0-255,66,272850,63,329150
26678,0.00241,74.125.130.0-255,5738,278588,63,329150
26679,0.002412,172.31.40.0-255,66,278654,63,329150
26680,0.002419,74.125.130.0-255,7156,285810,63,329150
26681,0.002421,172.31.40.0-255,66,285876,63,329150
26682,0.002426,74.125.130.0-255,2902,288778,63,329150
26683,0.002428,172.31.40.0-255,66,288844,63,329150
26684,0.002444,74.125.130.0-255,1484,290328,63,329150
26685,0.00245,74.125.130.0-255,2902,293230,63,329150
26686,0.002452,172.31.40.0-255,66,293296,63,329150
26687,0.002474,74.125.130.0-255,2184,295480,63,329150
26688,0.002477,172.31.40.0-255,66,295546,63,329150
26689,0.004966,74.125.130.0-255,2902,298448,63,329150
26690,0.004975,172.31.40.0-255,66,298514,63,329150
26691,0.004992,74.125.130.0-255,2902,301416,63,329150
26692,0.004995,172.31.40.0-255,66,301482,63,329150
26693,0.0075,74.125.130.0-255,4320,305802,63,329150
26694,0.007508,172.31.40.0-255,66,305868,63,329150
26695,0.00753,74.125.130.0-255,1484,307352,63,329150
26696,0.010023,74.125.130.0-255,4320,311672,63,329150
26697,0.010029,172.31.40.0-255,66,311738,63,329150
26698,0.012544,74.125.130.0-255,5738,317476,63,329150
26699,0.012552,172.31.40.0-255,66,317542,63,329150
26700,0.015072,74.125.130.0-255,5738,323280,63,329150
26701,0.015084,172.31.40.0-255,66,323346,63,329150
26702,0.017609,74.125.130.0-255,5738,329084,63,329150
26703,0.01762,172.31.40.0-255,66,329150,63,329150
26704,0.0,172.217.194.0-255,152,152,63,144607
26705,1.8e-05,172.31.40.0-255,66,218,63,144607
26706,2.6e-05,172.217.194.0-255,1484,1702,63,144607
26707,3e-05,172.31.40.0-255,66,1768,63,144607
26708,3.5e-05,172.217.194.0-255,2902,4670,63,144607
26709,3.8e-05,172.31.40.0-255,66,4736,63,144607
26710,5.2e-05,172.217.194.0-255,7156,11892,63,144607
26711,5.5e-05,172.31.40.0-255,66,11958,63,144607
26712,0.000119,172.31.40.0-255,66,12024,63,144607
26713,0.000152,172.217.194.0-255,4899,16923,63,144607
26714,0.000155,172.31.40.0-255,66,16989,63,144607
26715,0.000259,172.217.194.0-255,2543,19532,63,144607
26716,0.000263,172.31.40.0-255,66,19598,63,144607
26717,0.000743,172.217.194.0-255,1484,21082,63,144607
26718,0.00075,172.31.40.0-255,66,21148,63,144607
26719,0.000759,172.217.194.0-255,2902,24050,63,144607
26720,0.000761,172.31.40.0-255,66,24116,63,144607
26721,0.000766,172.217.194.0-255,2902,27018,63,144607
26722,0.000768,172.31.40.0-255,66,27084,63,144607
26723,0.000795,172.217.194.0-255,2902,29986,63,144607
26724,0.000797,172.31.40.0-255,66,30052,63,144607
26725,0.000822,172.217.194.0-255,4320,34372,63,144607
26726,0.000824,172.31.40.0-255,66,34438,63,144607
26727,0.000859,172.31.40.0-255,66,34504,63,144607
26728,0.000943,172.217.194.0-255,4320,38824,63,144607
26729,0.000946,172.31.40.0-255,66,38890,63,144607
26730,0.000975,172.217.194.0-255,5634,44524,63,144607
26731,0.000978,172.31.40.0-255,66,44590,63,144607
26732,0.001006,172.217.194.0-255,121,44711,63,144607
26733,0.001009,172.31.40.0-255,66,44777,63,144607
26734,0.00155,172.217.194.0-255,1484,46261,63,144607
26735,0.001562,172.217.194.0-255,2902,49163,63,144607
26736,0.001566,172.31.40.0-255,66,49229,63,144607
26737,0.001574,172.217.194.0-255,5738,54967,63,144607
26738,0.001577,172.31.40.0-255,66,55033,63,144607
26739,0.001624,172.217.194.0-255,1484,56517,63,144607
26740,0.00165,172.31.40.0-255,66,56583,63,144607
26741,0.001768,172.31.40.0-255,66,56649,63,144607
26742,0.001863,172.217.194.0-255,1484,58133,63,144607
26743,0.001869,172.217.194.0-255,2902,61035,63,144607
26744,0.001872,172.31.40.0-255,66,61101,63,144607
26745,0.001908,172.217.194.0-255,5738,66839,63,144607
26746,0.001911,172.31.40.0-255,66,66905,63,144607
26747,0.001943,172.217.194.0-255,5738,72643,63,144607
26748,0.001946,172.31.40.0-255,66,72709,63,144607
26749,0.00198,172.217.194.0-255,7156,79865,63,144607
26750,0.001983,172.31.40.0-255,66,79931,63,144607
26751,0.002063,172.217.194.0-255,4320,84251,63,144607
26752,0.002066,172.31.40.0-255,66,84317,63,144607
26753,0.0021,172.217.194.0-255,6438,90755,63,144607
26754,0.002104,172.31.40.0-255,66,90821,63,144607
26755,0.002163,172.217.194.0-255,1484,92305,63,144607
26756,0.00217,172.217.194.0-255,2902,95207,63,144607
26757,0.002172,172.31.40.0-255,66,95273,63,144607
26758,0.002202,172.217.194.0-255,5738,101011,63,144607
26759,0.002205,172.31.40.0-255,66,101077,63,144607
26760,0.002244,172.217.194.0-255,5738,106815,63,144607
26761,0.002249,172.31.40.0-255,66,106881,63,144607
26762,0.00227,172.217.194.0-255,7156,114037,63,144607
26763,0.00236,172.217.194.0-255,1484,115521,63,144607
26764,0.005924,172.31.40.0-255,66,115587,63,144607
26765,0.008291,172.217.194.0-255,5738,121325,63,144607
26766,0.008302,172.31.40.0-255,66,121391,63,144607
26767,0.010642,172.217.194.0-255,5738,127129,63,144607
26768,0.010654,172.31.40.0-255,66,127195,63,144607
26769,0.012981,172.217.194.0-255,5738,132933,63,144607
26770,0.012994,172.31.40.0-255,66,132999,63,144607
26771,0.015311,172.217.194.0-255,5738,138737,63,144607
26772,0.015327,172.31.40.0-255,66,138803,63,144607
26773,0.017696,172.217.194.0-255,5738,144541,63,144607
26774,0.017713,172.31.40.0-255,66,144607,63,144607
26775,0.0,172.253.118.0-255,150,150,63,174299
26776,1.6e-05,172.31.40.0-255,66,216,63,174299
26777,2.3e-05,172.253.118.0-255,1484,1700,63,174299
26778,2.8e-05,172.31.40.0-255,66,1766,63,174299
26779,3.3e-05,172.253.118.0-255,2902,4668,63,174299
26780,3.5e-05,172.31.40.0-255,66,4734,63,174299
26781,4.3e-05,172.253.118.0-255,7156,11890,63,174299
26782,4.7e-05,172.31.40.0-255,66,11956,63,174299
26783,7.5e-05,172.253.118.0-255,1986,13942,63,174299
26784,7.7e-05,172.31.40.0-255,66,14008,63,174299
26785,9.9e-05,172.253.118.0-255,2902,16910,63,174299
26786,0.000102,172.31.40.0-255,66,16976,63,174299
26787,0.000105,172.253.118.0-255,1484,18460,63,174299
26788,0.000106,172.31.40.0-255,66,18526,63,174299
26789,0.000128,172.253.118.0-255,5738,24264,63,174299
26790,0.000131,172.31.40.0-255,66,24330,63,174299
26791,0.000137,172.253.118.0-255,5738,30068,63,174299
26792,0.000139,172.31.40.0-255,66,30134,63,174299
26793,0.000171,172.253.118.0-255,1125,31259,63,174299
26794,0.000173,172.31.40.0-255,66,31325,63,174299
26795,0.000275,172.253.118.0-255,1484,32809,63,174299
26796,0.000279,172.31.40.0-255,66,32875,63,174299
26797,0.000285,172.253.118.0-255,2902,35777,63,174299
26798,0.000287,172.31.40.0-255,66,35843,63,174299
26799,0.000292,172.253.118.0-255,2902,38745,63,174299
26800,0.000294,172.31.40.0-255,66,38811,63,174299
26801,0.000322,172.253.118.0-255,2902,41713,63,174299
26802,0.000325,172.31.40.0-255,66,41779,63,174299
26803,0.000332,172.253.118.0-255,6797,48576,63,174299
26804,0.000334,172.31.40.0-255,66,48642,63,174299
26805,0.000395,172.253.118.0-255,1484,50126,63,174299
26806,0.000398,172.31.40.0-255,66,50192,63,174299
26807,0.000404,172.253.118.0-255,2902,53094,63,174299
26808,0.000406,172.31.40.0-255,66,53160,63,174299
26809,0.000443,172.253.118.0-255,5738,58898,63,174299
26810,0.000446,172.31.40.0-255,66,58964,63,174299
26811,0.000451,172.253.118.0-255,4320,63284,63,174299
26812,0.000453,172.31.40.0-255,66,63350,63,174299
26813,0.000478,172.253.118.0-255,1484,64834,63,174299
26814,0.000491,172.253.118.0-255,1705,66539,63,174299
26815,0.000493,172.31.40.0-255,66,66605,63,174299
26816,0.000833,172.253.118.0-255,1484,68089,63,174299
26817,0.000853,172.253.118.0-255,2902,70991,63,174299
26818,0.000856,172.31.40.0-255,66,71057,63,174299
26819,0.000861,172.253.118.0-255,1484,72541,63,174299
26820,0.000883,172.253.118.0-255,4320,76861,63,174299
26821,0.000885,172.31.40.0-255,66,76927,63,174299
26822,0.0009,172.31.40.0-255,66,76993,63,174299
26823,0.000937,172.253.118.0-255,4320,81313,63,174299
26824,0.00094,172.31.40.0-255,66,81379,63,174299
26825,0.000958,172.253.118.0-255,6438,87817,63,174299
26826,0.00096,172.31.40.0-255,66,87883,63,174299
26827,0.001184,172.253.118.0-255,1484,89367,63,174299
26828,0.00119,172.253.118.0-255,2902,92269,63,174299
26829,0.001193,172.31.40.0-255,66,92335,63,174299
26830,0.001197,172.253.118.0-255,1484,93819,63,174299
26831,0.001215,172.253.118.0-255,4320,98139,63,174299
26832,0.001217,172.31.40.0-255,66,98205,63,174299
26833,0.001251,172.31.40.0-255,66,98271,63,174299
26834,0.001262,172.31.40.0-255,66,98337,63,174299
26835,0.00129,172.253.118.0-255,2184,100521,63,174299
26836,0.001293,172.31.40.0-255,66,100587,63,174299
26837,0.001435,172.253.118.0-255,1484,102071,63,174299
26838,0.001454,172.253.118.0-255,2902,104973,63,174299
26839,0.001457,172.31.40.0-255,66,105039,63,174299
26840,0.001465,172.253.118.0-255,5738,110777,63,174299
26841,0.001467,172.31.40.0-255,66,110843,63,174299
26842,0.001528,172.31.40.0-255,66,110909,63,174299
26843,0.001536,172.253.118.0-255,7156,118065,63,174299
26844,0.001538,172.31.40.0-255,66,118131,63,174299
26845,0.001543,172.253.118.0-255,3602,121733,63,174299
26846,0.001546,172.31.40.0-255,66,121799,63,174299
26847,0.001846,172.253.118.0-255,1484,123283,63,174299
26848,0.001861,172.253.118.0-255,2902,126185,63,174299
26849,0.001865,172.31.40.0-255,66,126251,63,174299
26850,0.001887,172.253.118.0-255,5738,131989,63,174299
26851,0.001889,172.31.40.0-255,66,132055,63,174299
26852,0.001893,172.253.118.0-255,1484,133539,63,174299
26853,0.001915,172.31.40.0-255,66,133605,63,174299
26854,0.001948,172.31.40.0-255,66,133671,63,174299
26855,0.004474,172.253.118.0-255,5738,139409,63,174299
26856,0.004481,172.31.40.0-255,66,139475,63,174299
26857,0.006999,172.253.118.0-255,5738,145213,63,174299
26858,0.007004,172.31.40.0-255,66,145279,63,174299
26859,0.009528,172.253.118.0-255,5738,151017,63,174299
26860,0.009538,172.31.40.0-255,66,151083,63,174299
26861,0.012069,172.253.118.0-255,5738,156821,63,174299
26862,0.012081,172.31.40.0-255,66,156887,63,174299
26863,0.014599,172.253.118.0-255,5738,162625,63,174299
26864,0.014617,172.31.40.0-255,66,162691,63,174299
26865,0.017144,172.253.118.0-255,5738,168429,63,174299
26866,0.017157,172.31.40.0-255,66,168495,63,174299
26867,0.01968,172.253.118.0-255,5738,174233,63,174299
26868,0.019694,172.31.40.0-255,66,174299,63,174299
26869,0.0,172.217.194.0-255,153,153,63,220652
26870,2.3e-05,172.31.40.0-255,66,219,63,220652
26871,3e-05,172.217.194.0-255,1484,1703,63,220652
26872,3.4e-05,172.31.40.0-255,66,1769,63,220652
26873,4e-05,172.217.194.0-255,2902,4671,63,220652
26874,5.1e-05,172.31.40.0-255,66,4737,63,220652
26875,5.9e-05,172.217.194.0-255,7156,11893,63,220652
26876,6.3e-05,172.31.40.0-255,66,11959,63,220652
26877,6.7e-05,172.217.194.0-255,2020,13979,63,220652
26878,7e-05,172.31.40.0-255,66,14045,63,220652
26879,7.4e-05,172.217.194.0-255,2902,16947,63,220652
26880,7.7e-05,172.31.40.0-255,66,17013,63,220652
26881,0.000125,172.217.194.0-255,7156,24169,63,220652
26882,0.000133,172.31.40.0-255,66,24235,63,220652
26883,0.00014,172.217.194.0-255,6797,31032,63,220652
26884,0.000143,172.31.40.0-255,66,31098,63,220652
26885,0.000483,172.217.194.0-255,1484,32582,63,220652
26886,0.000489,172.31.40.0-255,66,32648,63,220652
26887,0.000495,172.217.194.0-255,2902,35550,63,220652
26888,0.000498,172.31.40.0-255,66,35616,63,220652
26889,0.000503,172.217.194.0-255,2902,38518,63,220652
26890,0.000506,172.31.40.0-255,66,38584,63,220652
26891,0.000526,172.217.194.0-255,2902,41486,63,220652
26892,0.000528,172.31.40.0-255,66,41552,63,220652
26893,0.00054,172.217.194.0-255,6797,48349,63,220652
26894,0.000542,172.31.40.0-255,66,48415,63,220652
26895,0.000592,172.31.40.0-255,66,48481,63,220652
26896,0.000596,172.217.194.0-255,2849,51330,63,220652
26897,0.000598,172.31.40.0-255,66,51396,63,220652
26898,0.000626,172.217.194.0-255,379,51775,63,220652
26899,0.000632,172.31.40.0-255,66,51841,63,220652
26900,0.001216,172.217.194.0-255,1484,53325,63,220652
26901,0.001227,172.217.194.0-255,2902,56227,63,220652
26902,0.001231,172.31.40.0-255,66,56293,63,220652
26903,0.001238,172.217.194.0-255,4320,60613,63,220652
26904,0.001241,172.31.40.0-255,66,60679,63,220652
26905,0.001272,172.217.194.0-255,1484,62163,63,220652
26906,0.001281,172.217.194.0-255,7156,69319,63,220652
26907,0.001283,172.31.40.0-255,66,69385,63,220652
26908,0.001315,172.217.194.0-255,2902,72287,63,220652
26909,0.001317,172.31.40.0-255,66,72353,63,220652
26910,0.001324,172.217.194.0-255,5738,78091,63,220652
26911,0.001327,172.31.40.0-255,66,78157,63,220652
26912,0.00135,172.217.194.0-255,1484,79641,63,220652
26913,0.001395,172.217.194.0-255,6438,86079,63,220652
26914,0.001398,172.31.40.0-255,66,86145,63,220652
26915,0.001472,172.217.194.0-255,1484,87629,63,220652
26916,0.001495,172.217.194.0-255,2902,90531,63,220652
26917,0.001498,172.31.40.0-255,66,90597,63,220652
26918,0.001502,172.217.194.0-255,1484,92081,63,220652
26919,0.001507,172.217.194.0-255,2902,94983,63,220652
26920,0.001509,172.31.40.0-255,66,95049,63,220652
26921,0.001512,172.217.194.0-255,1484,96533,63,220652
26922,0.001539,172.217.194.0-255,4320,100853,63,220652
26923,0.001541,172.31.40.0-255,66,100919,63,220652
26924,0.001557,172.31.40.0-255,66,100985,63,220652
26925,0.00158,172.217.194.0-255,4320,105305,63,220652
26926,0.001583,172.31.40.0-255,66,105371,63,220652
26927,0.001594,172.217.194.0-255,6438,111809,63,220652
26928,0.001596,172.31.40.0-255,66,111875,63,220652
26929,0.001996,172.217.194.0-255,1484,113359,63,220652
26930,0.002005,172.217.194.0-255,2902,116261,63,220652
26931,0.00201,172.31.40.0-255,66,116327,63,220652
26932,0.002017,172.217.194.0-255,4320,120647,63,220652
26933,0.00202,172.31.40.0-255,66,120713,63,220652
26934,0.002051,172.217.194.0-255,1484,122197,63,220652
26935,0.002063,172.31.40.0-255,66,122263,63,220652
26936,0.002086,172.217.194.0-255,4320,126583,63,220652
26937,0.002089,172.31.40.0-255,66,126649,63,220652
26938,0.002106,172.31.40.0-255,66,126715,63,220652
26939,0.002139,172.217.194.0-255,1484,128199,63,220652
26940,0.002144,172.217.194.0-255,2902,131101,63,220652
26941,0.002146,172.31.40.0-255,66,131167,63,220652
26942,0.002152,172.217.194.0-255,5738,136905,63,220652
26943,0.002156,172.31.40.0-255,66,136971,63,220652
26944,0.002178,172.217.194.0-255,1484,138455,63,220652
26945,0.002223,172.31.40.0-255,66,138521,63,220652
26946,0.002237,172.31.40.0-255,66,138587,63,220652
26947,0.002291,172.217.194.0-255,766,139353,63,220652
26948,0.00231,172.217.194.0-255,1484,140837,63,220652
26949,0.002312,172.31.40.0-255,66,140903,63,220652
26950,0.002316,172.217.194.0-255,2902,143805,63,220652
26951,0.002319,172.31.40.0-255,66,143871,63,220652
26952,0.002338,172.217.194.0-255,4320,148191,63,220652
26953,0.00234,172.31.40.0-255,66,148257,63,220652
26954,0.002365,172.217.194.0-255,1484,149741,63,220652
26955,0.002372,172.217.194.0-255,5738,155479,63,220652
26956,0.002375,172.31.40.0-255,66,155545,63,220652
26957,0.002411,172.217.194.0-255,4320,159865,63,220652
26958,0.002414,172.31.40.0-255,66,159931,63,220652
26959,0.002432,172.31.40.0-255,66,159997,63,220652
26960,0.002436,172.217.194.0-255,2184,162181,63,220652
26961,0.002438,172.31.40.0-255,66,162247,63,220652
26962,0.002564,172.217.194.0-255,1484,163731,63,220652
26963,0.002569,172.217.194.0-255,2902,166633,63,220652
26964,0.002572,172.31.40.0-255,66,166699,63,220652
26965,0.002575,172.217.194.0-255,1484,168183,63,220652
26966,0.002604,172.217.194.0-255,4320,172503,63,220652
26967,0.002607,172.31.40.0-255,66,172569,63,220652
26968,0.002618,172.217.194.0-255,5738,178307,63,220652
26969,0.002621,172.31.40.0-255,66,178373,63,220652
26970,0.002647,172.217.194.0-255,7156,185529,63,220652
26971,0.00265,172.31.40.0-255,66,185595,63,220652
26972,0.002653,172.217.194.0-255,1484,187079,63,220652
26973,0.005208,172.217.194.0-255,4320,191399,63,220652
26974,0.005213,172.31.40.0-255,66,191465,63,220652
26975,0.007755,172.217.194.0-255,5738,197203,63,220652
26976,0.007763,172.31.40.0-255,66,197269,63,220652
26977,0.007896,172.31.40.0-255,101,197370,63,220652
26978,0.010362,172.217.194.0-255,5738,203108,63,220652
26979,0.010369,172.31.40.0-255,66,203174,63,220652
26980,0.01043,172.217.194.0-255,66,203240,63,220652
26981,0.012918,172.217.194.0-255,5738,208978,63,220652
26982,0.012926,172.31.40.0-255,66,209044,63,220652
26983,0.015514,172.217.194.0-255,5738,214782,63,220652
26984,0.015521,172.31.40.0-255,66,214848,63,220652
26985,0.018092,172.217.194.0-255,5738,220586,63,220652
26986,0.018102,172.31.40.0-255,66,220652,63,220652
26987,0.0,172.217.160.0-255,152,152,63,133212
26988,2.1e-05,172.31.40.0-255,66,218,63,133212
26989,2.8e-05,172.217.160.0-255,1484,1702,63,133212
26990,3.2e-05,172.31.40.0-255,66,1768,63,133212
26991,3.7e-05,172.217.160.0-255,2902,4670,63,133212
26992,3.9e-05,172.31.40.0-255,66,4736,63,133212
26993,5.2e-05,172.217.160.0-255,5738,10474,63,133212
26994,5.5e-05,172.31.40.0-255,66,10540,63,133212
26995,0.00011,172.217.160.0-255,3359,13899,63,133212
26996,0.000113,172.31.40.0-255,66,13965,63,133212
26997,0.000194,172.217.160.0-255,1484,15449,63,133212
26998,0.000197,172.31.40.0-255,66,15515,63,133212
26999,0.000223,172.217.160.0-255,2902,18417,63,133212
27000,0.000226,172.31.40.0-255,66,18483,63,133212
27001,0.000256,172.217.160.0-255,5738,24221,63,133212
27002,0.000259,172.31.40.0-255,66,24287,63,133212
27003,0.000265,172.217.160.0-255,5738,30025,63,133212
27004,0.000266,172.31.40.0-255,66,30091,63,133212
27005,0.000292,172.217.160.0-255,1125,31216,63,133212
27006,0.000294,172.31.40.0-255,66,31282,63,133212
27007,0.00032,172.217.160.0-255,7156,38438,63,133212
27008,0.000323,172.31.40.0-255,66,38504,63,133212
27009,0.000328,172.217.160.0-255,4320,42824,63,133212
27010,0.000329,172.31.40.0-255,66,42890,63,133212
27011,0.000347,172.217.160.0-255,1484,44374,63,133212
27012,0.000349,172.31.40.0-255,66,44440,63,133212
27013,0.000379,172.217.160.0-255,3961,48401,63,133212
27014,0.000381,172.31.40.0-255,66,48467,63,133212
27015,0.000583,172.217.160.0-255,1484,49951,63,133212
27016,0.000587,172.31.40.0-255,66,50017,63,133212
27017,0.000593,172.217.160.0-255,2902,52919,63,133212
27018,0.000596,172.31.40.0-255,66,52985,63,133212
27019,0.000626,172.217.160.0-255,5738,58723,63,133212
27020,0.000628,172.31.40.0-255,66,58789,63,133212
27021,0.000635,172.217.160.0-255,6797,65586,63,133212
27022,0.000637,172.31.40.0-255,66,65652,63,133212
27023,0.000662,172.217.160.0-255,372,66024,63,133212
27024,0.000994,172.31.40.0-255,66,66090,63,133212
27025,0.001505,172.217.160.0-255,371,66461,63,133212
27026,0.001602,172.217.160.0-255,1484,67945,63,133212
27027,0.001607,172.31.40.0-255,66,68011,63,133212
27028,0.001613,172.217.160.0-255,2902,70913,63,133212
27029,0.001614,172.31.40.0-255,66,70979,63,133212
27030,0.001619,172.217.160.0-255,2902,73881,63,133212
27031,0.001621,172.31.40.0-255,66,73947,63,133212
27032,0.001648,172.217.160.0-255,2902,76849,63,133212
27033,0.001654,172.31.40.0-255,66,76915,63,133212
27034,0.001665,172.31.40.0-255,66,76981,63,133212
27035,0.001674,172.31.40.0-255,66,77047,63,133212
27036,0.001702,172.217.160.0-255,2902,79949,63,133212
27037,0.001704,172.31.40.0-255,66,80015,63,133212
27038,0.001707,172.217.160.0-255,1125,81140,63,133212
27039,0.003635,172.217.160.0-255,1484,82624,63,133212
27040,0.003638,172.31.40.0-255,66,82690,63,133212
27041,0.003674,172.217.160.0-255,1484,84174,63,133212
27042,0.003683,172.217.160.0-255,1484,85658,63,133212
27043,0.003684,172.31.40.0-255,66,85724,63,133212
27044,0.005616,172.217.160.0-255,2902,88626,63,133212
27045,0.005621,172.31.40.0-255,66,88692,63,133212
27046,0.005652,172.217.160.0-255,2902,91594,63,133212
27047,0.005655,172.31.40.0-255,66,91660,63,133212
27048,0.007592,172.217.160.0-255,2902,94562,63,133212
27049,0.007597,172.31.40.0-255,66,94628,63,133212
27050,0.007632,172.217.160.0-255,2902,97530,63,133212
27051,0.007635,172.31.40.0-255,66,97596,63,133212
27052,0.009578,172.217.160.0-255,2902,100498,63,133212
27053,0.009586,172.31.40.0-255,66,100564,63,133212
27054,0.009618,172.217.160.0-255,2902,103466,63,133212
27055,0.00962,172.31.40.0-255,66,103532,63,133212
27056,0.011564,172.217.160.0-255,2902,106434,63,133212
27057,0.011571,172.31.40.0-255,66,106500,63,133212
27058,0.011609,172.217.160.0-255,2902,109402,63,133212
27059,0.011612,172.31.40.0-255,66,109468,63,133212
27060,0.013549,172.217.160.0-255,2902,112370,63,133212
27061,0.013558,172.31.40.0-255,66,112436,63,133212
27062,0.013589,172.217.160.0-255,2902,115338,63,133212
27063,0.013592,172.31.40.0-255,66,115404,63,133212
27064,0.015546,172.217.160.0-255,2902,118306,63,133212
27065,0.015555,172.31.40.0-255,66,118372,63,133212
27066,0.015585,172.217.160.0-255,2902,121274,63,133212
27067,0.015588,172.31.40.0-255,66,121340,63,133212
27068,0.017525,172.217.160.0-255,2902,124242,63,133212
27069,0.017533,172.31.40.0-255,66,124308,63,133212
27070,0.017568,172.217.160.0-255,2902,127210,63,133212
27071,0.017571,172.31.40.0-255,66,127276,63,133212
27072,0.019545,172.217.160.0-255,2902,130178,63,133212
27073,0.019552,172.31.40.0-255,66,130244,63,133212
27074,0.019584,172.217.160.0-255,2902,133146,63,133212
27075,0.019587,172.31.40.0-255,66,133212,63,133212
27076,0.0,172.217.194.0-255,150,150,63,109634
27077,2.1e-05,172.31.40.0-255,66,216,63,109634
27078,2.8e-05,172.217.194.0-255,1484,1700,63,109634
27079,3.3e-05,172.31.40.0-255,66,1766,63,109634
27080,3.9e-05,172.217.194.0-255,2902,4668,63,109634
27081,4.3e-05,172.31.40.0-255,66,4734,63,109634
27082,5.1e-05,172.217.194.0-255,7156,11890,63,109634
27083,5.5e-05,172.31.40.0-255,66,11956,63,109634
27084,5.9e-05,172.217.194.0-255,2029,13985,63,109634
27085,6.3e-05,172.31.40.0-255,66,14051,63,109634
27086,6.8e-05,172.217.194.0-255,2902,16953,63,109634
27087,7.1e-05,172.31.40.0-255,66,17019,63,109634
27088,0.000116,172.31.40.0-255,66,17085,63,109634
27089,0.000122,172.217.194.0-255,5379,22464,63,109634
27090,0.000124,172.31.40.0-255,66,22530,63,109634
27091,0.000245,172.217.194.0-255,1484,24014,63,109634
27092,0.000249,172.31.40.0-255,66,24080,63,109634
27093,0.000255,172.217.194.0-255,2902,26982,63,109634
27094,0.000257,172.31.40.0-255,66,27048,63,109634
27095,0.000263,172.217.194.0-255,5738,32786,63,109634
27096,0.000266,172.31.40.0-255,66,32852,63,109634
27097,0.000315,172.31.40.0-255,66,32918,63,109634
27098,0.000333,172.217.194.0-255,5738,38656,63,109634
27099,0.000336,172.31.40.0-255,66,38722,63,109634
27100,0.00035,172.217.194.0-255,5738,44460,63,109634
27101,0.000353,172.31.40.0-255,66,44526,63,109634
27102,0.000356,172.217.194.0-255,1414,45940,63,109634
27103,0.000358,172.31.40.0-255,66,46006,63,109634
27104,0.000644,172.217.194.0-255,98,46104,63,109634
27105,0.000649,172.31.40.0-255,66,46170,63,109634
27106,0.000767,172.217.194.0-255,1484,47654,63,109634
27107,0.000772,172.217.194.0-255,1484,49138,63,109634
27108,0.000775,172.31.40.0-255,66,49204,63,109634
27109,0.000793,172.217.194.0-255,1484,50688,63,109634
27110,0.0008,172.217.194.0-255,5738,56426,63,109634
27111,0.000802,172.31.40.0-255,66,56492,63,109634
27112,0.000823,172.217.194.0-255,5738,62230,63,109634
27113,0.000826,172.31.40.0-255,66,62296,63,109634
27114,0.000859,172.31.40.0-255,66,62362,63,109634
27115,0.000871,172.31.40.0-255,66,62428,63,109634
27116,0.002194,172.217.194.0-255,1484,63912,63,109634
27117,0.002205,172.217.194.0-255,2902,66814,63,109634
27118,0.00221,172.31.40.0-255,66,66880,63,109634
27119,0.002223,172.217.194.0-255,1484,68364,63,109634
27120,0.002241,172.217.194.0-255,4320,72684,63,109634
27121,0.002244,172.31.40.0-255,66,72750,63,109634
27122,0.002261,172.217.194.0-255,1484,74234,63,109634
27123,0.002287,172.31.40.0-255,66,74300,63,109634
27124,0.00232,172.31.40.0-255,66,74366,63,109634
27125,0.002352,172.217.194.0-255,2184,76550,63,109634
27126,0.002354,172.31.40.0-255,66,76616,63,109634
27127,0.002366,172.31.40.0-255,66,76682,63,109634
27128,0.002379,172.31.40.0-255,66,76748,63,109634
27129,0.002391,172.31.40.0-255,66,76814,63,109634
27130,0.002421,172.217.194.0-255,766,77580,63,109634
27131,0.004929,172.217.194.0-255,4320,81900,63,109634
27132,0.004936,172.31.40.0-255,66,81966,63,109634
27133,0.007479,172.217.194.0-255,4320,86286,63,109634
27134,0.007484,172.31.40.0-255,66,86352,63,109634
27135,0.007502,172.217.194.0-255,1484,87836,63,109634
27136,0.010047,172.217.194.0-255,4320,92156,63,109634
27137,0.010055,172.31.40.0-255,66,92222,63,109634
27138,0.012614,172.217.194.0-255,5738,97960,63,109634
27139,0.012625,172.31.40.0-255,66,98026,63,109634
27140,0.015158,172.217.194.0-255,5738,103764,63,109634
27141,0.015167,172.31.40.0-255,66,103830,63,109634
27142,0.017719,172.217.194.0-255,5738,109568,63,109634
27143,0.017728,172.31.40.0-255,66,109634,63,109634
27144,0.0,74.125.68.0-255,153,153,63,194262
27145,2.3e-05,172.31.40.0-255,66,219,63,194262
27146,3e-05,74.125.68.0-255,1484,1703,63,194262
27147,3.4e-05,172.31.40.0-255,66,1769,63,194262
27148,3.9e-05,74.125.68.0-255,2902,4671,63,194262
27149,4.1e-05,172.31.40.0-255,66,4737,63,194262
27150,4.6e-05,74.125.68.0-255,2902,7639,63,194262
27151,4.9e-05,172.31.40.0-255,66,7705,63,194262
27152,7.3e-05,74.125.68.0-255,2902,10607,63,194262
27153,7.5e-05,172.31.40.0-255,66,10673,63,194262
27154,8e-05,74.125.68.0-255,3516,14189,63,194262
27155,8.2e-05,172.31.40.0-255,66,14255,63,194262
27156,8.7e-05,74.125.68.0-255,4320,18575,63,194262
27157,8.9e-05,172.31.40.0-255,66,18641,63,194262
27158,0.00012,74.125.68.0-255,7156,25797,63,194262
27159,0.000122,172.31.40.0-255,66,25863,63,194262
27160,0.000134,74.125.68.0-255,2902,28765,63,194262
27161,0.000136,172.31.40.0-255,66,28831,63,194262
27162,0.00014,74.125.68.0-255,2543,31374,63,194262
27163,0.000141,172.31.40.0-255,66,31440,63,194262
27164,0.000366,74.125.68.0-255,1484,32924,63,194262
27165,0.000371,172.31.40.0-255,66,32990,63,194262
27166,0.000376,74.125.68.0-255,2902,35892,63,194262
27167,0.000378,172.31.40.0-255,66,35958,63,194262
27168,0.000397,74.125.68.0-255,4320,40278,63,194262
27169,0.000399,172.31.40.0-255,66,40344,63,194262
27170,0.000424,74.125.68.0-255,2902,43246,63,194262
27171,0.000426,172.31.40.0-255,66,43312,63,194262
27172,0.00044,74.125.68.0-255,6797,50109,63,194262
27173,0.000442,172.31.40.0-255,66,50175,63,194262
27174,0.000446,74.125.68.0-255,2902,53077,63,194262
27175,0.000448,172.31.40.0-255,66,53143,63,194262
27176,0.000492,74.125.68.0-255,2902,56045,63,194262
27177,0.000495,172.31.40.0-255,66,56111,63,194262
27178,0.00052,172.31.40.0-255,66,56177,63,194262
27179,0.000682,74.125.68.0-255,117,56294,63,194262
27180,0.000733,74.125.68.0-255,1484,57778,63,194262
27181,0.000737,172.31.40.0-255,66,57844,63,194262
27182,0.000756,74.125.68.0-255,1484,59328,63,194262
27183,0.000767,74.125.68.0-255,1484,60812,63,194262
27184,0.000769,172.31.40.0-255,66,60878,63,194262
27185,0.000798,74.125.68.0-255,1484,62362,63,194262
27186,0.000848,74.125.68.0-255,1484,63846,63,194262
27187,0.00085,172.31.40.0-255,66,63912,63,194262
27188,0.000868,74.125.68.0-255,2902,66814,63,194262
27189,0.00087,172.31.40.0-255,66,66880,63,194262
27190,0.000874,74.125.68.0-255,2902,69782,63,194262
27191,0.000875,172.31.40.0-255,66,69848,63,194262
27192,0.000897,74.125.68.0-255,2902,72750,63,194262
27193,0.0009,172.31.40.0-255,66,72816,63,194262
27194,0.000902,74.125.68.0-255,1125,73941,63,194262
27195,0.001033,74.125.68.0-255,1484,75425,63,194262
27196,0.001037,172.31.40.0-255,66,75491,63,194262
27197,0.001041,74.125.68.0-255,1484,76975,63,194262
27198,0.001062,74.125.68.0-255,2902,79877,63,194262
27199,0.001065,172.31.40.0-255,66,79943,63,194262
27200,0.001069,74.125.68.0-255,2902,82845,63,194262
27201,0.001071,172.31.40.0-255,66,82911,63,194262
27202,0.001087,74.125.68.0-255,2902,85813,63,194262
27203,0.00109,172.31.40.0-255,66,85879,63,194262
27204,0.001096,74.125.68.0-255,4320,90199,63,194262
27205,0.001097,172.31.40.0-255,66,90265,63,194262
27206,0.001113,74.125.68.0-255,1125,91390,63,194262
27207,0.001408,172.31.40.0-255,66,91456,63,194262
27208,0.001527,74.125.68.0-255,1484,92940,63,194262
27209,0.001536,74.125.68.0-255,1484,94424,63,194262
27210,0.00154,172.31.40.0-255,66,94490,63,194262
27211,0.001556,74.125.68.0-255,1484,95974,63,194262
27212,0.001563,74.125.68.0-255,5738,101712,63,194262
27213,0.001566,172.31.40.0-255,66,101778,63,194262
27214,0.001584,74.125.68.0-255,4320,106098,63,194262
27215,0.001586,172.31.40.0-255,66,106164,63,194262
27216,0.001602,74.125.68.0-255,2902,109066,63,194262
27217,0.001604,172.31.40.0-255,66,109132,63,194262
27218,0.001634,172.31.40.0-255,66,109198,63,194262
27219,0.001654,74.125.68.0-255,4320,113518,63,194262
27220,0.001656,172.31.40.0-255,66,113584,63,194262
27221,0.00166,74.125.68.0-255,2184,115768,63,194262
27222,0.001662,172.31.40.0-255,66,115834,63,194262
27223,0.00172,74.125.68.0-255,1484,117318,63,194262
27224,0.001724,74.125.68.0-255,1484,118802,63,194262
27225,0.001727,172.31.40.0-255,66,118868,63,194262
27226,0.001746,74.125.68.0-255,1484,120352,63,194262
27227,0.001752,74.125.68.0-255,5738,126090,63,194262
27228,0.001754,172.31.40.0-255,66,126156,63,194262
27229,0.001757,74.125.68.0-255,1484,127640,63,194262
27230,0.001791,172.31.40.0-255,66,127706,63,194262
27231,0.0018,74.125.68.0-255,7156,134862,63,194262
27232,0.001802,172.31.40.0-255,66,134928,63,194262
27233,0.00182,74.125.68.0-255,4320,139248,63,194262
27234,0.001823,172.31.40.0-255,66,139314,63,194262
27235,0.001828,74.125.68.0-255,2184,141498,63,194262
27236,0.00183,172.31.40.0-255,66,141564,63,194262
27237,0.002006,74.125.68.0-255,1484,143048,63,194262
27238,0.002011,74.125.68.0-255,1484,144532,63,194262
27239,0.002015,172.31.40.0-255,66,144598,63,194262
27240,0.002034,74.125.68.0-255,1484,146082,63,194262
27241,0.002039,74.125.68.0-255,2902,148984,63,194262
27242,0.002042,172.31.40.0-255,66,149050,63,194262
27243,0.002061,74.125.68.0-255,2902,151952,63,194262
27244,0.002063,172.31.40.0-255,66,152018,63,194262
27245,0.002076,74.125.68.0-255,1484,153502,63,194262
27246,0.002102,172.31.40.0-255,66,153568,63,194262
27247,0.002135,172.31.40.0-255,66,153634,63,194262
27248,0.004447,74.125.68.0-255,5738,159372,63,194262
27249,0.004455,172.31.40.0-255,66,159438,63,194262
27250,0.006801,74.125.68.0-255,5738,165176,63,194262
27251,0.006806,172.31.40.0-255,66,165242,63,194262
27252,0.009158,74.125.68.0-255,5738,170980,63,194262
27253,0.009164,172.31.40.0-255,66,171046,63,194262
27254,0.011505,74.125.68.0-255,5738,176784,63,194262
27255,0.011514,172.31.40.0-255,66,176850,63,194262
27256,0.01385,74.125.68.0-255,5738,182588,63,194262
27257,0.013859,172.31.40.0-255,66,182654,63,194262
27258,0.016194,74.125.68.0-255,5738,188392,63,194262
27259,0.016205,172.31.40.0-255,66,188458,63,194262
27260,0.018529,74.125.68.0-255,5738,194196,63,194262
27261,0.018538,172.31.40.0-255,66,194262,63,194262
27262,0.0,172.253.118.0-255,150,150,63,162808
27263,1.6e-05,172.31.40.0-255,66,216,63,162808
27264,2.3e-05,172.253.118.0-255,1484,1700,63,162808
27265,2.7e-05,172.31.40.0-255,66,1766,63,162808
27266,3.2e-05,172.253.118.0-255,2902,4668,63,162808
27267,3.6e-05,172.31.40.0-255,66,4734,63,162808
27268,4e-05,172.253.118.0-255,2902,7636,63,162808
27269,4.3e-05,172.31.40.0-255,66,7702,63,162808
27270,6.7e-05,172.253.118.0-255,4320,12022,63,162808
27271,7e-05,172.31.40.0-255,66,12088,63,162808
27272,0.000114,172.31.40.0-255,66,12154,63,162808
27273,0.000187,172.253.118.0-255,7156,19310,63,162808
27274,0.000192,172.31.40.0-255,66,19376,63,162808
27275,0.000211,172.253.118.0-255,1484,20860,63,162808
27276,0.000213,172.31.40.0-255,66,20926,63,162808
27277,0.00024,172.253.118.0-255,1125,22051,63,162808
27278,0.000242,172.31.40.0-255,66,22117,63,162808
27279,0.000271,172.31.40.0-255,66,22183,63,162808
27280,0.000286,172.253.118.0-255,2902,25085,63,162808
27281,0.000288,172.31.40.0-255,66,25151,63,162808
27282,0.000364,172.253.118.0-255,5379,30530,63,162808
27283,0.000368,172.31.40.0-255,66,30596,63,162808
27284,0.000408,172.253.118.0-255,1484,32080,63,162808
27285,0.00041,172.31.40.0-255,66,32146,63,162808
27286,0.000429,172.253.118.0-255,1484,33630,63,162808
27287,0.000432,172.31.40.0-255,66,33696,63,162808
27288,0.000446,172.253.118.0-255,1484,35180,63,162808
27289,0.000448,172.31.40.0-255,66,35246,63,162808
27290,0.000455,172.253.118.0-255,5738,40984,63,162808
27291,0.000458,172.31.40.0-255,66,41050,63,162808
27292,0.000509,172.31.40.0-255,66,41116,63,162808
27293,0.000648,172.253.118.0-255,1484,42600,63,162808
27294,0.000663,172.253.118.0-255,2902,45502,63,162808
27295,0.000667,172.31.40.0-255,66,45568,63,162808
27296,0.000674,172.253.118.0-255,5738,51306,63,162808
27297,0.000677,172.31.40.0-255,66,51372,63,162808
27298,0.000725,172.253.118.0-255,5738,57110,63,162808
27299,0.000729,172.31.40.0-255,66,57176,63,162808
27300,0.00075,172.253.118.0-255,576,57752,63,162808
27301,0.000996,172.253.118.0-255,1484,59236,63,162808
27302,0.001001,172.31.40.0-255,66,59302,63,162808
27303,0.001007,172.253.118.0-255,2902,62204,63,162808
27304,0.001009,172.31.40.0-255,66,62270,63,162808
27305,0.001012,172.253.118.0-255,1484,63754,63,162808
27306,0.00103,172.253.118.0-255,4320,68074,63,162808
27307,0.001067,172.31.40.0-255,66,68140,63,162808
27308,0.001083,172.253.118.0-255,6797,74937,63,162808
27309,0.001086,172.31.40.0-255,66,75003,63,162808
27310,0.001306,172.253.118.0-255,1484,76487,63,162808
27311,0.00132,172.253.118.0-255,2902,79389,63,162808
27312,0.001323,172.31.40.0-255,66,79455,63,162808
27313,0.001328,172.253.118.0-255,2902,82357,63,162808
27314,0.00133,172.31.40.0-255,66,82423,63,162808
27315,0.001345,172.253.118.0-255,2902,85325,63,162808
27316,0.001348,172.31.40.0-255,66,85391,63,162808
27317,0.001387,172.253.118.0-255,5738,91129,63,162808
27318,0.001389,172.31.40.0-255,66,91195,63,162808
27319,0.001411,172.253.118.0-255,1484,92679,63,162808
27320,0.001456,172.31.40.0-255,66,92745,63,162808
27321,0.001475,172.253.118.0-255,5738,98483,63,162808
27322,0.001478,172.31.40.0-255,66,98549,63,162808
27323,0.001572,172.253.118.0-255,2184,100733,63,162808
27324,0.001575,172.31.40.0-255,66,100799,63,162808
27325,0.0016,172.253.118.0-255,5738,106537,63,162808
27326,0.001603,172.31.40.0-255,66,106603,63,162808
27327,0.001638,172.253.118.0-255,1484,108087,63,162808
27328,0.001688,172.31.40.0-255,66,108153,63,162808
27329,0.001864,172.253.118.0-255,2184,110337,63,162808
27330,0.001868,172.31.40.0-255,66,110403,63,162808
27331,0.001907,172.31.40.0-255,66,110469,63,162808
27332,0.001946,172.31.40.0-255,66,110535,63,162808
27333,0.002175,172.253.118.0-255,1484,112019,63,162808
27334,0.002181,172.253.118.0-255,2902,114921,63,162808
27335,0.002184,172.31.40.0-255,66,114987,63,162808
27336,0.002209,172.253.118.0-255,4320,119307,63,162808
27337,0.002212,172.31.40.0-255,66,119373,63,162808
27338,0.002229,172.253.118.0-255,1484,120857,63,162808
27339,0.002265,172.253.118.0-255,2902,123759,63,162808
27340,0.002268,172.31.40.0-255,66,123825,63,162808
27341,0.00229,172.253.118.0-255,3961,127786,63,162808
27342,0.002293,172.31.40.0-255,66,127852,63,162808
27343,0.002573,172.253.118.0-255,1484,129336,63,162808
27344,0.004865,172.253.118.0-255,4320,133656,63,162808
27345,0.004872,172.31.40.0-255,66,133722,63,162808
27346,0.007441,172.253.118.0-255,5738,139460,63,162808
27347,0.007444,172.31.40.0-255,66,139526,63,162808
27348,0.010032,172.253.118.0-255,5738,145264,63,162808
27349,0.010039,172.31.40.0-255,66,145330,63,162808
27350,0.012627,172.253.118.0-255,5738,151068,63,162808
27351,0.012639,172.31.40.0-255,66,151134,63,162808
27352,0.015231,172.253.118.0-255,5738,156872,63,162808
27353,0.015245,172.31.40.0-255,66,156938,63,162808
27354,0.017826,172.253.118.0-255,4320,161258,63,162808
27355,0.017836,172.31.40.0-255,66,161324,63,162808
27356,0.017861,172.253.118.0-255,1484,162808,63,162808
27357,0.0,172.217.194.0-255,152,152,63,224163
27358,2.3e-05,172.31.40.0-255,66,218,63,224163
27359,2.9e-05,172.217.194.0-255,1484,1702,63,224163
27360,3.2e-05,172.31.40.0-255,66,1768,63,224163
27361,3.6e-05,172.217.194.0-255,2902,4670,63,224163
27362,3.9e-05,172.31.40.0-255,66,4736,63,224163
27363,5.2e-05,172.217.194.0-255,7156,11892,63,224163
27364,5.5e-05,172.31.40.0-255,66,11958,63,224163
27365,8.2e-05,172.217.194.0-255,2902,14860,63,224163
27366,8.5e-05,172.31.40.0-255,66,14926,63,224163
27367,9.6e-05,172.217.194.0-255,2029,16955,63,224163
27368,9.8e-05,172.31.40.0-255,66,17021,63,224163
27369,0.000108,172.217.194.0-255,5738,22759,63,224163
27370,0.00011,172.31.40.0-255,66,22825,63,224163
27371,0.000133,172.217.194.0-255,4320,27145,63,224163
27372,0.000135,172.31.40.0-255,66,27211,63,224163
27373,0.00016,172.217.194.0-255,3961,31172,63,224163
27374,0.000166,172.31.40.0-255,66,31238,63,224163
27375,0.000191,172.217.194.0-255,1484,32722,63,224163
27376,0.000193,172.31.40.0-255,66,32788,63,224163
27377,0.000197,172.217.194.0-255,2902,35690,63,224163
27378,0.000199,172.31.40.0-255,66,35756,63,224163
27379,0.000227,172.217.194.0-255,5738,41494,63,224163
27380,0.00023,172.31.40.0-255,66,41560,63,224163
27381,0.000233,172.217.194.0-255,1484,43044,63,224163
27382,0.000234,172.31.40.0-255,66,43110,63,224163
27383,0.000258,172.217.194.0-255,5379,48489,63,224163
27384,0.000265,172.31.40.0-255,66,48555,63,224163
27385,0.000284,172.217.194.0-255,4320,52875,63,224163
27386,0.000287,172.31.40.0-255,66,52941,63,224163
27387,0.000317,172.217.194.0-255,2902,55843,63,224163
27388,0.000319,172.31.40.0-255,66,55909,63,224163
27389,0.000325,172.217.194.0-255,5738,61647,63,224163
27390,0.000327,172.31.40.0-255,66,61713,63,224163
27391,0.000343,172.217.194.0-255,4270,65983,63,224163
27392,0.000351,172.31.40.0-255,66,66049,63,224163
27393,0.000353,172.217.194.0-255,100,66149,63,224163
27394,0.000373,172.217.194.0-255,365,66514,63,224163
27395,0.000514,172.217.194.0-255,1484,67998,63,224163
27396,0.000518,172.31.40.0-255,66,68064,63,224163
27397,0.000523,172.217.194.0-255,2902,70966,63,224163
27398,0.000527,172.31.40.0-255,66,71032,63,224163
27399,0.000541,172.217.194.0-255,5738,76770,63,224163
27400,0.000544,172.31.40.0-255,66,76836,63,224163
27401,0.000551,172.217.194.0-255,5738,82574,63,224163
27402,0.000554,172.31.40.0-255,66,82640,63,224163
27403,0.000596,172.31.40.0-255,66,82706,63,224163
27404,0.000603,172.217.194.0-255,4471,87177,63,224163
27405,0.000605,172.31.40.0-255,66,87243,63,224163
27406,0.000743,172.217.194.0-255,1484,88727,63,224163
27407,0.000747,172.217.194.0-255,1484,90211,63,224163
27408,0.00075,172.31.40.0-255,66,90277,63,224163
27409,0.000777,172.217.194.0-255,1484,91761,63,224163
27410,0.000784,172.217.194.0-255,5738,97499,63,224163
27411,0.000787,172.31.40.0-255,66,97565,63,224163
27412,0.000795,172.217.194.0-255,7156,104721,63,224163
27413,0.000798,172.31.40.0-255,66,104787,63,224163
27414,0.00083,172.217.194.0-255,5738,110525,63,224163
27415,0.000833,172.31.40.0-255,66,110591,63,224163
27416,0.000844,172.31.40.0-255,66,110657,63,224163
27417,0.000852,172.217.194.0-255,766,111423,63,224163
27418,0.000887,172.217.194.0-255,1484,112907,63,224163
27419,0.000891,172.31.40.0-255,66,112973,63,224163
27420,0.000896,172.217.194.0-255,2902,115875,63,224163
27421,0.000898,172.31.40.0-255,66,115941,63,224163
27422,0.000928,172.217.194.0-255,1484,117425,63,224163
27423,0.00094,172.31.40.0-255,66,117491,63,224163
27424,0.000948,172.217.194.0-255,7156,124647,63,224163
27425,0.000952,172.31.40.0-255,66,124713,63,224163
27426,0.000971,172.217.194.0-255,5738,130451,63,224163
27427,0.00098,172.31.40.0-255,66,130517,63,224163
27428,0.001008,172.217.194.0-255,5020,135537,63,224163
27429,0.001011,172.31.40.0-255,66,135603,63,224163
27430,0.001178,172.217.194.0-255,1484,137087,63,224163
27431,0.001184,172.217.194.0-255,2902,139989,63,224163
27432,0.001187,172.31.40.0-255,66,140055,63,224163
27433,0.001192,172.217.194.0-255,2902,142957,63,224163
27434,0.001194,172.31.40.0-255,66,143023,63,224163
27435,0.001229,172.217.194.0-255,2902,145925,63,224163
27436,0.001235,172.217.194.0-255,5738,151663,63,224163
27437,0.001235,172.31.40.0-255,66,151729,63,224163
27438,0.001239,172.31.40.0-255,66,151795,63,224163
27439,0.00129,172.31.40.0-255,66,151861,63,224163
27440,0.00133,172.217.194.0-255,1484,153345,63,224163
27441,0.001337,172.217.194.0-255,5020,158365,63,224163
27442,0.001341,172.31.40.0-255,66,158431,63,224163
27443,0.001347,172.217.194.0-255,5738,164169,63,224163
27444,0.001349,172.31.40.0-255,66,164235,63,224163
27445,0.00137,172.31.40.0-255,66,164301,63,224163
27446,0.00138,172.31.40.0-255,66,164367,63,224163
27447,0.001395,172.31.40.0-255,66,164433,63,224163
27448,0.001413,172.31.40.0-255,66,164499,63,224163
27449,0.001416,172.217.194.0-255,1484,165983,63,224163
27450,0.001457,172.31.40.0-255,66,166049,63,224163
27451,0.00146,172.217.194.0-255,1484,167533,63,224163
27452,0.001492,172.31.40.0-255,66,167599,63,224163
27453,0.001495,172.217.194.0-255,1484,169083,63,224163
27454,0.001522,172.217.194.0-255,4320,173403,63,224163
27455,0.001525,172.31.40.0-255,66,173469,63,224163
27456,0.001554,172.31.40.0-255,66,173535,63,224163
27457,0.001583,172.217.194.0-255,1484,175019,63,224163
27458,0.001587,172.217.194.0-255,2902,177921,63,224163
27459,0.00159,172.31.40.0-255,66,177987,63,224163
27460,0.001596,172.217.194.0-255,5738,183725,63,224163
27461,0.001598,172.31.40.0-255,66,183791,63,224163
27462,0.001623,172.31.40.0-255,66,183857,63,224163
27463,0.001645,172.217.194.0-255,1484,185341,63,224163
27464,0.001662,172.31.40.0-255,66,185407,63,224163
27465,0.001665,172.217.194.0-255,766,186173,63,224163
27466,0.002886,172.31.40.0-255,66,186239,63,224163
27467,0.003984,172.217.194.0-255,4320,190559,63,224163
27468,0.003989,172.31.40.0-255,66,190625,63,224163
27469,0.005189,172.217.194.0-255,1484,192109,63,224163
27470,0.006291,172.217.194.0-255,4320,196429,63,224163
27471,0.006302,172.31.40.0-255,66,196495,63,224163
27472,0.008605,172.217.194.0-255,5738,202233,63,224163
27473,0.008614,172.31.40.0-255,66,202299,63,224163
27474,0.010912,172.217.194.0-255,4320,206619,63,224163
27475,0.010916,172.31.40.0-255,66,206685,63,224163
27476,0.010943,172.217.194.0-255,1484,208169,63,224163
27477,0.013252,172.217.194.0-255,4320,212489,63,224163
27478,0.013264,172.31.40.0-255,66,212555,63,224163
27479,0.015551,172.217.194.0-255,5738,218293,63,224163
27480,0.015566,172.31.40.0-255,66,218359,63,224163
27481,0.017898,172.217.194.0-255,5738,224097,63,224163
27482,0.017912,172.31.40.0-255,66,224163,63,224163
27483,0.0,74.125.68.0-255,146,146,63,172303
27484,2.4e-05,172.31.40.0-255,66,212,63,172303
27485,3.1e-05,74.125.68.0-255,1484,1696,63,172303
27486,3.6e-05,172.31.40.0-255,66,1762,63,172303
27487,4.2e-05,74.125.68.0-255,2902,4664,63,172303
27488,5.3e-05,172.31.40.0-255,66,4730,63,172303
27489,6.1e-05,74.125.68.0-255,7156,11886,63,172303
27490,6.4e-05,172.31.40.0-255,66,11952,63,172303
27491,6.8e-05,74.125.68.0-255,2066,14018,63,172303
27492,7.1e-05,172.31.40.0-255,66,14084,63,172303
27493,0.000129,74.125.68.0-255,1484,15568,63,172303
27494,0.000132,172.31.40.0-255,66,15634,63,172303
27495,0.000151,74.125.68.0-255,2902,18536,63,172303
27496,0.000154,172.31.40.0-255,66,18602,63,172303
27497,0.000156,74.125.68.0-255,1484,20086,63,172303
27498,0.000158,172.31.40.0-255,66,20152,63,172303
27499,0.000189,74.125.68.0-255,2902,23054,63,172303
27500,0.000192,172.31.40.0-255,66,23120,63,172303
27501,0.000198,74.125.68.0-255,4320,27440,63,172303
27502,0.0002,172.31.40.0-255,66,27506,63,172303
27503,0.000228,74.125.68.0-255,1484,28990,63,172303
27504,0.000231,172.31.40.0-255,66,29056,63,172303
27505,0.000236,74.125.68.0-255,2543,31599,63,172303
27506,0.000238,172.31.40.0-255,66,31665,63,172303
27507,0.00026,74.125.68.0-255,2902,34567,63,172303
27508,0.000263,172.31.40.0-255,66,34633,63,172303
27509,0.000269,74.125.68.0-255,1484,36117,63,172303
27510,0.000272,172.31.40.0-255,66,36183,63,172303
27511,0.000305,74.125.68.0-255,2902,39085,63,172303
27512,0.000308,172.31.40.0-255,66,39151,63,172303
27513,0.000315,74.125.68.0-255,5738,44889,63,172303
27514,0.000317,172.31.40.0-255,66,44955,63,172303
27515,0.00032,74.125.68.0-255,1484,46439,63,172303
27516,0.000365,74.125.68.0-255,2543,48982,63,172303
27517,0.000423,74.125.68.0-255,1484,50466,63,172303
27518,0.000441,74.125.68.0-255,2902,53368,63,172303
27519,0.000471,74.125.68.0-255,1484,54852,63,172303
27520,0.000491,74.125.68.0-255,2902,57754,63,172303
27521,0.000497,74.125.68.0-255,4320,62074,63,172303
27522,0.000508,74.125.68.0-255,1484,63558,63,172303
27523,0.000525,74.125.68.0-255,2543,66101,63,172303
27524,0.00059,74.125.68.0-255,1484,67585,63,172303
27525,0.000613,74.125.68.0-255,2902,70487,63,172303
27526,0.000623,172.31.40.0-255,66,70553,63,172303
27527,0.000634,74.125.68.0-255,4320,74873,63,172303
27528,0.000639,172.31.40.0-255,66,74939,63,172303
27529,0.000708,172.31.40.0-255,66,75005,63,172303
27530,0.001313,74.125.68.0-255,1484,76489,63,172303
27531,0.001334,74.125.68.0-255,2902,79391,63,172303
27532,0.001338,172.31.40.0-255,66,79457,63,172303
27533,0.001342,74.125.68.0-255,1484,80941,63,172303
27534,0.001376,74.125.68.0-255,4320,85261,63,172303
27535,0.001381,74.125.68.0-255,2902,88163,63,172303
27536,0.001386,74.125.68.0-255,4320,92483,63,172303
27537,0.001395,172.31.40.0-255,66,92549,63,172303
27538,0.001405,74.125.68.0-255,4320,96869,63,172303
27539,0.001411,172.31.40.0-255,66,96935,63,172303
27540,0.001431,74.125.68.0-255,4320,101255,63,172303
27541,0.001438,74.125.68.0-255,5738,106993,63,172303
27542,0.001462,172.31.40.0-255,66,107059,63,172303
27543,0.001475,74.125.68.0-255,2184,109243,63,172303
27544,0.002087,74.125.68.0-255,1484,110727,63,172303
27545,0.002113,74.125.68.0-255,1484,112211,63,172303
27546,0.002129,74.125.68.0-255,2902,115113,63,172303
27547,0.002167,74.125.68.0-255,4320,119433,63,172303
27548,0.002178,74.125.68.0-255,1484,120917,63,172303
27549,0.00219,74.125.68.0-255,4320,125237,63,172303
27550,0.002204,74.125.68.0-255,2902,128139,63,172303
27551,0.002248,74.125.68.0-255,4320,132459,63,172303
27552,0.002273,74.125.68.0-255,7156,139615,63,172303
27553,0.002278,74.125.68.0-255,3602,143217,63,172303
27554,0.005598,172.31.40.0-255,66,143283,63,172303
27555,0.008202,74.125.68.0-255,5738,149021,63,172303
27556,0.008209,172.31.40.0-255,66,149087,63,172303
27557,0.010797,74.125.68.0-255,5738,154825,63,172303
27558,0.010806,172.31.40.0-255,66,154891,63,172303
27559,0.013406,74.125.68.0-255,5738,160629,63,172303
27560,0.013415,172.31.40.0-255,66,160695,63,172303
27561,0.016022,74.125.68.0-255,5738,166433,63,172303
27562,0.016032,172.31.40.0-255,66,166499,63,172303
27563,0.018631,74.125.68.0-255,5738,172237,63,172303
27564,0.01864,172.31.40.0-255,66,172303,63,172303
27565,0.0,172.217.194.0-255,153,153,63,167678
27566,3.4e-05,172.31.40.0-255,66,219,63,167678
27567,4.1e-05,172.217.194.0-255,1484,1703,63,167678
27568,4.5e-05,172.31.40.0-255,66,1769,63,167678
27569,5e-05,172.217.194.0-255,2902,4671,63,167678
27570,5.9e-05,172.31.40.0-255,66,4737,63,167678
27571,6.5e-05,172.217.194.0-255,4320,9057,63,167678
27572,6.7e-05,172.31.40.0-255,66,9123,63,167678
27573,0.000103,172.31.40.0-255,66,9189,63,167678
27574,0.000105,172.217.194.0-255,1484,10673,63,167678
27575,0.000107,172.31.40.0-255,66,10739,63,167678
27576,0.00015,172.31.40.0-255,66,10805,63,167678
27577,0.000166,172.31.40.0-255,66,10871,63,167678
27578,0.000222,172.217.194.0-255,2184,13055,63,167678
27579,0.000225,172.31.40.0-255,66,13121,63,167678
27580,0.00023,172.217.194.0-255,2902,16023,63,167678
27581,0.000232,172.31.40.0-255,66,16089,63,167678
27582,0.000239,172.217.194.0-255,7156,23245,63,167678
27583,0.000241,172.31.40.0-255,66,23311,63,167678
27584,0.000249,172.217.194.0-255,7100,30411,63,167678
27585,0.000251,172.31.40.0-255,66,30477,63,167678
27586,0.000299,172.217.194.0-255,384,30861,63,167678
27587,0.000316,172.31.40.0-255,66,30927,63,167678
27588,0.000403,172.217.194.0-255,1484,32411,63,167678
27589,0.000408,172.31.40.0-255,66,32477,63,167678
27590,0.000413,172.217.194.0-255,2902,35379,63,167678
27591,0.000416,172.31.40.0-255,66,35445,63,167678
27592,0.000445,172.217.194.0-255,5738,41183,63,167678
27593,0.000448,172.31.40.0-255,66,41249,63,167678
27594,0.000454,172.217.194.0-255,4320,45569,63,167678
27595,0.00047,172.31.40.0-255,66,45635,63,167678
27596,0.000509,172.31.40.0-255,66,45701,63,167678
27597,0.000542,172.217.194.0-255,1484,47185,63,167678
27598,0.000563,172.217.194.0-255,5379,52564,63,167678
27599,0.000566,172.31.40.0-255,66,52630,63,167678
27600,0.000953,172.217.194.0-255,1484,54114,63,167678
27601,0.000959,172.217.194.0-255,2902,57016,63,167678
27602,0.000963,172.31.40.0-255,66,57082,63,167678
27603,0.000979,172.217.194.0-255,5738,62820,63,167678
27604,0.000986,172.31.40.0-255,66,62886,63,167678
27605,0.00099,172.217.194.0-255,1484,64370,63,167678
27606,0.001021,172.31.40.0-255,66,64436,63,167678
27607,0.001032,172.31.40.0-255,66,64502,63,167678
27608,0.001035,172.217.194.0-255,766,65268,63,167678
27609,0.001233,172.217.194.0-255,1484,66752,63,167678
27610,0.001237,172.31.40.0-255,66,66818,63,167678
27611,0.001241,172.217.194.0-255,2902,69720,63,167678
27612,0.001244,172.31.40.0-255,66,69786,63,167678
27613,0.001247,172.217.194.0-255,1484,71270,63,167678
27614,0.001269,172.217.194.0-255,4320,75590,63,167678
27615,0.001272,172.31.40.0-255,66,75656,63,167678
27616,0.001278,172.217.194.0-255,5738,81394,63,167678
27617,0.00128,172.31.40.0-255,66,81460,63,167678
27618,0.001285,172.217.194.0-255,4320,85780,63,167678
27619,0.001288,172.31.40.0-255,66,85846,63,167678
27620,0.001307,172.31.40.0-255,66,85912,63,167678
27621,0.001317,172.217.194.0-255,5020,90932,63,167678
27622,0.00132,172.31.40.0-255,66,90998,63,167678
27623,0.00137,172.217.194.0-255,4320,95318,63,167678
27624,0.001374,172.31.40.0-255,66,95384,63,167678
27625,0.001395,172.217.194.0-255,1484,96868,63,167678
27626,0.001403,172.217.194.0-255,7156,104024,63,167678
27627,0.001405,172.31.40.0-255,66,104090,63,167678
27628,0.001419,172.31.40.0-255,66,104156,63,167678
27629,0.001441,172.217.194.0-255,2902,107058,63,167678
27630,0.001449,172.31.40.0-255,66,107124,63,167678
27631,0.001456,172.217.194.0-255,6438,113562,63,167678
27632,0.001458,172.31.40.0-255,66,113628,63,167678
27633,0.00203,172.217.194.0-255,1484,115112,63,167678
27634,0.002039,172.217.194.0-255,2902,118014,63,167678
27635,0.002042,172.31.40.0-255,66,118080,63,167678
27636,0.002046,172.217.194.0-255,1484,119564,63,167678
27637,0.002074,172.217.194.0-255,4320,123884,63,167678
27638,0.002077,172.31.40.0-255,66,123950,63,167678
27639,0.00208,172.217.194.0-255,1484,125434,63,167678
27640,0.002116,172.31.40.0-255,66,125500,63,167678
27641,0.002119,172.217.194.0-255,1484,126984,63,167678
27642,0.002149,172.31.40.0-255,66,127050,63,167678
27643,0.004552,172.217.194.0-255,5738,132788,63,167678
27644,0.004559,172.31.40.0-255,66,132854,63,167678
27645,0.006911,172.217.194.0-255,5738,138592,63,167678
27646,0.006914,172.31.40.0-255,66,138658,63,167678
27647,0.009313,172.217.194.0-255,5738,144396,63,167678
27648,0.00932,172.31.40.0-255,66,144462,63,167678
27649,0.011696,172.217.194.0-255,5738,150200,63,167678
27650,0.011704,172.31.40.0-255,66,150266,63,167678
27651,0.014122,172.217.194.0-255,5738,156004,63,167678
27652,0.014143,172.31.40.0-255,66,156070,63,167678
27653,0.016544,172.217.194.0-255,5738,161808,63,167678
27654,0.016559,172.31.40.0-255,66,161874,63,167678
27655,0.01896,172.217.194.0-255,5738,167612,63,167678
27656,0.018969,172.31.40.0-255,66,167678,63,167678
27657,0.0,74.125.68.0-255,152,152,63,212673
27658,1.4e-05,172.31.40.0-255,66,218,63,212673
27659,2e-05,74.125.68.0-255,1484,1702,63,212673
27660,2.5e-05,172.31.40.0-255,66,1768,63,212673
27661,2.8e-05,74.125.68.0-255,1484,3252,63,212673
27662,3.2e-05,172.31.40.0-255,66,3318,63,212673
27663,3.8e-05,74.125.68.0-255,2902,6220,63,212673
27664,4.2e-05,172.31.40.0-255,66,6286,63,212673
27665,4.8e-05,74.125.68.0-255,5738,12024,63,212673
27666,5.2e-05,172.31.40.0-255,66,12090,63,212673
27667,7.1e-05,74.125.68.0-255,2039,14129,63,212673
27668,7.3e-05,172.31.40.0-255,66,14195,63,212673
27669,0.000123,74.125.68.0-255,1484,15679,63,212673
27670,0.000125,172.31.40.0-255,66,15745,63,212673
27671,0.00014,74.125.68.0-255,2902,18647,63,212673
27672,0.000142,172.31.40.0-255,66,18713,63,212673
27673,0.000168,74.125.68.0-255,5738,24451,63,212673
27674,0.000171,172.31.40.0-255,66,24517,63,212673
27675,0.000175,74.125.68.0-255,2902,27419,63,212673
27676,0.000177,172.31.40.0-255,66,27485,63,212673
27677,0.000222,74.125.68.0-255,2902,30387,63,212673
27678,0.000225,172.31.40.0-255,66,30453,63,212673
27679,0.000238,74.125.68.0-255,3961,34414,63,212673
27680,0.000241,172.31.40.0-255,66,34480,63,212673
27681,0.000248,74.125.68.0-255,7156,41636,63,212673
27682,0.000251,172.31.40.0-255,66,41702,63,212673
27683,0.000268,74.125.68.0-255,2902,44604,63,212673
27684,0.00027,172.31.40.0-255,66,44670,63,212673
27685,0.000284,74.125.68.0-255,3961,48631,63,212673
27686,0.000287,172.31.40.0-255,66,48697,63,212673
27687,0.000321,74.125.68.0-255,1484,50181,63,212673
27688,0.000323,172.31.40.0-255,66,50247,63,212673
27689,0.000327,74.125.68.0-255,1484,51731,63,212673
27690,0.000341,74.125.68.0-255,1484,53215,63,212673
27691,0.000343,172.31.40.0-255,66,53281,63,212673
27692,0.00035,74.125.68.0-255,5738,59019,63,212673
27693,0.000352,172.31.40.0-255,66,59085,63,212673
27694,0.000369,74.125.68.0-255,1484,60569,63,212673
27695,0.000385,74.125.68.0-255,5379,65948,63,212673
27696,0.000388,172.31.40.0-255,66,66014,63,212673
27697,0.000403,74.125.68.0-255,645,66659,63,212673
27698,0.00045,74.125.68.0-255,1484,68143,63,212673
27699,0.000454,172.31.40.0-255,66,68209,63,212673
27700,0.000477,74.125.68.0-255,4320,72529,63,212673
27701,0.00048,172.31.40.0-255,66,72595,63,212673
27702,0.000485,74.125.68.0-255,2902,75497,63,212673
27703,0.000487,172.31.40.0-255,66,75563,63,212673
27704,0.000493,74.125.68.0-255,4320,79883,63,212673
27705,0.000495,172.31.40.0-255,66,79949,63,212673
27706,0.000529,74.125.68.0-255,1484,81433,63,212673
27707,0.000543,74.125.68.0-255,2543,83976,63,212673
27708,0.000545,172.31.40.0-255,66,84042,63,212673
27709,0.000596,74.125.68.0-255,4320,88362,63,212673
27710,0.000599,172.31.40.0-255,66,88428,63,212673
27711,0.000607,74.125.68.0-255,7156,95584,63,212673
27712,0.000609,172.31.40.0-255,66,95650,63,212673
27713,0.000632,74.125.68.0-255,5379,101029,63,212673
27714,0.000635,172.31.40.0-255,66,101095,63,212673
27715,0.001189,74.125.68.0-255,1484,102579,63,212673
27716,0.001205,74.125.68.0-255,2902,105481,63,212673
27717,0.001209,172.31.40.0-255,66,105547,63,212673
27718,0.001233,74.125.68.0-255,5738,111285,63,212673
27719,0.001235,172.31.40.0-255,66,111351,63,212673
27720,0.001265,172.31.40.0-255,66,111417,63,212673
27721,0.001291,74.125.68.0-255,1484,112901,63,212673
27722,0.001305,172.31.40.0-255,66,112967,63,212673
27723,0.00165,74.125.68.0-255,1484,114451,63,212673
27724,0.00167,74.125.68.0-255,2902,117353,63,212673
27725,0.001673,172.31.40.0-255,66,117419,63,212673
27726,0.001695,74.125.68.0-255,4320,121739,63,212673
27727,0.001697,172.31.40.0-255,66,121805,63,212673
27728,0.001714,74.125.68.0-255,1484,123289,63,212673
27729,0.001717,74.125.68.0-255,1484,124773,63,212673
27730,0.001719,172.31.40.0-255,66,124839,63,212673
27731,0.001723,74.125.68.0-255,2902,127741,63,212673
27732,0.001725,172.31.40.0-255,66,127807,63,212673
27733,0.001748,74.125.68.0-255,2902,130709,63,212673
27734,0.00175,172.31.40.0-255,66,130775,63,212673
27735,0.001767,74.125.68.0-255,2902,133677,63,212673
27736,0.00177,172.31.40.0-255,66,133743,63,212673
27737,0.001772,74.125.68.0-255,1484,135227,63,212673
27738,0.001815,74.125.68.0-255,1484,136711,63,212673
27739,0.001822,172.31.40.0-255,66,136777,63,212673
27740,0.001868,74.125.68.0-255,2184,138961,63,212673
27741,0.001871,172.31.40.0-255,66,139027,63,212673
27742,0.001996,74.125.68.0-255,1484,140511,63,212673
27743,0.002014,74.125.68.0-255,2902,143413,63,212673
27744,0.002016,172.31.40.0-255,66,143479,63,212673
27745,0.002048,74.125.68.0-255,4320,147799,63,212673
27746,0.002051,172.31.40.0-255,66,147865,63,212673
27747,0.002089,74.125.68.0-255,7156,155021,63,212673
27748,0.002092,172.31.40.0-255,66,155087,63,212673
27749,0.002107,74.125.68.0-255,4320,159407,63,212673
27750,0.002109,172.31.40.0-255,66,159473,63,212673
27751,0.002133,74.125.68.0-255,4320,163793,63,212673
27752,0.002135,172.31.40.0-255,66,163859,63,212673
27753,0.002138,74.125.68.0-255,1484,165343,63,212673
27754,0.002185,74.125.68.0-255,4320,169663,63,212673
27755,0.002188,172.31.40.0-255,66,169729,63,212673
27756,0.002209,74.125.68.0-255,3602,173331,63,212673
27757,0.002211,172.31.40.0-255,66,173397,63,212673
27758,0.004476,74.125.68.0-255,5738,179135,63,212673
27759,0.004483,172.31.40.0-255,66,179201,63,212673
27760,0.006774,74.125.68.0-255,5738,184939,63,212673
27761,0.006779,172.31.40.0-255,66,185005,63,212673
27762,0.009066,74.125.68.0-255,4320,189325,63,212673
27763,0.009076,172.31.40.0-255,66,189391,63,212673
27764,0.009101,74.125.68.0-255,1484,190875,63,212673
27765,0.011353,74.125.68.0-255,4320,195195,63,212673
27766,0.011361,172.31.40.0-255,66,195261,63,212673
27767,0.013649,74.125.68.0-255,5738,200999,63,212673
27768,0.013659,172.31.40.0-255,66,201065,63,212673
27769,0.015955,74.125.68.0-255,5738,206803,63,212673
27770,0.015963,172.31.40.0-255,66,206869,63,212673
27771,0.018233,74.125.68.0-255,5738,212607,63,212673
27772,0.018241,172.31.40.0-255,66,212673,63,212673
27773,0.0,172.217.194.0-255,291,291,63,157129
27774,1.8e-05,172.31.40.0-255,66,357,63,157129
27775,2.5e-05,172.217.194.0-255,1484,1841,63,157129
27776,3e-05,172.31.40.0-255,66,1907,63,157129
27777,3.6e-05,172.217.194.0-255,4320,6227,63,157129
27778,4e-05,172.31.40.0-255,66,6293,63,157129
27779,5.9e-05,172.31.40.0-255,66,6359,63,157129
27780,7e-05,172.31.40.0-255,66,6425,63,157129
27781,0.000103,172.31.40.0-255,66,6491,63,157129
27782,0.000135,172.217.194.0-255,1484,7975,63,157129
27783,0.000138,172.31.40.0-255,66,8041,63,157129
27784,0.000143,172.217.194.0-255,2902,10943,63,157129
27785,0.000145,172.31.40.0-255,66,11009,63,157129
27786,0.000151,172.217.194.0-255,4320,15329,63,157129
27787,0.000157,172.31.40.0-255,66,15395,63,157129
27788,0.000184,172.217.194.0-255,1484,16879,63,157129
27789,0.000186,172.31.40.0-255,66,16945,63,157129
27790,0.000197,172.31.40.0-255,66,17011,63,157129
27791,0.000228,172.217.194.0-255,3961,20972,63,157129
27792,0.00023,172.31.40.0-255,66,21038,63,157129
27793,0.00026,172.31.40.0-255,66,21104,63,157129
27794,0.000418,172.217.194.0-255,380,21484,63,157129
27795,0.000423,172.31.40.0-255,66,21550,63,157129
27796,0.000512,172.217.194.0-255,1484,23034,63,157129
27797,0.000516,172.31.40.0-255,66,23100,63,157129
27798,0.000553,172.217.194.0-255,2902,26002,63,157129
27799,0.000556,172.31.40.0-255,66,26068,63,157129
27800,0.000562,172.217.194.0-255,5738,31806,63,157129
27801,0.000564,172.31.40.0-255,66,31872,63,157129
27802,0.000575,172.217.194.0-255,5738,37610,63,157129
27803,0.000577,172.31.40.0-255,66,37676,63,157129
27804,0.000605,172.217.194.0-255,5738,43414,63,157129
27805,0.000607,172.31.40.0-255,66,43480,63,157129
27806,0.000643,172.31.40.0-255,66,43546,63,157129
27807,0.000646,172.217.194.0-255,1484,45030,63,157129
27808,0.000651,172.217.194.0-255,2543,47573,63,157129
27809,0.000654,172.31.40.0-255,66,47639,63,157129
27810,0.001507,172.217.194.0-255,1484,49123,63,157129
27811,0.001513,172.217.194.0-255,1484,50607,63,157129
27812,0.001516,172.31.40.0-255,66,50673,63,157129
27813,0.001532,172.217.194.0-255,1484,52157,63,157129
27814,0.001543,172.217.194.0-255,5738,57895,63,157129
27815,0.001546,172.31.40.0-255,66,57961,63,157129
27816,0.001552,172.217.194.0-255,4320,62281,63,157129
27817,0.001554,172.31.40.0-255,66,62347,63,157129
27818,0.001585,172.31.40.0-255,66,62413,63,157129
27819,0.001601,172.31.40.0-255,66,62479,63,157129
27820,0.001604,172.217.194.0-255,766,63245,63,157129
27821,0.001707,172.217.194.0-255,1484,64729,63,157129
27822,0.001711,172.31.40.0-255,66,64795,63,157129
27823,0.001717,172.217.194.0-255,2902,67697,63,157129
27824,0.001719,172.31.40.0-255,66,67763,63,157129
27825,0.001731,172.217.194.0-255,5738,73501,63,157129
27826,0.001733,172.31.40.0-255,66,73567,63,157129
27827,0.001736,172.217.194.0-255,1484,75051,63,157129
27828,0.001767,172.217.194.0-255,5738,80789,63,157129
27829,0.001769,172.31.40.0-255,66,80855,63,157129
27830,0.001784,172.31.40.0-255,66,80921,63,157129
27831,0.001788,172.217.194.0-255,2184,83105,63,157129
27832,0.00179,172.31.40.0-255,66,83171,63,157129
27833,0.001858,172.217.194.0-255,1484,84655,63,157129
27834,0.001863,172.217.194.0-255,2902,87557,63,157129
27835,0.001866,172.31.40.0-255,66,87623,63,157129
27836,0.001872,172.217.194.0-255,5738,93361,63,157129
27837,0.001874,172.31.40.0-255,66,93427,63,157129
27838,0.001902,172.31.40.0-255,66,93493,63,157129
27839,0.001943,172.217.194.0-255,4320,97813,63,157129
27840,0.001945,172.31.40.0-255,66,97879,63,157129
27841,0.001981,172.31.40.0-255,66,97945,63,157129
27842,0.001988,172.217.194.0-255,7156,105101,63,157129
27843,0.00199,172.31.40.0-255,66,105167,63,157129
27844,0.002035,172.31.40.0-255,66,105233,63,157129
27845,0.00205,172.31.40.0-255,66,105299,63,157129
27846,0.002081,172.217.194.0-255,2902,108201,63,157129
27847,0.002083,172.31.40.0-255,66,108267,63,157129
27848,0.00209,172.217.194.0-255,6438,114705,63,157129
27849,0.002093,172.31.40.0-255,66,114771,63,157129
27850,0.00212,172.31.40.0-255,66,114837,63,157129
27851,0.002125,172.217.194.0-255,2184,117021,63,157129
27852,0.002128,172.31.40.0-255,66,117087,63,157129
27853,0.002148,172.217.194.0-255,1484,118571,63,157129
27854,0.002153,172.217.194.0-255,2902,121473,63,157129
27855,0.002156,172.31.40.0-255,66,121539,63,157129
27856,0.002188,172.217.194.0-255,5738,127277,63,157129
27857,0.002232,172.217.194.0-255,1484,128761,63,157129
27858,0.002253,172.217.194.0-255,7156,135917,63,157129
27859,0.002257,172.217.194.0-255,2184,138101,63,157129
27860,0.002569,172.217.194.0-255,1484,139585,63,157129
27861,0.011074,172.31.40.0-255,66,139651,63,157129
27862,0.013408,172.217.194.0-255,1484,141135,63,157129
27863,0.013622,172.217.194.0-255,4320,145455,63,157129
27864,0.01363,172.31.40.0-255,66,145521,63,157129
27865,0.016197,172.217.194.0-255,5738,151259,63,157129
27866,0.016214,172.31.40.0-255,66,151325,63,157129
27867,0.018762,172.217.194.0-255,5738,157063,63,157129
27868,0.018776,172.31.40.0-255,66,157129,63,157129
27869,0.0,74.125.200.0-255,150,150,63,144124
27870,1.8e-05,172.31.40.0-255,66,216,63,144124
27871,2.5e-05,74.125.200.0-255,1484,1700,63,144124
27872,3e-05,172.31.40.0-255,66,1766,63,144124
27873,4.3e-05,74.125.200.0-255,2902,4668,63,144124
27874,4.6e-05,172.31.40.0-255,66,4734,63,144124
27875,5.2e-05,74.125.200.0-255,4320,9054,63,144124
27876,5.5e-05,172.31.40.0-255,66,9120,63,144124
27877,9.3e-05,74.125.200.0-255,4846,13966,63,144124
27878,9.7e-05,172.31.40.0-255,66,14032,63,144124
27879,0.000357,74.125.200.0-255,1484,15516,63,144124
27880,0.000363,172.31.40.0-255,66,15582,63,144124
27881,0.00037,74.125.200.0-255,2902,18484,63,144124
27882,0.000372,172.31.40.0-255,66,18550,63,144124
27883,0.000382,74.125.200.0-255,4320,22870,63,144124
27884,0.000385,172.31.40.0-255,66,22936,63,144124
27885,0.000391,74.125.200.0-255,4320,27256,63,144124
27886,0.000393,172.31.40.0-255,66,27322,63,144124
27887,0.000423,74.125.200.0-255,1484,28806,63,144124
27888,0.000426,172.31.40.0-255,66,28872,63,144124
27889,0.000432,74.125.200.0-255,2902,31774,63,144124
27890,0.000434,172.31.40.0-255,66,31840,63,144124
27891,0.000455,74.125.200.0-255,2543,34383,63,144124
27892,0.000458,172.31.40.0-255,66,34449,63,144124
27893,0.000468,74.125.200.0-255,5738,40187,63,144124
27894,0.000471,172.31.40.0-255,66,40253,63,144124
27895,0.000495,74.125.200.0-255,7156,47409,63,144124
27896,0.000498,172.31.40.0-255,66,47475,63,144124
27897,0.000522,74.125.200.0-255,1125,48600,63,144124
27898,0.000525,172.31.40.0-255,66,48666,63,144124
27899,0.000817,74.125.200.0-255,1484,50150,63,144124
27900,0.000821,172.31.40.0-255,66,50216,63,144124
27901,0.000826,74.125.200.0-255,1484,51700,63,144124
27902,0.000853,74.125.200.0-255,1484,53184,63,144124
27903,0.000855,172.31.40.0-255,66,53250,63,144124
27904,0.00086,74.125.200.0-255,2902,56152,63,144124
27905,0.000863,172.31.40.0-255,66,56218,63,144124
27906,0.000874,74.125.200.0-255,7156,63374,63,144124
27907,0.000876,172.31.40.0-255,66,63440,63,144124
27908,0.000897,74.125.200.0-255,2889,66329,63,144124
27909,0.000899,172.31.40.0-255,66,66395,63,144124
27910,0.0014,74.125.200.0-255,331,66726,63,144124
27911,0.001724,74.125.200.0-255,1484,68210,63,144124
27912,0.001731,172.31.40.0-255,66,68276,63,144124
27913,0.001737,74.125.200.0-255,2902,71178,63,144124
27914,0.00174,172.31.40.0-255,66,71244,63,144124
27915,0.001774,74.125.200.0-255,2902,74146,63,144124
27916,0.001776,172.31.40.0-255,66,74212,63,144124
27917,0.001781,74.125.200.0-255,4320,78532,63,144124
27918,0.001783,172.31.40.0-255,66,78598,63,144124
27919,0.001787,74.125.200.0-255,1484,80082,63,144124
27920,0.001827,74.125.200.0-255,7156,87238,63,144124
27921,0.00183,172.31.40.0-255,66,87304,63,144124
27922,0.001835,74.125.200.0-255,4320,91624,63,144124
27923,0.001837,172.31.40.0-255,66,91690,63,144124
27924,0.001878,172.31.40.0-255,66,91756,63,144124
27925,0.003869,74.125.200.0-255,1484,93240,63,144124
27926,0.003882,74.125.200.0-255,4320,97560,63,144124
27927,0.003885,172.31.40.0-255,66,97626,63,144124
27928,0.00586,74.125.200.0-255,1484,99110,63,144124
27929,0.005879,74.125.200.0-255,4320,103430,63,144124
27930,0.005882,172.31.40.0-255,66,103496,63,144124
27931,0.00787,74.125.200.0-255,5738,109234,63,144124
27932,0.007877,172.31.40.0-255,66,109300,63,144124
27933,0.009878,74.125.200.0-255,5738,115038,63,144124
27934,0.009887,172.31.40.0-255,66,115104,63,144124
27935,0.011881,74.125.200.0-255,5738,120842,63,144124
27936,0.01189,172.31.40.0-255,66,120908,63,144124
27937,0.013883,74.125.200.0-255,5738,126646,63,144124
27938,0.013891,172.31.40.0-255,66,126712,63,144124
27939,0.015886,74.125.200.0-255,5738,132450,63,144124
27940,0.015895,172.31.40.0-255,66,132516,63,144124
27941,0.017901,74.125.200.0-255,5738,138254,63,144124
27942,0.017909,172.31.40.0-255,66,138320,63,144124
27943,0.01993,74.125.200.0-255,5738,144058,63,144124
27944,0.019939,172.31.40.0-255,66,144124,63,144124
27945,0.0,74.125.24.0-255,150,150,63,211988
27946,3.4e-05,172.31.40.0-255,66,216,63,211988
27947,4.2e-05,74.125.24.0-255,1484,1700,63,211988
27948,4.6e-05,172.31.40.0-255,66,1766,63,211988
27949,5.2e-05,74.125.24.0-255,2902,4668,63,211988
27950,5.5e-05,172.31.40.0-255,66,4734,63,211988
27951,5.9e-05,74.125.24.0-255,2902,7636,63,211988
27952,6.2e-05,172.31.40.0-255,66,7702,63,211988
27953,6.9e-05,74.125.24.0-255,4320,12022,63,211988
27954,7.2e-05,172.31.40.0-255,66,12088,63,211988
27955,9.4e-05,74.125.24.0-255,2010,14098,63,211988
27956,9.7e-05,172.31.40.0-255,66,14164,63,211988
27957,0.00049,74.125.24.0-255,1484,15648,63,211988
27958,0.000496,172.31.40.0-255,66,15714,63,211988
27959,0.000502,74.125.24.0-255,2902,18616,63,211988
27960,0.000504,172.31.40.0-255,66,18682,63,211988
27961,0.00051,74.125.24.0-255,5738,24420,63,211988
27962,0.000513,172.31.40.0-255,66,24486,63,211988
27963,0.000543,74.125.24.0-255,2902,27388,63,211988
27964,0.000546,172.31.40.0-255,66,27454,63,211988
27965,0.000578,172.31.40.0-255,66,27520,63,211988
27966,0.000583,74.125.24.0-255,2902,30422,63,211988
27967,0.000584,172.31.40.0-255,66,30488,63,211988
27968,0.000592,74.125.24.0-255,5738,36226,63,211988
27969,0.000595,172.31.40.0-255,66,36292,63,211988
27970,0.000626,172.31.40.0-255,66,36358,63,211988
27971,0.000632,74.125.24.0-255,5020,41378,63,211988
27972,0.000634,172.31.40.0-255,66,41444,63,211988
27973,0.000655,74.125.24.0-255,416,41860,63,211988
27974,0.000659,172.31.40.0-255,66,41926,63,211988
27975,0.000867,74.125.24.0-255,1484,43410,63,211988
27976,0.000873,74.125.24.0-255,2902,46312,63,211988
27977,0.000876,172.31.40.0-255,66,46378,63,211988
27978,0.000892,74.125.24.0-255,1484,47862,63,211988
27979,0.000907,74.125.24.0-255,4320,52182,63,211988
27980,0.000909,172.31.40.0-255,66,52248,63,211988
27981,0.000915,74.125.24.0-255,4320,56568,63,211988
27982,0.000917,172.31.40.0-255,66,56634,63,211988
27983,0.000928,74.125.24.0-255,1484,58118,63,211988
27984,0.000969,172.31.40.0-255,66,58184,63,211988
27985,0.000989,74.125.24.0-255,1484,59668,63,211988
27986,0.000996,74.125.24.0-255,5020,64688,63,211988
27987,0.000998,172.31.40.0-255,66,64754,63,211988
27988,0.001035,74.125.24.0-255,1484,66238,63,211988
27989,0.00104,74.125.24.0-255,2902,69140,63,211988
27990,0.001042,172.31.40.0-255,66,69206,63,211988
27991,0.001049,74.125.24.0-255,5738,74944,63,211988
27992,0.001051,172.31.40.0-255,66,75010,63,211988
27993,0.00108,74.125.24.0-255,7156,82166,63,211988
27994,0.001083,172.31.40.0-255,66,82232,63,211988
27995,0.001118,74.125.24.0-255,2902,85134,63,211988
27996,0.001121,172.31.40.0-255,66,85200,63,211988
27997,0.001138,74.125.24.0-255,5738,90938,63,211988
27998,0.00114,172.31.40.0-255,66,91004,63,211988
27999,0.001163,74.125.24.0-255,2902,93906,63,211988
28000,0.001165,172.31.40.0-255,66,93972,63,211988
28001,0.001183,74.125.24.0-255,5020,98992,63,211988
28002,0.001185,172.31.40.0-255,66,99058,63,211988
28003,0.001216,74.125.24.0-255,1484,100542,63,211988
28004,0.001221,74.125.24.0-255,2902,103444,63,211988
28005,0.001223,172.31.40.0-255,66,103510,63,211988
28006,0.001242,74.125.24.0-255,5738,109248,63,211988
28007,0.001244,172.31.40.0-255,66,109314,63,211988
28008,0.001272,74.125.24.0-255,5738,115052,63,211988
28009,0.001275,172.31.40.0-255,66,115118,63,211988
28010,0.001292,74.125.24.0-255,4320,119438,63,211988
28011,0.001294,172.31.40.0-255,66,119504,63,211988
28012,0.001306,172.31.40.0-255,66,119570,63,211988
28013,0.001328,74.125.24.0-255,2184,121754,63,211988
28014,0.00133,172.31.40.0-255,66,121820,63,211988
28015,0.001909,74.125.24.0-255,1484,123304,63,211988
28016,0.001925,74.125.24.0-255,1484,124788,63,211988
28017,0.001928,172.31.40.0-255,66,124854,63,211988
28018,0.001933,74.125.24.0-255,2902,127756,63,211988
28019,0.001935,172.31.40.0-255,66,127822,63,211988
28020,0.001937,74.125.24.0-255,1484,129306,63,211988
28021,0.001956,74.125.24.0-255,4320,133626,63,211988
28022,0.001958,172.31.40.0-255,66,133692,63,211988
28023,0.001961,74.125.24.0-255,1484,135176,63,211988
28024,0.001993,172.31.40.0-255,66,135242,63,211988
28025,0.001999,74.125.24.0-255,4320,139562,63,211988
28026,0.002,172.31.40.0-255,66,139628,63,211988
28027,0.002015,74.125.24.0-255,2902,142530,63,211988
28028,0.002017,172.31.40.0-255,66,142596,63,211988
28029,0.002021,74.125.24.0-255,2184,144780,63,211988
28030,0.002022,172.31.40.0-255,66,144846,63,211988
28031,0.002056,74.125.24.0-255,1484,146330,63,211988
28032,0.002067,74.125.24.0-255,1484,147814,63,211988
28033,0.002069,172.31.40.0-255,66,147880,63,211988
28034,0.002074,74.125.24.0-255,2902,150782,63,211988
28035,0.002075,172.31.40.0-255,66,150848,63,211988
28036,0.002091,74.125.24.0-255,4320,155168,63,211988
28037,0.002093,172.31.40.0-255,66,155234,63,211988
28038,0.002096,74.125.24.0-255,2902,158136,63,211988
28039,0.002098,172.31.40.0-255,66,158202,63,211988
28040,0.002116,74.125.24.0-255,1484,159686,63,211988
28041,0.002122,74.125.24.0-255,5738,165424,63,211988
28042,0.002124,172.31.40.0-255,66,165490,63,211988
28043,0.002142,74.125.24.0-255,1484,166974,63,211988
28044,0.004174,74.125.24.0-255,4320,171294,63,211988
28045,0.004181,172.31.40.0-255,66,171360,63,211988
28046,0.006247,74.125.24.0-255,5738,177098,63,211988
28047,0.006251,172.31.40.0-255,66,177164,63,211988
28048,0.008301,74.125.24.0-255,5738,182902,63,211988
28049,0.008308,172.31.40.0-255,66,182968,63,211988
28050,0.010361,74.125.24.0-255,5738,188706,63,211988
28051,0.010369,172.31.40.0-255,66,188772,63,211988
28052,0.012436,74.125.24.0-255,5738,194510,63,211988
28053,0.012444,172.31.40.0-255,66,194576,63,211988
28054,0.014517,74.125.24.0-255,5738,200314,63,211988
28055,0.014535,172.31.40.0-255,66,200380,63,211988
28056,0.016599,74.125.24.0-255,5738,206118,63,211988
28057,0.016612,172.31.40.0-255,66,206184,63,211988
28058,0.018672,74.125.24.0-255,5738,211922,63,211988
28059,0.018688,172.31.40.0-255,66,211988,63,211988
28060,0.0,74.125.200.0-255,143,143,63,244242
28061,1.8e-05,172.31.40.0-255,66,209,63,244242
28062,4.5e-05,74.125.200.0-255,1484,1693,63,244242
28063,5e-05,172.31.40.0-255,66,1759,63,244242
28064,5.6e-05,74.125.200.0-255,2902,4661,63,244242
28065,5.9e-05,172.31.40.0-255,66,4727,63,244242
28066,8e-05,74.125.200.0-255,4320,9047,63,244242
28067,8.3e-05,172.31.40.0-255,66,9113,63,244242
28068,0.000113,74.125.200.0-255,4813,13926,63,244242
28069,0.000115,172.31.40.0-255,66,13992,63,244242
28070,0.00015,74.125.200.0-255,1484,15476,63,244242
28071,0.000152,172.31.40.0-255,66,15542,63,244242
28072,0.000157,74.125.200.0-255,2902,18444,63,244242
28073,0.00016,172.31.40.0-255,66,18510,63,244242
28074,0.000177,74.125.200.0-255,2902,21412,63,244242
28075,0.00018,172.31.40.0-255,66,21478,63,244242
28076,0.000229,74.125.200.0-255,2902,24380,63,244242
28077,0.000231,172.31.40.0-255,66,24446,63,244242
28078,0.000235,74.125.200.0-255,1484,25930,63,244242
28079,0.000237,172.31.40.0-255,66,25996,63,244242
28080,0.000256,74.125.200.0-255,2902,28898,63,244242
28081,0.000258,172.31.40.0-255,66,28964,63,244242
28082,0.000281,74.125.200.0-255,2543,31507,63,244242
28083,0.000284,172.31.40.0-255,66,31573,63,244242
28084,0.00041,74.125.200.0-255,1484,33057,63,244242
28085,0.000414,172.31.40.0-255,66,33123,63,244242
28086,0.000489,74.125.200.0-255,1484,34607,63,244242
28087,0.000494,172.31.40.0-255,66,34673,63,244242
28088,0.000524,74.125.200.0-255,2902,37575,63,244242
28089,0.000528,172.31.40.0-255,66,37641,63,244242
28090,0.000534,74.125.200.0-255,4320,41961,63,244242
28091,0.000536,172.31.40.0-255,66,42027,63,244242
28092,0.000581,74.125.200.0-255,4320,46347,63,244242
28093,0.000585,172.31.40.0-255,66,46413,63,244242
28094,0.000604,74.125.200.0-255,1484,47897,63,244242
28095,0.000625,74.125.200.0-255,7156,55053,63,244242
28096,0.000629,172.31.40.0-255,66,55119,63,244242
28097,0.000632,74.125.200.0-255,1484,56603,63,244242
28098,0.000651,74.125.200.0-255,2902,59505,63,244242
28099,0.000654,172.31.40.0-255,66,59571,63,244242
28100,0.00066,74.125.200.0-255,4320,63891,63,244242
28101,0.000662,172.31.40.0-255,66,63957,63,244242
28102,0.000674,74.125.200.0-255,1484,65441,63,244242
28103,0.000676,74.125.200.0-255,766,66207,63,244242
28104,0.00068,172.31.40.0-255,66,66273,63,244242
28105,0.000748,74.125.200.0-255,361,66634,63,244242
28106,0.00076,74.125.200.0-255,382,67016,63,244242
28107,0.000915,74.125.200.0-255,1484,68500,63,244242
28108,0.000919,172.31.40.0-255,66,68566,63,244242
28109,0.000924,74.125.200.0-255,2902,71468,63,244242
28110,0.000927,172.31.40.0-255,66,71534,63,244242
28111,0.00093,74.125.200.0-255,1484,73018,63,244242
28112,0.000951,74.125.200.0-255,2902,75920,63,244242
28113,0.000955,74.125.200.0-255,2902,78822,63,244242
28114,0.000958,172.31.40.0-255,66,78888,63,244242
28115,0.000962,172.31.40.0-255,66,78954,63,244242
28116,0.000979,74.125.200.0-255,2902,81856,63,244242
28117,0.000981,172.31.40.0-255,66,81922,63,244242
28118,0.000998,74.125.200.0-255,2902,84824,63,244242
28119,0.001,172.31.40.0-255,66,84890,63,244242
28120,0.001022,74.125.200.0-255,7156,92046,63,244242
28121,0.001025,172.31.40.0-255,66,92112,63,244242
28122,0.001047,74.125.200.0-255,5738,97850,63,244242
28123,0.00105,172.31.40.0-255,66,97916,63,244242
28124,0.001072,74.125.200.0-255,3602,101518,63,244242
28125,0.001075,172.31.40.0-255,66,101584,63,244242
28126,0.001088,74.125.200.0-255,1484,103068,63,244242
28127,0.00111,74.125.200.0-255,4320,107388,63,244242
28128,0.001113,172.31.40.0-255,66,107454,63,244242
28129,0.001119,74.125.200.0-255,5738,113192,63,244242
28130,0.001122,172.31.40.0-255,66,113258,63,244242
28131,0.001133,74.125.200.0-255,1484,114742,63,244242
28132,0.001138,74.125.200.0-255,3412,118154,63,244242
28133,0.001141,172.31.40.0-255,66,118220,63,244242
28134,0.001552,74.125.200.0-255,1484,119704,63,244242
28135,0.001572,74.125.200.0-255,1484,121188,63,244242
28136,0.001575,172.31.40.0-255,66,121254,63,244242
28137,0.0016,74.125.200.0-255,1484,122738,63,244242
28138,0.001604,74.125.200.0-255,2902,125640,63,244242
28139,0.001606,172.31.40.0-255,66,125706,63,244242
28140,0.001611,74.125.200.0-255,4320,130026,63,244242
28141,0.001613,172.31.40.0-255,66,130092,63,244242
28142,0.001637,74.125.200.0-255,2902,132994,63,244242
28143,0.001639,172.31.40.0-255,66,133060,63,244242
28144,0.001664,74.125.200.0-255,5738,138798,63,244242
28145,0.001667,172.31.40.0-255,66,138864,63,244242
28146,0.001706,74.125.200.0-255,7156,146020,63,244242
28147,0.001708,172.31.40.0-255,66,146086,63,244242
28148,0.001725,74.125.200.0-255,2902,148988,63,244242
28149,0.001727,172.31.40.0-255,66,149054,63,244242
28150,0.00173,74.125.200.0-255,2902,151956,63,244242
28151,0.001732,172.31.40.0-255,66,152022,63,244242
28152,0.001734,74.125.200.0-255,766,152788,63,244242
28153,0.001796,74.125.200.0-255,1484,154272,63,244242
28154,0.001799,172.31.40.0-255,66,154338,63,244242
28155,0.001825,74.125.200.0-255,1484,155822,63,244242
28156,0.001842,74.125.200.0-255,1484,157306,63,244242
28157,0.001844,172.31.40.0-255,66,157372,63,244242
28158,0.00185,74.125.200.0-255,4320,161692,63,244242
28159,0.001851,172.31.40.0-255,66,161758,63,244242
28160,0.001865,74.125.200.0-255,4320,166078,63,244242
28161,0.001867,172.31.40.0-255,66,166144,63,244242
28162,0.001884,74.125.200.0-255,1484,167628,63,244242
28163,0.001901,74.125.200.0-255,2902,170530,63,244242
28164,0.001904,172.31.40.0-255,66,170596,63,244242
28165,0.001916,74.125.200.0-255,4320,174916,63,244242
28166,0.001918,172.31.40.0-255,66,174982,63,244242
28167,0.001944,172.31.40.0-255,66,175048,63,244242
28168,0.001949,74.125.200.0-255,3602,178650,63,244242
28169,0.001951,172.31.40.0-255,66,178716,63,244242
28170,0.002224,74.125.200.0-255,1484,180200,63,244242
28171,0.002231,74.125.200.0-255,2902,183102,63,244242
28172,0.002234,172.31.40.0-255,66,183168,63,244242
28173,0.002238,74.125.200.0-255,1484,184652,63,244242
28174,0.002251,74.125.200.0-255,1484,186136,63,244242
28175,0.002254,172.31.40.0-255,66,186202,63,244242
28176,0.002272,74.125.200.0-255,4320,190522,63,244242
28177,0.002274,172.31.40.0-255,66,190588,63,244242
28178,0.002299,74.125.200.0-255,5738,196326,63,244242
28179,0.002302,172.31.40.0-255,66,196392,63,244242
28180,0.002327,74.125.200.0-255,7156,203548,63,244242
28181,0.00233,172.31.40.0-255,66,203614,63,244242
28182,0.0046,74.125.200.0-255,5738,209352,63,244242
28183,0.004607,172.31.40.0-255,66,209418,63,244242
28184,0.006886,74.125.200.0-255,5738,215156,63,244242
28185,0.00689,172.31.40.0-255,66,215222,63,244242
28186,0.009182,74.125.200.0-255,5738,220960,63,244242
28187,0.009189,172.31.40.0-255,66,221026,63,244242
28188,0.011475,74.125.200.0-255,5738,226764,63,244242
28189,0.011482,172.31.40.0-255,66,226830,63,244242
28190,0.013775,74.125.200.0-255,5738,232568,63,244242
28191,0.013788,172.31.40.0-255,66,232634,63,244242
28192,0.01608,74.125.200.0-255,5738,238372,63,244242
28193,0.016093,172.31.40.0-255,66,238438,63,244242
28194,0.018379,74.125.200.0-255,5738,244176,63,244242
28195,0.018389,172.31.40.0-255,66,244242,63,244242
28196,0.0,74.125.200.0-255,297,297,63,189135
28197,2.2e-05,172.31.40.0-255,66,363,63,189135
28198,2.8e-05,74.125.200.0-255,1484,1847,63,189135
28199,3.2e-05,172.31.40.0-255,66,1913,63,189135
28200,3.5e-05,74.125.200.0-255,1484,3397,63,189135
28201,3.8e-05,172.31.40.0-255,66,3463,63,189135
28202,6.7e-05,74.125.200.0-255,1484,4947,63,189135
28203,7e-05,172.31.40.0-255,66,5013,63,189135
28204,7.6e-05,74.125.200.0-255,2902,7915,63,189135
28205,7.8e-05,172.31.40.0-255,66,7981,63,189135
28206,8.2e-05,74.125.200.0-255,1484,9465,63,189135
28207,8.4e-05,172.31.40.0-255,66,9531,63,189135
28208,0.000112,74.125.200.0-255,4320,13851,63,189135
28209,0.000115,172.31.40.0-255,66,13917,63,189135
28210,0.000117,74.125.200.0-255,413,14330,63,189135
28211,0.000119,172.31.40.0-255,66,14396,63,189135
28212,0.000193,74.125.200.0-255,1484,15880,63,189135
28213,0.000196,172.31.40.0-255,66,15946,63,189135
28214,0.000199,74.125.200.0-255,1484,17430,63,189135
28215,0.000202,172.31.40.0-255,66,17496,63,189135
28216,0.000217,74.125.200.0-255,2902,20398,63,189135
28217,0.000221,172.31.40.0-255,66,20464,63,189135
28218,0.000238,74.125.200.0-255,4320,24784,63,189135
28219,0.000241,172.31.40.0-255,66,24850,63,189135
28220,0.000262,74.125.200.0-255,1484,26334,63,189135
28221,0.000265,172.31.40.0-255,66,26400,63,189135
28222,0.000272,74.125.200.0-255,5379,31779,63,189135
28223,0.000274,172.31.40.0-255,66,31845,63,189135
28224,0.000302,74.125.200.0-255,5738,37583,63,189135
28225,0.000305,172.31.40.0-255,66,37649,63,189135
28226,0.000309,74.125.200.0-255,2902,40551,63,189135
28227,0.000312,172.31.40.0-255,66,40617,63,189135
28228,0.000342,172.31.40.0-255,66,40683,63,189135
28229,0.000359,74.125.200.0-255,1484,42167,63,189135
28230,0.000364,74.125.200.0-255,2902,45069,63,189135
28231,0.000367,172.31.40.0-255,66,45135,63,189135
28232,0.000386,74.125.200.0-255,1484,46619,63,189135
28233,0.000402,74.125.200.0-255,2902,49521,63,189135
28234,0.000404,172.31.40.0-255,66,49587,63,189135
28235,0.000407,74.125.200.0-255,1484,51071,63,189135
28236,0.000422,74.125.200.0-255,1484,52555,63,189135
28237,0.000424,172.31.40.0-255,66,52621,63,189135
28238,0.000429,74.125.200.0-255,2902,55523,63,189135
28239,0.000431,172.31.40.0-255,66,55589,63,189135
28240,0.00045,74.125.200.0-255,1484,57073,63,189135
28241,0.000453,74.125.200.0-255,766,57839,63,189135
28242,0.000455,172.31.40.0-255,66,57905,63,189135
28243,0.000486,74.125.200.0-255,395,58300,63,189135
28244,0.000537,74.125.200.0-255,115,58415,63,189135
28245,0.000901,74.125.200.0-255,1484,59899,63,189135
28246,0.000906,74.125.200.0-255,1484,61383,63,189135
28247,0.000911,172.31.40.0-255,66,61449,63,189135
28248,0.000922,74.125.200.0-255,2902,64351,63,189135
28249,0.000925,172.31.40.0-255,66,64417,63,189135
28250,0.00095,74.125.200.0-255,4320,68737,63,189135
28251,0.000954,172.31.40.0-255,66,68803,63,189135
28252,0.000973,74.125.200.0-255,1484,70287,63,189135
28253,0.000986,172.31.40.0-255,66,70353,63,189135
28254,0.001022,74.125.200.0-255,7156,77509,63,189135
28255,0.001025,172.31.40.0-255,66,77575,63,189135
28256,0.001072,74.125.200.0-255,3602,81177,63,189135
28257,0.001075,172.31.40.0-255,66,81243,63,189135
28258,0.0014,74.125.200.0-255,1484,82727,63,189135
28259,0.001419,74.125.200.0-255,2902,85629,63,189135
28260,0.001422,172.31.40.0-255,66,85695,63,189135
28261,0.001459,74.125.200.0-255,1484,87179,63,189135
28262,0.001479,74.125.200.0-255,2902,90081,63,189135
28263,0.001482,172.31.40.0-255,66,90147,63,189135
28264,0.001499,74.125.200.0-255,4320,94467,63,189135
28265,0.001501,172.31.40.0-255,66,94533,63,189135
28266,0.001521,74.125.200.0-255,1484,96017,63,189135
28267,0.00154,172.31.40.0-255,66,96083,63,189135
28268,0.001567,172.31.40.0-255,66,96149,63,189135
28269,0.001584,74.125.200.0-255,1484,97633,63,189135
28270,0.001587,74.125.200.0-255,766,98399,63,189135
28271,0.001589,172.31.40.0-255,66,98465,63,189135
28272,0.001593,74.125.200.0-255,1484,99949,63,189135
28273,0.001618,74.125.200.0-255,4320,104269,63,189135
28274,0.001621,172.31.40.0-255,66,104335,63,189135
28275,0.001624,74.125.200.0-255,1484,105819,63,189135
28276,0.001639,74.125.200.0-255,2902,108721,63,189135
28277,0.001641,172.31.40.0-255,66,108787,63,189135
28278,0.001661,74.125.200.0-255,5738,114525,63,189135
28279,0.001664,172.31.40.0-255,66,114591,63,189135
28280,0.001667,74.125.200.0-255,1484,116075,63,189135
28281,0.001702,74.125.200.0-255,2902,118977,63,189135
28282,0.001705,172.31.40.0-255,66,119043,63,189135
28283,0.001727,74.125.200.0-255,5738,124781,63,189135
28284,0.001731,172.31.40.0-255,66,124847,63,189135
28285,0.001737,74.125.200.0-255,7156,132003,63,189135
28286,0.001739,172.31.40.0-255,66,132069,63,189135
28287,0.001753,74.125.200.0-255,766,132835,63,189135
28288,0.0021,74.125.200.0-255,1484,134319,63,189135
28289,0.002105,172.31.40.0-255,66,134385,63,189135
28290,0.00211,74.125.200.0-255,2902,137287,63,189135
28291,0.002112,172.31.40.0-255,66,137353,63,189135
28292,0.002127,74.125.200.0-255,2902,140255,63,189135
28293,0.00213,172.31.40.0-255,66,140321,63,189135
28294,0.002144,74.125.200.0-255,2902,143223,63,189135
28295,0.002146,172.31.40.0-255,66,143289,63,189135
28296,0.002153,74.125.200.0-255,7156,150445,63,189135
28297,0.002155,172.31.40.0-255,66,150511,63,189135
28298,0.002179,74.125.200.0-255,1484,151995,63,189135
28299,0.002208,172.31.40.0-255,66,152061,63,189135
28300,0.002231,74.125.200.0-255,2184,154245,63,189135
28301,0.002234,172.31.40.0-255,66,154311,63,189135
28302,0.004769,74.125.200.0-255,5738,160049,63,189135
28303,0.004776,172.31.40.0-255,66,160115,63,189135
28304,0.007337,74.125.200.0-255,5738,165853,63,189135
28305,0.007343,172.31.40.0-255,66,165919,63,189135
28306,0.00991,74.125.200.0-255,5738,171657,63,189135
28307,0.009918,172.31.40.0-255,66,171723,63,189135
28308,0.012484,74.125.200.0-255,5738,177461,63,189135
28309,0.012494,172.31.40.0-255,66,177527,63,189135
28310,0.015068,74.125.200.0-255,5738,183265,63,189135
28311,0.015079,172.31.40.0-255,66,183331,63,189135
28312,0.01764,74.125.200.0-255,5738,189069,63,189135
28313,0.017649,172.31.40.0-255,66,189135,63,189135
28314,0.0,172.217.26.0-255,153,153,63,96314
28315,2.3e-05,172.31.40.0-255,66,219,63,96314
28316,3.1e-05,172.217.26.0-255,1484,1703,63,96314
28317,3.5e-05,172.31.40.0-255,66,1769,63,96314
28318,4.1e-05,172.217.26.0-255,2902,4671,63,96314
28319,5.2e-05,172.31.40.0-255,66,4737,63,96314
28320,6e-05,172.217.26.0-255,7156,11893,63,96314
28321,6.3e-05,172.31.40.0-255,66,11959,63,96314
28322,6.7e-05,172.217.26.0-255,1939,13898,63,96314
28323,7e-05,172.31.40.0-255,66,13964,63,96314
28324,0.000109,172.217.26.0-255,1484,15448,63,96314
28325,0.000112,172.31.40.0-255,66,15514,63,96314
28326,0.000117,172.217.26.0-255,2902,18416,63,96314
28327,0.000119,172.31.40.0-255,66,18482,63,96314
28328,0.000123,172.217.26.0-255,2902,21384,63,96314
28329,0.000125,172.31.40.0-255,66,21450,63,96314
28330,0.000156,172.217.26.0-255,2902,24352,63,96314
28331,0.000158,172.31.40.0-255,66,24418,63,96314
28332,0.000164,172.217.26.0-255,4320,28738,63,96314
28333,0.000166,172.31.40.0-255,66,28804,63,96314
28334,0.000195,172.217.26.0-255,2543,31347,63,96314
28335,0.000197,172.31.40.0-255,66,31413,63,96314
28336,0.00037,172.217.26.0-255,1484,32897,63,96314
28337,0.000374,172.31.40.0-255,66,32963,63,96314
28338,0.000393,172.217.26.0-255,1484,34447,63,96314
28339,0.000395,172.31.40.0-255,66,34513,63,96314
28340,0.000399,172.217.26.0-255,2902,37415,63,96314
28341,0.000402,172.31.40.0-255,66,37481,63,96314
28342,0.000408,172.217.26.0-255,5738,43219,63,96314
28343,0.000411,172.31.40.0-255,66,43285,63,96314
28344,0.000434,172.217.26.0-255,1484,44769,63,96314
28345,0.000437,172.31.40.0-255,66,44835,63,96314
28346,0.000477,172.31.40.0-255,66,44901,63,96314
28347,0.000508,172.31.40.0-255,66,44967,63,96314
28348,0.000532,172.217.26.0-255,397,45364,63,96314
28349,0.001091,172.31.40.0-255,66,45430,63,96314
28350,0.002444,172.217.26.0-255,4320,49750,63,96314
28351,0.002451,172.31.40.0-255,66,49816,63,96314
28352,0.003018,172.217.26.0-255,1484,51300,63,96314
28353,0.004386,172.217.26.0-255,4320,55620,63,96314
28354,0.00439,172.31.40.0-255,66,55686,63,96314
28355,0.006335,172.217.26.0-255,5738,61424,63,96314
28356,0.00634,172.31.40.0-255,66,61490,63,96314
28357,0.008292,172.217.26.0-255,5738,67228,63,96314
28358,0.0083,172.31.40.0-255,66,67294,63,96314
28359,0.010236,172.217.26.0-255,5738,73032,63,96314
28360,0.010244,172.31.40.0-255,66,73098,63,96314
28361,0.012195,172.217.26.0-255,5738,78836,63,96314
28362,0.012202,172.31.40.0-255,66,78902,63,96314
28363,0.014152,172.217.26.0-255,5738,84640,63,96314
28364,0.014162,172.31.40.0-255,66,84706,63,96314
28365,0.016133,172.217.26.0-255,5738,90444,63,96314
28366,0.01614,172.31.40.0-255,66,90510,63,96314
28367,0.018082,172.217.26.0-255,5738,96248,63,96314
28368,0.018089,172.31.40.0-255,66,96314,63,96314
28369,0.0,74.125.24.0-255,153,153,63,164857
28370,1.5e-05,172.31.40.0-255,66,219,63,164857
28371,2.1e-05,74.125.24.0-255,1484,1703,63,164857
28372,2.6e-05,172.31.40.0-255,66,1769,63,164857
28373,3.1e-05,74.125.24.0-255,2902,4671,63,164857
28374,3.5e-05,172.31.40.0-255,66,4737,63,164857
28375,5e-05,74.125.24.0-255,7156,11893,63,164857
28376,5.4e-05,172.31.40.0-255,66,11959,63,164857
28377,9.3e-05,74.125.24.0-255,7156,19115,63,164857
28378,9.6e-05,172.31.40.0-255,66,19181,63,164857
28379,0.000126,74.125.24.0-255,585,19766,63,164857
28380,0.000128,172.31.40.0-255,66,19832,63,164857
28381,0.000139,172.31.40.0-255,66,19898,63,164857
28382,0.000151,74.125.24.0-255,7156,27054,63,164857
28383,0.000154,172.31.40.0-255,66,27120,63,164857
28384,0.000193,172.31.40.0-255,66,27186,63,164857
28385,0.000196,74.125.24.0-255,766,27952,63,164857
28386,0.000198,172.31.40.0-255,66,28018,63,164857
28387,0.000254,74.125.24.0-255,1484,29502,63,164857
28388,0.000257,172.31.40.0-255,66,29568,63,164857
28389,0.000262,74.125.24.0-255,2902,32470,63,164857
28390,0.000264,172.31.40.0-255,66,32536,63,164857
28391,0.00027,74.125.24.0-255,4320,36856,63,164857
28392,0.000277,172.31.40.0-255,66,36922,63,164857
28393,0.000299,74.125.24.0-255,1484,38406,63,164857
28394,0.000302,172.31.40.0-255,66,38472,63,164857
28395,0.000315,74.125.24.0-255,7124,45596,63,164857
28396,0.000317,172.31.40.0-255,66,45662,63,164857
28397,0.000505,74.125.24.0-255,329,45991,63,164857
28398,0.00051,172.31.40.0-255,66,46057,63,164857
28399,0.000538,74.125.24.0-255,1484,47541,63,164857
28400,0.000558,74.125.24.0-255,2902,50443,63,164857
28401,0.000562,172.31.40.0-255,66,50509,63,164857
28402,0.000579,74.125.24.0-255,1484,51993,63,164857
28403,0.000583,74.125.24.0-255,1484,53477,63,164857
28404,0.000585,172.31.40.0-255,66,53543,63,164857
28405,0.00062,74.125.24.0-255,7156,60699,63,164857
28406,0.000623,172.31.40.0-255,66,60765,63,164857
28407,0.000628,74.125.24.0-255,2543,63308,63,164857
28408,0.00063,172.31.40.0-255,66,63374,63,164857
28409,0.00066,74.125.24.0-255,2902,66276,63,164857
28410,0.000663,172.31.40.0-255,66,66342,63,164857
28411,0.000668,74.125.24.0-255,4320,70662,63,164857
28412,0.00067,172.31.40.0-255,66,70728,63,164857
28413,0.000695,74.125.24.0-255,5738,76466,63,164857
28414,0.000698,172.31.40.0-255,66,76532,63,164857
28415,0.000722,74.125.24.0-255,2902,79434,63,164857
28416,0.000729,172.31.40.0-255,66,79500,63,164857
28417,0.000741,74.125.24.0-255,1125,80625,63,164857
28418,0.001297,74.125.24.0-255,1484,82109,63,164857
28419,0.001302,172.31.40.0-255,66,82175,63,164857
28420,0.001307,74.125.24.0-255,2902,85077,63,164857
28421,0.001309,172.31.40.0-255,66,85143,63,164857
28422,0.001334,74.125.24.0-255,5738,90881,63,164857
28423,0.00134,172.31.40.0-255,66,90947,63,164857
28424,0.001372,172.31.40.0-255,66,91013,63,164857
28425,0.001375,74.125.24.0-255,1484,92497,63,164857
28426,0.001408,172.31.40.0-255,66,92563,63,164857
28427,0.002093,74.125.24.0-255,1484,94047,63,164857
28428,0.002104,74.125.24.0-255,2902,96949,63,164857
28429,0.002108,172.31.40.0-255,66,97015,63,164857
28430,0.002117,74.125.24.0-255,5738,102753,63,164857
28431,0.002119,172.31.40.0-255,66,102819,63,164857
28432,0.002139,74.125.24.0-255,1484,104303,63,164857
28433,0.002171,172.31.40.0-255,66,104369,63,164857
28434,0.002174,74.125.24.0-255,1484,105853,63,164857
28435,0.002219,74.125.24.0-255,4320,110173,63,164857
28436,0.002221,172.31.40.0-255,66,110239,63,164857
28437,0.002261,74.125.24.0-255,5020,115259,63,164857
28438,0.002264,172.31.40.0-255,66,115325,63,164857
28439,0.00227,74.125.24.0-255,5738,121063,63,164857
28440,0.002272,172.31.40.0-255,66,121129,63,164857
28441,0.002302,74.125.24.0-255,2902,124031,63,164857
28442,0.002304,172.31.40.0-255,66,124097,63,164857
28443,0.002315,172.31.40.0-255,66,124163,63,164857
28444,0.002332,172.31.40.0-255,66,124229,63,164857
28445,0.00466,74.125.24.0-255,5738,129967,63,164857
28446,0.004667,172.31.40.0-255,66,130033,63,164857
28447,0.006983,74.125.24.0-255,5738,135771,63,164857
28448,0.006991,172.31.40.0-255,66,135837,63,164857
28449,0.009331,74.125.24.0-255,5738,141575,63,164857
28450,0.009334,172.31.40.0-255,66,141641,63,164857
28451,0.011634,74.125.24.0-255,5738,147379,63,164857
28452,0.011642,172.31.40.0-255,66,147445,63,164857
28453,0.013967,74.125.24.0-255,5738,153183,63,164857
28454,0.013975,172.31.40.0-255,66,153249,63,164857
28455,0.016259,74.125.24.0-255,5738,158987,63,164857
28456,0.016265,172.31.40.0-255,66,159053,63,164857
28457,0.018555,74.125.24.0-255,5738,164791,63,164857
28458,0.018565,172.31.40.0-255,66,164857,63,164857
28459,0.0,74.125.24.0-255,296,296,63,207095
28460,2.4e-05,172.31.40.0-255,66,362,63,207095
28461,3e-05,74.125.24.0-255,1484,1846,63,207095
28462,3.5e-05,172.31.40.0-255,66,1912,63,207095
28463,5.2e-05,74.125.24.0-255,2902,4814,63,207095
28464,5.7e-05,172.31.40.0-255,66,4880,63,207095
28465,6.2e-05,74.125.24.0-255,4320,9200,63,207095
28466,6.5e-05,172.31.40.0-255,66,9266,63,207095
28467,7.6e-05,172.31.40.0-255,66,9332,63,207095
28468,8e-05,74.125.24.0-255,2902,12234,63,207095
28469,8.2e-05,172.31.40.0-255,66,12300,63,207095
28470,0.00014,172.31.40.0-255,66,12366,63,207095
28471,0.000172,74.125.24.0-255,1484,13850,63,207095
28472,0.000174,172.31.40.0-255,66,13916,63,207095
28473,0.000201,74.125.24.0-255,2902,16818,63,207095
28474,0.000203,172.31.40.0-255,66,16884,63,207095
28475,0.000209,74.125.24.0-255,5738,22622,63,207095
28476,0.000211,172.31.40.0-255,66,22688,63,207095
28477,0.000222,172.31.40.0-255,66,22754,63,207095
28478,0.000242,74.125.24.0-255,2902,25656,63,207095
28479,0.000254,172.31.40.0-255,66,25722,63,207095
28480,0.000257,172.31.40.0-255,66,25788,63,207095
28481,0.00029,74.125.24.0-255,2481,28269,63,207095
28482,0.000293,172.31.40.0-255,66,28335,63,207095
28483,0.000296,74.125.24.0-255,130,28465,63,207095
28484,0.000298,172.31.40.0-255,66,28531,63,207095
28485,0.001229,74.125.24.0-255,1484,30015,63,207095
28486,0.001237,172.31.40.0-255,66,30081,63,207095
28487,0.001246,74.125.24.0-255,2902,32983,63,207095
28488,0.001248,172.31.40.0-255,66,33049,63,207095
28489,0.001256,74.125.24.0-255,5738,38787,63,207095
28490,0.001258,172.31.40.0-255,66,38853,63,207095
28491,0.0013,74.125.24.0-255,2902,41755,63,207095
28492,0.001303,172.31.40.0-255,66,41821,63,207095
28493,0.00132,74.125.24.0-255,2902,44723,63,207095
28494,0.001322,172.31.40.0-255,66,44789,63,207095
28495,0.00133,74.125.24.0-255,7156,51945,63,207095
28496,0.001332,172.31.40.0-255,66,52011,63,207095
28497,0.001335,74.125.24.0-255,1484,53495,63,207095
28498,0.001349,74.125.24.0-255,2902,56397,63,207095
28499,0.001351,172.31.40.0-255,66,56463,63,207095
28500,0.001376,74.125.24.0-255,5738,62201,63,207095
28501,0.001379,172.31.40.0-255,66,62267,63,207095
28502,0.001382,74.125.24.0-255,766,63033,63,207095
28503,0.001831,74.125.24.0-255,1484,64517,63,207095
28504,0.001837,172.31.40.0-255,66,64583,63,207095
28505,0.001844,74.125.24.0-255,2902,67485,63,207095
28506,0.001846,172.31.40.0-255,66,67551,63,207095
28507,0.00185,74.125.24.0-255,2902,70453,63,207095
28508,0.001853,172.31.40.0-255,66,70519,63,207095
28509,0.00186,74.125.24.0-255,7156,77675,63,207095
28510,0.001862,172.31.40.0-255,66,77741,63,207095
28511,0.00191,172.31.40.0-255,66,77807,63,207095
28512,0.001936,74.125.24.0-255,7156,84963,63,207095
28513,0.001939,172.31.40.0-255,66,85029,63,207095
28514,0.001944,74.125.24.0-255,3602,88631,63,207095
28515,0.001947,172.31.40.0-255,66,88697,63,207095
28516,0.001962,172.31.40.0-255,66,88763,63,207095
28517,0.001983,74.125.24.0-255,5738,94501,63,207095
28518,0.001987,172.31.40.0-255,66,94567,63,207095
28519,0.002001,74.125.24.0-255,3602,98169,63,207095
28520,0.002027,74.125.24.0-255,4320,102489,63,207095
28521,0.00203,74.125.24.0-255,1484,103973,63,207095
28522,0.002134,74.125.24.0-255,3602,107575,63,207095
28523,0.002165,74.125.24.0-255,7156,114731,63,207095
28524,0.002172,74.125.24.0-255,5738,120469,63,207095
28525,0.00221,74.125.24.0-255,2184,122653,63,207095
28526,0.002226,74.125.24.0-255,2902,125555,63,207095
28527,0.002245,74.125.24.0-255,1484,127039,63,207095
28528,0.002267,74.125.24.0-255,5738,132777,63,207095
28529,0.002272,74.125.24.0-255,2902,135679,63,207095
28530,0.002325,74.125.24.0-255,7156,142835,63,207095
28531,0.002338,74.125.24.0-255,766,143601,63,207095
28532,0.002383,74.125.24.0-255,2902,146503,63,207095
28533,0.002404,74.125.24.0-255,7156,153659,63,207095
28534,0.002466,74.125.24.0-255,4320,157979,63,207095
28535,0.002472,74.125.24.0-255,5738,163717,63,207095
28536,0.002498,74.125.24.0-255,5738,169455,63,207095
28537,0.002525,74.125.24.0-255,4320,173775,63,207095
28538,0.002539,74.125.24.0-255,2902,176677,63,207095
28539,0.002582,74.125.24.0-255,4320,180997,63,207095
28540,0.00261,74.125.24.0-255,7156,188153,63,207095
28541,0.002613,74.125.24.0-255,1484,189637,63,207095
28542,0.002653,74.125.24.0-255,1484,191121,63,207095
28543,0.002671,74.125.24.0-255,6438,197559,63,207095
28544,0.002725,74.125.24.0-255,2902,200461,63,207095
28545,0.00273,74.125.24.0-255,4320,204781,63,207095
28546,0.002759,74.125.24.0-255,1221,206002,63,207095
28547,0.002762,74.125.24.0-255,97,206099,63,207095
28548,0.002819,74.125.24.0-255,105,206204,63,207095
28549,0.002823,74.125.24.0-255,129,206333,63,207095
28550,0.008175,172.31.40.0-255,66,206399,63,207095
28551,0.010871,172.31.40.0-255,105,206504,63,207095
28552,0.010917,172.31.40.0-255,105,206609,63,207095
28553,0.011184,172.31.40.0-255,90,206699,63,207095
28554,0.011195,172.31.40.0-255,66,206765,63,207095
28555,0.013391,74.125.24.0-255,66,206831,63,207095
28556,0.013419,74.125.24.0-255,66,206897,63,207095
28557,0.013698,74.125.24.0-255,66,206963,63,207095
28558,0.01394,74.125.24.0-255,66,207029,63,207095
28559,0.013946,172.31.40.0-255,66,207095,63,207095
28560,0.0,74.125.24.0-255,150,150,63,206040
28561,2.2e-05,172.31.40.0-255,66,216,63,206040
28562,2.9e-05,74.125.24.0-255,1484,1700,63,206040
28563,3.4e-05,172.31.40.0-255,66,1766,63,206040
28564,4.8e-05,74.125.24.0-255,2902,4668,63,206040
28565,5.2e-05,172.31.40.0-255,66,4734,63,206040
28566,6e-05,74.125.24.0-255,5738,10472,63,206040
28567,6.4e-05,172.31.40.0-255,66,10538,63,206040
28568,8.4e-05,74.125.24.0-255,1484,12022,63,206040
28569,9e-05,172.31.40.0-255,66,12088,63,206040
28570,9.5e-05,74.125.24.0-255,2022,14110,63,206040
28571,9.7e-05,172.31.40.0-255,66,14176,63,206040
28572,0.000207,74.125.24.0-255,1484,15660,63,206040
28573,0.000211,172.31.40.0-255,66,15726,63,206040
28574,0.000215,74.125.24.0-255,1484,17210,63,206040
28575,0.000217,172.31.40.0-255,66,17276,63,206040
28576,0.000235,74.125.24.0-255,1484,18760,63,206040
28577,0.000238,172.31.40.0-255,66,18826,63,206040
28578,0.000249,74.125.24.0-255,5738,24564,63,206040
28579,0.000252,172.31.40.0-255,66,24630,63,206040
28580,0.000293,74.125.24.0-255,6797,31427,63,206040
28581,0.000296,172.31.40.0-255,66,31493,63,206040
28582,0.000328,74.125.24.0-255,1484,32977,63,206040
28583,0.00033,172.31.40.0-255,66,33043,63,206040
28584,0.000335,74.125.24.0-255,2902,35945,63,206040
28585,0.000337,172.31.40.0-255,66,36011,63,206040
28586,0.000362,74.125.24.0-255,5738,41749,63,206040
28587,0.000365,172.31.40.0-255,66,41815,63,206040
28588,0.00037,74.125.24.0-255,4320,46135,63,206040
28589,0.000372,172.31.40.0-255,66,46201,63,206040
28590,0.000406,74.125.24.0-255,2543,48744,63,206040
28591,0.000408,172.31.40.0-255,66,48810,63,206040
28592,0.000806,74.125.24.0-255,1484,50294,63,206040
28593,0.000813,74.125.24.0-255,2902,53196,63,206040
28594,0.000817,172.31.40.0-255,66,53262,63,206040
28595,0.000847,74.125.24.0-255,4320,57582,63,206040
28596,0.000849,172.31.40.0-255,66,57648,63,206040
28597,0.000892,74.125.24.0-255,7156,64804,63,206040
28598,0.000895,172.31.40.0-255,66,64870,63,206040
28599,0.000912,74.125.24.0-255,1125,65995,63,206040
28600,0.001009,74.125.24.0-255,1484,67479,63,206040
28601,0.001012,172.31.40.0-255,66,67545,63,206040
28602,0.001016,74.125.24.0-255,1484,69029,63,206040
28603,0.00104,74.125.24.0-255,1484,70513,63,206040
28604,0.001043,172.31.40.0-255,66,70579,63,206040
28605,0.00105,74.125.24.0-255,5738,76317,63,206040
28606,0.001052,172.31.40.0-255,66,76383,63,206040
28607,0.001057,74.125.24.0-255,4320,80703,63,206040
28608,0.00106,172.31.40.0-255,66,80769,63,206040
28609,0.001096,74.125.24.0-255,6797,87566,63,206040
28610,0.001098,172.31.40.0-255,66,87632,63,206040
28611,0.001131,172.31.40.0-255,66,87698,63,206040
28612,0.001541,74.125.24.0-255,1484,89182,63,206040
28613,0.001548,74.125.24.0-255,2902,92084,63,206040
28614,0.001551,172.31.40.0-255,66,92150,63,206040
28615,0.001557,74.125.24.0-255,2902,95052,63,206040
28616,0.001559,172.31.40.0-255,66,95118,63,206040
28617,0.001584,74.125.24.0-255,2902,98020,63,206040
28618,0.001604,172.31.40.0-255,66,98086,63,206040
28619,0.001618,172.31.40.0-255,66,98152,63,206040
28620,0.001627,172.31.40.0-255,66,98218,63,206040
28621,0.001652,74.125.24.0-255,2184,100402,63,206040
28622,0.001659,172.31.40.0-255,66,100468,63,206040
28623,0.001676,74.125.24.0-255,2902,103370,63,206040
28624,0.001679,172.31.40.0-255,66,103436,63,206040
28625,0.001706,74.125.24.0-255,4320,107756,63,206040
28626,0.001708,172.31.40.0-255,66,107822,63,206040
28627,0.001719,172.31.40.0-255,66,107888,63,206040
28628,0.001824,172.31.40.0-255,66,107954,63,206040
28629,0.002005,74.125.24.0-255,1484,109438,63,206040
28630,0.002013,74.125.24.0-255,2902,112340,63,206040
28631,0.002016,172.31.40.0-255,66,112406,63,206040
28632,0.002022,74.125.24.0-255,2902,115308,63,206040
28633,0.002024,172.31.40.0-255,66,115374,63,206040
28634,0.002044,74.125.24.0-255,2902,118276,63,206040
28635,0.002051,172.31.40.0-255,66,118342,63,206040
28636,0.002126,172.31.40.0-255,66,118408,63,206040
28637,0.002145,172.31.40.0-255,66,118474,63,206040
28638,0.002149,74.125.24.0-255,2184,120658,63,206040
28639,0.002151,172.31.40.0-255,66,120724,63,206040
28640,0.002156,74.125.24.0-255,2902,123626,63,206040
28641,0.002158,172.31.40.0-255,66,123692,63,206040
28642,0.002193,74.125.24.0-255,4320,128012,63,206040
28643,0.002197,172.31.40.0-255,66,128078,63,206040
28644,0.002208,172.31.40.0-255,66,128144,63,206040
28645,0.002215,74.125.24.0-255,7156,135300,63,206040
28646,0.002223,172.31.40.0-255,66,135366,63,206040
28647,0.00223,74.125.24.0-255,7156,142522,63,206040
28648,0.002232,172.31.40.0-255,66,142588,63,206040
28649,0.002258,74.125.24.0-255,3602,146190,63,206040
28650,0.00226,172.31.40.0-255,66,146256,63,206040
28651,0.002304,74.125.24.0-255,1484,147740,63,206040
28652,0.002309,74.125.24.0-255,2902,150642,63,206040
28653,0.002312,172.31.40.0-255,66,150708,63,206040
28654,0.002343,74.125.24.0-255,5738,156446,63,206040
28655,0.002346,172.31.40.0-255,66,156512,63,206040
28656,0.002353,74.125.24.0-255,5738,162250,63,206040
28657,0.002356,172.31.40.0-255,66,162316,63,206040
28658,0.002386,74.125.24.0-255,2902,165218,63,206040
28659,0.002388,172.31.40.0-255,66,165284,63,206040
28660,0.002394,74.125.24.0-255,5738,171022,63,206040
28661,0.002397,172.31.40.0-255,66,171088,63,206040
28662,0.002401,74.125.24.0-255,2902,173990,63,206040
28663,0.002403,172.31.40.0-255,66,174056,63,206040
28664,0.002437,74.125.24.0-255,6438,180494,63,206040
28665,0.00244,172.31.40.0-255,66,180560,63,206040
28666,0.002525,74.125.24.0-255,1484,182044,63,206040
28667,0.002531,74.125.24.0-255,2902,184946,63,206040
28668,0.002535,172.31.40.0-255,66,185012,63,206040
28669,0.002565,74.125.24.0-255,5738,190750,63,206040
28670,0.002567,172.31.40.0-255,66,190816,63,206040
28671,0.002573,74.125.24.0-255,5738,196554,63,206040
28672,0.002576,172.31.40.0-255,66,196620,63,206040
28673,0.002581,74.125.24.0-255,4320,200940,63,206040
28674,0.002583,172.31.40.0-255,66,201006,63,206040
28675,0.002618,172.31.40.0-255,66,201072,63,206040
28676,0.002637,172.31.40.0-255,66,201138,63,206040
28677,0.002681,74.125.24.0-255,3602,204740,63,206040
28678,0.002684,172.31.40.0-255,66,204806,63,206040
28679,0.002706,172.31.40.0-255,66,204872,63,206040
28680,0.00272,172.31.40.0-255,66,204938,63,206040
28681,0.002767,172.31.40.0-255,66,205004,63,206040
28682,0.002814,172.31.40.0-255,66,205070,63,206040
28683,0.002839,172.31.40.0-255,66,205136,63,206040
28684,0.002842,74.125.24.0-255,97,205233,63,206040
28685,0.002844,74.125.24.0-255,105,205338,63,206040
28686,0.002847,74.125.24.0-255,129,205467,63,206040
28687,0.01186,74.125.24.0-255,129,205596,63,206040
28688,0.01188,172.31.40.0-255,78,205674,63,206040
28689,0.018312,172.31.40.0-255,105,205779,63,206040
28690,0.01836,172.31.40.0-255,105,205884,63,206040
28691,0.018638,172.31.40.0-255,90,205974,63,206040
28692,0.018659,172.31.40.0-255,66,206040,63,206040
28693,0.0,172.217.194.0-255,153,153,63,178240
28694,2.4e-05,172.31.40.0-255,66,219,63,178240
28695,3.2e-05,172.217.194.0-255,1484,1703,63,178240
28696,3.7e-05,172.31.40.0-255,66,1769,63,178240
28697,4.3e-05,172.217.194.0-255,2902,4671,63,178240
28698,5.4e-05,172.31.40.0-255,66,4737,63,178240
28699,6.2e-05,172.217.194.0-255,7156,11893,63,178240
28700,6.4e-05,172.31.40.0-255,66,11959,63,178240
28701,6.8e-05,172.217.194.0-255,2074,14033,63,178240
28702,7.2e-05,172.31.40.0-255,66,14099,63,178240
28703,8.6e-05,172.31.40.0-255,66,14165,63,178240
28704,0.000113,172.217.194.0-255,4320,18485,63,178240
28705,0.000116,172.31.40.0-255,66,18551,63,178240
28706,0.00014,172.217.194.0-255,1125,19676,63,178240
28707,0.000142,172.31.40.0-255,66,19742,63,178240
28708,0.000204,172.217.194.0-255,1484,21226,63,178240
28709,0.000206,172.31.40.0-255,66,21292,63,178240
28710,0.000211,172.217.194.0-255,2902,24194,63,178240
28711,0.000213,172.31.40.0-255,66,24260,63,178240
28712,0.00022,172.217.194.0-255,5738,29998,63,178240
28713,0.000226,172.31.40.0-255,66,30064,63,178240
28714,0.000254,172.217.194.0-255,6797,36861,63,178240
28715,0.000257,172.31.40.0-255,66,36927,63,178240
28716,0.000294,172.217.194.0-255,7156,44083,63,178240
28717,0.000297,172.31.40.0-255,66,44149,63,178240
28718,0.000303,172.217.194.0-255,5738,49887,63,178240
28719,0.000305,172.31.40.0-255,66,49953,63,178240
28720,0.000336,172.217.194.0-255,3961,53914,63,178240
28721,0.000339,172.31.40.0-255,66,53980,63,178240
28722,0.000517,172.217.194.0-255,381,54361,63,178240
28723,0.000522,172.31.40.0-255,66,54427,63,178240
28724,0.000588,172.217.194.0-255,363,54790,63,178240
28725,0.000873,172.217.194.0-255,1484,56274,63,178240
28726,0.000878,172.217.194.0-255,2902,59176,63,178240
28727,0.000883,172.31.40.0-255,66,59242,63,178240
28728,0.000887,172.31.40.0-255,66,59308,63,178240
28729,0.000904,172.217.194.0-255,5738,65046,63,178240
28730,0.000909,172.31.40.0-255,66,65112,63,178240
28731,0.000941,172.31.40.0-255,66,65178,63,178240
28732,0.000981,172.31.40.0-255,66,65244,63,178240
28733,0.001008,172.217.194.0-255,3602,68846,63,178240
28734,0.001011,172.31.40.0-255,66,68912,63,178240
28735,0.001422,172.217.194.0-255,1484,70396,63,178240
28736,0.001428,172.217.194.0-255,2902,73298,63,178240
28737,0.001431,172.31.40.0-255,66,73364,63,178240
28738,0.001436,172.217.194.0-255,2902,76266,63,178240
28739,0.001439,172.31.40.0-255,66,76332,63,178240
28740,0.001461,172.217.194.0-255,2902,79234,63,178240
28741,0.001463,172.31.40.0-255,66,79300,63,178240
28742,0.001469,172.217.194.0-255,4320,83620,63,178240
28743,0.001471,172.31.40.0-255,66,83686,63,178240
28744,0.001501,172.31.40.0-255,66,83752,63,178240
28745,0.001514,172.31.40.0-255,66,83818,63,178240
28746,0.001802,172.217.194.0-255,1484,85302,63,178240
28747,0.001821,172.217.194.0-255,2902,88204,63,178240
28748,0.001824,172.31.40.0-255,66,88270,63,178240
28749,0.001832,172.217.194.0-255,5738,94008,63,178240
28750,0.001834,172.31.40.0-255,66,94074,63,178240
28751,0.001861,172.31.40.0-255,66,94140,63,178240
28752,0.00189,172.217.194.0-255,4320,98460,63,178240
28753,0.001892,172.31.40.0-255,66,98526,63,178240
28754,0.00193,172.31.40.0-255,66,98592,63,178240
28755,0.001964,172.217.194.0-255,1484,100076,63,178240
28756,0.001969,172.217.194.0-255,2902,102978,63,178240
28757,0.001971,172.31.40.0-255,66,103044,63,178240
28758,0.002001,172.217.194.0-255,5738,108782,63,178240
28759,0.002004,172.31.40.0-255,66,108848,63,178240
28760,0.002007,172.217.194.0-255,1484,110332,63,178240
28761,0.002012,172.217.194.0-255,4320,114652,63,178240
28762,0.002014,172.31.40.0-255,66,114718,63,178240
28763,0.002039,172.31.40.0-255,66,114784,63,178240
28764,0.002042,172.217.194.0-255,1484,116268,63,178240
28765,0.002076,172.31.40.0-255,66,116334,63,178240
28766,0.002103,172.217.194.0-255,1484,117818,63,178240
28767,0.00212,172.217.194.0-255,2902,120720,63,178240
28768,0.002123,172.31.40.0-255,66,120786,63,178240
28769,0.00213,172.217.194.0-255,5738,126524,63,178240
28770,0.002132,172.31.40.0-255,66,126590,63,178240
28771,0.002168,172.217.194.0-255,1484,128074,63,178240
28772,0.002214,172.217.194.0-255,4320,132394,63,178240
28773,0.002218,172.31.40.0-255,66,132460,63,178240
28774,0.002232,172.31.40.0-255,66,132526,63,178240
28775,0.002237,172.217.194.0-255,5020,137546,63,178240
28776,0.002239,172.31.40.0-255,66,137612,63,178240
28777,0.004542,172.217.194.0-255,5738,143350,63,178240
28778,0.00455,172.31.40.0-255,66,143416,63,178240
28779,0.006818,172.217.194.0-255,5738,149154,63,178240
28780,0.006824,172.31.40.0-255,66,149220,63,178240
28781,0.009092,172.217.194.0-255,5738,154958,63,178240
28782,0.009101,172.31.40.0-255,66,155024,63,178240
28783,0.011375,172.217.194.0-255,5738,160762,63,178240
28784,0.011394,172.31.40.0-255,66,160828,63,178240
28785,0.013698,172.217.194.0-255,5738,166566,63,178240
28786,0.013715,172.31.40.0-255,66,166632,63,178240
28787,0.016005,172.217.194.0-255,5738,172370,63,178240
28788,0.016022,172.31.40.0-255,66,172436,63,178240
28789,0.018305,172.217.194.0-255,5738,178174,63,178240
28790,0.018324,172.31.40.0-255,66,178240,63,178240
28791,0.0,74.125.24.0-255,299,299,63,179136
28792,3.3e-05,172.31.40.0-255,66,365,63,179136
28793,3.9e-05,74.125.24.0-255,1484,1849,63,179136
28794,4.4e-05,172.31.40.0-255,66,1915,63,179136
28795,5e-05,74.125.24.0-255,4320,6235,63,179136
28796,5.3e-05,172.31.40.0-255,66,6301,63,179136
28797,5.9e-05,74.125.24.0-255,7156,13457,63,179136
28798,6.2e-05,172.31.40.0-255,66,13523,63,179136
28799,0.000104,172.31.40.0-255,66,13589,63,179136
28800,0.000127,74.125.24.0-255,6040,19629,63,179136
28801,0.000131,172.31.40.0-255,66,19695,63,179136
28802,0.000134,74.125.24.0-255,1125,20820,63,179136
28803,0.000136,172.31.40.0-255,66,20886,63,179136
28804,0.000148,74.125.24.0-255,1484,22370,63,179136
28805,0.00015,172.31.40.0-255,66,22436,63,179136
28806,0.000154,74.125.24.0-255,2902,25338,63,179136
28807,0.000157,172.31.40.0-255,66,25404,63,179136
28808,0.000162,74.125.24.0-255,4320,29724,63,179136
28809,0.000164,172.31.40.0-255,66,29790,63,179136
28810,0.000179,74.125.24.0-255,1484,31274,63,179136
28811,0.000181,172.31.40.0-255,66,31340,63,179136
28812,0.000199,74.125.24.0-255,6797,38137,63,179136
28813,0.000203,172.31.40.0-255,66,38203,63,179136
28814,0.000633,74.125.24.0-255,1484,39687,63,179136
28815,0.000638,172.31.40.0-255,66,39753,63,179136
28816,0.000643,74.125.24.0-255,2902,42655,63,179136
28817,0.000646,172.31.40.0-255,66,42721,63,179136
28818,0.000669,74.125.24.0-255,5738,48459,63,179136
28819,0.000673,172.31.40.0-255,66,48525,63,179136
28820,0.000684,74.125.24.0-255,1484,50009,63,179136
28821,0.000687,172.31.40.0-255,66,50075,63,179136
28822,0.000714,172.31.40.0-255,66,50141,63,179136
28823,0.000738,172.31.40.0-255,66,50207,63,179136
28824,0.00076,74.125.24.0-255,1484,51691,63,179136
28825,0.000777,74.125.24.0-255,1484,53175,63,179136
28826,0.00078,172.31.40.0-255,66,53241,63,179136
28827,0.000802,74.125.24.0-255,1484,54725,63,179136
28828,0.000808,74.125.24.0-255,5738,60463,63,179136
28829,0.000812,172.31.40.0-255,66,60529,63,179136
28830,0.000824,172.31.40.0-255,66,60595,63,179136
28831,0.000861,74.125.24.0-255,5738,66333,63,179136
28832,0.000865,172.31.40.0-255,66,66399,63,179136
28833,0.000892,172.31.40.0-255,66,66465,63,179136
28834,0.000896,74.125.24.0-255,2902,69367,63,179136
28835,0.000899,172.31.40.0-255,66,69433,63,179136
28836,0.000914,74.125.24.0-255,7156,76589,63,179136
28837,0.000917,172.31.40.0-255,66,76655,63,179136
28838,0.000941,74.125.24.0-255,4320,80975,63,179136
28839,0.000944,172.31.40.0-255,66,81041,63,179136
28840,0.001028,74.125.24.0-255,3237,84278,63,179136
28841,0.001032,172.31.40.0-255,66,84344,63,179136
28842,0.001098,74.125.24.0-255,1484,85828,63,179136
28843,0.001102,74.125.24.0-255,1484,87312,63,179136
28844,0.001107,172.31.40.0-255,66,87378,63,179136
28845,0.001115,74.125.24.0-255,1484,88862,63,179136
28846,0.001136,74.125.24.0-255,5738,94600,63,179136
28847,0.00114,172.31.40.0-255,66,94666,63,179136
28848,0.001201,172.31.40.0-255,66,94732,63,179136
28849,0.001238,74.125.24.0-255,4320,99052,63,179136
28850,0.001242,172.31.40.0-255,66,99118,63,179136
28851,0.001266,74.125.24.0-255,6438,105556,63,179136
28852,0.00127,172.31.40.0-255,66,105622,63,179136
28853,0.001901,74.125.24.0-255,1484,107106,63,179136
28854,0.001911,74.125.24.0-255,2902,110008,63,179136
28855,0.001916,172.31.40.0-255,66,110074,63,179136
28856,0.001923,74.125.24.0-255,4320,114394,63,179136
28857,0.001925,172.31.40.0-255,66,114460,63,179136
28858,0.001938,74.125.24.0-255,1484,115944,63,179136
28859,0.001955,74.125.24.0-255,5738,121682,63,179136
28860,0.001958,172.31.40.0-255,66,121748,63,179136
28861,0.001977,74.125.24.0-255,7156,128904,63,179136
28862,0.001979,172.31.40.0-255,66,128970,63,179136
28863,0.001995,74.125.24.0-255,4320,133290,63,179136
28864,0.001997,172.31.40.0-255,66,133356,63,179136
28865,0.002015,74.125.24.0-255,6438,139794,63,179136
28866,0.002017,172.31.40.0-255,66,139860,63,179136
28867,0.004372,74.125.24.0-255,4320,144180,63,179136
28868,0.004379,172.31.40.0-255,66,144246,63,179136
28869,0.004397,74.125.24.0-255,1484,145730,63,179136
28870,0.006722,74.125.24.0-255,4320,150050,63,179136
28871,0.006728,172.31.40.0-255,66,150116,63,179136
28872,0.00912,74.125.24.0-255,5738,155854,63,179136
28873,0.009127,172.31.40.0-255,66,155920,63,179136
28874,0.011517,74.125.24.0-255,5738,161658,63,179136
28875,0.011524,172.31.40.0-255,66,161724,63,179136
28876,0.013833,74.125.24.0-255,5738,167462,63,179136
28877,0.013842,172.31.40.0-255,66,167528,63,179136
28878,0.016201,74.125.24.0-255,5738,173266,63,179136
28879,0.016207,172.31.40.0-255,66,173332,63,179136
28880,0.01856,74.125.24.0-255,5738,179070,63,179136
28881,0.018566,172.31.40.0-255,66,179136,63,179136
28882,0.0,74.125.24.0-255,296,296,63,205819
28883,2.8e-05,172.31.40.0-255,66,362,63,205819
28884,3.5e-05,74.125.24.0-255,1484,1846,63,205819
28885,3.9e-05,172.31.40.0-255,66,1912,63,205819
28886,4.6e-05,74.125.24.0-255,4320,6232,63,205819
28887,5e-05,172.31.40.0-255,66,6298,63,205819
28888,6.2e-05,172.31.40.0-255,66,6364,63,205819
28889,7.5e-05,172.31.40.0-255,66,6430,63,205819
28890,0.0001,74.125.24.0-255,2902,9332,63,205819
28891,0.000103,172.31.40.0-255,66,9398,63,205819
28892,0.000108,74.125.24.0-255,2543,11941,63,205819
28893,0.00011,172.31.40.0-255,66,12007,63,205819
28894,0.000128,74.125.24.0-255,2902,14909,63,205819
28895,0.000131,172.31.40.0-255,66,14975,63,205819
28896,0.000139,74.125.24.0-255,7156,22131,63,205819
28897,0.000141,172.31.40.0-255,66,22197,63,205819
28898,0.000163,74.125.24.0-255,4320,26517,63,205819
28899,0.000165,172.31.40.0-255,66,26583,63,205819
28900,0.000209,172.31.40.0-255,66,26649,63,205819
28901,0.000213,74.125.24.0-255,2480,29129,63,205819
28902,0.000216,172.31.40.0-255,66,29195,63,205819
28903,0.000254,74.125.24.0-255,132,29327,63,205819
28904,0.000257,172.31.40.0-255,66,29393,63,205819
28905,0.000352,74.125.24.0-255,1484,30877,63,205819
28906,0.000356,172.31.40.0-255,66,30943,63,205819
28907,0.000362,74.125.24.0-255,2902,33845,63,205819
28908,0.000365,172.31.40.0-255,66,33911,63,205819
28909,0.000396,74.125.24.0-255,7156,41067,63,205819
28910,0.000399,172.31.40.0-255,66,41133,63,205819
28911,0.000405,74.125.24.0-255,5738,46871,63,205819
28912,0.000408,172.31.40.0-255,66,46937,63,205819
28913,0.00045,172.31.40.0-255,66,47003,63,205819
28914,0.000469,74.125.24.0-255,2464,49467,63,205819
28915,0.000471,172.31.40.0-255,66,49533,63,205819
28916,0.000507,74.125.24.0-255,1484,51017,63,205819
28917,0.000513,74.125.24.0-255,2902,53919,63,205819
28918,0.000516,172.31.40.0-255,66,53985,63,205819
28919,0.000522,74.125.24.0-255,5738,59723,63,205819
28920,0.000525,172.31.40.0-255,66,59789,63,205819
28921,0.000544,74.125.24.0-255,2902,62691,63,205819
28922,0.000547,172.31.40.0-255,66,62757,63,205819
28923,0.000581,172.31.40.0-255,66,62823,63,205819
28924,0.000592,172.31.40.0-255,66,62889,63,205819
28925,0.000611,74.125.24.0-255,2184,65073,63,205819
28926,0.000613,172.31.40.0-255,66,65139,63,205819
28927,0.000691,74.125.24.0-255,1484,66623,63,205819
28928,0.000697,74.125.24.0-255,2902,69525,63,205819
28929,0.000703,172.31.40.0-255,66,69591,63,205819
28930,0.000713,74.125.24.0-255,4320,73911,63,205819
28931,0.000716,172.31.40.0-255,66,73977,63,205819
28932,0.000729,74.125.24.0-255,1484,75461,63,205819
28933,0.000744,172.31.40.0-255,66,75527,63,205819
28934,0.000758,74.125.24.0-255,1484,77011,63,205819
28935,0.000763,74.125.24.0-255,4320,81331,63,205819
28936,0.000766,172.31.40.0-255,66,81397,63,205819
28937,0.000794,74.125.24.0-255,6438,87835,63,205819
28938,0.000798,172.31.40.0-255,66,87901,63,205819
28939,0.001097,74.125.24.0-255,1484,89385,63,205819
28940,0.001116,74.125.24.0-255,2902,92287,63,205819
28941,0.00112,172.31.40.0-255,66,92353,63,205819
28942,0.001126,74.125.24.0-255,5738,98091,63,205819
28943,0.001129,172.31.40.0-255,66,98157,63,205819
28944,0.001132,74.125.24.0-255,1484,99641,63,205819
28945,0.001188,172.31.40.0-255,66,99707,63,205819
28946,0.0012,172.31.40.0-255,66,99773,63,205819
28947,0.001383,74.125.24.0-255,1484,101257,63,205819
28948,0.001387,74.125.24.0-255,1484,102741,63,205819
28949,0.001391,172.31.40.0-255,66,102807,63,205819
28950,0.001408,74.125.24.0-255,1484,104291,63,205819
28951,0.001414,74.125.24.0-255,5738,110029,63,205819
28952,0.001416,172.31.40.0-255,66,110095,63,205819
28953,0.001433,74.125.24.0-255,7156,117251,63,205819
28954,0.001442,172.31.40.0-255,66,117317,63,205819
28955,0.001468,74.125.24.0-255,2184,119501,63,205819
28956,0.001485,172.31.40.0-255,66,119567,63,205819
28957,0.001563,74.125.24.0-255,1484,121051,63,205819
28958,0.001567,74.125.24.0-255,1484,122535,63,205819
28959,0.00157,172.31.40.0-255,66,122601,63,205819
28960,0.001588,74.125.24.0-255,1484,124085,63,205819
28961,0.001595,74.125.24.0-255,4320,128405,63,205819
28962,0.001609,74.125.24.0-255,1484,129889,63,205819
28963,0.001648,74.125.24.0-255,1484,131373,63,205819
28964,0.001661,74.125.24.0-255,4320,135693,63,205819
28965,0.001671,74.125.24.0-255,7156,142849,63,205819
28966,0.001703,172.31.40.0-255,66,142915,63,205819
28967,0.001773,74.125.24.0-255,1484,144399,63,205819
28968,0.001778,74.125.24.0-255,2902,147301,63,205819
28969,0.001781,74.125.24.0-255,1484,148785,63,205819
28970,0.001798,172.31.40.0-255,66,148851,63,205819
28971,0.001804,74.125.24.0-255,4320,153171,63,205819
28972,0.00181,74.125.24.0-255,7156,160327,63,205819
28973,0.001817,172.31.40.0-255,66,160393,63,205819
28974,0.00184,74.125.24.0-255,5738,166131,63,205819
28975,0.00186,74.125.24.0-255,2184,168315,63,205819
28976,0.00187,172.31.40.0-255,66,168381,63,205819
28977,0.001885,74.125.24.0-255,2902,171283,63,205819
28978,0.001899,172.31.40.0-255,66,171349,63,205819
28979,0.001916,74.125.24.0-255,7156,178505,63,205819
28980,0.001921,74.125.24.0-255,4320,182825,63,205819
28981,0.001941,74.125.24.0-255,5738,188563,63,205819
28982,0.001957,74.125.24.0-255,5738,194301,63,205819
28983,0.001992,172.31.40.0-255,66,194367,63,205819
28984,0.002001,74.125.24.0-255,4320,198687,63,205819
28985,0.00201,172.31.40.0-255,66,198753,63,205819
28986,0.002028,74.125.24.0-255,1484,200237,63,205819
28987,0.00209,172.31.40.0-255,66,200303,63,205819
28988,0.002101,74.125.24.0-255,5108,205411,63,205819
28989,0.002115,74.125.24.0-255,105,205516,63,205819
28990,0.002117,172.31.40.0-255,66,205582,63,205819
28991,0.004481,172.31.40.0-255,66,205648,63,205819
28992,0.004519,172.31.40.0-255,105,205753,63,205819
28993,0.006768,74.125.24.0-255,66,205819,63,205819
28994,0.0,172.217.27.0-255,153,153,63,125263
28995,3.2e-05,172.31.40.0-255,66,219,63,125263
28996,4e-05,172.217.27.0-255,1484,1703,63,125263
28997,4.5e-05,172.31.40.0-255,66,1769,63,125263
28998,5e-05,172.217.27.0-255,2902,4671,63,125263
28999,6.2e-05,172.31.40.0-255,66,4737,63,125263
29000,7e-05,172.217.27.0-255,7156,11893,63,125263
29001,7.2e-05,172.31.40.0-255,66,11959,63,125263
29002,7.7e-05,172.217.27.0-255,3460,15419,63,125263
29003,8e-05,172.31.40.0-255,66,15485,63,125263
29004,8.5e-05,172.217.27.0-255,4320,19805,63,125263
29005,8.8e-05,172.31.40.0-255,66,19871,63,125263
29006,0.0001,172.31.40.0-255,66,19937,63,125263
29007,0.000103,172.217.27.0-255,1125,21062,63,125263
29008,0.000106,172.31.40.0-255,66,21128,63,125263
29009,0.000239,172.217.27.0-255,1484,22612,63,125263
29010,0.000242,172.31.40.0-255,66,22678,63,125263
29011,0.000251,172.217.27.0-255,2902,25580,63,125263
29012,0.000254,172.31.40.0-255,66,25646,63,125263
29013,0.000264,172.217.27.0-255,5738,31384,63,125263
29014,0.000267,172.31.40.0-255,66,31450,63,125263
29015,0.000271,172.217.27.0-255,2902,34352,63,125263
29016,0.000273,172.31.40.0-255,66,34418,63,125263
29017,0.000305,172.217.27.0-255,3961,38379,63,125263
29018,0.000308,172.31.40.0-255,66,38445,63,125263
29019,0.000319,172.31.40.0-255,66,38511,63,125263
29020,0.000324,172.217.27.0-255,4320,42831,63,125263
29021,0.000326,172.31.40.0-255,66,42897,63,125263
29022,0.000356,172.217.27.0-255,3961,46858,63,125263
29023,0.000358,172.31.40.0-255,66,46924,63,125263
29024,0.000365,172.217.27.0-255,361,47285,63,125263
29025,0.001111,172.31.40.0-255,66,47351,63,125263
29026,0.001198,172.217.27.0-255,382,47733,63,125263
29027,0.001358,172.217.27.0-255,1484,49217,63,125263
29028,0.001363,172.31.40.0-255,66,49283,63,125263
29029,0.00137,172.217.27.0-255,2902,52185,63,125263
29030,0.001373,172.31.40.0-255,66,52251,63,125263
29031,0.001385,172.217.27.0-255,5738,57989,63,125263
29032,0.001387,172.31.40.0-255,66,58055,63,125263
29033,0.001392,172.217.27.0-255,2902,60957,63,125263
29034,0.001394,172.31.40.0-255,66,61023,63,125263
29035,0.001443,172.31.40.0-255,66,61089,63,125263
29036,0.001459,172.31.40.0-255,66,61155,63,125263
29037,0.00309,172.217.27.0-255,5738,66893,63,125263
29038,0.003098,172.31.40.0-255,66,66959,63,125263
29039,0.004734,172.217.27.0-255,2902,69861,63,125263
29040,0.004737,172.31.40.0-255,66,69927,63,125263
29041,0.004764,172.217.27.0-255,2902,72829,63,125263
29042,0.004766,172.31.40.0-255,66,72895,63,125263
29043,0.006369,172.217.27.0-255,2902,75797,63,125263
29044,0.006372,172.31.40.0-255,66,75863,63,125263
29045,0.006401,172.217.27.0-255,2902,78765,63,125263
29046,0.006403,172.31.40.0-255,66,78831,63,125263
29047,0.008026,172.217.27.0-255,5738,84569,63,125263
29048,0.008033,172.31.40.0-255,66,84635,63,125263
29049,0.009679,172.217.27.0-255,5738,90373,63,125263
29050,0.009697,172.31.40.0-255,66,90439,63,125263
29051,0.011334,172.217.27.0-255,5738,96177,63,125263
29052,0.011342,172.31.40.0-255,66,96243,63,125263
29053,0.012987,172.217.27.0-255,5738,101981,63,125263
29054,0.012996,172.31.40.0-255,66,102047,63,125263
29055,0.014657,172.217.27.0-255,5738,107785,63,125263
29056,0.014664,172.31.40.0-255,66,107851,63,125263
29057,0.016302,172.217.27.0-255,5738,113589,63,125263
29058,0.016309,172.31.40.0-255,66,113655,63,125263
29059,0.017941,172.217.27.0-255,5738,119393,63,125263
29060,0.017957,172.31.40.0-255,66,119459,63,125263
29061,0.019607,172.217.27.0-255,5738,125197,63,125263
29062,0.019615,172.31.40.0-255,66,125263,63,125263
29063,0.0,172.217.194.0-255,146,146,63,215572
29064,2.3e-05,172.31.40.0-255,66,212,63,215572
29065,3e-05,172.217.194.0-255,1484,1696,63,215572
29066,3.5e-05,172.31.40.0-255,66,1762,63,215572
29067,4.2e-05,172.217.194.0-255,2902,4664,63,215572
29068,4.4e-05,172.31.40.0-255,66,4730,63,215572
29069,5.1e-05,172.217.194.0-255,5738,10468,63,215572
29070,5.4e-05,172.31.40.0-255,66,10534,63,215572
29071,8.4e-05,172.217.194.0-255,3582,14116,63,215572
29072,8.7e-05,172.31.40.0-255,66,14182,63,215572
29073,0.000118,172.217.194.0-255,2902,17084,63,215572
29074,0.000121,172.31.40.0-255,66,17150,63,215572
29075,0.000143,172.217.194.0-255,4320,21470,63,215572
29076,0.000146,172.31.40.0-255,66,21536,63,215572
29077,0.000153,172.217.194.0-255,5738,27274,63,215572
29078,0.000155,172.31.40.0-255,66,27340,63,215572
29079,0.000169,172.217.194.0-255,2902,30242,63,215572
29080,0.000172,172.31.40.0-255,66,30308,63,215572
29081,0.000175,172.217.194.0-255,1125,31433,63,215572
29082,0.000176,172.31.40.0-255,66,31499,63,215572
29083,0.000196,172.217.194.0-255,7156,38655,63,215572
29084,0.000199,172.31.40.0-255,66,38721,63,215572
29085,0.000217,172.217.194.0-255,4320,43041,63,215572
29086,0.000219,172.31.40.0-255,66,43107,63,215572
29087,0.000247,172.217.194.0-255,5379,48486,63,215572
29088,0.00025,172.31.40.0-255,66,48552,63,215572
29089,0.000553,172.217.194.0-255,1484,50036,63,215572
29090,0.000558,172.31.40.0-255,66,50102,63,215572
29091,0.000565,172.217.194.0-255,2902,53004,63,215572
29092,0.000567,172.31.40.0-255,66,53070,63,215572
29093,0.000596,172.217.194.0-255,4320,57390,63,215572
29094,0.000599,172.31.40.0-255,66,57456,63,215572
29095,0.000614,172.217.194.0-255,1484,58940,63,215572
29096,0.000628,172.217.194.0-255,1484,60424,63,215572
29097,0.000631,172.31.40.0-255,66,60490,63,215572
29098,0.000647,172.217.194.0-255,4320,64810,63,215572
29099,0.00065,172.31.40.0-255,66,64876,63,215572
29100,0.000671,172.217.194.0-255,1375,66251,63,215572
29101,0.000901,172.217.194.0-255,1484,67735,63,215572
29102,0.000905,172.31.40.0-255,66,67801,63,215572
29103,0.000911,172.217.194.0-255,2902,70703,63,215572
29104,0.000913,172.31.40.0-255,66,70769,63,215572
29105,0.00093,172.217.194.0-255,5738,76507,63,215572
29106,0.000932,172.31.40.0-255,66,76573,63,215572
29107,0.000935,172.217.194.0-255,1484,78057,63,215572
29108,0.000959,172.217.194.0-255,2902,80959,63,215572
29109,0.000962,172.31.40.0-255,66,81025,63,215572
29110,0.000979,172.217.194.0-255,4320,85345,63,215572
29111,0.000981,172.31.40.0-255,66,85411,63,215572
29112,0.000996,172.217.194.0-255,7156,92567,63,215572
29113,0.000998,172.31.40.0-255,66,92633,63,215572
29114,0.001009,172.31.40.0-255,66,92699,63,215572
29115,0.001193,172.217.194.0-255,1484,94183,63,215572
29116,0.001199,172.217.194.0-255,2902,97085,63,215572
29117,0.001202,172.31.40.0-255,66,97151,63,215572
29118,0.001206,172.217.194.0-255,1484,98635,63,215572
29119,0.00122,172.217.194.0-255,4320,102955,63,215572
29120,0.001222,172.31.40.0-255,66,103021,63,215572
29121,0.001255,172.31.40.0-255,66,103087,63,215572
29122,0.001277,172.217.194.0-255,4320,107407,63,215572
29123,0.001279,172.31.40.0-255,66,107473,63,215572
29124,0.001286,172.217.194.0-255,7156,114629,63,215572
29125,0.001288,172.31.40.0-255,66,114695,63,215572
29126,0.001318,172.217.194.0-255,3941,118636,63,215572
29127,0.00132,172.31.40.0-255,66,118702,63,215572
29128,0.001369,172.217.194.0-255,1484,120186,63,215572
29129,0.001374,172.217.194.0-255,2902,123088,63,215572
29130,0.001377,172.31.40.0-255,66,123154,63,215572
29131,0.001383,172.217.194.0-255,5738,128892,63,215572
29132,0.001386,172.31.40.0-255,66,128958,63,215572
29133,0.001388,172.217.194.0-255,1484,130442,63,215572
29134,0.001446,172.31.40.0-255,66,130508,63,215572
29135,0.001459,172.31.40.0-255,66,130574,63,215572
29136,0.001497,172.31.40.0-255,66,130640,63,215572
29137,0.001518,172.217.194.0-255,7156,137796,63,215572
29138,0.00152,172.31.40.0-255,66,137862,63,215572
29139,0.001535,172.31.40.0-255,66,137928,63,215572
29140,0.001537,172.217.194.0-255,1484,139412,63,215572
29141,0.001566,172.31.40.0-255,66,139478,63,215572
29142,0.001574,172.217.194.0-255,5738,145216,63,215572
29143,0.001576,172.31.40.0-255,66,145282,63,215572
29144,0.001633,172.31.40.0-255,66,145348,63,215572
29145,0.001654,172.217.194.0-255,6438,151786,63,215572
29146,0.001657,172.31.40.0-255,66,151852,63,215572
29147,0.002195,172.217.194.0-255,1484,153336,63,215572
29148,0.002203,172.217.194.0-255,2902,156238,63,215572
29149,0.002208,172.31.40.0-255,66,156304,63,215572
29150,0.002215,172.217.194.0-255,2902,159206,63,215572
29151,0.002218,172.31.40.0-255,66,159272,63,215572
29152,0.002233,172.217.194.0-255,2902,162174,63,215572
29153,0.002236,172.31.40.0-255,66,162240,63,215572
29154,0.002242,172.217.194.0-255,5738,167978,63,215572
29155,0.002245,172.31.40.0-255,66,168044,63,215572
29156,0.002254,172.217.194.0-255,2902,170946,63,215572
29157,0.002257,172.31.40.0-255,66,171012,63,215572
29158,0.00229,172.31.40.0-255,66,171078,63,215572
29159,0.002294,172.217.194.0-255,2902,173980,63,215572
29160,0.002296,172.31.40.0-255,66,174046,63,215572
29161,0.002309,172.217.194.0-255,2184,176230,63,215572
29162,0.002312,172.31.40.0-255,66,176296,63,215572
29163,0.004663,172.217.194.0-255,5738,182034,63,215572
29164,0.004673,172.31.40.0-255,66,182100,63,215572
29165,0.007104,172.217.194.0-255,4320,186420,63,215572
29166,0.007117,172.31.40.0-255,66,186486,63,215572
29167,0.007133,172.217.194.0-255,1484,187970,63,215572
29168,0.009513,172.217.194.0-255,4320,192290,63,215572
29169,0.009522,172.31.40.0-255,66,192356,63,215572
29170,0.011901,172.217.194.0-255,5738,198094,63,215572
29171,0.011912,172.31.40.0-255,66,198160,63,215572
29172,0.014281,172.217.194.0-255,5738,203898,63,215572
29173,0.014298,172.31.40.0-255,66,203964,63,215572
29174,0.016688,172.217.194.0-255,5738,209702,63,215572
29175,0.0167,172.31.40.0-255,66,209768,63,215572
29176,0.019198,172.217.194.0-255,5738,215506,63,215572
29177,0.019209,172.31.40.0-255,66,215572,63,215572
29178,0.0,74.125.24.0-255,152,152,63,204406
29179,2.4e-05,172.31.40.0-255,66,218,63,204406
29180,3.1e-05,74.125.24.0-255,1484,1702,63,204406
29181,3.6e-05,172.31.40.0-255,66,1768,63,204406
29182,5e-05,74.125.24.0-255,2902,4670,63,204406
29183,5.3e-05,172.31.40.0-255,66,4736,63,204406
29184,5.9e-05,74.125.24.0-255,4320,9056,63,204406
29185,6.2e-05,172.31.40.0-255,66,9122,63,204406
29186,6.8e-05,74.125.24.0-255,4868,13990,63,204406
29187,7.1e-05,172.31.40.0-255,66,14056,63,204406
29188,0.000182,74.125.24.0-255,1484,15540,63,204406
29189,0.000185,172.31.40.0-255,66,15606,63,204406
29190,0.000191,74.125.24.0-255,2902,18508,63,204406
29191,0.000193,172.31.40.0-255,66,18574,63,204406
29192,0.0002,74.125.24.0-255,5738,24312,63,204406
29193,0.000202,172.31.40.0-255,66,24378,63,204406
29194,0.000238,74.125.24.0-255,4320,28698,63,204406
29195,0.000241,172.31.40.0-255,66,28764,63,204406
29196,0.000275,172.31.40.0-255,66,28830,63,204406
29197,0.000289,172.31.40.0-255,66,28896,63,204406
29198,0.000295,74.125.24.0-255,4320,33216,63,204406
29199,0.0003,172.31.40.0-255,66,33282,63,204406
29200,0.00033,172.31.40.0-255,66,33348,63,204406
29201,0.000333,74.125.24.0-255,708,34056,63,204406
29202,0.000337,172.31.40.0-255,66,34122,63,204406
29203,0.000669,74.125.24.0-255,1484,35606,63,204406
29204,0.000675,172.31.40.0-255,66,35672,63,204406
29205,0.000681,74.125.24.0-255,2902,38574,63,204406
29206,0.000684,172.31.40.0-255,66,38640,63,204406
29207,0.000696,74.125.24.0-255,5738,44378,63,204406
29208,0.000698,172.31.40.0-255,66,44444,63,204406
29209,0.000703,74.125.24.0-255,4320,48764,63,204406
29210,0.000706,172.31.40.0-255,66,48830,63,204406
29211,0.00075,172.31.40.0-255,66,48896,63,204406
29212,0.000787,74.125.24.0-255,7156,56052,63,204406
29213,0.000789,172.31.40.0-255,66,56118,63,204406
29214,0.000813,74.125.24.0-255,766,56884,63,204406
29215,0.000868,74.125.24.0-255,1484,58368,63,204406
29216,0.000872,172.31.40.0-255,66,58434,63,204406
29217,0.000877,74.125.24.0-255,2902,61336,63,204406
29218,0.000879,172.31.40.0-255,66,61402,63,204406
29219,0.000899,74.125.24.0-255,5738,67140,63,204406
29220,0.000905,172.31.40.0-255,66,67206,63,204406
29221,0.000908,74.125.24.0-255,1484,68690,63,204406
29222,0.000925,74.125.24.0-255,1484,70174,63,204406
29223,0.000928,172.31.40.0-255,66,70240,63,204406
29224,0.000957,74.125.24.0-255,7156,77396,63,204406
29225,0.00096,172.31.40.0-255,66,77462,63,204406
29226,0.000967,74.125.24.0-255,5738,83200,63,204406
29227,0.000968,172.31.40.0-255,66,83266,63,204406
29228,0.001017,172.31.40.0-255,66,83332,63,204406
29229,0.001021,74.125.24.0-255,1484,84816,63,204406
29230,0.001027,74.125.24.0-255,2902,87718,63,204406
29231,0.00103,172.31.40.0-255,66,87784,63,204406
29232,0.001036,74.125.24.0-255,5738,93522,63,204406
29233,0.001038,172.31.40.0-255,66,93588,63,204406
29234,0.001068,74.125.24.0-255,7156,100744,63,204406
29235,0.001071,172.31.40.0-255,66,100810,63,204406
29236,0.001074,74.125.24.0-255,1484,102294,63,204406
29237,0.001107,74.125.24.0-255,7156,109450,63,204406
29238,0.00111,172.31.40.0-255,66,109516,63,204406
29239,0.001116,74.125.24.0-255,4320,113836,63,204406
29240,0.001118,172.31.40.0-255,66,113902,63,204406
29241,0.001149,74.125.24.0-255,3602,117504,63,204406
29242,0.001152,172.31.40.0-255,66,117570,63,204406
29243,0.001159,74.125.24.0-255,7156,124726,63,204406
29244,0.001161,172.31.40.0-255,66,124792,63,204406
29245,0.00119,74.125.24.0-255,1484,126276,63,204406
29246,0.001197,74.125.24.0-255,5738,132014,63,204406
29247,0.0012,172.31.40.0-255,66,132080,63,204406
29248,0.001215,172.31.40.0-255,66,132146,63,204406
29249,0.001221,74.125.24.0-255,3602,135748,63,204406
29250,0.001224,172.31.40.0-255,66,135814,63,204406
29251,0.001361,74.125.24.0-255,1484,137298,63,204406
29252,0.001368,74.125.24.0-255,2902,140200,63,204406
29253,0.001371,172.31.40.0-255,66,140266,63,204406
29254,0.00139,74.125.24.0-255,5738,146004,63,204406
29255,0.001393,172.31.40.0-255,66,146070,63,204406
29256,0.001423,172.31.40.0-255,66,146136,63,204406
29257,0.001427,74.125.24.0-255,2902,149038,63,204406
29258,0.001429,172.31.40.0-255,66,149104,63,204406
29259,0.001457,74.125.24.0-255,7156,156260,63,204406
29260,0.00146,172.31.40.0-255,66,156326,63,204406
29261,0.001543,172.31.40.0-255,66,156392,63,204406
29262,0.001555,172.31.40.0-255,66,156458,63,204406
29263,0.001674,74.125.24.0-255,1484,157942,63,204406
29264,0.001699,74.125.24.0-255,2902,160844,63,204406
29265,0.001704,172.31.40.0-255,66,160910,63,204406
29266,0.001725,74.125.24.0-255,5738,166648,63,204406
29267,0.001728,172.31.40.0-255,66,166714,63,204406
29268,0.001733,74.125.24.0-255,4320,171034,63,204406
29269,0.001736,172.31.40.0-255,66,171100,63,204406
29270,0.001808,172.31.40.0-255,66,171166,63,204406
29271,0.001819,172.31.40.0-255,66,171232,63,204406
29272,0.001868,74.125.24.0-255,1484,172716,63,204406
29273,0.001874,74.125.24.0-255,2902,175618,63,204406
29274,0.001877,172.31.40.0-255,66,175684,63,204406
29275,0.00188,74.125.24.0-255,1484,177168,63,204406
29276,0.001898,74.125.24.0-255,4320,181488,63,204406
29277,0.001901,172.31.40.0-255,66,181554,63,204406
29278,0.00194,172.31.40.0-255,66,181620,63,204406
29279,0.001951,172.31.40.0-255,66,181686,63,204406
29280,0.001983,74.125.24.0-255,3602,185288,63,204406
29281,0.001986,172.31.40.0-255,66,185354,63,204406
29282,0.001999,172.31.40.0-255,66,185420,63,204406
29283,0.002021,172.31.40.0-255,66,185486,63,204406
29284,0.002024,74.125.24.0-255,1484,186970,63,204406
29285,0.002071,172.31.40.0-255,66,187036,63,204406
29286,0.002077,74.125.24.0-255,7156,194192,63,204406
29287,0.00208,172.31.40.0-255,66,194258,63,204406
29288,0.002116,74.125.24.0-255,6438,200696,63,204406
29289,0.002119,172.31.40.0-255,66,200762,63,204406
29290,0.002145,74.125.24.0-255,3236,203998,63,204406
29291,0.002147,172.31.40.0-255,66,204064,63,204406
29292,0.002174,74.125.24.0-255,105,204169,63,204406
29293,0.007861,172.31.40.0-255,66,204235,63,204406
29294,0.007901,172.31.40.0-255,105,204340,63,204406
29295,0.010117,74.125.24.0-255,66,204406,63,204406
29296,0.0,172.217.194.0-255,150,150,63,91423
29297,3.1e-05,172.31.40.0-255,66,216,63,91423
29298,3.8e-05,172.217.194.0-255,1484,1700,63,91423
29299,4.2e-05,172.31.40.0-255,66,1766,63,91423
29300,4.9e-05,172.217.194.0-255,2902,4668,63,91423
29301,5.3e-05,172.31.40.0-255,66,4734,63,91423
29302,5.8e-05,172.217.194.0-255,4320,9054,63,91423
29303,6.2e-05,172.31.40.0-255,66,9120,63,91423
29304,8.7e-05,172.217.194.0-255,4818,13938,63,91423
29305,9e-05,172.31.40.0-255,66,14004,63,91423
29306,0.000169,172.217.194.0-255,1484,15488,63,91423
29307,0.000172,172.31.40.0-255,66,15554,63,91423
29308,0.000177,172.217.194.0-255,2902,18456,63,91423
29309,0.000179,172.31.40.0-255,66,18522,63,91423
29310,0.000198,172.217.194.0-255,5738,24260,63,91423
29311,0.0002,172.31.40.0-255,66,24326,63,91423
29312,0.000241,172.217.194.0-255,7156,31482,63,91423
29313,0.000243,172.31.40.0-255,66,31548,63,91423
29314,0.000266,172.217.194.0-255,5379,36927,63,91423
29315,0.00027,172.31.40.0-255,66,36993,63,91423
29316,0.000324,172.217.194.0-255,7156,44149,63,91423
29317,0.000328,172.31.40.0-255,66,44215,63,91423
29318,0.00035,172.217.194.0-255,5738,49953,63,91423
29319,0.000353,172.31.40.0-255,66,50019,63,91423
29320,0.00039,172.217.194.0-255,1484,51503,63,91423
29321,0.000393,172.31.40.0-255,66,51569,63,91423
29322,0.000427,172.31.40.0-255,66,51635,63,91423
29323,0.000502,172.217.194.0-255,4320,55955,63,91423
29324,0.000505,172.31.40.0-255,66,56021,63,91423
29325,0.000538,172.31.40.0-255,66,56087,63,91423
29326,0.000597,172.217.194.0-255,5738,61825,63,91423
29327,0.000638,172.31.40.0-255,66,61891,63,91423
29328,0.000746,172.31.40.0-255,66,61957,63,91423
29329,0.000784,172.31.40.0-255,66,62023,63,91423
29330,0.000858,172.31.40.0-255,66,62089,63,91423
29331,0.00102,172.31.40.0-255,66,62155,63,91423
29332,0.001026,172.217.194.0-255,5738,67893,63,91423
29333,0.001038,172.31.40.0-255,66,67959,63,91423
29334,0.001043,172.217.194.0-255,4320,72279,63,91423
29335,0.001072,172.31.40.0-255,66,72345,63,91423
29336,0.00119,172.217.194.0-255,7156,79501,63,91423
29337,0.001223,172.31.40.0-255,66,79567,63,91423
29338,0.001229,172.31.40.0-255,66,79633,63,91423
29339,0.00124,172.217.194.0-255,1466,81099,63,91423
29340,0.001432,172.31.40.0-255,66,81165,63,91423
29341,0.001464,172.31.40.0-255,66,81231,63,91423
29342,0.001656,172.31.40.0-255,66,81297,63,91423
29343,0.001716,172.31.40.0-255,66,81363,63,91423
29344,0.001875,172.217.194.0-255,2902,84265,63,91423
29345,0.001879,172.31.40.0-255,66,84331,63,91423
29346,0.00193,172.31.40.0-255,66,84397,63,91423
29347,0.002021,172.31.40.0-255,66,84463,63,91423
29348,0.002325,172.217.194.0-255,2902,87365,63,91423
29349,0.00233,172.31.40.0-255,66,87431,63,91423
29350,0.002386,172.31.40.0-255,66,87497,63,91423
29351,0.002424,172.31.40.0-255,66,87563,63,91423
29352,0.002467,172.31.40.0-255,66,87629,63,91423
29353,0.002779,172.217.194.0-255,3557,91186,63,91423
29354,0.002786,172.31.40.0-255,66,91252,63,91423
29355,0.004346,172.31.40.0-255,105,91357,63,91423
29356,0.006241,172.217.194.0-255,66,91423,63,91423
29357,0.0,74.125.68.0-255,150,150,63,287478
29358,1.5e-05,172.31.40.0-255,66,216,63,287478
29359,2.1e-05,74.125.68.0-255,1484,1700,63,287478
29360,2.5e-05,172.31.40.0-255,66,1766,63,287478
29361,3e-05,74.125.68.0-255,2902,4668,63,287478
29362,3.3e-05,172.31.40.0-255,66,4734,63,287478
29363,3.6e-05,74.125.68.0-255,2902,7636,63,287478
29364,3.9e-05,172.31.40.0-255,66,7702,63,287478
29365,6.1e-05,74.125.68.0-255,4320,12022,63,287478
29366,6.4e-05,172.31.40.0-255,66,12088,63,287478
29367,0.000107,172.31.40.0-255,66,12154,63,287478
29368,0.000109,74.125.68.0-255,1484,13638,63,287478
29369,0.000111,172.31.40.0-255,66,13704,63,287478
29370,0.000131,172.31.40.0-255,66,13770,63,287478
29371,0.000321,74.125.68.0-255,1484,15254,63,287478
29372,0.000325,172.31.40.0-255,66,15320,63,287478
29373,0.000331,74.125.68.0-255,2902,18222,63,287478
29374,0.000333,172.31.40.0-255,66,18288,63,287478
29375,0.000336,74.125.68.0-255,1484,19772,63,287478
29376,0.000337,172.31.40.0-255,66,19838,63,287478
29377,0.000358,74.125.68.0-255,2902,22740,63,287478
29378,0.00036,172.31.40.0-255,66,22806,63,287478
29379,0.000366,74.125.68.0-255,5738,28544,63,287478
29380,0.000368,172.31.40.0-255,66,28610,63,287478
29381,0.000389,74.125.68.0-255,1484,30094,63,287478
29382,0.000391,172.31.40.0-255,66,30160,63,287478
29383,0.000408,74.125.68.0-255,3961,34121,63,287478
29384,0.00041,172.31.40.0-255,66,34187,63,287478
29385,0.000427,74.125.68.0-255,4320,38507,63,287478
29386,0.00043,172.31.40.0-255,66,38573,63,287478
29387,0.000449,74.125.68.0-255,1484,40057,63,287478
29388,0.000459,172.31.40.0-255,66,40123,63,287478
29389,0.000475,74.125.68.0-255,134,40257,63,287478
29390,0.000558,74.125.68.0-255,1484,41741,63,287478
29391,0.000561,172.31.40.0-255,66,41807,63,287478
29392,0.000566,74.125.68.0-255,2902,44709,63,287478
29393,0.000569,172.31.40.0-255,66,44775,63,287478
29394,0.000591,74.125.68.0-255,5738,50513,63,287478
29395,0.000593,172.31.40.0-255,66,50579,63,287478
29396,0.000597,74.125.68.0-255,2902,53481,63,287478
29397,0.000598,172.31.40.0-255,66,53547,63,287478
29398,0.000613,74.125.68.0-255,1484,55031,63,287478
29399,0.000627,74.125.68.0-255,2902,57933,63,287478
29400,0.000629,172.31.40.0-255,66,57999,63,287478
29401,0.000635,74.125.68.0-255,5738,63737,63,287478
29402,0.000637,172.31.40.0-255,66,63803,63,287478
29403,0.000655,74.125.68.0-255,2902,66705,63,287478
29404,0.000657,172.31.40.0-255,66,66771,63,287478
29405,0.000662,74.125.68.0-255,4320,71091,63,287478
29406,0.000664,172.31.40.0-255,66,71157,63,287478
29407,0.000705,74.125.68.0-255,3883,75040,63,287478
29408,0.000709,172.31.40.0-255,66,75106,63,287478
29409,0.000801,74.125.68.0-255,1484,76590,63,287478
29410,0.000823,74.125.68.0-255,2902,79492,63,287478
29411,0.000827,172.31.40.0-255,66,79558,63,287478
29412,0.000857,74.125.68.0-255,2902,82460,63,287478
29413,0.00086,172.31.40.0-255,66,82526,63,287478
29414,0.000881,74.125.68.0-255,2902,85428,63,287478
29415,0.000883,172.31.40.0-255,66,85494,63,287478
29416,0.000889,74.125.68.0-255,5738,91232,63,287478
29417,0.000891,172.31.40.0-255,66,91298,63,287478
29418,0.000896,74.125.68.0-255,7156,98454,63,287478
29419,0.000899,172.31.40.0-255,66,98520,63,287478
29420,0.000927,172.31.40.0-255,66,98586,63,287478
29421,0.000969,74.125.68.0-255,1484,100070,63,287478
29422,0.000984,74.125.68.0-255,2902,102972,63,287478
29423,0.000987,172.31.40.0-255,66,103038,63,287478
29424,0.001002,74.125.68.0-255,2902,105940,63,287478
29425,0.001004,172.31.40.0-255,66,106006,63,287478
29426,0.001029,74.125.68.0-255,4320,110326,63,287478
29427,0.001032,172.31.40.0-255,66,110392,63,287478
29428,0.001035,74.125.68.0-255,1484,111876,63,287478
29429,0.001048,74.125.68.0-255,4320,116196,63,287478
29430,0.00105,172.31.40.0-255,66,116262,63,287478
29431,0.001062,74.125.68.0-255,2902,119164,63,287478
29432,0.001065,172.31.40.0-255,66,119230,63,287478
29433,0.00107,74.125.68.0-255,4320,123550,63,287478
29434,0.001072,172.31.40.0-255,66,123616,63,287478
29435,0.001077,74.125.68.0-255,5738,129354,63,287478
29436,0.001079,172.31.40.0-255,66,129420,63,287478
29437,0.001102,74.125.68.0-255,3602,133022,63,287478
29438,0.001107,172.31.40.0-255,66,133088,63,287478
29439,0.001502,74.125.68.0-255,1484,134572,63,287478
29440,0.001507,74.125.68.0-255,1484,136056,63,287478
29441,0.001509,172.31.40.0-255,66,136122,63,287478
29442,0.001527,74.125.68.0-255,2902,139024,63,287478
29443,0.001529,172.31.40.0-255,66,139090,63,287478
29444,0.001552,74.125.68.0-255,5738,144828,63,287478
29445,0.001554,172.31.40.0-255,66,144894,63,287478
29446,0.001584,172.31.40.0-255,66,144960,63,287478
29447,0.001593,74.125.68.0-255,4320,149280,63,287478
29448,0.001595,172.31.40.0-255,66,149346,63,287478
29449,0.001611,74.125.68.0-255,5738,155084,63,287478
29450,0.001612,172.31.40.0-255,66,155150,63,287478
29451,0.001628,74.125.68.0-255,3602,158752,63,287478
29452,0.00163,172.31.40.0-255,66,158818,63,287478
29453,0.001791,74.125.68.0-255,1484,160302,63,287478
29454,0.001809,74.125.68.0-255,2902,163204,63,287478
29455,0.001812,172.31.40.0-255,66,163270,63,287478
29456,0.001816,74.125.68.0-255,2902,166172,63,287478
29457,0.001818,172.31.40.0-255,66,166238,63,287478
29458,0.001828,74.125.68.0-255,1484,167722,63,287478
29459,0.001844,74.125.68.0-255,2902,170624,63,287478
29460,0.001852,172.31.40.0-255,66,170690,63,287478
29461,0.001877,172.31.40.0-255,66,170756,63,287478
29462,0.001882,74.125.68.0-255,4320,175076,63,287478
29463,0.001884,172.31.40.0-255,66,175142,63,287478
29464,0.00189,74.125.68.0-255,5738,180880,63,287478
29465,0.001891,172.31.40.0-255,66,180946,63,287478
29466,0.001917,74.125.68.0-255,3602,184548,63,287478
29467,0.00192,172.31.40.0-255,66,184614,63,287478
29468,0.002036,74.125.68.0-255,1484,186098,63,287478
29469,0.002051,74.125.68.0-255,2902,189000,63,287478
29470,0.002054,172.31.40.0-255,66,189066,63,287478
29471,0.002078,74.125.68.0-255,4320,193386,63,287478
29472,0.00208,172.31.40.0-255,66,193452,63,287478
29473,0.002084,74.125.68.0-255,2902,196354,63,287478
29474,0.002086,172.31.40.0-255,66,196420,63,287478
29475,0.002106,74.125.68.0-255,2902,199322,63,287478
29476,0.002108,172.31.40.0-255,66,199388,63,287478
29477,0.002113,74.125.68.0-255,4320,203708,63,287478
29478,0.002114,172.31.40.0-255,66,203774,63,287478
29479,0.002146,74.125.68.0-255,7156,210930,63,287478
29480,0.002149,172.31.40.0-255,66,210996,63,287478
29481,0.002154,74.125.68.0-255,4320,215316,63,287478
29482,0.002156,172.31.40.0-255,66,215382,63,287478
29483,0.002179,74.125.68.0-255,3602,218984,63,287478
29484,0.002181,172.31.40.0-255,66,219050,63,287478
29485,0.002206,74.125.68.0-255,4320,223370,63,287478
29486,0.002208,172.31.40.0-255,66,223436,63,287478
29487,0.002225,74.125.68.0-255,4320,227756,63,287478
29488,0.002227,172.31.40.0-255,66,227822,63,287478
29489,0.002243,74.125.68.0-255,5738,233560,63,287478
29490,0.002245,172.31.40.0-255,66,233626,63,287478
29491,0.00225,74.125.68.0-255,4320,237946,63,287478
29492,0.002252,172.31.40.0-255,66,238012,63,287478
29493,0.00232,74.125.68.0-255,1484,239496,63,287478
29494,0.002352,74.125.68.0-255,7156,246652,63,287478
29495,0.002357,172.31.40.0-255,66,246718,63,287478
29496,0.00236,172.31.40.0-255,66,246784,63,287478
29497,0.004651,74.125.68.0-255,5738,252522,63,287478
29498,0.004658,172.31.40.0-255,66,252588,63,287478
29499,0.00692,74.125.68.0-255,1484,254072,63,287478
29500,0.006937,74.125.68.0-255,4320,258392,63,287478
29501,0.006939,172.31.40.0-255,66,258458,63,287478
29502,0.009216,74.125.68.0-255,5738,264196,63,287478
29503,0.009223,172.31.40.0-255,66,264262,63,287478
29504,0.011501,74.125.68.0-255,5738,270000,63,287478
29505,0.011508,172.31.40.0-255,66,270066,63,287478
29506,0.013779,74.125.68.0-255,5738,275804,63,287478
29507,0.013785,172.31.40.0-255,66,275870,63,287478
29508,0.01607,74.125.68.0-255,5738,281608,63,287478
29509,0.01608,172.31.40.0-255,66,281674,63,287478
29510,0.018359,74.125.68.0-255,5738,287412,63,287478
29511,0.018368,172.31.40.0-255,66,287478,63,287478
29512,0.0,172.217.24.0-255,153,153,63,161251
29513,2.3e-05,172.31.40.0-255,66,219,63,161251
29514,3e-05,172.217.24.0-255,1484,1703,63,161251
29515,3.4e-05,172.31.40.0-255,66,1769,63,161251
29516,4e-05,172.217.24.0-255,2902,4671,63,161251
29517,4.4e-05,172.31.40.0-255,66,4737,63,161251
29518,4.7e-05,172.217.24.0-255,1484,6221,63,161251
29519,5e-05,172.31.40.0-255,66,6287,63,161251
29520,5.5e-05,172.217.24.0-255,2902,9189,63,161251
29521,5.8e-05,172.31.40.0-255,66,9255,63,161251
29522,8.6e-05,172.217.24.0-255,4945,14200,63,161251
29523,8.9e-05,172.31.40.0-255,66,14266,63,161251
29524,0.000144,172.217.24.0-255,1484,15750,63,161251
29525,0.000146,172.31.40.0-255,66,15816,63,161251
29526,0.000151,172.217.24.0-255,2902,18718,63,161251
29527,0.000153,172.31.40.0-255,66,18784,63,161251
29528,0.000165,172.217.24.0-255,1484,20268,63,161251
29529,0.000168,172.31.40.0-255,66,20334,63,161251
29530,0.000199,172.217.24.0-255,2902,23236,63,161251
29531,0.000201,172.31.40.0-255,66,23302,63,161251
29532,0.000205,172.217.24.0-255,2902,26204,63,161251
29533,0.000207,172.31.40.0-255,66,26270,63,161251
29534,0.000213,172.217.24.0-255,4320,30590,63,161251
29535,0.000216,172.31.40.0-255,66,30656,63,161251
29536,0.000218,172.217.24.0-255,1125,31781,63,161251
29537,0.00022,172.31.40.0-255,66,31847,63,161251
29538,0.000333,172.217.24.0-255,1484,33331,63,161251
29539,0.000338,172.31.40.0-255,66,33397,63,161251
29540,0.000343,172.217.24.0-255,2902,36299,63,161251
29541,0.000345,172.31.40.0-255,66,36365,63,161251
29542,0.000352,172.217.24.0-255,5738,42103,63,161251
29543,0.000355,172.31.40.0-255,66,42169,63,161251
29544,0.00038,172.217.24.0-255,1484,43653,63,161251
29545,0.000401,172.217.24.0-255,5379,49032,63,161251
29546,0.000404,172.31.40.0-255,66,49098,63,161251
29547,0.000439,172.217.24.0-255,5738,54836,63,161251
29548,0.000442,172.31.40.0-255,66,54902,63,161251
29549,0.000445,172.217.24.0-255,1484,56386,63,161251
29550,0.00047,172.217.24.0-255,5738,62124,63,161251
29551,0.000472,172.31.40.0-255,66,62190,63,161251
29552,0.000493,172.217.24.0-255,3961,66151,63,161251
29553,0.000496,172.31.40.0-255,66,66217,63,161251
29554,0.000707,172.217.24.0-255,364,66581,63,161251
29555,0.001091,172.217.24.0-255,380,66961,63,161251
29556,0.001125,172.31.40.0-255,66,67027,63,161251
29557,0.00124,172.217.24.0-255,1484,68511,63,161251
29558,0.001248,172.217.24.0-255,2902,71413,63,161251
29559,0.001251,172.31.40.0-255,66,71479,63,161251
29560,0.001255,172.217.24.0-255,1484,72963,63,161251
29561,0.001273,172.217.24.0-255,2902,75865,63,161251
29562,0.001275,172.31.40.0-255,66,75931,63,161251
29563,0.001282,172.217.24.0-255,4320,80251,63,161251
29564,0.001285,172.31.40.0-255,66,80317,63,161251
29565,0.001313,172.217.24.0-255,5379,85696,63,161251
29566,0.001315,172.31.40.0-255,66,85762,63,161251
29567,0.001326,172.31.40.0-255,66,85828,63,161251
29568,0.001375,172.217.24.0-255,6797,92625,63,161251
29569,0.001378,172.31.40.0-255,66,92691,63,161251
29570,0.001917,172.217.24.0-255,1484,94175,63,161251
29571,0.001926,172.217.24.0-255,2902,97077,63,161251
29572,0.001931,172.31.40.0-255,66,97143,63,161251
29573,0.001938,172.217.24.0-255,5738,102881,63,161251
29574,0.00194,172.31.40.0-255,66,102947,63,161251
29575,0.001964,172.217.24.0-255,2902,105849,63,161251
29576,0.001967,172.31.40.0-255,66,105915,63,161251
29577,0.001988,172.217.24.0-255,4320,110235,63,161251
29578,0.00199,172.31.40.0-255,66,110301,63,161251
29579,0.003885,172.217.24.0-255,1484,111785,63,161251
29580,0.003907,172.217.24.0-255,2902,114687,63,161251
29581,0.003912,172.31.40.0-255,66,114753,63,161251
29582,0.003927,172.217.24.0-255,1484,116237,63,161251
29583,0.005844,172.217.24.0-255,4320,120557,63,161251
29584,0.005848,172.31.40.0-255,66,120623,63,161251
29585,0.007774,172.217.24.0-255,5738,126361,63,161251
29586,0.007781,172.31.40.0-255,66,126427,63,161251
29587,0.00971,172.217.24.0-255,5738,132165,63,161251
29588,0.009718,172.31.40.0-255,66,132231,63,161251
29589,0.011653,172.217.24.0-255,5738,137969,63,161251
29590,0.011661,172.31.40.0-255,66,138035,63,161251
29591,0.013585,172.217.24.0-255,5738,143773,63,161251
29592,0.013592,172.31.40.0-255,66,143839,63,161251
29593,0.015521,172.217.24.0-255,5738,149577,63,161251
29594,0.015528,172.31.40.0-255,66,149643,63,161251
29595,0.017457,172.217.24.0-255,5738,155381,63,161251
29596,0.017466,172.31.40.0-255,66,155447,63,161251
29597,0.019405,172.217.24.0-255,5738,161185,63,161251
29598,0.019415,172.31.40.0-255,66,161251,63,161251
29599,0.0,172.217.194.0-255,150,150,63,209566
29600,2.2e-05,172.31.40.0-255,66,216,63,209566
29601,2.9e-05,172.217.194.0-255,1484,1700,63,209566
29602,3.3e-05,172.31.40.0-255,66,1766,63,209566
29603,3.9e-05,172.217.194.0-255,2902,4668,63,209566
29604,4.1e-05,172.31.40.0-255,66,4734,63,209566
29605,4.9e-05,172.217.194.0-255,7156,11890,63,209566
29606,5.2e-05,172.31.40.0-255,66,11956,63,209566
29607,8.6e-05,172.31.40.0-255,66,12022,63,209566
29608,0.000111,172.217.194.0-255,4320,16342,63,209566
29609,0.000113,172.31.40.0-255,66,16408,63,209566
29610,0.000132,172.217.194.0-255,1125,17533,63,209566
29611,0.000134,172.31.40.0-255,66,17599,63,209566
29612,0.00014,172.217.194.0-255,5738,23337,63,209566
29613,0.000143,172.31.40.0-255,66,23403,63,209566
29614,0.000171,172.217.194.0-255,7156,30559,63,209566
29615,0.000174,172.31.40.0-255,66,30625,63,209566
29616,0.000187,172.217.194.0-255,3961,34586,63,209566
29617,0.00019,172.31.40.0-255,66,34652,63,209566
29618,0.00027,172.217.194.0-255,1484,36136,63,209566
29619,0.000273,172.31.40.0-255,66,36202,63,209566
29620,0.000287,172.217.194.0-255,2902,39104,63,209566
29621,0.000289,172.31.40.0-255,66,39170,63,209566
29622,0.000295,172.217.194.0-255,5738,44908,63,209566
29623,0.000299,172.31.40.0-255,66,44974,63,209566
29624,0.00033,172.217.194.0-255,6797,51771,63,209566
29625,0.000333,172.31.40.0-255,66,51837,63,209566
29626,0.000351,172.217.194.0-255,1484,53321,63,209566
29627,0.000353,172.31.40.0-255,66,53387,63,209566
29628,0.000372,172.217.194.0-255,5738,59125,63,209566
29629,0.000375,172.31.40.0-255,66,59191,63,209566
29630,0.000381,172.217.194.0-255,5738,64929,63,209566
29631,0.000383,172.31.40.0-255,66,64995,63,209566
29632,0.000401,172.217.194.0-255,2902,67897,63,209566
29633,0.000404,172.31.40.0-255,66,67963,63,209566
29634,0.000416,172.217.194.0-255,1705,69668,63,209566
29635,0.000419,172.31.40.0-255,66,69734,63,209566
29636,0.00045,172.217.194.0-255,2902,72636,63,209566
29637,0.000453,172.31.40.0-255,66,72702,63,209566
29638,0.000478,172.217.194.0-255,7156,79858,63,209566
29639,0.000481,172.31.40.0-255,66,79924,63,209566
29640,0.000484,172.217.194.0-255,1484,81408,63,209566
29641,0.000497,172.217.194.0-255,1484,82892,63,209566
29642,0.000499,172.31.40.0-255,66,82958,63,209566
29643,0.00053,172.31.40.0-255,66,83024,63,209566
29644,0.000536,172.217.194.0-255,4320,87344,63,209566
29645,0.000539,172.31.40.0-255,66,87410,63,209566
29646,0.000557,172.217.194.0-255,3070,90480,63,209566
29647,0.00056,172.31.40.0-255,66,90546,63,209566
29648,0.000602,172.217.194.0-255,1484,92030,63,209566
29649,0.000607,172.217.194.0-255,2902,94932,63,209566
29650,0.000609,172.31.40.0-255,66,94998,63,209566
29651,0.000624,172.217.194.0-255,5738,100736,63,209566
29652,0.000627,172.31.40.0-255,66,100802,63,209566
29653,0.00067,172.31.40.0-255,66,100868,63,209566
29654,0.000675,172.217.194.0-255,2902,103770,63,209566
29655,0.000677,172.31.40.0-255,66,103836,63,209566
29656,0.000711,172.31.40.0-255,66,103902,63,209566
29657,0.000856,172.217.194.0-255,1484,105386,63,209566
29658,0.000862,172.217.194.0-255,2902,108288,63,209566
29659,0.000866,172.31.40.0-255,66,108354,63,209566
29660,0.000871,172.217.194.0-255,2902,111256,63,209566
29661,0.000873,172.31.40.0-255,66,111322,63,209566
29662,0.000895,172.217.194.0-255,2902,114224,63,209566
29663,0.000898,172.31.40.0-255,66,114290,63,209566
29664,0.000923,172.217.194.0-255,7156,121446,63,209566
29665,0.000927,172.31.40.0-255,66,121512,63,209566
29666,0.000949,172.217.194.0-255,5738,127250,63,209566
29667,0.000953,172.31.40.0-255,66,127316,63,209566
29668,0.000966,172.31.40.0-255,66,127382,63,209566
29669,0.001033,172.217.194.0-255,1484,128866,63,209566
29670,0.001038,172.217.194.0-255,2902,131768,63,209566
29671,0.001041,172.31.40.0-255,66,131834,63,209566
29672,0.001047,172.217.194.0-255,5738,137572,63,209566
29673,0.00105,172.31.40.0-255,66,137638,63,209566
29674,0.001055,172.217.194.0-255,4320,141958,63,209566
29675,0.001057,172.31.40.0-255,66,142024,63,209566
29676,0.001069,172.31.40.0-255,66,142090,63,209566
29677,0.001107,172.31.40.0-255,66,142156,63,209566
29678,0.001136,172.217.194.0-255,1484,143640,63,209566
29679,0.00114,172.217.194.0-255,1484,145124,63,209566
29680,0.001142,172.31.40.0-255,66,145190,63,209566
29681,0.00116,172.217.194.0-255,1484,146674,63,209566
29682,0.001167,172.217.194.0-255,5738,152412,63,209566
29683,0.001169,172.31.40.0-255,66,152478,63,209566
29684,0.001172,172.217.194.0-255,1484,153962,63,209566
29685,0.001203,172.217.194.0-255,5738,159700,63,209566
29686,0.001206,172.31.40.0-255,66,159766,63,209566
29687,0.001211,172.217.194.0-255,2902,162668,63,209566
29688,0.001213,172.31.40.0-255,66,162734,63,209566
29689,0.001248,172.217.194.0-255,2184,164918,63,209566
29690,0.001252,172.31.40.0-255,66,164984,63,209566
29691,0.001265,172.31.40.0-255,66,165050,63,209566
29692,0.001298,172.31.40.0-255,66,165116,63,209566
29693,0.001327,172.217.194.0-255,4320,169436,63,209566
29694,0.00133,172.31.40.0-255,66,169502,63,209566
29695,0.001345,172.31.40.0-255,66,169568,63,209566
29696,0.001352,172.217.194.0-255,6438,176006,63,209566
29697,0.00137,172.31.40.0-255,66,176072,63,209566
29698,0.001498,172.217.194.0-255,1484,177556,63,209566
29699,0.001505,172.217.194.0-255,2902,180458,63,209566
29700,0.001508,172.31.40.0-255,66,180524,63,209566
29701,0.001529,172.217.194.0-255,5738,186262,63,209566
29702,0.001532,172.31.40.0-255,66,186328,63,209566
29703,0.001562,172.217.194.0-255,5738,192066,63,209566
29704,0.001564,172.31.40.0-255,66,192132,63,209566
29705,0.001584,172.217.194.0-255,4320,196452,63,209566
29706,0.001586,172.31.40.0-255,66,196518,63,209566
29707,0.001626,172.31.40.0-255,66,196584,63,209566
29708,0.001653,172.217.194.0-255,3602,200186,63,209566
29709,0.001656,172.31.40.0-255,66,200252,63,209566
29710,0.001671,172.31.40.0-255,66,200318,63,209566
29711,0.001682,172.31.40.0-255,66,200384,63,209566
29712,0.001694,172.217.194.0-255,1484,201868,63,209566
29713,0.001718,172.31.40.0-255,66,201934,63,209566
29714,0.001753,172.217.194.0-255,6438,208372,63,209566
29715,0.001756,172.31.40.0-255,66,208438,63,209566
29716,0.001771,172.31.40.0-255,66,208504,63,209566
29717,0.001785,172.31.40.0-255,66,208570,63,209566
29718,0.001855,172.31.40.0-255,66,208636,63,209566
29719,0.001858,172.217.194.0-255,105,208741,63,209566
29720,0.00186,172.217.194.0-255,129,208870,63,209566
29721,0.004453,172.31.40.0-255,105,208975,63,209566
29722,0.004484,172.31.40.0-255,105,209080,63,209566
29723,0.004685,172.31.40.0-255,90,209170,63,209566
29724,0.004694,172.31.40.0-255,66,209236,63,209566
29725,0.006688,172.217.194.0-255,66,209302,63,209566
29726,0.006711,172.217.194.0-255,66,209368,63,209566
29727,0.006939,172.217.194.0-255,66,209434,63,209566
29728,0.006971,172.217.194.0-255,66,209500,63,209566
29729,0.006977,172.31.40.0-255,66,209566,63,209566
29730,0.0,74.125.130.0-255,150,150,63,171716
29731,2.5e-05,172.31.40.0-255,66,216,63,171716
29732,3.2e-05,74.125.130.0-255,1484,1700,63,171716
29733,3.7e-05,172.31.40.0-255,66,1766,63,171716
29734,4.2e-05,74.125.130.0-255,2902,4668,63,171716
29735,4.5e-05,172.31.40.0-255,66,4734,63,171716
29736,5.2e-05,74.125.130.0-255,5738,10472,63,171716
29737,5.4e-05,172.31.40.0-255,66,10538,63,171716
29738,5.9e-05,74.125.130.0-255,2902,13440,63,171716
29739,6.2e-05,172.31.40.0-255,66,13506,63,171716
29740,8.4e-05,74.125.130.0-255,683,14189,63,171716
29741,8.6e-05,172.31.40.0-255,66,14255,63,171716
29742,0.000102,74.125.130.0-255,4320,18575,63,171716
29743,0.000105,172.31.40.0-255,66,18641,63,171716
29744,0.000107,74.125.130.0-255,1484,20125,63,171716
29745,0.000109,172.31.40.0-255,66,20191,63,171716
29746,0.000137,74.125.130.0-255,2902,23093,63,171716
29747,0.000139,172.31.40.0-255,66,23159,63,171716
29748,0.000142,74.125.130.0-255,1484,24643,63,171716
29749,0.000144,172.31.40.0-255,66,24709,63,171716
29750,0.000161,74.125.130.0-255,4320,29029,63,171716
29751,0.000163,172.31.40.0-255,66,29095,63,171716
29752,0.000177,74.125.130.0-255,1484,30579,63,171716
29753,0.000179,172.31.40.0-255,66,30645,63,171716
29754,0.000206,74.125.130.0-255,2902,33547,63,171716
29755,0.00021,74.125.130.0-255,2902,36449,63,171716
29756,0.000214,172.31.40.0-255,66,36515,63,171716
29757,0.000217,172.31.40.0-255,66,36581,63,171716
29758,0.000235,74.125.130.0-255,2902,39483,63,171716
29759,0.000237,172.31.40.0-255,66,39549,63,171716
29760,0.00024,74.125.130.0-255,1484,41033,63,171716
29761,0.000242,172.31.40.0-255,66,41099,63,171716
29762,0.000284,74.125.130.0-255,7156,48255,63,171716
29763,0.000287,172.31.40.0-255,66,48321,63,171716
29764,0.000289,74.125.130.0-255,766,49087,63,171716
29765,0.000485,74.125.130.0-255,1484,50571,63,171716
29766,0.00049,172.31.40.0-255,66,50637,63,171716
29767,0.000496,74.125.130.0-255,2902,53539,63,171716
29768,0.000499,172.31.40.0-255,66,53605,63,171716
29769,0.000522,74.125.130.0-255,4320,57925,63,171716
29770,0.000525,172.31.40.0-255,66,57991,63,171716
29771,0.000531,74.125.130.0-255,5738,63729,63,171716
29772,0.000533,172.31.40.0-255,66,63795,63,171716
29773,0.000578,74.125.130.0-255,2831,66626,63,171716
29774,0.000581,172.31.40.0-255,66,66692,63,171716
29775,0.000911,74.125.130.0-255,100,66792,63,171716
29776,0.000963,74.125.130.0-255,1484,68276,63,171716
29777,0.000967,172.31.40.0-255,66,68342,63,171716
29778,0.000971,74.125.130.0-255,1484,69826,63,171716
29779,0.000974,74.125.130.0-255,1484,71310,63,171716
29780,0.000976,172.31.40.0-255,66,71376,63,171716
29781,0.001001,74.125.130.0-255,1484,72860,63,171716
29782,0.001008,74.125.130.0-255,5738,78598,63,171716
29783,0.00101,172.31.40.0-255,66,78664,63,171716
29784,0.001066,74.125.130.0-255,7156,85820,63,171716
29785,0.00107,172.31.40.0-255,66,85886,63,171716
29786,0.001073,172.31.40.0-255,66,85952,63,171716
29787,0.001083,74.125.130.0-255,4320,90272,63,171716
29788,0.001085,172.31.40.0-255,66,90338,63,171716
29789,0.001087,74.125.130.0-255,766,91104,63,171716
29790,0.001427,74.125.130.0-255,1484,92588,63,171716
29791,0.001431,172.31.40.0-255,66,92654,63,171716
29792,0.001461,74.125.130.0-255,2902,95556,63,171716
29793,0.001463,172.31.40.0-255,66,95622,63,171716
29794,0.00147,74.125.130.0-255,5738,101360,63,171716
29795,0.001472,172.31.40.0-255,66,101426,63,171716
29796,0.001475,74.125.130.0-255,1484,102910,63,171716
29797,0.001498,172.31.40.0-255,66,102976,63,171716
29798,0.001542,172.31.40.0-255,66,103042,63,171716
29799,0.001547,74.125.130.0-255,2184,105226,63,171716
29800,0.001548,172.31.40.0-255,66,105292,63,171716
29801,0.001582,74.125.130.0-255,2902,108194,63,171716
29802,0.001585,172.31.40.0-255,66,108260,63,171716
29803,0.001593,74.125.130.0-255,7156,115416,63,171716
29804,0.001595,172.31.40.0-255,66,115482,63,171716
29805,0.00165,172.31.40.0-255,66,115548,63,171716
29806,0.001655,74.125.130.0-255,2902,118450,63,171716
29807,0.001656,172.31.40.0-255,66,118516,63,171716
29808,0.001662,74.125.130.0-255,4320,122836,63,171716
29809,0.001663,172.31.40.0-255,66,122902,63,171716
29810,0.001691,74.125.130.0-255,2902,125804,63,171716
29811,0.001694,172.31.40.0-255,66,125870,63,171716
29812,0.001717,74.125.130.0-255,5020,130890,63,171716
29813,0.00172,172.31.40.0-255,66,130956,63,171716
29814,0.004017,74.125.130.0-255,5738,136694,63,171716
29815,0.004028,172.31.40.0-255,66,136760,63,171716
29816,0.006324,74.125.130.0-255,2902,139662,63,171716
29817,0.006329,172.31.40.0-255,66,139728,63,171716
29818,0.006347,74.125.130.0-255,2902,142630,63,171716
29819,0.006349,172.31.40.0-255,66,142696,63,171716
29820,0.008648,74.125.130.0-255,5738,148434,63,171716
29821,0.008661,172.31.40.0-255,66,148500,63,171716
29822,0.011007,74.125.130.0-255,5738,154238,63,171716
29823,0.011023,172.31.40.0-255,66,154304,63,171716
29824,0.013342,74.125.130.0-255,5738,160042,63,171716
29825,0.013359,172.31.40.0-255,66,160108,63,171716
29826,0.015679,74.125.130.0-255,5738,165846,63,171716
29827,0.015697,172.31.40.0-255,66,165912,63,171716
29828,0.018011,74.125.130.0-255,5738,171650,63,171716
29829,0.018026,172.31.40.0-255,66,171716,63,171716
29830,0.0,74.125.24.0-255,153,153,63,142553
29831,1.4e-05,172.31.40.0-255,66,219,63,142553
29832,2e-05,74.125.24.0-255,1484,1703,63,142553
29833,2.4e-05,172.31.40.0-255,66,1769,63,142553
29834,3e-05,74.125.24.0-255,2902,4671,63,142553
29835,3.3e-05,172.31.40.0-255,66,4737,63,142553
29836,3.6e-05,74.125.24.0-255,1484,6221,63,142553
29837,3.8e-05,172.31.40.0-255,66,6287,63,142553
29838,5.1e-05,172.31.40.0-255,66,6353,63,142553
29839,5.6e-05,74.125.24.0-255,2902,9255,63,142553
29840,5.9e-05,172.31.40.0-255,66,9321,63,142553
29841,8.6e-05,172.31.40.0-255,66,9387,63,142553
29842,0.000126,74.125.24.0-255,1484,10871,63,142553
29843,0.000128,172.31.40.0-255,66,10937,63,142553
29844,0.000132,74.125.24.0-255,2902,13839,63,142553
29845,0.000134,172.31.40.0-255,66,13905,63,142553
29846,0.000148,74.125.24.0-255,5738,19643,63,142553
29847,0.00015,172.31.40.0-255,66,19709,63,142553
29848,0.000218,74.125.24.0-255,6797,26506,63,142553
29849,0.000222,172.31.40.0-255,66,26572,63,142553
29850,0.000831,74.125.24.0-255,1484,28056,63,142553
29851,0.000837,172.31.40.0-255,66,28122,63,142553
29852,0.000845,74.125.24.0-255,2902,31024,63,142553
29853,0.000847,172.31.40.0-255,66,31090,63,142553
29854,0.00085,74.125.24.0-255,1484,32574,63,142553
29855,0.000853,172.31.40.0-255,66,32640,63,142553
29856,0.00088,74.125.24.0-255,4320,36960,63,142553
29857,0.000883,172.31.40.0-255,66,37026,63,142553
29858,0.000916,74.125.24.0-255,6797,43823,63,142553
29859,0.000919,172.31.40.0-255,66,43889,63,142553
29860,0.001158,74.125.24.0-255,1484,45373,63,142553
29861,0.001166,74.125.24.0-255,2902,48275,63,142553
29862,0.001169,172.31.40.0-255,66,48341,63,142553
29863,0.001191,74.125.24.0-255,5738,54079,63,142553
29864,0.001193,172.31.40.0-255,66,54145,63,142553
29865,0.001219,172.31.40.0-255,66,54211,63,142553
29866,0.001246,74.125.24.0-255,3961,58172,63,142553
29867,0.001248,172.31.40.0-255,66,58238,63,142553
29868,0.001255,74.125.24.0-255,7156,65394,63,142553
29869,0.001257,172.31.40.0-255,66,65460,63,142553
29870,0.001261,74.125.24.0-255,1484,66944,63,142553
29871,0.001286,74.125.24.0-255,6797,73741,63,142553
29872,0.00129,172.31.40.0-255,66,73807,63,142553
29873,0.0013,172.31.40.0-255,66,73873,63,142553
29874,0.001328,74.125.24.0-255,2428,76301,63,142553
29875,0.00133,172.31.40.0-255,66,76367,63,142553
29876,0.001536,74.125.24.0-255,198,76565,63,142553
29877,0.001737,74.125.24.0-255,1484,78049,63,142553
29878,0.001742,172.31.40.0-255,66,78115,63,142553
29879,0.001749,74.125.24.0-255,2902,81017,63,142553
29880,0.001752,172.31.40.0-255,66,81083,63,142553
29881,0.001758,74.125.24.0-255,5738,86821,63,142553
29882,0.001761,172.31.40.0-255,66,86887,63,142553
29883,0.001794,172.31.40.0-255,66,86953,63,142553
29884,0.001808,74.125.24.0-255,1484,88437,63,142553
29885,0.001813,74.125.24.0-255,2902,91339,63,142553
29886,0.001815,172.31.40.0-255,66,91405,63,142553
29887,0.001848,172.31.40.0-255,66,91471,63,142553
29888,0.002187,74.125.24.0-255,1484,92955,63,142553
29889,0.002191,74.125.24.0-255,2902,95857,63,142553
29890,0.002194,172.31.40.0-255,66,95923,63,142553
29891,0.002245,74.125.24.0-255,5738,101661,63,142553
29892,0.002247,172.31.40.0-255,66,101727,63,142553
29893,0.00226,172.31.40.0-255,66,101793,63,142553
29894,0.002295,172.31.40.0-255,66,101859,63,142553
29895,0.002353,74.125.24.0-255,1484,103343,63,142553
29896,0.004684,74.125.24.0-255,4320,107663,63,142553
29897,0.004688,172.31.40.0-255,66,107729,63,142553
29898,0.007025,74.125.24.0-255,5738,113467,63,142553
29899,0.007031,172.31.40.0-255,66,113533,63,142553
29900,0.009383,74.125.24.0-255,5738,119271,63,142553
29901,0.009391,172.31.40.0-255,66,119337,63,142553
29902,0.011735,74.125.24.0-255,5738,125075,63,142553
29903,0.011742,172.31.40.0-255,66,125141,63,142553
29904,0.014088,74.125.24.0-255,5738,130879,63,142553
29905,0.014099,172.31.40.0-255,66,130945,63,142553
29906,0.016459,74.125.24.0-255,5738,136683,63,142553
29907,0.016467,172.31.40.0-255,66,136749,63,142553
29908,0.018825,74.125.24.0-255,5738,142487,63,142553
29909,0.018833,172.31.40.0-255,66,142553,63,142553
29910,0.0,172.217.194.0-255,152,152,63,195272
29911,2.8e-05,172.31.40.0-255,66,218,63,195272
29912,3.6e-05,172.217.194.0-255,1484,1702,63,195272
29913,4.1e-05,172.31.40.0-255,66,1768,63,195272
29914,7e-05,172.217.194.0-255,2902,4670,63,195272
29915,7.5e-05,172.31.40.0-255,66,4736,63,195272
29916,8.3e-05,172.217.194.0-255,5738,10474,63,195272
29917,8.6e-05,172.31.40.0-255,66,10540,63,195272
29918,9.1e-05,172.217.194.0-255,3479,14019,63,195272
29919,9.4e-05,172.31.40.0-255,66,14085,63,195272
29920,0.0001,172.217.194.0-255,4320,18405,63,195272
29921,0.000102,172.31.40.0-255,66,18471,63,195272
29922,0.000114,172.31.40.0-255,66,18537,63,195272
29923,0.000118,172.217.194.0-255,2543,21080,63,195272
29924,0.000121,172.31.40.0-255,66,21146,63,195272
29925,0.00017,172.217.194.0-255,1484,22630,63,195272
29926,0.000172,172.31.40.0-255,66,22696,63,195272
29927,0.000177,172.217.194.0-255,2902,25598,63,195272
29928,0.000179,172.31.40.0-255,66,25664,63,195272
29929,0.000182,172.217.194.0-255,1484,27148,63,195272
29930,0.000184,172.31.40.0-255,66,27214,63,195272
29931,0.000212,172.217.194.0-255,4320,31534,63,195272
29932,0.000215,172.31.40.0-255,66,31600,63,195272
29933,0.000223,172.217.194.0-255,6797,38397,63,195272
29934,0.000225,172.31.40.0-255,66,38463,63,195272
29935,0.000253,172.217.194.0-255,7156,45619,63,195272
29936,0.000255,172.31.40.0-255,66,45685,63,195272
29937,0.000258,172.217.194.0-255,1484,47169,63,195272
29938,0.000259,172.31.40.0-255,66,47235,63,195272
29939,0.000291,172.31.40.0-255,66,47301,63,195272
29940,0.00034,172.217.194.0-255,645,47946,63,195272
29941,0.000594,172.217.194.0-255,1484,49430,63,195272
29942,0.000598,172.31.40.0-255,66,49496,63,195272
29943,0.000604,172.217.194.0-255,2902,52398,63,195272
29944,0.000606,172.31.40.0-255,66,52464,63,195272
29945,0.000611,172.217.194.0-255,2902,55366,63,195272
29946,0.000612,172.31.40.0-255,66,55432,63,195272
29947,0.000636,172.217.194.0-255,2902,58334,63,195272
29948,0.000639,172.31.40.0-255,66,58400,63,195272
29949,0.000643,172.217.194.0-255,2902,61302,63,195272
29950,0.000645,172.31.40.0-255,66,61368,63,195272
29951,0.000667,172.31.40.0-255,66,61434,63,195272
29952,0.000694,172.217.194.0-255,5738,67172,63,195272
29953,0.000696,172.31.40.0-255,66,67238,63,195272
29954,0.000715,172.217.194.0-255,5020,72258,63,195272
29955,0.000717,172.31.40.0-255,66,72324,63,195272
29956,0.001171,172.217.194.0-255,1484,73808,63,195272
29957,0.001176,172.217.194.0-255,2902,76710,63,195272
29958,0.001179,172.31.40.0-255,66,76776,63,195272
29959,0.001182,172.217.194.0-255,1484,78260,63,195272
29960,0.001201,172.217.194.0-255,4320,82580,63,195272
29961,0.001204,172.31.40.0-255,66,82646,63,195272
29962,0.001216,172.217.194.0-255,2902,85548,63,195272
29963,0.001218,172.31.40.0-255,66,85614,63,195272
29964,0.001244,172.31.40.0-255,66,85680,63,195272
29965,0.001254,172.31.40.0-255,66,85746,63,195272
29966,0.001256,172.217.194.0-255,766,86512,63,195272
29967,0.001577,172.31.40.0-255,66,86578,63,195272
29968,0.0019,172.217.194.0-255,1484,88062,63,195272
29969,0.001909,172.217.194.0-255,2902,90964,63,195272
29970,0.001922,172.31.40.0-255,66,91030,63,195272
29971,0.00193,172.217.194.0-255,5738,96768,63,195272
29972,0.001932,172.31.40.0-255,66,96834,63,195272
29973,0.001963,172.31.40.0-255,66,96900,63,195272
29974,0.001997,172.217.194.0-255,4320,101220,63,195272
29975,0.001999,172.31.40.0-255,66,101286,63,195272
29976,0.002026,172.31.40.0-255,66,101352,63,195272
29977,0.00211,172.217.194.0-255,1484,102836,63,195272
29978,0.002133,172.217.194.0-255,2902,105738,63,195272
29979,0.002136,172.31.40.0-255,66,105804,63,195272
29980,0.002142,172.217.194.0-255,5738,111542,63,195272
29981,0.002144,172.31.40.0-255,66,111608,63,195272
29982,0.002149,172.217.194.0-255,4320,115928,63,195272
29983,0.002151,172.31.40.0-255,66,115994,63,195272
29984,0.002169,172.217.194.0-255,7156,123150,63,195272
29985,0.002172,172.31.40.0-255,66,123216,63,195272
29986,0.002195,172.217.194.0-255,1484,124700,63,195272
29987,0.00221,172.31.40.0-255,66,124766,63,195272
29988,0.002254,172.31.40.0-255,66,124832,63,195272
29989,0.00227,172.31.40.0-255,66,124898,63,195272
29990,0.002293,172.31.40.0-255,66,124964,63,195272
29991,0.002325,172.217.194.0-255,2902,127866,63,195272
29992,0.002328,172.31.40.0-255,66,127932,63,195272
29993,0.002355,172.217.194.0-255,7156,135088,63,195272
29994,0.002358,172.31.40.0-255,66,135154,63,195272
29995,0.002373,172.31.40.0-255,66,135220,63,195272
29996,0.002376,172.217.194.0-255,1484,136704,63,195272
29997,0.00238,172.217.194.0-255,2902,139606,63,195272
29998,0.002383,172.31.40.0-255,66,139672,63,195272
29999,0.002416,172.217.194.0-255,5738,145410,63,195272
30000,0.002419,172.31.40.0-255,66,145476,63,195272
30001,0.002432,172.31.40.0-255,66,145542,63,195272
30002,0.002462,172.217.194.0-255,7156,152698,63,195272
30003,0.002465,172.31.40.0-255,66,152764,63,195272
30004,0.002485,172.217.194.0-255,4320,157084,63,195272
30005,0.002488,172.31.40.0-255,66,157150,63,195272
30006,0.002519,172.31.40.0-255,66,157216,63,195272
30007,0.00255,172.31.40.0-255,66,157282,63,195272
30008,0.002587,172.31.40.0-255,66,157348,63,195272
30009,0.002604,172.31.40.0-255,66,157414,63,195272
30010,0.002609,172.217.194.0-255,4320,161734,63,195272
30011,0.002612,172.31.40.0-255,66,161800,63,195272
30012,0.005152,172.217.194.0-255,4320,166120,63,195272
30013,0.005157,172.31.40.0-255,66,166186,63,195272
30014,0.005175,172.217.194.0-255,1484,167670,63,195272
30015,0.007728,172.217.194.0-255,4320,171990,63,195272
30016,0.007733,172.31.40.0-255,66,172056,63,195272
30017,0.010304,172.217.194.0-255,5738,177794,63,195272
30018,0.01031,172.31.40.0-255,66,177860,63,195272
30019,0.012859,172.217.194.0-255,5738,183598,63,195272
30020,0.012868,172.31.40.0-255,66,183664,63,195272
30021,0.015435,172.217.194.0-255,5738,189402,63,195272
30022,0.015448,172.31.40.0-255,66,189468,63,195272
30023,0.018011,172.217.194.0-255,5738,195206,63,195272
30024,0.01802,172.31.40.0-255,66,195272,63,195272
30025,0.0,172.217.194.0-255,150,150,63,77815
30026,1.9e-05,172.31.40.0-255,66,216,63,77815
30027,2.5e-05,172.217.194.0-255,1484,1700,63,77815
30028,3e-05,172.31.40.0-255,66,1766,63,77815
30029,3.5e-05,172.217.194.0-255,2902,4668,63,77815
30030,4.7e-05,172.31.40.0-255,66,4734,63,77815
30031,5.6e-05,172.217.194.0-255,7156,11890,63,77815
30032,5.9e-05,172.31.40.0-255,66,11956,63,77815
30033,6.3e-05,172.217.194.0-255,2022,13978,63,77815
30034,6.6e-05,172.31.40.0-255,66,14044,63,77815
30035,0.000748,172.217.194.0-255,1484,15528,63,77815
30036,0.000754,172.31.40.0-255,66,15594,63,77815
30037,0.000764,172.217.194.0-255,2902,18496,63,77815
30038,0.000767,172.31.40.0-255,66,18562,63,77815
30039,0.000779,172.217.194.0-255,5738,24300,63,77815
30040,0.000781,172.31.40.0-255,66,24366,63,77815
30041,0.000825,172.31.40.0-255,66,24432,63,77815
30042,0.000854,172.217.194.0-255,1125,25557,63,77815
30043,0.000856,172.31.40.0-255,66,25623,63,77815
30044,0.000869,172.31.40.0-255,66,25689,63,77815
30045,0.00089,172.31.40.0-255,66,25755,63,77815
30046,0.001711,172.217.194.0-255,648,26403,63,77815
30047,0.001719,172.31.40.0-255,66,26469,63,77815
30048,0.001829,172.217.194.0-255,1484,27953,63,77815
30049,0.001831,172.31.40.0-255,66,28019,63,77815
30050,0.001859,172.217.194.0-255,2902,30921,63,77815
30051,0.001862,172.31.40.0-255,66,30987,63,77815
30052,0.001866,172.217.194.0-255,2902,33889,63,77815
30053,0.001868,172.31.40.0-255,66,33955,63,77815
30054,0.001887,172.217.194.0-255,2902,36857,63,77815
30055,0.00189,172.31.40.0-255,66,36923,63,77815
30056,0.001909,172.31.40.0-255,66,36989,63,77815
30057,0.001922,172.31.40.0-255,66,37055,63,77815
30058,0.002427,172.217.194.0-255,1484,38539,63,77815
30059,0.004263,172.217.194.0-255,4320,42859,63,77815
30060,0.00427,172.31.40.0-255,66,42925,63,77815
30061,0.00661,172.217.194.0-255,5738,48663,63,77815
30062,0.006621,172.31.40.0-255,66,48729,63,77815
30063,0.008996,172.217.194.0-255,5738,54467,63,77815
30064,0.009005,172.31.40.0-255,66,54533,63,77815
30065,0.011378,172.217.194.0-255,5738,60271,63,77815
30066,0.011388,172.31.40.0-255,66,60337,63,77815
30067,0.013771,172.217.194.0-255,5738,66075,63,77815
30068,0.013778,172.31.40.0-255,66,66141,63,77815
30069,0.016151,172.217.194.0-255,5738,71879,63,77815
30070,0.016161,172.31.40.0-255,66,71945,63,77815
30071,0.018541,172.217.194.0-255,1484,73429,63,77815
30072,0.018569,172.217.194.0-255,4320,77749,63,77815
30073,0.018574,172.31.40.0-255,66,77815,63,77815
30074,0.0,74.125.24.0-255,146,146,63,167835
30075,1.9e-05,172.31.40.0-255,66,212,63,167835
30076,2.5e-05,74.125.24.0-255,1484,1696,63,167835
30077,2.9e-05,172.31.40.0-255,66,1762,63,167835
30078,3.5e-05,74.125.24.0-255,2902,4664,63,167835
30079,3.8e-05,172.31.40.0-255,66,4730,63,167835
30080,5.3e-05,74.125.24.0-255,7156,11886,63,167835
30081,5.7e-05,172.31.40.0-255,66,11952,63,167835
30082,6.4e-05,74.125.24.0-255,5738,17690,63,167835
30083,6.7e-05,172.31.40.0-255,66,17756,63,167835
30084,8.7e-05,74.125.24.0-255,3439,21195,63,167835
30085,9e-05,172.31.40.0-255,66,21261,63,167835
30086,0.000106,172.31.40.0-255,66,21327,63,167835
30087,0.000109,74.125.24.0-255,2902,24229,63,167835
30088,0.000112,172.31.40.0-255,66,24295,63,167835
30089,0.000152,172.31.40.0-255,66,24361,63,167835
30090,0.000155,74.125.24.0-255,1484,25845,63,167835
30091,0.000157,172.31.40.0-255,66,25911,63,167835
30092,0.000185,172.31.40.0-255,66,25977,63,167835
30093,0.00021,74.125.24.0-255,2818,28795,63,167835
30094,0.000212,172.31.40.0-255,66,28861,63,167835
30095,0.000892,74.125.24.0-255,380,29241,63,167835
30096,0.000897,172.31.40.0-255,66,29307,63,167835
30097,0.000941,74.125.24.0-255,1484,30791,63,167835
30098,0.000944,172.31.40.0-255,66,30857,63,167835
30099,0.000966,74.125.24.0-255,4320,35177,63,167835
30100,0.000969,172.31.40.0-255,66,35243,63,167835
30101,0.000974,74.125.24.0-255,2902,38145,63,167835
30102,0.000977,172.31.40.0-255,66,38211,63,167835
30103,0.001028,172.31.40.0-255,66,38277,63,167835
30104,0.001035,74.125.24.0-255,5738,44015,63,167835
30105,0.001037,172.31.40.0-255,66,44081,63,167835
30106,0.001041,74.125.24.0-255,2902,46983,63,167835
30107,0.001043,172.31.40.0-255,66,47049,63,167835
30108,0.001072,74.125.24.0-255,4320,51369,63,167835
30109,0.001074,172.31.40.0-255,66,51435,63,167835
30110,0.00108,74.125.24.0-255,3602,55037,63,167835
30111,0.001082,172.31.40.0-255,66,55103,63,167835
30112,0.001333,74.125.24.0-255,1484,56587,63,167835
30113,0.00135,74.125.24.0-255,2902,59489,63,167835
30114,0.001354,172.31.40.0-255,66,59555,63,167835
30115,0.001385,74.125.24.0-255,5738,65293,63,167835
30116,0.001387,172.31.40.0-255,66,65359,63,167835
30117,0.001395,74.125.24.0-255,7156,72515,63,167835
30118,0.001397,172.31.40.0-255,66,72581,63,167835
30119,0.001435,74.125.24.0-255,5738,78319,63,167835
30120,0.001438,172.31.40.0-255,66,78385,63,167835
30121,0.001449,172.31.40.0-255,66,78451,63,167835
30122,0.001454,74.125.24.0-255,2184,80635,63,167835
30123,0.001457,172.31.40.0-255,66,80701,63,167835
30124,0.002124,74.125.24.0-255,1484,82185,63,167835
30125,0.002132,74.125.24.0-255,2902,85087,63,167835
30126,0.002137,172.31.40.0-255,66,85153,63,167835
30127,0.002145,74.125.24.0-255,5738,90891,63,167835
30128,0.002148,172.31.40.0-255,66,90957,63,167835
30129,0.002175,74.125.24.0-255,1484,92441,63,167835
30130,0.002197,74.125.24.0-255,2902,95343,63,167835
30131,0.0022,172.31.40.0-255,66,95409,63,167835
30132,0.002225,74.125.24.0-255,2902,98311,63,167835
30133,0.002228,172.31.40.0-255,66,98377,63,167835
30134,0.002239,172.31.40.0-255,66,98443,63,167835
30135,0.002271,172.31.40.0-255,66,98509,63,167835
30136,0.002459,74.125.24.0-255,1484,99993,63,167835
30137,0.002478,74.125.24.0-255,2902,102895,63,167835
30138,0.002481,172.31.40.0-255,66,102961,63,167835
30139,0.002485,74.125.24.0-255,2902,105863,63,167835
30140,0.002486,172.31.40.0-255,66,105929,63,167835
30141,0.002508,74.125.24.0-255,2902,108831,63,167835
30142,0.00251,172.31.40.0-255,66,108897,63,167835
30143,0.002515,74.125.24.0-255,4320,113217,63,167835
30144,0.002517,172.31.40.0-255,66,113283,63,167835
30145,0.002532,172.31.40.0-255,66,113349,63,167835
30146,0.002558,74.125.24.0-255,5738,119087,63,167835
30147,0.002561,172.31.40.0-255,66,119153,63,167835
30148,0.002591,74.125.24.0-255,6438,125591,63,167835
30149,0.002593,172.31.40.0-255,66,125657,63,167835
30150,0.002606,172.31.40.0-255,66,125723,63,167835
30151,0.002612,74.125.24.0-255,7156,132879,63,167835
30152,0.002614,172.31.40.0-255,66,132945,63,167835
30153,0.002645,172.31.40.0-255,66,133011,63,167835
30154,0.005236,74.125.24.0-255,5738,138749,63,167835
30155,0.005242,172.31.40.0-255,66,138815,63,167835
30156,0.007812,74.125.24.0-255,5738,144553,63,167835
30157,0.007819,172.31.40.0-255,66,144619,63,167835
30158,0.010416,74.125.24.0-255,5738,150357,63,167835
30159,0.010424,172.31.40.0-255,66,150423,63,167835
30160,0.013046,74.125.24.0-255,5738,156161,63,167835
30161,0.013054,172.31.40.0-255,66,156227,63,167835
30162,0.015636,74.125.24.0-255,5738,161965,63,167835
30163,0.015649,172.31.40.0-255,66,162031,63,167835
30164,0.018242,74.125.24.0-255,5738,167769,63,167835
30165,0.01825,172.31.40.0-255,66,167835,63,167835
30166,0.0,172.217.194.0-255,153,153,63,185162
30167,2e-05,172.31.40.0-255,66,219,63,185162
30168,2.8e-05,172.217.194.0-255,1484,1703,63,185162
30169,3.3e-05,172.31.40.0-255,66,1769,63,185162
30170,3.9e-05,172.217.194.0-255,2902,4671,63,185162
30171,4.3e-05,172.31.40.0-255,66,4737,63,185162
30172,5.2e-05,172.217.194.0-255,7156,11893,63,185162
30173,5.4e-05,172.31.40.0-255,66,11959,63,185162
30174,8.6e-05,172.217.194.0-255,1484,13443,63,185162
30175,8.9e-05,172.31.40.0-255,66,13509,63,185162
30176,0.000108,172.217.194.0-255,2134,15643,63,185162
30177,0.000111,172.31.40.0-255,66,15709,63,185162
30178,0.000116,172.217.194.0-255,4320,20029,63,185162
30179,0.000119,172.31.40.0-255,66,20095,63,185162
30180,0.00014,172.217.194.0-255,2902,22997,63,185162
30181,0.000143,172.31.40.0-255,66,23063,63,185162
30182,0.000167,172.217.194.0-255,7156,30219,63,185162
30183,0.00017,172.31.40.0-255,66,30285,63,185162
30184,0.000173,172.217.194.0-255,1125,31410,63,185162
30185,0.000175,172.31.40.0-255,66,31476,63,185162
30186,0.000221,172.217.194.0-255,1484,32960,63,185162
30187,0.000224,172.31.40.0-255,66,33026,63,185162
30188,0.000227,172.217.194.0-255,1484,34510,63,185162
30189,0.000229,172.31.40.0-255,66,34576,63,185162
30190,0.000244,172.217.194.0-255,1484,36060,63,185162
30191,0.000247,172.31.40.0-255,66,36126,63,185162
30192,0.000254,172.217.194.0-255,5738,41864,63,185162
30193,0.000256,172.31.40.0-255,66,41930,63,185162
30194,0.000278,172.217.194.0-255,7156,49086,63,185162
30195,0.000281,172.31.40.0-255,66,49152,63,185162
30196,0.000301,172.31.40.0-255,66,49218,63,185162
30197,0.000317,172.217.194.0-255,5738,54956,63,185162
30198,0.000319,172.31.40.0-255,66,55022,63,185162
30199,0.000323,172.217.194.0-255,2184,57206,63,185162
30200,0.000326,172.31.40.0-255,66,57272,63,185162
30201,0.000699,172.217.194.0-255,343,57615,63,185162
30202,0.000972,172.217.194.0-255,115,57730,63,185162
30203,0.000999,172.217.194.0-255,1484,59214,63,185162
30204,0.001003,172.31.40.0-255,66,59280,63,185162
30205,0.001009,172.217.194.0-255,2902,62182,63,185162
30206,0.001012,172.31.40.0-255,66,62248,63,185162
30207,0.001019,172.217.194.0-255,5738,67986,63,185162
30208,0.001021,172.31.40.0-255,66,68052,63,185162
30209,0.001042,172.217.194.0-255,1484,69536,63,185162
30210,0.001047,172.217.194.0-255,2902,72438,63,185162
30211,0.00105,172.31.40.0-255,66,72504,63,185162
30212,0.001079,172.31.40.0-255,66,72570,63,185162
30213,0.001109,172.31.40.0-255,66,72636,63,185162
30214,0.001648,172.217.194.0-255,1484,74120,63,185162
30215,0.001659,172.217.194.0-255,2902,77022,63,185162
30216,0.001663,172.31.40.0-255,66,77088,63,185162
30217,0.001679,172.217.194.0-255,1484,78572,63,185162
30218,0.001703,172.217.194.0-255,4320,82892,63,185162
30219,0.001706,172.31.40.0-255,66,82958,63,185162
30220,0.001709,172.217.194.0-255,1484,84442,63,185162
30221,0.001735,172.31.40.0-255,66,84508,63,185162
30222,0.001771,172.31.40.0-255,66,84574,63,185162
30223,0.001793,172.217.194.0-255,1484,86058,63,185162
30224,0.001809,172.217.194.0-255,7156,93214,63,185162
30225,0.001812,172.31.40.0-255,66,93280,63,185162
30226,0.001844,172.31.40.0-255,66,93346,63,185162
30227,0.00185,172.217.194.0-255,4320,97666,63,185162
30228,0.001852,172.31.40.0-255,66,97732,63,185162
30229,0.001858,172.217.194.0-255,5020,102752,63,185162
30230,0.001861,172.31.40.0-255,66,102818,63,185162
30231,0.001914,172.217.194.0-255,5738,108556,63,185162
30232,0.001917,172.31.40.0-255,66,108622,63,185162
30233,0.001932,172.31.40.0-255,66,108688,63,185162
30234,0.001938,172.217.194.0-255,5738,114426,63,185162
30235,0.00194,172.31.40.0-255,66,114492,63,185162
30236,0.001962,172.217.194.0-255,5738,120230,63,185162
30237,0.001965,172.31.40.0-255,66,120296,63,185162
30238,0.001996,172.31.40.0-255,66,120362,63,185162
30239,0.002033,172.31.40.0-255,66,120428,63,185162
30240,0.00204,172.217.194.0-255,5738,126166,63,185162
30241,0.002042,172.31.40.0-255,66,126232,63,185162
30242,0.002076,172.31.40.0-255,66,126298,63,185162
30243,0.002083,172.217.194.0-255,7156,133454,63,185162
30244,0.002085,172.31.40.0-255,66,133520,63,185162
30245,0.002125,172.31.40.0-255,66,133586,63,185162
30246,0.002136,172.31.40.0-255,66,133652,63,185162
30247,0.002142,172.217.194.0-255,5738,139390,63,185162
30248,0.002145,172.31.40.0-255,66,139456,63,185162
30249,0.002192,172.31.40.0-255,66,139522,63,185162
30250,0.002198,172.217.194.0-255,5020,144542,63,185162
30251,0.0022,172.31.40.0-255,66,144608,63,185162
30252,0.002204,172.217.194.0-255,2902,147510,63,185162
30253,0.002207,172.31.40.0-255,66,147576,63,185162
30254,0.002212,172.217.194.0-255,4320,151896,63,185162
30255,0.002215,172.31.40.0-255,66,151962,63,185162
30256,0.002219,172.217.194.0-255,2902,154864,63,185162
30257,0.002221,172.31.40.0-255,66,154930,63,185162
30258,0.002249,172.217.194.0-255,5738,160668,63,185162
30259,0.002252,172.31.40.0-255,66,160734,63,185162
30260,0.002286,172.217.194.0-255,1484,162218,63,185162
30261,0.002304,172.217.194.0-255,2902,165120,63,185162
30262,0.002307,172.31.40.0-255,66,165186,63,185162
30263,0.002336,172.31.40.0-255,66,165252,63,185162
30264,0.002357,172.217.194.0-255,2184,167436,63,185162
30265,0.002359,172.31.40.0-255,66,167502,63,185162
30266,0.002372,172.31.40.0-255,66,167568,63,185162
30267,0.002402,172.217.194.0-255,7156,174724,63,185162
30268,0.002405,172.31.40.0-255,66,174790,63,185162
30269,0.002421,172.31.40.0-255,66,174856,63,185162
30270,0.002423,172.217.194.0-255,382,175238,63,185162
30271,0.002426,172.217.194.0-255,1484,176722,63,185162
30272,0.002428,172.31.40.0-255,66,176788,63,185162
30273,0.002434,172.217.194.0-255,4320,181108,63,185162
30274,0.002437,172.31.40.0-255,66,181174,63,185162
30275,0.002448,172.31.40.0-255,66,181240,63,185162
30276,0.002462,172.31.40.0-255,66,181306,63,185162
30277,0.002467,172.217.194.0-255,3448,184754,63,185162
30278,0.00247,172.31.40.0-255,66,184820,63,185162
30279,0.002531,172.217.194.0-255,105,184925,63,185162
30280,0.011552,172.31.40.0-255,66,184991,63,185162
30281,0.011602,172.31.40.0-255,105,185096,63,185162
30282,0.014221,172.217.194.0-255,66,185162,63,185162
30283,0.0,74.125.68.0-255,150,150,63,253076
30284,2.3e-05,172.31.40.0-255,66,216,63,253076
30285,3.1e-05,74.125.68.0-255,1484,1700,63,253076
30286,3.6e-05,172.31.40.0-255,66,1766,63,253076
30287,4.3e-05,74.125.68.0-255,2902,4668,63,253076
30288,5.5e-05,172.31.40.0-255,66,4734,63,253076
30289,6.1e-05,74.125.68.0-255,4320,9054,63,253076
30290,6.5e-05,172.31.40.0-255,66,9120,63,253076
30291,7.2e-05,74.125.68.0-255,4881,14001,63,253076
30292,7.5e-05,172.31.40.0-255,66,14067,63,253076
30293,0.000128,74.125.68.0-255,1484,15551,63,253076
30294,0.000131,172.31.40.0-255,66,15617,63,253076
30295,0.000136,74.125.68.0-255,2902,18519,63,253076
30296,0.000138,172.31.40.0-255,66,18585,63,253076
30297,0.000168,74.125.68.0-255,5738,24323,63,253076
30298,0.000171,172.31.40.0-255,66,24389,63,253076
30299,0.000177,74.125.68.0-255,5738,30127,63,253076
30300,0.00018,172.31.40.0-255,66,30193,63,253076
30301,0.000267,74.125.68.0-255,6797,36990,63,253076
30302,0.000272,172.31.40.0-255,66,37056,63,253076
30303,0.000277,74.125.68.0-255,2902,39958,63,253076
30304,0.000279,172.31.40.0-255,66,40024,63,253076
30305,0.000285,74.125.68.0-255,4320,44344,63,253076
30306,0.000287,172.31.40.0-255,66,44410,63,253076
30307,0.00032,74.125.68.0-255,3961,48371,63,253076
30308,0.000322,172.31.40.0-255,66,48437,63,253076
30309,0.000486,74.125.68.0-255,1484,49921,63,253076
30310,0.000491,172.31.40.0-255,66,49987,63,253076
30311,0.000512,74.125.68.0-255,2902,52889,63,253076
30312,0.000515,172.31.40.0-255,66,52955,63,253076
30313,0.00052,74.125.68.0-255,2902,55857,63,253076
30314,0.000522,172.31.40.0-255,66,55923,63,253076
30315,0.000528,74.125.68.0-255,4320,60243,63,253076
30316,0.000571,74.125.68.0-255,2902,63145,63,253076
30317,0.000617,172.31.40.0-255,66,63211,63,253076
30318,0.000663,74.125.68.0-255,4320,67531,63,253076
30319,0.000692,74.125.68.0-255,7156,74687,63,253076
30320,0.000697,74.125.68.0-255,4320,79007,63,253076
30321,0.0007,172.31.40.0-255,66,79073,63,253076
30322,0.000706,172.31.40.0-255,66,79139,63,253076
30323,0.000725,74.125.68.0-255,1125,80264,63,253076
30324,0.000866,74.125.68.0-255,1484,81748,63,253076
30325,0.000872,74.125.68.0-255,2902,84650,63,253076
30326,0.000877,172.31.40.0-255,66,84716,63,253076
30327,0.000908,74.125.68.0-255,5738,90454,63,253076
30328,0.000914,172.31.40.0-255,66,90520,63,253076
30329,0.000958,74.125.68.0-255,5738,96258,63,253076
30330,0.000969,172.31.40.0-255,66,96324,63,253076
30331,0.001003,74.125.68.0-255,5020,101344,63,253076
30332,0.00102,172.31.40.0-255,66,101410,63,253076
30333,0.001091,74.125.68.0-255,1484,102894,63,253076
30334,0.001095,74.125.68.0-255,1484,104378,63,253076
30335,0.001107,74.125.68.0-255,1484,105862,63,253076
30336,0.00111,172.31.40.0-255,66,105928,63,253076
30337,0.001142,74.125.68.0-255,5738,111666,63,253076
30338,0.00115,74.125.68.0-255,5738,117404,63,253076
30339,0.001162,74.125.68.0-255,1484,118888,63,253076
30340,0.001167,172.31.40.0-255,66,118954,63,253076
30341,0.001187,74.125.68.0-255,7156,126110,63,253076
30342,0.001205,172.31.40.0-255,66,126176,63,253076
30343,0.001212,74.125.68.0-255,1484,127660,63,253076
30344,0.001237,74.125.68.0-255,2902,130562,63,253076
30345,0.001246,172.31.40.0-255,66,130628,63,253076
30346,0.001262,74.125.68.0-255,4320,134948,63,253076
30347,0.001266,74.125.68.0-255,1484,136432,63,253076
30348,0.001283,74.125.68.0-255,7156,143588,63,253076
30349,0.001301,172.31.40.0-255,66,143654,63,253076
30350,0.001351,74.125.68.0-255,5738,149392,63,253076
30351,0.001358,172.31.40.0-255,66,149458,63,253076
30352,0.001376,74.125.68.0-255,3602,153060,63,253076
30353,0.001393,74.125.68.0-255,1484,154544,63,253076
30354,0.001398,74.125.68.0-255,2902,157446,63,253076
30355,0.001401,74.125.68.0-255,2902,160348,63,253076
30356,0.001416,74.125.68.0-255,2902,163250,63,253076
30357,0.00143,172.31.40.0-255,66,163316,63,253076
30358,0.001471,74.125.68.0-255,1484,164800,63,253076
30359,0.001479,172.31.40.0-255,66,164866,63,253076
30360,0.001515,74.125.68.0-255,2184,167050,63,253076
30361,0.001533,172.31.40.0-255,66,167116,63,253076
30362,0.001751,74.125.68.0-255,1484,168600,63,253076
30363,0.001755,74.125.68.0-255,1484,170084,63,253076
30364,0.001767,74.125.68.0-255,1484,171568,63,253076
30365,0.001774,172.31.40.0-255,66,171634,63,253076
30366,0.001804,74.125.68.0-255,5738,177372,63,253076
30367,0.001811,74.125.68.0-255,5738,183110,63,253076
30368,0.001813,74.125.68.0-255,1484,184594,63,253076
30369,0.001819,172.31.40.0-255,66,184660,63,253076
30370,0.001854,74.125.68.0-255,5738,190398,63,253076
30371,0.001858,74.125.68.0-255,2902,193300,63,253076
30372,0.001894,172.31.40.0-255,66,193366,63,253076
30373,0.001905,74.125.68.0-255,7156,200522,63,253076
30374,0.001923,74.125.68.0-255,4320,204842,63,253076
30375,0.001927,74.125.68.0-255,4320,209162,63,253076
30376,0.00193,172.31.40.0-255,66,209228,63,253076
30377,0.001955,74.125.68.0-255,2902,212130,63,253076
30378,0.001966,172.31.40.0-255,66,212196,63,253076
30379,0.00199,74.125.68.0-255,766,212962,63,253076
30380,0.002018,74.125.68.0-255,5738,218700,63,253076
30381,0.00203,74.125.68.0-255,4320,223020,63,253076
30382,0.002034,172.31.40.0-255,66,223086,63,253076
30383,0.002038,172.31.40.0-255,66,223152,63,253076
30384,0.002082,74.125.68.0-255,4320,227472,63,253076
30385,0.002086,74.125.68.0-255,2902,230374,63,253076
30386,0.002102,74.125.68.0-255,2902,233276,63,253076
30387,0.002107,172.31.40.0-255,66,233342,63,253076
30388,0.002118,74.125.68.0-255,4320,237662,63,253076
30389,0.002156,74.125.68.0-255,2902,240564,63,253076
30390,0.00216,172.31.40.0-255,66,240630,63,253076
30391,0.002164,172.31.40.0-255,66,240696,63,253076
30392,0.002205,172.31.40.0-255,66,240762,63,253076
30393,0.002231,74.125.68.0-255,7156,247918,63,253076
30394,0.002274,172.31.40.0-255,66,247984,63,253076
30395,0.002279,74.125.68.0-255,2184,250168,63,253076
30396,0.00232,172.31.40.0-255,66,250234,63,253076
30397,0.002369,172.31.40.0-255,66,250300,63,253076
30398,0.002385,74.125.68.0-255,2605,252905,63,253076
30399,0.002404,172.31.40.0-255,66,252971,63,253076
30400,0.019257,172.31.40.0-255,105,253076,63,253076
30401,0.0,172.253.118.0-255,152,152,63,224625
30402,2.4e-05,172.31.40.0-255,66,218,63,224625
30403,3.1e-05,172.253.118.0-255,1484,1702,63,224625
30404,3.6e-05,172.31.40.0-255,66,1768,63,224625
30405,4.3e-05,172.253.118.0-255,2902,4670,63,224625
30406,5.4e-05,172.31.40.0-255,66,4736,63,224625
30407,6.2e-05,172.253.118.0-255,7156,11892,63,224625
30408,6.5e-05,172.31.40.0-255,66,11958,63,224625
30409,7e-05,172.253.118.0-255,2111,14069,63,224625
30410,7.3e-05,172.31.40.0-255,66,14135,63,224625
30411,7.8e-05,172.253.118.0-255,4320,18455,63,224625
30412,8.2e-05,172.31.40.0-255,66,18521,63,224625
30413,0.000103,172.253.118.0-255,7156,25677,63,224625
30414,0.000113,172.31.40.0-255,66,25743,63,224625
30415,0.000118,172.253.118.0-255,4320,30063,63,224625
30416,0.000121,172.31.40.0-255,66,30129,63,224625
30417,0.000124,172.253.118.0-255,1125,31254,63,224625
30418,0.000127,172.31.40.0-255,66,31320,63,224625
30419,0.000204,172.253.118.0-255,1484,32804,63,224625
30420,0.000207,172.31.40.0-255,66,32870,63,224625
30421,0.000211,172.253.118.0-255,1484,34354,63,224625
30422,0.000213,172.31.40.0-255,66,34420,63,224625
30423,0.000252,172.253.118.0-255,1484,35904,63,224625
30424,0.000255,172.31.40.0-255,66,35970,63,224625
30425,0.000262,172.253.118.0-255,5738,41708,63,224625
30426,0.000265,172.31.40.0-255,66,41774,63,224625
30427,0.000272,172.253.118.0-255,6797,48571,63,224625
30428,0.000274,172.31.40.0-255,66,48637,63,224625
30429,0.00028,172.253.118.0-255,5738,54375,63,224625
30430,0.000283,172.31.40.0-255,66,54441,63,224625
30431,0.000313,172.31.40.0-255,66,54507,63,224625
30432,0.000317,172.253.118.0-255,2818,57325,63,224625
30433,0.000319,172.31.40.0-255,66,57391,63,224625
30434,0.000322,172.253.118.0-255,130,57521,63,224625
30435,0.000373,172.253.118.0-255,1484,59005,63,224625
30436,0.000375,172.31.40.0-255,66,59071,63,224625
30437,0.00038,172.253.118.0-255,2902,61973,63,224625
30438,0.000383,172.31.40.0-255,66,62039,63,224625
30439,0.000407,172.253.118.0-255,2902,64941,63,224625
30440,0.00041,172.31.40.0-255,66,65007,63,224625
30441,0.000451,172.253.118.0-255,5738,70745,63,224625
30442,0.000454,172.31.40.0-255,66,70811,63,224625
30443,0.000479,172.253.118.0-255,3662,74473,63,224625
30444,0.000482,172.31.40.0-255,66,74539,63,224625
30445,0.00056,172.253.118.0-255,1484,76023,63,224625
30446,0.000566,172.253.118.0-255,2902,78925,63,224625
30447,0.000568,172.31.40.0-255,66,78991,63,224625
30448,0.000623,172.253.118.0-255,4320,83311,63,224625
30449,0.000626,172.31.40.0-255,66,83377,63,224625
30450,0.000632,172.253.118.0-255,5738,89115,63,224625
30451,0.000634,172.31.40.0-255,66,89181,63,224625
30452,0.000663,172.253.118.0-255,5738,94919,63,224625
30453,0.000666,172.31.40.0-255,66,94985,63,224625
30454,0.000692,172.253.118.0-255,2902,97887,63,224625
30455,0.000695,172.31.40.0-255,66,97953,63,224625
30456,0.000706,172.31.40.0-255,66,98019,63,224625
30457,0.000713,172.253.118.0-255,752,98771,63,224625
30458,0.000799,172.253.118.0-255,1484,100255,63,224625
30459,0.000803,172.31.40.0-255,66,100321,63,224625
30460,0.000806,172.253.118.0-255,1484,101805,63,224625
30461,0.000829,172.253.118.0-255,1484,103289,63,224625
30462,0.000831,172.31.40.0-255,66,103355,63,224625
30463,0.000837,172.253.118.0-255,5738,109093,63,224625
30464,0.00084,172.31.40.0-255,66,109159,63,224625
30465,0.000861,172.253.118.0-255,4320,113479,63,224625
30466,0.000869,172.31.40.0-255,66,113545,63,224625
30467,0.000887,172.253.118.0-255,1533,115078,63,224625
30468,0.00089,172.31.40.0-255,66,115144,63,224625
30469,0.000982,172.253.118.0-255,1484,116628,63,224625
30470,0.000987,172.253.118.0-255,2902,119530,63,224625
30471,0.00099,172.31.40.0-255,66,119596,63,224625
30472,0.001018,172.253.118.0-255,5738,125334,63,224625
30473,0.00103,172.31.40.0-255,66,125400,63,224625
30474,0.001043,172.31.40.0-255,66,125466,63,224625
30475,0.001079,172.253.118.0-255,2902,128368,63,224625
30476,0.001082,172.31.40.0-255,66,128434,63,224625
30477,0.001094,172.31.40.0-255,66,128500,63,224625
30478,0.001219,172.253.118.0-255,1484,129984,63,224625
30479,0.001234,172.253.118.0-255,2902,132886,63,224625
30480,0.001237,172.31.40.0-255,66,132952,63,224625
30481,0.001241,172.253.118.0-255,1484,134436,63,224625
30482,0.001269,172.253.118.0-255,4320,138756,63,224625
30483,0.001272,172.31.40.0-255,66,138822,63,224625
30484,0.001278,172.253.118.0-255,4320,143142,63,224625
30485,0.00128,172.31.40.0-255,66,143208,63,224625
30486,0.001294,172.31.40.0-255,66,143274,63,224625
30487,0.001327,172.253.118.0-255,2902,146176,63,224625
30488,0.00133,172.31.40.0-255,66,146242,63,224625
30489,0.001341,172.31.40.0-255,66,146308,63,224625
30490,0.001382,172.253.118.0-255,1484,147792,63,224625
30491,0.001405,172.253.118.0-255,2902,150694,63,224625
30492,0.001408,172.31.40.0-255,66,150760,63,224625
30493,0.001415,172.253.118.0-255,5738,156498,63,224625
30494,0.001418,172.31.40.0-255,66,156564,63,224625
30495,0.00143,172.253.118.0-255,5738,162302,63,224625
30496,0.001432,172.31.40.0-255,66,162368,63,224625
30497,0.001463,172.253.118.0-255,1484,163852,63,224625
30498,0.001478,172.31.40.0-255,66,163918,63,224625
30499,0.001482,172.253.118.0-255,2184,166102,63,224625
30500,0.001484,172.31.40.0-255,66,166168,63,224625
30501,0.001671,172.253.118.0-255,1484,167652,63,224625
30502,0.001678,172.253.118.0-255,2902,170554,63,224625
30503,0.001683,172.31.40.0-255,66,170620,63,224625
30504,0.00169,172.253.118.0-255,2902,173522,63,224625
30505,0.001692,172.31.40.0-255,66,173588,63,224625
30506,0.001719,172.253.118.0-255,2902,176490,63,224625
30507,0.001722,172.31.40.0-255,66,176556,63,224625
30508,0.001742,172.31.40.0-255,66,176622,63,224625
30509,0.001766,172.253.118.0-255,1484,178106,63,224625
30510,0.001841,172.31.40.0-255,66,178172,63,224625
30511,0.002007,172.253.118.0-255,1484,179656,63,224625
30512,0.002016,172.253.118.0-255,2902,182558,63,224625
30513,0.00202,172.31.40.0-255,66,182624,63,224625
30514,0.002025,172.253.118.0-255,4320,186944,63,224625
30515,0.002028,172.31.40.0-255,66,187010,63,224625
30516,0.002051,172.253.118.0-255,1484,188494,63,224625
30517,0.002065,172.31.40.0-255,66,188560,63,224625
30518,0.002071,172.253.118.0-255,5738,194298,63,224625
30519,0.002074,172.31.40.0-255,66,194364,63,224625
30520,0.002102,172.253.118.0-255,5020,199384,63,224625
30521,0.002105,172.31.40.0-255,66,199450,63,224625
30522,0.002141,172.31.40.0-255,66,199516,63,224625
30523,0.002182,172.31.40.0-255,66,199582,63,224625
30524,0.002194,172.31.40.0-255,66,199648,63,224625
30525,0.002226,172.253.118.0-255,6438,206086,63,224625
30526,0.00223,172.31.40.0-255,66,206152,63,224625
30527,0.002244,172.31.40.0-255,66,206218,63,224625
30528,0.002271,172.253.118.0-255,2902,209120,63,224625
30529,0.002273,172.31.40.0-255,66,209186,63,224625
30530,0.002281,172.253.118.0-255,7156,216342,63,224625
30531,0.002284,172.31.40.0-255,66,216408,63,224625
30532,0.002326,172.31.40.0-255,66,216474,63,224625
30533,0.002341,172.31.40.0-255,66,216540,63,224625
30534,0.002352,172.31.40.0-255,66,216606,63,224625
30535,0.00238,172.253.118.0-255,2902,219508,63,224625
30536,0.002382,172.31.40.0-255,66,219574,63,224625
30537,0.002403,172.253.118.0-255,4643,224217,63,224625
30538,0.002406,172.31.40.0-255,66,224283,63,224625
30539,0.002408,172.253.118.0-255,105,224388,63,224625
30540,0.004939,172.31.40.0-255,66,224454,63,224625
30541,0.00498,172.31.40.0-255,105,224559,63,224625
30542,0.007471,172.253.118.0-255,66,224625,63,224625
30543,0.0,172.217.194.0-255,154,154,63,134770
30544,2.4e-05,172.31.40.0-255,66,220,63,134770
30545,3.2e-05,172.217.194.0-255,1484,1704,63,134770
30546,3.7e-05,172.31.40.0-255,66,1770,63,134770
30547,4.3e-05,172.217.194.0-255,2902,4672,63,134770
30548,5.4e-05,172.31.40.0-255,66,4738,63,134770
30549,6.2e-05,172.217.194.0-255,7156,11894,63,134770
30550,6.5e-05,172.31.40.0-255,66,11960,63,134770
30551,9.8e-05,172.217.194.0-255,2038,13998,63,134770
30552,0.000101,172.31.40.0-255,66,14064,63,134770
30553,0.000164,172.217.194.0-255,1484,15548,63,134770
30554,0.000167,172.31.40.0-255,66,15614,63,134770
30555,0.000196,172.217.194.0-255,2902,18516,63,134770
30556,0.000199,172.31.40.0-255,66,18582,63,134770
30557,0.000205,172.217.194.0-255,5738,24320,63,134770
30558,0.000208,172.31.40.0-255,66,24386,63,134770
30559,0.000237,172.217.194.0-255,6797,31183,63,134770
30560,0.000239,172.31.40.0-255,66,31249,63,134770
30561,0.000275,172.217.194.0-255,1484,32733,63,134770
30562,0.000277,172.31.40.0-255,66,32799,63,134770
30563,0.00029,172.217.194.0-255,1484,34283,63,134770
30564,0.000296,172.31.40.0-255,66,34349,63,134770
30565,0.000324,172.217.194.0-255,1484,35833,63,134770
30566,0.000326,172.31.40.0-255,66,35899,63,134770
30567,0.000334,172.217.194.0-255,5738,41637,63,134770
30568,0.000336,172.31.40.0-255,66,41703,63,134770
30569,0.000346,172.217.194.0-255,4320,46023,63,134770
30570,0.000348,172.31.40.0-255,66,46089,63,134770
30571,0.000377,172.217.194.0-255,2543,48632,63,134770
30572,0.000379,172.31.40.0-255,66,48698,63,134770
30573,0.000386,172.217.194.0-255,7156,55854,63,134770
30574,0.000389,172.31.40.0-255,66,55920,63,134770
30575,0.000405,172.31.40.0-255,66,55986,63,134770
30576,0.001082,172.217.194.0-255,358,56344,63,134770
30577,0.00111,172.217.194.0-255,386,56730,63,134770
30578,0.001131,172.31.40.0-255,66,56796,63,134770
30579,0.001417,172.217.194.0-255,1484,58280,63,134770
30580,0.001426,172.217.194.0-255,2902,61182,63,134770
30581,0.00143,172.31.40.0-255,66,61248,63,134770
30582,0.001439,172.217.194.0-255,5738,66986,63,134770
30583,0.001441,172.31.40.0-255,66,67052,63,134770
30584,0.001445,172.217.194.0-255,1484,68536,63,134770
30585,0.00151,172.31.40.0-255,66,68602,63,134770
30586,0.001528,172.31.40.0-255,66,68668,63,134770
30587,0.001534,172.217.194.0-255,4320,72988,63,134770
30588,0.001535,172.31.40.0-255,66,73054,63,134770
30589,0.001564,172.31.40.0-255,66,73120,63,134770
30590,0.001585,172.31.40.0-255,66,73186,63,134770
30591,0.001588,172.217.194.0-255,766,73952,63,134770
30592,0.001641,172.217.194.0-255,5738,79690,63,134770
30593,0.001644,172.31.40.0-255,66,79756,63,134770
30594,0.001689,172.31.40.0-255,66,79822,63,134770
30595,0.001693,172.217.194.0-255,1484,81306,63,134770
30596,0.00171,172.31.40.0-255,66,81372,63,134770
30597,0.001823,172.217.194.0-255,1484,82856,63,134770
30598,0.001829,172.217.194.0-255,2902,85758,63,134770
30599,0.001833,172.31.40.0-255,66,85824,63,134770
30600,0.001837,172.217.194.0-255,1484,87308,63,134770
30601,0.00186,172.217.194.0-255,4320,91628,63,134770
30602,0.001864,172.31.40.0-255,66,91694,63,134770
30603,0.001875,172.31.40.0-255,66,91760,63,134770
30604,0.001908,172.217.194.0-255,2902,94662,63,134770
30605,0.00191,172.31.40.0-255,66,94728,63,134770
30606,0.001928,172.31.40.0-255,66,94794,63,134770
30607,0.00193,172.217.194.0-255,766,95560,63,134770
30608,0.004324,172.217.194.0-255,4320,99880,63,134770
30609,0.004332,172.31.40.0-255,66,99946,63,134770
30610,0.00672,172.217.194.0-255,5738,105684,63,134770
30611,0.006725,172.31.40.0-255,66,105750,63,134770
30612,0.009087,172.217.194.0-255,5738,111488,63,134770
30613,0.009094,172.31.40.0-255,66,111554,63,134770
30614,0.011488,172.217.194.0-255,5738,117292,63,134770
30615,0.011497,172.31.40.0-255,66,117358,63,134770
30616,0.013901,172.217.194.0-255,5738,123096,63,134770
30617,0.01391,172.31.40.0-255,66,123162,63,134770
30618,0.016285,172.217.194.0-255,5738,128900,63,134770
30619,0.016293,172.31.40.0-255,66,128966,63,134770
30620,0.01867,172.217.194.0-255,5738,134704,63,134770
30621,0.018675,172.31.40.0-255,66,134770,63,134770
30622,0.0,74.125.200.0-255,150,150,63,283512
30623,2.5e-05,172.31.40.0-255,66,216,63,283512
30624,3.3e-05,74.125.200.0-255,1484,1700,63,283512
30625,3.8e-05,172.31.40.0-255,66,1766,63,283512
30626,4.3e-05,74.125.200.0-255,2902,4668,63,283512
30627,4.7e-05,172.31.40.0-255,66,4734,63,283512
30628,5.5e-05,74.125.200.0-255,7156,11890,63,283512
30629,5.8e-05,172.31.40.0-255,66,11956,63,283512
30630,6.3e-05,74.125.200.0-255,2157,14113,63,283512
30631,6.6e-05,172.31.40.0-255,66,14179,63,283512
30632,8.8e-05,74.125.200.0-255,2902,17081,63,283512
30633,9.2e-05,172.31.40.0-255,66,17147,63,283512
30634,0.000122,172.31.40.0-255,66,17213,63,283512
30635,0.000128,74.125.200.0-255,5379,22592,63,283512
30636,0.000131,172.31.40.0-255,66,22658,63,283512
30637,0.000167,74.125.200.0-255,1484,24142,63,283512
30638,0.000169,172.31.40.0-255,66,24208,63,283512
30639,0.000188,74.125.200.0-255,2902,27110,63,283512
30640,0.00019,172.31.40.0-255,66,27176,63,283512
30641,0.000201,74.125.200.0-255,1484,28660,63,283512
30642,0.000203,172.31.40.0-255,66,28726,63,283512
30643,0.000219,74.125.200.0-255,2902,31628,63,283512
30644,0.000222,172.31.40.0-255,66,31694,63,283512
30645,0.000227,74.125.200.0-255,4320,36014,63,283512
30646,0.00023,172.31.40.0-255,66,36080,63,283512
30647,0.000246,74.125.200.0-255,1484,37564,63,283512
30648,0.000248,172.31.40.0-255,66,37630,63,283512
30649,0.000264,74.125.200.0-255,2902,40532,63,283512
30650,0.000266,172.31.40.0-255,66,40598,63,283512
30651,0.000307,74.125.200.0-255,2902,43500,63,283512
30652,0.00031,172.31.40.0-255,66,43566,63,283512
30653,0.000327,74.125.200.0-255,1484,45050,63,283512
30654,0.000342,74.125.200.0-255,2902,47952,63,283512
30655,0.000344,172.31.40.0-255,66,48018,63,283512
30656,0.000365,74.125.200.0-255,7156,55174,63,283512
30657,0.000368,172.31.40.0-255,66,55240,63,283512
30658,0.000412,74.125.200.0-255,2184,57424,63,283512
30659,0.000414,172.31.40.0-255,66,57490,63,283512
30660,0.000437,74.125.200.0-255,356,57846,63,283512
30661,0.000477,74.125.200.0-255,136,57982,63,283512
30662,0.000732,74.125.200.0-255,1484,59466,63,283512
30663,0.000737,172.31.40.0-255,66,59532,63,283512
30664,0.000766,74.125.200.0-255,2902,62434,63,283512
30665,0.000768,74.125.200.0-255,1484,63918,63,283512
30666,0.000777,172.31.40.0-255,66,63984,63,283512
30667,0.000783,74.125.200.0-255,2902,66886,63,283512
30668,0.000786,172.31.40.0-255,66,66952,63,283512
30669,0.000866,172.31.40.0-255,66,67018,63,283512
30670,0.000872,74.125.200.0-255,4320,71338,63,283512
30671,0.000874,172.31.40.0-255,66,71404,63,283512
30672,0.000903,74.125.200.0-255,5738,77142,63,283512
30673,0.000905,172.31.40.0-255,66,77208,63,283512
30674,0.000923,74.125.200.0-255,6438,83646,63,283512
30675,0.000927,172.31.40.0-255,66,83712,63,283512
30676,0.001029,74.125.200.0-255,1484,85196,63,283512
30677,0.001044,74.125.200.0-255,2902,88098,63,283512
30678,0.001047,172.31.40.0-255,66,88164,63,283512
30679,0.001052,74.125.200.0-255,2902,91066,63,283512
30680,0.001055,172.31.40.0-255,66,91132,63,283512
30681,0.001068,74.125.200.0-255,2902,94034,63,283512
30682,0.00107,74.125.200.0-255,1484,95518,63,283512
30683,0.001073,172.31.40.0-255,66,95584,63,283512
30684,0.001094,74.125.200.0-255,5738,101322,63,283512
30685,0.001097,172.31.40.0-255,66,101388,63,283512
30686,0.001116,74.125.200.0-255,5738,107126,63,283512
30687,0.001119,172.31.40.0-255,66,107192,63,283512
30688,0.001136,74.125.200.0-255,7156,114348,63,283512
30689,0.00114,172.31.40.0-255,66,114414,63,283512
30690,0.001177,74.125.200.0-255,3602,118016,63,283512
30691,0.00118,172.31.40.0-255,66,118082,63,283512
30692,0.001185,74.125.200.0-255,4320,122402,63,283512
30693,0.001188,172.31.40.0-255,66,122468,63,283512
30694,0.001249,172.31.40.0-255,66,122534,63,283512
30695,0.001263,74.125.200.0-255,2902,125436,63,283512
30696,0.001265,172.31.40.0-255,66,125502,63,283512
30697,0.001286,74.125.200.0-255,7156,132658,63,283512
30698,0.001289,172.31.40.0-255,66,132724,63,283512
30699,0.001302,172.31.40.0-255,66,132790,63,283512
30700,0.001436,74.125.200.0-255,1484,134274,63,283512
30701,0.001441,74.125.200.0-255,2902,137176,63,283512
30702,0.001446,172.31.40.0-255,66,137242,63,283512
30703,0.001472,74.125.200.0-255,5738,142980,63,283512
30704,0.001475,172.31.40.0-255,66,143046,63,283512
30705,0.001479,74.125.200.0-255,2902,145948,63,283512
30706,0.001481,172.31.40.0-255,66,146014,63,283512
30707,0.001509,74.125.200.0-255,7156,153170,63,283512
30708,0.001513,172.31.40.0-255,66,153236,63,283512
30709,0.001534,74.125.200.0-255,2902,156138,63,283512
30710,0.001537,172.31.40.0-255,66,156204,63,283512
30711,0.00155,172.31.40.0-255,66,156270,63,283512
30712,0.001594,74.125.200.0-255,1484,157754,63,283512
30713,0.001607,74.125.200.0-255,2902,160656,63,283512
30714,0.00161,172.31.40.0-255,66,160722,63,283512
30715,0.001615,74.125.200.0-255,2902,163624,63,283512
30716,0.001617,172.31.40.0-255,66,163690,63,283512
30717,0.001643,74.125.200.0-255,4320,168010,63,283512
30718,0.001647,172.31.40.0-255,66,168076,63,283512
30719,0.001671,172.31.40.0-255,66,168142,63,283512
30720,0.001677,74.125.200.0-255,5738,173880,63,283512
30721,0.001679,172.31.40.0-255,66,173946,63,283512
30722,0.001707,74.125.200.0-255,7156,181102,63,283512
30723,0.00171,172.31.40.0-255,66,181168,63,283512
30724,0.001713,74.125.200.0-255,766,181934,63,283512
30725,0.001734,74.125.200.0-255,1484,183418,63,283512
30726,0.001737,172.31.40.0-255,66,183484,63,283512
30727,0.001758,74.125.200.0-255,4320,187804,63,283512
30728,0.001761,172.31.40.0-255,66,187870,63,283512
30729,0.001779,74.125.200.0-255,5738,193608,63,283512
30730,0.001782,172.31.40.0-255,66,193674,63,283512
30731,0.001814,74.125.200.0-255,2902,196576,63,283512
30732,0.001817,172.31.40.0-255,66,196642,63,283512
30733,0.001829,172.31.40.0-255,66,196708,63,283512
30734,0.00184,172.31.40.0-255,66,196774,63,283512
30735,0.001868,172.31.40.0-255,66,196840,63,283512
30736,0.001887,74.125.200.0-255,1484,198324,63,283512
30737,0.001893,74.125.200.0-255,4320,202644,63,283512
30738,0.001895,172.31.40.0-255,66,202710,63,283512
30739,0.001917,74.125.200.0-255,5738,208448,63,283512
30740,0.00192,172.31.40.0-255,66,208514,63,283512
30741,0.001944,74.125.200.0-255,5738,214252,63,283512
30742,0.001947,172.31.40.0-255,66,214318,63,283512
30743,0.001969,74.125.200.0-255,5738,220056,63,283512
30744,0.001972,172.31.40.0-255,66,220122,63,283512
30745,0.001976,74.125.200.0-255,2184,222306,63,283512
30746,0.001978,172.31.40.0-255,66,222372,63,283512
30747,0.001982,74.125.200.0-255,2902,225274,63,283512
30748,0.001985,172.31.40.0-255,66,225340,63,283512
30749,0.001988,74.125.200.0-255,1484,226824,63,283512
30750,0.002009,74.125.200.0-255,2902,229726,63,283512
30751,0.002011,172.31.40.0-255,66,229792,63,283512
30752,0.002019,74.125.200.0-255,7156,236948,63,283512
30753,0.002021,172.31.40.0-255,66,237014,63,283512
30754,0.002044,74.125.200.0-255,1484,238498,63,283512
30755,0.00404,74.125.200.0-255,4320,242818,63,283512
30756,0.004047,172.31.40.0-255,66,242884,63,283512
30757,0.006047,74.125.200.0-255,5738,248622,63,283512
30758,0.006058,172.31.40.0-255,66,248688,63,283512
30759,0.008057,74.125.200.0-255,5738,254426,63,283512
30760,0.00806,172.31.40.0-255,66,254492,63,283512
30761,0.01007,74.125.200.0-255,5738,260230,63,283512
30762,0.010084,172.31.40.0-255,66,260296,63,283512
30763,0.01213,74.125.200.0-255,5738,266034,63,283512
30764,0.012145,172.31.40.0-255,66,266100,63,283512
30765,0.014166,74.125.200.0-255,5738,271838,63,283512
30766,0.014181,172.31.40.0-255,66,271904,63,283512
30767,0.01619,74.125.200.0-255,5738,277642,63,283512
30768,0.016205,172.31.40.0-255,66,277708,63,283512
30769,0.01823,74.125.200.0-255,5738,283446,63,283512
30770,0.018248,172.31.40.0-255,66,283512,63,283512
30771,0.0,172.217.194.0-255,153,153,63,229427
30772,2.5e-05,172.31.40.0-255,66,219,63,229427
30773,3.2e-05,172.217.194.0-255,1484,1703,63,229427
30774,3.6e-05,172.31.40.0-255,66,1769,63,229427
30775,4.3e-05,172.217.194.0-255,2902,4671,63,229427
30776,4.6e-05,172.31.40.0-255,66,4737,63,229427
30777,5.4e-05,172.217.194.0-255,7156,11893,63,229427
30778,5.7e-05,172.31.40.0-255,66,11959,63,229427
30779,8.3e-05,172.217.194.0-255,2018,13977,63,229427
30780,8.6e-05,172.31.40.0-255,66,14043,63,229427
30781,0.000106,172.217.194.0-255,2902,16945,63,229427
30782,0.000108,172.31.40.0-255,66,17011,63,229427
30783,0.000131,172.217.194.0-255,7156,24167,63,229427
30784,0.000133,172.31.40.0-255,66,24233,63,229427
30785,0.000138,172.217.194.0-255,2902,27135,63,229427
30786,0.00014,172.31.40.0-255,66,27201,63,229427
30787,0.000194,172.31.40.0-255,66,27267,63,229427
30788,0.000205,172.31.40.0-255,66,27333,63,229427
30789,0.000662,172.217.194.0-255,1484,28817,63,229427
30790,0.000668,172.31.40.0-255,66,28883,63,229427
30791,0.000674,172.217.194.0-255,2902,31785,63,229427
30792,0.000676,172.31.40.0-255,66,31851,63,229427
30793,0.000683,172.217.194.0-255,5738,37589,63,229427
30794,0.000685,172.31.40.0-255,66,37655,63,229427
30795,0.000692,172.217.194.0-255,5738,43393,63,229427
30796,0.000694,172.31.40.0-255,66,43459,63,229427
30797,0.000739,172.217.194.0-255,4320,47779,63,229427
30798,0.000743,172.31.40.0-255,66,47845,63,229427
30799,0.000777,172.31.40.0-255,66,47911,63,229427
30800,0.00079,172.217.194.0-255,1484,49395,63,229427
30801,0.000806,172.217.194.0-255,5738,55133,63,229427
30802,0.000811,172.31.40.0-255,66,55199,63,229427
30803,0.000839,172.31.40.0-255,66,55265,63,229427
30804,0.000846,172.217.194.0-255,5958,61223,63,229427
30805,0.000848,172.31.40.0-255,66,61289,63,229427
30806,0.001948,172.217.194.0-255,1484,62773,63,229427
30807,0.001961,172.217.194.0-255,2902,65675,63,229427
30808,0.001965,172.31.40.0-255,66,65741,63,229427
30809,0.001972,172.217.194.0-255,2902,68643,63,229427
30810,0.001974,172.31.40.0-255,66,68709,63,229427
30811,0.001989,172.217.194.0-255,2902,71611,63,229427
30812,0.001991,172.31.40.0-255,66,71677,63,229427
30813,0.001996,172.217.194.0-255,2902,74579,63,229427
30814,0.001998,172.31.40.0-255,66,74645,63,229427
30815,0.002022,172.217.194.0-255,7156,81801,63,229427
30816,0.002024,172.31.40.0-255,66,81867,63,229427
30817,0.002041,172.217.194.0-255,2902,84769,63,229427
30818,0.002043,172.31.40.0-255,66,84835,63,229427
30819,0.002048,172.217.194.0-255,2902,87737,63,229427
30820,0.00205,172.31.40.0-255,66,87803,63,229427
30821,0.00207,172.217.194.0-255,4320,92123,63,229427
30822,0.002072,172.31.40.0-255,66,92189,63,229427
30823,0.002091,172.217.194.0-255,2902,95091,63,229427
30824,0.002093,172.31.40.0-255,66,95157,63,229427
30825,0.002096,172.217.194.0-255,766,95923,63,229427
30826,0.002099,172.217.194.0-255,1484,97407,63,229427
30827,0.002101,172.31.40.0-255,66,97473,63,229427
30828,0.002107,172.217.194.0-255,4320,101793,63,229427
30829,0.00211,172.31.40.0-255,66,101859,63,229427
30830,0.002114,172.217.194.0-255,2902,104761,63,229427
30831,0.002116,172.31.40.0-255,66,104827,63,229427
30832,0.002145,172.217.194.0-255,7156,111983,63,229427
30833,0.002148,172.31.40.0-255,66,112049,63,229427
30834,0.00216,172.31.40.0-255,66,112115,63,229427
30835,0.00221,172.217.194.0-255,6438,118553,63,229427
30836,0.002213,172.31.40.0-255,66,118619,63,229427
30837,0.00222,172.217.194.0-255,7156,125775,63,229427
30838,0.002222,172.31.40.0-255,66,125841,63,229427
30839,0.002236,172.31.40.0-255,66,125907,63,229427
30840,0.002261,172.217.194.0-255,4320,130227,63,229427
30841,0.002264,172.31.40.0-255,66,130293,63,229427
30842,0.002277,172.31.40.0-255,66,130359,63,229427
30843,0.002638,172.217.194.0-255,1484,131843,63,229427
30844,0.00266,172.217.194.0-255,2902,134745,63,229427
30845,0.002664,172.31.40.0-255,66,134811,63,229427
30846,0.00267,172.217.194.0-255,2902,137713,63,229427
30847,0.002672,172.31.40.0-255,66,137779,63,229427
30848,0.002686,172.217.194.0-255,2902,140681,63,229427
30849,0.002689,172.31.40.0-255,66,140747,63,229427
30850,0.002706,172.217.194.0-255,2902,143649,63,229427
30851,0.002709,172.31.40.0-255,66,143715,63,229427
30852,0.002736,172.31.40.0-255,66,143781,63,229427
30853,0.002748,172.31.40.0-255,66,143847,63,229427
30854,0.003018,172.217.194.0-255,1484,145331,63,229427
30855,0.003037,172.217.194.0-255,2902,148233,63,229427
30856,0.00304,172.31.40.0-255,66,148299,63,229427
30857,0.003065,172.217.194.0-255,4320,152619,63,229427
30858,0.003067,172.31.40.0-255,66,152685,63,229427
30859,0.003072,172.217.194.0-255,2902,155587,63,229427
30860,0.003074,172.31.40.0-255,66,155653,63,229427
30861,0.003097,172.217.194.0-255,5738,161391,63,229427
30862,0.0031,172.31.40.0-255,66,161457,63,229427
30863,0.003106,172.217.194.0-255,5738,167195,63,229427
30864,0.003109,172.31.40.0-255,66,167261,63,229427
30865,0.003129,172.217.194.0-255,1484,168745,63,229427
30866,0.003162,172.217.194.0-255,2902,171647,63,229427
30867,0.003164,172.31.40.0-255,66,171713,63,229427
30868,0.003187,172.217.194.0-255,6438,178151,63,229427
30869,0.003189,172.31.40.0-255,66,178217,63,229427
30870,0.003221,172.217.194.0-255,4320,182537,63,229427
30871,0.003223,172.31.40.0-255,66,182603,63,229427
30872,0.00323,172.217.194.0-255,5738,188341,63,229427
30873,0.003233,172.31.40.0-255,66,188407,63,229427
30874,0.003246,172.217.194.0-255,2902,191309,63,229427
30875,0.003249,172.31.40.0-255,66,191375,63,229427
30876,0.003283,172.31.40.0-255,66,191441,63,229427
30877,0.003293,172.31.40.0-255,66,191507,63,229427
30878,0.003302,172.217.194.0-255,7156,198663,63,229427
30879,0.003304,172.31.40.0-255,66,198729,63,229427
30880,0.003327,172.31.40.0-255,66,198795,63,229427
30881,0.00333,172.217.194.0-255,1484,200279,63,229427
30882,0.003336,172.217.194.0-255,4320,204599,63,229427
30883,0.003338,172.31.40.0-255,66,204665,63,229427
30884,0.003358,172.217.194.0-255,4320,208985,63,229427
30885,0.003361,172.31.40.0-255,66,209051,63,229427
30886,0.003384,172.31.40.0-255,66,209117,63,229427
30887,0.003434,172.31.40.0-255,66,209183,63,229427
30888,0.003438,172.217.194.0-255,2902,212085,63,229427
30889,0.00344,172.31.40.0-255,66,212151,63,229427
30890,0.003453,172.31.40.0-255,66,212217,63,229427
30891,0.003455,172.217.194.0-255,1484,213701,63,229427
30892,0.003458,172.217.194.0-255,766,214467,63,229427
30893,0.00346,172.31.40.0-255,66,214533,63,229427
30894,0.00353,172.217.194.0-255,1484,216017,63,229427
30895,0.003535,172.217.194.0-255,4320,220337,63,229427
30896,0.003538,172.31.40.0-255,66,220403,63,229427
30897,0.003549,172.31.40.0-255,66,220469,63,229427
30898,0.003556,172.217.194.0-255,7156,227625,63,229427
30899,0.003558,172.31.40.0-255,66,227691,63,229427
30900,0.003569,172.31.40.0-255,66,227757,63,229427
30901,0.003572,172.217.194.0-255,1328,229085,63,229427
30902,0.003593,172.217.194.0-255,105,229190,63,229427
30903,0.00817,172.31.40.0-255,66,229256,63,229427
30904,0.008208,172.31.40.0-255,105,229361,63,229427
30905,0.010797,172.217.194.0-255,66,229427,63,229427
30906,0.0,74.125.24.0-255,146,146,63,191896
30907,2.3e-05,172.31.40.0-255,66,212,63,191896
30908,3.1e-05,74.125.24.0-255,1484,1696,63,191896
30909,3.5e-05,172.31.40.0-255,66,1762,63,191896
30910,4.1e-05,74.125.24.0-255,2902,4664,63,191896
30911,5.3e-05,172.31.40.0-255,66,4730,63,191896
30912,6.1e-05,74.125.24.0-255,7156,11886,63,191896
30913,6.4e-05,172.31.40.0-255,66,11952,63,191896
30914,8.8e-05,74.125.24.0-255,4320,16272,63,191896
30915,9.1e-05,172.31.40.0-255,66,16338,63,191896
30916,0.000124,172.31.40.0-255,66,16404,63,191896
30917,0.000129,74.125.24.0-255,4320,20724,63,191896
30918,0.000132,172.31.40.0-255,66,20790,63,191896
30919,0.000175,74.125.24.0-255,2543,23333,63,191896
30920,0.000178,172.31.40.0-255,66,23399,63,191896
30921,0.000215,74.125.24.0-255,1484,24883,63,191896
30922,0.000218,172.31.40.0-255,66,24949,63,191896
30923,0.000223,74.125.24.0-255,2902,27851,63,191896
30924,0.000225,172.31.40.0-255,66,27917,63,191896
30925,0.000228,74.125.24.0-255,1484,29401,63,191896
30926,0.00023,172.31.40.0-255,66,29467,63,191896
30927,0.000257,74.125.24.0-255,4320,33787,63,191896
30928,0.000264,172.31.40.0-255,66,33853,63,191896
30929,0.000272,74.125.24.0-255,6797,40650,63,191896
30930,0.000275,172.31.40.0-255,66,40716,63,191896
30931,0.000283,74.125.24.0-255,7156,47872,63,191896
30932,0.000288,172.31.40.0-255,66,47938,63,191896
30933,0.000319,74.125.24.0-255,7156,55094,63,191896
30934,0.000326,172.31.40.0-255,66,55160,63,191896
30935,0.000331,74.125.24.0-255,2855,58015,63,191896
30936,0.000333,172.31.40.0-255,66,58081,63,191896
30937,0.000371,74.125.24.0-255,112,58193,63,191896
30938,0.000571,74.125.24.0-255,1484,59677,63,191896
30939,0.000577,172.31.40.0-255,66,59743,63,191896
30940,0.000583,74.125.24.0-255,2902,62645,63,191896
30941,0.000586,172.31.40.0-255,66,62711,63,191896
30942,0.000597,74.125.24.0-255,5738,68449,63,191896
30943,0.0006,172.31.40.0-255,66,68515,63,191896
30944,0.000649,172.31.40.0-255,66,68581,63,191896
30945,0.00066,172.31.40.0-255,66,68647,63,191896
30946,0.000676,74.125.24.0-255,1367,70014,63,191896
30947,0.001124,74.125.24.0-255,1484,71498,63,191896
30948,0.001129,172.31.40.0-255,66,71564,63,191896
30949,0.001134,74.125.24.0-255,2902,74466,63,191896
30950,0.001137,172.31.40.0-255,66,74532,63,191896
30951,0.001161,74.125.24.0-255,2902,77434,63,191896
30952,0.001163,172.31.40.0-255,66,77500,63,191896
30953,0.001191,74.125.24.0-255,2902,80402,63,191896
30954,0.001193,172.31.40.0-255,66,80468,63,191896
30955,0.001207,172.31.40.0-255,66,80534,63,191896
30956,0.001211,74.125.24.0-255,2902,83436,63,191896
30957,0.001214,172.31.40.0-255,66,83502,63,191896
30958,0.001248,172.31.40.0-255,66,83568,63,191896
30959,0.001263,172.31.40.0-255,66,83634,63,191896
30960,0.001314,172.31.40.0-255,66,83700,63,191896
30961,0.001342,74.125.24.0-255,5020,88720,63,191896
30962,0.001345,172.31.40.0-255,66,88786,63,191896
30963,0.001351,74.125.24.0-255,5738,94524,63,191896
30964,0.001353,172.31.40.0-255,66,94590,63,191896
30965,0.00136,74.125.24.0-255,7156,101746,63,191896
30966,0.001368,172.31.40.0-255,66,101812,63,191896
30967,0.001382,172.31.40.0-255,66,101878,63,191896
30968,0.001405,74.125.24.0-255,1484,103362,63,191896
30969,0.001412,74.125.24.0-255,6438,109800,63,191896
30970,0.001419,172.31.40.0-255,66,109866,63,191896
30971,0.001741,74.125.24.0-255,1484,111350,63,191896
30972,0.001748,74.125.24.0-255,2902,114252,63,191896
30973,0.001751,172.31.40.0-255,66,114318,63,191896
30974,0.001758,74.125.24.0-255,5738,120056,63,191896
30975,0.001761,172.31.40.0-255,66,120122,63,191896
30976,0.001848,172.31.40.0-255,66,120188,63,191896
30977,0.001864,172.31.40.0-255,66,120254,63,191896
30978,0.001868,74.125.24.0-255,2184,122438,63,191896
30979,0.00187,172.31.40.0-255,66,122504,63,191896
30980,0.001919,74.125.24.0-255,1484,123988,63,191896
30981,0.001923,74.125.24.0-255,1484,125472,63,191896
30982,0.001925,172.31.40.0-255,66,125538,63,191896
30983,0.001938,74.125.24.0-255,1484,127022,63,191896
30984,0.001948,74.125.24.0-255,5738,132760,63,191896
30985,0.001951,172.31.40.0-255,66,132826,63,191896
30986,0.001957,74.125.24.0-255,4320,137146,63,191896
30987,0.001959,172.31.40.0-255,66,137212,63,191896
30988,0.002007,172.31.40.0-255,66,137278,63,191896
30989,0.002024,172.31.40.0-255,66,137344,63,191896
30990,0.002145,74.125.24.0-255,1484,138828,63,191896
30991,0.002151,74.125.24.0-255,2902,141730,63,191896
30992,0.002153,172.31.40.0-255,66,141796,63,191896
30993,0.002173,74.125.24.0-255,5738,147534,63,191896
30994,0.002176,172.31.40.0-255,66,147600,63,191896
30995,0.002182,74.125.24.0-255,7156,154756,63,191896
30996,0.002184,172.31.40.0-255,66,154822,63,191896
30997,0.00223,74.125.24.0-255,2184,157006,63,191896
30998,0.005732,172.31.40.0-255,66,157072,63,191896
30999,0.008008,74.125.24.0-255,5738,162810,63,191896
31000,0.008015,172.31.40.0-255,66,162876,63,191896
31001,0.010287,74.125.24.0-255,5738,168614,63,191896
31002,0.010294,172.31.40.0-255,66,168680,63,191896
31003,0.012573,74.125.24.0-255,5738,174418,63,191896
31004,0.012581,172.31.40.0-255,66,174484,63,191896
31005,0.014861,74.125.24.0-255,5738,180222,63,191896
31006,0.01487,172.31.40.0-255,66,180288,63,191896
31007,0.017146,74.125.24.0-255,5738,186026,63,191896
31008,0.017154,172.31.40.0-255,66,186092,63,191896
31009,0.019459,74.125.24.0-255,5738,191830,63,191896
31010,0.019477,172.31.40.0-255,66,191896,63,191896
31011,0.0,74.125.24.0-255,152,152,63,274615
31012,1.5e-05,172.31.40.0-255,66,218,63,274615
31013,2.1e-05,74.125.24.0-255,1484,1702,63,274615
31014,2.5e-05,172.31.40.0-255,66,1768,63,274615
31015,2.8e-05,74.125.24.0-255,1484,3252,63,274615
31016,3e-05,172.31.40.0-255,66,3318,63,274615
31017,5.3e-05,74.125.24.0-255,1484,4802,63,274615
31018,5.6e-05,172.31.40.0-255,66,4868,63,274615
31019,8.1e-05,74.125.24.0-255,4320,9188,63,274615
31020,8.6e-05,172.31.40.0-255,66,9254,63,274615
31021,9.2e-05,74.125.24.0-255,4900,14154,63,274615
31022,9.4e-05,172.31.40.0-255,66,14220,63,274615
31023,0.000189,74.125.24.0-255,1484,15704,63,274615
31024,0.000192,172.31.40.0-255,66,15770,63,274615
31025,0.000197,74.125.24.0-255,2902,18672,63,274615
31026,0.000198,172.31.40.0-255,66,18738,63,274615
31027,0.000228,74.125.24.0-255,5738,24476,63,274615
31028,0.000231,172.31.40.0-255,66,24542,63,274615
31029,0.000235,74.125.24.0-255,4320,28862,63,274615
31030,0.000237,172.31.40.0-255,66,28928,63,274615
31031,0.000254,74.125.24.0-255,2543,31471,63,274615
31032,0.000257,172.31.40.0-255,66,31537,63,274615
31033,0.000313,172.31.40.0-255,66,31603,63,274615
31034,0.000317,74.125.24.0-255,2543,34146,63,274615
31035,0.000319,172.31.40.0-255,66,34212,63,274615
31036,0.000352,74.125.24.0-255,1484,35696,63,274615
31037,0.000354,172.31.40.0-255,66,35762,63,274615
31038,0.000385,74.125.24.0-255,2902,38664,63,274615
31039,0.000388,172.31.40.0-255,66,38730,63,274615
31040,0.000393,74.125.24.0-255,5738,44468,63,274615
31041,0.000395,172.31.40.0-255,66,44534,63,274615
31042,0.000399,74.125.24.0-255,2902,47436,63,274615
31043,0.000401,172.31.40.0-255,66,47502,63,274615
31044,0.00041,74.125.24.0-255,4235,51737,63,274615
31045,0.000413,74.125.24.0-255,135,51872,63,274615
31046,0.000417,172.31.40.0-255,66,51938,63,274615
31047,0.000489,74.125.24.0-255,1484,53422,63,274615
31048,0.000492,172.31.40.0-255,66,53488,63,274615
31049,0.000517,74.125.24.0-255,2902,56390,63,274615
31050,0.00052,172.31.40.0-255,66,56456,63,274615
31051,0.000527,74.125.24.0-255,5738,62194,63,274615
31052,0.000529,172.31.40.0-255,66,62260,63,274615
31053,0.000551,74.125.24.0-255,1484,63744,63,274615
31054,0.000571,74.125.24.0-255,2902,66646,63,274615
31055,0.000574,172.31.40.0-255,66,66712,63,274615
31056,0.000599,74.125.24.0-255,2543,69255,63,274615
31057,0.000602,172.31.40.0-255,66,69321,63,274615
31058,0.000628,74.125.24.0-255,2902,72223,63,274615
31059,0.000631,172.31.40.0-255,66,72289,63,274615
31060,0.000659,74.125.24.0-255,4320,76609,63,274615
31061,0.000662,172.31.40.0-255,66,76675,63,274615
31062,0.00067,74.125.24.0-255,7156,83831,63,274615
31063,0.000673,172.31.40.0-255,66,83897,63,274615
31064,0.000702,74.125.24.0-255,1484,85381,63,274615
31065,0.000714,172.31.40.0-255,66,85447,63,274615
31066,0.000739,74.125.24.0-255,2902,88349,63,274615
31067,0.000741,172.31.40.0-255,66,88415,63,274615
31068,0.000771,74.125.24.0-255,5379,93794,63,274615
31069,0.000773,172.31.40.0-255,66,93860,63,274615
31070,0.000828,74.125.24.0-255,1484,95344,63,274615
31071,0.000834,74.125.24.0-255,2902,98246,63,274615
31072,0.000837,172.31.40.0-255,66,98312,63,274615
31073,0.000841,74.125.24.0-255,2902,101214,63,274615
31074,0.000843,172.31.40.0-255,66,101280,63,274615
31075,0.000863,74.125.24.0-255,2902,104182,63,274615
31076,0.000866,172.31.40.0-255,66,104248,63,274615
31077,0.000872,74.125.24.0-255,5738,109986,63,274615
31078,0.000875,172.31.40.0-255,66,110052,63,274615
31079,0.000903,74.125.24.0-255,7156,117208,63,274615
31080,0.000906,172.31.40.0-255,66,117274,63,274615
31081,0.000919,172.31.40.0-255,66,117340,63,274615
31082,0.001165,74.125.24.0-255,1484,118824,63,274615
31083,0.001188,74.125.24.0-255,2902,121726,63,274615
31084,0.001191,172.31.40.0-255,66,121792,63,274615
31085,0.001211,74.125.24.0-255,4320,126112,63,274615
31086,0.001214,172.31.40.0-255,66,126178,63,274615
31087,0.001232,74.125.24.0-255,1484,127662,63,274615
31088,0.001248,74.125.24.0-255,4320,131982,63,274615
31089,0.00125,172.31.40.0-255,66,132048,63,274615
31090,0.001263,172.31.40.0-255,66,132114,63,274615
31091,0.001271,74.125.24.0-255,2902,135016,63,274615
31092,0.001273,172.31.40.0-255,66,135082,63,274615
31093,0.001331,74.125.24.0-255,5020,140102,63,274615
31094,0.001333,172.31.40.0-255,66,140168,63,274615
31095,0.001361,74.125.24.0-255,1484,141652,63,274615
31096,0.001365,74.125.24.0-255,1484,143136,63,274615
31097,0.001368,172.31.40.0-255,66,143202,63,274615
31098,0.001395,74.125.24.0-255,1484,144686,63,274615
31099,0.001403,74.125.24.0-255,5738,150424,63,274615
31100,0.001405,172.31.40.0-255,66,150490,63,274615
31101,0.001448,172.31.40.0-255,66,150556,63,274615
31102,0.001456,74.125.24.0-255,7156,157712,63,274615
31103,0.001458,172.31.40.0-255,66,157778,63,274615
31104,0.001486,74.125.24.0-255,3602,161380,63,274615
31105,0.00149,172.31.40.0-255,66,161446,63,274615
31106,0.001616,74.125.24.0-255,1484,162930,63,274615
31107,0.001629,74.125.24.0-255,2902,165832,63,274615
31108,0.001632,172.31.40.0-255,66,165898,63,274615
31109,0.001665,74.125.24.0-255,5738,171636,63,274615
31110,0.001668,172.31.40.0-255,66,171702,63,274615
31111,0.00167,74.125.24.0-255,1484,173186,63,274615
31112,0.001676,74.125.24.0-255,5738,178924,63,274615
31113,0.001677,172.31.40.0-255,66,178990,63,274615
31114,0.001698,74.125.24.0-255,2902,181892,63,274615
31115,0.0017,172.31.40.0-255,66,181958,63,274615
31116,0.001736,172.31.40.0-255,66,182024,63,274615
31117,0.00176,74.125.24.0-255,766,182790,63,274615
31118,0.001836,74.125.24.0-255,1484,184274,63,274615
31119,0.001839,172.31.40.0-255,66,184340,63,274615
31120,0.001844,74.125.24.0-255,2902,187242,63,274615
31121,0.001845,172.31.40.0-255,66,187308,63,274615
31122,0.00185,74.125.24.0-255,4320,191628,63,274615
31123,0.001852,172.31.40.0-255,66,191694,63,274615
31124,0.001875,74.125.24.0-255,1484,193178,63,274615
31125,0.001881,74.125.24.0-255,4320,197498,63,274615
31126,0.001883,172.31.40.0-255,66,197564,63,274615
31127,0.001898,74.125.24.0-255,2902,200466,63,274615
31128,0.0019,172.31.40.0-255,66,200532,63,274615
31129,0.00194,172.31.40.0-255,66,200598,63,274615
31130,0.001944,74.125.24.0-255,2902,203500,63,274615
31131,0.001946,172.31.40.0-255,66,203566,63,274615
31132,0.001976,74.125.24.0-255,4320,207886,63,274615
31133,0.001982,172.31.40.0-255,66,207952,63,274615
31134,0.001985,74.125.24.0-255,766,208718,63,274615
31135,0.001988,74.125.24.0-255,1484,210202,63,274615
31136,0.001989,172.31.40.0-255,66,210268,63,274615
31137,0.001994,74.125.24.0-255,4320,214588,63,274615
31138,0.001996,172.31.40.0-255,66,214654,63,274615
31139,0.002028,172.31.40.0-255,66,214720,63,274615
31140,0.002031,74.125.24.0-255,1484,216204,63,274615
31141,0.002036,74.125.24.0-255,4320,220524,63,274615
31142,0.002038,172.31.40.0-255,66,220590,63,274615
31143,0.002069,172.31.40.0-255,66,220656,63,274615
31144,0.002074,74.125.24.0-255,3602,224258,63,274615
31145,0.002076,172.31.40.0-255,66,224324,63,274615
31146,0.002121,74.125.24.0-255,1484,225808,63,274615
31147,0.002126,74.125.24.0-255,2902,228710,63,274615
31148,0.002128,172.31.40.0-255,66,228776,63,274615
31149,0.002157,74.125.24.0-255,5738,234514,63,274615
31150,0.002159,172.31.40.0-255,66,234580,63,274615
31151,0.002165,74.125.24.0-255,5738,240318,63,274615
31152,0.002167,172.31.40.0-255,66,240384,63,274615
31153,0.002194,74.125.24.0-255,7156,247540,63,274615
31154,0.002197,172.31.40.0-255,66,247606,63,274615
31155,0.002222,74.125.24.0-255,5738,253344,63,274615
31156,0.002224,172.31.40.0-255,66,253410,63,274615
31157,0.002252,74.125.24.0-255,5020,258430,63,274615
31158,0.002255,172.31.40.0-255,66,258496,63,274615
31159,0.002283,74.125.24.0-255,7156,265652,63,274615
31160,0.002285,172.31.40.0-255,66,265718,63,274615
31161,0.002295,172.31.40.0-255,66,265784,63,274615
31162,0.002364,172.31.40.0-255,66,265850,63,274615
31163,0.002367,74.125.24.0-255,766,266616,63,274615
31164,0.002382,74.125.24.0-255,4320,270936,63,274615
31165,0.002387,172.31.40.0-255,66,271002,63,274615
31166,0.002413,172.31.40.0-255,66,271068,63,274615
31167,0.002442,74.125.24.0-255,2344,273412,63,274615
31168,0.002444,172.31.40.0-255,66,273478,63,274615
31169,0.002447,74.125.24.0-255,105,273583,63,274615
31170,0.002449,74.125.24.0-255,129,273712,63,274615
31171,0.012588,172.31.40.0-255,105,273817,63,274615
31172,0.012636,172.31.40.0-255,105,273922,63,274615
31173,0.012892,172.31.40.0-255,90,274012,63,274615
31174,0.012902,172.31.40.0-255,66,274078,63,274615
31175,0.014241,74.125.24.0-255,129,274207,63,274615
31176,0.014255,172.31.40.0-255,78,274285,63,274615
31177,0.015032,74.125.24.0-255,66,274351,63,274615
31178,0.01509,74.125.24.0-255,66,274417,63,274615
31179,0.015351,74.125.24.0-255,66,274483,63,274615
31180,0.015371,74.125.24.0-255,66,274549,63,274615
31181,0.015377,172.31.40.0-255,66,274615,63,274615
31182,0.0,216.58.221.0-255,152,152,63,195428
31183,2.3e-05,172.31.40.0-255,66,218,63,195428
31184,3e-05,216.58.221.0-255,1484,1702,63,195428
31185,3.6e-05,172.31.40.0-255,66,1768,63,195428
31186,4.2e-05,216.58.221.0-255,2902,4670,63,195428
31187,4.6e-05,172.31.40.0-255,66,4736,63,195428
31188,5.4e-05,216.58.221.0-255,7156,11892,63,195428
31189,5.7e-05,172.31.40.0-255,66,11958,63,195428
31190,6e-05,216.58.221.0-255,2034,13992,63,195428
31191,6.4e-05,172.31.40.0-255,66,14058,63,195428
31192,0.000104,216.58.221.0-255,2902,16960,63,195428
31193,0.000107,172.31.40.0-255,66,17026,63,195428
31194,0.000111,216.58.221.0-255,2902,19928,63,195428
31195,0.000113,172.31.40.0-255,66,19994,63,195428
31196,0.000128,216.58.221.0-255,1484,21478,63,195428
31197,0.00013,172.31.40.0-255,66,21544,63,195428
31198,0.000142,172.31.40.0-255,66,21610,63,195428
31199,0.000145,216.58.221.0-255,1125,22735,63,195428
31200,0.000147,172.31.40.0-255,66,22801,63,195428
31201,0.000368,216.58.221.0-255,1484,24285,63,195428
31202,0.000373,172.31.40.0-255,66,24351,63,195428
31203,0.000379,216.58.221.0-255,2902,27253,63,195428
31204,0.000381,172.31.40.0-255,66,27319,63,195428
31205,0.000388,216.58.221.0-255,5738,33057,63,195428
31206,0.00039,172.31.40.0-255,66,33123,63,195428
31207,0.00043,216.58.221.0-255,6797,39920,63,195428
31208,0.000433,172.31.40.0-255,66,39986,63,195428
31209,0.00084,216.58.221.0-255,1484,41470,63,195428
31210,0.000845,172.31.40.0-255,66,41536,63,195428
31211,0.000851,216.58.221.0-255,2902,44438,63,195428
31212,0.000853,172.31.40.0-255,66,44504,63,195428
31213,0.000859,216.58.221.0-255,4320,48824,63,195428
31214,0.000861,172.31.40.0-255,66,48890,63,195428
31215,0.000891,216.58.221.0-255,1484,50374,63,195428
31216,0.000896,216.58.221.0-255,2902,53276,63,195428
31217,0.000899,172.31.40.0-255,66,53342,63,195428
31218,0.000904,216.58.221.0-255,3961,57303,63,195428
31219,0.000906,172.31.40.0-255,66,57369,63,195428
31220,0.000909,216.58.221.0-255,362,57731,63,195428
31221,0.001067,172.31.40.0-255,66,57797,63,195428
31222,0.001298,216.58.221.0-255,131,57928,63,195428
31223,0.001406,216.58.221.0-255,1484,59412,63,195428
31224,0.001412,172.31.40.0-255,66,59478,63,195428
31225,0.001418,216.58.221.0-255,2902,62380,63,195428
31226,0.00142,172.31.40.0-255,66,62446,63,195428
31227,0.001426,216.58.221.0-255,4320,66766,63,195428
31228,0.001428,172.31.40.0-255,66,66832,63,195428
31229,0.001452,216.58.221.0-255,1484,68316,63,195428
31230,0.001458,216.58.221.0-255,4320,72636,63,195428
31231,0.00146,172.31.40.0-255,66,72702,63,195428
31232,0.001499,172.31.40.0-255,66,72768,63,195428
31233,0.001504,216.58.221.0-255,4320,77088,63,195428
31234,0.001506,172.31.40.0-255,66,77154,63,195428
31235,0.001522,216.58.221.0-255,4320,81474,63,195428
31236,0.001524,172.31.40.0-255,66,81540,63,195428
31237,0.00154,216.58.221.0-255,2543,84083,63,195428
31238,0.001543,172.31.40.0-255,66,84149,63,195428
31239,0.001601,216.58.221.0-255,1484,85633,63,195428
31240,0.001605,216.58.221.0-255,1484,87117,63,195428
31241,0.001608,172.31.40.0-255,66,87183,63,195428
31242,0.001627,216.58.221.0-255,1484,88667,63,195428
31243,0.001634,216.58.221.0-255,5738,94405,63,195428
31244,0.001636,172.31.40.0-255,66,94471,63,195428
31245,0.001643,216.58.221.0-255,5738,100209,63,195428
31246,0.001645,172.31.40.0-255,66,100275,63,195428
31247,0.001656,216.58.221.0-255,709,100984,63,195428
31248,0.001705,216.58.221.0-255,1484,102468,63,195428
31249,0.001708,172.31.40.0-255,66,102534,63,195428
31250,0.001712,216.58.221.0-255,1484,104018,63,195428
31251,0.001728,216.58.221.0-255,1484,105502,63,195428
31252,0.00173,172.31.40.0-255,66,105568,63,195428
31253,0.001737,216.58.221.0-255,5738,111306,63,195428
31254,0.00174,172.31.40.0-255,66,111372,63,195428
31255,0.001745,216.58.221.0-255,5738,117110,63,195428
31256,0.001748,172.31.40.0-255,66,117176,63,195428
31257,0.001789,216.58.221.0-255,1572,118748,63,195428
31258,0.001792,172.31.40.0-255,66,118814,63,195428
31259,0.00184,216.58.221.0-255,1484,120298,63,195428
31260,0.001846,216.58.221.0-255,2902,123200,63,195428
31261,0.001849,172.31.40.0-255,66,123266,63,195428
31262,0.001865,216.58.221.0-255,5738,129004,63,195428
31263,0.001868,172.31.40.0-255,66,129070,63,195428
31264,0.001894,216.58.221.0-255,7156,136226,63,195428
31265,0.001897,172.31.40.0-255,66,136292,63,195428
31266,0.001921,216.58.221.0-255,5738,142030,63,195428
31267,0.001924,172.31.40.0-255,66,142096,63,195428
31268,0.001935,172.31.40.0-255,66,142162,63,195428
31269,0.001939,216.58.221.0-255,2184,144346,63,195428
31270,0.001942,172.31.40.0-255,66,144412,63,195428
31271,0.003823,216.58.221.0-255,5738,150150,63,195428
31272,0.00383,172.31.40.0-255,66,150216,63,195428
31273,0.00573,216.58.221.0-255,5738,155954,63,195428
31274,0.005737,172.31.40.0-255,66,156020,63,195428
31275,0.007637,216.58.221.0-255,4320,160340,63,195428
31276,0.007642,172.31.40.0-255,66,160406,63,195428
31277,0.00766,216.58.221.0-255,1484,161890,63,195428
31278,0.009532,216.58.221.0-255,4320,166210,63,195428
31279,0.009539,172.31.40.0-255,66,166276,63,195428
31280,0.011437,216.58.221.0-255,5738,172014,63,195428
31281,0.011445,172.31.40.0-255,66,172080,63,195428
31282,0.013343,216.58.221.0-255,5738,177818,63,195428
31283,0.01335,172.31.40.0-255,66,177884,63,195428
31284,0.015249,216.58.221.0-255,5738,183622,63,195428
31285,0.015258,172.31.40.0-255,66,183688,63,195428
31286,0.017159,216.58.221.0-255,5738,189426,63,195428
31287,0.017167,172.31.40.0-255,66,189492,63,195428
31288,0.019058,216.58.221.0-255,2902,192394,63,195428
31289,0.019063,172.31.40.0-255,66,192460,63,195428
31290,0.019083,216.58.221.0-255,2902,195362,63,195428
31291,0.019085,172.31.40.0-255,66,195428,63,195428
31292,0.0,74.125.24.0-255,153,153,63,69364
31293,2.3e-05,172.31.40.0-255,66,219,63,69364
31294,3e-05,74.125.24.0-255,1484,1703,63,69364
31295,3.6e-05,172.31.40.0-255,66,1769,63,69364
31296,5e-05,74.125.24.0-255,2902,4671,63,69364
31297,5.4e-05,172.31.40.0-255,66,4737,63,69364
31298,6.2e-05,74.125.24.0-255,7156,11893,63,69364
31299,6.6e-05,172.31.40.0-255,66,11959,63,69364
31300,0.000181,172.31.40.0-255,66,12025,63,69364
31301,0.000207,172.31.40.0-255,66,12091,63,69364
31302,0.000416,74.125.24.0-255,2543,14634,63,69364
31303,0.000421,172.31.40.0-255,66,14700,63,69364
31304,0.000473,74.125.24.0-255,2902,17602,63,69364
31305,0.000476,172.31.40.0-255,66,17668,63,69364
31306,0.000522,172.31.40.0-255,66,17734,63,69364
31307,0.000786,172.31.40.0-255,66,17800,63,69364
31308,0.000812,74.125.24.0-255,2543,20343,63,69364
31309,0.000819,172.31.40.0-255,66,20409,63,69364
31310,0.000942,74.125.24.0-255,709,21118,63,69364
31311,0.000947,172.31.40.0-255,66,21184,63,69364
31312,0.000973,74.125.24.0-255,4320,25504,63,69364
31313,0.000976,172.31.40.0-255,66,25570,63,69364
31314,0.001012,172.31.40.0-255,66,25636,63,69364
31315,0.00123,172.31.40.0-255,66,25702,63,69364
31316,0.001257,172.31.40.0-255,66,25768,63,69364
31317,0.001494,74.125.24.0-255,7156,32924,63,69364
31318,0.001498,172.31.40.0-255,66,32990,63,69364
31319,0.001545,172.31.40.0-255,66,33056,63,69364
31320,0.001824,74.125.24.0-255,7156,40212,63,69364
31321,0.00183,172.31.40.0-255,66,40278,63,69364
31322,0.003416,74.125.24.0-255,5738,46016,63,69364
31323,0.008752,172.31.40.0-255,66,46082,63,69364
31324,0.011122,74.125.24.0-255,5738,51820,63,69364
31325,0.011129,172.31.40.0-255,66,51886,63,69364
31326,0.013486,74.125.24.0-255,5738,57624,63,69364
31327,0.013495,172.31.40.0-255,66,57690,63,69364
31328,0.015832,74.125.24.0-255,5738,63428,63,69364
31329,0.015839,172.31.40.0-255,66,63494,63,69364
31330,0.018242,74.125.24.0-255,4320,67814,63,69364
31331,0.01825,172.31.40.0-255,66,67880,63,69364
31332,0.018279,74.125.24.0-255,1484,69364,63,69364
31333,0.0,172.31.40.0-255,105,105,63,276
31334,0.00179,157.240.24.0-255,105,210,63,276
31335,0.001802,172.31.40.0-255,66,276,63,276
31336,0.0,172.217.194.0-255,152,152,63,185623
31337,1.8e-05,172.31.40.0-255,66,218,63,185623
31338,2.5e-05,172.217.194.0-255,1484,1702,63,185623
31339,2.9e-05,172.31.40.0-255,66,1768,63,185623
31340,3.4e-05,172.217.194.0-255,2902,4670,63,185623
31341,3.7e-05,172.31.40.0-255,66,4736,63,185623
31342,6.3e-05,172.217.194.0-255,5738,10474,63,185623
31343,6.6e-05,172.31.40.0-255,66,10540,63,185623
31344,0.000101,172.217.194.0-255,3467,14007,63,185623
31345,0.000103,172.31.40.0-255,66,14073,63,185623
31346,0.000188,172.217.194.0-255,1484,15557,63,185623
31347,0.000192,172.31.40.0-255,66,15623,63,185623
31348,0.000227,172.217.194.0-255,2902,18525,63,185623
31349,0.00023,172.31.40.0-255,66,18591,63,185623
31350,0.000236,172.217.194.0-255,5738,24329,63,185623
31351,0.000238,172.31.40.0-255,66,24395,63,185623
31352,0.000269,172.217.194.0-255,6797,31192,63,185623
31353,0.000272,172.31.40.0-255,66,31258,63,185623
31354,0.00028,172.217.194.0-255,7156,38414,63,185623
31355,0.000282,172.31.40.0-255,66,38480,63,185623
31356,0.000303,172.217.194.0-255,2902,41382,63,185623
31357,0.000306,172.31.40.0-255,66,41448,63,185623
31358,0.000322,172.217.194.0-255,6797,48245,63,185623
31359,0.000324,172.31.40.0-255,66,48311,63,185623
31360,0.000349,172.217.194.0-255,1484,49795,63,185623
31361,0.000351,172.31.40.0-255,66,49861,63,185623
31362,0.000373,172.217.194.0-255,5738,55599,63,185623
31363,0.000375,172.31.40.0-255,66,55665,63,185623
31364,0.000381,172.217.194.0-255,5738,61403,63,185623
31365,0.000383,172.31.40.0-255,66,61469,63,185623
31366,0.000404,172.217.194.0-255,2902,64371,63,185623
31367,0.000406,172.31.40.0-255,66,64437,63,185623
31368,0.000408,172.217.194.0-255,1400,65837,63,185623
31369,0.000518,172.217.194.0-255,117,65954,63,185623
31370,0.000622,172.217.194.0-255,1484,67438,63,185623
31371,0.000627,172.31.40.0-255,66,67504,63,185623
31372,0.000632,172.217.194.0-255,2902,70406,63,185623
31373,0.000635,172.31.40.0-255,66,70472,63,185623
31374,0.000639,172.217.194.0-255,2902,73374,63,185623
31375,0.000641,172.31.40.0-255,66,73440,63,185623
31376,0.000663,172.217.194.0-255,2902,76342,63,185623
31377,0.000665,172.31.40.0-255,66,76408,63,185623
31378,0.000671,172.217.194.0-255,5738,82146,63,185623
31379,0.000673,172.31.40.0-255,66,82212,63,185623
31380,0.000747,172.217.194.0-255,4320,86532,63,185623
31381,0.000751,172.31.40.0-255,66,86598,63,185623
31382,0.000781,172.31.40.0-255,66,86664,63,185623
31383,0.000787,172.217.194.0-255,3961,90625,63,185623
31384,0.000789,172.31.40.0-255,66,90691,63,185623
31385,0.001378,172.217.194.0-255,1484,92175,63,185623
31386,0.001386,172.217.194.0-255,2902,95077,63,185623
31387,0.00139,172.31.40.0-255,66,95143,63,185623
31388,0.001395,172.217.194.0-255,2902,98045,63,185623
31389,0.001397,172.31.40.0-255,66,98111,63,185623
31390,0.001411,172.217.194.0-255,2902,101013,63,185623
31391,0.001413,172.31.40.0-255,66,101079,63,185623
31392,0.001416,172.217.194.0-255,1484,102563,63,185623
31393,0.001442,172.31.40.0-255,66,102629,63,185623
31394,0.001454,172.217.194.0-255,1484,104113,63,185623
31395,0.001488,172.31.40.0-255,66,104179,63,185623
31396,0.001495,172.217.194.0-255,7156,111335,63,185623
31397,0.001497,172.31.40.0-255,66,111401,63,185623
31398,0.001525,172.217.194.0-255,7156,118557,63,185623
31399,0.001528,172.31.40.0-255,66,118623,63,185623
31400,0.001541,172.31.40.0-255,66,118689,63,185623
31401,0.001571,172.217.194.0-255,4320,123009,63,185623
31402,0.001574,172.31.40.0-255,66,123075,63,185623
31403,0.001619,172.31.40.0-255,66,123141,63,185623
31404,0.001645,172.217.194.0-255,5020,128161,63,185623
31405,0.001647,172.31.40.0-255,66,128227,63,185623
31406,0.001664,172.31.40.0-255,66,128293,63,185623
31407,0.001668,172.217.194.0-255,2184,130477,63,185623
31408,0.00167,172.31.40.0-255,66,130543,63,185623
31409,0.001675,172.217.194.0-255,4320,134863,63,185623
31410,0.001678,172.31.40.0-255,66,134929,63,185623
31411,0.001683,172.217.194.0-255,5738,140667,63,185623
31412,0.001686,172.31.40.0-255,66,140733,63,185623
31413,0.001691,172.217.194.0-255,4320,145053,63,185623
31414,0.001693,172.31.40.0-255,66,145119,63,185623
31415,0.00172,172.217.194.0-255,7156,152275,63,185623
31416,0.001723,172.31.40.0-255,66,152341,63,185623
31417,0.001735,172.217.194.0-255,2902,155243,63,185623
31418,0.001737,172.31.40.0-255,66,155309,63,185623
31419,0.001761,172.31.40.0-255,66,155375,63,185623
31420,0.002205,172.217.194.0-255,1484,156859,63,185623
31421,0.002208,172.217.194.0-255,1484,158343,63,185623
31422,0.002215,172.31.40.0-255,66,158409,63,185623
31423,0.002226,172.217.194.0-255,2902,161311,63,185623
31424,0.002228,172.31.40.0-255,66,161377,63,185623
31425,0.002234,172.217.194.0-255,5738,167115,63,185623
31426,0.002236,172.31.40.0-255,66,167181,63,185623
31427,0.0023,172.31.40.0-255,66,167247,63,185623
31428,0.002323,172.217.194.0-255,7156,174403,63,185623
31429,0.002368,172.217.194.0-255,5020,179423,63,185623
31430,0.011582,172.217.194.0-255,1484,180907,63,185623
31431,0.016863,172.31.40.0-255,66,180973,63,185623
31432,0.016874,172.31.40.0-255,66,181039,63,185623
31433,0.016878,172.31.40.0-255,66,181105,63,185623
31434,0.016894,172.31.40.0-255,66,181171,63,185623
31435,0.016898,172.31.40.0-255,66,181237,63,185623
31436,0.019235,172.217.194.0-255,4320,185557,63,185623
31437,0.019245,172.31.40.0-255,66,185623,63,185623
31438,0.0,74.125.24.0-255,153,153,63,194971
31439,2e-05,172.31.40.0-255,66,219,63,194971
31440,2.6e-05,74.125.24.0-255,1484,1703,63,194971
31441,3e-05,172.31.40.0-255,66,1769,63,194971
31442,3.4e-05,74.125.24.0-255,2902,4671,63,194971
31443,4.6e-05,172.31.40.0-255,66,4737,63,194971
31444,5.2e-05,74.125.24.0-255,5738,10475,63,194971
31445,5.5e-05,172.31.40.0-255,66,10541,63,194971
31446,8.8e-05,74.125.24.0-255,3447,13988,63,194971
31447,9.1e-05,172.31.40.0-255,66,14054,63,194971
31448,0.000116,74.125.24.0-255,4320,18374,63,194971
31449,0.000119,172.31.40.0-255,66,18440,63,194971
31450,0.000142,74.125.24.0-255,4320,22760,63,194971
31451,0.000144,172.31.40.0-255,66,22826,63,194971
31452,0.00017,74.125.24.0-255,5738,28564,63,194971
31453,0.000172,172.31.40.0-255,66,28630,63,194971
31454,0.000248,172.31.40.0-255,66,28696,63,194971
31455,0.000275,74.125.24.0-255,5738,34434,63,194971
31456,0.000277,172.31.40.0-255,66,34500,63,194971
31457,0.000361,74.125.24.0-255,3602,38102,63,194971
31458,0.000364,172.31.40.0-255,66,38168,63,194971
31459,0.00039,74.125.24.0-255,4320,42488,63,194971
31460,0.000392,172.31.40.0-255,66,42554,63,194971
31461,0.000429,172.31.40.0-255,66,42620,63,194971
31462,0.000512,74.125.24.0-255,343,42963,63,194971
31463,0.000515,172.31.40.0-255,66,43029,63,194971
31464,0.000701,74.125.24.0-255,1484,44513,63,194971
31465,0.000705,172.31.40.0-255,66,44579,63,194971
31466,0.00072,74.125.24.0-255,2902,47481,63,194971
31467,0.000725,172.31.40.0-255,66,47547,63,194971
31468,0.00073,74.125.24.0-255,4320,51867,63,194971
31469,0.000733,172.31.40.0-255,66,51933,63,194971
31470,0.000769,172.31.40.0-255,66,51999,63,194971
31471,0.000839,74.125.24.0-255,5738,57737,63,194971
31472,0.000843,172.31.40.0-255,66,57803,63,194971
31473,0.000859,74.125.24.0-255,2902,60705,63,194971
31474,0.000861,172.31.40.0-255,66,60771,63,194971
31475,0.000906,74.125.24.0-255,5738,66509,63,194971
31476,0.000909,172.31.40.0-255,66,66575,63,194971
31477,0.000947,74.125.24.0-255,2184,68759,63,194971
31478,0.00095,172.31.40.0-255,66,68825,63,194971
31479,0.001136,74.125.24.0-255,1484,70309,63,194971
31480,0.001142,74.125.24.0-255,2902,73211,63,194971
31481,0.001145,172.31.40.0-255,66,73277,63,194971
31482,0.001165,74.125.24.0-255,5738,79015,63,194971
31483,0.001167,172.31.40.0-255,66,79081,63,194971
31484,0.001208,74.125.24.0-255,5738,84819,63,194971
31485,0.001211,172.31.40.0-255,66,84885,63,194971
31486,0.001231,74.125.24.0-255,7156,92041,63,194971
31487,0.001233,172.31.40.0-255,66,92107,63,194971
31488,0.001313,74.125.24.0-255,4320,96427,63,194971
31489,0.001316,172.31.40.0-255,66,96493,63,194971
31490,0.001343,74.125.24.0-255,6438,102931,63,194971
31491,0.001345,172.31.40.0-255,66,102997,63,194971
31492,0.001408,74.125.24.0-255,5738,108735,63,194971
31493,0.001412,172.31.40.0-255,66,108801,63,194971
31494,0.001437,74.125.24.0-255,5738,114539,63,194971
31495,0.001439,172.31.40.0-255,66,114605,63,194971
31496,0.001536,172.31.40.0-255,66,114671,63,194971
31497,0.001706,74.125.24.0-255,5738,120409,63,194971
31498,0.00171,172.31.40.0-255,66,120475,63,194971
31499,0.00176,74.125.24.0-255,4320,124795,63,194971
31500,0.001763,172.31.40.0-255,66,124861,63,194971
31501,0.001789,74.125.24.0-255,5738,130599,63,194971
31502,0.001791,172.31.40.0-255,66,130665,63,194971
31503,0.001833,172.31.40.0-255,66,130731,63,194971
31504,0.002018,172.31.40.0-255,66,130797,63,194971
31505,0.002043,172.31.40.0-255,66,130863,63,194971
31506,0.002075,172.31.40.0-255,66,130929,63,194971
31507,0.00234,74.125.24.0-255,4320,135249,63,194971
31508,0.002344,172.31.40.0-255,66,135315,63,194971
31509,0.002385,172.31.40.0-255,66,135381,63,194971
31510,0.002541,74.125.24.0-255,5738,141119,63,194971
31511,0.002546,172.31.40.0-255,66,141185,63,194971
31512,0.002594,172.31.40.0-255,66,141251,63,194971
31513,0.002748,74.125.24.0-255,7156,148407,63,194971
31514,0.002752,172.31.40.0-255,66,148473,63,194971
31515,0.002808,172.31.40.0-255,66,148539,63,194971
31516,0.004855,74.125.24.0-255,5738,154277,63,194971
31517,0.004874,172.31.40.0-255,66,154343,63,194971
31518,0.006945,74.125.24.0-255,5738,160081,63,194971
31519,0.006961,172.31.40.0-255,66,160147,63,194971
31520,0.009004,74.125.24.0-255,5738,165885,63,194971
31521,0.009019,172.31.40.0-255,66,165951,63,194971
31522,0.01109,74.125.24.0-255,5738,171689,63,194971
31523,0.011101,172.31.40.0-255,66,171755,63,194971
31524,0.013143,74.125.24.0-255,5738,177493,63,194971
31525,0.013147,172.31.40.0-255,66,177559,63,194971
31526,0.015194,74.125.24.0-255,5738,183297,63,194971
31527,0.015201,172.31.40.0-255,66,183363,63,194971
31528,0.017245,74.125.24.0-255,5738,189101,63,194971
31529,0.017253,172.31.40.0-255,66,189167,63,194971
31530,0.019305,74.125.24.0-255,5738,194905,63,194971
31531,0.019312,172.31.40.0-255,66,194971,63,194971
31532,0.0,172.217.194.0-255,152,152,63,211078
31533,2.2e-05,172.31.40.0-255,66,218,63,211078
31534,2.8e-05,172.217.194.0-255,1484,1702,63,211078
31535,3.3e-05,172.31.40.0-255,66,1768,63,211078
31536,3.8e-05,172.217.194.0-255,2902,4670,63,211078
31537,4.1e-05,172.31.40.0-255,66,4736,63,211078
31538,4.8e-05,172.217.194.0-255,5738,10474,63,211078
31539,5.1e-05,172.31.40.0-255,66,10540,63,211078
31540,8.6e-05,172.217.194.0-255,6354,16894,63,211078
31541,8.9e-05,172.31.40.0-255,66,16960,63,211078
31542,0.000116,172.217.194.0-255,2902,19862,63,211078
31543,0.000118,172.31.40.0-255,66,19928,63,211078
31544,0.000143,172.217.194.0-255,5738,25666,63,211078
31545,0.000146,172.31.40.0-255,66,25732,63,211078
31546,0.000152,172.217.194.0-255,5379,31111,63,211078
31547,0.000154,172.31.40.0-255,66,31177,63,211078
31548,0.000193,172.217.194.0-255,1484,32661,63,211078
31549,0.000196,172.31.40.0-255,66,32727,63,211078
31550,0.000201,172.217.194.0-255,2902,35629,63,211078
31551,0.000203,172.31.40.0-255,66,35695,63,211078
31552,0.000208,172.217.194.0-255,4320,40015,63,211078
31553,0.00021,172.31.40.0-255,66,40081,63,211078
31554,0.000225,172.217.194.0-255,1484,41565,63,211078
31555,0.000228,172.31.40.0-255,66,41631,63,211078
31556,0.000247,172.217.194.0-255,5738,47369,63,211078
31557,0.000249,172.31.40.0-255,66,47435,63,211078
31558,0.000273,172.31.40.0-255,66,47501,63,211078
31559,0.000296,172.217.194.0-255,5738,53239,63,211078
31560,0.000299,172.31.40.0-255,66,53305,63,211078
31561,0.000317,172.217.194.0-255,2902,56207,63,211078
31562,0.000319,172.31.40.0-255,66,56273,63,211078
31563,0.000336,172.217.194.0-255,1418,57691,63,211078
31564,0.000371,172.217.194.0-255,363,58054,63,211078
31565,0.000439,172.217.194.0-255,1484,59538,63,211078
31566,0.000445,172.217.194.0-255,2902,62440,63,211078
31567,0.000467,172.217.194.0-255,5738,68178,63,211078
31568,0.000482,172.217.194.0-255,4320,72498,63,211078
31569,0.000506,172.217.194.0-255,4320,76818,63,211078
31570,0.000523,172.217.194.0-255,5738,82556,63,211078
31571,0.000554,172.217.194.0-255,3602,86158,63,211078
31572,0.00056,172.217.194.0-255,4320,90478,63,211078
31573,0.000566,172.31.40.0-255,66,90544,63,211078
31574,0.000597,172.217.194.0-255,1484,92028,63,211078
31575,0.000612,172.31.40.0-255,66,92094,63,211078
31576,0.000661,172.31.40.0-255,66,92160,63,211078
31577,0.000679,172.217.194.0-255,5738,97898,63,211078
31578,0.000692,172.217.194.0-255,1484,99382,63,211078
31579,0.000711,172.217.194.0-255,3602,102984,63,211078
31580,0.00072,172.31.40.0-255,66,103050,63,211078
31581,0.000749,172.217.194.0-255,1484,104534,63,211078
31582,0.000755,172.217.194.0-255,2902,107436,63,211078
31583,0.000766,172.217.194.0-255,1484,108920,63,211078
31584,0.000782,172.217.194.0-255,4320,113240,63,211078
31585,0.000789,172.31.40.0-255,66,113306,63,211078
31586,0.000801,172.217.194.0-255,7156,120462,63,211078
31587,0.000818,172.217.194.0-255,5738,126200,63,211078
31588,0.000834,172.31.40.0-255,66,126266,63,211078
31589,0.000852,172.217.194.0-255,1484,127750,63,211078
31590,0.00092,172.31.40.0-255,66,127816,63,211078
31591,0.00093,172.217.194.0-255,1484,129300,63,211078
31592,0.000935,172.217.194.0-255,2902,132202,63,211078
31593,0.000941,172.217.194.0-255,5738,137940,63,211078
31594,0.000944,172.217.194.0-255,1484,139424,63,211078
31595,0.000961,172.217.194.0-255,4320,143744,63,211078
31596,0.000981,172.217.194.0-255,7156,150900,63,211078
31597,0.000987,172.31.40.0-255,66,150966,63,211078
31598,0.001,172.217.194.0-255,5738,156704,63,211078
31599,0.001006,172.217.194.0-255,4320,161024,63,211078
31600,0.001021,172.217.194.0-255,766,161790,63,211078
31601,0.001031,172.31.40.0-255,66,161856,63,211078
31602,0.001173,172.217.194.0-255,1484,163340,63,211078
31603,0.001179,172.217.194.0-255,2902,166242,63,211078
31604,0.001185,172.31.40.0-255,66,166308,63,211078
31605,0.001209,172.217.194.0-255,5738,172046,63,211078
31606,0.001215,172.217.194.0-255,4320,176366,63,211078
31607,0.001221,172.31.40.0-255,66,176432,63,211078
31608,0.001278,172.31.40.0-255,66,176498,63,211078
31609,0.001282,172.31.40.0-255,66,176564,63,211078
31610,0.001297,172.217.194.0-255,6438,183002,63,211078
31611,0.001303,172.217.194.0-255,5738,188740,63,211078
31612,0.001322,172.31.40.0-255,66,188806,63,211078
31613,0.001347,172.31.40.0-255,66,188872,63,211078
31614,0.001382,172.217.194.0-255,5738,194610,63,211078
31615,0.001398,172.31.40.0-255,66,194676,63,211078
31616,0.00142,172.217.194.0-255,7156,201832,63,211078
31617,0.001426,172.31.40.0-255,66,201898,63,211078
31618,0.001474,172.31.40.0-255,66,201964,63,211078
31619,0.001496,172.217.194.0-255,5738,207702,63,211078
31620,0.001501,172.31.40.0-255,66,207768,63,211078
31621,0.001538,172.217.194.0-255,2902,210670,63,211078
31622,0.001554,172.31.40.0-255,66,210736,63,211078
31623,0.001575,172.217.194.0-255,105,210841,63,211078
31624,0.00162,172.31.40.0-255,66,210907,63,211078
31625,0.013767,172.31.40.0-255,105,211012,63,211078
31626,0.01603,172.217.194.0-255,66,211078,63,211078
31627,0.0,74.125.24.0-255,292,292,63,149468
31628,1.6e-05,172.31.40.0-255,66,358,63,149468
31629,2.1e-05,74.125.24.0-255,1484,1842,63,149468
31630,2.5e-05,172.31.40.0-255,66,1908,63,149468
31631,4.7e-05,74.125.24.0-255,4320,6228,63,149468
31632,5e-05,172.31.40.0-255,66,6294,63,149468
31633,7.3e-05,74.125.24.0-255,5738,12032,63,149468
31634,7.6e-05,172.31.40.0-255,66,12098,63,149468
31635,9.4e-05,74.125.24.0-255,1802,13900,63,149468
31636,9.6e-05,172.31.40.0-255,66,13966,63,149468
31637,0.000319,74.125.24.0-255,1484,15450,63,149468
31638,0.000323,172.31.40.0-255,66,15516,63,149468
31639,0.000329,74.125.24.0-255,2902,18418,63,149468
31640,0.000332,172.31.40.0-255,66,18484,63,149468
31641,0.000338,74.125.24.0-255,5738,24222,63,149468
31642,0.000341,172.31.40.0-255,66,24288,63,149468
31643,0.000372,74.125.24.0-255,6797,31085,63,149468
31644,0.000375,172.31.40.0-255,66,31151,63,149468
31645,0.000431,74.125.24.0-255,1484,32635,63,149468
31646,0.000434,172.31.40.0-255,66,32701,63,149468
31647,0.000448,74.125.24.0-255,2902,35603,63,149468
31648,0.00045,172.31.40.0-255,66,35669,63,149468
31649,0.000456,74.125.24.0-255,5738,41407,63,149468
31650,0.000459,172.31.40.0-255,66,41473,63,149468
31651,0.000485,74.125.24.0-255,7156,48629,63,149468
31652,0.00049,172.31.40.0-255,66,48695,63,149468
31653,0.00051,74.125.24.0-255,6797,55492,63,149468
31654,0.000514,172.31.40.0-255,66,55558,63,149468
31655,0.000525,172.31.40.0-255,66,55624,63,149468
31656,0.000547,74.125.24.0-255,400,56024,63,149468
31657,0.000549,172.31.40.0-255,66,56090,63,149468
31658,0.000563,74.125.24.0-255,110,56200,63,149468
31659,0.00074,74.125.24.0-255,330,56530,63,149468
31660,0.001021,172.31.40.0-255,66,56596,63,149468
31661,0.001276,74.125.24.0-255,1484,58080,63,149468
31662,0.001287,74.125.24.0-255,2902,60982,63,149468
31663,0.001291,172.31.40.0-255,66,61048,63,149468
31664,0.001317,74.125.24.0-255,5738,66786,63,149468
31665,0.00132,172.31.40.0-255,66,66852,63,149468
31666,0.001325,74.125.24.0-255,4320,71172,63,149468
31667,0.001328,172.31.40.0-255,66,71238,63,149468
31668,0.00137,172.31.40.0-255,66,71304,63,149468
31669,0.001381,172.31.40.0-255,66,71370,63,149468
31670,0.00158,74.125.24.0-255,1484,72854,63,149468
31671,0.001588,74.125.24.0-255,2902,75756,63,149468
31672,0.001593,172.31.40.0-255,66,75822,63,149468
31673,0.0016,74.125.24.0-255,5738,81560,63,149468
31674,0.001602,172.31.40.0-255,66,81626,63,149468
31675,0.001608,74.125.24.0-255,2902,84528,63,149468
31676,0.00161,172.31.40.0-255,66,84594,63,149468
31677,0.001642,172.31.40.0-255,66,84660,63,149468
31678,0.001655,172.31.40.0-255,66,84726,63,149468
31679,0.001658,74.125.24.0-255,766,85492,63,149468
31680,0.00202,74.125.24.0-255,1484,86976,63,149468
31681,0.002026,172.31.40.0-255,66,87042,63,149468
31682,0.002034,74.125.24.0-255,2902,89944,63,149468
31683,0.002037,172.31.40.0-255,66,90010,63,149468
31684,0.002043,74.125.24.0-255,5738,95748,63,149468
31685,0.002046,172.31.40.0-255,66,95814,63,149468
31686,0.002079,74.125.24.0-255,7156,102970,63,149468
31687,0.002083,172.31.40.0-255,66,103036,63,149468
31688,0.004138,74.125.24.0-255,5738,108774,63,149468
31689,0.004144,172.31.40.0-255,66,108840,63,149468
31690,0.006159,74.125.24.0-255,5738,114578,63,149468
31691,0.006166,172.31.40.0-255,66,114644,63,149468
31692,0.00818,74.125.24.0-255,5738,120382,63,149468
31693,0.008184,172.31.40.0-255,66,120448,63,149468
31694,0.01021,74.125.24.0-255,5738,126186,63,149468
31695,0.010217,172.31.40.0-255,66,126252,63,149468
31696,0.012241,74.125.24.0-255,5738,131990,63,149468
31697,0.012249,172.31.40.0-255,66,132056,63,149468
31698,0.014262,74.125.24.0-255,5738,137794,63,149468
31699,0.014271,172.31.40.0-255,66,137860,63,149468
31700,0.016291,74.125.24.0-255,5738,143598,63,149468
31701,0.016301,172.31.40.0-255,66,143664,63,149468
31702,0.018362,74.125.24.0-255,5738,149402,63,149468
31703,0.018371,172.31.40.0-255,66,149468,63,149468
31704,0.0,172.217.160.0-255,152,152,63,162346
31705,2e-05,172.31.40.0-255,66,218,63,162346
31706,2.7e-05,172.217.160.0-255,1484,1702,63,162346
31707,3.2e-05,172.31.40.0-255,66,1768,63,162346
31708,4.4e-05,172.217.160.0-255,2902,4670,63,162346
31709,4.7e-05,172.31.40.0-255,66,4736,63,162346
31710,5.4e-05,172.217.160.0-255,5738,10474,63,162346
31711,5.8e-05,172.31.40.0-255,66,10540,63,162346
31712,0.000105,172.217.160.0-255,3517,14057,63,162346
31713,0.000108,172.31.40.0-255,66,14123,63,162346
31714,0.000144,172.217.160.0-255,4320,18443,63,162346
31715,0.000148,172.31.40.0-255,66,18509,63,162346
31716,0.000181,172.217.160.0-255,5738,24247,63,162346
31717,0.000183,172.31.40.0-255,66,24313,63,162346
31718,0.000202,172.217.160.0-255,4320,28633,63,162346
31719,0.000205,172.31.40.0-255,66,28699,63,162346
31720,0.000285,172.217.160.0-255,2543,31242,63,162346
31721,0.000288,172.31.40.0-255,66,31308,63,162346
31722,0.00032,172.217.160.0-255,7156,38464,63,162346
31723,0.000323,172.31.40.0-255,66,38530,63,162346
31724,0.000388,172.217.160.0-255,4320,42850,63,162346
31725,0.000392,172.31.40.0-255,66,42916,63,162346
31726,0.00042,172.217.160.0-255,5379,48295,63,162346
31727,0.000423,172.31.40.0-255,66,48361,63,162346
31728,0.000496,172.31.40.0-255,66,48427,63,162346
31729,0.000578,172.217.160.0-255,4320,52747,63,162346
31730,0.000582,172.31.40.0-255,66,52813,63,162346
31731,0.000601,172.217.160.0-255,2851,55664,63,162346
31732,0.000603,172.31.40.0-255,66,55730,63,162346
31733,0.000974,172.217.160.0-255,102,55832,63,162346
31734,0.00098,172.31.40.0-255,66,55898,63,162346
31735,0.001043,172.217.160.0-255,1484,57382,63,162346
31736,0.001065,172.217.160.0-255,2902,60284,63,162346
31737,0.001088,172.217.160.0-255,2902,63186,63,162346
31738,0.001093,172.31.40.0-255,66,63252,63,162346
31739,0.001104,172.217.160.0-255,1484,64736,63,162346
31740,0.001122,172.217.160.0-255,5738,70474,63,162346
31741,0.001133,172.31.40.0-255,66,70540,63,162346
31742,0.001181,172.217.160.0-255,2543,73083,63,162346
31743,0.001184,172.31.40.0-255,66,73149,63,162346
31744,0.001214,172.217.160.0-255,2902,76051,63,162346
31745,0.001219,172.31.40.0-255,66,76117,63,162346
31746,0.001233,172.217.160.0-255,7156,83273,63,162346
31747,0.001257,172.31.40.0-255,66,83339,63,162346
31748,0.001303,172.217.160.0-255,5738,89077,63,162346
31749,0.001309,172.31.40.0-255,66,89143,63,162346
31750,0.001317,172.217.160.0-255,1125,90268,63,162346
31751,0.001365,172.217.160.0-255,4320,94588,63,162346
31752,0.00137,172.31.40.0-255,66,94654,63,162346
31753,0.001379,172.217.160.0-255,2902,97556,63,162346
31754,0.001401,172.31.40.0-255,66,97622,63,162346
31755,0.001457,172.217.160.0-255,5738,103360,63,162346
31756,0.001468,172.31.40.0-255,66,103426,63,162346
31757,0.001491,172.31.40.0-255,66,103492,63,162346
31758,0.001498,172.217.160.0-255,1484,104976,63,162346
31759,0.001623,172.31.40.0-255,66,105042,63,162346
31760,0.00165,172.217.160.0-255,2184,107226,63,162346
31761,0.001662,172.31.40.0-255,66,107292,63,162346
31762,0.001714,172.217.160.0-255,5738,113030,63,162346
31763,0.001726,172.31.40.0-255,66,113096,63,162346
31764,0.001788,172.31.40.0-255,66,113162,63,162346
31765,0.002003,172.217.160.0-255,5020,118182,63,162346
31766,0.002007,172.31.40.0-255,66,118248,63,162346
31767,0.002286,172.217.160.0-255,4320,122568,63,162346
31768,0.002306,172.217.160.0-255,6438,129006,63,162346
31769,0.00239,172.217.160.0-255,4320,133326,63,162346
31770,0.006078,172.31.40.0-255,66,133392,63,162346
31771,0.008012,172.217.160.0-255,5738,139130,63,162346
31772,0.008018,172.31.40.0-255,66,139196,63,162346
31773,0.00995,172.217.160.0-255,5738,144934,63,162346
31774,0.009957,172.31.40.0-255,66,145000,63,162346
31775,0.011892,172.217.160.0-255,5738,150738,63,162346
31776,0.012887,172.31.40.0-255,66,150804,63,162346
31777,0.01483,172.217.160.0-255,5738,156542,63,162346
31778,0.014836,172.31.40.0-255,66,156608,63,162346
31779,0.016785,172.217.160.0-255,5738,162346,63,162346
31780,0.0,74.125.68.0-255,146,146,63,329538
31781,2.2e-05,172.31.40.0-255,66,212,63,329538
31782,3e-05,74.125.68.0-255,1484,1696,63,329538
31783,3.4e-05,172.31.40.0-255,66,1762,63,329538
31784,4e-05,74.125.68.0-255,2902,4664,63,329538
31785,4.3e-05,172.31.40.0-255,66,4730,63,329538
31786,4.9e-05,74.125.68.0-255,5738,10468,63,329538
31787,5.3e-05,172.31.40.0-255,66,10534,63,329538
31788,5.8e-05,74.125.68.0-255,3386,13920,63,329538
31789,6.1e-05,172.31.40.0-255,66,13986,63,329538
31790,8.2e-05,74.125.68.0-255,4320,18306,63,329538
31791,8.5e-05,172.31.40.0-255,66,18372,63,329538
31792,0.000117,172.31.40.0-255,66,18438,63,329538
31793,0.000157,74.125.68.0-255,2543,20981,63,329538
31794,0.00016,172.31.40.0-255,66,21047,63,329538
31795,0.000262,74.125.68.0-255,1484,22531,63,329538
31796,0.000267,172.31.40.0-255,66,22597,63,329538
31797,0.000272,74.125.68.0-255,2902,25499,63,329538
31798,0.000274,172.31.40.0-255,66,25565,63,329538
31799,0.000309,74.125.68.0-255,4320,29885,63,329538
31800,0.000312,172.31.40.0-255,66,29951,63,329538
31801,0.000327,74.125.68.0-255,1484,31435,63,329538
31802,0.000329,172.31.40.0-255,66,31501,63,329538
31803,0.000332,74.125.68.0-255,1484,32985,63,329538
31804,0.000334,172.31.40.0-255,66,33051,63,329538
31805,0.000338,74.125.68.0-255,2902,35953,63,329538
31806,0.00034,172.31.40.0-255,66,36019,63,329538
31807,0.000376,74.125.68.0-255,3961,39980,63,329538
31808,0.000378,172.31.40.0-255,66,40046,63,329538
31809,0.000398,74.125.68.0-255,4320,44366,63,329538
31810,0.000401,172.31.40.0-255,66,44432,63,329538
31811,0.000419,74.125.68.0-255,2902,47334,63,329538
31812,0.000422,172.31.40.0-255,66,47400,63,329538
31813,0.000439,74.125.68.0-255,2902,50302,63,329538
31814,0.000442,172.31.40.0-255,66,50368,63,329538
31815,0.000479,74.125.68.0-255,4320,54688,63,329538
31816,0.000482,172.31.40.0-255,66,54754,63,329538
31817,0.0005,74.125.68.0-255,1396,56150,63,329538
31818,0.000503,74.125.68.0-255,386,56536,63,329538
31819,0.000505,172.31.40.0-255,66,56602,63,329538
31820,0.000682,74.125.68.0-255,1484,58086,63,329538
31821,0.000696,74.125.68.0-255,2902,60988,63,329538
31822,0.0007,172.31.40.0-255,66,61054,63,329538
31823,0.000735,74.125.68.0-255,5738,66792,63,329538
31824,0.000737,172.31.40.0-255,66,66858,63,329538
31825,0.00077,74.125.68.0-255,7156,74014,63,329538
31826,0.000772,172.31.40.0-255,66,74080,63,329538
31827,0.000775,74.125.68.0-255,1484,75564,63,329538
31828,0.000791,74.125.68.0-255,1484,77048,63,329538
31829,0.000793,172.31.40.0-255,66,77114,63,329538
31830,0.000796,74.125.68.0-255,1484,78598,63,329538
31831,0.000812,74.125.68.0-255,1484,80082,63,329538
31832,0.000814,172.31.40.0-255,66,80148,63,329538
31833,0.000818,74.125.68.0-255,1484,81632,63,329538
31834,0.000834,74.125.68.0-255,4320,85952,63,329538
31835,0.000837,172.31.40.0-255,66,86018,63,329538
31836,0.000862,74.125.68.0-255,5020,91038,63,329538
31837,0.000866,172.31.40.0-255,66,91104,63,329538
31838,0.000945,74.125.68.0-255,1484,92588,63,329538
31839,0.000949,74.125.68.0-255,1484,94072,63,329538
31840,0.000953,172.31.40.0-255,66,94138,63,329538
31841,0.000967,74.125.68.0-255,1484,95622,63,329538
31842,0.000981,74.125.68.0-255,5738,101360,63,329538
31843,0.000983,172.31.40.0-255,66,101426,63,329538
31844,0.001004,74.125.68.0-255,5738,107164,63,329538
31845,0.001007,172.31.40.0-255,66,107230,63,329538
31846,0.001022,74.125.68.0-255,2902,110132,63,329538
31847,0.001024,172.31.40.0-255,66,110198,63,329538
31848,0.001042,74.125.68.0-255,4320,114518,63,329538
31849,0.001045,172.31.40.0-255,66,114584,63,329538
31850,0.00105,74.125.68.0-255,4320,118904,63,329538
31851,0.001052,172.31.40.0-255,66,118970,63,329538
31852,0.001078,74.125.68.0-255,6438,125408,63,329538
31853,0.00108,172.31.40.0-255,66,125474,63,329538
31854,0.001154,74.125.68.0-255,1484,126958,63,329538
31855,0.00117,74.125.68.0-255,2902,129860,63,329538
31856,0.001178,172.31.40.0-255,66,129926,63,329538
31857,0.001182,74.125.68.0-255,1484,131410,63,329538
31858,0.001201,74.125.68.0-255,4320,135730,63,329538
31859,0.001204,172.31.40.0-255,66,135796,63,329538
31860,0.001208,74.125.68.0-255,2902,138698,63,329538
31861,0.00121,172.31.40.0-255,66,138764,63,329538
31862,0.001215,74.125.68.0-255,4320,143084,63,329538
31863,0.001217,172.31.40.0-255,66,143150,63,329538
31864,0.001241,74.125.68.0-255,5738,148888,63,329538
31865,0.001244,172.31.40.0-255,66,148954,63,329538
31866,0.001266,74.125.68.0-255,2902,151856,63,329538
31867,0.001269,172.31.40.0-255,66,151922,63,329538
31868,0.001274,74.125.68.0-255,4320,156242,63,329538
31869,0.001277,172.31.40.0-255,66,156308,63,329538
31870,0.001308,74.125.68.0-255,1484,157792,63,329538
31871,0.00132,74.125.68.0-255,2184,159976,63,329538
31872,0.001322,172.31.40.0-255,66,160042,63,329538
31873,0.001365,74.125.68.0-255,1484,161526,63,329538
31874,0.001378,74.125.68.0-255,2902,164428,63,329538
31875,0.00138,172.31.40.0-255,66,164494,63,329538
31876,0.001384,74.125.68.0-255,1484,165978,63,329538
31877,0.0014,74.125.68.0-255,2902,168880,63,329538
31878,0.001402,172.31.40.0-255,66,168946,63,329538
31879,0.001464,74.125.68.0-255,1484,170430,63,329538
31880,0.001469,74.125.68.0-255,2902,173332,63,329538
31881,0.001471,172.31.40.0-255,66,173398,63,329538
31882,0.001477,74.125.68.0-255,4320,177718,63,329538
31883,0.001479,172.31.40.0-255,66,177784,63,329538
31884,0.00149,172.31.40.0-255,66,177850,63,329538
31885,0.001497,74.125.68.0-255,7156,185006,63,329538
31886,0.001499,172.31.40.0-255,66,185072,63,329538
31887,0.001502,74.125.68.0-255,766,185838,63,329538
31888,0.001522,74.125.68.0-255,1484,187322,63,329538
31889,0.001525,172.31.40.0-255,66,187388,63,329538
31890,0.001548,74.125.68.0-255,1484,188872,63,329538
31891,0.001565,74.125.68.0-255,2902,191774,63,329538
31892,0.001568,172.31.40.0-255,66,191840,63,329538
31893,0.001574,74.125.68.0-255,4320,196160,63,329538
31894,0.001576,172.31.40.0-255,66,196226,63,329538
31895,0.001582,74.125.68.0-255,5738,201964,63,329538
31896,0.001584,172.31.40.0-255,66,202030,63,329538
31897,0.001606,74.125.68.0-255,4320,206350,63,329538
31898,0.001608,172.31.40.0-255,66,206416,63,329538
31899,0.001638,74.125.68.0-255,7156,213572,63,329538
31900,0.001642,172.31.40.0-255,66,213638,63,329538
31901,0.001647,74.125.68.0-255,4320,217958,63,329538
31902,0.001648,172.31.40.0-255,66,218024,63,329538
31903,0.001716,172.31.40.0-255,66,218090,63,329538
31904,0.001728,172.31.40.0-255,66,218156,63,329538
31905,0.001758,74.125.68.0-255,4320,222476,63,329538
31906,0.001761,172.31.40.0-255,66,222542,63,329538
31907,0.001767,74.125.68.0-255,5020,227562,63,329538
31908,0.001769,172.31.40.0-255,66,227628,63,329538
31909,0.00179,74.125.68.0-255,1484,229112,63,329538
31910,0.001793,74.125.68.0-255,1484,230596,63,329538
31911,0.001796,172.31.40.0-255,66,230662,63,329538
31912,0.001816,74.125.68.0-255,1484,232146,63,329538
31913,0.001823,74.125.68.0-255,5738,237884,63,329538
31914,0.001825,172.31.40.0-255,66,237950,63,329538
31915,0.001832,74.125.68.0-255,5738,243688,63,329538
31916,0.001834,172.31.40.0-255,66,243754,63,329538
31917,0.001854,74.125.68.0-255,4320,248074,63,329538
31918,0.001857,172.31.40.0-255,66,248140,63,329538
31919,0.001876,172.31.40.0-255,66,248206,63,329538
31920,0.001882,74.125.68.0-255,5020,253226,63,329538
31921,0.001885,172.31.40.0-255,66,253292,63,329538
31922,0.001985,74.125.68.0-255,1484,254776,63,329538
31923,0.001998,74.125.68.0-255,2902,257678,63,329538
31924,0.002001,172.31.40.0-255,66,257744,63,329538
31925,0.002025,74.125.68.0-255,5738,263482,63,329538
31926,0.002028,172.31.40.0-255,66,263548,63,329538
31927,0.002032,74.125.68.0-255,2902,266450,63,329538
31928,0.002034,172.31.40.0-255,66,266516,63,329538
31929,0.002049,74.125.68.0-255,2902,269418,63,329538
31930,0.002051,172.31.40.0-255,66,269484,63,329538
31931,0.002054,74.125.68.0-255,1484,270968,63,329538
31932,0.002058,74.125.68.0-255,2902,273870,63,329538
31933,0.00206,172.31.40.0-255,66,273936,63,329538
31934,0.002082,74.125.68.0-255,1484,275420,63,329538
31935,0.002085,74.125.68.0-255,1484,276904,63,329538
31936,0.002088,172.31.40.0-255,66,276970,63,329538
31937,0.002092,74.125.68.0-255,2902,279872,63,329538
31938,0.002094,172.31.40.0-255,66,279938,63,329538
31939,0.002107,74.125.68.0-255,2902,282840,63,329538
31940,0.00211,172.31.40.0-255,66,282906,63,329538
31941,0.002131,74.125.68.0-255,5020,287926,63,329538
31942,0.002134,172.31.40.0-255,66,287992,63,329538
31943,0.00214,74.125.68.0-255,7156,295148,63,329538
31944,0.002142,172.31.40.0-255,66,295214,63,329538
31945,0.002181,172.31.40.0-255,66,295280,63,329538
31946,0.002186,74.125.68.0-255,2902,298182,63,329538
31947,0.002188,172.31.40.0-255,66,298248,63,329538
31948,0.002205,74.125.68.0-255,5738,303986,63,329538
31949,0.002208,172.31.40.0-255,66,304052,63,329538
31950,0.002215,74.125.68.0-255,6438,310490,63,329538
31951,0.002217,172.31.40.0-255,66,310556,63,329538
31952,0.002244,74.125.68.0-255,5738,316294,63,329538
31953,0.002247,172.31.40.0-255,66,316360,63,329538
31954,0.002269,74.125.68.0-255,4320,320680,63,329538
31955,0.002272,172.31.40.0-255,66,320746,63,329538
31956,0.002298,172.31.40.0-255,66,320812,63,329538
31957,0.002301,74.125.68.0-255,1484,322296,63,329538
31958,0.002305,74.125.68.0-255,1484,323780,63,329538
31959,0.002307,172.31.40.0-255,66,323846,63,329538
31960,0.00233,74.125.68.0-255,2902,326748,63,329538
31961,0.002333,172.31.40.0-255,66,326814,63,329538
31962,0.002363,172.31.40.0-255,66,326880,63,329538
31963,0.002366,74.125.68.0-255,1484,328364,63,329538
31964,0.002369,74.125.68.0-255,669,329033,63,329538
31965,0.00237,172.31.40.0-255,66,329099,63,329538
31966,0.002373,74.125.68.0-255,97,329196,63,329538
31967,0.002402,74.125.68.0-255,105,329301,63,329538
31968,0.004677,172.31.40.0-255,66,329367,63,329538
31969,0.004709,172.31.40.0-255,105,329472,63,329538
31970,0.006694,74.125.68.0-255,66,329538,63,329538
31971,0.0,74.125.68.0-255,153,153,63,196380
31972,2.1e-05,172.31.40.0-255,66,219,63,196380
31973,2.8e-05,74.125.68.0-255,1484,1703,63,196380
31974,3.3e-05,172.31.40.0-255,66,1769,63,196380
31975,3.6e-05,74.125.68.0-255,1484,3253,63,196380
31976,4.5e-05,172.31.40.0-255,66,3319,63,196380
31977,5.1e-05,74.125.68.0-255,2902,6221,63,196380
31978,5.5e-05,172.31.40.0-255,66,6287,63,196380
31979,6e-05,74.125.68.0-255,4320,10607,63,196380
31980,6.3e-05,172.31.40.0-255,66,10673,63,196380
31981,9.1e-05,74.125.68.0-255,1484,12157,63,196380
31982,9.3e-05,172.31.40.0-255,66,12223,63,196380
31983,9.8e-05,74.125.68.0-255,2102,14325,63,196380
31984,0.0001,172.31.40.0-255,66,14391,63,196380
31985,0.000159,74.125.68.0-255,1484,15875,63,196380
31986,0.000161,172.31.40.0-255,66,15941,63,196380
31987,0.000178,74.125.68.0-255,2902,18843,63,196380
31988,0.00018,172.31.40.0-255,66,18909,63,196380
31989,0.000183,74.125.68.0-255,1484,20393,63,196380
31990,0.000185,172.31.40.0-255,66,20459,63,196380
31991,0.00021,74.125.68.0-255,2902,23361,63,196380
31992,0.000212,172.31.40.0-255,66,23427,63,196380
31993,0.000234,74.125.68.0-255,2902,26329,63,196380
31994,0.000236,172.31.40.0-255,66,26395,63,196380
31995,0.000262,74.125.68.0-255,4320,30715,63,196380
31996,0.000265,172.31.40.0-255,66,30781,63,196380
31997,0.000268,74.125.68.0-255,1125,31906,63,196380
31998,0.000269,172.31.40.0-255,66,31972,63,196380
31999,0.000299,74.125.68.0-255,1484,33456,63,196380
32000,0.000301,172.31.40.0-255,66,33522,63,196380
32001,0.000332,74.125.68.0-255,4320,37842,63,196380
32002,0.000334,172.31.40.0-255,66,37908,63,196380
32003,0.000338,74.125.68.0-255,2902,40810,63,196380
32004,0.00034,172.31.40.0-255,66,40876,63,196380
32005,0.000343,74.125.68.0-255,1484,42360,63,196380
32006,0.00037,74.125.68.0-255,2902,45262,63,196380
32007,0.000373,172.31.40.0-255,66,45328,63,196380
32008,0.000378,74.125.68.0-255,3961,49289,63,196380
32009,0.00038,172.31.40.0-255,66,49355,63,196380
32010,0.000618,74.125.68.0-255,1484,50839,63,196380
32011,0.000623,74.125.68.0-255,1484,52323,63,196380
32012,0.000638,172.31.40.0-255,66,52389,63,196380
32013,0.000666,74.125.68.0-255,2902,55291,63,196380
32014,0.000669,172.31.40.0-255,66,55357,63,196380
32015,0.000675,74.125.68.0-255,5738,61095,63,196380
32016,0.000677,172.31.40.0-255,66,61161,63,196380
32017,0.000705,74.125.68.0-255,5379,66540,63,196380
32018,0.000708,172.31.40.0-255,66,66606,63,196380
32019,0.00071,74.125.68.0-255,412,67018,63,196380
32020,0.00097,74.125.68.0-255,332,67350,63,196380
32021,0.001053,172.31.40.0-255,66,67416,63,196380
32022,0.00125,74.125.68.0-255,1484,68900,63,196380
32023,0.001258,74.125.68.0-255,2902,71802,63,196380
32024,0.001262,172.31.40.0-255,66,71868,63,196380
32025,0.00129,74.125.68.0-255,5738,77606,63,196380
32026,0.001292,172.31.40.0-255,66,77672,63,196380
32027,0.001316,74.125.68.0-255,1484,79156,63,196380
32028,0.001321,74.125.68.0-255,2902,82058,63,196380
32029,0.001323,172.31.40.0-255,66,82124,63,196380
32030,0.001341,74.125.68.0-255,5738,87862,63,196380
32031,0.001344,172.31.40.0-255,66,87928,63,196380
32032,0.001347,74.125.68.0-255,2902,90830,63,196380
32033,0.001349,172.31.40.0-255,66,90896,63,196380
32034,0.001376,74.125.68.0-255,4320,95216,63,196380
32035,0.001378,172.31.40.0-255,66,95282,63,196380
32036,0.001407,74.125.68.0-255,2902,98184,63,196380
32037,0.001409,172.31.40.0-255,66,98250,63,196380
32038,0.001435,74.125.68.0-255,3602,101852,63,196380
32039,0.001437,172.31.40.0-255,66,101918,63,196380
32040,0.001766,74.125.68.0-255,1484,103402,63,196380
32041,0.001773,74.125.68.0-255,2902,106304,63,196380
32042,0.001777,172.31.40.0-255,66,106370,63,196380
32043,0.001784,74.125.68.0-255,5738,112108,63,196380
32044,0.001786,172.31.40.0-255,66,112174,63,196380
32045,0.001813,74.125.68.0-255,5738,117912,63,196380
32046,0.001816,172.31.40.0-255,66,117978,63,196380
32047,0.001844,74.125.68.0-255,7156,125134,63,196380
32048,0.001846,172.31.40.0-255,66,125200,63,196380
32049,0.001875,172.31.40.0-255,66,125266,63,196380
32050,0.001907,74.125.68.0-255,2184,127450,63,196380
32051,0.00191,172.31.40.0-255,66,127516,63,196380
32052,0.00196,74.125.68.0-255,1484,129000,63,196380
32053,0.001973,74.125.68.0-255,2902,131902,63,196380
32054,0.001976,172.31.40.0-255,66,131968,63,196380
32055,0.002003,74.125.68.0-255,5738,137706,63,196380
32056,0.002006,172.31.40.0-255,66,137772,63,196380
32057,0.002008,74.125.68.0-255,1484,139256,63,196380
32058,0.002032,74.125.68.0-255,7156,146412,63,196380
32059,0.002038,74.125.68.0-255,5738,152150,63,196380
32060,0.002054,74.125.68.0-255,4320,156470,63,196380
32061,0.002074,74.125.68.0-255,5020,161490,63,196380
32062,0.004009,172.31.40.0-255,66,161556,63,196380
32063,0.006356,74.125.68.0-255,5738,167294,63,196380
32064,0.006361,172.31.40.0-255,66,167360,63,196380
32065,0.008705,74.125.68.0-255,5738,173098,63,196380
32066,0.008713,172.31.40.0-255,66,173164,63,196380
32067,0.01107,74.125.68.0-255,5738,178902,63,196380
32068,0.011079,172.31.40.0-255,66,178968,63,196380
32069,0.013424,74.125.68.0-255,5738,184706,63,196380
32070,0.013433,172.31.40.0-255,66,184772,63,196380
32071,0.015792,74.125.68.0-255,5738,190510,63,196380
32072,0.015801,172.31.40.0-255,66,190576,63,196380
32073,0.018158,74.125.68.0-255,5738,196314,63,196380
32074,0.018168,172.31.40.0-255,66,196380,63,196380
32075,0.0,74.125.68.0-255,151,151,63,150013
32076,1.6e-05,172.31.40.0-255,66,217,63,150013
32077,2.3e-05,74.125.68.0-255,1484,1701,63,150013
32078,2.6e-05,172.31.40.0-255,66,1767,63,150013
32079,4.4e-05,74.125.68.0-255,2902,4669,63,150013
32080,4.7e-05,172.31.40.0-255,66,4735,63,150013
32081,5.3e-05,74.125.68.0-255,4320,9055,63,150013
32082,5.5e-05,172.31.40.0-255,66,9121,63,150013
32083,7.7e-05,74.125.68.0-255,1484,10605,63,150013
32084,7.9e-05,172.31.40.0-255,66,10671,63,150013
32085,0.000101,172.31.40.0-255,66,10737,63,150013
32086,0.000128,172.31.40.0-255,66,10803,63,150013
32087,0.000132,74.125.68.0-255,2543,13346,63,150013
32088,0.000136,172.31.40.0-255,66,13412,63,150013
32089,0.000205,74.125.68.0-255,1484,14896,63,150013
32090,0.000208,172.31.40.0-255,66,14962,63,150013
32091,0.000213,74.125.68.0-255,2902,17864,63,150013
32092,0.000216,172.31.40.0-255,66,17930,63,150013
32093,0.000232,74.125.68.0-255,2902,20832,63,150013
32094,0.000235,172.31.40.0-255,66,20898,63,150013
32095,0.000256,74.125.68.0-255,1484,22382,63,150013
32096,0.00026,172.31.40.0-255,66,22448,63,150013
32097,0.000266,74.125.68.0-255,5738,28186,63,150013
32098,0.000269,172.31.40.0-255,66,28252,63,150013
32099,0.000286,74.125.68.0-255,2543,30795,63,150013
32100,0.000288,172.31.40.0-255,66,30861,63,150013
32101,0.000811,74.125.68.0-255,1484,32345,63,150013
32102,0.000817,172.31.40.0-255,66,32411,63,150013
32103,0.000824,74.125.68.0-255,2902,35313,63,150013
32104,0.000826,172.31.40.0-255,66,35379,63,150013
32105,0.000832,74.125.68.0-255,4320,39699,63,150013
32106,0.000834,172.31.40.0-255,66,39765,63,150013
32107,0.000839,74.125.68.0-255,2902,42667,63,150013
32108,0.000841,172.31.40.0-255,66,42733,63,150013
32109,0.000866,74.125.68.0-255,2902,45635,63,150013
32110,0.000868,172.31.40.0-255,66,45701,63,150013
32111,0.0009,74.125.68.0-255,2543,48244,63,150013
32112,0.000904,172.31.40.0-255,66,48310,63,150013
32113,0.001088,74.125.68.0-255,1484,49794,63,150013
32114,0.001104,74.125.68.0-255,2902,52696,63,150013
32115,0.00111,172.31.40.0-255,66,52762,63,150013
32116,0.001134,74.125.68.0-255,5738,58500,63,150013
32117,0.001138,74.125.68.0-255,2902,61402,63,150013
32118,0.001143,74.125.68.0-255,3961,65363,63,150013
32119,0.001146,172.31.40.0-255,66,65429,63,150013
32120,0.001154,172.31.40.0-255,66,65495,63,150013
32121,0.001156,172.31.40.0-255,66,65561,63,150013
32122,0.001168,74.125.68.0-255,1484,67045,63,150013
32123,0.001189,74.125.68.0-255,7156,74201,63,150013
32124,0.001194,172.31.40.0-255,66,74267,63,150013
32125,0.001198,74.125.68.0-255,2902,77169,63,150013
32126,0.0012,172.31.40.0-255,66,77235,63,150013
32127,0.001237,74.125.68.0-255,4320,81555,63,150013
32128,0.00124,172.31.40.0-255,66,81621,63,150013
32129,0.001257,74.125.68.0-255,1704,83325,63,150013
32130,0.001259,172.31.40.0-255,66,83391,63,150013
32131,0.002185,74.125.68.0-255,1484,84875,63,150013
32132,0.002196,74.125.68.0-255,2902,87777,63,150013
32133,0.0022,172.31.40.0-255,66,87843,63,150013
32134,0.002207,74.125.68.0-255,4320,92163,63,150013
32135,0.00221,172.31.40.0-255,66,92229,63,150013
32136,0.002259,172.31.40.0-255,66,92295,63,150013
32137,0.002267,74.125.68.0-255,7156,99451,63,150013
32138,0.002269,172.31.40.0-255,66,99517,63,150013
32139,0.002305,74.125.68.0-255,2902,102419,63,150013
32140,0.002307,172.31.40.0-255,66,102485,63,150013
32141,0.002339,74.125.68.0-255,4320,106805,63,150013
32142,0.002342,172.31.40.0-255,66,106871,63,150013
32143,0.002346,74.125.68.0-255,2184,109055,63,150013
32144,0.002348,172.31.40.0-255,66,109121,63,150013
32145,0.004695,74.125.68.0-255,2902,112023,63,150013
32146,0.004701,172.31.40.0-255,66,112089,63,150013
32147,0.004721,74.125.68.0-255,2902,114991,63,150013
32148,0.004723,172.31.40.0-255,66,115057,63,150013
32149,0.007051,74.125.68.0-255,2902,117959,63,150013
32150,0.007054,172.31.40.0-255,66,118025,63,150013
32151,0.007071,74.125.68.0-255,2902,120927,63,150013
32152,0.007073,172.31.40.0-255,66,120993,63,150013
32153,0.009415,74.125.68.0-255,5738,126731,63,150013
32154,0.009421,172.31.40.0-255,66,126797,63,150013
32155,0.011778,74.125.68.0-255,5738,132535,63,150013
32156,0.011784,172.31.40.0-255,66,132601,63,150013
32157,0.014157,74.125.68.0-255,5738,138339,63,150013
32158,0.014167,172.31.40.0-255,66,138405,63,150013
32159,0.016525,74.125.68.0-255,5738,144143,63,150013
32160,0.016533,172.31.40.0-255,66,144209,63,150013
32161,0.01889,74.125.68.0-255,5738,149947,63,150013
32162,0.018897,172.31.40.0-255,66,150013,63,150013
32163,0.0,172.217.194.0-255,152,152,63,181606
32164,2.3e-05,172.31.40.0-255,66,218,63,181606
32165,3e-05,172.217.194.0-255,1484,1702,63,181606
32166,3.4e-05,172.31.40.0-255,66,1768,63,181606
32167,3.9e-05,172.217.194.0-255,2902,4670,63,181606
32168,4.2e-05,172.31.40.0-255,66,4736,63,181606
32169,4.9e-05,172.217.194.0-255,7156,11892,63,181606
32170,5.2e-05,172.31.40.0-255,66,11958,63,181606
32171,5.7e-05,172.217.194.0-255,5738,17696,63,181606
32172,6e-05,172.31.40.0-255,66,17762,63,181606
32173,8.7e-05,172.217.194.0-255,633,18395,63,181606
32174,8.9e-05,172.31.40.0-255,66,18461,63,181606
32175,9.6e-05,172.217.194.0-255,7156,25617,63,181606
32176,9.8e-05,172.31.40.0-255,66,25683,63,181606
32177,0.000103,172.217.194.0-255,5738,31421,63,181606
32178,0.000105,172.31.40.0-255,66,31487,63,181606
32179,0.000145,172.31.40.0-255,66,31553,63,181606
32180,0.000152,172.217.194.0-255,6438,37991,63,181606
32181,0.000154,172.31.40.0-255,66,38057,63,181606
32182,0.000172,172.217.194.0-255,1484,39541,63,181606
32183,0.000174,172.31.40.0-255,66,39607,63,181606
32184,0.000179,172.217.194.0-255,2902,42509,63,181606
32185,0.00018,172.31.40.0-255,66,42575,63,181606
32186,0.000184,172.217.194.0-255,2902,45477,63,181606
32187,0.000186,172.31.40.0-255,66,45543,63,181606
32188,0.000207,172.217.194.0-255,2902,48445,63,181606
32189,0.000209,172.31.40.0-255,66,48511,63,181606
32190,0.000215,172.217.194.0-255,5738,54249,63,181606
32191,0.000217,172.31.40.0-255,66,54315,63,181606
32192,0.000227,172.217.194.0-255,1376,55691,63,181606
32193,0.000228,172.31.40.0-255,66,55757,63,181606
32194,0.000412,172.217.194.0-255,117,55874,63,181606
32195,0.000444,172.217.194.0-255,1484,57358,63,181606
32196,0.00045,172.217.194.0-255,2902,60260,63,181606
32197,0.000459,172.31.40.0-255,66,60326,63,181606
32198,0.000491,172.217.194.0-255,5738,66064,63,181606
32199,0.000502,172.217.194.0-255,1484,67548,63,181606
32200,0.000508,172.217.194.0-255,5379,72927,63,181606
32201,0.000538,172.31.40.0-255,66,72993,63,181606
32202,0.000575,172.217.194.0-255,2543,75536,63,181606
32203,0.000596,172.31.40.0-255,66,75602,63,181606
32204,0.00146,172.217.194.0-255,1484,77086,63,181606
32205,0.001469,172.217.194.0-255,2902,79988,63,181606
32206,0.001473,172.31.40.0-255,66,80054,63,181606
32207,0.001478,172.217.194.0-255,2902,82956,63,181606
32208,0.001496,172.217.194.0-255,2902,85858,63,181606
32209,0.001499,172.217.194.0-255,1484,87342,63,181606
32210,0.001513,172.217.194.0-255,5738,93080,63,181606
32211,0.001529,172.217.194.0-255,2902,95982,63,181606
32212,0.001573,172.217.194.0-255,3602,99584,63,181606
32213,0.001651,172.217.194.0-255,1484,101068,63,181606
32214,0.001669,172.217.194.0-255,2902,103970,63,181606
32215,0.001671,172.217.194.0-255,1484,105454,63,181606
32216,0.00169,172.217.194.0-255,4320,109774,63,181606
32217,0.001795,172.217.194.0-255,2902,112676,63,181606
32218,0.001892,172.217.194.0-255,1484,114160,63,181606
32219,0.001896,172.217.194.0-255,1484,115644,63,181606
32220,0.001909,172.217.194.0-255,1484,117128,63,181606
32221,0.001933,172.217.194.0-255,5738,122866,63,181606
32222,0.001946,172.217.194.0-255,2902,125768,63,181606
32223,0.002022,172.217.194.0-255,4320,130088,63,181606
32224,0.002241,172.217.194.0-255,1484,131572,63,181606
32225,0.002246,172.217.194.0-255,1484,133056,63,181606
32226,0.002255,172.217.194.0-255,1484,134540,63,181606
32227,0.002257,172.217.194.0-255,1484,136024,63,181606
32228,0.002279,172.217.194.0-255,4320,140344,63,181606
32229,0.002282,172.217.194.0-255,1484,141828,63,181606
32230,0.002311,172.217.194.0-255,1484,143312,63,181606
32231,0.002326,172.217.194.0-255,4320,147632,63,181606
32232,0.002346,172.217.194.0-255,7156,154788,63,181606
32233,0.002385,172.217.194.0-255,7156,161944,63,181606
32234,0.002399,172.217.194.0-255,2184,164128,63,181606
32235,0.009362,172.31.40.0-255,66,164194,63,181606
32236,0.011772,172.217.194.0-255,5738,169932,63,181606
32237,0.011787,172.31.40.0-255,66,169998,63,181606
32238,0.014164,172.217.194.0-255,5738,175736,63,181606
32239,0.017444,172.31.40.0-255,66,175802,63,181606
32240,0.019814,172.217.194.0-255,5738,181540,63,181606
32241,0.019826,172.31.40.0-255,66,181606,63,181606
32242,0.0,74.125.200.0-255,152,152,63,167831
32243,2.5e-05,172.31.40.0-255,66,218,63,167831
32244,3.3e-05,74.125.200.0-255,1484,1702,63,167831
32245,3.7e-05,172.31.40.0-255,66,1768,63,167831
32246,4.3e-05,74.125.200.0-255,2902,4670,63,167831
32247,5.3e-05,172.31.40.0-255,66,4736,63,167831
32248,9e-05,74.125.200.0-255,5738,10474,63,167831
32249,9.3e-05,172.31.40.0-255,66,10540,63,167831
32250,0.000101,74.125.200.0-255,6193,16733,63,167831
32251,0.000103,172.31.40.0-255,66,16799,63,167831
32252,0.000156,74.125.200.0-255,7156,23955,63,167831
32253,0.000159,172.31.40.0-255,66,24021,63,167831
32254,0.000176,74.125.200.0-255,4320,28341,63,167831
32255,0.000183,172.31.40.0-255,66,28407,63,167831
32256,0.00021,74.125.200.0-255,2543,30950,63,167831
32257,0.000214,172.31.40.0-255,66,31016,63,167831
32258,0.00028,74.125.200.0-255,1484,32500,63,167831
32259,0.000284,172.31.40.0-255,66,32566,63,167831
32260,0.000289,74.125.200.0-255,2902,35468,63,167831
32261,0.000291,172.31.40.0-255,66,35534,63,167831
32262,0.000297,74.125.200.0-255,5738,41272,63,167831
32263,0.000304,172.31.40.0-255,66,41338,63,167831
32264,0.000334,74.125.200.0-255,5738,47076,63,167831
32265,0.000337,172.31.40.0-255,66,47142,63,167831
32266,0.000362,74.125.200.0-255,5379,52521,63,167831
32267,0.000365,172.31.40.0-255,66,52587,63,167831
32268,0.000379,172.31.40.0-255,66,52653,63,167831
32269,0.000382,74.125.200.0-255,1437,54090,63,167831
32270,0.000385,172.31.40.0-255,66,54156,63,167831
32271,0.000704,74.125.200.0-255,111,54267,63,167831
32272,0.00071,172.31.40.0-255,66,54333,63,167831
32273,0.000924,74.125.200.0-255,1484,55817,63,167831
32274,0.00093,74.125.200.0-255,1484,57301,63,167831
32275,0.000933,172.31.40.0-255,66,57367,63,167831
32276,0.000967,74.125.200.0-255,1484,58851,63,167831
32277,0.000974,74.125.200.0-255,5738,64589,63,167831
32278,0.000977,172.31.40.0-255,66,64655,63,167831
32279,0.000982,74.125.200.0-255,2902,67557,63,167831
32280,0.000985,172.31.40.0-255,66,67623,63,167831
32281,0.001015,74.125.200.0-255,3961,71584,63,167831
32282,0.001018,172.31.40.0-255,66,71650,63,167831
32283,0.001022,74.125.200.0-255,1484,73134,63,167831
32284,0.001055,74.125.200.0-255,5738,78872,63,167831
32285,0.001058,172.31.40.0-255,66,78938,63,167831
32286,0.00107,172.31.40.0-255,66,79004,63,167831
32287,0.001072,74.125.200.0-255,1125,80129,63,167831
32288,0.001504,172.31.40.0-255,66,80195,63,167831
32289,0.001946,74.125.200.0-255,1484,81679,63,167831
32290,0.001957,74.125.200.0-255,2902,84581,63,167831
32291,0.001962,172.31.40.0-255,66,84647,63,167831
32292,0.001968,74.125.200.0-255,2902,87549,63,167831
32293,0.00197,172.31.40.0-255,66,87615,63,167831
32294,0.001992,74.125.200.0-255,2902,90517,63,167831
32295,0.001999,172.31.40.0-255,66,90583,63,167831
32296,0.002009,172.31.40.0-255,66,90649,63,167831
32297,0.002016,74.125.200.0-255,5738,96387,63,167831
32298,0.002018,172.31.40.0-255,66,96453,63,167831
32299,0.002056,74.125.200.0-255,5738,102191,63,167831
32300,0.002059,172.31.40.0-255,66,102257,63,167831
32301,0.002064,74.125.200.0-255,2184,104441,63,167831
32302,0.002067,172.31.40.0-255,66,104507,63,167831
32303,0.002133,74.125.200.0-255,1484,105991,63,167831
32304,0.002139,74.125.200.0-255,2902,108893,63,167831
32305,0.002142,172.31.40.0-255,66,108959,63,167831
32306,0.002173,74.125.200.0-255,4320,113279,63,167831
32307,0.002176,172.31.40.0-255,66,113345,63,167831
32308,0.002179,74.125.200.0-255,1484,114829,63,167831
32309,0.002203,74.125.200.0-255,7156,121985,63,167831
32310,0.002205,172.31.40.0-255,66,122051,63,167831
32311,0.002218,172.31.40.0-255,66,122117,63,167831
32312,0.002255,74.125.200.0-255,5020,127137,63,167831
32313,0.002257,172.31.40.0-255,66,127203,63,167831
32314,0.004507,74.125.200.0-255,5738,132941,63,167831
32315,0.004513,172.31.40.0-255,66,133007,63,167831
32316,0.006758,74.125.200.0-255,5738,138745,63,167831
32317,0.006765,172.31.40.0-255,66,138811,63,167831
32318,0.009005,74.125.200.0-255,5738,144549,63,167831
32319,0.00901,172.31.40.0-255,66,144615,63,167831
32320,0.011262,74.125.200.0-255,5738,150353,63,167831
32321,0.01127,172.31.40.0-255,66,150419,63,167831
32322,0.013525,74.125.200.0-255,5738,156157,63,167831
32323,0.013532,172.31.40.0-255,66,156223,63,167831
32324,0.015824,74.125.200.0-255,5738,161961,63,167831
32325,0.015832,172.31.40.0-255,66,162027,63,167831
32326,0.018087,74.125.200.0-255,5738,167765,63,167831
32327,0.018098,172.31.40.0-255,66,167831,63,167831
32328,0.0,172.217.27.0-255,152,152,63,154991
32329,2.5e-05,172.31.40.0-255,66,218,63,154991
32330,3.3e-05,172.217.27.0-255,1484,1702,63,154991
32331,3.7e-05,172.31.40.0-255,66,1768,63,154991
32332,5.2e-05,172.217.27.0-255,2902,4670,63,154991
32333,5.6e-05,172.31.40.0-255,66,4736,63,154991
32334,6e-05,172.217.27.0-255,2902,7638,63,154991
32335,6.3e-05,172.31.40.0-255,66,7704,63,154991
32336,6.9e-05,172.217.27.0-255,4320,12024,63,154991
32337,7.1e-05,172.31.40.0-255,66,12090,63,154991
32338,7.6e-05,172.217.27.0-255,2155,14245,63,154991
32339,7.8e-05,172.31.40.0-255,66,14311,63,154991
32340,0.000197,172.217.27.0-255,1484,15795,63,154991
32341,0.0002,172.31.40.0-255,66,15861,63,154991
32342,0.000205,172.217.27.0-255,2902,18763,63,154991
32343,0.000208,172.31.40.0-255,66,18829,63,154991
32344,0.000239,172.217.27.0-255,5738,24567,63,154991
32345,0.000242,172.31.40.0-255,66,24633,63,154991
32346,0.00025,172.217.27.0-255,6797,31430,63,154991
32347,0.000253,172.31.40.0-255,66,31496,63,154991
32348,0.000287,172.217.27.0-255,5738,37234,63,154991
32349,0.000289,172.31.40.0-255,66,37300,63,154991
32350,0.000317,172.217.27.0-255,1484,38784,63,154991
32351,0.00032,172.31.40.0-255,66,38850,63,154991
32352,0.000332,172.31.40.0-255,66,38916,63,154991
32353,0.000369,172.217.27.0-255,1484,40400,63,154991
32354,0.000372,172.31.40.0-255,66,40466,63,154991
32355,0.0004,172.217.27.0-255,2902,43368,63,154991
32356,0.000403,172.31.40.0-255,66,43434,63,154991
32357,0.000408,172.217.27.0-255,4320,47754,63,154991
32358,0.00041,172.31.40.0-255,66,47820,63,154991
32359,0.000422,172.217.27.0-255,5738,53558,63,154991
32360,0.000446,172.217.27.0-255,2543,56101,63,154991
32361,0.000509,172.217.27.0-255,356,56457,63,154991
32362,0.000604,172.31.40.0-255,66,56523,63,154991
32363,0.000763,172.217.27.0-255,386,56909,63,154991
32364,0.000958,172.217.27.0-255,1484,58393,63,154991
32365,0.000962,172.31.40.0-255,66,58459,63,154991
32366,0.000968,172.217.27.0-255,2902,61361,63,154991
32367,0.000992,172.217.27.0-255,5738,67099,63,154991
32368,0.000999,172.217.27.0-255,5738,72837,63,154991
32369,0.001013,172.217.27.0-255,4320,77157,63,154991
32370,0.001016,172.31.40.0-255,66,77223,63,154991
32371,0.001025,172.217.27.0-255,2543,79766,63,154991
32372,0.001035,172.31.40.0-255,66,79832,63,154991
32373,0.001046,172.217.27.0-255,4320,84152,63,154991
32374,0.001067,172.217.27.0-255,6797,90949,63,154991
32375,0.001079,172.31.40.0-255,66,91015,63,154991
32376,0.002735,172.217.27.0-255,5738,96753,63,154991
32377,0.002742,172.31.40.0-255,66,96819,63,154991
32378,0.004378,172.217.27.0-255,5738,102557,63,154991
32379,0.004382,172.31.40.0-255,66,102623,63,154991
32380,0.006013,172.217.27.0-255,2902,105525,63,154991
32381,0.006015,172.31.40.0-255,66,105591,63,154991
32382,0.006045,172.217.27.0-255,2902,108493,63,154991
32383,0.006047,172.31.40.0-255,66,108559,63,154991
32384,0.007671,172.217.27.0-255,5738,114297,63,154991
32385,0.007678,172.31.40.0-255,66,114363,63,154991
32386,0.00932,172.217.27.0-255,5738,120101,63,154991
32387,0.009327,172.31.40.0-255,66,120167,63,154991
32388,0.010976,172.217.27.0-255,5738,125905,63,154991
32389,0.010983,172.31.40.0-255,66,125971,63,154991
32390,0.012629,172.217.27.0-255,5738,131709,63,154991
32391,0.012637,172.31.40.0-255,66,131775,63,154991
32392,0.014287,172.217.27.0-255,5738,137513,63,154991
32393,0.014293,172.31.40.0-255,66,137579,63,154991
32394,0.015936,172.217.27.0-255,5738,143317,63,154991
32395,0.015943,172.31.40.0-255,66,143383,63,154991
32396,0.01759,172.217.27.0-255,5738,149121,63,154991
32397,0.017597,172.31.40.0-255,66,149187,63,154991
32398,0.01928,172.217.27.0-255,5738,154925,63,154991
32399,0.019288,172.31.40.0-255,66,154991,63,154991
32400,0.0,172.217.194.0-255,152,152,63,204273
32401,2.3e-05,172.31.40.0-255,66,218,63,204273
32402,3e-05,172.217.194.0-255,1484,1702,63,204273
32403,3.5e-05,172.31.40.0-255,66,1768,63,204273
32404,4e-05,172.217.194.0-255,2902,4670,63,204273
32405,5e-05,172.31.40.0-255,66,4736,63,204273
32406,5.8e-05,172.217.194.0-255,7156,11892,63,204273
32407,6.1e-05,172.31.40.0-255,66,11958,63,204273
32408,6.5e-05,172.217.194.0-255,2020,13978,63,204273
32409,6.9e-05,172.31.40.0-255,66,14044,63,204273
32410,0.000324,172.217.194.0-255,1484,15528,63,204273
32411,0.00033,172.31.40.0-255,66,15594,63,204273
32412,0.00036,172.217.194.0-255,2902,18496,63,204273
32413,0.000364,172.31.40.0-255,66,18562,63,204273
32414,0.00037,172.217.194.0-255,5738,24300,63,204273
32415,0.000373,172.31.40.0-255,66,24366,63,204273
32416,0.000378,172.217.194.0-255,4320,28686,63,204273
32417,0.00038,172.31.40.0-255,66,28752,63,204273
32418,0.000418,172.217.194.0-255,2543,31295,63,204273
32419,0.00042,172.31.40.0-255,66,31361,63,204273
32420,0.000762,172.217.194.0-255,1484,32845,63,204273
32421,0.000767,172.31.40.0-255,66,32911,63,204273
32422,0.000775,172.217.194.0-255,2902,35813,63,204273
32423,0.000777,172.31.40.0-255,66,35879,63,204273
32424,0.000788,172.217.194.0-255,5738,41617,63,204273
32425,0.00079,172.31.40.0-255,66,41683,63,204273
32426,0.000799,172.217.194.0-255,7156,48839,63,204273
32427,0.000801,172.31.40.0-255,66,48905,63,204273
32428,0.000831,172.217.194.0-255,6797,55702,63,204273
32429,0.000833,172.31.40.0-255,66,55768,63,204273
32430,0.000871,172.31.40.0-255,66,55834,63,204273
32431,0.001036,172.217.194.0-255,117,55951,63,204273
32432,0.001078,172.217.194.0-255,1484,57435,63,204273
32433,0.001082,172.31.40.0-255,66,57501,63,204273
32434,0.001088,172.217.194.0-255,2902,60403,63,204273
32435,0.00109,172.31.40.0-255,66,60469,63,204273
32436,0.001101,172.217.194.0-255,5738,66207,63,204273
32437,0.001103,172.31.40.0-255,66,66273,63,204273
32438,0.001125,172.217.194.0-255,1484,67757,63,204273
32439,0.001132,172.217.194.0-255,5379,73136,63,204273
32440,0.001135,172.31.40.0-255,66,73202,63,204273
32441,0.001196,172.217.194.0-255,7156,80358,63,204273
32442,0.001202,172.31.40.0-255,66,80424,63,204273
32443,0.001224,172.217.194.0-255,7156,87580,63,204273
32444,0.001227,172.31.40.0-255,66,87646,63,204273
32445,0.001231,172.217.194.0-255,2543,90189,63,204273
32446,0.001233,172.31.40.0-255,66,90255,63,204273
32447,0.001518,172.217.194.0-255,1484,91739,63,204273
32448,0.001526,172.217.194.0-255,2902,94641,63,204273
32449,0.001532,172.31.40.0-255,66,94707,63,204273
32450,0.00154,172.217.194.0-255,5738,100445,63,204273
32451,0.001542,172.31.40.0-255,66,100511,63,204273
32452,0.00156,172.217.194.0-255,4320,104831,63,204273
32453,0.001563,172.31.40.0-255,66,104897,63,204273
32454,0.001595,172.31.40.0-255,66,104963,63,204273
32455,0.001601,172.217.194.0-255,5738,110701,63,204273
32456,0.001603,172.31.40.0-255,66,110767,63,204273
32457,0.001628,172.217.194.0-255,5020,115787,63,204273
32458,0.001631,172.31.40.0-255,66,115853,63,204273
32459,0.001637,172.217.194.0-255,4320,120173,63,204273
32460,0.001639,172.31.40.0-255,66,120239,63,204273
32461,0.001647,172.217.194.0-255,5738,125977,63,204273
32462,0.00165,172.31.40.0-255,66,126043,63,204273
32463,0.001683,172.31.40.0-255,66,126109,63,204273
32464,0.001686,172.217.194.0-255,1484,127593,63,204273
32465,0.00173,172.31.40.0-255,66,127659,63,204273
32466,0.0018,172.217.194.0-255,1484,129143,63,204273
32467,0.001805,172.217.194.0-255,2902,132045,63,204273
32468,0.001808,172.31.40.0-255,66,132111,63,204273
32469,0.001836,172.217.194.0-255,5738,137849,63,204273
32470,0.001839,172.31.40.0-255,66,137915,63,204273
32471,0.001847,172.217.194.0-255,7156,145071,63,204273
32472,0.001849,172.31.40.0-255,66,145137,63,204273
32473,0.001876,172.217.194.0-255,1484,146621,63,204273
32474,0.001888,172.31.40.0-255,66,146687,63,204273
32475,0.001895,172.217.194.0-255,5020,151707,63,204273
32476,0.001897,172.31.40.0-255,66,151773,63,204273
32477,0.002138,172.217.194.0-255,1484,153257,63,204273
32478,0.002158,172.217.194.0-255,2902,156159,63,204273
32479,0.002161,172.31.40.0-255,66,156225,63,204273
32480,0.002168,172.217.194.0-255,5738,161963,63,204273
32481,0.00217,172.31.40.0-255,66,162029,63,204273
32482,0.002221,172.217.194.0-255,1484,163513,63,204273
32483,0.002252,172.31.40.0-255,66,163579,63,204273
32484,0.002265,172.31.40.0-255,66,163645,63,204273
32485,0.004529,172.217.194.0-255,5738,169383,63,204273
32486,0.004533,172.31.40.0-255,66,169449,63,204273
32487,0.006789,172.217.194.0-255,5738,175187,63,204273
32488,0.006798,172.31.40.0-255,66,175253,63,204273
32489,0.009065,172.217.194.0-255,5738,180991,63,204273
32490,0.009072,172.31.40.0-255,66,181057,63,204273
32491,0.01132,172.217.194.0-255,5738,186795,63,204273
32492,0.011329,172.31.40.0-255,66,186861,63,204273
32493,0.013579,172.217.194.0-255,5738,192599,63,204273
32494,0.013588,172.31.40.0-255,66,192665,63,204273
32495,0.015847,172.217.194.0-255,5738,198403,63,204273
32496,0.015858,172.31.40.0-255,66,198469,63,204273
32497,0.018097,172.217.194.0-255,5738,204207,63,204273
32498,0.018109,172.31.40.0-255,66,204273,63,204273
32499,0.0,74.125.200.0-255,159,159,63,295462
32500,2e-05,172.31.40.0-255,66,225,63,295462
32501,2.7e-05,74.125.200.0-255,1484,1709,63,295462
32502,3.2e-05,172.31.40.0-255,66,1775,63,295462
32503,3.5e-05,74.125.200.0-255,1484,3259,63,295462
32504,3.9e-05,172.31.40.0-255,66,3325,63,295462
32505,5.2e-05,74.125.200.0-255,2902,6227,63,295462
32506,5.6e-05,172.31.40.0-255,66,6293,63,295462
32507,6.2e-05,74.125.200.0-255,5738,12031,63,295462
32508,6.6e-05,172.31.40.0-255,66,12097,63,295462
32509,6.9e-05,74.125.200.0-255,1992,14089,63,295462
32510,7.3e-05,172.31.40.0-255,66,14155,63,295462
32511,0.000182,74.125.200.0-255,1484,15639,63,295462
32512,0.000187,172.31.40.0-255,66,15705,63,295462
32513,0.000192,74.125.200.0-255,2902,18607,63,295462
32514,0.000194,172.31.40.0-255,66,18673,63,295462
32515,0.000227,74.125.200.0-255,5738,24411,63,295462
32516,0.000231,172.31.40.0-255,66,24477,63,295462
32517,0.000239,74.125.200.0-255,6797,31274,63,295462
32518,0.000241,172.31.40.0-255,66,31340,63,295462
32519,0.000281,74.125.200.0-255,7156,38496,63,295462
32520,0.000285,172.31.40.0-255,66,38562,63,295462
32521,0.000297,172.31.40.0-255,66,38628,63,295462
32522,0.000354,172.31.40.0-255,66,38694,63,295462
32523,0.000359,74.125.200.0-255,5020,43714,63,295462
32524,0.000362,172.31.40.0-255,66,43780,63,295462
32525,0.000364,74.125.200.0-255,447,44227,63,295462
32526,0.000366,172.31.40.0-255,66,44293,63,295462
32527,0.000405,74.125.200.0-255,328,44621,63,295462
32528,0.000407,172.31.40.0-255,66,44687,63,295462
32529,0.000581,74.125.200.0-255,1484,46171,63,295462
32530,0.000588,74.125.200.0-255,2902,49073,63,295462
32531,0.000592,172.31.40.0-255,66,49139,63,295462
32532,0.000598,74.125.200.0-255,4320,53459,63,295462
32533,0.0006,172.31.40.0-255,66,53525,63,295462
32534,0.000621,74.125.200.0-255,1484,55009,63,295462
32535,0.000644,172.31.40.0-255,66,55075,63,295462
32536,0.000671,74.125.200.0-255,4320,59395,63,295462
32537,0.000677,74.125.200.0-255,5738,65133,63,295462
32538,0.000683,172.31.40.0-255,66,65199,63,295462
32539,0.000686,172.31.40.0-255,66,65265,63,295462
32540,0.000702,74.125.200.0-255,2902,68167,63,295462
32541,0.000709,172.31.40.0-255,66,68233,63,295462
32542,0.000739,74.125.200.0-255,2184,70417,63,295462
32543,0.000742,172.31.40.0-255,66,70483,63,295462
32544,0.001198,74.125.200.0-255,1484,71967,63,295462
32545,0.001203,74.125.200.0-255,1484,73451,63,295462
32546,0.001206,172.31.40.0-255,66,73517,63,295462
32547,0.001231,74.125.200.0-255,1484,75001,63,295462
32548,0.001237,74.125.200.0-255,5738,80739,63,295462
32549,0.00124,172.31.40.0-255,66,80805,63,295462
32550,0.001271,172.31.40.0-255,66,80871,63,295462
32551,0.001308,172.31.40.0-255,66,80937,63,295462
32552,0.001333,74.125.200.0-255,5020,85957,63,295462
32553,0.001336,172.31.40.0-255,66,86023,63,295462
32554,0.001348,74.125.200.0-255,2902,88925,63,295462
32555,0.001354,172.31.40.0-255,66,88991,63,295462
32556,0.001381,74.125.200.0-255,4320,93311,63,295462
32557,0.001383,172.31.40.0-255,66,93377,63,295462
32558,0.001393,172.31.40.0-255,66,93443,63,295462
32559,0.001433,74.125.200.0-255,5738,99181,63,295462
32560,0.001436,172.31.40.0-255,66,99247,63,295462
32561,0.001442,74.125.200.0-255,7156,106403,63,295462
32562,0.001444,172.31.40.0-255,66,106469,63,295462
32563,0.001448,74.125.200.0-255,2902,109371,63,295462
32564,0.001452,172.31.40.0-255,66,109437,63,295462
32565,0.001478,74.125.200.0-255,2184,111621,63,295462
32566,0.001482,172.31.40.0-255,66,111687,63,295462
32567,0.00152,74.125.200.0-255,1484,113171,63,295462
32568,0.001525,74.125.200.0-255,2902,116073,63,295462
32569,0.001527,172.31.40.0-255,66,116139,63,295462
32570,0.001551,74.125.200.0-255,4320,120459,63,295462
32571,0.001554,172.31.40.0-255,66,120525,63,295462
32572,0.001584,74.125.200.0-255,5738,126263,63,295462
32573,0.001587,172.31.40.0-255,66,126329,63,295462
32574,0.00159,74.125.200.0-255,1484,127813,63,295462
32575,0.001628,172.31.40.0-255,66,127879,63,295462
32576,0.001633,74.125.200.0-255,4320,132199,63,295462
32577,0.001634,172.31.40.0-255,66,132265,63,295462
32578,0.001659,74.125.200.0-255,3602,135867,63,295462
32579,0.001661,172.31.40.0-255,66,135933,63,295462
32580,0.001707,74.125.200.0-255,2902,138835,63,295462
32581,0.001709,172.31.40.0-255,66,138901,63,295462
32582,0.001713,74.125.200.0-255,1484,140385,63,295462
32583,0.001739,74.125.200.0-255,2902,143287,63,295462
32584,0.001741,172.31.40.0-255,66,143353,63,295462
32585,0.001749,74.125.200.0-255,7156,150509,63,295462
32586,0.001752,172.31.40.0-255,66,150575,63,295462
32587,0.001778,74.125.200.0-255,1484,152059,63,295462
32588,0.001785,74.125.200.0-255,5738,157797,63,295462
32589,0.001788,172.31.40.0-255,66,157863,63,295462
32590,0.001794,74.125.200.0-255,7156,165019,63,295462
32591,0.001797,172.31.40.0-255,66,165085,63,295462
32592,0.001852,74.125.200.0-255,5020,170105,63,295462
32593,0.001855,172.31.40.0-255,66,170171,63,295462
32594,0.00188,74.125.200.0-255,1484,171655,63,295462
32595,0.001895,74.125.200.0-255,1484,173139,63,295462
32596,0.001898,172.31.40.0-255,66,173205,63,295462
32597,0.001912,74.125.200.0-255,1484,174689,63,295462
32598,0.001922,74.125.200.0-255,4320,179009,63,295462
32599,0.001924,172.31.40.0-255,66,179075,63,295462
32600,0.001929,74.125.200.0-255,2902,181977,63,295462
32601,0.001931,172.31.40.0-255,66,182043,63,295462
32602,0.001951,74.125.200.0-255,2902,184945,63,295462
32603,0.00196,172.31.40.0-255,66,185011,63,295462
32604,0.001973,74.125.200.0-255,2902,187913,63,295462
32605,0.001976,172.31.40.0-255,66,187979,63,295462
32606,0.002005,172.31.40.0-255,66,188045,63,295462
32607,0.00201,74.125.200.0-255,4320,192365,63,295462
32608,0.002014,172.31.40.0-255,66,192431,63,295462
32609,0.002056,172.31.40.0-255,66,192497,63,295462
32610,0.002088,172.31.40.0-255,66,192563,63,295462
32611,0.002118,74.125.200.0-255,7156,199719,63,295462
32612,0.002121,172.31.40.0-255,66,199785,63,295462
32613,0.002124,74.125.200.0-255,766,200551,63,295462
32614,0.002172,74.125.200.0-255,1484,202035,63,295462
32615,0.002175,74.125.200.0-255,1484,203519,63,295462
32616,0.002182,172.31.40.0-255,66,203585,63,295462
32617,0.002203,74.125.200.0-255,1484,205069,63,295462
32618,0.00221,74.125.200.0-255,5738,210807,63,295462
32619,0.002215,74.125.200.0-255,4320,215127,63,295462
32620,0.002225,172.31.40.0-255,66,215193,63,295462
32621,0.002251,74.125.200.0-255,5738,220931,63,295462
32622,0.002268,74.125.200.0-255,2902,223833,63,295462
32623,0.002273,172.31.40.0-255,66,223899,63,295462
32624,0.002302,74.125.200.0-255,1484,225383,63,295462
32625,0.002305,74.125.200.0-255,766,226149,63,295462
32626,0.002312,172.31.40.0-255,66,226215,63,295462
32627,0.002337,74.125.200.0-255,1484,227699,63,295462
32628,0.00235,74.125.200.0-255,2902,230601,63,295462
32629,0.002371,74.125.200.0-255,2902,233503,63,295462
32630,0.002385,74.125.200.0-255,2902,236405,63,295462
32631,0.002391,172.31.40.0-255,66,236471,63,295462
32632,0.002403,74.125.200.0-255,7156,243627,63,295462
32633,0.002422,172.31.40.0-255,66,243693,63,295462
32634,0.002427,74.125.200.0-255,2902,246595,63,295462
32635,0.002429,74.125.200.0-255,1484,248079,63,295462
32636,0.002449,74.125.200.0-255,2902,250981,63,295462
32637,0.002454,74.125.200.0-255,4320,255301,63,295462
32638,0.002478,74.125.200.0-255,5020,260321,63,295462
32639,0.002495,172.31.40.0-255,66,260387,63,295462
32640,0.002511,74.125.200.0-255,5738,266125,63,295462
32641,0.00252,74.125.200.0-255,4320,270445,63,295462
32642,0.002539,172.31.40.0-255,66,270511,63,295462
32643,0.002562,74.125.200.0-255,4320,274831,63,295462
32644,0.002572,172.31.40.0-255,66,274897,63,295462
32645,0.002583,74.125.200.0-255,4320,279217,63,295462
32646,0.002608,74.125.200.0-255,2902,282119,63,295462
32647,0.002612,74.125.200.0-255,2902,285021,63,295462
32648,0.002617,74.125.200.0-255,4320,289341,63,295462
32649,0.002623,74.125.200.0-255,5020,294361,63,295462
32650,0.00263,172.31.40.0-255,66,294427,63,295462
32651,0.002639,74.125.200.0-255,693,295120,63,295462
32652,0.002688,74.125.200.0-255,105,295225,63,295462
32653,0.004796,172.31.40.0-255,66,295291,63,295462
32654,0.004832,172.31.40.0-255,105,295396,63,295462
32655,0.006867,74.125.200.0-255,66,295462,63,295462
32656,0.0,172.217.24.0-255,143,143,63,156449
32657,1.8e-05,172.31.40.0-255,66,209,63,156449
32658,2.5e-05,172.217.24.0-255,1484,1693,63,156449
32659,2.9e-05,172.31.40.0-255,66,1759,63,156449
32660,3.4e-05,172.217.24.0-255,2902,4661,63,156449
32661,3.7e-05,172.31.40.0-255,66,4727,63,156449
32662,5.1e-05,172.217.24.0-255,5738,10465,63,156449
32663,5.3e-05,172.31.40.0-255,66,10531,63,156449
32664,7.5e-05,172.217.24.0-255,3420,13951,63,156449
32665,8.2e-05,172.31.40.0-255,66,14017,63,156449
32666,0.000116,172.217.24.0-255,4320,18337,63,156449
32667,0.000119,172.31.40.0-255,66,18403,63,156449
32668,0.000127,172.217.24.0-255,7156,25559,63,156449
32669,0.000129,172.31.40.0-255,66,25625,63,156449
32670,0.000153,172.217.24.0-255,2902,28527,63,156449
32671,0.00017,172.31.40.0-255,66,28593,63,156449
32672,0.000175,172.217.24.0-255,2543,31136,63,156449
32673,0.000181,172.31.40.0-255,66,31202,63,156449
32674,0.000368,172.217.24.0-255,1484,32686,63,156449
32675,0.000373,172.31.40.0-255,66,32752,63,156449
32676,0.00038,172.217.24.0-255,2902,35654,63,156449
32677,0.000383,172.31.40.0-255,66,35720,63,156449
32678,0.000412,172.217.24.0-255,4320,40040,63,156449
32679,0.000415,172.31.40.0-255,66,40106,63,156449
32680,0.000422,172.217.24.0-255,5738,45844,63,156449
32681,0.000424,172.31.40.0-255,66,45910,63,156449
32682,0.000459,172.31.40.0-255,66,45976,63,156449
32683,0.000497,172.217.24.0-255,4320,50296,63,156449
32684,0.0005,172.31.40.0-255,66,50362,63,156449
32685,0.000518,172.217.24.0-255,2543,52905,63,156449
32686,0.00052,172.31.40.0-255,66,52971,63,156449
32687,0.000633,172.217.24.0-255,393,53364,63,156449
32688,0.001093,172.31.40.0-255,66,53430,63,156449
32689,0.001347,172.217.24.0-255,115,53545,63,156449
32690,0.001381,172.217.24.0-255,1484,55029,63,156449
32691,0.001386,172.31.40.0-255,66,55095,63,156449
32692,0.001392,172.217.24.0-255,2902,57997,63,156449
32693,0.001395,172.217.24.0-255,1484,59481,63,156449
32694,0.001416,172.217.24.0-255,2902,62383,63,156449
32695,0.001421,172.217.24.0-255,4320,66703,63,156449
32696,0.001435,172.217.24.0-255,1484,68187,63,156449
32697,0.001439,172.217.24.0-255,2543,70730,63,156449
32698,0.001509,172.217.24.0-255,1484,72214,63,156449
32699,0.001514,172.217.24.0-255,1484,73698,63,156449
32700,0.001524,172.217.24.0-255,1484,75182,63,156449
32701,0.001531,172.217.24.0-255,5738,80920,63,156449
32702,0.001554,172.217.24.0-255,6797,87717,63,156449
32703,0.001557,172.217.24.0-255,1484,89201,63,156449
32704,0.001574,172.217.24.0-255,5738,94939,63,156449
32705,0.001621,172.217.24.0-255,7156,102095,63,156449
32706,0.001669,172.217.24.0-255,1484,103579,63,156449
32707,0.001687,172.217.24.0-255,2902,106481,63,156449
32708,0.001708,172.217.24.0-255,5738,112219,63,156449
32709,0.001713,172.217.24.0-255,2902,115121,63,156449
32710,0.001729,172.217.24.0-255,4320,119441,63,156449
32711,0.001763,172.217.24.0-255,5738,125179,63,156449
32712,0.001777,172.217.24.0-255,2184,127363,63,156449
32713,0.00688,172.31.40.0-255,66,127429,63,156449
32714,0.008845,172.217.24.0-255,5738,133167,63,156449
32715,0.008853,172.31.40.0-255,66,133233,63,156449
32716,0.010795,172.217.24.0-255,5738,138971,63,156449
32717,0.010802,172.31.40.0-255,66,139037,63,156449
32718,0.012742,172.217.24.0-255,5738,144775,63,156449
32719,0.014655,172.31.40.0-255,66,144841,63,156449
32720,0.016605,172.217.24.0-255,5738,150579,63,156449
32721,0.016614,172.31.40.0-255,66,150645,63,156449
32722,0.018582,172.217.24.0-255,5738,156383,63,156449
32723,0.018589,172.31.40.0-255,66,156449,63,156449
32724,0.0,74.125.68.0-255,152,152,63,279876
32725,1.4e-05,172.31.40.0-255,66,218,63,279876
32726,5.2e-05,74.125.68.0-255,1484,1702,63,279876
32727,5.7e-05,172.31.40.0-255,66,1768,63,279876
32728,6.3e-05,74.125.68.0-255,2902,4670,63,279876
32729,6.8e-05,172.31.40.0-255,66,4736,63,279876
32730,7.1e-05,74.125.68.0-255,1484,6220,63,279876
32731,7.4e-05,172.31.40.0-255,66,6286,63,279876
32732,8e-05,74.125.68.0-255,2902,9188,63,279876
32733,8.2e-05,172.31.40.0-255,66,9254,63,279876
32734,0.000129,74.125.68.0-255,4846,14100,63,279876
32735,0.000132,172.31.40.0-255,66,14166,63,279876
32736,0.000159,74.125.68.0-255,5738,19904,63,279876
32737,0.000162,172.31.40.0-255,66,19970,63,279876
32738,0.000166,74.125.68.0-255,2902,22872,63,279876
32739,0.000168,172.31.40.0-255,66,22938,63,279876
32740,0.000202,74.125.68.0-255,4320,27258,63,279876
32741,0.000206,172.31.40.0-255,66,27324,63,279876
32742,0.000211,74.125.68.0-255,3961,31285,63,279876
32743,0.000213,172.31.40.0-255,66,31351,63,279876
32744,0.000369,74.125.68.0-255,1484,32835,63,279876
32745,0.000375,172.31.40.0-255,66,32901,63,279876
32746,0.000379,74.125.68.0-255,1484,34385,63,279876
32747,0.000381,172.31.40.0-255,66,34451,63,279876
32748,0.000406,74.125.68.0-255,1484,35935,63,279876
32749,0.000409,172.31.40.0-255,66,36001,63,279876
32750,0.000415,74.125.68.0-255,4320,40321,63,279876
32751,0.000418,172.31.40.0-255,66,40387,63,279876
32752,0.00044,74.125.68.0-255,1484,41871,63,279876
32753,0.000442,172.31.40.0-255,66,41937,63,279876
32754,0.00045,74.125.68.0-255,6797,48734,63,279876
32755,0.000452,172.31.40.0-255,66,48800,63,279876
32756,0.000487,74.125.68.0-255,1484,50284,63,279876
32757,0.000492,74.125.68.0-255,2902,53186,63,279876
32758,0.000494,172.31.40.0-255,66,53252,63,279876
32759,0.000499,74.125.68.0-255,4320,57572,63,279876
32760,0.000502,172.31.40.0-255,66,57638,63,279876
32761,0.000519,74.125.68.0-255,1484,59122,63,279876
32762,0.000529,74.125.68.0-255,5738,64860,63,279876
32763,0.000532,172.31.40.0-255,66,64926,63,279876
32764,0.000568,74.125.68.0-255,1437,66363,63,279876
32765,0.000589,74.125.68.0-255,111,66474,63,279876
32766,0.000966,74.125.68.0-255,1484,67958,63,279876
32767,0.000971,172.31.40.0-255,66,68024,63,279876
32768,0.000978,74.125.68.0-255,2902,70926,63,279876
32769,0.00098,172.31.40.0-255,66,70992,63,279876
32770,0.001009,74.125.68.0-255,5738,76730,63,279876
32771,0.001011,172.31.40.0-255,66,76796,63,279876
32772,0.001059,74.125.68.0-255,1484,78280,63,279876
32773,0.001079,74.125.68.0-255,1484,79764,63,279876
32774,0.001082,172.31.40.0-255,66,79830,63,279876
32775,0.001086,74.125.68.0-255,2902,82732,63,279876
32776,0.001088,172.31.40.0-255,66,82798,63,279876
32777,0.001109,74.125.68.0-255,5738,88536,63,279876
32778,0.001116,172.31.40.0-255,66,88602,63,279876
32779,0.001119,74.125.68.0-255,1484,90086,63,279876
32780,0.001152,172.31.40.0-255,66,90152,63,279876
32781,0.001177,74.125.68.0-255,2184,92336,63,279876
32782,0.00118,172.31.40.0-255,66,92402,63,279876
32783,0.001208,74.125.68.0-255,2902,95304,63,279876
32784,0.001211,172.31.40.0-255,66,95370,63,279876
32785,0.001214,74.125.68.0-255,1484,96854,63,279876
32786,0.001239,74.125.68.0-255,2902,99756,63,279876
32787,0.001245,74.125.68.0-255,5738,105494,63,279876
32788,0.001249,172.31.40.0-255,66,105560,63,279876
32789,0.001253,172.31.40.0-255,66,105626,63,279876
32790,0.001281,172.31.40.0-255,66,105692,63,279876
32791,0.001304,74.125.68.0-255,1484,107176,63,279876
32792,0.001318,172.31.40.0-255,66,107242,63,279876
32793,0.001344,74.125.68.0-255,1484,108726,63,279876
32794,0.001349,74.125.68.0-255,2902,111628,63,279876
32795,0.001351,172.31.40.0-255,66,111694,63,279876
32796,0.001358,74.125.68.0-255,5738,117432,63,279876
32797,0.00136,172.31.40.0-255,66,117498,63,279876
32798,0.001394,74.125.68.0-255,5738,123236,63,279876
32799,0.001398,172.31.40.0-255,66,123302,63,279876
32800,0.001424,74.125.68.0-255,5738,129040,63,279876
32801,0.001427,172.31.40.0-255,66,129106,63,279876
32802,0.001456,74.125.68.0-255,7156,136262,63,279876
32803,0.001459,172.31.40.0-255,66,136328,63,279876
32804,0.001484,74.125.68.0-255,5020,141348,63,279876
32805,0.001487,172.31.40.0-255,66,141414,63,279876
32806,0.001591,74.125.68.0-255,1484,142898,63,279876
32807,0.001594,74.125.68.0-255,1484,144382,63,279876
32808,0.001597,172.31.40.0-255,66,144448,63,279876
32809,0.001629,74.125.68.0-255,1484,145932,63,279876
32810,0.001636,74.125.68.0-255,5738,151670,63,279876
32811,0.001639,172.31.40.0-255,66,151736,63,279876
32812,0.001642,74.125.68.0-255,1484,153220,63,279876
32813,0.001646,74.125.68.0-255,2902,156122,63,279876
32814,0.001647,172.31.40.0-255,66,156188,63,279876
32815,0.001687,74.125.68.0-255,5738,161926,63,279876
32816,0.00169,172.31.40.0-255,66,161992,63,279876
32817,0.001696,74.125.68.0-255,2902,164894,63,279876
32818,0.001698,172.31.40.0-255,66,164960,63,279876
32819,0.001743,172.31.40.0-255,66,165026,63,279876
32820,0.001745,74.125.68.0-255,766,165792,63,279876
32821,0.001869,74.125.68.0-255,1484,167276,63,279876
32822,0.001873,172.31.40.0-255,66,167342,63,279876
32823,0.001878,74.125.68.0-255,2902,170244,63,279876
32824,0.00188,172.31.40.0-255,66,170310,63,279876
32825,0.001934,74.125.68.0-255,2902,173212,63,279876
32826,0.001937,172.31.40.0-255,66,173278,63,279876
32827,0.001963,74.125.68.0-255,2902,176180,63,279876
32828,0.001966,172.31.40.0-255,66,176246,63,279876
32829,0.001974,74.125.68.0-255,7156,183402,63,279876
32830,0.001975,172.31.40.0-255,66,183468,63,279876
32831,0.001999,74.125.68.0-255,4320,187788,63,279876
32832,0.002001,172.31.40.0-255,66,187854,63,279876
32833,0.002008,74.125.68.0-255,5738,193592,63,279876
32834,0.00201,172.31.40.0-255,66,193658,63,279876
32835,0.002047,74.125.68.0-255,6438,200096,63,279876
32836,0.00205,172.31.40.0-255,66,200162,63,279876
32837,0.002075,74.125.68.0-255,4320,204482,63,279876
32838,0.002078,172.31.40.0-255,66,204548,63,279876
32839,0.002105,74.125.68.0-255,2902,207450,63,279876
32840,0.002108,172.31.40.0-255,66,207516,63,279876
32841,0.002113,74.125.68.0-255,4320,211836,63,279876
32842,0.002115,172.31.40.0-255,66,211902,63,279876
32843,0.002123,74.125.68.0-255,1484,213386,63,279876
32844,0.00216,172.31.40.0-255,66,213452,63,279876
32845,0.002167,74.125.68.0-255,5738,219190,63,279876
32846,0.002169,172.31.40.0-255,66,219256,63,279876
32847,0.002207,74.125.68.0-255,1484,220740,63,279876
32848,0.002234,74.125.68.0-255,5020,225760,63,279876
32849,0.002237,172.31.40.0-255,66,225826,63,279876
32850,0.002242,74.125.68.0-255,4320,230146,63,279876
32851,0.002245,172.31.40.0-255,66,230212,63,279876
32852,0.002256,172.31.40.0-255,66,230278,63,279876
32853,0.002292,74.125.68.0-255,4320,234598,63,279876
32854,0.002295,172.31.40.0-255,66,234664,63,279876
32855,0.002302,74.125.68.0-255,5738,240402,63,279876
32856,0.002304,172.31.40.0-255,66,240468,63,279876
32857,0.002315,172.31.40.0-255,66,240534,63,279876
32858,0.002317,74.125.68.0-255,1484,242018,63,279876
32859,0.004617,74.125.68.0-255,4320,246338,63,279876
32860,0.00464,172.31.40.0-255,66,246404,63,279876
32861,0.006944,74.125.68.0-255,5738,252142,63,279876
32862,0.006962,172.31.40.0-255,66,252208,63,279876
32863,0.009246,74.125.68.0-255,5738,257946,63,279876
32864,0.009252,172.31.40.0-255,66,258012,63,279876
32865,0.011545,74.125.68.0-255,4320,262332,63,279876
32866,0.011554,172.31.40.0-255,66,262398,63,279876
32867,0.01158,74.125.68.0-255,1484,263882,63,279876
32868,0.013854,74.125.68.0-255,4320,268202,63,279876
32869,0.015379,172.31.40.0-255,66,268268,63,279876
32870,0.017674,74.125.68.0-255,5738,274006,63,279876
32871,0.017685,172.31.40.0-255,66,274072,63,279876
32872,0.019968,74.125.68.0-255,5738,279810,63,279876
32873,0.019978,172.31.40.0-255,66,279876,63,279876
32874,0.0,74.125.200.0-255,153,153,63,214790
32875,3.1e-05,172.31.40.0-255,66,219,63,214790
32876,3.7e-05,74.125.200.0-255,1484,1703,63,214790
32877,4e-05,172.31.40.0-255,66,1769,63,214790
32878,4.4e-05,74.125.200.0-255,2902,4671,63,214790
32879,4.6e-05,172.31.40.0-255,66,4737,63,214790
32880,5e-05,74.125.200.0-255,2902,7639,63,214790
32881,6e-05,172.31.40.0-255,66,7705,63,214790
32882,6.5e-05,74.125.200.0-255,2902,10607,63,214790
32883,6.7e-05,172.31.40.0-255,66,10673,63,214790
32884,9.5e-05,74.125.200.0-255,1484,12157,63,214790
32885,9.7e-05,172.31.40.0-255,66,12223,63,214790
32886,0.000123,74.125.200.0-255,2038,14261,63,214790
32887,0.000125,172.31.40.0-255,66,14327,63,214790
32888,0.000202,74.125.200.0-255,1484,15811,63,214790
32889,0.000206,172.31.40.0-255,66,15877,63,214790
32890,0.00021,74.125.200.0-255,2902,18779,63,214790
32891,0.000212,172.31.40.0-255,66,18845,63,214790
32892,0.000247,74.125.200.0-255,5738,24583,63,214790
32893,0.00025,172.31.40.0-255,66,24649,63,214790
32894,0.000257,74.125.200.0-255,6797,31446,63,214790
32895,0.000259,172.31.40.0-255,66,31512,63,214790
32896,0.00033,74.125.200.0-255,1484,32996,63,214790
32897,0.000333,172.31.40.0-255,66,33062,63,214790
32898,0.000337,74.125.200.0-255,1484,34546,63,214790
32899,0.000338,172.31.40.0-255,66,34612,63,214790
32900,0.000367,74.125.200.0-255,2902,37514,63,214790
32901,0.00037,172.31.40.0-255,66,37580,63,214790
32902,0.000374,74.125.200.0-255,1484,39064,63,214790
32903,0.000375,172.31.40.0-255,66,39130,63,214790
32904,0.000396,74.125.200.0-255,4320,43450,63,214790
32905,0.000403,172.31.40.0-255,66,43516,63,214790
32906,0.000429,74.125.200.0-255,2902,46418,63,214790
32907,0.000431,172.31.40.0-255,66,46484,63,214790
32908,0.000463,74.125.200.0-255,5379,51863,63,214790
32909,0.000467,172.31.40.0-255,66,51929,63,214790
32910,0.000473,172.31.40.0-255,66,51995,63,214790
32911,0.000478,74.125.200.0-255,5379,57374,63,214790
32912,0.000484,172.31.40.0-255,66,57440,63,214790
32913,0.00053,74.125.200.0-255,409,57849,63,214790
32914,0.000638,74.125.200.0-255,333,58182,63,214790
32915,0.000707,172.31.40.0-255,66,58248,63,214790
32916,0.000895,74.125.200.0-255,1484,59732,63,214790
32917,0.000905,74.125.200.0-255,2902,62634,63,214790
32918,0.000908,172.31.40.0-255,66,62700,63,214790
32919,0.000913,74.125.200.0-255,1484,64184,63,214790
32920,0.000937,74.125.200.0-255,1484,65668,63,214790
32921,0.00094,172.31.40.0-255,66,65734,63,214790
32922,0.000946,74.125.200.0-255,4320,70054,63,214790
32923,0.000949,172.31.40.0-255,66,70120,63,214790
32924,0.000978,74.125.200.0-255,2902,73022,63,214790
32925,0.000982,172.31.40.0-255,66,73088,63,214790
32926,0.000989,74.125.200.0-255,7156,80244,63,214790
32927,0.000991,172.31.40.0-255,66,80310,63,214790
32928,0.001025,74.125.200.0-255,5738,86048,63,214790
32929,0.001028,172.31.40.0-255,66,86114,63,214790
32930,0.001033,74.125.200.0-255,2902,89016,63,214790
32931,0.001035,172.31.40.0-255,66,89082,63,214790
32932,0.001064,74.125.200.0-255,3602,92684,63,214790
32933,0.001067,172.31.40.0-255,66,92750,63,214790
32934,0.001091,74.125.200.0-255,1484,94234,63,214790
32935,0.001112,74.125.200.0-255,2902,97136,63,214790
32936,0.001114,172.31.40.0-255,66,97202,63,214790
32937,0.001118,74.125.200.0-255,1484,98686,63,214790
32938,0.001143,74.125.200.0-255,2902,101588,63,214790
32939,0.001145,172.31.40.0-255,66,101654,63,214790
32940,0.001173,74.125.200.0-255,5738,107392,63,214790
32941,0.001176,172.31.40.0-255,66,107458,63,214790
32942,0.001181,74.125.200.0-255,2902,110360,63,214790
32943,0.001182,172.31.40.0-255,66,110426,63,214790
32944,0.001213,74.125.200.0-255,4320,114746,63,214790
32945,0.001217,172.31.40.0-255,66,114812,63,214790
32946,0.00122,74.125.200.0-255,1484,116296,63,214790
32947,0.001245,74.125.200.0-255,2902,119198,63,214790
32948,0.001248,172.31.40.0-255,66,119264,63,214790
32949,0.001253,74.125.200.0-255,2902,122166,63,214790
32950,0.001254,172.31.40.0-255,66,122232,63,214790
32951,0.001279,74.125.200.0-255,2902,125134,63,214790
32952,0.001282,172.31.40.0-255,66,125200,63,214790
32953,0.001293,74.125.200.0-255,2184,127384,63,214790
32954,0.001296,172.31.40.0-255,66,127450,63,214790
32955,0.001353,74.125.200.0-255,1484,128934,63,214790
32956,0.001357,74.125.200.0-255,1484,130418,63,214790
32957,0.001359,172.31.40.0-255,66,130484,63,214790
32958,0.001371,74.125.200.0-255,1484,131968,63,214790
32959,0.001381,74.125.200.0-255,4320,136288,63,214790
32960,0.001383,172.31.40.0-255,66,136354,63,214790
32961,0.001408,74.125.200.0-255,1484,137838,63,214790
32962,0.001415,74.125.200.0-255,7156,144994,63,214790
32963,0.001417,172.31.40.0-255,66,145060,63,214790
32964,0.001496,172.31.40.0-255,66,145126,63,214790
32965,0.0015,74.125.200.0-255,2184,147310,63,214790
32966,0.001502,172.31.40.0-255,66,147376,63,214790
32967,0.001986,74.125.200.0-255,1484,148860,63,214790
32968,0.001996,74.125.200.0-255,1484,150344,63,214790
32969,0.001999,172.31.40.0-255,66,150410,63,214790
32970,0.002003,74.125.200.0-255,2902,153312,63,214790
32971,0.002005,172.31.40.0-255,66,153378,63,214790
32972,0.002027,74.125.200.0-255,5738,159116,63,214790
32973,0.002033,172.31.40.0-255,66,159182,63,214790
32974,0.002063,172.31.40.0-255,66,159248,63,214790
32975,0.002087,74.125.200.0-255,1484,160732,63,214790
32976,0.002093,74.125.200.0-255,4320,165052,63,214790
32977,0.002095,172.31.40.0-255,66,165118,63,214790
32978,0.002122,74.125.200.0-255,5738,170856,63,214790
32979,0.002124,172.31.40.0-255,66,170922,63,214790
32980,0.002148,74.125.200.0-255,1484,172406,63,214790
32981,0.002151,74.125.200.0-255,766,173172,63,214790
32982,0.002152,172.31.40.0-255,66,173238,63,214790
32983,0.004441,74.125.200.0-255,2902,176140,63,214790
32984,0.004444,172.31.40.0-255,66,176206,63,214790
32985,0.004464,74.125.200.0-255,2902,179108,63,214790
32986,0.004467,172.31.40.0-255,66,179174,63,214790
32987,0.006754,74.125.200.0-255,2902,182076,63,214790
32988,0.006758,172.31.40.0-255,66,182142,63,214790
32989,0.006795,74.125.200.0-255,2902,185044,63,214790
32990,0.006798,172.31.40.0-255,66,185110,63,214790
32991,0.009093,74.125.200.0-255,2902,188012,63,214790
32992,0.009101,172.31.40.0-255,66,188078,63,214790
32993,0.009124,74.125.200.0-255,2902,190980,63,214790
32994,0.009128,172.31.40.0-255,66,191046,63,214790
32995,0.011431,74.125.200.0-255,2902,193948,63,214790
32996,0.011438,172.31.40.0-255,66,194014,63,214790
32997,0.011473,74.125.200.0-255,2902,196916,63,214790
32998,0.011476,172.31.40.0-255,66,196982,63,214790
32999,0.013761,74.125.200.0-255,2902,199884,63,214790
33000,0.013771,172.31.40.0-255,66,199950,63,214790
33001,0.013809,74.125.200.0-255,2902,202852,63,214790
33002,0.013813,172.31.40.0-255,66,202918,63,214790
33003,0.016096,74.125.200.0-255,2902,205820,63,214790
33004,0.016103,172.31.40.0-255,66,205886,63,214790
33005,0.016139,74.125.200.0-255,2902,208788,63,214790
33006,0.016142,172.31.40.0-255,66,208854,63,214790
33007,0.01842,74.125.200.0-255,2902,211756,63,214790
33008,0.018428,172.31.40.0-255,66,211822,63,214790
33009,0.018467,74.125.200.0-255,2902,214724,63,214790
33010,0.018471,172.31.40.0-255,66,214790,63,214790
33011,0.0,172.217.194.0-255,290,290,63,193091
33012,2.3e-05,172.31.40.0-255,66,356,63,193091
33013,3e-05,172.217.194.0-255,1484,1840,63,193091
33014,3.5e-05,172.31.40.0-255,66,1906,63,193091
33015,4.9e-05,172.217.194.0-255,4320,6226,63,193091
33016,5.3e-05,172.31.40.0-255,66,6292,63,193091
33017,6.6e-05,172.31.40.0-255,66,6358,63,193091
33018,0.000125,172.31.40.0-255,66,6424,63,193091
33019,0.00013,172.217.194.0-255,2543,8967,63,193091
33020,0.000133,172.31.40.0-255,66,9033,63,193091
33021,0.000161,172.217.194.0-255,1484,10517,63,193091
33022,0.000164,172.31.40.0-255,66,10583,63,193091
33023,0.000169,172.217.194.0-255,2902,13485,63,193091
33024,0.000171,172.31.40.0-255,66,13551,63,193091
33025,0.000176,172.217.194.0-255,2902,16453,63,193091
33026,0.000184,172.31.40.0-255,66,16519,63,193091
33027,0.000221,172.217.194.0-255,2902,19421,63,193091
33028,0.000224,172.31.40.0-255,66,19487,63,193091
33029,0.000242,172.31.40.0-255,66,19553,63,193091
33030,0.000267,172.217.194.0-255,4320,23873,63,193091
33031,0.00027,172.31.40.0-255,66,23939,63,193091
33032,0.000293,172.217.194.0-255,6797,30736,63,193091
33033,0.000296,172.31.40.0-255,66,30802,63,193091
33034,0.000441,172.217.194.0-255,378,31180,63,193091
33035,0.000446,172.31.40.0-255,66,31246,63,193091
33036,0.000487,172.217.194.0-255,365,31611,63,193091
33037,0.00049,172.31.40.0-255,66,31677,63,193091
33038,0.000624,172.217.194.0-255,1484,33161,63,193091
33039,0.000628,172.31.40.0-255,66,33227,63,193091
33040,0.000634,172.217.194.0-255,2902,36129,63,193091
33041,0.000637,172.31.40.0-255,66,36195,63,193091
33042,0.000641,172.217.194.0-255,2902,39097,63,193091
33043,0.000649,172.31.40.0-255,66,39163,63,193091
33044,0.000685,172.217.194.0-255,2902,42065,63,193091
33045,0.000688,172.31.40.0-255,66,42131,63,193091
33046,0.000695,172.217.194.0-255,7156,49287,63,193091
33047,0.000733,172.31.40.0-255,66,49353,63,193091
33048,0.000957,172.217.194.0-255,1484,50837,63,193091
33049,0.000971,172.217.194.0-255,2902,53739,63,193091
33050,0.000975,172.217.194.0-255,1484,55223,63,193091
33051,0.000989,172.217.194.0-255,4320,59543,63,193091
33052,0.001002,172.31.40.0-255,66,59609,63,193091
33053,0.001005,172.217.194.0-255,1484,61093,63,193091
33054,0.001037,172.217.194.0-255,5738,66831,63,193091
33055,0.001062,172.217.194.0-255,5020,71851,63,193091
33056,0.001082,172.31.40.0-255,66,71917,63,193091
33057,0.001119,172.217.194.0-255,1484,73401,63,193091
33058,0.001135,172.217.194.0-255,2902,76303,63,193091
33059,0.001142,172.217.194.0-255,5738,82041,63,193091
33060,0.00116,172.31.40.0-255,66,82107,63,193091
33061,0.001189,172.31.40.0-255,66,82173,63,193091
33062,0.001192,172.217.194.0-255,1484,83657,63,193091
33063,0.001199,172.217.194.0-255,7156,90813,63,193091
33064,0.001226,172.31.40.0-255,66,90879,63,193091
33065,0.001246,172.217.194.0-255,3602,94481,63,193091
33066,0.001259,172.31.40.0-255,66,94547,63,193091
33067,0.00136,172.217.194.0-255,1484,96031,63,193091
33068,0.001385,172.217.194.0-255,1484,97515,63,193091
33069,0.001388,172.31.40.0-255,66,97581,63,193091
33070,0.001414,172.217.194.0-255,2902,100483,63,193091
33071,0.00142,172.217.194.0-255,5738,106221,63,193091
33072,0.001425,172.31.40.0-255,66,106287,63,193091
33073,0.001458,172.217.194.0-255,5738,112025,63,193091
33074,0.001461,172.217.194.0-255,1484,113509,63,193091
33075,0.001471,172.31.40.0-255,66,113575,63,193091
33076,0.00152,172.31.40.0-255,66,113641,63,193091
33077,0.001542,172.217.194.0-255,3602,117243,63,193091
33078,0.001553,172.31.40.0-255,66,117309,63,193091
33079,0.00174,172.217.194.0-255,1484,118793,63,193091
33080,0.001761,172.217.194.0-255,2902,121695,63,193091
33081,0.001764,172.31.40.0-255,66,121761,63,193091
33082,0.00177,172.217.194.0-255,5738,127499,63,193091
33083,0.001798,172.31.40.0-255,66,127565,63,193091
33084,0.001827,172.217.194.0-255,2902,130467,63,193091
33085,0.001841,172.31.40.0-255,66,130533,63,193091
33086,0.001863,172.217.194.0-255,5738,136271,63,193091
33087,0.001875,172.31.40.0-255,66,136337,63,193091
33088,0.001942,172.31.40.0-255,66,136403,63,193091
33089,0.001975,172.217.194.0-255,1484,137887,63,193091
33090,0.001987,172.217.194.0-255,2902,140789,63,193091
33091,0.001991,172.31.40.0-255,66,140855,63,193091
33092,0.002008,172.217.194.0-255,5738,146593,63,193091
33093,0.002023,172.31.40.0-255,66,146659,63,193091
33094,0.004033,172.217.194.0-255,5738,152397,63,193091
33095,0.00404,172.31.40.0-255,66,152463,63,193091
33096,0.006043,172.217.194.0-255,5738,158201,63,193091
33097,0.006047,172.31.40.0-255,66,158267,63,193091
33098,0.008048,172.217.194.0-255,5738,164005,63,193091
33099,0.008794,172.31.40.0-255,66,164071,63,193091
33100,0.010788,172.217.194.0-255,5738,169809,63,193091
33101,0.010795,172.31.40.0-255,66,169875,63,193091
33102,0.012842,172.217.194.0-255,5738,175613,63,193091
33103,0.01285,172.31.40.0-255,66,175679,63,193091
33104,0.014872,172.217.194.0-255,5738,181417,63,193091
33105,0.015081,172.31.40.0-255,66,181483,63,193091
33106,0.017115,172.217.194.0-255,5738,187221,63,193091
33107,0.017126,172.31.40.0-255,66,187287,63,193091
33108,0.019135,172.217.194.0-255,5738,193025,63,193091
33109,0.019143,172.31.40.0-255,66,193091,63,193091
33110,0.0,172.31.40.0-255,105,105,63,276
33111,0.001796,157.240.24.0-255,105,210,63,276
33112,0.00181,172.31.40.0-255,66,276,63,276
33113,0.0,74.125.130.0-255,152,152,63,154647
33114,2.4e-05,172.31.40.0-255,66,218,63,154647
33115,3.1e-05,74.125.130.0-255,1484,1702,63,154647
33116,3.7e-05,172.31.40.0-255,66,1768,63,154647
33117,5e-05,74.125.130.0-255,2902,4670,63,154647
33118,5.4e-05,172.31.40.0-255,66,4736,63,154647
33119,6.1e-05,74.125.130.0-255,5738,10474,63,154647
33120,6.4e-05,172.31.40.0-255,66,10540,63,154647
33121,6.8e-05,74.125.130.0-255,2902,13442,63,154647
33122,7.1e-05,172.31.40.0-255,66,13508,63,154647
33123,9.7e-05,74.125.130.0-255,3448,16956,63,154647
33124,0.000105,172.31.40.0-255,66,17022,63,154647
33125,0.000113,74.125.130.0-255,5738,22760,63,154647
33126,0.000116,172.31.40.0-255,66,22826,63,154647
33127,0.000138,74.125.130.0-255,2902,25728,63,154647
33128,0.00014,172.31.40.0-255,66,25794,63,154647
33129,0.000149,74.125.130.0-255,2902,28696,63,154647
33130,0.000152,172.31.40.0-255,66,28762,63,154647
33131,0.000175,74.125.130.0-255,2543,31305,63,154647
33132,0.000177,172.31.40.0-255,66,31371,63,154647
33133,0.000399,74.125.130.0-255,1484,32855,63,154647
33134,0.000405,172.31.40.0-255,66,32921,63,154647
33135,0.000411,74.125.130.0-255,2902,35823,63,154647
33136,0.000413,172.31.40.0-255,66,35889,63,154647
33137,0.000416,74.125.130.0-255,1484,37373,63,154647
33138,0.000418,172.31.40.0-255,66,37439,63,154647
33139,0.000451,74.125.130.0-255,2902,40341,63,154647
33140,0.000454,172.31.40.0-255,66,40407,63,154647
33141,0.000459,74.125.130.0-255,5738,46145,63,154647
33142,0.000462,172.31.40.0-255,66,46211,63,154647
33143,0.000477,74.125.130.0-255,1484,47695,63,154647
33144,0.000479,172.31.40.0-255,66,47761,63,154647
33145,0.000484,74.125.130.0-255,2902,50663,63,154647
33146,0.000486,172.31.40.0-255,66,50729,63,154647
33147,0.000514,74.125.130.0-255,5738,56467,63,154647
33148,0.000517,172.31.40.0-255,66,56533,63,154647
33149,0.000522,74.125.130.0-255,2902,59435,63,154647
33150,0.000524,172.31.40.0-255,66,59501,63,154647
33151,0.000554,74.125.130.0-255,6438,65939,63,154647
33152,0.000557,172.31.40.0-255,66,66005,63,154647
33153,0.00056,74.125.130.0-255,341,66346,63,154647
33154,0.001023,74.125.130.0-255,401,66747,63,154647
33155,0.001114,172.31.40.0-255,66,66813,63,154647
33156,0.001571,74.125.130.0-255,1484,68297,63,154647
33157,0.001581,74.125.130.0-255,2902,71199,63,154647
33158,0.001596,172.31.40.0-255,66,71265,63,154647
33159,0.001602,74.125.130.0-255,4320,75585,63,154647
33160,0.001604,172.31.40.0-255,66,75651,63,154647
33161,0.001653,172.31.40.0-255,66,75717,63,154647
33162,0.001658,74.125.130.0-255,2902,78619,63,154647
33163,0.00166,172.31.40.0-255,66,78685,63,154647
33164,0.001676,74.125.130.0-255,2902,81587,63,154647
33165,0.001678,172.31.40.0-255,66,81653,63,154647
33166,0.00171,172.31.40.0-255,66,81719,63,154647
33167,0.001713,74.125.130.0-255,766,82485,63,154647
33168,0.001855,74.125.130.0-255,1484,83969,63,154647
33169,0.00186,172.31.40.0-255,66,84035,63,154647
33170,0.001866,74.125.130.0-255,2902,86937,63,154647
33171,0.001868,172.31.40.0-255,66,87003,63,154647
33172,0.001872,74.125.130.0-255,1484,88487,63,154647
33173,0.001898,74.125.130.0-255,4320,92807,63,154647
33174,0.001901,172.31.40.0-255,66,92873,63,154647
33175,0.001912,172.31.40.0-255,66,92939,63,154647
33176,0.001916,74.125.130.0-255,2902,95841,63,154647
33177,0.001918,172.31.40.0-255,66,95907,63,154647
33178,0.001954,74.125.130.0-255,7156,103063,63,154647
33179,0.001957,172.31.40.0-255,66,103129,63,154647
33180,0.001963,74.125.130.0-255,5020,108149,63,154647
33181,0.001965,172.31.40.0-255,66,108215,63,154647
33182,0.004031,74.125.130.0-255,5738,113953,63,154647
33183,0.004038,172.31.40.0-255,66,114019,63,154647
33184,0.006121,74.125.130.0-255,5738,119757,63,154647
33185,0.006126,172.31.40.0-255,66,119823,63,154647
33186,0.008194,74.125.130.0-255,5738,125561,63,154647
33187,0.008201,172.31.40.0-255,66,125627,63,154647
33188,0.010283,74.125.130.0-255,5738,131365,63,154647
33189,0.010291,172.31.40.0-255,66,131431,63,154647
33190,0.012365,74.125.130.0-255,5738,137169,63,154647
33191,0.012373,172.31.40.0-255,66,137235,63,154647
33192,0.014444,74.125.130.0-255,5738,142973,63,154647
33193,0.014454,172.31.40.0-255,66,143039,63,154647
33194,0.016532,74.125.130.0-255,5738,148777,63,154647
33195,0.016541,172.31.40.0-255,66,148843,63,154647
33196,0.018625,74.125.130.0-255,5738,154581,63,154647
33197,0.018633,172.31.40.0-255,66,154647,63,154647
33198,0.0,172.217.194.0-255,152,152,63,123588
33199,1.9e-05,172.31.40.0-255,66,218,63,123588
33200,2.6e-05,172.217.194.0-255,1484,1702,63,123588
33201,3.1e-05,172.31.40.0-255,66,1768,63,123588
33202,3.7e-05,172.217.194.0-255,2902,4670,63,123588
33203,4e-05,172.31.40.0-255,66,4736,63,123588
33204,4.7e-05,172.217.194.0-255,7156,11892,63,123588
33205,5e-05,172.31.40.0-255,66,11958,63,123588
33206,5.4e-05,172.217.194.0-255,2109,14067,63,123588
33207,5.7e-05,172.31.40.0-255,66,14133,63,123588
33208,0.000111,172.217.194.0-255,1484,15617,63,123588
33209,0.000114,172.31.40.0-255,66,15683,63,123588
33210,0.000119,172.217.194.0-255,2902,18585,63,123588
33211,0.000121,172.31.40.0-255,66,18651,63,123588
33212,0.000128,172.217.194.0-255,5738,24389,63,123588
33213,0.00013,172.31.40.0-255,66,24455,63,123588
33214,0.000159,172.217.194.0-255,6797,31252,63,123588
33215,0.000162,172.31.40.0-255,66,31318,63,123588
33216,0.000697,172.217.194.0-255,1484,32802,63,123588
33217,0.000703,172.31.40.0-255,66,32868,63,123588
33218,0.000711,172.217.194.0-255,2902,35770,63,123588
33219,0.000713,172.31.40.0-255,66,35836,63,123588
33220,0.000717,172.217.194.0-255,1484,37320,63,123588
33221,0.000718,172.31.40.0-255,66,37386,63,123588
33222,0.000745,172.217.194.0-255,4320,41706,63,123588
33223,0.000747,172.31.40.0-255,66,41772,63,123588
33224,0.000758,172.31.40.0-255,66,41838,63,123588
33225,0.000772,172.217.194.0-255,5379,47217,63,123588
33226,0.000774,172.31.40.0-255,66,47283,63,123588
33227,0.000785,172.31.40.0-255,66,47349,63,123588
33228,0.001653,172.217.194.0-255,647,47996,63,123588
33229,0.001769,172.217.194.0-255,1484,49480,63,123588
33230,0.001775,172.31.40.0-255,66,49546,63,123588
33231,0.001781,172.217.194.0-255,2902,52448,63,123588
33232,0.001783,172.31.40.0-255,66,52514,63,123588
33233,0.001787,172.217.194.0-255,2902,55416,63,123588
33234,0.001789,172.31.40.0-255,66,55482,63,123588
33235,0.001823,172.217.194.0-255,2902,58384,63,123588
33236,0.001826,172.31.40.0-255,66,58450,63,123588
33237,0.001837,172.31.40.0-255,66,58516,63,123588
33238,0.001888,172.31.40.0-255,66,58582,63,123588
33239,0.002184,172.217.194.0-255,1484,60066,63,123588
33240,0.002235,172.217.194.0-255,2902,62968,63,123588
33241,0.002239,172.31.40.0-255,66,63034,63,123588
33242,0.002245,172.217.194.0-255,5738,68772,63,123588
33243,0.002248,172.31.40.0-255,66,68838,63,123588
33244,0.002261,172.31.40.0-255,66,68904,63,123588
33245,0.002266,172.217.194.0-255,4320,73224,63,123588
33246,0.002269,172.31.40.0-255,66,73290,63,123588
33247,0.002303,172.217.194.0-255,6438,79728,63,123588
33248,0.002307,172.31.40.0-255,66,79794,63,123588
33249,0.002317,172.31.40.0-255,66,79860,63,123588
33250,0.002336,172.217.194.0-255,2902,82762,63,123588
33251,0.002338,172.31.40.0-255,66,82828,63,123588
33252,0.002348,172.31.40.0-255,66,82894,63,123588
33253,0.002352,172.217.194.0-255,1484,84378,63,123588
33254,0.004629,172.217.194.0-255,4320,88698,63,123588
33255,0.004634,172.31.40.0-255,66,88764,63,123588
33256,0.006914,172.217.194.0-255,5738,94502,63,123588
33257,0.00692,172.31.40.0-255,66,94568,63,123588
33258,0.009226,172.217.194.0-255,5738,100306,63,123588
33259,0.009233,172.31.40.0-255,66,100372,63,123588
33260,0.011571,172.217.194.0-255,5738,106110,63,123588
33261,0.011579,172.31.40.0-255,66,106176,63,123588
33262,0.013898,172.217.194.0-255,5738,111914,63,123588
33263,0.013905,172.31.40.0-255,66,111980,63,123588
33264,0.016218,172.217.194.0-255,5738,117718,63,123588
33265,0.016226,172.31.40.0-255,66,117784,63,123588
33266,0.018539,172.217.194.0-255,5738,123522,63,123588
33267,0.018549,172.31.40.0-255,66,123588,63,123588
33268,0.0,172.31.40.0-255,105,105,63,276
33269,0.001785,157.240.24.0-255,105,210,63,276
33270,0.001799,172.31.40.0-255,66,276,63,276
33271,0.0,74.125.68.0-255,153,153,63,225270
33272,2.8e-05,172.31.40.0-255,66,219,63,225270
33273,3.5e-05,74.125.68.0-255,1484,1703,63,225270
33274,3.9e-05,172.31.40.0-255,66,1769,63,225270
33275,4.5e-05,74.125.68.0-255,2902,4671,63,225270
33276,4.9e-05,172.31.40.0-255,66,4737,63,225270
33277,6.5e-05,74.125.68.0-255,7156,11893,63,225270
33278,6.8e-05,172.31.40.0-255,66,11959,63,225270
33279,7.4e-05,74.125.68.0-255,4320,16279,63,225270
33280,7.8e-05,172.31.40.0-255,66,16345,63,225270
33281,0.000118,74.125.68.0-255,3419,19764,63,225270
33282,0.000122,172.31.40.0-255,66,19830,63,225270
33283,0.000126,74.125.68.0-255,1484,21314,63,225270
33284,0.000128,172.31.40.0-255,66,21380,63,225270
33285,0.000135,74.125.68.0-255,2902,24282,63,225270
33286,0.000138,172.31.40.0-255,66,24348,63,225270
33287,0.000144,74.125.68.0-255,4320,28668,63,225270
33288,0.000146,172.31.40.0-255,66,28734,63,225270
33289,0.000169,74.125.68.0-255,1484,30218,63,225270
33290,0.000171,172.31.40.0-255,66,30284,63,225270
33291,0.000203,74.125.68.0-255,1125,31409,63,225270
33292,0.000206,172.31.40.0-255,66,31475,63,225270
33293,0.000285,74.125.68.0-255,1484,32959,63,225270
33294,0.000289,172.31.40.0-255,66,33025,63,225270
33295,0.000316,74.125.68.0-255,1484,34509,63,225270
33296,0.000319,172.31.40.0-255,66,34575,63,225270
33297,0.00035,74.125.68.0-255,2902,37477,63,225270
33298,0.000353,172.31.40.0-255,66,37543,63,225270
33299,0.000356,74.125.68.0-255,1484,39027,63,225270
33300,0.000358,172.31.40.0-255,66,39093,63,225270
33301,0.000363,74.125.68.0-255,2902,41995,63,225270
33302,0.000365,172.31.40.0-255,66,42061,63,225270
33303,0.000398,74.125.68.0-255,5738,47799,63,225270
33304,0.000401,172.31.40.0-255,66,47865,63,225270
33305,0.000405,74.125.68.0-255,2902,50767,63,225270
33306,0.000408,172.31.40.0-255,66,50833,63,225270
33307,0.000419,74.125.68.0-255,1484,52317,63,225270
33308,0.000442,74.125.68.0-255,5738,58055,63,225270
33309,0.000445,172.31.40.0-255,66,58121,63,225270
33310,0.000448,74.125.68.0-255,1484,59605,63,225270
33311,0.000476,74.125.68.0-255,4320,63925,63,225270
33312,0.000478,172.31.40.0-255,66,63991,63,225270
33313,0.000505,74.125.68.0-255,2184,66175,63,225270
33314,0.000507,172.31.40.0-255,66,66241,63,225270
33315,0.000535,74.125.68.0-255,442,66683,63,225270
33316,0.000828,74.125.68.0-255,1484,68167,63,225270
33317,0.000834,172.31.40.0-255,66,68233,63,225270
33318,0.00084,74.125.68.0-255,2902,71135,63,225270
33319,0.000843,172.31.40.0-255,66,71201,63,225270
33320,0.000847,74.125.68.0-255,2902,74103,63,225270
33321,0.000855,172.31.40.0-255,66,74169,63,225270
33322,0.000894,74.125.68.0-255,7156,81325,63,225270
33323,0.000896,172.31.40.0-255,66,81391,63,225270
33324,0.000908,74.125.68.0-255,5738,87129,63,225270
33325,0.000911,172.31.40.0-255,66,87195,63,225270
33326,0.000949,74.125.68.0-255,5738,92933,63,225270
33327,0.000952,172.31.40.0-255,66,92999,63,225270
33328,0.00096,74.125.68.0-255,7156,100155,63,225270
33329,0.000963,172.31.40.0-255,66,100221,63,225270
33330,0.000999,74.125.68.0-255,2184,102405,63,225270
33331,0.001002,172.31.40.0-255,66,102471,63,225270
33332,0.001015,172.31.40.0-255,66,102537,63,225270
33333,0.001026,172.31.40.0-255,66,102603,63,225270
33334,0.001028,74.125.68.0-255,1484,104087,63,225270
33335,0.00106,172.31.40.0-255,66,104153,63,225270
33336,0.001065,74.125.68.0-255,2184,106337,63,225270
33337,0.001066,172.31.40.0-255,66,106403,63,225270
33338,0.00107,74.125.68.0-255,2902,109305,63,225270
33339,0.001072,172.31.40.0-255,66,109371,63,225270
33340,0.001119,74.125.68.0-255,7156,116527,63,225270
33341,0.001123,172.31.40.0-255,66,116593,63,225270
33342,0.00113,74.125.68.0-255,7156,123749,63,225270
33343,0.001132,172.31.40.0-255,66,123815,63,225270
33344,0.001135,74.125.68.0-255,1484,125299,63,225270
33345,0.001167,74.125.68.0-255,7156,132455,63,225270
33346,0.00117,172.31.40.0-255,66,132521,63,225270
33347,0.001175,74.125.68.0-255,2902,135423,63,225270
33348,0.001177,172.31.40.0-255,66,135489,63,225270
33349,0.001182,74.125.68.0-255,3602,139091,63,225270
33350,0.001184,172.31.40.0-255,66,139157,63,225270
33351,0.001187,74.125.68.0-255,331,139488,63,225270
33352,0.001693,74.125.68.0-255,1484,140972,63,225270
33353,0.001699,74.125.68.0-255,2902,143874,63,225270
33354,0.001709,172.31.40.0-255,66,143940,63,225270
33355,0.001713,172.31.40.0-255,66,144006,63,225270
33356,0.001718,74.125.68.0-255,2902,146908,63,225270
33357,0.00172,172.31.40.0-255,66,146974,63,225270
33358,0.001726,74.125.68.0-255,4320,151294,63,225270
33359,0.001728,172.31.40.0-255,66,151360,63,225270
33360,0.001783,74.125.68.0-255,4320,155680,63,225270
33361,0.001788,74.125.68.0-255,5738,161418,63,225270
33362,0.001798,172.31.40.0-255,66,161484,63,225270
33363,0.001801,172.31.40.0-255,66,161550,63,225270
33364,0.001804,172.31.40.0-255,66,161616,63,225270
33365,0.001826,74.125.68.0-255,3602,165218,63,225270
33366,0.001832,172.31.40.0-255,66,165284,63,225270
33367,0.002022,74.125.68.0-255,1484,166768,63,225270
33368,0.002038,74.125.68.0-255,2902,169670,63,225270
33369,0.002042,172.31.40.0-255,66,169736,63,225270
33370,0.002072,74.125.68.0-255,5738,175474,63,225270
33371,0.002075,172.31.40.0-255,66,175540,63,225270
33372,0.002105,74.125.68.0-255,2902,178442,63,225270
33373,0.002108,172.31.40.0-255,66,178508,63,225270
33374,0.004136,74.125.68.0-255,2902,181410,63,225270
33375,0.004144,172.31.40.0-255,66,181476,63,225270
33376,0.004177,74.125.68.0-255,2902,184378,63,225270
33377,0.004179,172.31.40.0-255,66,184444,63,225270
33378,0.006201,74.125.68.0-255,1484,185928,63,225270
33379,0.006213,74.125.68.0-255,1484,187412,63,225270
33380,0.006216,172.31.40.0-255,66,187478,63,225270
33381,0.00623,74.125.68.0-255,2902,190380,63,225270
33382,0.006236,172.31.40.0-255,66,190446,63,225270
33383,0.008283,74.125.68.0-255,5738,196184,63,225270
33384,0.008292,172.31.40.0-255,66,196250,63,225270
33385,0.010378,74.125.68.0-255,5738,201988,63,225270
33386,0.010386,172.31.40.0-255,66,202054,63,225270
33387,0.012466,74.125.68.0-255,5738,207792,63,225270
33388,0.012476,172.31.40.0-255,66,207858,63,225270
33389,0.014572,74.125.68.0-255,5738,213596,63,225270
33390,0.014589,172.31.40.0-255,66,213662,63,225270
33391,0.016736,74.125.68.0-255,5738,219400,63,225270
33392,0.016755,172.31.40.0-255,66,219466,63,225270
33393,0.018851,74.125.68.0-255,5738,225204,63,225270
33394,0.018873,172.31.40.0-255,66,225270,63,225270
33395,0.0,172.217.27.0-255,146,146,63,143245
33396,1.8e-05,172.31.40.0-255,66,212,63,143245
33397,4.2e-05,172.217.27.0-255,1484,1696,63,143245
33398,4.8e-05,172.31.40.0-255,66,1762,63,143245
33399,5.4e-05,172.217.27.0-255,2902,4664,63,143245
33400,5.8e-05,172.31.40.0-255,66,4730,63,143245
33401,6.2e-05,172.217.27.0-255,2902,7632,63,143245
33402,6.4e-05,172.31.40.0-255,66,7698,63,143245
33403,6.9e-05,172.217.27.0-255,4320,12018,63,143245
33404,7.2e-05,172.31.40.0-255,66,12084,63,143245
33405,0.000116,172.217.27.0-255,2151,14235,63,143245
33406,0.000119,172.31.40.0-255,66,14301,63,143245
33407,0.000318,172.217.27.0-255,1484,15785,63,143245
33408,0.000323,172.31.40.0-255,66,15851,63,143245
33409,0.000329,172.217.27.0-255,2902,18753,63,143245
33410,0.000332,172.31.40.0-255,66,18819,63,143245
33411,0.000335,172.217.27.0-255,1484,20303,63,143245
33412,0.000342,172.31.40.0-255,66,20369,63,143245
33413,0.000357,172.217.27.0-255,4320,24689,63,143245
33414,0.000359,172.31.40.0-255,66,24755,63,143245
33415,0.000371,172.217.27.0-255,6797,31552,63,143245
33416,0.000373,172.31.40.0-255,66,31618,63,143245
33417,0.000415,172.217.27.0-255,7156,38774,63,143245
33418,0.000418,172.31.40.0-255,66,38840,63,143245
33419,0.000434,172.31.40.0-255,66,38906,63,143245
33420,0.001159,172.217.27.0-255,1484,40390,63,143245
33421,0.001166,172.31.40.0-255,66,40456,63,143245
33422,0.001176,172.217.27.0-255,2902,43358,63,143245
33423,0.001178,172.31.40.0-255,66,43424,63,143245
33424,0.00119,172.217.27.0-255,4320,47744,63,143245
33425,0.001192,172.31.40.0-255,66,47810,63,143245
33426,0.001225,172.217.27.0-255,4320,52130,63,143245
33427,0.001228,172.31.40.0-255,66,52196,63,143245
33428,0.001259,172.217.27.0-255,5379,57575,63,143245
33429,0.001262,172.31.40.0-255,66,57641,63,143245
33430,0.001278,172.31.40.0-255,66,57707,63,143245
33431,0.001281,172.217.27.0-255,1484,59191,63,143245
33432,0.001284,172.31.40.0-255,66,59257,63,143245
33433,0.001308,172.217.27.0-255,4541,63798,63,143245
33434,0.00131,172.31.40.0-255,66,63864,63,143245
33435,0.001338,172.217.27.0-255,1484,65348,63,143245
33436,0.00134,172.31.40.0-255,66,65414,63,143245
33437,0.001347,172.217.27.0-255,2902,68316,63,143245
33438,0.001349,172.31.40.0-255,66,68382,63,143245
33439,0.00136,172.217.27.0-255,5738,74120,63,143245
33440,0.001363,172.31.40.0-255,66,74186,63,143245
33441,0.001397,172.217.27.0-255,6797,80983,63,143245
33442,0.0014,172.31.40.0-255,66,81049,63,143245
33443,0.00306,172.217.27.0-255,5738,86787,63,143245
33444,0.003068,172.31.40.0-255,66,86853,63,143245
33445,0.004757,172.217.27.0-255,2902,89755,63,143245
33446,0.004762,172.31.40.0-255,66,89821,63,143245
33447,0.004786,172.217.27.0-255,2902,92723,63,143245
33448,0.004789,172.31.40.0-255,66,92789,63,143245
33449,0.006426,172.217.27.0-255,2902,95691,63,143245
33450,0.006429,172.31.40.0-255,66,95757,63,143245
33451,0.006454,172.217.27.0-255,2902,98659,63,143245
33452,0.006456,172.31.40.0-255,66,98725,63,143245
33453,0.008081,172.217.27.0-255,2902,101627,63,143245
33454,0.008089,172.31.40.0-255,66,101693,63,143245
33455,0.008117,172.217.27.0-255,2902,104595,63,143245
33456,0.00812,172.31.40.0-255,66,104661,63,143245
33457,0.009755,172.217.27.0-255,2902,107563,63,143245
33458,0.009763,172.31.40.0-255,66,107629,63,143245
33459,0.009794,172.217.27.0-255,2902,110531,63,143245
33460,0.009797,172.31.40.0-255,66,110597,63,143245
33461,0.011428,172.217.27.0-255,2902,113499,63,143245
33462,0.011436,172.31.40.0-255,66,113565,63,143245
33463,0.011466,172.217.27.0-255,2902,116467,63,143245
33464,0.011468,172.31.40.0-255,66,116533,63,143245
33465,0.013099,172.217.27.0-255,2902,119435,63,143245
33466,0.013106,172.31.40.0-255,66,119501,63,143245
33467,0.013138,172.217.27.0-255,2902,122403,63,143245
33468,0.013141,172.31.40.0-255,66,122469,63,143245
33469,0.014769,172.217.27.0-255,2902,125371,63,143245
33470,0.014776,172.31.40.0-255,66,125437,63,143245
33471,0.014808,172.217.27.0-255,2902,128339,63,143245
33472,0.014811,172.31.40.0-255,66,128405,63,143245
33473,0.016433,172.217.27.0-255,2902,131307,63,143245
33474,0.01644,172.31.40.0-255,66,131373,63,143245
33475,0.016498,172.217.27.0-255,2902,134275,63,143245
33476,0.016501,172.31.40.0-255,66,134341,63,143245
33477,0.01811,172.217.27.0-255,2902,137243,63,143245
33478,0.018125,172.31.40.0-255,66,137309,63,143245
33479,0.018167,172.217.27.0-255,2902,140211,63,143245
33480,0.018501,172.31.40.0-255,66,140277,63,143245
33481,0.019786,172.217.27.0-255,2902,143179,63,143245
33482,0.019793,172.31.40.0-255,66,143245,63,143245
33483,0.0,74.125.130.0-255,153,153,63,160191
33484,2.4e-05,172.31.40.0-255,66,219,63,160191
33485,3.1e-05,74.125.130.0-255,1484,1703,63,160191
33486,3.5e-05,172.31.40.0-255,66,1769,63,160191
33487,4.2e-05,74.125.130.0-255,2902,4671,63,160191
33488,5.3e-05,172.31.40.0-255,66,4737,63,160191
33489,5.9e-05,74.125.130.0-255,4320,9057,63,160191
33490,6.2e-05,172.31.40.0-255,66,9123,63,160191
33491,6.9e-05,74.125.130.0-255,4841,13964,63,160191
33492,7.1e-05,172.31.40.0-255,66,14030,63,160191
33493,0.000137,74.125.130.0-255,1484,15514,63,160191
33494,0.00014,172.31.40.0-255,66,15580,63,160191
33495,0.000145,74.125.130.0-255,1484,17064,63,160191
33496,0.000147,172.31.40.0-255,66,17130,63,160191
33497,0.000167,74.125.130.0-255,1484,18614,63,160191
33498,0.00017,172.31.40.0-255,66,18680,63,160191
33499,0.000181,74.125.130.0-255,5738,24418,63,160191
33500,0.000184,172.31.40.0-255,66,24484,63,160191
33501,0.000208,74.125.130.0-255,4320,28804,63,160191
33502,0.00021,172.31.40.0-255,66,28870,63,160191
33503,0.000236,74.125.130.0-255,1484,30354,63,160191
33504,0.000238,172.31.40.0-255,66,30420,63,160191
33505,0.00024,74.125.130.0-255,1125,31545,63,160191
33506,0.000242,172.31.40.0-255,66,31611,63,160191
33507,0.000336,74.125.130.0-255,1484,33095,63,160191
33508,0.000339,172.31.40.0-255,66,33161,63,160191
33509,0.000358,74.125.130.0-255,2902,36063,63,160191
33510,0.000361,172.31.40.0-255,66,36129,63,160191
33511,0.000388,74.125.130.0-255,5738,41867,63,160191
33512,0.00039,172.31.40.0-255,66,41933,63,160191
33513,0.000393,74.125.130.0-255,1484,43417,63,160191
33514,0.000394,172.31.40.0-255,66,43483,63,160191
33515,0.000398,74.125.130.0-255,1484,44967,63,160191
33516,0.000417,74.125.130.0-255,1484,46451,63,160191
33517,0.000419,172.31.40.0-255,66,46517,63,160191
33518,0.000451,74.125.130.0-255,3961,50478,63,160191
33519,0.000453,172.31.40.0-255,66,50544,63,160191
33520,0.000482,74.125.130.0-255,4320,54864,63,160191
33521,0.000484,172.31.40.0-255,66,54930,63,160191
33522,0.000497,74.125.130.0-255,4320,59250,63,160191
33523,0.000502,172.31.40.0-255,66,59316,63,160191
33524,0.000519,74.125.130.0-255,4320,63636,63,160191
33525,0.000522,172.31.40.0-255,66,63702,63,160191
33526,0.000549,74.125.130.0-255,2543,66245,63,160191
33527,0.000551,172.31.40.0-255,66,66311,63,160191
33528,0.000563,74.125.130.0-255,378,66689,63,160191
33529,0.000617,74.125.130.0-255,366,67055,63,160191
33530,0.000977,172.31.40.0-255,66,67121,63,160191
33531,0.001002,74.125.130.0-255,1484,68605,63,160191
33532,0.001016,74.125.130.0-255,2902,71507,63,160191
33533,0.001018,172.31.40.0-255,66,71573,63,160191
33534,0.001046,74.125.130.0-255,2902,74475,63,160191
33535,0.001047,172.31.40.0-255,66,74541,63,160191
33536,0.001072,74.125.130.0-255,4320,78861,63,160191
33537,0.001074,172.31.40.0-255,66,78927,63,160191
33538,0.001103,172.31.40.0-255,66,78993,63,160191
33539,0.001107,74.125.130.0-255,4320,83313,63,160191
33540,0.001109,172.31.40.0-255,66,83379,63,160191
33541,0.001159,74.125.130.0-255,4320,87699,63,160191
33542,0.001162,172.31.40.0-255,66,87765,63,160191
33543,0.001181,74.125.130.0-255,5020,92785,63,160191
33544,0.001183,172.31.40.0-255,66,92851,63,160191
33545,0.001846,74.125.130.0-255,1484,94335,63,160191
33546,0.001904,74.125.130.0-255,1484,95819,63,160191
33547,0.001909,172.31.40.0-255,66,95885,63,160191
33548,0.001938,74.125.130.0-255,2902,98787,63,160191
33549,0.00194,172.31.40.0-255,66,98853,63,160191
33550,0.001961,74.125.130.0-255,1484,100337,63,160191
33551,0.001985,74.125.130.0-255,2902,103239,63,160191
33552,0.001987,172.31.40.0-255,66,103305,63,160191
33553,0.002011,74.125.130.0-255,2902,106207,63,160191
33554,0.002013,172.31.40.0-255,66,106273,63,160191
33555,0.002034,74.125.130.0-255,2902,109175,63,160191
33556,0.002036,172.31.40.0-255,66,109241,63,160191
33557,0.002057,74.125.130.0-255,1484,110725,63,160191
33558,0.002062,74.125.130.0-255,4320,115045,63,160191
33559,0.002064,172.31.40.0-255,66,115111,63,160191
33560,0.002096,74.125.130.0-255,4320,119431,63,160191
33561,0.002098,172.31.40.0-255,66,119497,63,160191
33562,0.002129,172.31.40.0-255,66,119563,63,160191
33563,0.004365,74.125.130.0-255,5738,125301,63,160191
33564,0.004369,172.31.40.0-255,66,125367,63,160191
33565,0.006615,74.125.130.0-255,5738,131105,63,160191
33566,0.006625,172.31.40.0-255,66,131171,63,160191
33567,0.008865,74.125.130.0-255,5738,136909,63,160191
33568,0.008872,172.31.40.0-255,66,136975,63,160191
33569,0.011193,74.125.130.0-255,5738,142713,63,160191
33570,0.0112,172.31.40.0-255,66,142779,63,160191
33571,0.013478,74.125.130.0-255,5738,148517,63,160191
33572,0.013485,172.31.40.0-255,66,148583,63,160191
33573,0.015736,74.125.130.0-255,5738,154321,63,160191
33574,0.015745,172.31.40.0-255,66,154387,63,160191
33575,0.017992,74.125.130.0-255,5738,160125,63,160191
33576,0.017999,172.31.40.0-255,66,160191,63,160191
33577,0.0,74.125.200.0-255,147,147,63,197049
33578,2.2e-05,172.31.40.0-255,66,213,63,197049
33579,3e-05,74.125.200.0-255,1484,1697,63,197049
33580,3.5e-05,172.31.40.0-255,66,1763,63,197049
33581,4.8e-05,74.125.200.0-255,2902,4665,63,197049
33582,5.2e-05,172.31.40.0-255,66,4731,63,197049
33583,6.1e-05,74.125.200.0-255,7156,11887,63,197049
33584,6.4e-05,172.31.40.0-255,66,11953,63,197049
33585,0.000122,74.125.200.0-255,2012,13965,63,197049
33586,0.000125,172.31.40.0-255,66,14031,63,197049
33587,0.000759,74.125.200.0-255,1484,15515,63,197049
33588,0.000766,172.31.40.0-255,66,15581,63,197049
33589,0.000775,74.125.200.0-255,2902,18483,63,197049
33590,0.000778,172.31.40.0-255,66,18549,63,197049
33591,0.00079,74.125.200.0-255,5738,24287,63,197049
33592,0.000793,172.31.40.0-255,66,24353,63,197049
33593,0.000844,74.125.200.0-255,2902,27255,63,197049
33594,0.000847,172.31.40.0-255,66,27321,63,197049
33595,0.000875,74.125.200.0-255,3961,31282,63,197049
33596,0.000879,172.31.40.0-255,66,31348,63,197049
33597,0.000927,74.125.200.0-255,7156,38504,63,197049
33598,0.000931,172.31.40.0-255,66,38570,63,197049
33599,0.001017,74.125.200.0-255,7156,45726,63,197049
33600,0.001021,172.31.40.0-255,66,45792,63,197049
33601,0.001057,172.31.40.0-255,66,45858,63,197049
33602,0.001203,74.125.200.0-255,7156,53014,63,197049
33603,0.001207,172.31.40.0-255,66,53080,63,197049
33604,0.001237,74.125.200.0-255,3602,56682,63,197049
33605,0.00124,172.31.40.0-255,66,56748,63,197049
33606,0.0013,74.125.200.0-255,398,57146,63,197049
33607,0.001303,172.31.40.0-255,66,57212,63,197049
33608,0.001307,74.125.200.0-255,111,57323,63,197049
33609,0.001332,74.125.200.0-255,1484,58807,63,197049
33610,0.001343,74.125.200.0-255,1484,60291,63,197049
33611,0.001361,74.125.200.0-255,4320,64611,63,197049
33612,0.001366,172.31.40.0-255,66,64677,63,197049
33613,0.001393,74.125.200.0-255,2902,67579,63,197049
33614,0.001408,172.31.40.0-255,66,67645,63,197049
33615,0.001441,74.125.200.0-255,2902,70547,63,197049
33616,0.001454,172.31.40.0-255,66,70613,63,197049
33617,0.001476,74.125.200.0-255,1484,72097,63,197049
33618,0.001492,74.125.200.0-255,5738,77835,63,197049
33619,0.001505,74.125.200.0-255,4320,82155,63,197049
33620,0.001511,172.31.40.0-255,66,82221,63,197049
33621,0.001623,74.125.200.0-255,7156,89377,63,197049
33622,0.001626,172.31.40.0-255,66,89443,63,197049
33623,0.001694,74.125.200.0-255,2184,91627,63,197049
33624,0.001709,172.31.40.0-255,66,91693,63,197049
33625,0.001853,74.125.200.0-255,1484,93177,63,197049
33626,0.001874,74.125.200.0-255,2902,96079,63,197049
33627,0.001877,172.31.40.0-255,66,96145,63,197049
33628,0.001905,74.125.200.0-255,5738,101883,63,197049
33629,0.001924,172.31.40.0-255,66,101949,63,197049
33630,0.00196,74.125.200.0-255,4320,106269,63,197049
33631,0.001972,172.31.40.0-255,66,106335,63,197049
33632,0.002012,74.125.200.0-255,5738,112073,63,197049
33633,0.002017,172.31.40.0-255,66,112139,63,197049
33634,0.002075,74.125.200.0-255,7156,119295,63,197049
33635,0.002084,172.31.40.0-255,66,119361,63,197049
33636,0.002093,74.125.200.0-255,4320,123681,63,197049
33637,0.002103,172.31.40.0-255,66,123747,63,197049
33638,0.002205,74.125.200.0-255,2184,125931,63,197049
33639,0.002208,172.31.40.0-255,66,125997,63,197049
33640,0.00226,74.125.200.0-255,1484,127481,63,197049
33641,0.002264,74.125.200.0-255,1484,128965,63,197049
33642,0.002273,172.31.40.0-255,66,129031,63,197049
33643,0.002284,74.125.200.0-255,4320,133351,63,197049
33644,0.002288,172.31.40.0-255,66,133417,63,197049
33645,0.002305,74.125.200.0-255,2902,136319,63,197049
33646,0.002326,172.31.40.0-255,66,136385,63,197049
33647,0.002368,74.125.200.0-255,2902,139287,63,197049
33648,0.002382,172.31.40.0-255,66,139353,63,197049
33649,0.002427,172.31.40.0-255,66,139419,63,197049
33650,0.002534,74.125.200.0-255,2902,142321,63,197049
33651,0.002538,172.31.40.0-255,66,142387,63,197049
33652,0.002563,74.125.200.0-255,1484,143871,63,197049
33653,0.002612,172.31.40.0-255,66,143937,63,197049
33654,0.002654,172.31.40.0-255,66,144003,63,197049
33655,0.003002,74.125.200.0-255,3602,147605,63,197049
33656,0.003006,172.31.40.0-255,66,147671,63,197049
33657,0.003033,74.125.200.0-255,1484,149155,63,197049
33658,0.003046,74.125.200.0-255,2902,152057,63,197049
33659,0.003052,172.31.40.0-255,66,152123,63,197049
33660,0.003091,74.125.200.0-255,4320,156443,63,197049
33661,0.003101,172.31.40.0-255,66,156509,63,197049
33662,0.00312,74.125.200.0-255,7156,163665,63,197049
33663,0.003137,172.31.40.0-255,66,163731,63,197049
33664,0.003224,74.125.200.0-255,2902,166633,63,197049
33665,0.003228,172.31.40.0-255,66,166699,63,197049
33666,0.003354,172.31.40.0-255,66,166765,63,197049
33667,0.003852,74.125.200.0-255,2902,169667,63,197049
33668,0.003946,74.125.200.0-255,5738,175405,63,197049
33669,0.003961,74.125.200.0-255,5738,181143,63,197049
33670,0.003979,74.125.200.0-255,2184,183327,63,197049
33671,0.004554,74.125.200.0-255,4320,187647,63,197049
33672,0.004611,74.125.200.0-255,5738,193385,63,197049
33673,0.005,74.125.200.0-255,2902,196287,63,197049
33674,0.009625,172.31.40.0-255,66,196353,63,197049
33675,0.011493,172.31.40.0-255,105,196458,63,197049
33676,0.011532,172.31.40.0-255,105,196563,63,197049
33677,0.011785,172.31.40.0-255,90,196653,63,197049
33678,0.011796,172.31.40.0-255,66,196719,63,197049
33679,0.013493,74.125.200.0-255,66,196785,63,197049
33680,0.013505,74.125.200.0-255,66,196851,63,197049
33681,0.013744,74.125.200.0-255,66,196917,63,197049
33682,0.014214,74.125.200.0-255,66,196983,63,197049
33683,0.014222,172.31.40.0-255,66,197049,63,197049
33684,0.0,172.217.194.0-255,150,150,63,168451
33685,2.3e-05,172.31.40.0-255,66,216,63,168451
33686,3e-05,172.217.194.0-255,1484,1700,63,168451
33687,3.5e-05,172.31.40.0-255,66,1766,63,168451
33688,4.1e-05,172.217.194.0-255,2902,4668,63,168451
33689,4.4e-05,172.31.40.0-255,66,4734,63,168451
33690,5e-05,172.217.194.0-255,5738,10472,63,168451
33691,5.2e-05,172.31.40.0-255,66,10538,63,168451
33692,5.9e-05,172.217.194.0-255,6236,16774,63,168451
33693,6.3e-05,172.31.40.0-255,66,16840,63,168451
33694,6.8e-05,172.217.194.0-255,4320,21160,63,168451
33695,7.2e-05,172.31.40.0-255,66,21226,63,168451
33696,0.000107,172.31.40.0-255,66,21292,63,168451
33697,0.00016,172.217.194.0-255,1484,22776,63,168451
33698,0.000163,172.31.40.0-255,66,22842,63,168451
33699,0.000166,172.217.194.0-255,1484,24326,63,168451
33700,0.000168,172.31.40.0-255,66,24392,63,168451
33701,0.000181,172.217.194.0-255,1484,25876,63,168451
33702,0.000185,172.31.40.0-255,66,25942,63,168451
33703,0.00019,172.217.194.0-255,4320,30262,63,168451
33704,0.000192,172.31.40.0-255,66,30328,63,168451
33705,0.000213,172.217.194.0-255,1484,31812,63,168451
33706,0.000215,172.31.40.0-255,66,31878,63,168451
33707,0.000227,172.31.40.0-255,66,31944,63,168451
33708,0.000243,172.217.194.0-255,2543,34487,63,168451
33709,0.000246,172.31.40.0-255,66,34553,63,168451
33710,0.000257,172.31.40.0-255,66,34619,63,168451
33711,0.000753,172.217.194.0-255,646,35265,63,168451
33712,0.000758,172.31.40.0-255,66,35331,63,168451
33713,0.001125,172.217.194.0-255,1484,36815,63,168451
33714,0.001134,172.217.194.0-255,2902,39717,63,168451
33715,0.001138,172.31.40.0-255,66,39783,63,168451
33716,0.001146,172.217.194.0-255,5738,45521,63,168451
33717,0.001149,172.31.40.0-255,66,45587,63,168451
33718,0.001216,172.31.40.0-255,66,45653,63,168451
33719,0.001229,172.31.40.0-255,66,45719,63,168451
33720,0.001902,172.217.194.0-255,1484,47203,63,168451
33721,0.001911,172.217.194.0-255,2902,50105,63,168451
33722,0.001916,172.31.40.0-255,66,50171,63,168451
33723,0.001923,172.217.194.0-255,4320,54491,63,168451
33724,0.001925,172.31.40.0-255,66,54557,63,168451
33725,0.00194,172.217.194.0-255,1484,56041,63,168451
33726,0.001946,172.217.194.0-255,5738,61779,63,168451
33727,0.001948,172.31.40.0-255,66,61845,63,168451
33728,0.001969,172.217.194.0-255,7156,69001,63,168451
33729,0.001972,172.31.40.0-255,66,69067,63,168451
33730,0.001983,172.31.40.0-255,66,69133,63,168451
33731,0.002006,172.217.194.0-255,766,69899,63,168451
33732,0.002105,172.217.194.0-255,1484,71383,63,168451
33733,0.002109,172.31.40.0-255,66,71449,63,168451
33734,0.002124,172.217.194.0-255,2902,74351,63,168451
33735,0.002127,172.31.40.0-255,66,74417,63,168451
33736,0.00213,172.217.194.0-255,1484,75901,63,168451
33737,0.002151,172.217.194.0-255,4320,80221,63,168451
33738,0.002153,172.31.40.0-255,66,80287,63,168451
33739,0.002166,172.217.194.0-255,1484,81771,63,168451
33740,0.002194,172.31.40.0-255,66,81837,63,168451
33741,0.002235,172.31.40.0-255,66,81903,63,168451
33742,0.002268,172.217.194.0-255,1484,83387,63,168451
33743,0.002297,172.217.194.0-255,2902,86289,63,168451
33744,0.002299,172.31.40.0-255,66,86355,63,168451
33745,0.002303,172.217.194.0-255,2902,89257,63,168451
33746,0.002306,172.31.40.0-255,66,89323,63,168451
33747,0.002318,172.217.194.0-255,2902,92225,63,168451
33748,0.002321,172.31.40.0-255,66,92291,63,168451
33749,0.002325,172.217.194.0-255,2902,95193,63,168451
33750,0.002327,172.31.40.0-255,66,95259,63,168451
33751,0.002343,172.217.194.0-255,2902,98161,63,168451
33752,0.002346,172.31.40.0-255,66,98227,63,168451
33753,0.002351,172.217.194.0-255,4320,102547,63,168451
33754,0.002354,172.31.40.0-255,66,102613,63,168451
33755,0.002381,172.31.40.0-255,66,102679,63,168451
33756,0.002387,172.217.194.0-255,5020,107699,63,168451
33757,0.00239,172.31.40.0-255,66,107765,63,168451
33758,0.002471,172.217.194.0-255,1484,109249,63,168451
33759,0.002475,172.217.194.0-255,2902,112151,63,168451
33760,0.002477,172.31.40.0-255,66,112217,63,168451
33761,0.002494,172.217.194.0-255,2902,115119,63,168451
33762,0.002496,172.31.40.0-255,66,115185,63,168451
33763,0.002508,172.217.194.0-255,2902,118087,63,168451
33764,0.00251,172.31.40.0-255,66,118153,63,168451
33765,0.002522,172.31.40.0-255,66,118219,63,168451
33766,0.002533,172.217.194.0-255,1484,119703,63,168451
33767,0.002565,172.217.194.0-255,2902,122605,63,168451
33768,0.002567,172.31.40.0-255,66,122671,63,168451
33769,0.00259,172.217.194.0-255,7156,129827,63,168451
33770,0.002593,172.31.40.0-255,66,129893,63,168451
33771,0.00261,172.217.194.0-255,3602,133495,63,168451
33772,0.002613,172.31.40.0-255,66,133561,63,168451
33773,0.005136,172.217.194.0-255,1484,135045,63,168451
33774,0.005153,172.217.194.0-255,4320,139365,63,168451
33775,0.005157,172.31.40.0-255,66,139431,63,168451
33776,0.007727,172.217.194.0-255,5738,145169,63,168451
33777,0.007733,172.31.40.0-255,66,145235,63,168451
33778,0.010301,172.217.194.0-255,5738,150973,63,168451
33779,0.010307,172.31.40.0-255,66,151039,63,168451
33780,0.012947,172.217.194.0-255,5738,156777,63,168451
33781,0.012967,172.31.40.0-255,66,156843,63,168451
33782,0.015521,172.217.194.0-255,5738,162581,63,168451
33783,0.015539,172.31.40.0-255,66,162647,63,168451
33784,0.018141,172.217.194.0-255,5738,168385,63,168451
33785,0.018158,172.31.40.0-255,66,168451,63,168451
33786,0.0,74.125.130.0-255,150,150,63,212262
33787,1.9e-05,172.31.40.0-255,66,216,63,212262
33788,2.6e-05,74.125.130.0-255,1484,1700,63,212262
33789,3.1e-05,172.31.40.0-255,66,1766,63,212262
33790,3.7e-05,74.125.130.0-255,2902,4668,63,212262
33791,4.1e-05,172.31.40.0-255,66,4734,63,212262
33792,6.6e-05,74.125.130.0-255,4320,9054,63,212262
33793,6.9e-05,172.31.40.0-255,66,9120,63,212262
33794,7.6e-05,74.125.130.0-255,4834,13954,63,212262
33795,7.8e-05,172.31.40.0-255,66,14020,63,212262
33796,0.000163,74.125.130.0-255,1484,15504,63,212262
33797,0.000166,172.31.40.0-255,66,15570,63,212262
33798,0.000181,74.125.130.0-255,2902,18472,63,212262
33799,0.000184,172.31.40.0-255,66,18538,63,212262
33800,0.000199,74.125.130.0-255,2902,21440,63,212262
33801,0.000201,172.31.40.0-255,66,21506,63,212262
33802,0.000214,74.125.130.0-255,2902,24408,63,212262
33803,0.000216,172.31.40.0-255,66,24474,63,212262
33804,0.000221,74.125.130.0-255,4320,28794,63,212262
33805,0.000224,172.31.40.0-255,66,28860,63,212262
33806,0.000251,74.125.130.0-255,2543,31403,63,212262
33807,0.000254,172.31.40.0-255,66,31469,63,212262
33808,0.000284,74.125.130.0-255,1484,32953,63,212262
33809,0.000287,172.31.40.0-255,66,33019,63,212262
33810,0.00029,74.125.130.0-255,1484,34503,63,212262
33811,0.000292,172.31.40.0-255,66,34569,63,212262
33812,0.000307,74.125.130.0-255,1484,36053,63,212262
33813,0.00031,172.31.40.0-255,66,36119,63,212262
33814,0.000316,74.125.130.0-255,5738,41857,63,212262
33815,0.000319,172.31.40.0-255,66,41923,63,212262
33816,0.000323,74.125.130.0-255,2902,44825,63,212262
33817,0.000325,172.31.40.0-255,66,44891,63,212262
33818,0.000331,74.125.130.0-255,3961,48852,63,212262
33819,0.000334,172.31.40.0-255,66,48918,63,212262
33820,0.000415,74.125.130.0-255,1484,50402,63,212262
33821,0.000421,74.125.130.0-255,2902,53304,63,212262
33822,0.000424,172.31.40.0-255,66,53370,63,212262
33823,0.00045,74.125.130.0-255,5738,59108,63,212262
33824,0.000454,172.31.40.0-255,66,59174,63,212262
33825,0.000458,74.125.130.0-255,2902,62076,63,212262
33826,0.00046,172.31.40.0-255,66,62142,63,212262
33827,0.000465,74.125.130.0-255,3961,66103,63,212262
33828,0.000467,172.31.40.0-255,66,66169,63,212262
33829,0.000553,74.125.130.0-255,1484,67653,63,212262
33830,0.000572,74.125.130.0-255,2902,70555,63,212262
33831,0.000575,172.31.40.0-255,66,70621,63,212262
33832,0.0006,74.125.130.0-255,5738,76359,63,212262
33833,0.000603,172.31.40.0-255,66,76425,63,212262
33834,0.000608,74.125.130.0-255,4320,80745,63,212262
33835,0.00061,172.31.40.0-255,66,80811,63,212262
33836,0.000666,74.125.130.0-255,3124,83935,63,212262
33837,0.000669,172.31.40.0-255,66,84001,63,212262
33838,0.000773,74.125.130.0-255,1484,85485,63,212262
33839,0.000777,74.125.130.0-255,1484,86969,63,212262
33840,0.00078,172.31.40.0-255,66,87035,63,212262
33841,0.000792,74.125.130.0-255,1484,88519,63,212262
33842,0.000799,74.125.130.0-255,5738,94257,63,212262
33843,0.000801,172.31.40.0-255,66,94323,63,212262
33844,0.000803,74.125.130.0-255,1484,95807,63,212262
33845,0.000859,74.125.130.0-255,4320,100127,63,212262
33846,0.000862,172.31.40.0-255,66,100193,63,212262
33847,0.000878,74.125.130.0-255,1125,101318,63,212262
33848,0.001298,74.125.130.0-255,1484,102802,63,212262
33849,0.001302,172.31.40.0-255,66,102868,63,212262
33850,0.001306,74.125.130.0-255,1484,104352,63,212262
33851,0.00132,74.125.130.0-255,2902,107254,63,212262
33852,0.001322,172.31.40.0-255,66,107320,63,212262
33853,0.001353,74.125.130.0-255,5738,113058,63,212262
33854,0.001355,172.31.40.0-255,66,113124,63,212262
33855,0.001358,74.125.130.0-255,1484,114608,63,212262
33856,0.001397,74.125.130.0-255,7156,121764,63,212262
33857,0.0014,172.31.40.0-255,66,121830,63,212262
33858,0.001418,74.125.130.0-255,1484,123314,63,212262
33859,0.001423,74.125.130.0-255,4320,127634,63,212262
33860,0.001425,172.31.40.0-255,66,127700,63,212262
33861,0.001445,74.125.130.0-255,4320,132020,63,212262
33862,0.001447,172.31.40.0-255,66,132086,63,212262
33863,0.001465,74.125.130.0-255,1484,133570,63,212262
33864,0.00147,74.125.130.0-255,2184,135754,63,212262
33865,0.001472,172.31.40.0-255,66,135820,63,212262
33866,0.001668,74.125.130.0-255,1484,137304,63,212262
33867,0.001694,74.125.130.0-255,2902,140206,63,212262
33868,0.001697,172.31.40.0-255,66,140272,63,212262
33869,0.001715,74.125.130.0-255,1484,141756,63,212262
33870,0.001738,74.125.130.0-255,4320,146076,63,212262
33871,0.001741,172.31.40.0-255,66,146142,63,212262
33872,0.001746,74.125.130.0-255,2902,149044,63,212262
33873,0.001748,172.31.40.0-255,66,149110,63,212262
33874,0.00175,74.125.130.0-255,1484,150594,63,212262
33875,0.001765,74.125.130.0-255,5738,156332,63,212262
33876,0.001768,172.31.40.0-255,66,156398,63,212262
33877,0.001784,74.125.130.0-255,2902,159300,63,212262
33878,0.001786,172.31.40.0-255,66,159366,63,212262
33879,0.00179,74.125.130.0-255,2902,162268,63,212262
33880,0.001793,172.31.40.0-255,66,162334,63,212262
33881,0.001855,172.31.40.0-255,66,162400,63,212262
33882,0.002289,74.125.130.0-255,1484,163884,63,212262
33883,0.002309,74.125.130.0-255,2902,166786,63,212262
33884,0.002314,172.31.40.0-255,66,166852,63,212262
33885,0.002333,74.125.130.0-255,2902,169754,63,212262
33886,0.002336,172.31.40.0-255,66,169820,63,212262
33887,0.002349,74.125.130.0-255,1484,171304,63,212262
33888,0.002364,74.125.130.0-255,2902,174206,63,212262
33889,0.002366,172.31.40.0-255,66,174272,63,212262
33890,0.004675,74.125.130.0-255,1484,175756,63,212262
33891,0.004707,74.125.130.0-255,4320,180076,63,212262
33892,0.004711,172.31.40.0-255,66,180142,63,212262
33893,0.007045,74.125.130.0-255,4320,184462,63,212262
33894,0.007048,172.31.40.0-255,66,184528,63,212262
33895,0.007069,74.125.130.0-255,1484,186012,63,212262
33896,0.009402,74.125.130.0-255,4320,190332,63,212262
33897,0.00941,172.31.40.0-255,66,190398,63,212262
33898,0.011765,74.125.130.0-255,5738,196136,63,212262
33899,0.011774,172.31.40.0-255,66,196202,63,212262
33900,0.014121,74.125.130.0-255,5738,201940,63,212262
33901,0.014128,172.31.40.0-255,66,202006,63,212262
33902,0.016466,74.125.130.0-255,4320,206326,63,212262
33903,0.016473,172.31.40.0-255,66,206392,63,212262
33904,0.016487,74.125.130.0-255,1484,207876,63,212262
33905,0.018827,74.125.130.0-255,4320,212196,63,212262
33906,0.018836,172.31.40.0-255,66,212262,63,212262
33907,0.0,74.125.130.0-255,153,153,63,162697
33908,1.7e-05,172.31.40.0-255,66,219,63,162697
33909,2.4e-05,74.125.130.0-255,1484,1703,63,162697
33910,2.8e-05,172.31.40.0-255,66,1769,63,162697
33911,3.3e-05,74.125.130.0-255,2902,4671,63,162697
33912,4.3e-05,172.31.40.0-255,66,4737,63,162697
33913,4.6e-05,74.125.130.0-255,1484,6221,63,162697
33914,4.8e-05,172.31.40.0-255,66,6287,63,162697
33915,8.5e-05,74.125.130.0-255,5738,12025,63,162697
33916,8.8e-05,172.31.40.0-255,66,12091,63,162697
33917,9.1e-05,74.125.130.0-255,2036,14127,63,162697
33918,9.3e-05,172.31.40.0-255,66,14193,63,162697
33919,0.00017,74.125.130.0-255,1484,15677,63,162697
33920,0.000173,172.31.40.0-255,66,15743,63,162697
33921,0.000178,74.125.130.0-255,2902,18645,63,162697
33922,0.00018,172.31.40.0-255,66,18711,63,162697
33923,0.000199,74.125.130.0-255,5738,24449,63,162697
33924,0.000202,172.31.40.0-255,66,24515,63,162697
33925,0.000226,74.125.130.0-255,6797,31312,63,162697
33926,0.000228,172.31.40.0-255,66,31378,63,162697
33927,0.000352,74.125.130.0-255,1484,32862,63,162697
33928,0.000355,172.31.40.0-255,66,32928,63,162697
33929,0.000361,74.125.130.0-255,2902,35830,63,162697
33930,0.000362,172.31.40.0-255,66,35896,63,162697
33931,0.000384,74.125.130.0-255,4320,40216,63,162697
33932,0.000391,172.31.40.0-255,66,40282,63,162697
33933,0.000425,172.31.40.0-255,66,40348,63,162697
33934,0.000435,172.31.40.0-255,66,40414,63,162697
33935,0.000465,74.125.130.0-255,1484,41898,63,162697
33936,0.000468,172.31.40.0-255,66,41964,63,162697
33937,0.000494,74.125.130.0-255,5379,47343,63,162697
33938,0.000497,172.31.40.0-255,66,47409,63,162697
33939,0.000526,74.125.130.0-255,357,47766,63,162697
33940,0.000821,74.125.130.0-255,385,48151,63,162697
33941,0.000931,172.31.40.0-255,66,48217,63,162697
33942,0.00161,74.125.130.0-255,1484,49701,63,162697
33943,0.001619,74.125.130.0-255,2902,52603,63,162697
33944,0.001624,172.31.40.0-255,66,52669,63,162697
33945,0.00163,74.125.130.0-255,4320,56989,63,162697
33946,0.001632,172.31.40.0-255,66,57055,63,162697
33947,0.001649,74.125.130.0-255,1484,58539,63,162697
33948,0.001656,74.125.130.0-255,7156,65695,63,162697
33949,0.001658,172.31.40.0-255,66,65761,63,162697
33950,0.001662,74.125.130.0-255,2902,68663,63,162697
33951,0.001664,172.31.40.0-255,66,68729,63,162697
33952,0.001705,172.31.40.0-255,66,68795,63,162697
33953,0.001709,74.125.130.0-255,2184,70979,63,162697
33954,0.00171,172.31.40.0-255,66,71045,63,162697
33955,0.001838,74.125.130.0-255,1484,72529,63,162697
33956,0.00185,74.125.130.0-255,2902,75431,63,162697
33957,0.001852,172.31.40.0-255,66,75497,63,162697
33958,0.001863,74.125.130.0-255,1484,76981,63,162697
33959,0.001882,74.125.130.0-255,4320,81301,63,162697
33960,0.001883,172.31.40.0-255,66,81367,63,162697
33961,0.001887,74.125.130.0-255,2902,84269,63,162697
33962,0.001889,172.31.40.0-255,66,84335,63,162697
33963,0.001917,74.125.130.0-255,1484,85819,63,162697
33964,0.001945,74.125.130.0-255,2902,88721,63,162697
33965,0.001947,172.31.40.0-255,66,88787,63,162697
33966,0.001956,172.31.40.0-255,66,88853,63,162697
33967,0.001961,74.125.130.0-255,5738,94591,63,162697
33968,0.001963,172.31.40.0-255,66,94657,63,162697
33969,0.001986,74.125.130.0-255,2184,96841,63,162697
33970,0.001988,172.31.40.0-255,66,96907,63,162697
33971,0.002044,74.125.130.0-255,1484,98391,63,162697
33972,0.002056,74.125.130.0-255,2902,101293,63,162697
33973,0.002059,172.31.40.0-255,66,101359,63,162697
33974,0.002062,74.125.130.0-255,1484,102843,63,162697
33975,0.002084,74.125.130.0-255,4320,107163,63,162697
33976,0.002086,172.31.40.0-255,66,107229,63,162697
33977,0.00209,74.125.130.0-255,2902,110131,63,162697
33978,0.002092,172.31.40.0-255,66,110197,63,162697
33979,0.002095,74.125.130.0-255,1484,111681,63,162697
33980,0.002118,74.125.130.0-255,2902,114583,63,162697
33981,0.00212,172.31.40.0-255,66,114649,63,162697
33982,0.002127,74.125.130.0-255,7156,121805,63,162697
33983,0.002129,172.31.40.0-255,66,121871,63,162697
33984,0.002148,74.125.130.0-255,1484,123355,63,162697
33985,0.002162,172.31.40.0-255,66,123421,63,162697
33986,0.00451,74.125.130.0-255,5738,129159,63,162697
33987,0.004517,172.31.40.0-255,66,129225,63,162697
33988,0.006849,74.125.130.0-255,4320,133545,63,162697
33989,0.006855,172.31.40.0-255,66,133611,63,162697
33990,0.006873,74.125.130.0-255,1484,135095,63,162697
33991,0.009201,74.125.130.0-255,4320,139415,63,162697
33992,0.009208,172.31.40.0-255,66,139481,63,162697
33993,0.011541,74.125.130.0-255,5738,145219,63,162697
33994,0.01155,172.31.40.0-255,66,145285,63,162697
33995,0.013896,74.125.130.0-255,5738,151023,63,162697
33996,0.013905,172.31.40.0-255,66,151089,63,162697
33997,0.016249,74.125.130.0-255,5738,156827,63,162697
33998,0.016258,172.31.40.0-255,66,156893,63,162697
33999,0.018602,74.125.130.0-255,5738,162631,63,162697
34000,0.018609,172.31.40.0-255,66,162697,63,162697
34001,0.0,74.125.24.0-255,153,153,63,212734
34002,1.6e-05,172.31.40.0-255,66,219,63,212734
34003,2.3e-05,74.125.24.0-255,1484,1703,63,212734
34004,2.8e-05,172.31.40.0-255,66,1769,63,212734
34005,3.3e-05,74.125.24.0-255,2902,4671,63,212734
34006,3.5e-05,172.31.40.0-255,66,4737,63,212734
34007,4.8e-05,74.125.24.0-255,5738,10475,63,212734
34008,5.2e-05,172.31.40.0-255,66,10541,63,212734
34009,7.2e-05,74.125.24.0-255,3447,13988,63,212734
34010,7.4e-05,172.31.40.0-255,66,14054,63,212734
34011,0.0001,74.125.24.0-255,2902,16956,63,212734
34012,0.000103,172.31.40.0-255,66,17022,63,212734
34013,0.000123,74.125.24.0-255,1484,18506,63,212734
34014,0.000125,172.31.40.0-255,66,18572,63,212734
34015,0.000131,74.125.24.0-255,4320,22892,63,212734
34016,0.000133,172.31.40.0-255,66,22958,63,212734
34017,0.000155,74.125.24.0-255,5738,28696,63,212734
34018,0.000161,172.31.40.0-255,66,28762,63,212734
34019,0.000164,74.125.24.0-255,1484,30246,63,212734
34020,0.000165,172.31.40.0-255,66,30312,63,212734
34021,0.000168,74.125.24.0-255,1125,31437,63,212734
34022,0.000173,172.31.40.0-255,66,31503,63,212734
34023,0.000226,74.125.24.0-255,1484,32987,63,212734
34024,0.000229,172.31.40.0-255,66,33053,63,212734
34025,0.000234,74.125.24.0-255,2902,35955,63,212734
34026,0.000236,172.31.40.0-255,66,36021,63,212734
34027,0.000239,74.125.24.0-255,1484,37505,63,212734
34028,0.00024,172.31.40.0-255,66,37571,63,212734
34029,0.000273,74.125.24.0-255,4320,41891,63,212734
34030,0.000276,172.31.40.0-255,66,41957,63,212734
34031,0.000288,172.31.40.0-255,66,42023,63,212734
34032,0.000321,74.125.24.0-255,1484,43507,63,212734
34033,0.000354,172.31.40.0-255,66,43573,63,212734
34034,0.000356,74.125.24.0-255,114,43687,63,212734
34035,0.000452,74.125.24.0-255,1484,45171,63,212734
34036,0.000455,172.31.40.0-255,66,45237,63,212734
34037,0.00046,74.125.24.0-255,2902,48139,63,212734
34038,0.000463,172.31.40.0-255,66,48205,63,212734
34039,0.00049,74.125.24.0-255,5738,53943,63,212734
34040,0.000492,172.31.40.0-255,66,54009,63,212734
34041,0.000495,74.125.24.0-255,1484,55493,63,212734
34042,0.000539,172.31.40.0-255,66,55559,63,212734
34043,0.00055,172.31.40.0-255,66,55625,63,212734
34044,0.000556,74.125.24.0-255,329,55954,63,212734
34045,0.000829,74.125.24.0-255,1484,57438,63,212734
34046,0.000834,172.31.40.0-255,66,57504,63,212734
34047,0.000839,74.125.24.0-255,2902,60406,63,212734
34048,0.000841,172.31.40.0-255,66,60472,63,212734
34049,0.000845,74.125.24.0-255,2902,63374,63,212734
34050,0.000848,172.31.40.0-255,66,63440,63,212734
34051,0.000883,74.125.24.0-255,2902,66342,63,212734
34052,0.000885,172.31.40.0-255,66,66408,63,212734
34053,0.000897,172.31.40.0-255,66,66474,63,212734
34054,0.000903,74.125.24.0-255,7156,73630,63,212734
34055,0.000906,172.31.40.0-255,66,73696,63,212734
34056,0.000931,74.125.24.0-255,3602,77298,63,212734
34057,0.000933,172.31.40.0-255,66,77364,63,212734
34058,0.000985,74.125.24.0-255,1484,78848,63,212734
34059,0.000999,74.125.24.0-255,2902,81750,63,212734
34060,0.001002,172.31.40.0-255,66,81816,63,212734
34061,0.001008,74.125.24.0-255,5738,87554,63,212734
34062,0.00101,172.31.40.0-255,66,87620,63,212734
34063,0.001033,74.125.24.0-255,2902,90522,63,212734
34064,0.001035,172.31.40.0-255,66,90588,63,212734
34065,0.001076,172.31.40.0-255,66,90654,63,212734
34066,0.001083,74.125.24.0-255,7156,97810,63,212734
34067,0.001085,172.31.40.0-255,66,97876,63,212734
34068,0.001094,74.125.24.0-255,3602,101478,63,212734
34069,0.001096,172.31.40.0-255,66,101544,63,212734
34070,0.001137,74.125.24.0-255,1484,103028,63,212734
34071,0.001157,74.125.24.0-255,2902,105930,63,212734
34072,0.00116,172.31.40.0-255,66,105996,63,212734
34073,0.001166,74.125.24.0-255,5738,111734,63,212734
34074,0.001168,172.31.40.0-255,66,111800,63,212734
34075,0.001198,172.31.40.0-255,66,111866,63,212734
34076,0.001205,74.125.24.0-255,7156,119022,63,212734
34077,0.001207,172.31.40.0-255,66,119088,63,212734
34078,0.001243,74.125.24.0-255,3602,122690,63,212734
34079,0.001246,172.31.40.0-255,66,122756,63,212734
34080,0.001392,74.125.24.0-255,1484,124240,63,212734
34081,0.001404,74.125.24.0-255,2902,127142,63,212734
34082,0.001407,172.31.40.0-255,66,127208,63,212734
34083,0.001412,74.125.24.0-255,2902,130110,63,212734
34084,0.001413,172.31.40.0-255,66,130176,63,212734
34085,0.001436,74.125.24.0-255,2902,133078,63,212734
34086,0.001455,172.31.40.0-255,66,133144,63,212734
34087,0.001458,172.31.40.0-255,66,133210,63,212734
34088,0.001467,74.125.24.0-255,1484,134694,63,212734
34089,0.001478,74.125.24.0-255,7156,141850,63,212734
34090,0.001479,172.31.40.0-255,66,141916,63,212734
34091,0.001507,74.125.24.0-255,3602,145518,63,212734
34092,0.00151,172.31.40.0-255,66,145584,63,212734
34093,0.001515,74.125.24.0-255,4320,149904,63,212734
34094,0.001517,172.31.40.0-255,66,149970,63,212734
34095,0.001556,74.125.24.0-255,2902,152872,63,212734
34096,0.001558,172.31.40.0-255,66,152938,63,212734
34097,0.001592,74.125.24.0-255,7156,160094,63,212734
34098,0.001595,172.31.40.0-255,66,160160,63,212734
34099,0.001614,172.31.40.0-255,66,160226,63,212734
34100,0.001616,74.125.24.0-255,766,160992,63,212734
34101,0.001619,74.125.24.0-255,1484,162476,63,212734
34102,0.001621,172.31.40.0-255,66,162542,63,212734
34103,0.001626,74.125.24.0-255,4320,166862,63,212734
34104,0.001627,172.31.40.0-255,66,166928,63,212734
34105,0.001655,172.31.40.0-255,66,166994,63,212734
34106,0.001662,74.125.24.0-255,7156,174150,63,212734
34107,0.001664,172.31.40.0-255,66,174216,63,212734
34108,0.001707,74.125.24.0-255,4320,178536,63,212734
34109,0.00171,172.31.40.0-255,66,178602,63,212734
34110,0.001738,74.125.24.0-255,6438,185040,63,212734
34111,0.001741,172.31.40.0-255,66,185106,63,212734
34112,0.001754,74.125.24.0-255,1484,186590,63,212734
34113,0.001759,74.125.24.0-255,1484,188074,63,212734
34114,0.001761,172.31.40.0-255,66,188140,63,212734
34115,0.00179,74.125.24.0-255,1484,189624,63,212734
34116,0.001796,74.125.24.0-255,5738,195362,63,212734
34117,0.001799,172.31.40.0-255,66,195428,63,212734
34118,0.001811,172.31.40.0-255,66,195494,63,212734
34119,0.001814,74.125.24.0-255,2902,198396,63,212734
34120,0.001817,172.31.40.0-255,66,198462,63,212734
34121,0.001864,172.31.40.0-255,66,198528,63,212734
34122,0.001868,74.125.24.0-255,4320,202848,63,212734
34123,0.00187,74.125.24.0-255,1484,204332,63,212734
34124,0.001892,74.125.24.0-255,4320,208652,63,212734
34125,0.001908,172.31.40.0-255,66,208718,63,212734
34126,0.001917,74.125.24.0-255,1484,210202,63,212734
34127,0.001967,172.31.40.0-255,66,210268,63,212734
34128,0.002011,74.125.24.0-255,1263,211531,63,212734
34129,0.002017,172.31.40.0-255,66,211597,63,212734
34130,0.002044,74.125.24.0-255,105,211702,63,212734
34131,0.002046,74.125.24.0-255,129,211831,63,212734
34132,0.013417,74.125.24.0-255,129,211960,63,212734
34133,0.013437,172.31.40.0-255,78,212038,63,212734
34134,0.015687,172.31.40.0-255,105,212143,63,212734
34135,0.015728,172.31.40.0-255,105,212248,63,212734
34136,0.015942,172.31.40.0-255,90,212338,63,212734
34137,0.015952,172.31.40.0-255,66,212404,63,212734
34138,0.018282,74.125.24.0-255,66,212470,63,212734
34139,0.0183,74.125.24.0-255,66,212536,63,212734
34140,0.018542,74.125.24.0-255,66,212602,63,212734
34141,0.018559,74.125.24.0-255,66,212668,63,212734
34142,0.01857,172.31.40.0-255,66,212734,63,212734
34143,0.0,74.125.24.0-255,153,153,63,176826
34144,1.3e-05,172.31.40.0-255,66,219,63,176826
34145,3.2e-05,74.125.24.0-255,1484,1703,63,176826
34146,3.6e-05,172.31.40.0-255,66,1769,63,176826
34147,4.2e-05,74.125.24.0-255,2902,4671,63,176826
34148,4.5e-05,172.31.40.0-255,66,4737,63,176826
34149,7.8e-05,74.125.24.0-255,2902,7639,63,176826
34150,8e-05,172.31.40.0-255,66,7705,63,176826
34151,9.3e-05,74.125.24.0-255,4320,12025,63,176826
34152,9.5e-05,172.31.40.0-255,66,12091,63,176826
34153,0.000141,74.125.24.0-255,2069,14160,63,176826
34154,0.000144,172.31.40.0-255,66,14226,63,176826
34155,0.000242,74.125.24.0-255,1484,15710,63,176826
34156,0.000246,172.31.40.0-255,66,15776,63,176826
34157,0.000251,74.125.24.0-255,2902,18678,63,176826
34158,0.000253,172.31.40.0-255,66,18744,63,176826
34159,0.000257,74.125.24.0-255,2902,21646,63,176826
34160,0.000259,172.31.40.0-255,66,21712,63,176826
34161,0.00028,74.125.24.0-255,2902,24614,63,176826
34162,0.000282,172.31.40.0-255,66,24680,63,176826
34163,0.000286,74.125.24.0-255,2902,27582,63,176826
34164,0.000288,172.31.40.0-255,66,27648,63,176826
34165,0.000309,74.125.24.0-255,3961,31609,63,176826
34166,0.000311,172.31.40.0-255,66,31675,63,176826
34167,0.000353,172.31.40.0-255,66,31741,63,176826
34168,0.000372,74.125.24.0-255,2543,34284,63,176826
34169,0.000374,172.31.40.0-255,66,34350,63,176826
34170,0.000392,74.125.24.0-255,1484,35834,63,176826
34171,0.000394,172.31.40.0-255,66,35900,63,176826
34172,0.000408,74.125.24.0-255,1484,37384,63,176826
34173,0.000437,74.125.24.0-255,5738,43122,63,176826
34174,0.00044,172.31.40.0-255,66,43188,63,176826
34175,0.000443,172.31.40.0-255,66,43254,63,176826
34176,0.000461,74.125.24.0-255,1484,44738,63,176826
34177,0.000468,74.125.24.0-255,6797,51535,63,176826
34178,0.00047,172.31.40.0-255,66,51601,63,176826
34179,0.000473,74.125.24.0-255,359,51960,63,176826
34180,0.000537,74.125.24.0-255,386,52346,63,176826
34181,0.000668,74.125.24.0-255,1484,53830,63,176826
34182,0.000673,172.31.40.0-255,66,53896,63,176826
34183,0.000687,74.125.24.0-255,2902,56798,63,176826
34184,0.000689,172.31.40.0-255,66,56864,63,176826
34185,0.000693,74.125.24.0-255,2902,59766,63,176826
34186,0.000695,172.31.40.0-255,66,59832,63,176826
34187,0.000731,74.125.24.0-255,2902,62734,63,176826
34188,0.000733,172.31.40.0-255,66,62800,63,176826
34189,0.000746,172.31.40.0-255,66,62866,63,176826
34190,0.000756,172.31.40.0-255,66,62932,63,176826
34191,0.001734,74.125.24.0-255,1484,64416,63,176826
34192,0.001744,74.125.24.0-255,2902,67318,63,176826
34193,0.001748,172.31.40.0-255,66,67384,63,176826
34194,0.001764,74.125.24.0-255,4320,71704,63,176826
34195,0.001767,172.31.40.0-255,66,71770,63,176826
34196,0.001797,74.125.24.0-255,5738,77508,63,176826
34197,0.001799,172.31.40.0-255,66,77574,63,176826
34198,0.00182,74.125.24.0-255,5738,83312,63,176826
34199,0.001822,172.31.40.0-255,66,83378,63,176826
34200,0.00184,74.125.24.0-255,4320,87698,63,176826
34201,0.001843,172.31.40.0-255,66,87764,63,176826
34202,0.001866,74.125.24.0-255,4320,92084,63,176826
34203,0.001868,172.31.40.0-255,66,92150,63,176826
34204,0.001887,74.125.24.0-255,5020,97170,63,176826
34205,0.00189,172.31.40.0-255,66,97236,63,176826
34206,0.002031,74.125.24.0-255,1484,98720,63,176826
34207,0.002038,74.125.24.0-255,2902,101622,63,176826
34208,0.002041,172.31.40.0-255,66,101688,63,176826
34209,0.002047,74.125.24.0-255,2902,104590,63,176826
34210,0.002049,172.31.40.0-255,66,104656,63,176826
34211,0.002064,74.125.24.0-255,2902,107558,63,176826
34212,0.002067,172.31.40.0-255,66,107624,63,176826
34213,0.002071,74.125.24.0-255,2902,110526,63,176826
34214,0.002073,172.31.40.0-255,66,110592,63,176826
34215,0.002106,172.31.40.0-255,66,110658,63,176826
34216,0.002142,172.31.40.0-255,66,110724,63,176826
34217,0.002174,172.31.40.0-255,66,110790,63,176826
34218,0.002181,74.125.24.0-255,5738,116528,63,176826
34219,0.002185,172.31.40.0-255,66,116594,63,176826
34220,0.002239,74.125.24.0-255,5738,122332,63,176826
34221,0.002242,172.31.40.0-255,66,122398,63,176826
34222,0.002271,172.31.40.0-255,66,122464,63,176826
34223,0.002295,74.125.24.0-255,7156,129620,63,176826
34224,0.002298,172.31.40.0-255,66,129686,63,176826
34225,0.002331,172.31.40.0-255,66,129752,63,176826
34226,0.002348,172.31.40.0-255,66,129818,63,176826
34227,0.00235,74.125.24.0-255,766,130584,63,176826
34228,0.002432,172.31.40.0-255,66,130650,63,176826
34229,0.00247,172.31.40.0-255,66,130716,63,176826
34230,0.002485,172.31.40.0-255,66,130782,63,176826
34231,0.002501,172.31.40.0-255,66,130848,63,176826
34232,0.002521,74.125.24.0-255,1484,132332,63,176826
34233,0.002532,172.31.40.0-255,66,132398,63,176826
34234,0.002544,74.125.24.0-255,1484,133882,63,176826
34235,0.002574,172.31.40.0-255,66,133948,63,176826
34236,0.00259,74.125.24.0-255,3602,137550,63,176826
34237,0.002593,172.31.40.0-255,66,137616,63,176826
34238,0.002598,74.125.24.0-255,4320,141936,63,176826
34239,0.0026,172.31.40.0-255,66,142002,63,176826
34240,0.005134,74.125.24.0-255,5738,147740,63,176826
34241,0.005146,172.31.40.0-255,66,147806,63,176826
34242,0.007692,74.125.24.0-255,5738,153544,63,176826
34243,0.0077,172.31.40.0-255,66,153610,63,176826
34244,0.010283,74.125.24.0-255,5738,159348,63,176826
34245,0.010295,172.31.40.0-255,66,159414,63,176826
34246,0.01286,74.125.24.0-255,5738,165152,63,176826
34247,0.012864,172.31.40.0-255,66,165218,63,176826
34248,0.015423,74.125.24.0-255,5738,170956,63,176826
34249,0.015438,172.31.40.0-255,66,171022,63,176826
34250,0.018025,74.125.24.0-255,5738,176760,63,176826
34251,0.01804,172.31.40.0-255,66,176826,63,176826
34252,0.0,74.125.24.0-255,153,153,63,203700
34253,2.3e-05,172.31.40.0-255,66,219,63,203700
34254,3.1e-05,74.125.24.0-255,1484,1703,63,203700
34255,3.6e-05,172.31.40.0-255,66,1769,63,203700
34256,5e-05,74.125.24.0-255,2902,4671,63,203700
34257,5.4e-05,172.31.40.0-255,66,4737,63,203700
34258,6.1e-05,74.125.24.0-255,7156,11893,63,203700
34259,6.3e-05,172.31.40.0-255,66,11959,63,203700
34260,7.6e-05,172.31.40.0-255,66,12025,63,203700
34261,9.6e-05,74.125.24.0-255,4320,16345,63,203700
34262,0.000102,172.31.40.0-255,66,16411,63,203700
34263,0.000123,74.125.24.0-255,2543,18954,63,203700
34264,0.000126,172.31.40.0-255,66,19020,63,203700
34265,0.00088,74.125.24.0-255,1484,20504,63,203700
34266,0.000887,172.31.40.0-255,66,20570,63,203700
34267,0.000896,74.125.24.0-255,2902,23472,63,203700
34268,0.000898,172.31.40.0-255,66,23538,63,203700
34269,0.000921,74.125.24.0-255,2902,26440,63,203700
34270,0.000923,172.31.40.0-255,66,26506,63,203700
34271,0.000948,74.125.24.0-255,2902,29408,63,203700
34272,0.000951,172.31.40.0-255,66,29474,63,203700
34273,0.000955,74.125.24.0-255,2902,32376,63,203700
34274,0.000956,172.31.40.0-255,66,32442,63,203700
34275,0.000982,74.125.24.0-255,3961,36403,63,203700
34276,0.000984,172.31.40.0-255,66,36469,63,203700
34277,0.001009,74.125.24.0-255,1484,37953,63,203700
34278,0.001011,172.31.40.0-255,66,38019,63,203700
34279,0.001044,172.31.40.0-255,66,38085,63,203700
34280,0.00105,74.125.24.0-255,5647,43732,63,203700
34281,0.001052,172.31.40.0-255,66,43798,63,203700
34282,0.001054,74.125.24.0-255,135,43933,63,203700
34283,0.001138,74.125.24.0-255,1484,45417,63,203700
34284,0.001143,172.31.40.0-255,66,45483,63,203700
34285,0.001148,74.125.24.0-255,2902,48385,63,203700
34286,0.00115,172.31.40.0-255,66,48451,63,203700
34287,0.001172,74.125.24.0-255,2902,51353,63,203700
34288,0.001174,172.31.40.0-255,66,51419,63,203700
34289,0.001202,74.125.24.0-255,2902,54321,63,203700
34290,0.001204,172.31.40.0-255,66,54387,63,203700
34291,0.001214,172.31.40.0-255,66,54453,63,203700
34292,0.001245,74.125.24.0-255,5379,59832,63,203700
34293,0.001248,172.31.40.0-255,66,59898,63,203700
34294,0.001263,172.31.40.0-255,66,59964,63,203700
34295,0.001685,74.125.24.0-255,1484,61448,63,203700
34296,0.001693,74.125.24.0-255,2902,64350,63,203700
34297,0.001697,172.31.40.0-255,66,64416,63,203700
34298,0.001705,74.125.24.0-255,5738,70154,63,203700
34299,0.001708,172.31.40.0-255,66,70220,63,203700
34300,0.00172,74.125.24.0-255,4320,74540,63,203700
34301,0.001722,172.31.40.0-255,66,74606,63,203700
34302,0.001755,172.31.40.0-255,66,74672,63,203700
34303,0.001799,172.31.40.0-255,66,74738,63,203700
34304,0.001812,172.31.40.0-255,66,74804,63,203700
34305,0.001823,74.125.24.0-255,2902,77706,63,203700
34306,0.001826,172.31.40.0-255,66,77772,63,203700
34307,0.001832,74.125.24.0-255,5738,83510,63,203700
34308,0.001834,172.31.40.0-255,66,83576,63,203700
34309,0.001879,172.31.40.0-255,66,83642,63,203700
34310,0.001904,74.125.24.0-255,1484,85126,63,203700
34311,0.001924,74.125.24.0-255,1484,86610,63,203700
34312,0.001926,172.31.40.0-255,66,86676,63,203700
34313,0.001949,74.125.24.0-255,1484,88160,63,203700
34314,0.001956,74.125.24.0-255,5738,93898,63,203700
34315,0.001959,172.31.40.0-255,66,93964,63,203700
34316,0.001962,74.125.24.0-255,1484,95448,63,203700
34317,0.001984,74.125.24.0-255,5738,101186,63,203700
34318,0.001987,172.31.40.0-255,66,101252,63,203700
34319,0.002019,74.125.24.0-255,5738,106990,63,203700
34320,0.002022,172.31.40.0-255,66,107056,63,203700
34321,0.002041,172.31.40.0-255,66,107122,63,203700
34322,0.004471,74.125.24.0-255,1484,108606,63,203700
34323,0.00448,74.125.24.0-255,2902,111508,63,203700
34324,0.004498,172.31.40.0-255,66,111574,63,203700
34325,0.004506,74.125.24.0-255,5738,117312,63,203700
34326,0.004508,172.31.40.0-255,66,117378,63,203700
34327,0.004542,172.31.40.0-255,66,117444,63,203700
34328,0.004549,74.125.24.0-255,4320,121764,63,203700
34329,0.00455,172.31.40.0-255,66,121830,63,203700
34330,0.004572,74.125.24.0-255,5738,127568,63,203700
34331,0.004575,172.31.40.0-255,66,127634,63,203700
34332,0.004581,74.125.24.0-255,5020,132654,63,203700
34333,0.004583,172.31.40.0-255,66,132720,63,203700
34334,0.005065,74.125.24.0-255,1484,134204,63,203700
34335,0.005073,74.125.24.0-255,2902,137106,63,203700
34336,0.005077,172.31.40.0-255,66,137172,63,203700
34337,0.005085,74.125.24.0-255,5738,142910,63,203700
34338,0.005087,172.31.40.0-255,66,142976,63,203700
34339,0.00514,172.31.40.0-255,66,143042,63,203700
34340,0.005151,172.31.40.0-255,66,143108,63,203700
34341,0.005186,172.31.40.0-255,66,143174,63,203700
34342,0.005193,74.125.24.0-255,5738,148912,63,203700
34343,0.005195,172.31.40.0-255,66,148978,63,203700
34344,0.005219,74.125.24.0-255,5738,154716,63,203700
34345,0.005222,172.31.40.0-255,66,154782,63,203700
34346,0.005261,172.31.40.0-255,66,154848,63,203700
34347,0.005723,74.125.24.0-255,1484,156332,63,203700
34348,0.00573,74.125.24.0-255,2902,159234,63,203700
34349,0.005734,172.31.40.0-255,66,159300,63,203700
34350,0.005741,74.125.24.0-255,5738,165038,63,203700
34351,0.005743,172.31.40.0-255,66,165104,63,203700
34352,0.005755,74.125.24.0-255,7156,172260,63,203700
34353,0.005758,172.31.40.0-255,66,172326,63,203700
34354,0.005787,74.125.24.0-255,5738,178064,63,203700
34355,0.005789,172.31.40.0-255,66,178130,63,203700
34356,0.005793,74.125.24.0-255,2902,181032,63,203700
34357,0.005795,172.31.40.0-255,66,181098,63,203700
34358,0.005836,172.31.40.0-255,66,181164,63,203700
34359,0.006119,74.125.24.0-255,1484,182648,63,203700
34360,0.006125,74.125.24.0-255,2902,185550,63,203700
34361,0.006128,172.31.40.0-255,66,185616,63,203700
34362,0.006162,74.125.24.0-255,5738,191354,63,203700
34363,0.006165,172.31.40.0-255,66,191420,63,203700
34364,0.006172,74.125.24.0-255,7156,198576,63,203700
34365,0.006174,172.31.40.0-255,66,198642,63,203700
34366,0.006192,172.31.40.0-255,66,198708,63,203700
34367,0.006216,74.125.24.0-255,1484,200192,63,203700
34368,0.00623,172.31.40.0-255,66,200258,63,203700
34369,0.006244,172.31.40.0-255,66,200324,63,203700
34370,0.006275,74.125.24.0-255,2902,203226,63,203700
34371,0.006277,172.31.40.0-255,66,203292,63,203700
34372,0.006289,172.31.40.0-255,66,203358,63,203700
34373,0.006292,74.125.24.0-255,105,203463,63,203700
34374,0.013701,172.31.40.0-255,66,203529,63,203700
34375,0.013752,172.31.40.0-255,105,203634,63,203700
34376,0.016091,74.125.24.0-255,66,203700,63,203700
34377,0.0,172.217.194.0-255,143,143,63,175630
34378,2.2e-05,172.31.40.0-255,66,209,63,175630
34379,2.9e-05,172.217.194.0-255,1484,1693,63,175630
34380,3.4e-05,172.31.40.0-255,66,1759,63,175630
34381,4e-05,172.217.194.0-255,2902,4661,63,175630
34382,4.3e-05,172.31.40.0-255,66,4727,63,175630
34383,5e-05,172.217.194.0-255,7156,11883,63,175630
34384,5.3e-05,172.31.40.0-255,66,11949,63,175630
34385,5.6e-05,172.217.194.0-255,2037,13986,63,175630
34386,6e-05,172.31.40.0-255,66,14052,63,175630
34387,9.7e-05,172.217.194.0-255,4320,18372,63,175630
34388,0.0001,172.31.40.0-255,66,18438,63,175630
34389,0.000121,172.217.194.0-255,7156,25594,63,175630
34390,0.000124,172.31.40.0-255,66,25660,63,175630
34391,0.00013,172.217.194.0-255,5379,31039,63,175630
34392,0.000132,172.31.40.0-255,66,31105,63,175630
34393,0.000174,172.217.194.0-255,1484,32589,63,175630
34394,0.000176,172.31.40.0-255,66,32655,63,175630
34395,0.000182,172.217.194.0-255,2902,35557,63,175630
34396,0.000183,172.31.40.0-255,66,35623,63,175630
34397,0.0002,172.217.194.0-255,5738,41361,63,175630
34398,0.000202,172.31.40.0-255,66,41427,63,175630
34399,0.000229,172.217.194.0-255,5738,47165,63,175630
34400,0.000246,172.31.40.0-255,66,47231,63,175630
34401,0.000252,172.217.194.0-255,6797,54028,63,175630
34402,0.000255,172.31.40.0-255,66,54094,63,175630
34403,0.000284,172.31.40.0-255,66,54160,63,175630
34404,0.000297,172.217.194.0-255,2795,56955,63,175630
34405,0.000299,172.31.40.0-255,66,57021,63,175630
34406,0.000302,172.217.194.0-255,118,57139,63,175630
34407,0.000304,172.31.40.0-255,66,57205,63,175630
34408,0.000411,172.217.194.0-255,381,57586,63,175630
34409,0.00082,172.217.194.0-255,1484,59070,63,175630
34410,0.000826,172.31.40.0-255,66,59136,63,175630
34411,0.000833,172.217.194.0-255,2902,62038,63,175630
34412,0.000835,172.31.40.0-255,66,62104,63,175630
34413,0.000842,172.217.194.0-255,5738,67842,63,175630
34414,0.000844,172.31.40.0-255,66,67908,63,175630
34415,0.000882,172.31.40.0-255,66,67974,63,175630
34416,0.000917,172.31.40.0-255,66,68040,63,175630
34417,0.000937,172.217.194.0-255,766,68806,63,175630
34418,0.001131,172.217.194.0-255,1484,70290,63,175630
34419,0.001135,172.31.40.0-255,66,70356,63,175630
34420,0.001141,172.217.194.0-255,2902,73258,63,175630
34421,0.001143,172.31.40.0-255,66,73324,63,175630
34422,0.001149,172.217.194.0-255,5738,79062,63,175630
34423,0.001152,172.31.40.0-255,66,79128,63,175630
34424,0.001187,172.31.40.0-255,66,79194,63,175630
34425,0.001192,172.217.194.0-255,4320,83514,63,175630
34426,0.001195,172.31.40.0-255,66,83580,63,175630
34427,0.001213,172.217.194.0-255,5738,89318,63,175630
34428,0.001216,172.31.40.0-255,66,89384,63,175630
34429,0.001218,172.217.194.0-255,766,90150,63,175630
34430,0.001653,172.217.194.0-255,1484,91634,63,175630
34431,0.001658,172.31.40.0-255,66,91700,63,175630
34432,0.001663,172.217.194.0-255,2902,94602,63,175630
34433,0.001666,172.31.40.0-255,66,94668,63,175630
34434,0.001672,172.217.194.0-255,5738,100406,63,175630
34435,0.001674,172.31.40.0-255,66,100472,63,175630
34436,0.001696,172.217.194.0-255,5738,106210,63,175630
34437,0.001698,172.31.40.0-255,66,106276,63,175630
34438,0.001728,172.217.194.0-255,2902,109178,63,175630
34439,0.001731,172.31.40.0-255,66,109244,63,175630
34440,0.001743,172.31.40.0-255,66,109310,63,175630
34441,0.001749,172.217.194.0-255,5020,114330,63,175630
34442,0.001751,172.31.40.0-255,66,114396,63,175630
34443,0.001776,172.217.194.0-255,5738,120134,63,175630
34444,0.001779,172.31.40.0-255,66,120200,63,175630
34445,0.00181,172.31.40.0-255,66,120266,63,175630
34446,0.001851,172.217.194.0-255,4320,124586,63,175630
34447,0.001854,172.31.40.0-255,66,124652,63,175630
34448,0.001889,172.31.40.0-255,66,124718,63,175630
34449,0.001905,172.31.40.0-255,66,124784,63,175630
34450,0.001909,172.217.194.0-255,2902,127686,63,175630
34451,0.001912,172.31.40.0-255,66,127752,63,175630
34452,0.001955,172.31.40.0-255,66,127818,63,175630
34453,0.002063,172.217.194.0-255,1484,129302,63,175630
34454,0.002066,172.217.194.0-255,1484,130786,63,175630
34455,0.002076,172.31.40.0-255,66,130852,63,175630
34456,0.002081,172.217.194.0-255,1484,132336,63,175630
34457,0.002091,172.217.194.0-255,5738,138074,63,175630
34458,0.002094,172.31.40.0-255,66,138140,63,175630
34459,0.0021,172.217.194.0-255,5738,143878,63,175630
34460,0.002102,172.31.40.0-255,66,143944,63,175630
34461,0.002126,172.217.194.0-255,1484,145428,63,175630
34462,0.002147,172.31.40.0-255,66,145494,63,175630
34463,0.002152,172.217.194.0-255,2184,147678,63,175630
34464,0.002153,172.31.40.0-255,66,147744,63,175630
34465,0.002191,172.217.194.0-255,2902,150646,63,175630
34466,0.002194,172.31.40.0-255,66,150712,63,175630
34467,0.0022,172.217.194.0-255,4320,155032,63,175630
34468,0.002202,172.31.40.0-255,66,155098,63,175630
34469,0.002217,172.217.194.0-255,2902,158000,63,175630
34470,0.002219,172.31.40.0-255,66,158066,63,175630
34471,0.002244,172.217.194.0-255,5738,163804,63,175630
34472,0.002247,172.31.40.0-255,66,163870,63,175630
34473,0.002282,172.217.194.0-255,4320,168190,63,175630
34474,0.002284,172.31.40.0-255,66,168256,63,175630
34475,0.002328,172.31.40.0-255,66,168322,63,175630
34476,0.002346,172.31.40.0-255,66,168388,63,175630
34477,0.00236,172.31.40.0-255,66,168454,63,175630
34478,0.002363,172.217.194.0-255,1484,169938,63,175630
34479,0.002414,172.31.40.0-255,66,170004,63,175630
34480,0.002449,172.31.40.0-255,66,170070,63,175630
34481,0.002485,172.31.40.0-255,66,170136,63,175630
34482,0.002509,172.217.194.0-255,5020,175156,63,175630
34483,0.002511,172.31.40.0-255,66,175222,63,175630
34484,0.002522,172.31.40.0-255,66,175288,63,175630
34485,0.002525,172.217.194.0-255,105,175393,63,175630
34486,0.004159,172.31.40.0-255,66,175459,63,175630
34487,0.004191,172.31.40.0-255,105,175564,63,175630
34488,0.006734,172.217.194.0-255,66,175630,63,175630
34489,0.0,74.125.200.0-255,431,431,63,137722
34490,1.5e-05,74.125.200.0-255,1484,1915,63,137722
34491,2.3e-05,172.31.40.0-255,66,1981,63,137722
34492,3.4e-05,74.125.200.0-255,4320,6301,63,137722
34493,3.8e-05,172.31.40.0-255,66,6367,63,137722
34494,0.000182,172.31.40.0-255,66,6433,63,137722
34495,0.000471,74.125.200.0-255,4320,10753,63,137722
34496,0.000477,172.31.40.0-255,66,10819,63,137722
34497,0.000509,74.125.200.0-255,4320,15139,63,137722
34498,0.000513,172.31.40.0-255,66,15205,63,137722
34499,0.000818,74.125.200.0-255,5738,20943,63,137722
34500,0.000824,172.31.40.0-255,66,21009,63,137722
34501,0.000857,74.125.200.0-255,1484,22493,63,137722
34502,0.002296,74.125.200.0-255,5738,28231,63,137722
34503,0.002303,172.31.40.0-255,66,28297,63,137722
34504,0.002427,74.125.200.0-255,5738,34035,63,137722
34505,0.002449,74.125.200.0-255,7156,41191,63,137722
34506,0.002867,74.125.200.0-255,4320,45511,63,137722
34507,0.002885,74.125.200.0-255,7156,52667,63,137722
34508,0.002899,74.125.200.0-255,7156,59823,63,137722
34509,0.003632,74.125.200.0-255,7156,66979,63,137722
34510,0.004017,172.31.40.0-255,66,67045,63,137722
34511,0.004504,172.31.40.0-255,66,67111,63,137722
34512,0.004545,74.125.200.0-255,4320,71431,63,137722
34513,0.004549,172.31.40.0-255,66,71497,63,137722
34514,0.00461,172.31.40.0-255,66,71563,63,137722
34515,0.006276,74.125.200.0-255,5738,77301,63,137722
34516,0.006282,172.31.40.0-255,66,77367,63,137722
34517,0.006692,172.31.40.0-255,66,77433,63,137722
34518,0.006796,172.31.40.0-255,66,77499,63,137722
34519,0.006835,172.31.40.0-255,66,77565,63,137722
34520,0.006945,74.125.200.0-255,5738,83303,63,137722
34521,0.006948,172.31.40.0-255,66,83369,63,137722
34522,0.006985,172.31.40.0-255,66,83435,63,137722
34523,0.007278,74.125.200.0-255,7156,90591,63,137722
34524,0.007282,172.31.40.0-255,66,90657,63,137722
34525,0.007336,172.31.40.0-255,66,90723,63,137722
34526,0.007646,172.31.40.0-255,66,90789,63,137722
34527,0.007674,74.125.200.0-255,3444,94233,63,137722
34528,0.007677,172.31.40.0-255,66,94299,63,137722
34529,0.008534,74.125.200.0-255,5196,99495,63,137722
34530,0.008541,172.31.40.0-255,66,99561,63,137722
34531,0.008552,74.125.200.0-255,7156,106717,63,137722
34532,0.008555,172.31.40.0-255,66,106783,63,137722
34533,0.008597,172.31.40.0-255,66,106849,63,137722
34534,0.009062,172.31.40.0-255,66,106915,63,137722
34535,0.009093,74.125.200.0-255,5738,112653,63,137722
34536,0.009096,172.31.40.0-255,66,112719,63,137722
34537,0.009138,74.125.200.0-255,5738,118457,63,137722
34538,0.00914,172.31.40.0-255,66,118523,63,137722
34539,0.009194,172.31.40.0-255,66,118589,63,137722
34540,0.009218,74.125.200.0-255,1484,120073,63,137722
34541,0.009542,74.125.200.0-255,5738,125811,63,137722
34542,0.009549,172.31.40.0-255,66,125877,63,137722
34543,0.009604,172.31.40.0-255,66,125943,63,137722
34544,0.009921,74.125.200.0-255,4320,130263,63,137722
34545,0.009927,172.31.40.0-255,66,130329,63,137722
34546,0.009997,172.31.40.0-255,66,130395,63,137722
34547,0.010825,74.125.200.0-255,7156,137551,63,137722
34548,0.015559,172.31.40.0-255,66,137617,63,137722
34549,0.017361,172.31.40.0-255,105,137722,63,137722
34550,0.0,172.217.194.0-255,152,152,63,196632
34551,2.5e-05,172.31.40.0-255,66,218,63,196632
34552,3.2e-05,172.217.194.0-255,1484,1702,63,196632
34553,3.7e-05,172.31.40.0-255,66,1768,63,196632
34554,4.3e-05,172.217.194.0-255,2902,4670,63,196632
34555,4.7e-05,172.31.40.0-255,66,4736,63,196632
34556,5.5e-05,172.217.194.0-255,7156,11892,63,196632
34557,5.8e-05,172.31.40.0-255,66,11958,63,196632
34558,6.4e-05,172.217.194.0-255,4320,16278,63,196632
34559,6.7e-05,172.31.40.0-255,66,16344,63,196632
34560,9.5e-05,172.217.194.0-255,6237,22581,63,196632
34561,9.8e-05,172.31.40.0-255,66,22647,63,196632
34562,0.00011,172.31.40.0-255,66,22713,63,196632
34563,0.000142,172.31.40.0-255,66,22779,63,196632
34564,0.000148,172.217.194.0-255,5020,27799,63,196632
34565,0.00015,172.31.40.0-255,66,27865,63,196632
34566,0.000153,172.217.194.0-255,1484,29349,63,196632
34567,0.000155,172.31.40.0-255,66,29415,63,196632
34568,0.000195,172.31.40.0-255,66,29481,63,196632
34569,0.000198,172.217.194.0-255,1484,30965,63,196632
34570,0.0002,172.31.40.0-255,66,31031,63,196632
34571,0.000205,172.217.194.0-255,2902,33933,63,196632
34572,0.000207,172.31.40.0-255,66,33999,63,196632
34573,0.000224,172.217.194.0-255,5738,39737,63,196632
34574,0.000227,172.31.40.0-255,66,39803,63,196632
34575,0.000256,172.31.40.0-255,66,39869,63,196632
34576,0.000279,172.217.194.0-255,2902,42771,63,196632
34577,0.000282,172.31.40.0-255,66,42837,63,196632
34578,0.000289,172.217.194.0-255,7156,49993,63,196632
34579,0.000292,172.31.40.0-255,66,50059,63,196632
34580,0.000311,172.217.194.0-255,3902,53961,63,196632
34581,0.000314,172.31.40.0-255,66,54027,63,196632
34582,0.000583,172.217.194.0-255,1484,55511,63,196632
34583,0.000591,172.217.194.0-255,2902,58413,63,196632
34584,0.000596,172.31.40.0-255,66,58479,63,196632
34585,0.000603,172.217.194.0-255,5738,64217,63,196632
34586,0.000605,172.31.40.0-255,66,64283,63,196632
34587,0.000638,172.217.194.0-255,7156,71439,63,196632
34588,0.000641,172.31.40.0-255,66,71505,63,196632
34589,0.000691,172.31.40.0-255,66,71571,63,196632
34590,0.000704,172.217.194.0-255,1484,73055,63,196632
34591,0.000708,172.217.194.0-255,2184,75239,63,196632
34592,0.00071,172.31.40.0-255,66,75305,63,196632
34593,0.001271,172.217.194.0-255,1484,76789,63,196632
34594,0.001276,172.217.194.0-255,2902,79691,63,196632
34595,0.001279,172.31.40.0-255,66,79757,63,196632
34596,0.001286,172.217.194.0-255,5738,85495,63,196632
34597,0.001288,172.31.40.0-255,66,85561,63,196632
34598,0.001319,172.31.40.0-255,66,85627,63,196632
34599,0.001371,172.31.40.0-255,66,85693,63,196632
34600,0.001374,172.217.194.0-255,1484,87177,63,196632
34601,0.001389,172.217.194.0-255,2902,90079,63,196632
34602,0.001391,172.31.40.0-255,66,90145,63,196632
34603,0.00141,172.217.194.0-255,5738,95883,63,196632
34604,0.001413,172.31.40.0-255,66,95949,63,196632
34605,0.001416,172.217.194.0-255,1484,97433,63,196632
34606,0.00146,172.31.40.0-255,66,97499,63,196632
34607,0.001463,172.31.40.0-255,66,97565,63,196632
34608,0.001476,172.217.194.0-255,766,98331,63,196632
34609,0.00167,172.217.194.0-255,1484,99815,63,196632
34610,0.001674,172.31.40.0-255,66,99881,63,196632
34611,0.001678,172.217.194.0-255,2902,102783,63,196632
34612,0.00168,172.31.40.0-255,66,102849,63,196632
34613,0.001684,172.217.194.0-255,2902,105751,63,196632
34614,0.001686,172.31.40.0-255,66,105817,63,196632
34615,0.001713,172.217.194.0-255,2902,108719,63,196632
34616,0.001715,172.31.40.0-255,66,108785,63,196632
34617,0.001726,172.31.40.0-255,66,108851,63,196632
34618,0.00174,172.217.194.0-255,2902,111753,63,196632
34619,0.001742,172.31.40.0-255,66,111819,63,196632
34620,0.001744,172.217.194.0-255,1484,113303,63,196632
34621,0.001789,172.31.40.0-255,66,113369,63,196632
34622,0.001795,172.217.194.0-255,7156,120525,63,196632
34623,0.001797,172.31.40.0-255,66,120591,63,196632
34624,0.001835,172.31.40.0-255,66,120657,63,196632
34625,0.00184,172.217.194.0-255,5020,125677,63,196632
34626,0.001842,172.31.40.0-255,66,125743,63,196632
34627,0.002022,172.217.194.0-255,1484,127227,63,196632
34628,0.002026,172.217.194.0-255,1484,128711,63,196632
34629,0.002028,172.31.40.0-255,66,128777,63,196632
34630,0.002039,172.217.194.0-255,1484,130261,63,196632
34631,0.002041,172.217.194.0-255,1484,131745,63,196632
34632,0.002044,172.31.40.0-255,66,131811,63,196632
34633,0.002054,172.217.194.0-255,4320,136131,63,196632
34634,0.002058,172.217.194.0-255,2902,139033,63,196632
34635,0.002061,172.31.40.0-255,66,139099,63,196632
34636,0.002067,172.31.40.0-255,66,139165,63,196632
34637,0.00207,172.217.194.0-255,1484,140649,63,196632
34638,0.002089,172.217.194.0-255,2902,143551,63,196632
34639,0.002091,172.31.40.0-255,66,143617,63,196632
34640,0.002114,172.31.40.0-255,66,143683,63,196632
34641,0.002123,172.31.40.0-255,66,143749,63,196632
34642,0.002166,172.217.194.0-255,2902,146651,63,196632
34643,0.002169,172.31.40.0-255,66,146717,63,196632
34644,0.002203,172.31.40.0-255,66,146783,63,196632
34645,0.002253,172.31.40.0-255,66,146849,63,196632
34646,0.002279,172.217.194.0-255,5020,151869,63,196632
34647,0.002281,172.31.40.0-255,66,151935,63,196632
34648,0.002296,172.31.40.0-255,66,152001,63,196632
34649,0.002319,172.217.194.0-255,5738,157739,63,196632
34650,0.002322,172.31.40.0-255,66,157805,63,196632
34651,0.002324,172.217.194.0-255,766,158571,63,196632
34652,0.003752,172.31.40.0-255,66,158637,63,196632
34653,0.00462,172.217.194.0-255,4320,162957,63,196632
34654,0.004626,172.31.40.0-255,66,163023,63,196632
34655,0.006061,172.217.194.0-255,1484,164507,63,196632
34656,0.006885,172.217.194.0-255,4320,168827,63,196632
34657,0.006895,172.31.40.0-255,66,168893,63,196632
34658,0.009176,172.217.194.0-255,5738,174631,63,196632
34659,0.009191,172.31.40.0-255,66,174697,63,196632
34660,0.011487,172.217.194.0-255,5738,180435,63,196632
34661,0.011496,172.31.40.0-255,66,180501,63,196632
34662,0.013776,172.217.194.0-255,2902,183403,63,196632
34663,0.013779,172.31.40.0-255,66,183469,63,196632
34664,0.013798,172.217.194.0-255,2902,186371,63,196632
34665,0.0138,172.31.40.0-255,66,186437,63,196632
34666,0.016046,172.217.194.0-255,2902,189339,63,196632
34667,0.016055,172.31.40.0-255,66,189405,63,196632
34668,0.016076,172.217.194.0-255,2902,192307,63,196632
34669,0.016079,172.31.40.0-255,66,192373,63,196632
34670,0.018348,172.217.194.0-255,2902,195275,63,196632
34671,0.018355,172.31.40.0-255,66,195341,63,196632
34672,0.018376,172.217.194.0-255,1120,196461,63,196632
34673,0.018736,172.31.40.0-255,66,196527,63,196632
34674,0.018777,172.31.40.0-255,105,196632,63,196632
34675,0.0,74.125.200.0-255,296,296,63,190466
34676,2.2e-05,172.31.40.0-255,66,362,63,190466
34677,2.8e-05,74.125.200.0-255,1484,1846,63,190466
34678,3.3e-05,172.31.40.0-255,66,1912,63,190466
34679,3.6e-05,74.125.200.0-255,1484,3396,63,190466
34680,3.9e-05,172.31.40.0-255,66,3462,63,190466
34681,4.6e-05,74.125.200.0-255,2902,6364,63,190466
34682,4.9e-05,172.31.40.0-255,66,6430,63,190466
34683,5.5e-05,74.125.200.0-255,5738,12168,63,190466
34684,5.8e-05,172.31.40.0-255,66,12234,63,190466
34685,8.6e-05,172.31.40.0-255,66,12300,63,190466
34686,0.000107,172.31.40.0-255,66,12366,63,190466
34687,0.000111,74.125.200.0-255,2543,14909,63,190466
34688,0.000113,172.31.40.0-255,66,14975,63,190466
34689,0.000515,74.125.200.0-255,1484,16459,63,190466
34690,0.000521,172.31.40.0-255,66,16525,63,190466
34691,0.000542,74.125.200.0-255,1484,18009,63,190466
34692,0.000545,172.31.40.0-255,66,18075,63,190466
34693,0.00055,74.125.200.0-255,2902,20977,63,190466
34694,0.000553,172.31.40.0-255,66,21043,63,190466
34695,0.000574,74.125.200.0-255,4320,25363,63,190466
34696,0.00058,74.125.200.0-255,4320,29683,63,190466
34697,0.000584,172.31.40.0-255,66,29749,63,190466
34698,0.000587,172.31.40.0-255,66,29815,63,190466
34699,0.000602,74.125.200.0-255,1484,31299,63,190466
34700,0.000604,172.31.40.0-255,66,31365,63,190466
34701,0.000612,74.125.200.0-255,5738,37103,63,190466
34702,0.000614,172.31.40.0-255,66,37169,63,190466
34703,0.000647,74.125.200.0-255,5738,42907,63,190466
34704,0.000651,172.31.40.0-255,66,42973,63,190466
34705,0.000657,74.125.200.0-255,4320,47293,63,190466
34706,0.000659,172.31.40.0-255,66,47359,63,190466
34707,0.000673,74.125.200.0-255,2184,49543,63,190466
34708,0.000675,172.31.40.0-255,66,49609,63,190466
34709,0.000712,74.125.200.0-255,3245,52854,63,190466
34710,0.000715,172.31.40.0-255,66,52920,63,190466
34711,0.000739,74.125.200.0-255,2902,55822,63,190466
34712,0.000742,172.31.40.0-255,66,55888,63,190466
34713,0.000748,74.125.200.0-255,4320,60208,63,190466
34714,0.00075,172.31.40.0-255,66,60274,63,190466
34715,0.000788,172.31.40.0-255,66,60340,63,190466
34716,0.0008,74.125.200.0-255,2902,63242,63,190466
34717,0.000803,172.31.40.0-255,66,63308,63,190466
34718,0.000826,74.125.200.0-255,7156,70464,63,190466
34719,0.000828,172.31.40.0-255,66,70530,63,190466
34720,0.000835,74.125.200.0-255,5020,75550,63,190466
34721,0.000837,172.31.40.0-255,66,75616,63,190466
34722,0.000858,74.125.200.0-255,335,75951,63,190466
34723,0.001065,74.125.200.0-255,1484,77435,63,190466
34724,0.00107,172.31.40.0-255,66,77501,63,190466
34725,0.001075,74.125.200.0-255,2902,80403,63,190466
34726,0.001077,172.31.40.0-255,66,80469,63,190466
34727,0.001106,74.125.200.0-255,5738,86207,63,190466
34728,0.001108,172.31.40.0-255,66,86273,63,190466
34729,0.001112,74.125.200.0-255,1484,87757,63,190466
34730,0.001135,172.31.40.0-255,66,87823,63,190466
34731,0.001141,74.125.200.0-255,5738,93561,63,190466
34732,0.001144,172.31.40.0-255,66,93627,63,190466
34733,0.001188,74.125.200.0-255,5020,98647,63,190466
34734,0.001193,172.31.40.0-255,66,98713,63,190466
34735,0.001699,74.125.200.0-255,1484,100197,63,190466
34736,0.001704,74.125.200.0-255,2902,103099,63,190466
34737,0.001708,172.31.40.0-255,66,103165,63,190466
34738,0.001715,74.125.200.0-255,5738,108903,63,190466
34739,0.001717,172.31.40.0-255,66,108969,63,190466
34740,0.001751,172.31.40.0-255,66,109035,63,190466
34741,0.001802,74.125.200.0-255,5738,114773,63,190466
34742,0.001805,172.31.40.0-255,66,114839,63,190466
34743,0.001837,74.125.200.0-255,2902,117741,63,190466
34744,0.00184,172.31.40.0-255,66,117807,63,190466
34745,0.001857,74.125.200.0-255,1484,119291,63,190466
34746,0.00189,74.125.200.0-255,1484,120775,63,190466
34747,0.001893,172.31.40.0-255,66,120841,63,190466
34748,0.001905,74.125.200.0-255,2184,123025,63,190466
34749,0.001908,172.31.40.0-255,66,123091,63,190466
34750,0.002199,74.125.200.0-255,1484,124575,63,190466
34751,0.002206,74.125.200.0-255,2902,127477,63,190466
34752,0.002209,172.31.40.0-255,66,127543,63,190466
34753,0.002235,74.125.200.0-255,5738,133281,63,190466
34754,0.002238,172.31.40.0-255,66,133347,63,190466
34755,0.002242,74.125.200.0-255,2902,136249,63,190466
34756,0.002244,172.31.40.0-255,66,136315,63,190466
34757,0.002261,74.125.200.0-255,4320,140635,63,190466
34758,0.002263,172.31.40.0-255,66,140701,63,190466
34759,0.002286,74.125.200.0-255,1484,142185,63,190466
34760,0.002306,74.125.200.0-255,2902,145087,63,190466
34761,0.002309,172.31.40.0-255,66,145153,63,190466
34762,0.002352,74.125.200.0-255,5738,150891,63,190466
34763,0.002354,74.125.200.0-255,1484,152375,63,190466
34764,0.002357,172.31.40.0-255,101,152476,63,190466
34765,0.002361,172.31.40.0-255,66,152542,63,190466
34766,0.004656,74.125.200.0-255,66,152608,63,190466
34767,0.004698,74.125.200.0-255,2902,155510,63,190466
34768,0.004702,172.31.40.0-255,66,155576,63,190466
34769,0.004738,74.125.200.0-255,1484,157060,63,190466
34770,0.007062,74.125.200.0-255,4320,161380,63,190466
34771,0.007065,172.31.40.0-255,66,161446,63,190466
34772,0.009412,74.125.200.0-255,5738,167184,63,190466
34773,0.00942,172.31.40.0-255,66,167250,63,190466
34774,0.011769,74.125.200.0-255,5738,172988,63,190466
34775,0.01178,172.31.40.0-255,66,173054,63,190466
34776,0.014141,74.125.200.0-255,5738,178792,63,190466
34777,0.014151,172.31.40.0-255,66,178858,63,190466
34778,0.016492,74.125.200.0-255,5738,184596,63,190466
34779,0.016499,172.31.40.0-255,66,184662,63,190466
34780,0.018837,74.125.200.0-255,5738,190400,63,190466
34781,0.018845,172.31.40.0-255,66,190466,63,190466
34782,0.0,172.217.160.0-255,153,153,63,184193
34783,2.2e-05,172.31.40.0-255,66,219,63,184193
34784,3e-05,172.217.160.0-255,1484,1703,63,184193
34785,3.4e-05,172.31.40.0-255,66,1769,63,184193
34786,4e-05,172.217.160.0-255,2902,4671,63,184193
34787,4.3e-05,172.31.40.0-255,66,4737,63,184193
34788,5e-05,172.217.160.0-255,7156,11893,63,184193
34789,5.3e-05,172.31.40.0-255,66,11959,63,184193
34790,8.7e-05,172.217.160.0-255,7156,19115,63,184193
34791,9e-05,172.31.40.0-255,66,19181,63,184193
34792,0.000111,172.217.160.0-255,3535,22716,63,184193
34793,0.000114,172.31.40.0-255,66,22782,63,184193
34794,0.000124,172.31.40.0-255,66,22848,63,184193
34795,0.000149,172.217.160.0-255,1484,24332,63,184193
34796,0.000152,172.31.40.0-255,66,24398,63,184193
34797,0.000156,172.217.160.0-255,2902,27300,63,184193
34798,0.000158,172.31.40.0-255,66,27366,63,184193
34799,0.000162,172.217.160.0-255,2902,30268,63,184193
34800,0.000165,172.31.40.0-255,66,30334,63,184193
34801,0.000183,172.217.160.0-255,2902,33236,63,184193
34802,0.000186,172.31.40.0-255,66,33302,63,184193
34803,0.000202,172.217.160.0-255,5738,39040,63,184193
34804,0.000205,172.31.40.0-255,66,39106,63,184193
34805,0.000231,172.31.40.0-255,66,39172,63,184193
34806,0.000268,172.31.40.0-255,66,39238,63,184193
34807,0.000831,172.217.160.0-255,103,39341,63,184193
34808,0.000837,172.31.40.0-255,66,39407,63,184193
34809,0.000973,172.217.160.0-255,1484,40891,63,184193
34810,0.000976,172.31.40.0-255,66,40957,63,184193
34811,0.00098,172.217.160.0-255,1484,42441,63,184193
34812,0.000999,172.217.160.0-255,1484,43925,63,184193
34813,0.001001,172.31.40.0-255,66,43991,63,184193
34814,0.001008,172.217.160.0-255,5738,49729,63,184193
34815,0.00101,172.31.40.0-255,66,49795,63,184193
34816,0.001033,172.217.160.0-255,6797,56592,63,184193
34817,0.001035,172.31.40.0-255,66,56658,63,184193
34818,0.001038,172.217.160.0-255,1484,58142,63,184193
34819,0.001069,172.217.160.0-255,5738,63880,63,184193
34820,0.001071,172.31.40.0-255,66,63946,63,184193
34821,0.001078,172.217.160.0-255,4320,68266,63,184193
34822,0.00108,172.31.40.0-255,66,68332,63,184193
34823,0.001097,172.217.160.0-255,5379,73711,63,184193
34824,0.001099,172.31.40.0-255,66,73777,63,184193
34825,0.00135,172.217.160.0-255,1484,75261,63,184193
34826,0.001355,172.217.160.0-255,2902,78163,63,184193
34827,0.001358,172.31.40.0-255,66,78229,63,184193
34828,0.001365,172.217.160.0-255,4320,82549,63,184193
34829,0.001367,172.31.40.0-255,66,82615,63,184193
34830,0.00139,172.217.160.0-255,1484,84099,63,184193
34831,0.001402,172.31.40.0-255,66,84165,63,184193
34832,0.00142,172.217.160.0-255,4320,88485,63,184193
34833,0.001422,172.31.40.0-255,66,88551,63,184193
34834,0.001425,172.217.160.0-255,1484,90035,63,184193
34835,0.001455,172.31.40.0-255,66,90101,63,184193
34836,0.001468,172.31.40.0-255,66,90167,63,184193
34837,0.0015,172.217.160.0-255,4320,94487,63,184193
34838,0.001502,172.31.40.0-255,66,94553,63,184193
34839,0.001517,172.217.160.0-255,2902,97455,63,184193
34840,0.001523,172.217.160.0-255,5738,103193,63,184193
34841,0.001526,172.31.40.0-255,66,103259,63,184193
34842,0.001529,172.31.40.0-255,66,103325,63,184193
34843,0.00156,172.31.40.0-255,66,103391,63,184193
34844,0.001571,172.31.40.0-255,66,103457,63,184193
34845,0.001603,172.217.160.0-255,4320,107777,63,184193
34846,0.001605,172.31.40.0-255,66,107843,63,184193
34847,0.001619,172.31.40.0-255,66,107909,63,184193
34848,0.001625,172.217.160.0-255,5020,112929,63,184193
34849,0.001627,172.31.40.0-255,66,112995,63,184193
34850,0.001656,172.217.160.0-255,5738,118733,63,184193
34851,0.00166,172.31.40.0-255,66,118799,63,184193
34852,0.001703,172.217.160.0-255,1484,120283,63,184193
34853,0.001722,172.31.40.0-255,66,120349,63,184193
34854,0.003365,172.217.160.0-255,5738,126087,63,184193
34855,0.003372,172.31.40.0-255,66,126153,63,184193
34856,0.005015,172.217.160.0-255,5738,131891,63,184193
34857,0.00502,172.31.40.0-255,66,131957,63,184193
34858,0.00666,172.217.160.0-255,5738,137695,63,184193
34859,0.006663,172.31.40.0-255,66,137761,63,184193
34860,0.008314,172.217.160.0-255,5738,143499,63,184193
34861,0.00832,172.31.40.0-255,66,143565,63,184193
34862,0.009991,172.217.160.0-255,5738,149303,63,184193
34863,0.010005,172.31.40.0-255,66,149369,63,184193
34864,0.011659,172.217.160.0-255,5738,155107,63,184193
34865,0.011675,172.31.40.0-255,66,155173,63,184193
34866,0.013352,172.217.160.0-255,5738,160911,63,184193
34867,0.013364,172.31.40.0-255,66,160977,63,184193
34868,0.015014,172.217.160.0-255,5738,166715,63,184193
34869,0.015022,172.31.40.0-255,66,166781,63,184193
34870,0.016669,172.217.160.0-255,5738,172519,63,184193
34871,0.016677,172.31.40.0-255,66,172585,63,184193
34872,0.018321,172.217.160.0-255,5738,178323,63,184193
34873,0.01833,172.31.40.0-255,66,178389,63,184193
34874,0.019979,172.217.160.0-255,5738,184127,63,184193
34875,0.019986,172.31.40.0-255,66,184193,63,184193
34876,0.0,74.125.24.0-255,153,153,63,197217
34877,2.3e-05,172.31.40.0-255,66,219,63,197217
34878,3.2e-05,74.125.24.0-255,1484,1703,63,197217
34879,3.6e-05,172.31.40.0-255,66,1769,63,197217
34880,4.2e-05,74.125.24.0-255,2902,4671,63,197217
34881,4.5e-05,172.31.40.0-255,66,4737,63,197217
34882,5.3e-05,74.125.24.0-255,7156,11893,63,197217
34883,5.7e-05,172.31.40.0-255,66,11959,63,197217
34884,8.9e-05,172.31.40.0-255,66,12025,63,197217
34885,0.000114,74.125.24.0-255,2026,14051,63,197217
34886,0.000116,172.31.40.0-255,66,14117,63,197217
34887,0.000123,74.125.24.0-255,6797,20914,63,197217
34888,0.000125,172.31.40.0-255,66,20980,63,197217
34889,0.000284,74.125.24.0-255,1484,22464,63,197217
34890,0.000289,172.31.40.0-255,66,22530,63,197217
34891,0.000295,74.125.24.0-255,2902,25432,63,197217
34892,0.000297,172.31.40.0-255,66,25498,63,197217
34893,0.000304,74.125.24.0-255,5738,31236,63,197217
34894,0.000306,172.31.40.0-255,66,31302,63,197217
34895,0.000339,172.31.40.0-255,66,31368,63,197217
34896,0.000364,74.125.24.0-255,3961,35329,63,197217
34897,0.000367,172.31.40.0-255,66,35395,63,197217
34898,0.00037,74.125.24.0-255,1484,36879,63,197217
34899,0.000372,172.31.40.0-255,66,36945,63,197217
34900,0.000389,74.125.24.0-255,5738,42683,63,197217
34901,0.000392,172.31.40.0-255,66,42749,63,197217
34902,0.000418,74.125.24.0-255,2816,45565,63,197217
34903,0.00042,172.31.40.0-255,66,45631,63,197217
34904,0.000493,74.125.24.0-255,131,45762,63,197217
34905,0.000497,172.31.40.0-255,66,45828,63,197217
34906,0.000658,74.125.24.0-255,1484,47312,63,197217
34907,0.000664,74.125.24.0-255,2902,50214,63,197217
34908,0.000667,172.31.40.0-255,66,50280,63,197217
34909,0.000715,74.125.24.0-255,5738,56018,63,197217
34910,0.000718,172.31.40.0-255,66,56084,63,197217
34911,0.000725,74.125.24.0-255,6797,62881,63,197217
34912,0.000727,172.31.40.0-255,66,62947,63,197217
34913,0.000765,172.31.40.0-255,66,63013,63,197217
34914,0.000791,74.125.24.0-255,2543,65556,63,197217
34915,0.000793,172.31.40.0-255,66,65622,63,197217
34916,0.000824,74.125.24.0-255,347,65969,63,197217
34917,0.001235,74.125.24.0-255,1484,67453,63,197217
34918,0.001239,172.31.40.0-255,66,67519,63,197217
34919,0.001245,74.125.24.0-255,2902,70421,63,197217
34920,0.001247,172.31.40.0-255,66,70487,63,197217
34921,0.001253,74.125.24.0-255,4320,74807,63,197217
34922,0.001255,172.31.40.0-255,66,74873,63,197217
34923,0.001279,74.125.24.0-255,1484,76357,63,197217
34924,0.00129,172.31.40.0-255,66,76423,63,197217
34925,0.001315,74.125.24.0-255,4320,80743,63,197217
34926,0.001318,172.31.40.0-255,66,80809,63,197217
34927,0.00133,172.31.40.0-255,66,80875,63,197217
34928,0.001666,74.125.24.0-255,1484,82359,63,197217
34929,0.001687,74.125.24.0-255,2902,85261,63,197217
34930,0.00169,172.31.40.0-255,66,85327,63,197217
34931,0.001698,74.125.24.0-255,5738,91065,63,197217
34932,0.0017,172.31.40.0-255,66,91131,63,197217
34933,0.001703,74.125.24.0-255,1484,92615,63,197217
34934,0.001718,74.125.24.0-255,1484,94099,63,197217
34935,0.00172,172.31.40.0-255,66,94165,63,197217
34936,0.00175,74.125.24.0-255,7156,101321,63,197217
34937,0.001753,172.31.40.0-255,66,101387,63,197217
34938,0.001768,172.31.40.0-255,66,101453,63,197217
34939,0.001789,74.125.24.0-255,766,102219,63,197217
34940,0.001805,74.125.24.0-255,1484,103703,63,197217
34941,0.001807,172.31.40.0-255,66,103769,63,197217
34942,0.001813,74.125.24.0-255,4320,108089,63,197217
34943,0.001815,172.31.40.0-255,66,108155,63,197217
34944,0.001853,172.31.40.0-255,66,108221,63,197217
34945,0.00186,74.125.24.0-255,7156,115377,63,197217
34946,0.001862,172.31.40.0-255,66,115443,63,197217
34947,0.001878,74.125.24.0-255,2902,118345,63,197217
34948,0.00188,172.31.40.0-255,66,118411,63,197217
34949,0.001904,74.125.24.0-255,1484,119895,63,197217
34950,0.001919,74.125.24.0-255,6438,126333,63,197217
34951,0.001921,172.31.40.0-255,66,126399,63,197217
34952,0.001957,74.125.24.0-255,1484,127883,63,197217
34953,0.001977,74.125.24.0-255,2902,130785,63,197217
34954,0.00198,172.31.40.0-255,66,130851,63,197217
34955,0.001983,74.125.24.0-255,1484,132335,63,197217
34956,0.001998,74.125.24.0-255,4320,136655,63,197217
34957,0.002001,172.31.40.0-255,66,136721,63,197217
34958,0.002007,74.125.24.0-255,4320,141041,63,197217
34959,0.002009,172.31.40.0-255,66,141107,63,197217
34960,0.002033,74.125.24.0-255,2902,144009,63,197217
34961,0.002035,172.31.40.0-255,66,144075,63,197217
34962,0.00205,172.31.40.0-255,66,144141,63,197217
34963,0.002054,74.125.24.0-255,2184,146325,63,197217
34964,0.002057,172.31.40.0-255,66,146391,63,197217
34965,0.002247,74.125.24.0-255,1484,147875,63,197217
34966,0.002262,74.125.24.0-255,2902,150777,63,197217
34967,0.002266,172.31.40.0-255,66,150843,63,197217
34968,0.002291,74.125.24.0-255,5738,156581,63,197217
34969,0.002294,172.31.40.0-255,66,156647,63,197217
34970,0.002299,74.125.24.0-255,2902,159549,63,197217
34971,0.002301,172.31.40.0-255,66,159615,63,197217
34972,0.002356,74.125.24.0-255,766,160381,63,197217
34973,0.002394,172.31.40.0-255,66,160447,63,197217
34974,0.002471,74.125.24.0-255,1484,161931,63,197217
34975,0.002476,74.125.24.0-255,2902,164833,63,197217
34976,0.002478,74.125.24.0-255,1484,166317,63,197217
34977,0.002498,74.125.24.0-255,4320,170637,63,197217
34978,0.002518,74.125.24.0-255,2902,173539,63,197217
34979,0.007715,172.31.40.0-255,66,173605,63,197217
34980,0.00772,172.31.40.0-255,66,173671,63,197217
34981,0.007723,172.31.40.0-255,66,173737,63,197217
34982,0.007725,172.31.40.0-255,66,173803,63,197217
34983,0.007728,172.31.40.0-255,66,173869,63,197217
34984,0.007739,172.31.40.0-255,66,173935,63,197217
34985,0.007741,172.31.40.0-255,66,174001,63,197217
34986,0.010267,74.125.24.0-255,5738,179739,63,197217
34987,0.010275,172.31.40.0-255,66,179805,63,197217
34988,0.012784,74.125.24.0-255,5738,185543,63,197217
34989,0.012792,172.31.40.0-255,66,185609,63,197217
34990,0.015304,74.125.24.0-255,5738,191347,63,197217
34991,0.015315,172.31.40.0-255,66,191413,63,197217
34992,0.017846,74.125.24.0-255,5738,197151,63,197217
34993,0.017853,172.31.40.0-255,66,197217,63,197217
34994,0.0,172.217.194.0-255,153,153,63,209025
34995,2.2e-05,172.31.40.0-255,66,219,63,209025
34996,2.8e-05,172.217.194.0-255,1484,1703,63,209025
34997,3.2e-05,172.31.40.0-255,66,1769,63,209025
34998,3.4e-05,172.217.194.0-255,1484,3253,63,209025
34999,3.7e-05,172.31.40.0-255,66,3319,63,209025
35000,5e-05,172.217.194.0-255,4320,7639,63,209025
35001,5.2e-05,172.31.40.0-255,66,7705,63,209025
35002,5.8e-05,172.217.194.0-255,4320,12025,63,209025
35003,6e-05,172.31.40.0-255,66,12091,63,209025
35004,9e-05,172.217.194.0-255,1940,14031,63,209025
35005,9.2e-05,172.31.40.0-255,66,14097,63,209025
35006,0.000126,172.217.194.0-255,1484,15581,63,209025
35007,0.000128,172.31.40.0-255,66,15647,63,209025
35008,0.000131,172.217.194.0-255,1484,17131,63,209025
35009,0.000133,172.31.40.0-255,66,17197,63,209025
35010,0.00015,172.217.194.0-255,1484,18681,63,209025
35011,0.000152,172.31.40.0-255,66,18747,63,209025
35012,0.000158,172.217.194.0-255,5738,24485,63,209025
35013,0.00016,172.31.40.0-255,66,24551,63,209025
35014,0.000191,172.217.194.0-255,6797,31348,63,209025
35015,0.000193,172.31.40.0-255,66,31414,63,209025
35016,0.000288,172.217.194.0-255,1484,32898,63,209025
35017,0.000292,172.31.40.0-255,66,32964,63,209025
35018,0.000296,172.217.194.0-255,1484,34448,63,209025
35019,0.000298,172.31.40.0-255,66,34514,63,209025
35020,0.000322,172.217.194.0-255,1484,35998,63,209025
35021,0.000324,172.31.40.0-255,66,36064,63,209025
35022,0.000335,172.217.194.0-255,5738,41802,63,209025
35023,0.000338,172.31.40.0-255,66,41868,63,209025
35024,0.000342,172.217.194.0-255,2902,44770,63,209025
35025,0.000344,172.31.40.0-255,66,44836,63,209025
35026,0.000373,172.217.194.0-255,1484,46320,63,209025
35027,0.000402,172.31.40.0-255,66,46386,63,209025
35028,0.000408,172.217.194.0-255,4320,50706,63,209025
35029,0.00041,172.31.40.0-255,66,50772,63,209025
35030,0.000469,172.217.194.0-255,5674,56446,63,209025
35031,0.000472,172.31.40.0-255,66,56512,63,209025
35032,0.000502,172.217.194.0-255,383,56895,63,209025
35033,0.000878,172.217.194.0-255,1484,58379,63,209025
35034,0.000884,172.31.40.0-255,66,58445,63,209025
35035,0.00089,172.217.194.0-255,2902,61347,63,209025
35036,0.000891,172.31.40.0-255,66,61413,63,209025
35037,0.000922,172.217.194.0-255,5738,67151,63,209025
35038,0.000924,172.31.40.0-255,66,67217,63,209025
35039,0.000961,172.31.40.0-255,66,67283,63,209025
35040,0.000976,172.31.40.0-255,66,67349,63,209025
35041,0.001004,172.217.194.0-255,2184,69533,63,209025
35042,0.001007,172.31.40.0-255,66,69599,63,209025
35043,0.00155,172.217.194.0-255,1484,71083,63,209025
35044,0.00156,172.217.194.0-255,2902,73985,63,209025
35045,0.001564,172.31.40.0-255,66,74051,63,209025
35046,0.001594,172.217.194.0-255,5738,79789,63,209025
35047,0.001596,172.31.40.0-255,66,79855,63,209025
35048,0.001629,172.31.40.0-255,66,79921,63,209025
35049,0.00167,172.31.40.0-255,66,79987,63,209025
35050,0.001676,172.217.194.0-255,5020,85007,63,209025
35051,0.001678,172.31.40.0-255,66,85073,63,209025
35052,0.001723,172.217.194.0-255,1484,86557,63,209025
35053,0.001727,172.217.194.0-255,1484,88041,63,209025
35054,0.001729,172.31.40.0-255,66,88107,63,209025
35055,0.001754,172.217.194.0-255,1484,89591,63,209025
35056,0.001771,172.217.194.0-255,2902,92493,63,209025
35057,0.001773,172.31.40.0-255,66,92559,63,209025
35058,0.001801,172.217.194.0-255,2902,95461,63,209025
35059,0.001803,172.31.40.0-255,66,95527,63,209025
35060,0.001811,172.217.194.0-255,7156,102683,63,209025
35061,0.001813,172.31.40.0-255,66,102749,63,209025
35062,0.001822,172.217.194.0-255,4320,107069,63,209025
35063,0.001824,172.31.40.0-255,66,107135,63,209025
35064,0.00186,172.31.40.0-255,66,107201,63,209025
35065,0.001865,172.217.194.0-255,2184,109385,63,209025
35066,0.001867,172.31.40.0-255,66,109451,63,209025
35067,0.001892,172.217.194.0-255,2902,112353,63,209025
35068,0.001894,172.31.40.0-255,66,112419,63,209025
35069,0.001921,172.217.194.0-255,2902,115321,63,209025
35070,0.001923,172.31.40.0-255,66,115387,63,209025
35071,0.001949,172.217.194.0-255,4320,119707,63,209025
35072,0.001951,172.31.40.0-255,66,119773,63,209025
35073,0.001988,172.31.40.0-255,66,119839,63,209025
35074,0.001991,172.217.194.0-255,1484,121323,63,209025
35075,0.002023,172.31.40.0-255,66,121389,63,209025
35076,0.002027,172.217.194.0-255,2184,123573,63,209025
35077,0.00203,172.31.40.0-255,66,123639,63,209025
35078,0.002123,172.217.194.0-255,1484,125123,63,209025
35079,0.00213,172.217.194.0-255,2902,128025,63,209025
35080,0.002134,172.31.40.0-255,66,128091,63,209025
35081,0.002169,172.217.194.0-255,5738,133829,63,209025
35082,0.002171,172.31.40.0-255,66,133895,63,209025
35083,0.002176,172.217.194.0-255,2902,136797,63,209025
35084,0.002178,172.31.40.0-255,66,136863,63,209025
35085,0.002212,172.217.194.0-255,7156,144019,63,209025
35086,0.002215,172.31.40.0-255,66,144085,63,209025
35087,0.002232,172.31.40.0-255,66,144151,63,209025
35088,0.002258,172.217.194.0-255,1484,145635,63,209025
35089,0.002264,172.217.194.0-255,2184,147819,63,209025
35090,0.002266,172.31.40.0-255,66,147885,63,209025
35091,0.002295,172.217.194.0-255,1484,149369,63,209025
35092,0.0023,172.217.194.0-255,2902,152271,63,209025
35093,0.002303,172.31.40.0-255,66,152337,63,209025
35094,0.002309,172.217.194.0-255,5738,158075,63,209025
35095,0.002312,172.31.40.0-255,66,158141,63,209025
35096,0.00238,172.217.194.0-255,4320,162461,63,209025
35097,0.002383,172.31.40.0-255,66,162527,63,209025
35098,0.002409,172.31.40.0-255,66,162593,63,209025
35099,0.002415,172.217.194.0-255,5738,168331,63,209025
35100,0.002418,172.31.40.0-255,66,168397,63,209025
35101,0.004738,172.217.194.0-255,5738,174135,63,209025
35102,0.004746,172.31.40.0-255,66,174201,63,209025
35103,0.007053,172.217.194.0-255,5738,179939,63,209025
35104,0.007061,172.31.40.0-255,66,180005,63,209025
35105,0.009386,172.217.194.0-255,5738,185743,63,209025
35106,0.009408,172.31.40.0-255,66,185809,63,209025
35107,0.011722,172.217.194.0-255,5738,191547,63,209025
35108,0.011736,172.31.40.0-255,66,191613,63,209025
35109,0.014062,172.217.194.0-255,5738,197351,63,209025
35110,0.014072,172.31.40.0-255,66,197417,63,209025
35111,0.016404,172.217.194.0-255,5738,203155,63,209025
35112,0.016418,172.31.40.0-255,66,203221,63,209025
35113,0.018726,172.217.194.0-255,5738,208959,63,209025
35114,0.018738,172.31.40.0-255,66,209025,63,209025
35115,0.0,74.125.24.0-255,146,146,63,122827
35116,3.1e-05,172.31.40.0-255,66,212,63,122827
35117,3.8e-05,74.125.24.0-255,1484,1696,63,122827
35118,4.3e-05,172.31.40.0-255,66,1762,63,122827
35119,4.8e-05,74.125.24.0-255,2902,4664,63,122827
35120,5.9e-05,172.31.40.0-255,66,4730,63,122827
35121,6.7e-05,74.125.24.0-255,7156,11886,63,122827
35122,6.9e-05,172.31.40.0-255,66,11952,63,122827
35123,0.000109,74.125.24.0-255,2036,13988,63,122827
35124,0.000112,172.31.40.0-255,66,14054,63,122827
35125,0.000117,74.125.24.0-255,2902,16956,63,122827
35126,0.00012,172.31.40.0-255,66,17022,63,122827
35127,0.000125,74.125.24.0-255,2902,19924,63,122827
35128,0.000127,172.31.40.0-255,66,19990,63,122827
35129,0.000147,74.125.24.0-255,4320,24310,63,122827
35130,0.000155,172.31.40.0-255,66,24376,63,122827
35131,0.000161,74.125.24.0-255,4320,28696,63,122827
35132,0.000163,172.31.40.0-255,66,28762,63,122827
35133,0.000191,74.125.24.0-255,2543,31305,63,122827
35134,0.000193,172.31.40.0-255,66,31371,63,122827
35135,0.001279,74.125.24.0-255,1484,32855,63,122827
35136,0.001286,172.31.40.0-255,66,32921,63,122827
35137,0.001296,74.125.24.0-255,2902,35823,63,122827
35138,0.001298,172.31.40.0-255,66,35889,63,122827
35139,0.00131,74.125.24.0-255,5738,41627,63,122827
35140,0.001313,172.31.40.0-255,66,41693,63,122827
35141,0.00132,74.125.24.0-255,5738,47431,63,122827
35142,0.001322,172.31.40.0-255,66,47497,63,122827
35143,0.001338,74.125.24.0-255,1125,48622,63,122827
35144,0.001345,172.31.40.0-255,66,48688,63,122827
35145,0.001352,74.125.24.0-255,5738,54426,63,122827
35146,0.001354,172.31.40.0-255,66,54492,63,122827
35147,0.001381,172.31.40.0-255,66,54558,63,122827
35148,0.001385,74.125.24.0-255,2855,57413,63,122827
35149,0.001387,172.31.40.0-255,66,57479,63,122827
35150,0.001615,74.125.24.0-255,342,57821,63,122827
35151,0.001699,172.31.40.0-255,66,57887,63,122827
35152,0.001848,74.125.24.0-255,1484,59371,63,122827
35153,0.001856,74.125.24.0-255,2902,62273,63,122827
35154,0.001859,172.31.40.0-255,66,62339,63,122827
35155,0.001863,74.125.24.0-255,1484,63823,63,122827
35156,0.001901,74.125.24.0-255,4320,68143,63,122827
35157,0.001904,172.31.40.0-255,66,68209,63,122827
35158,0.001911,74.125.24.0-255,7156,75365,63,122827
35159,0.001914,172.31.40.0-255,66,75431,63,122827
35160,0.001949,74.125.24.0-255,6797,82228,63,122827
35161,0.001951,172.31.40.0-255,66,82294,63,122827
35162,0.001961,172.31.40.0-255,66,82360,63,122827
35163,0.001964,74.125.24.0-255,1125,83485,63,122827
35164,0.002216,172.31.40.0-255,66,83551,63,122827
35165,0.004245,74.125.24.0-255,4320,87871,63,122827
35166,0.00425,172.31.40.0-255,66,87937,63,122827
35167,0.004515,74.125.24.0-255,1484,89421,63,122827
35168,0.006558,74.125.24.0-255,4320,93741,63,122827
35169,0.006581,172.31.40.0-255,66,93807,63,122827
35170,0.008877,74.125.24.0-255,5738,99545,63,122827
35171,0.008885,172.31.40.0-255,66,99611,63,122827
35172,0.011194,74.125.24.0-255,5738,105349,63,122827
35173,0.011202,172.31.40.0-255,66,105415,63,122827
35174,0.013471,74.125.24.0-255,5738,111153,63,122827
35175,0.013482,172.31.40.0-255,66,111219,63,122827
35176,0.015786,74.125.24.0-255,5738,116957,63,122827
35177,0.015796,172.31.40.0-255,66,117023,63,122827
35178,0.01809,74.125.24.0-255,5738,122761,63,122827
35179,0.018098,172.31.40.0-255,66,122827,63,122827
35180,0.0,172.217.27.0-255,153,153,63,124988
35181,2e-05,172.31.40.0-255,66,219,63,124988
35182,2.8e-05,172.217.27.0-255,1484,1703,63,124988
35183,3.4e-05,172.31.40.0-255,66,1769,63,124988
35184,4e-05,172.217.27.0-255,2902,4671,63,124988
35185,4.3e-05,172.31.40.0-255,66,4737,63,124988
35186,5.1e-05,172.217.27.0-255,7156,11893,63,124988
35187,5.4e-05,172.31.40.0-255,66,11959,63,124988
35188,5.8e-05,172.217.27.0-255,2002,13961,63,124988
35189,6.1e-05,172.31.40.0-255,66,14027,63,124988
35190,0.000161,172.217.27.0-255,1484,15511,63,124988
35191,0.000164,172.31.40.0-255,66,15577,63,124988
35192,0.000169,172.217.27.0-255,1484,17061,63,124988
35193,0.000171,172.31.40.0-255,66,17127,63,124988
35194,0.000183,172.217.27.0-255,1484,18611,63,124988
35195,0.000185,172.31.40.0-255,66,18677,63,124988
35196,0.000193,172.217.27.0-255,5738,24415,63,124988
35197,0.000195,172.31.40.0-255,66,24481,63,124988
35198,0.000227,172.217.27.0-255,6797,31278,63,124988
35199,0.00023,172.31.40.0-255,66,31344,63,124988
35200,0.000261,172.217.27.0-255,4320,35664,63,124988
35201,0.000263,172.31.40.0-255,66,35730,63,124988
35202,0.000296,172.31.40.0-255,66,35796,63,124988
35203,0.000309,172.31.40.0-255,66,35862,63,124988
35204,0.00032,172.31.40.0-255,66,35928,63,124988
35205,0.000776,172.217.27.0-255,394,36322,63,124988
35206,0.000781,172.31.40.0-255,66,36388,63,124988
35207,0.000906,172.217.27.0-255,114,36502,63,124988
35208,0.000909,172.31.40.0-255,66,36568,63,124988
35209,0.000943,172.217.27.0-255,1484,38052,63,124988
35210,0.000956,172.217.27.0-255,2902,40954,63,124988
35211,0.000959,172.31.40.0-255,66,41020,63,124988
35212,0.000964,172.217.27.0-255,2902,43922,63,124988
35213,0.000966,172.31.40.0-255,66,43988,63,124988
35214,0.000978,172.217.27.0-255,1484,45472,63,124988
35215,0.000982,172.217.27.0-255,1484,46956,63,124988
35216,0.000984,172.31.40.0-255,66,47022,63,124988
35217,0.001002,172.217.27.0-255,7156,54178,63,124988
35218,0.001005,172.31.40.0-255,66,54244,63,124988
35219,0.001029,172.217.27.0-255,7156,61400,63,124988
35220,0.001032,172.31.40.0-255,66,61466,63,124988
35221,0.001059,172.31.40.0-255,66,61532,63,124988
35222,0.001063,172.217.27.0-255,766,62298,63,124988
35223,0.001354,172.31.40.0-255,66,62364,63,124988
35224,0.002706,172.217.27.0-255,4320,66684,63,124988
35225,0.002714,172.31.40.0-255,66,66750,63,124988
35226,0.002971,172.217.27.0-255,1484,68234,63,124988
35227,0.004333,172.217.27.0-255,4320,72554,63,124988
35228,0.004338,172.31.40.0-255,66,72620,63,124988
35229,0.005965,172.217.27.0-255,2902,75522,63,124988
35230,0.005969,172.31.40.0-255,66,75588,63,124988
35231,0.005986,172.217.27.0-255,2902,78490,63,124988
35232,0.005989,172.31.40.0-255,66,78556,63,124988
35233,0.007597,172.217.27.0-255,5738,84294,63,124988
35234,0.007603,172.31.40.0-255,66,84360,63,124988
35235,0.00924,172.217.27.0-255,5738,90098,63,124988
35236,0.009247,172.31.40.0-255,66,90164,63,124988
35237,0.010883,172.217.27.0-255,5738,95902,63,124988
35238,0.010891,172.31.40.0-255,66,95968,63,124988
35239,0.012527,172.217.27.0-255,5738,101706,63,124988
35240,0.012535,172.31.40.0-255,66,101772,63,124988
35241,0.014176,172.217.27.0-255,5738,107510,63,124988
35242,0.014183,172.31.40.0-255,66,107576,63,124988
35243,0.01582,172.217.27.0-255,5738,113314,63,124988
35244,0.015827,172.31.40.0-255,66,113380,63,124988
35245,0.017456,172.217.27.0-255,5738,119118,63,124988
35246,0.017464,172.31.40.0-255,66,119184,63,124988
35247,0.019097,172.217.27.0-255,5738,124922,63,124988
35248,0.019105,172.31.40.0-255,66,124988,63,124988
35249,0.0,172.217.194.0-255,152,152,63,234809
35250,1.4e-05,172.31.40.0-255,66,218,63,234809
35251,2.1e-05,172.217.194.0-255,1484,1702,63,234809
35252,2.6e-05,172.31.40.0-255,66,1768,63,234809
35253,3.3e-05,172.217.194.0-255,2902,4670,63,234809
35254,3.6e-05,172.31.40.0-255,66,4736,63,234809
35255,4.4e-05,172.217.194.0-255,7156,11892,63,234809
35256,4.7e-05,172.31.40.0-255,66,11958,63,234809
35257,5.1e-05,172.217.194.0-255,1978,13936,63,234809
35258,5.3e-05,172.31.40.0-255,66,14002,63,234809
35259,0.000146,172.217.194.0-255,1484,15486,63,234809
35260,0.000149,172.31.40.0-255,66,15552,63,234809
35261,0.000154,172.217.194.0-255,2902,18454,63,234809
35262,0.000157,172.31.40.0-255,66,18520,63,234809
35263,0.00016,172.217.194.0-255,1484,20004,63,234809
35264,0.000162,172.31.40.0-255,66,20070,63,234809
35265,0.000203,172.217.194.0-255,4320,24390,63,234809
35266,0.000205,172.31.40.0-255,66,24456,63,234809
35267,0.000212,172.217.194.0-255,5738,30194,63,234809
35268,0.000214,172.31.40.0-255,66,30260,63,234809
35269,0.000235,172.217.194.0-255,2902,33162,63,234809
35270,0.000237,172.31.40.0-255,66,33228,63,234809
35271,0.000273,172.217.194.0-255,2543,35771,63,234809
35272,0.000276,172.31.40.0-255,66,35837,63,234809
35273,0.000283,172.217.194.0-255,5738,41575,63,234809
35274,0.000285,172.31.40.0-255,66,41641,63,234809
35275,0.000339,172.217.194.0-255,6797,48438,63,234809
35276,0.000344,172.31.40.0-255,66,48504,63,234809
35277,0.000351,172.217.194.0-255,7156,55660,63,234809
35278,0.000353,172.31.40.0-255,66,55726,63,234809
35279,0.00036,172.217.194.0-255,7156,62882,63,234809
35280,0.000363,172.31.40.0-255,66,62948,63,234809
35281,0.000394,172.217.194.0-255,2839,65787,63,234809
35282,0.000396,172.31.40.0-255,66,65853,63,234809
35283,0.000785,172.217.194.0-255,382,66235,63,234809
35284,0.000998,172.217.194.0-255,1484,67719,63,234809
35285,0.001002,172.31.40.0-255,66,67785,63,234809
35286,0.001008,172.217.194.0-255,2902,70687,63,234809
35287,0.001011,172.31.40.0-255,66,70753,63,234809
35288,0.00104,172.217.194.0-255,5738,76491,63,234809
35289,0.001042,172.31.40.0-255,66,76557,63,234809
35290,0.00105,172.217.194.0-255,4320,80877,63,234809
35291,0.001052,172.31.40.0-255,66,80943,63,234809
35292,0.00108,172.31.40.0-255,66,81009,63,234809
35293,0.001092,172.31.40.0-255,66,81075,63,234809
35294,0.001135,172.217.194.0-255,1484,82559,63,234809
35295,0.001139,172.217.194.0-255,1484,84043,63,234809
35296,0.001142,172.31.40.0-255,66,84109,63,234809
35297,0.001162,172.217.194.0-255,1484,85593,63,234809
35298,0.001169,172.217.194.0-255,5738,91331,63,234809
35299,0.001171,172.31.40.0-255,66,91397,63,234809
35300,0.001185,172.31.40.0-255,66,91463,63,234809
35301,0.001216,172.217.194.0-255,1484,92947,63,234809
35302,0.00123,172.31.40.0-255,66,93013,63,234809
35303,0.0014,172.217.194.0-255,1484,94497,63,234809
35304,0.001406,172.217.194.0-255,2902,97399,63,234809
35305,0.001409,172.31.40.0-255,66,97465,63,234809
35306,0.001413,172.217.194.0-255,1484,98949,63,234809
35307,0.001432,172.217.194.0-255,4320,103269,63,234809
35308,0.001436,172.31.40.0-255,66,103335,63,234809
35309,0.001456,172.217.194.0-255,4320,107655,63,234809
35310,0.001459,172.31.40.0-255,66,107721,63,234809
35311,0.001487,172.31.40.0-255,66,107787,63,234809
35312,0.001492,172.217.194.0-255,2902,110689,63,234809
35313,0.001494,172.31.40.0-255,66,110755,63,234809
35314,0.001537,172.31.40.0-255,66,110821,63,234809
35315,0.002115,172.217.194.0-255,1484,112305,63,234809
35316,0.002121,172.217.194.0-255,2902,115207,63,234809
35317,0.002125,172.31.40.0-255,66,115273,63,234809
35318,0.002155,172.217.194.0-255,4320,119593,63,234809
35319,0.002159,172.31.40.0-255,66,119659,63,234809
35320,0.002164,172.217.194.0-255,4320,123979,63,234809
35321,0.002166,172.31.40.0-255,66,124045,63,234809
35322,0.002189,172.31.40.0-255,66,124111,63,234809
35323,0.002218,172.217.194.0-255,4320,128431,63,234809
35324,0.002221,172.31.40.0-255,66,128497,63,234809
35325,0.002227,172.217.194.0-255,6438,134935,63,234809
35326,0.002229,172.31.40.0-255,66,135001,63,234809
35327,0.002388,172.217.194.0-255,1484,136485,63,234809
35328,0.002418,172.217.194.0-255,2902,139387,63,234809
35329,0.002422,172.31.40.0-255,66,139453,63,234809
35330,0.002428,172.217.194.0-255,5738,145191,63,234809
35331,0.00243,172.31.40.0-255,66,145257,63,234809
35332,0.002435,172.217.194.0-255,2902,148159,63,234809
35333,0.002437,172.31.40.0-255,66,148225,63,234809
35334,0.002467,172.31.40.0-255,66,148291,63,234809
35335,0.002479,172.31.40.0-255,66,148357,63,234809
35336,0.002531,172.217.194.0-255,1484,149841,63,234809
35337,0.002536,172.217.194.0-255,2902,152743,63,234809
35338,0.002539,172.31.40.0-255,66,152809,63,234809
35339,0.002542,172.217.194.0-255,1484,154293,63,234809
35340,0.002562,172.217.194.0-255,4320,158613,63,234809
35341,0.002564,172.31.40.0-255,66,158679,63,234809
35342,0.002577,172.217.194.0-255,7156,165835,63,234809
35343,0.00258,172.31.40.0-255,66,165901,63,234809
35344,0.002599,172.217.194.0-255,5738,171639,63,234809
35345,0.002601,172.31.40.0-255,66,171705,63,234809
35346,0.002609,172.217.194.0-255,7156,178861,63,234809
35347,0.002611,172.31.40.0-255,66,178927,63,234809
35348,0.002629,172.217.194.0-255,3602,182529,63,234809
35349,0.002631,172.31.40.0-255,66,182595,63,234809
35350,0.00268,172.217.194.0-255,1484,184079,63,234809
35351,0.002685,172.217.194.0-255,2902,186981,63,234809
35352,0.002688,172.31.40.0-255,66,187047,63,234809
35353,0.002708,172.217.194.0-255,5738,192785,63,234809
35354,0.002711,172.31.40.0-255,66,192851,63,234809
35355,0.00273,172.217.194.0-255,1484,194335,63,234809
35356,0.002754,172.31.40.0-255,66,194401,63,234809
35357,0.002765,172.31.40.0-255,66,194467,63,234809
35358,0.002805,172.217.194.0-255,4320,198787,63,234809
35359,0.002808,172.31.40.0-255,66,198853,63,234809
35360,0.002846,172.31.40.0-255,66,198919,63,234809
35361,0.002863,172.31.40.0-255,66,198985,63,234809
35362,0.002867,172.217.194.0-255,2184,201169,63,234809
35363,0.002869,172.31.40.0-255,66,201235,63,234809
35364,0.002923,172.31.40.0-255,66,201301,63,234809
35365,0.002952,172.31.40.0-255,66,201367,63,234809
35366,0.002954,172.217.194.0-255,1484,202851,63,234809
35367,0.002961,172.217.194.0-255,5738,208589,63,234809
35368,0.002963,172.31.40.0-255,66,208655,63,234809
35369,0.002983,172.217.194.0-255,5020,213675,63,234809
35370,0.002986,172.31.40.0-255,66,213741,63,234809
35371,0.003376,172.217.194.0-255,1484,215225,63,234809
35372,0.003383,172.217.194.0-255,2902,218127,63,234809
35373,0.003387,172.31.40.0-255,66,218193,63,234809
35374,0.003423,172.217.194.0-255,5738,223931,63,234809
35375,0.003426,172.31.40.0-255,66,223997,63,234809
35376,0.003467,172.217.194.0-255,7156,231153,63,234809
35377,0.00347,172.31.40.0-255,66,231219,63,234809
35378,0.003499,172.217.194.0-255,2902,234121,63,234809
35379,0.003501,172.31.40.0-255,66,234187,63,234809
35380,0.003515,172.31.40.0-255,66,234253,63,234809
35381,0.003518,172.217.194.0-255,97,234350,63,234809
35382,0.003538,172.217.194.0-255,105,234455,63,234809
35383,0.012191,172.217.194.0-255,105,234560,63,234809
35384,0.012213,172.31.40.0-255,78,234638,63,234809
35385,0.014366,172.31.40.0-255,105,234743,63,234809
35386,0.016446,172.217.194.0-255,66,234809,63,234809
35387,0.0,74.125.24.0-255,146,146,63,150155
35388,2.1e-05,172.31.40.0-255,66,212,63,150155
35389,2.8e-05,74.125.24.0-255,1484,1696,63,150155
35390,3.3e-05,172.31.40.0-255,66,1762,63,150155
35391,3.9e-05,74.125.24.0-255,2902,4664,63,150155
35392,4.2e-05,172.31.40.0-255,66,4730,63,150155
35393,4.8e-05,74.125.24.0-255,4320,9050,63,150155
35394,5.1e-05,172.31.40.0-255,66,9116,63,150155
35395,9.3e-05,74.125.24.0-255,2902,12018,63,150155
35396,9.5e-05,172.31.40.0-255,66,12084,63,150155
35397,0.000102,74.125.24.0-255,4865,16949,63,150155
35398,0.000105,172.31.40.0-255,66,17015,63,150155
35399,0.000111,74.125.24.0-255,5738,22753,63,150155
35400,0.000113,172.31.40.0-255,66,22819,63,150155
35401,0.00012,74.125.24.0-255,5738,28557,63,150155
35402,0.000122,172.31.40.0-255,66,28623,63,150155
35403,0.000146,74.125.24.0-255,2543,31166,63,150155
35404,0.000149,172.31.40.0-255,66,31232,63,150155
35405,0.000152,74.125.24.0-255,1484,32716,63,150155
35406,0.000154,172.31.40.0-255,66,32782,63,150155
35407,0.00017,74.125.24.0-255,7156,39938,63,150155
35408,0.000173,172.31.40.0-255,66,40004,63,150155
35409,0.000178,74.125.24.0-255,4320,44324,63,150155
35410,0.00018,172.31.40.0-255,66,44390,63,150155
35411,0.000231,74.125.24.0-255,3961,48351,63,150155
35412,0.000235,172.31.40.0-255,66,48417,63,150155
35413,0.000277,74.125.24.0-255,4320,52737,63,150155
35414,0.00028,172.31.40.0-255,66,52803,63,150155
35415,0.000283,74.125.24.0-255,1484,54287,63,150155
35416,0.000285,172.31.40.0-255,66,54353,63,150155
35417,0.000307,74.125.24.0-255,4320,58673,63,150155
35418,0.00031,172.31.40.0-255,66,58739,63,150155
35419,0.000336,74.125.24.0-255,6797,65536,63,150155
35420,0.000339,172.31.40.0-255,66,65602,63,150155
35421,0.000342,74.125.24.0-255,402,66004,63,150155
35422,0.000423,74.125.24.0-255,109,66113,63,150155
35423,0.000471,74.125.24.0-255,1484,67597,63,150155
35424,0.000475,172.31.40.0-255,66,67663,63,150155
35425,0.00048,74.125.24.0-255,2902,70565,63,150155
35426,0.000483,172.31.40.0-255,66,70631,63,150155
35427,0.000501,74.125.24.0-255,7156,77787,63,150155
35428,0.000504,172.31.40.0-255,66,77853,63,150155
35429,0.000526,74.125.24.0-255,5738,83591,63,150155
35430,0.000529,172.31.40.0-255,66,83657,63,150155
35431,0.00055,172.31.40.0-255,66,83723,63,150155
35432,0.000556,74.125.24.0-255,6438,90161,63,150155
35433,0.000559,172.31.40.0-255,66,90227,63,150155
35434,0.000584,74.125.24.0-255,330,90557,63,150155
35435,0.000876,74.125.24.0-255,1484,92041,63,150155
35436,0.000882,172.31.40.0-255,66,92107,63,150155
35437,0.000887,74.125.24.0-255,1484,93591,63,150155
35438,0.000906,74.125.24.0-255,1484,95075,63,150155
35439,0.000909,172.31.40.0-255,66,95141,63,150155
35440,0.000916,74.125.24.0-255,5738,100879,63,150155
35441,0.000918,172.31.40.0-255,66,100945,63,150155
35442,0.000955,172.31.40.0-255,66,101011,63,150155
35443,0.000965,172.31.40.0-255,66,101077,63,150155
35444,0.001013,74.125.24.0-255,2184,103261,63,150155
35445,0.001017,172.31.40.0-255,66,103327,63,150155
35446,0.003281,74.125.24.0-255,2902,106229,63,150155
35447,0.003288,172.31.40.0-255,66,106295,63,150155
35448,0.003308,74.125.24.0-255,2902,109197,63,150155
35449,0.003311,172.31.40.0-255,66,109263,63,150155
35450,0.005583,74.125.24.0-255,2902,112165,63,150155
35451,0.005586,172.31.40.0-255,66,112231,63,150155
35452,0.005612,74.125.24.0-255,2902,115133,63,150155
35453,0.005615,172.31.40.0-255,66,115199,63,150155
35454,0.007872,74.125.24.0-255,2902,118101,63,150155
35455,0.007878,172.31.40.0-255,66,118167,63,150155
35456,0.007897,74.125.24.0-255,2902,121069,63,150155
35457,0.007899,172.31.40.0-255,66,121135,63,150155
35458,0.010178,74.125.24.0-255,5738,126873,63,150155
35459,0.010185,172.31.40.0-255,66,126939,63,150155
35460,0.012477,74.125.24.0-255,5738,132677,63,150155
35461,0.012484,172.31.40.0-255,66,132743,63,150155
35462,0.014803,74.125.24.0-255,5738,138481,63,150155
35463,0.01483,172.31.40.0-255,66,138547,63,150155
35464,0.017142,74.125.24.0-255,5738,144285,63,150155
35465,0.017151,172.31.40.0-255,66,144351,63,150155
35466,0.019474,74.125.24.0-255,5738,150089,63,150155
35467,0.019483,172.31.40.0-255,66,150155,63,150155
35468,0.0,74.125.24.0-255,152,152,63,210409
35469,2.3e-05,172.31.40.0-255,66,218,63,210409
35470,3e-05,74.125.24.0-255,1484,1702,63,210409
35471,3.4e-05,172.31.40.0-255,66,1768,63,210409
35472,4e-05,74.125.24.0-255,2902,4670,63,210409
35473,4.4e-05,172.31.40.0-255,66,4736,63,210409
35474,5.9e-05,74.125.24.0-255,7156,11892,63,210409
35475,6.3e-05,172.31.40.0-255,66,11958,63,210409
35476,6.8e-05,74.125.24.0-255,3534,15492,63,210409
35477,7.1e-05,172.31.40.0-255,66,15558,63,210409
35478,0.00011,74.125.24.0-255,5738,21296,63,210409
35479,0.000113,172.31.40.0-255,66,21362,63,210409
35480,0.000146,74.125.24.0-255,7156,28518,63,210409
35481,0.000149,172.31.40.0-255,66,28584,63,210409
35482,0.000153,74.125.24.0-255,2543,31127,63,210409
35483,0.000155,172.31.40.0-255,66,31193,63,210409
35484,0.000195,74.125.24.0-255,1484,32677,63,210409
35485,0.000198,172.31.40.0-255,66,32743,63,210409
35486,0.000226,74.125.24.0-255,2902,35645,63,210409
35487,0.000228,172.31.40.0-255,66,35711,63,210409
35488,0.000235,74.125.24.0-255,5738,41449,63,210409
35489,0.000237,172.31.40.0-255,66,41515,63,210409
35490,0.000261,74.125.24.0-255,1484,42999,63,210409
35491,0.000263,172.31.40.0-255,66,43065,63,210409
35492,0.000285,74.125.24.0-255,5379,48444,63,210409
35493,0.000288,172.31.40.0-255,66,48510,63,210409
35494,0.00032,74.125.24.0-255,7156,55666,63,210409
35495,0.000323,172.31.40.0-255,66,55732,63,210409
35496,0.000335,172.31.40.0-255,66,55798,63,210409
35497,0.000361,74.125.24.0-255,1438,57236,63,210409
35498,0.000364,172.31.40.0-255,66,57302,63,210409
35499,0.000519,74.125.24.0-255,109,57411,63,210409
35500,0.000625,74.125.24.0-255,1484,58895,63,210409
35501,0.000631,74.125.24.0-255,2902,61797,63,210409
35502,0.000637,172.31.40.0-255,66,61863,63,210409
35503,0.000641,172.31.40.0-255,66,61929,63,210409
35504,0.000658,74.125.24.0-255,5738,67667,63,210409
35505,0.000663,172.31.40.0-255,66,67733,63,210409
35506,0.000697,172.31.40.0-255,66,67799,63,210409
35507,0.000733,172.31.40.0-255,66,67865,63,210409
35508,0.000749,74.125.24.0-255,2543,70408,63,210409
35509,0.000752,172.31.40.0-255,66,70474,63,210409
35510,0.000967,74.125.24.0-255,1484,71958,63,210409
35511,0.000974,74.125.24.0-255,2902,74860,63,210409
35512,0.000977,172.31.40.0-255,66,74926,63,210409
35513,0.000983,74.125.24.0-255,2902,77828,63,210409
35514,0.000986,172.31.40.0-255,66,77894,63,210409
35515,0.001004,74.125.24.0-255,2902,80796,63,210409
35516,0.001007,172.31.40.0-255,66,80862,63,210409
35517,0.001026,172.31.40.0-255,66,80928,63,210409
35518,0.001033,74.125.24.0-255,7156,88084,63,210409
35519,0.001036,172.31.40.0-255,66,88150,63,210409
35520,0.001079,74.125.24.0-255,3602,91752,63,210409
35521,0.001083,172.31.40.0-255,66,91818,63,210409
35522,0.00113,74.125.24.0-255,1484,93302,63,210409
35523,0.001146,74.125.24.0-255,2902,96204,63,210409
35524,0.001149,172.31.40.0-255,66,96270,63,210409
35525,0.001156,74.125.24.0-255,5738,102008,63,210409
35526,0.001159,172.31.40.0-255,66,102074,63,210409
35527,0.001191,74.125.24.0-255,7156,109230,63,210409
35528,0.001195,172.31.40.0-255,66,109296,63,210409
35529,0.001201,74.125.24.0-255,5738,115034,63,210409
35530,0.001203,172.31.40.0-255,66,115100,63,210409
35531,0.00124,172.31.40.0-255,66,115166,63,210409
35532,0.001244,74.125.24.0-255,2184,117350,63,210409
35533,0.001247,172.31.40.0-255,66,117416,63,210409
35534,0.001283,74.125.24.0-255,1484,118900,63,210409
35535,0.001287,74.125.24.0-255,1484,120384,63,210409
35536,0.001289,172.31.40.0-255,66,120450,63,210409
35537,0.001302,74.125.24.0-255,1484,121934,63,210409
35538,0.001313,74.125.24.0-255,5738,127672,63,210409
35539,0.001316,172.31.40.0-255,66,127738,63,210409
35540,0.001355,172.31.40.0-255,66,127804,63,210409
35541,0.001395,172.31.40.0-255,66,127870,63,210409
35542,0.001438,74.125.24.0-255,5738,133608,63,210409
35543,0.001442,172.31.40.0-255,66,133674,63,210409
35544,0.001449,74.125.24.0-255,7156,140830,63,210409
35545,0.001452,172.31.40.0-255,66,140896,63,210409
35546,0.001495,74.125.24.0-255,1484,142380,63,210409
35547,0.001526,172.31.40.0-255,66,142446,63,210409
35548,0.001533,74.125.24.0-255,6438,148884,63,210409
35549,0.001535,172.31.40.0-255,66,148950,63,210409
35550,0.00157,74.125.24.0-255,4320,153270,63,210409
35551,0.001574,172.31.40.0-255,66,153336,63,210409
35552,0.001603,74.125.24.0-255,2902,156238,63,210409
35553,0.001606,172.31.40.0-255,66,156304,63,210409
35554,0.001645,74.125.24.0-255,766,157070,63,210409
35555,0.001658,172.31.40.0-255,66,157136,63,210409
35556,0.001727,74.125.24.0-255,1484,158620,63,210409
35557,0.001741,74.125.24.0-255,2902,161522,63,210409
35558,0.001744,172.31.40.0-255,66,161588,63,210409
35559,0.00175,74.125.24.0-255,4320,165908,63,210409
35560,0.001771,74.125.24.0-255,1484,167392,63,210409
35561,0.001788,74.125.24.0-255,4320,171712,63,210409
35562,0.001794,172.31.40.0-255,66,171778,63,210409
35563,0.00181,74.125.24.0-255,4320,176098,63,210409
35564,0.001825,74.125.24.0-255,2184,178282,63,210409
35565,0.001844,172.31.40.0-255,66,178348,63,210409
35566,0.001878,74.125.24.0-255,1484,179832,63,210409
35567,0.001883,74.125.24.0-255,2902,182734,63,210409
35568,0.001895,172.31.40.0-255,66,182800,63,210409
35569,0.001902,74.125.24.0-255,5738,188538,63,210409
35570,0.001907,172.31.40.0-255,66,188604,63,210409
35571,0.001982,172.31.40.0-255,66,188670,63,210409
35572,0.001989,74.125.24.0-255,7156,195826,63,210409
35573,0.001997,172.31.40.0-255,66,195892,63,210409
35574,0.002078,172.31.40.0-255,66,195958,63,210409
35575,0.002104,74.125.24.0-255,5738,201696,63,210409
35576,0.002144,172.31.40.0-255,66,201762,63,210409
35577,0.002155,74.125.24.0-255,6438,208200,63,210409
35578,0.002177,172.31.40.0-255,66,208266,63,210409
35579,0.002185,74.125.24.0-255,1735,210001,63,210409
35580,0.002205,172.31.40.0-255,66,210067,63,210409
35581,0.002247,74.125.24.0-255,105,210172,63,210409
35582,0.015999,172.31.40.0-255,66,210238,63,210409
35583,0.016059,172.31.40.0-255,105,210343,63,210409
35584,0.018649,74.125.24.0-255,66,210409,63,210409
35585,0.0,172.217.194.0-255,150,150,63,199664
35586,1.4e-05,172.31.40.0-255,66,216,63,199664
35587,1.9e-05,172.217.194.0-255,1484,1700,63,199664
35588,2.4e-05,172.31.40.0-255,66,1766,63,199664
35589,3.6e-05,172.217.194.0-255,2902,4668,63,199664
35590,3.9e-05,172.31.40.0-255,66,4734,63,199664
35591,4.5e-05,172.217.194.0-255,4320,9054,63,199664
35592,4.8e-05,172.31.40.0-255,66,9120,63,199664
35593,8.6e-05,172.31.40.0-255,66,9186,63,199664
35594,9.2e-05,172.217.194.0-255,4320,13506,63,199664
35595,9.4e-05,172.31.40.0-255,66,13572,63,199664
35596,0.000149,172.31.40.0-255,66,13638,63,199664
35597,0.000153,172.217.194.0-255,1484,15122,63,199664
35598,0.000155,172.31.40.0-255,66,15188,63,199664
35599,0.000161,172.217.194.0-255,2902,18090,63,199664
35600,0.000164,172.31.40.0-255,66,18156,63,199664
35601,0.00017,172.217.194.0-255,5738,23894,63,199664
35602,0.000173,172.31.40.0-255,66,23960,63,199664
35603,0.000241,172.31.40.0-255,66,24026,63,199664
35604,0.000246,172.217.194.0-255,4320,28346,63,199664
35605,0.000249,172.31.40.0-255,66,28412,63,199664
35606,0.000278,172.217.194.0-255,5674,34086,63,199664
35607,0.000281,172.31.40.0-255,66,34152,63,199664
35608,0.000283,172.217.194.0-255,381,34533,63,199664
35609,0.000285,172.31.40.0-255,66,34599,63,199664
35610,0.000577,172.217.194.0-255,1484,36083,63,199664
35611,0.000584,172.31.40.0-255,66,36149,63,199664
35612,0.00059,172.217.194.0-255,2902,39051,63,199664
35613,0.000592,172.31.40.0-255,66,39117,63,199664
35614,0.000599,172.217.194.0-255,5738,44855,63,199664
35615,0.000601,172.31.40.0-255,66,44921,63,199664
35616,0.000614,172.217.194.0-255,7156,52077,63,199664
35617,0.000616,172.31.40.0-255,66,52143,63,199664
35618,0.000663,172.31.40.0-255,66,52209,63,199664
35619,0.000667,172.217.194.0-255,2184,54393,63,199664
35620,0.000669,172.31.40.0-255,66,54459,63,199664
35621,0.000872,172.217.194.0-255,1484,55943,63,199664
35622,0.000879,172.217.194.0-255,2902,58845,63,199664
35623,0.000883,172.31.40.0-255,66,58911,63,199664
35624,0.000891,172.217.194.0-255,5738,64649,63,199664
35625,0.000894,172.31.40.0-255,66,64715,63,199664
35626,0.000935,172.31.40.0-255,66,64781,63,199664
35627,0.000968,172.31.40.0-255,66,64847,63,199664
35628,0.000996,172.217.194.0-255,3602,68449,63,199664
35629,0.000999,172.31.40.0-255,66,68515,63,199664
35630,0.001014,172.31.40.0-255,66,68581,63,199664
35631,0.001027,172.31.40.0-255,66,68647,63,199664
35632,0.001059,172.217.194.0-255,2902,71549,63,199664
35633,0.001062,172.31.40.0-255,66,71615,63,199664
35634,0.001069,172.217.194.0-255,5020,76635,63,199664
35635,0.001071,172.31.40.0-255,66,76701,63,199664
35636,0.001106,172.217.194.0-255,1484,78185,63,199664
35637,0.001111,172.217.194.0-255,2902,81087,63,199664
35638,0.001113,172.31.40.0-255,66,81153,63,199664
35639,0.001142,172.217.194.0-255,5738,86891,63,199664
35640,0.001145,172.31.40.0-255,66,86957,63,199664
35641,0.001153,172.217.194.0-255,7156,94113,63,199664
35642,0.001155,172.31.40.0-255,66,94179,63,199664
35643,0.001187,172.217.194.0-255,5738,99917,63,199664
35644,0.00119,172.31.40.0-255,66,99983,63,199664
35645,0.001201,172.31.40.0-255,66,100049,63,199664
35646,0.001226,172.217.194.0-255,2184,102233,63,199664
35647,0.001228,172.31.40.0-255,66,102299,63,199664
35648,0.001294,172.217.194.0-255,1484,103783,63,199664
35649,0.001298,172.217.194.0-255,1484,105267,63,199664
35650,0.0013,172.31.40.0-255,66,105333,63,199664
35651,0.001327,172.217.194.0-255,1484,106817,63,199664
35652,0.001335,172.217.194.0-255,5738,112555,63,199664
35653,0.001338,172.31.40.0-255,66,112621,63,199664
35654,0.001351,172.31.40.0-255,66,112687,63,199664
35655,0.001424,172.31.40.0-255,66,112753,63,199664
35656,0.001437,172.31.40.0-255,66,112819,63,199664
35657,0.001464,172.31.40.0-255,66,112885,63,199664
35658,0.00147,172.217.194.0-255,5738,118623,63,199664
35659,0.001472,172.31.40.0-255,66,118689,63,199664
35660,0.001505,172.217.194.0-255,5020,123709,63,199664
35661,0.001509,172.31.40.0-255,66,123775,63,199664
35662,0.001521,172.31.40.0-255,66,123841,63,199664
35663,0.001576,172.31.40.0-255,66,123907,63,199664
35664,0.001613,172.217.194.0-255,1484,125391,63,199664
35665,0.001618,172.217.194.0-255,2902,128293,63,199664
35666,0.00162,172.31.40.0-255,66,128359,63,199664
35667,0.001626,172.217.194.0-255,4320,132679,63,199664
35668,0.001629,172.31.40.0-255,66,132745,63,199664
35669,0.00166,172.217.194.0-255,1484,134229,63,199664
35670,0.001676,172.31.40.0-255,66,134295,63,199664
35671,0.001683,172.217.194.0-255,5738,140033,63,199664
35672,0.001686,172.31.40.0-255,66,140099,63,199664
35673,0.001715,172.217.194.0-255,5020,145119,63,199664
35674,0.001719,172.31.40.0-255,66,145185,63,199664
35675,0.001746,172.217.194.0-255,1484,146669,63,199664
35676,0.001751,172.217.194.0-255,2902,149571,63,199664
35677,0.001753,172.31.40.0-255,66,149637,63,199664
35678,0.001759,172.217.194.0-255,5738,155375,63,199664
35679,0.001762,172.31.40.0-255,66,155441,63,199664
35680,0.001798,172.217.194.0-255,7156,162597,63,199664
35681,0.001802,172.31.40.0-255,66,162663,63,199664
35682,0.001813,172.31.40.0-255,66,162729,63,199664
35683,0.001843,172.217.194.0-255,5738,168467,63,199664
35684,0.001846,172.31.40.0-255,66,168533,63,199664
35685,0.00185,172.217.194.0-255,2184,170717,63,199664
35686,0.001852,172.31.40.0-255,66,170783,63,199664
35687,0.001857,172.217.194.0-255,2902,173685,63,199664
35688,0.001859,172.31.40.0-255,66,173751,63,199664
35689,0.001896,172.217.194.0-255,7156,180907,63,199664
35690,0.001899,172.31.40.0-255,66,180973,63,199664
35691,0.001907,172.217.194.0-255,7156,188129,63,199664
35692,0.001909,172.31.40.0-255,66,188195,63,199664
35693,0.00192,172.31.40.0-255,66,188261,63,199664
35694,0.001964,172.217.194.0-255,7156,195417,63,199664
35695,0.001968,172.31.40.0-255,66,195483,63,199664
35696,0.001971,172.217.194.0-255,766,196249,63,199664
35697,0.002008,172.217.194.0-255,1484,197733,63,199664
35698,0.00201,172.31.40.0-255,66,197799,63,199664
35699,0.002037,172.217.194.0-255,1340,199139,63,199664
35700,0.002039,172.217.194.0-255,105,199244,63,199664
35701,0.009863,172.31.40.0-255,66,199310,63,199664
35702,0.009898,172.31.40.0-255,105,199415,63,199664
35703,0.011362,172.217.194.0-255,105,199520,63,199664
35704,0.011372,172.31.40.0-255,78,199598,63,199664
35705,0.012239,172.217.194.0-255,66,199664,63,199664
35706,0.0,172.217.194.0-255,153,153,63,174114
35707,2.3e-05,172.31.40.0-255,66,219,63,174114
35708,3e-05,172.217.194.0-255,1484,1703,63,174114
35709,3.5e-05,172.31.40.0-255,66,1769,63,174114
35710,4.1e-05,172.217.194.0-255,2902,4671,63,174114
35711,5.4e-05,172.31.40.0-255,66,4737,63,174114
35712,6.1e-05,172.217.194.0-255,5738,10475,63,174114
35713,6.5e-05,172.31.40.0-255,66,10541,63,174114
35714,9.5e-05,172.217.194.0-255,3458,13999,63,174114
35715,9.8e-05,172.31.40.0-255,66,14065,63,174114
35716,0.000126,172.217.194.0-255,1484,15549,63,174114
35717,0.000129,172.31.40.0-255,66,15615,63,174114
35718,0.000141,172.217.194.0-255,1484,17099,63,174114
35719,0.000148,172.31.40.0-255,66,17165,63,174114
35720,0.000176,172.217.194.0-255,1484,18649,63,174114
35721,0.000178,172.31.40.0-255,66,18715,63,174114
35722,0.000185,172.217.194.0-255,5738,24453,63,174114
35723,0.000187,172.31.40.0-255,66,24519,63,174114
35724,0.000198,172.217.194.0-255,6797,31316,63,174114
35725,0.0002,172.31.40.0-255,66,31382,63,174114
35726,0.000208,172.217.194.0-255,5738,37120,63,174114
35727,0.000211,172.31.40.0-255,66,37186,63,174114
35728,0.000242,172.217.194.0-255,1484,38670,63,174114
35729,0.000245,172.31.40.0-255,66,38736,63,174114
35730,0.000261,172.31.40.0-255,66,38802,63,174114
35731,0.00059,172.217.194.0-255,1484,40286,63,174114
35732,0.000595,172.31.40.0-255,66,40352,63,174114
35733,0.000601,172.217.194.0-255,2902,43254,63,174114
35734,0.000603,172.31.40.0-255,66,43320,63,174114
35735,0.000609,172.217.194.0-255,5738,49058,63,174114
35736,0.000619,172.31.40.0-255,66,49124,63,174114
35737,0.000681,172.31.40.0-255,66,49190,63,174114
35738,0.000685,172.217.194.0-255,1484,50674,63,174114
35739,0.000691,172.217.194.0-255,2902,53576,63,174114
35740,0.000692,172.31.40.0-255,66,53642,63,174114
35741,0.000702,172.217.194.0-255,2902,56544,63,174114
35742,0.000704,172.31.40.0-255,66,56610,63,174114
35743,0.000728,172.217.194.0-255,2902,59512,63,174114
35744,0.000735,172.31.40.0-255,66,59578,63,174114
35745,0.00076,172.217.194.0-255,4320,63898,63,174114
35746,0.000764,172.31.40.0-255,66,63964,63,174114
35747,0.0008,172.31.40.0-255,66,64030,63,174114
35748,0.000843,172.217.194.0-255,4320,68350,63,174114
35749,0.000847,172.31.40.0-255,66,68416,63,174114
35750,0.000877,172.217.194.0-255,6248,74664,63,174114
35751,0.00088,172.31.40.0-255,66,74730,63,174114
35752,0.001198,172.217.194.0-255,1484,76214,63,174114
35753,0.001204,172.217.194.0-255,2902,79116,63,174114
35754,0.001207,172.31.40.0-255,66,79182,63,174114
35755,0.001242,172.217.194.0-255,5738,84920,63,174114
35756,0.001245,172.31.40.0-255,66,84986,63,174114
35757,0.001255,172.31.40.0-255,66,85052,63,174114
35758,0.00129,172.31.40.0-255,66,85118,63,174114
35759,0.001316,172.217.194.0-255,1484,86602,63,174114
35760,0.001323,172.217.194.0-255,5020,91622,63,174114
35761,0.001326,172.31.40.0-255,66,91688,63,174114
35762,0.001399,172.217.194.0-255,1484,93172,63,174114
35763,0.001405,172.217.194.0-255,2902,96074,63,174114
35764,0.001407,172.31.40.0-255,66,96140,63,174114
35765,0.001436,172.217.194.0-255,5738,101878,63,174114
35766,0.001438,172.31.40.0-255,66,101944,63,174114
35767,0.001443,172.217.194.0-255,2902,104846,63,174114
35768,0.001445,172.31.40.0-255,66,104912,63,174114
35769,0.001465,172.217.194.0-255,4320,109232,63,174114
35770,0.001468,172.31.40.0-255,66,109298,63,174114
35771,0.001497,172.217.194.0-255,4320,113618,63,174114
35772,0.001499,172.31.40.0-255,66,113684,63,174114
35773,0.001526,172.31.40.0-255,66,113750,63,174114
35774,0.001552,172.217.194.0-255,2184,115934,63,174114
35775,0.001568,172.31.40.0-255,66,116000,63,174114
35776,0.002324,172.217.194.0-255,1484,117484,63,174114
35777,0.002333,172.217.194.0-255,2902,120386,63,174114
35778,0.002337,172.31.40.0-255,66,120452,63,174114
35779,0.002365,172.217.194.0-255,5738,126190,63,174114
35780,0.002368,172.31.40.0-255,66,126256,63,174114
35781,0.002372,172.217.194.0-255,1484,127740,63,174114
35782,0.002393,172.217.194.0-255,4320,132060,63,174114
35783,0.002395,172.31.40.0-255,66,132126,63,174114
35784,0.002422,172.217.194.0-255,4320,136446,63,174114
35785,0.002425,172.31.40.0-255,66,136512,63,174114
35786,0.002437,172.31.40.0-255,66,136578,63,174114
35787,0.002469,172.217.194.0-255,2184,138762,63,174114
35788,0.002471,172.31.40.0-255,66,138828,63,174114
35789,0.004998,172.217.194.0-255,2902,141730,63,174114
35790,0.005005,172.31.40.0-255,66,141796,63,174114
35791,0.005052,172.217.194.0-255,1484,143280,63,174114
35792,0.005073,172.217.194.0-255,1484,144764,63,174114
35793,0.005076,172.31.40.0-255,66,144830,63,174114
35794,0.007541,172.217.194.0-255,2902,147732,63,174114
35795,0.007547,172.31.40.0-255,66,147798,63,174114
35796,0.007627,172.217.194.0-255,2902,150700,63,174114
35797,0.007632,172.31.40.0-255,66,150766,63,174114
35798,0.010139,172.217.194.0-255,2902,153668,63,174114
35799,0.010146,172.31.40.0-255,66,153734,63,174114
35800,0.010191,172.217.194.0-255,2902,156636,63,174114
35801,0.010196,172.31.40.0-255,66,156702,63,174114
35802,0.012748,172.217.194.0-255,5738,162440,63,174114
35803,0.012755,172.31.40.0-255,66,162506,63,174114
35804,0.015337,172.217.194.0-255,5738,168244,63,174114
35805,0.015345,172.31.40.0-255,66,168310,63,174114
35806,0.017957,172.217.194.0-255,5738,174048,63,174114
35807,0.017967,172.31.40.0-255,66,174114,63,174114
35808,0.0,74.125.24.0-255,152,152,63,121825
35809,1.7e-05,172.31.40.0-255,66,218,63,121825
35810,2.3e-05,74.125.24.0-255,1484,1702,63,121825
35811,2.7e-05,172.31.40.0-255,66,1768,63,121825
35812,3.3e-05,74.125.24.0-255,2902,4670,63,121825
35813,3.6e-05,172.31.40.0-255,66,4736,63,121825
35814,5e-05,74.125.24.0-255,7156,11892,63,121825
35815,5.3e-05,172.31.40.0-255,66,11958,63,121825
35816,5.7e-05,74.125.24.0-255,2001,13959,63,121825
35817,6e-05,172.31.40.0-255,66,14025,63,121825
35818,0.000199,74.125.24.0-255,1484,15509,63,121825
35819,0.000202,172.31.40.0-255,66,15575,63,121825
35820,0.000206,74.125.24.0-255,1484,17059,63,121825
35821,0.000208,172.31.40.0-255,66,17125,63,121825
35822,0.000233,74.125.24.0-255,1484,18609,63,121825
35823,0.000235,172.31.40.0-255,66,18675,63,121825
35824,0.000242,74.125.24.0-255,5738,24413,63,121825
35825,0.000244,172.31.40.0-255,66,24479,63,121825
35826,0.000248,74.125.24.0-255,2902,27381,63,121825
35827,0.000249,172.31.40.0-255,66,27447,63,121825
35828,0.000273,74.125.24.0-255,3961,31408,63,121825
35829,0.000276,172.31.40.0-255,66,31474,63,121825
35830,0.0003,74.125.24.0-255,7156,38630,63,121825
35831,0.000303,172.31.40.0-255,66,38696,63,121825
35832,0.000309,74.125.24.0-255,5738,44434,63,121825
35833,0.000311,172.31.40.0-255,66,44500,63,121825
35834,0.00034,74.125.24.0-255,2902,47402,63,121825
35835,0.000343,172.31.40.0-255,66,47468,63,121825
35836,0.000346,74.125.24.0-255,1125,48593,63,121825
35837,0.000347,172.31.40.0-255,66,48659,63,121825
35838,0.001124,74.125.24.0-255,1484,50143,63,121825
35839,0.00113,172.31.40.0-255,66,50209,63,121825
35840,0.001139,74.125.24.0-255,2902,53111,63,121825
35841,0.001141,172.31.40.0-255,66,53177,63,121825
35842,0.001155,74.125.24.0-255,5738,58915,63,121825
35843,0.001157,172.31.40.0-255,66,58981,63,121825
35844,0.001201,172.31.40.0-255,66,59047,63,121825
35845,0.001206,74.125.24.0-255,2902,61949,63,121825
35846,0.001208,172.31.40.0-255,66,62015,63,121825
35847,0.001245,74.125.24.0-255,6797,68812,63,121825
35848,0.001248,172.31.40.0-255,66,68878,63,121825
35849,0.001289,74.125.24.0-255,7156,76034,63,121825
35850,0.001292,172.31.40.0-255,66,76100,63,121825
35851,0.00132,172.31.40.0-255,66,76166,63,121825
35852,0.001507,74.125.24.0-255,645,76811,63,121825
35853,0.003623,74.125.24.0-255,4320,81131,63,121825
35854,0.003629,172.31.40.0-255,66,81197,63,121825
35855,0.005948,74.125.24.0-255,5738,86935,63,121825
35856,0.005955,172.31.40.0-255,66,87001,63,121825
35857,0.008259,74.125.24.0-255,5738,92739,63,121825
35858,0.008267,172.31.40.0-255,66,92805,63,121825
35859,0.010612,74.125.24.0-255,5738,98543,63,121825
35860,0.010621,172.31.40.0-255,66,98609,63,121825
35861,0.012966,74.125.24.0-255,5738,104347,63,121825
35862,0.012974,172.31.40.0-255,66,104413,63,121825
35863,0.01533,74.125.24.0-255,5738,110151,63,121825
35864,0.01534,172.31.40.0-255,66,110217,63,121825
35865,0.01762,74.125.24.0-255,5738,115955,63,121825
35866,0.017628,172.31.40.0-255,66,116021,63,121825
35867,0.019984,74.125.24.0-255,5738,121759,63,121825
35868,0.01999,172.31.40.0-255,66,121825,63,121825
35869,0.0,74.125.24.0-255,152,152,63,243694
35870,2.3e-05,172.31.40.0-255,66,218,63,243694
35871,2.9e-05,74.125.24.0-255,1484,1702,63,243694
35872,3.4e-05,172.31.40.0-255,66,1768,63,243694
35873,4e-05,74.125.24.0-255,2902,4670,63,243694
35874,4.2e-05,172.31.40.0-255,66,4736,63,243694
35875,4.9e-05,74.125.24.0-255,5738,10474,63,243694
35876,5.2e-05,172.31.40.0-255,66,10540,63,243694
35877,7.2e-05,74.125.24.0-255,3456,13996,63,243694
35878,7.6e-05,172.31.40.0-255,66,14062,63,243694
35879,0.00013,74.125.24.0-255,1484,15546,63,243694
35880,0.000132,172.31.40.0-255,66,15612,63,243694
35881,0.000154,74.125.24.0-255,2902,18514,63,243694
35882,0.000157,172.31.40.0-255,66,18580,63,243694
35883,0.000163,74.125.24.0-255,5738,24318,63,243694
35884,0.000165,172.31.40.0-255,66,24384,63,243694
35885,0.000217,74.125.24.0-255,6797,31181,63,243694
35886,0.00022,172.31.40.0-255,66,31247,63,243694
35887,0.000246,74.125.24.0-255,1484,32731,63,243694
35888,0.000248,172.31.40.0-255,66,32797,63,243694
35889,0.000264,74.125.24.0-255,5738,38535,63,243694
35890,0.000266,172.31.40.0-255,66,38601,63,243694
35891,0.000274,74.125.24.0-255,7156,45757,63,243694
35892,0.000276,172.31.40.0-255,66,45823,63,243694
35893,0.000299,74.125.24.0-255,2543,48366,63,243694
35894,0.000301,172.31.40.0-255,66,48432,63,243694
35895,0.000494,74.125.24.0-255,1484,49916,63,243694
35896,0.000499,172.31.40.0-255,66,49982,63,243694
35897,0.000505,74.125.24.0-255,2902,52884,63,243694
35898,0.000507,172.31.40.0-255,66,52950,63,243694
35899,0.00051,74.125.24.0-255,1484,54434,63,243694
35900,0.000513,172.31.40.0-255,66,54500,63,243694
35901,0.000533,74.125.24.0-255,4320,58820,63,243694
35902,0.000536,172.31.40.0-255,66,58886,63,243694
35903,0.000539,74.125.24.0-255,1484,60370,63,243694
35904,0.000576,74.125.24.0-255,5960,66330,63,243694
35905,0.000579,172.31.40.0-255,66,66396,63,243694
35906,0.000615,74.125.24.0-255,5738,72134,63,243694
35907,0.000618,172.31.40.0-255,66,72200,63,243694
35908,0.000639,74.125.24.0-255,1484,73684,63,243694
35909,0.000646,74.125.24.0-255,5738,79422,63,243694
35910,0.00065,74.125.24.0-255,4320,83742,63,243694
35911,0.000655,172.31.40.0-255,66,83808,63,243694
35912,0.000662,172.31.40.0-255,66,83874,63,243694
35913,0.00067,74.125.24.0-255,7156,91030,63,243694
35914,0.000673,172.31.40.0-255,66,91096,63,243694
35915,0.000687,74.125.24.0-255,2902,93998,63,243694
35916,0.000689,172.31.40.0-255,66,94064,63,243694
35917,0.000696,74.125.24.0-255,6438,100502,63,243694
35918,0.0007,172.31.40.0-255,66,100568,63,243694
35919,0.00073,74.125.24.0-255,7156,107724,63,243694
35920,0.000733,172.31.40.0-255,66,107790,63,243694
35921,0.000738,74.125.24.0-255,2902,110692,63,243694
35922,0.000739,172.31.40.0-255,66,110758,63,243694
35923,0.000758,74.125.24.0-255,5738,116496,63,243694
35924,0.000761,172.31.40.0-255,66,116562,63,243694
35925,0.000778,74.125.24.0-255,4320,120882,63,243694
35926,0.000782,172.31.40.0-255,66,120948,63,243694
35927,0.000804,172.31.40.0-255,66,121014,63,243694
35928,0.000819,74.125.24.0-255,1484,122498,63,243694
35929,0.000832,74.125.24.0-255,3239,125737,63,243694
35930,0.000835,172.31.40.0-255,66,125803,63,243694
35931,0.000876,74.125.24.0-255,5738,131541,63,243694
35932,0.000884,172.31.40.0-255,66,131607,63,243694
35933,0.000888,74.125.24.0-255,1484,133091,63,243694
35934,0.000903,74.125.24.0-255,2902,135993,63,243694
35935,0.000906,172.31.40.0-255,66,136059,63,243694
35936,0.000923,74.125.24.0-255,1484,137543,63,243694
35937,0.000948,172.31.40.0-255,66,137609,63,243694
35938,0.000987,74.125.24.0-255,1484,139093,63,243694
35939,0.001023,172.31.40.0-255,66,139159,63,243694
35940,0.001028,74.125.24.0-255,4320,143479,63,243694
35941,0.001031,172.31.40.0-255,66,143545,63,243694
35942,0.001037,74.125.24.0-255,5738,149283,63,243694
35943,0.001039,172.31.40.0-255,66,149349,63,243694
35944,0.001052,172.31.40.0-255,66,149415,63,243694
35945,0.001066,172.31.40.0-255,66,149481,63,243694
35946,0.00108,172.31.40.0-255,66,149547,63,243694
35947,0.001085,74.125.24.0-255,2902,152449,63,243694
35948,0.001088,172.31.40.0-255,66,152515,63,243694
35949,0.001133,172.31.40.0-255,66,152581,63,243694
35950,0.001171,74.125.24.0-255,1484,154065,63,243694
35951,0.001175,74.125.24.0-255,1484,155549,63,243694
35952,0.001177,172.31.40.0-255,66,155615,63,243694
35953,0.001201,74.125.24.0-255,1484,157099,63,243694
35954,0.001206,74.125.24.0-255,5738,162837,63,243694
35955,0.001209,172.31.40.0-255,66,162903,63,243694
35956,0.001252,74.125.24.0-255,5738,168641,63,243694
35957,0.001256,172.31.40.0-255,66,168707,63,243694
35958,0.001259,172.31.40.0-255,66,168773,63,243694
35959,0.001282,74.125.24.0-255,5020,173793,63,243694
35960,0.001284,172.31.40.0-255,66,173859,63,243694
35961,0.001317,74.125.24.0-255,1484,175343,63,243694
35962,0.00133,74.125.24.0-255,2902,178245,63,243694
35963,0.001333,172.31.40.0-255,66,178311,63,243694
35964,0.001356,74.125.24.0-255,5738,184049,63,243694
35965,0.001359,172.31.40.0-255,66,184115,63,243694
35966,0.001377,74.125.24.0-255,7156,191271,63,243694
35967,0.00138,172.31.40.0-255,66,191337,63,243694
35968,0.001402,74.125.24.0-255,5738,197075,63,243694
35969,0.001404,172.31.40.0-255,66,197141,63,243694
35970,0.001417,172.31.40.0-255,66,197207,63,243694
35971,0.001464,74.125.24.0-255,1484,198691,63,243694
35972,0.001469,74.125.24.0-255,2902,201593,63,243694
35973,0.001472,172.31.40.0-255,66,201659,63,243694
35974,0.001475,74.125.24.0-255,1484,203143,63,243694
35975,0.0015,74.125.24.0-255,4320,207463,63,243694
35976,0.001503,172.31.40.0-255,66,207529,63,243694
35977,0.00151,74.125.24.0-255,5738,213267,63,243694
35978,0.001512,172.31.40.0-255,66,213333,63,243694
35979,0.001533,74.125.24.0-255,7156,220489,63,243694
35980,0.001536,172.31.40.0-255,66,220555,63,243694
35981,0.001561,172.31.40.0-255,66,220621,63,243694
35982,0.001636,74.125.24.0-255,1484,222105,63,243694
35983,0.001689,74.125.24.0-255,2902,225007,63,243694
35984,0.001692,172.31.40.0-255,66,225073,63,243694
35985,0.001699,74.125.24.0-255,5738,230811,63,243694
35986,0.001701,172.31.40.0-255,66,230877,63,243694
35987,0.001715,172.31.40.0-255,66,230943,63,243694
35988,0.001744,74.125.24.0-255,1484,232427,63,243694
35989,0.001759,172.31.40.0-255,66,232493,63,243694
35990,0.001767,74.125.24.0-255,7156,239649,63,243694
35991,0.001769,172.31.40.0-255,66,239715,63,243694
35992,0.001791,74.125.24.0-255,1484,241199,63,243694
35993,0.001815,172.31.40.0-255,66,241265,63,243694
35994,0.00185,74.125.24.0-255,766,242031,63,243694
35995,0.001854,172.31.40.0-255,66,242097,63,243694
35996,0.002,74.125.24.0-255,991,243088,63,243694
35997,0.002004,172.31.40.0-255,66,243154,63,243694
35998,0.002034,74.125.24.0-255,97,243251,63,243694
35999,0.002091,74.125.24.0-255,105,243356,63,243694
36000,0.003528,172.31.40.0-255,101,243457,63,243694
36001,0.004784,172.31.40.0-255,105,243562,63,243694
36002,0.005858,74.125.24.0-255,66,243628,63,243694
36003,0.007084,74.125.24.0-255,66,243694,63,243694
36004,0.0,74.125.130.0-255,150,150,63,166626
36005,2.2e-05,172.31.40.0-255,66,216,63,166626
36006,2.9e-05,74.125.130.0-255,1484,1700,63,166626
36007,3.2e-05,172.31.40.0-255,66,1766,63,166626
36008,3.7e-05,74.125.130.0-255,2902,4668,63,166626
36009,4.6e-05,172.31.40.0-255,66,4734,63,166626
36010,7.2e-05,74.125.130.0-255,5738,10472,63,166626
36011,7.5e-05,172.31.40.0-255,66,10538,63,166626
36012,0.000101,74.125.130.0-255,2902,13440,63,166626
36013,0.000103,172.31.40.0-255,66,13506,63,166626
36014,0.000134,74.125.130.0-255,3438,16944,63,166626
36015,0.000137,172.31.40.0-255,66,17010,63,166626
36016,0.000143,74.125.130.0-255,7156,24166,63,166626
36017,0.000145,172.31.40.0-255,66,24232,63,166626
36018,0.000169,74.125.130.0-255,2902,27134,63,166626
36019,0.000171,172.31.40.0-255,66,27200,63,166626
36020,0.000189,74.125.130.0-255,3961,31161,63,166626
36021,0.000191,172.31.40.0-255,66,31227,63,166626
36022,0.000296,74.125.130.0-255,1484,32711,63,166626
36023,0.000299,172.31.40.0-255,66,32777,63,166626
36024,0.000326,74.125.130.0-255,1484,34261,63,166626
36025,0.000328,172.31.40.0-255,66,34327,63,166626
36026,0.00035,74.125.130.0-255,1484,35811,63,166626
36027,0.000352,172.31.40.0-255,66,35877,63,166626
36028,0.000357,74.125.130.0-255,4320,40197,63,166626
36029,0.000359,172.31.40.0-255,66,40263,63,166626
36030,0.000362,74.125.130.0-255,1484,41747,63,166626
36031,0.000364,172.31.40.0-255,66,41813,63,166626
36032,0.000397,74.125.130.0-255,5738,47551,63,166626
36033,0.000403,172.31.40.0-255,66,47617,63,166626
36034,0.000405,74.125.130.0-255,1125,48742,63,166626
36035,0.000407,172.31.40.0-255,66,48808,63,166626
36036,0.000535,74.125.130.0-255,1484,50292,63,166626
36037,0.00054,74.125.130.0-255,1484,51776,63,166626
36038,0.000551,74.125.130.0-255,1484,53260,63,166626
36039,0.00056,172.31.40.0-255,66,53326,63,166626
36040,0.000566,74.125.130.0-255,4320,57646,63,166626
36041,0.000582,172.31.40.0-255,66,57712,63,166626
36042,0.000588,74.125.130.0-255,5738,63450,63,166626
36043,0.000623,74.125.130.0-255,2543,65993,63,166626
36044,0.000631,172.31.40.0-255,66,66059,63,166626
36045,0.000678,74.125.130.0-255,1484,67543,63,166626
36046,0.000694,74.125.130.0-255,2902,70445,63,166626
36047,0.000703,172.31.40.0-255,66,70511,63,166626
36048,0.000723,74.125.130.0-255,4320,74831,63,166626
36049,0.00073,172.31.40.0-255,66,74897,63,166626
36050,0.000736,74.125.130.0-255,1484,76381,63,166626
36051,0.000739,74.125.130.0-255,1484,77865,63,166626
36052,0.000742,172.31.40.0-255,66,77931,63,166626
36053,0.000757,74.125.130.0-255,5379,83310,63,166626
36054,0.000774,172.31.40.0-255,66,83376,63,166626
36055,0.001223,74.125.130.0-255,1484,84860,63,166626
36056,0.001228,74.125.130.0-255,1484,86344,63,166626
36057,0.001231,172.31.40.0-255,66,86410,63,166626
36058,0.001261,74.125.130.0-255,2902,89312,63,166626
36059,0.001267,74.125.130.0-255,5738,95050,63,166626
36060,0.001271,172.31.40.0-255,66,95116,63,166626
36061,0.001297,74.125.130.0-255,4320,99436,63,166626
36062,0.001318,74.125.130.0-255,5738,105174,63,166626
36063,0.001321,172.31.40.0-255,66,105240,63,166626
36064,0.001329,74.125.130.0-255,1484,106724,63,166626
36065,0.001332,172.31.40.0-255,66,106790,63,166626
36066,0.001368,74.125.130.0-255,766,107556,63,166626
36067,0.001374,172.31.40.0-255,66,107622,63,166626
36068,0.001761,74.125.130.0-255,1484,109106,63,166626
36069,0.00177,74.125.130.0-255,1484,110590,63,166626
36070,0.001773,172.31.40.0-255,66,110656,63,166626
36071,0.001792,74.125.130.0-255,1484,112140,63,166626
36072,0.001798,74.125.130.0-255,4320,116460,63,166626
36073,0.001815,74.125.130.0-255,1484,117944,63,166626
36074,0.001823,74.125.130.0-255,7156,125100,63,166626
36075,0.001845,74.125.130.0-255,2902,128002,63,166626
36076,0.001911,74.125.130.0-255,3602,131604,63,166626
36077,0.005053,172.31.40.0-255,66,131670,63,166626
36078,0.00709,74.125.130.0-255,5738,137408,63,166626
36079,0.007096,172.31.40.0-255,66,137474,63,166626
36080,0.00912,74.125.130.0-255,1484,138958,63,166626
36081,0.009136,74.125.130.0-255,4320,143278,63,166626
36082,0.00914,172.31.40.0-255,66,143344,63,166626
36083,0.011173,74.125.130.0-255,5738,149082,63,166626
36084,0.012495,172.31.40.0-255,66,149148,63,166626
36085,0.01455,74.125.130.0-255,5738,154886,63,166626
36086,0.014558,172.31.40.0-255,66,154952,63,166626
36087,0.016598,74.125.130.0-255,4320,159272,63,166626
36088,0.016614,74.125.130.0-255,1484,160756,63,166626
36089,0.016969,172.31.40.0-255,66,160822,63,166626
36090,0.019001,74.125.130.0-255,5738,166560,63,166626
36091,0.019007,172.31.40.0-255,66,166626,63,166626
36092,0.0,172.31.40.0-255,105,105,63,276
36093,0.001789,157.240.24.0-255,105,210,63,276
36094,0.001803,172.31.40.0-255,66,276,63,276
